box_score_id,player_id,minutes_played,fg,fg_a,two_pt,two_pt_a,three_pt,three_pt_a,ft,ft_a,o_reb,d_reb,assist,pf,stl,to,blk,pts
8,790932,27,5,10,3,5,2,5,1,2,1,1,5,3,1,1,0,13
8,774936,17,1,4,1,4,0,0,10,12,5,5,0,1,0,3,0,12
8,786803,27,3,6,2,4,1,2,0,3,0,3,5,3,1,1,0,7
8,781345,26,0,2,0,2,0,0,1,2,0,6,2,1,1,1,1,1
8,786805,20,0,6,0,4,0,2,1,2,0,1,1,4,0,1,0,1
8,786804,19,5,5,0,0,5,5,2,2,0,0,0,2,3,4,1,17
8,790931,12,3,5,1,3,2,2,0,0,0,1,0,1,0,1,0,8
8,796487,5,2,2,0,0,2,2,1,2,0,0,0,1,0,1,0,7
8,796488,8,1,2,0,0,1,2,0,0,0,1,0,0,0,1,0,3
8,790933,14,0,4,0,2,0,2,1,2,0,2,1,3,1,1,0,1
8,790934,12,0,2,0,1,0,1,0,0,0,2,0,1,1,0,0,0
8,780033,6,0,0,0,0,0,0,0,0,0,1,0,0,0,0,1,0
8,780030,3,0,1,0,1,0,0,0,0,0,0,0,0,0,0,0,0
8,796489,2,0,0,0,0,0,0,0,0,0,0,0,1,0,0,0,0
8,796490,2,0,0,0,0,0,0,0,0,0,1,0,0,0,0,0,0
9,790818,27,4,8,3,5,1,3,2,2,0,1,1,2,1,5,0,11
9,780730,33,2,8,2,5,0,3,6,8,0,4,0,2,1,2,0,10
9,786396,26,2,8,1,4,1,4,2,2,1,3,0,4,0,2,0,7
9,776217,27,3,5,3,5,0,0,0,0,2,4,0,4,0,2,0,6
9,791220,16,0,3,0,1,0,2,2,3,1,2,4,4,2,0,1,2
9,786824,24,2,5,2,4,0,1,2,2,3,4,0,2,1,2,0,6
9,791219,16,1,7,0,3,1,4,0,0,1,7,0,1,1,2,1,3
9,796923,9,1,1,1,1,0,0,0,0,2,1,0,1,0,1,0,2
9,796921,16,0,4,0,1,0,3,0,0,0,1,0,2,0,4,0,0
9,796920,4,0,2,0,1,0,1,0,0,1,0,0,1,0,1,0,0
9,791221,2,0,0,0,0,0,0,0,0,0,0,0,3,0,1,0,0
10,780163,29,5,12,4,8,1,4,2,3,0,2,4,2,2,0,0,13
10,785742,23,5,8,2,4,3,4,0,0,0,1,5,2,1,3,0,13
10,797243,21,4,9,4,9,0,0,3,5,3,3,2,1,2,5,0,11
10,791366,21,5,7,5,6,0,1,1,1,2,1,0,2,1,1,0,11
10,786155,13,1,5,1,5,0,0,3,5,4,2,0,1,0,0,0,5
10,797241,22,8,8,8,8,0,0,0,0,2,2,0,0,3,1,0,16
10,797242,7,0,2,0,2,0,0,0,0,3,0,0,1,0,0,0,0
10,797244,20,1,4,1,4,0,0,2,4,0,2,8,3,10,1,1,4
10,780170,20,3,9,2,5,1,4,3,3,1,5,0,1,1,2,0,10
10,797245,3,1,3,1,2,0,1,0,0,0,1,0,0,1,0,0,2
10,791363,18,2,4,2,3,0,1,0,0,1,1,0,3,0,0,0,4
10,797246,3,0,1,0,0,0,1,0,0,0,1,0,0,0,1,0,0
12,781342,24,7,10,4,5,3,5,2,2,0,3,2,3,0,2,2,19
12,790902,25,4,6,0,0,4,6,0,0,0,2,0,1,1,0,0,12
12,790901,32,4,8,2,4,2,4,4,4,0,1,2,2,1,2,0,14
12,785452,30,4,9,3,6,1,3,0,0,1,2,5,1,1,1,0,9
12,781620,22,4,8,3,7,1,1,0,0,0,3,2,2,1,2,2,9
12,774864,19,4,6,4,4,0,2,0,0,0,2,3,2,0,2,0,8
12,781593,21,1,3,1,1,0,2,0,0,0,4,4,4,0,0,0,2
12,796450,7,0,2,0,1,0,1,0,0,1,0,0,1,0,0,0,0
12,796449,11,1,8,1,6,0,2,1,1,3,4,0,0,0,1,0,3
12,774835,7,0,0,0,0,0,0,1,4,0,1,0,2,0,0,0,1
12,796452,2,0,0,0,0,0,0,0,0,0,0,0,0,0,0,0,0
13,785622,34,4,10,3,5,1,5,3,4,1,3,1,2,0,1,1,12
13,781058,24,2,3,2,3,0,0,2,2,2,5,0,2,0,1,0,6
13,780327,19,1,4,1,4,0,0,2,6,2,1,1,2,0,1,0,4
13,797451,32,2,12,1,9,1,3,5,6,1,3,5,0,1,3,0,10
13,786607,29,5,11,3,6,2,5,0,0,0,2,1,1,3,1,0,12
13,797458,21,2,3,1,2,1,1,0,0,0,1,1,0,2,4,0,5
13,797452,19,2,5,2,3,0,2,1,1,0,4,1,0,0,2,0,5
13,797455,15,2,4,2,4,0,0,1,2,0,2,0,3,0,2,0,5
13,791848,7,1,1,0,0,1,1,0,0,0,1,0,1,0,0,0,3
14,791949,29,10,15,9,13,1,2,0,0,3,9,4,1,1,1,2,21
14,776014,23,3,5,3,3,0,2,0,0,2,4,1,1,2,0,1,6
14,797691,25,5,8,5,6,0,2,2,2,0,3,4,4,1,1,2,12
14,780747,31,3,10,2,3,1,7,0,0,1,5,10,1,3,2,0,7
14,776363,28,6,10,1,1,5,9,0,0,0,5,5,0,2,2,1,17
14,784336,23,4,5,4,5,0,0,0,0,0,8,0,1,0,2,1,8
14,791946,23,6,10,0,0,6,10,0,0,0,2,7,3,0,2,0,18
14,791948,18,6,8,6,7,0,1,0,2,0,1,3,0,0,0,2,12
15,797529,23,1,4,1,3,0,1,0,0,3,3,0,2,2,2,0,2
15,791936,18,3,8,3,8,0,0,2,2,2,3,0,2,1,1,0,8
15,797532,29,2,8,1,6,1,2,3,4,0,1,5,1,1,3,0,8
15,791933,25,2,10,0,1,2,9,0,0,1,1,0,0,0,0,0,6
15,785988,22,2,10,1,4,1,6,1,2,0,5,0,1,1,2,0,6
15,791932,14,2,6,0,2,2,4,2,2,0,2,0,0,1,3,0,8
15,785688,13,1,9,0,4,1,5,2,3,0,0,0,1,0,1,0,5
15,797527,20,1,6,1,3,0,3,0,0,6,2,1,0,3,0,0,2
15,791931,12,1,4,1,4,0,0,0,0,1,1,0,0,0,1,0,2
15,797530,10,1,2,1,2,0,0,0,0,0,1,2,0,0,1,0,2
15,791935,7,0,1,0,1,0,0,0,0,0,0,0,0,0,2,0,0
15,797528,5,0,1,0,0,0,1,0,0,0,1,0,0,0,0,0,0
15,786532,2,0,0,0,0,0,0,0,0,0,0,0,0,0,0,0,0
16,791621,34,8,15,5,8,3,7,2,2,0,3,4,0,3,3,0,21
16,781125,31,4,8,4,8,0,0,6,10,2,8,0,3,0,2,1,14
16,786431,23,2,4,2,4,0,0,10,10,1,0,0,3,4,0,0,14
16,775620,24,4,8,4,8,0,0,0,0,2,2,0,2,0,1,0,8
16,780440,29,3,6,3,4,0,2,0,0,0,3,1,2,0,0,0,6
16,791620,12,3,3,1,1,2,2,0,0,0,1,0,1,0,1,0,8
16,781088,21,2,5,2,3,0,2,0,0,0,2,5,4,0,0,0,4
16,786434,10,2,6,2,6,0,0,0,0,1,1,0,4,1,1,2,4
16,791619,7,1,1,1,1,0,0,0,0,0,1,0,1,0,1,0,2
16,786432,8,0,1,0,0,0,1,0,0,0,0,0,1,0,0,0,0
16,796976,1,0,0,0,0,0,0,0,0,0,0,0,1,0,0,0,0
17,786481,29,4,8,3,7,1,1,6,8,5,2,0,4,1,7,1,15
17,791790,31,3,9,3,5,0,4,3,3,1,1,1,1,0,3,0,9
17,781032,21,3,4,1,1,2,3,0,1,0,0,1,2,0,0,0,8
17,797628,15,0,5,0,3,0,2,0,0,1,2,1,2,0,0,0,0
17,786480,9,0,2,0,0,0,2,0,0,0,2,0,1,0,1,0,0
17,785965,32,4,11,2,6,2,5,6,8,0,2,2,1,2,2,0,16
17,791793,12,3,4,3,3,0,1,1,2,0,7,0,0,0,0,0,7
17,797627,18,2,3,1,1,1,2,0,0,0,1,1,2,0,2,0,5
17,797624,16,1,5,1,1,0,4,2,2,2,1,0,5,0,0,1,4
17,791791,17,1,3,0,0,1,3,0,0,4,1,2,0,0,2,0,3
18,786685,26,7,11,6,8,1,3,1,3,0,4,1,3,2,3,0,16
18,796609,18,6,8,4,5,2,3,2,2,1,2,5,3,2,2,0,16
18,785841,31,5,10,5,9,0,1,3,9,3,7,4,3,1,0,0,13
18,785664,16,4,8,4,8,0,0,1,4,7,3,0,0,1,2,0,9
18,792232,22,3,6,3,3,0,3,2,4,4,1,1,1,1,1,0,8
18,796611,24,6,9,3,4,3,5,0,0,1,6,0,0,1,1,1,15
18,796613,30,3,9,3,7,0,2,0,1,1,5,6,0,0,0,0,6
18,780728,5,3,7,3,7,0,0,0,0,4,1,0,2,0,0,0,6
18,791312,10,2,4,2,4,0,0,0,0,3,1,1,2,0,2,1,4
18,785840,11,1,3,1,1,0,2,0,2,1,0,0,2,1,0,0,2
18,791313,1,1,1,1,1,0,0,0,1,0,0,0,0,0,0,0,2
18,796203,4,0,1,0,0,0,1,0,0,0,0,1,0,0,0,0,0
18,785848,1,0,0,0,0,0,0,0,0,0,0,0,0,0,0,0,0
18,796620,1,0,0,0,0,0,0,0,0,0,1,0,0,0,0,0,0
20,785833,29,7,12,7,11,0,1,4,4,3,7,2,2,2,1,2,18
20,785836,20,4,10,2,5,2,5,4,4,7,7,3,0,3,1,1,14
20,775872,32,4,9,3,5,1,4,0,0,3,5,3,2,1,1,1,9
20,797533,22,4,5,4,4,0,1,0,0,0,1,1,3,0,3,0,8
20,785838,16,2,6,1,2,1,4,0,0,0,2,1,0,1,1,0,5
20,791707,33,7,17,5,15,2,2,2,3,1,4,4,3,4,2,1,18
20,791704,14,6,8,6,7,0,1,0,0,0,0,1,2,1,1,0,12
20,791705,24,2,6,2,4,0,2,2,3,1,5,1,0,0,0,0,6
20,797534,10,1,2,0,0,1,2,0,0,0,1,0,2,0,0,0,3
22,775574,25,7,19,4,11,3,8,2,4,2,2,1,0,2,0,0,19
22,786066,32,7,13,5,10,2,3,2,3,3,7,5,0,2,0,0,18
22,780890,21,4,5,1,2,3,3,0,0,2,3,0,2,0,2,1,11
22,775757,12,3,3,2,2,1,1,3,4,0,2,0,2,0,0,0,10
22,785636,37,4,8,3,5,1,3,0,0,2,6,5,1,0,1,0,9
22,785969,8,4,9,4,6,0,3,0,0,1,4,1,1,2,1,0,8
22,791121,12,2,7,1,5,1,2,2,4,1,1,1,1,1,1,0,7
22,791123,26,2,5,0,2,2,3,0,0,4,2,0,1,1,3,0,6
22,791119,11,2,5,2,5,0,0,2,2,2,2,0,1,1,0,0,6
22,781068,16,2,3,2,2,0,1,1,2,2,1,2,3,0,3,1,5
24,792025,17,3,3,3,3,0,0,0,0,1,3,0,0,0,1,2,6
24,785948,32,3,7,3,7,0,0,3,4,2,4,0,3,1,1,0,9
24,785941,35,7,15,4,6,3,9,0,0,0,1,2,1,0,5,0,17
24,785939,27,6,14,5,10,1,4,0,2,0,3,2,1,3,1,0,13
24,785938,30,4,8,3,5,1,3,1,2,0,2,6,3,1,0,0,10
24,785940,7,0,0,0,0,0,0,0,0,0,1,0,0,1,0,0,0
24,797634,14,3,7,1,1,2,6,2,2,1,2,0,5,0,1,0,10
24,792022,15,2,3,2,2,0,1,1,2,1,3,1,2,0,0,0,5
24,792023,14,0,4,0,3,0,1,0,0,0,1,2,4,1,0,0,0
24,785946,9,1,1,1,1,0,0,0,0,0,0,1,1,0,2,0,2
24,792024,0,0,0,0,0,0,0,0,0,0,0,0,0,0,0,0,0
26,798963,18,2,10,1,8,1,2,3,6,0,2,3,0,0,1,0,8
26,798962,21,4,7,4,6,0,1,0,2,2,0,0,3,2,1,0,8
26,791718,24,2,8,1,1,1,7,0,0,0,1,2,0,3,0,0,5
26,791719,15,0,6,0,2,0,4,0,0,0,0,1,1,0,1,0,0
26,798964,8,1,1,1,1,0,0,0,0,1,1,1,2,0,0,0,2
26,781446,22,3,13,2,8,1,5,0,0,1,3,1,2,2,1,0,7
26,791720,5,0,0,0,0,0,0,0,0,1,0,0,1,0,1,0,0
26,798965,23,3,12,1,7,2,5,0,0,3,7,0,2,1,3,0,8
26,791717,23,1,6,1,5,0,1,0,0,2,1,2,1,3,1,0,2
26,798968,26,4,10,3,6,1,4,3,3,0,3,1,1,1,0,0,12
26,798969,3,2,3,1,1,1,2,0,0,0,0,0,0,1,0,0,5
26,787996,12,2,4,2,3,0,1,0,0,2,0,1,1,0,0,0,4
27,780146,25,4,8,3,4,1,4,0,1,0,7,3,3,2,2,0,9
27,790962,23,4,11,4,6,0,5,3,4,2,4,2,2,0,4,0,11
27,775860,26,1,5,0,1,1,4,0,0,0,7,3,0,0,5,0,3
27,790961,24,5,7,5,6,0,1,4,4,2,2,0,2,3,3,0,14
27,785278,22,5,9,2,3,3,6,0,0,0,3,2,0,0,1,1,13
27,796553,4,0,1,0,1,0,0,0,0,0,3,1,2,1,1,0,0
27,796554,18,5,6,4,4,1,2,1,2,1,5,1,0,0,1,0,12
27,796555,10,2,4,1,2,1,2,0,0,1,0,1,2,0,3,0,5
27,796556,16,3,6,3,4,0,2,0,0,3,3,2,1,0,0,0,6
27,790965,12,1,2,1,1,0,1,0,0,2,2,0,0,0,2,1,2
27,780832,17,2,3,2,3,0,0,2,2,1,4,0,1,0,1,1,6
27,796557,3,0,0,0,0,0,0,0,0,1,1,0,0,0,0,0,0
28,790837,19,2,3,1,1,1,2,0,0,1,1,1,5,0,0,1,5
28,780025,27,8,11,8,11,0,0,7,9,2,8,1,2,0,1,0,23
28,786228,24,0,4,0,3,0,1,4,4,0,0,8,4,2,0,0,4
28,785385,27,5,12,3,5,2,7,2,3,0,2,2,2,2,0,0,14
28,785383,24,5,14,2,10,3,4,5,5,2,5,4,3,0,3,0,18
28,786297,14,5,7,5,7,0,0,0,2,4,2,1,2,0,2,0,10
28,785382,14,3,5,2,3,1,2,1,2,3,0,2,1,0,0,1,8
28,781046,24,5,11,5,11,0,0,1,2,3,6,0,0,0,0,1,11
28,796391,13,0,2,0,2,0,0,0,0,1,1,0,3,0,0,0,0
28,792180,14,1,1,1,1,0,0,2,2,0,1,2,1,3,1,0,4
29,796955,18,0,1,0,1,0,0,2,4,1,3,0,5,0,1,0,2
29,791257,24,2,7,2,3,0,4,1,2,0,3,0,3,0,1,0,5
29,781606,34,4,10,4,10,0,0,0,2,2,1,4,2,0,5,0,8
29,781263,25,3,8,3,6,0,2,2,2,0,0,1,4,1,0,0,8
29,781257,29,3,8,3,7,0,1,4,6,0,4,1,1,0,0,0,10
29,780900,23,3,5,2,3,1,2,0,1,1,7,0,2,0,2,2,7
29,791255,16,2,5,2,4,0,1,2,2,2,0,0,4,0,1,0,6
29,796954,25,2,6,1,2,1,4,5,5,0,1,0,0,2,4,0,10
29,785508,6,0,1,0,0,0,1,0,0,0,1,0,1,0,0,0,0
30,791416,17,6,9,6,9,0,0,6,8,4,6,0,3,0,4,1,18
30,797096,27,10,12,4,4,6,8,2,2,1,2,3,0,1,2,0,28
30,785906,26,11,18,6,10,5,8,1,3,1,9,5,1,0,1,0,28
30,780100,25,2,5,0,1,2,4,0,0,1,4,7,2,2,0,0,6
30,780096,22,2,10,0,3,2,7,0,0,0,4,4,5,0,0,0,6
30,797093,19,3,4,3,3,0,1,2,3,1,1,6,4,1,4,0,8
30,785907,17,3,7,3,7,0,0,1,2,5,2,3,1,0,0,1,7
30,781614,18,4,5,2,3,2,2,0,0,1,7,1,1,1,2,1,10
30,797094,13,1,2,1,1,0,1,3,4,2,2,2,1,0,1,0,5
30,785903,4,0,0,0,0,0,0,0,0,0,1,0,0,0,0,0,0
30,797095,5,1,2,1,2,0,0,2,2,2,1,0,0,0,1,1,4
30,797098,3,1,1,1,1,0,0,0,0,0,1,0,0,0,0,0,2
30,791417,1,0,0,0,0,0,0,0,0,0,0,0,0,0,0,0,0
30,797097,3,0,0,0,0,0,0,0,0,0,0,0,0,0,0,0,0
31,787522,15,2,3,2,3,0,0,0,0,1,1,1,3,0,2,0,4
31,787524,17,0,4,0,1,0,3,3,6,0,1,0,3,2,2,0,3
31,791772,20,2,11,0,7,2,4,3,4,2,2,1,1,1,1,0,9
31,781019,31,3,8,3,8,0,0,2,5,1,0,4,0,1,3,0,8
31,780017,25,6,16,6,15,0,1,0,0,0,2,4,2,2,4,0,12
31,775541,11,2,4,1,1,1,3,0,0,0,3,0,5,1,0,0,5
31,783269,15,0,4,0,0,0,4,0,0,0,0,0,3,0,0,0,0
31,791774,17,3,3,3,3,0,0,0,0,0,1,0,3,1,0,0,6
31,780328,25,1,2,1,2,0,0,3,6,0,1,0,0,0,0,0,5
31,797611,9,2,4,1,3,1,1,0,0,0,1,0,0,1,0,0,5
31,797610,11,1,4,0,1,1,3,0,0,0,0,0,0,0,0,0,3
31,797608,4,0,1,0,1,0,0,0,0,0,0,0,1,0,0,0,0
32,792253,18,2,3,2,3,0,0,2,2,3,2,1,3,0,1,4,6
32,781430,35,8,16,7,12,1,4,5,7,5,11,3,1,4,3,1,22
32,792248,15,3,8,1,2,2,6,0,0,0,0,0,2,1,1,0,8
32,781445,31,9,19,0,1,9,18,0,0,0,2,1,2,1,3,0,27
32,768845,33,3,7,0,2,3,5,2,3,2,3,5,1,1,3,1,11
32,792249,17,1,2,1,2,0,0,0,2,2,5,1,3,0,4,0,2
32,797941,10,1,2,1,2,0,0,0,1,2,2,0,1,0,1,1,2
32,792251,8,0,2,0,1,0,1,0,0,1,0,1,2,0,2,0,0
32,792250,15,2,4,1,2,1,2,0,0,1,0,3,0,2,0,0,5
32,786076,7,2,3,0,0,2,3,0,0,0,0,0,0,1,1,0,6
32,797957,4,0,1,0,1,0,0,0,0,0,2,0,1,0,0,0,0
32,781448,5,0,0,0,0,0,0,0,0,1,0,1,1,0,1,0,0
32,797944,2,0,0,0,0,0,0,0,0,0,0,0,0,0,0,0,0
34,785335,24,5,8,5,8,0,0,1,1,2,3,0,1,0,2,0,11
34,780303,33,6,14,6,14,0,0,2,3,3,3,1,2,0,2,4,14
34,791594,33,3,10,3,6,0,4,2,2,1,5,8,3,1,3,0,8
34,786349,20,1,4,1,3,0,1,0,0,0,3,0,2,0,2,0,2
34,781385,25,4,8,2,3,2,5,0,0,2,3,1,3,0,2,0,10
34,791011,5,0,1,0,0,0,1,0,0,1,1,0,1,0,0,0,0
34,785337,25,3,4,2,3,1,1,3,4,3,6,0,1,0,1,1,10
34,791012,22,2,6,0,0,2,6,0,0,0,6,1,1,0,2,0,6
34,781221,13,0,4,0,1,0,3,0,0,0,0,1,0,0,1,1,0
35,797967,31,7,14,4,10,3,4,0,0,3,3,2,3,2,2,0,17
35,786087,31,1,5,1,5,0,0,0,0,2,4,0,2,0,0,2,2
35,797970,26,2,10,0,3,2,7,4,6,0,3,0,3,1,1,0,10
35,781453,36,6,21,3,13,3,8,0,0,1,3,5,1,2,2,0,15
35,774869,30,4,8,2,2,2,6,0,0,1,4,3,1,1,1,0,10
35,792254,9,0,3,0,2,0,1,0,2,0,0,0,0,0,0,0,0
35,797962,13,0,0,0,0,0,0,0,0,5,2,1,0,0,0,0,0
35,786098,18,1,4,0,1,1,3,0,0,0,2,2,1,0,1,0,3
35,797961,6,1,1,1,1,0,0,0,0,0,2,0,0,0,0,0,2
36,792288,30,5,8,3,5,2,3,4,5,1,3,1,0,2,2,1,16
36,785227,21,1,3,1,3,0,0,5,6,0,4,0,2,0,0,6,7
36,786237,6,2,5,2,5,0,0,2,2,1,1,1,3,0,0,0,6
36,780287,28,4,9,4,7,0,2,2,3,1,1,1,3,1,2,0,10
36,776309,27,6,9,6,9,0,0,2,6,0,9,1,1,3,2,0,14
36,792278,23,5,11,2,5,3,6,8,8,0,1,4,1,1,0,0,21
36,786232,26,3,6,2,4,1,2,3,3,1,2,2,0,4,2,1,10
36,798066,5,1,1,1,1,0,0,0,0,0,2,0,0,0,0,0,2
36,798067,17,2,2,2,2,0,0,3,4,1,3,0,2,0,1,2,7
36,798084,2,1,1,1,1,0,0,0,0,0,0,0,1,1,0,0,2
36,798068,11,1,3,1,1,0,2,2,2,0,1,1,3,1,1,0,4
36,792282,2,0,0,0,0,0,0,0,0,0,0,0,0,0,1,0,0
36,798077,2,0,0,0,0,0,0,0,0,0,0,0,0,0,0,0,0
37,796543,17,0,3,0,2,0,1,2,2,2,1,0,1,0,0,0,2
37,790951,10,0,1,0,1,0,0,0,0,2,4,0,4,0,0,0,0
37,786309,27,2,11,2,8,0,3,2,2,1,1,0,0,0,6,0,6
37,786089,18,0,3,0,1,0,2,0,0,0,2,0,1,0,3,0,0
37,780087,17,3,14,3,11,0,3,3,4,0,0,1,5,0,2,0,9
37,796540,18,5,9,4,8,1,1,0,1,5,2,0,2,0,2,0,11
37,775037,13,1,1,1,1,0,0,0,0,1,3,0,0,0,0,0,2
37,798697,5,0,0,0,0,0,0,0,0,0,1,0,0,0,0,0,0
37,790952,16,2,5,2,4,0,1,0,0,1,0,0,5,0,1,0,4
37,776136,29,6,11,4,8,2,3,0,0,0,2,1,1,0,3,0,14
37,796545,7,0,2,0,1,0,1,0,0,0,0,0,3,0,0,0,0
37,796544,15,0,1,0,0,0,1,2,3,0,2,0,1,2,4,0,2
37,796541,8,0,2,0,2,0,0,0,0,1,0,0,0,0,0,0,0
38,792140,26,9,12,9,12,0,0,2,2,1,0,3,2,1,0,2,20
38,792144,28,3,9,3,6,0,3,4,4,3,5,0,2,2,1,2,10
38,792148,32,5,10,3,6,2,4,1,2,0,6,3,1,1,4,0,13
38,781429,31,7,11,1,1,6,10,0,1,0,1,2,3,1,0,0,20
38,776092,32,7,12,6,9,1,3,5,6,1,7,5,2,3,5,0,20
38,797791,2,0,0,0,0,0,0,0,0,0,0,0,2,0,0,0,0
38,792146,12,0,2,0,2,0,0,4,4,1,3,0,3,0,0,0,4
38,797786,18,2,3,1,2,1,1,0,0,0,2,3,3,1,1,0,5
38,797789,11,2,4,2,4,0,0,0,0,0,3,0,3,0,0,0,4
38,797793,3,1,1,1,1,0,0,0,1,0,0,0,0,0,0,0,2
38,797787,1,0,0,0,0,0,0,0,0,0,0,1,0,0,0,0,0
38,785975,3,0,0,0,0,0,0,0,0,1,0,0,0,0,0,0,0
38,797797,1,0,0,0,0,0,0,0,0,0,0,0,0,0,0,0,0
39,791681,11,0,3,0,2,0,1,0,0,1,2,0,0,2,0,0,0
39,791680,32,6,11,3,6,3,5,2,4,3,5,0,4,0,0,0,17
39,785815,39,6,13,2,7,4,6,13,18,1,3,0,2,0,3,0,29
39,785812,32,3,11,2,5,1,6,6,6,0,0,2,5,1,2,0,13
39,780104,23,4,10,4,8,0,2,1,3,1,3,2,3,2,4,1,9
39,791682,11,1,3,1,3,0,0,0,0,0,0,1,2,0,0,0,2
39,797431,30,3,10,3,5,0,5,0,0,0,1,1,2,0,2,0,6
39,791684,9,0,1,0,0,0,1,0,0,0,0,0,0,0,1,0,0
39,790530,13,0,0,0,0,0,0,0,0,1,1,0,3,0,0,0,0
40,780012,35,7,14,4,6,3,8,0,0,1,8,3,1,1,2,0,17
40,774895,12,0,1,0,1,0,0,2,2,1,5,0,1,0,2,0,2
40,790824,26,4,10,4,6,0,4,1,3,1,5,2,1,1,0,1,9
40,780011,32,4,7,3,5,1,2,2,2,0,2,4,0,1,1,0,11
40,775667,32,4,6,3,4,1,2,7,8,0,1,8,3,0,1,0,16
40,796309,18,4,7,4,6,0,1,3,4,3,5,1,3,0,1,1,11
40,781524,21,6,8,1,1,5,7,2,4,2,2,3,2,0,2,1,19
40,785370,14,2,2,2,2,0,0,3,3,0,2,2,3,0,0,0,7
40,796382,3,0,1,0,0,0,1,0,0,0,0,0,2,0,0,0,0
40,796383,7,2,5,2,3,0,2,0,0,1,3,0,0,0,1,0,4
41,780291,31,4,12,2,7,2,5,5,5,3,4,2,3,0,0,0,15
41,785607,7,0,3,0,3,0,0,0,0,1,0,0,4,0,0,0,0
41,796665,24,2,7,2,4,0,3,3,3,0,1,3,5,1,2,0,7
41,785333,32,2,5,2,4,0,1,0,0,1,5,3,1,0,0,0,4
41,775305,36,9,24,6,16,3,8,3,3,3,0,1,3,1,1,0,24
41,796663,15,2,3,2,3,0,0,0,0,2,3,2,1,0,0,0,4
41,791004,23,6,11,0,1,6,10,3,3,0,2,0,2,1,0,0,21
41,796666,8,0,1,0,0,0,1,0,0,0,3,0,4,0,1,0,0
41,791007,15,1,4,0,3,1,1,3,6,0,4,1,1,0,2,0,6
41,791006,7,0,0,0,0,0,0,1,2,0,0,0,0,0,0,0,1
41,791005,2,0,0,0,0,0,0,0,0,0,0,0,0,0,0,0,0
42,790897,13,3,8,0,1,3,7,0,0,0,1,1,2,0,0,0,9
42,785442,15,2,4,2,3,0,1,5,6,1,4,0,3,3,4,0,9
42,785579,22,3,6,3,4,0,2,1,3,0,3,2,1,1,1,0,7
42,781628,22,3,7,1,4,2,3,0,0,1,4,4,0,2,0,0,8
42,775959,23,5,8,1,2,4,6,2,2,1,6,2,1,1,1,1,16
42,790898,21,1,6,1,6,0,0,4,4,1,5,6,2,2,2,0,6
42,785448,22,3,4,2,2,1,2,3,4,1,3,3,4,5,0,1,10
42,775737,14,4,8,0,0,4,8,0,0,0,1,0,0,1,1,0,12
42,790896,18,7,7,7,7,0,0,5,5,5,0,1,3,1,2,0,19
42,796447,7,0,0,0,0,0,0,2,2,2,0,0,2,2,3,1,2
42,796446,11,4,5,4,5,0,0,3,6,1,1,1,2,2,1,0,11
42,790900,4,1,1,1,1,0,0,0,0,0,2,0,0,0,0,0,2
42,785447,4,0,1,0,0,0,1,0,0,0,2,0,0,0,0,0,0
42,780596,4,0,1,0,0,0,1,0,0,0,0,1,1,0,0,0,0
43,790494,26,1,2,1,2,0,0,1,2,0,2,3,4,0,2,1,3
43,781659,28,2,4,1,2,1,2,0,2,0,5,0,3,0,1,0,5
43,781005,24,3,9,2,3,1,6,2,3,0,0,1,5,0,1,4,9
43,780610,31,2,12,0,4,2,8,2,3,0,2,3,2,1,5,0,8
43,796851,34,2,12,0,4,2,8,5,6,1,3,1,3,1,6,0,11
43,788866,14,0,1,0,1,0,0,0,0,1,1,0,4,2,2,0,0
43,796854,29,2,6,1,5,1,1,5,6,4,1,3,2,2,6,0,10
43,796855,14,2,7,2,7,0,0,1,2,1,1,0,0,0,2,1,5
44,785775,25,3,4,3,4,0,0,2,4,1,1,7,2,2,1,0,8
44,781335,27,4,15,4,11,0,4,2,2,0,6,1,3,2,3,2,10
44,776351,24,7,11,5,7,2,4,7,7,4,6,0,4,0,0,1,23
44,785770,27,8,10,8,9,0,1,4,6,1,6,6,2,1,0,0,20
44,781341,27,2,4,0,0,2,4,0,0,0,2,7,2,0,1,0,6
44,796542,17,8,8,8,8,0,0,1,1,3,2,0,3,1,2,1,17
44,796538,15,1,4,0,0,1,4,0,0,1,1,3,0,0,1,0,3
44,791283,18,2,7,1,4,1,3,1,2,0,6,0,2,1,0,0,6
44,791282,5,0,1,0,1,0,0,0,0,0,0,1,0,0,0,0,0
44,791284,2,0,0,0,0,0,0,2,2,0,1,0,0,0,0,0,2
44,785767,9,0,2,0,1,0,1,0,0,0,1,0,0,0,0,0,0
44,791285,2,0,0,0,0,0,0,0,0,0,0,0,0,0,0,0,0
44,791286,1,0,0,0,0,0,0,0,0,0,0,0,0,0,0,0,0
44,785773,1,0,0,0,0,0,0,0,0,0,0,0,0,0,0,0,0
46,780027,24,11,14,11,13,0,1,4,4,7,3,1,1,2,1,3,26
46,786173,21,3,5,0,0,3,5,1,1,0,1,3,0,0,0,0,10
46,774828,26,2,8,0,1,2,7,0,0,0,5,2,1,1,1,0,6
46,780028,21,1,2,0,0,1,2,0,0,0,3,4,3,1,1,0,3
46,786176,18,2,4,2,2,0,2,5,6,2,4,1,3,0,2,1,9
46,791380,16,1,2,0,1,1,1,0,0,0,2,3,2,3,3,0,3
46,791379,21,5,10,4,6,1,4,5,8,3,0,1,0,1,0,1,16
46,797175,21,4,10,2,4,2,6,2,2,3,4,1,2,0,0,1,12
46,797176,6,1,4,1,3,0,1,0,0,2,0,0,1,0,1,1,2
46,797178,9,2,5,2,5,0,0,0,0,0,0,2,2,1,0,0,4
46,797179,10,0,0,0,0,0,0,5,6,1,1,1,0,0,0,0,5
46,797177,3,0,1,0,1,0,0,1,2,2,0,0,1,0,0,0,1
46,780026,3,0,1,0,0,0,1,0,0,0,1,1,0,0,0,0,0
46,786170,1,0,0,0,0,0,0,0,0,0,0,0,0,0,0,0,0
47,798153,8,1,2,1,2,0,0,0,0,1,3,0,5,0,0,0,2
47,780193,28,3,7,0,1,3,6,0,0,1,0,2,1,0,1,1,9
47,792670,21,3,8,3,3,0,5,1,2,1,1,1,4,0,1,0,7
47,782157,25,1,4,1,4,0,0,5,6,1,3,4,3,0,5,0,7
47,789025,38,5,10,5,9,0,1,2,2,2,5,1,3,1,5,1,12
47,792666,14,2,3,2,3,0,0,0,0,2,1,0,5,0,1,0,4
47,792669,15,1,1,1,1,0,0,1,3,1,0,3,0,2,2,0,3
47,774985,23,6,15,5,13,1,2,2,2,0,0,0,1,0,0,0,15
47,775276,20,2,4,0,1,2,3,2,2,0,0,1,0,0,0,0,8
47,798152,8,0,3,0,1,0,2,0,0,0,3,1,2,1,0,0,0
48,780377,26,4,10,1,2,3,8,0,0,0,2,2,1,0,1,0,11
48,791852,11,5,5,5,5,0,0,2,4,1,2,0,3,0,1,1,12
48,786601,17,3,8,2,3,1,5,0,0,1,2,1,2,0,1,0,7
48,786600,17,5,9,5,9,0,0,2,2,0,2,3,3,1,3,0,12
48,786599,20,2,5,1,2,1,3,0,0,2,3,1,0,0,1,0,5
48,797462,28,4,8,4,8,0,0,3,4,5,4,2,2,1,0,2,11
48,791853,1,0,0,0,0,0,0,0,0,0,0,0,2,0,2,0,0
48,797461,16,1,3,1,2,0,1,2,2,0,4,1,3,0,1,0,4
48,797460,17,3,5,2,3,1,2,4,4,3,3,0,3,1,2,2,11
48,797459,23,1,3,0,2,1,1,0,0,0,2,7,3,0,1,0,3
48,786602,23,3,7,1,3,2,4,0,0,1,2,1,2,4,0,1,8
48,786604,1,0,0,0,0,0,0,0,0,0,0,0,0,0,0,0,0
49,796959,30,3,6,3,6,0,0,0,0,2,6,3,1,0,3,5,6
49,781272,33,8,16,8,15,0,1,3,4,2,1,1,3,4,3,0,19
49,791261,35,9,15,8,11,1,4,2,3,1,3,2,2,1,2,1,21
49,791258,31,1,4,0,2,1,2,1,3,1,2,0,2,2,2,0,4
49,781270,32,1,14,1,9,0,5,4,4,1,3,3,2,0,3,0,6
49,796960,17,1,2,1,2,0,0,2,2,4,0,1,2,0,0,0,4
49,791260,3,0,1,0,1,0,0,0,0,0,0,0,1,0,0,0,0
49,785502,3,0,1,0,1,0,0,0,2,3,1,0,0,0,0,0,0
49,796958,16,2,4,2,3,0,1,2,4,1,2,1,4,0,2,0,6
50,796774,30,1,7,1,5,0,2,2,2,3,4,3,2,2,2,0,4
50,792695,13,0,3,0,2,0,1,0,0,1,0,1,5,1,2,0,0
50,792699,19,2,4,2,4,0,0,2,2,1,0,1,3,1,2,0,6
50,792701,29,3,10,2,5,1,5,4,4,0,3,2,4,0,1,0,11
50,792700,25,3,13,2,9,1,4,3,4,0,1,0,3,0,1,0,10
50,792704,9,1,2,1,1,0,1,0,0,1,1,0,1,0,0,0,2
50,792702,13,0,1,0,0,0,1,1,2,0,2,0,3,0,2,0,1
50,796775,24,4,6,2,3,2,3,2,2,1,5,1,4,0,1,0,12
50,796776,19,5,5,5,5,0,0,1,2,1,0,0,2,0,2,0,11
50,792698,19,1,6,1,3,0,3,2,2,0,0,1,3,1,0,0,4
51,792197,18,3,6,2,3,1,3,1,1,0,0,1,3,1,2,0,8
51,781132,22,4,4,3,3,1,1,2,3,0,2,2,2,0,2,0,11
51,797517,19,4,5,4,5,0,0,2,4,3,4,1,1,0,1,0,10
51,791940,28,4,7,1,2,3,5,4,4,2,0,0,1,0,0,1,15
51,786534,31,5,9,4,7,1,2,0,2,0,6,8,0,0,0,0,11
51,797521,15,0,2,0,1,0,1,1,2,1,3,0,3,0,3,0,1
51,797519,20,1,2,1,1,0,1,2,4,0,4,2,0,0,1,0,4
51,791939,3,1,1,1,1,0,0,0,0,0,0,0,2,0,0,0,2
51,797522,3,0,0,0,0,0,0,0,0,0,0,0,0,0,0,0,0
51,786539,2,1,1,1,1,0,0,1,2,1,1,0,0,0,1,0,3
51,797520,12,2,4,1,2,1,2,0,0,0,2,0,0,0,0,1,5
51,797518,11,1,1,1,1,0,0,5,6,0,0,0,2,0,2,0,7
51,791938,16,2,6,1,2,1,4,2,5,0,1,1,4,0,1,1,7
52,785388,25,3,7,3,7,0,0,1,3,1,10,5,4,1,3,1,7
52,780370,29,4,6,2,3,2,3,0,1,1,4,4,4,1,3,0,10
52,790840,32,4,9,3,6,1,3,1,1,0,1,2,0,1,0,1,10
52,790841,27,2,4,1,1,1,3,2,2,0,0,2,0,0,0,0,7
52,780373,33,3,8,0,3,3,5,0,0,0,3,5,1,1,1,0,9
52,790839,11,1,2,0,0,1,2,0,0,0,2,0,3,1,2,0,3
52,796393,16,9,10,9,10,0,0,1,1,2,3,0,3,0,2,0,19
52,796395,17,5,7,4,5,1,2,1,3,0,1,0,2,0,2,0,12
52,796396,10,0,0,0,0,0,0,0,0,0,0,2,1,0,2,0,0
53,797198,19,7,7,4,4,3,3,2,2,2,1,0,4,1,2,0,19
53,791482,27,2,5,0,1,2,4,0,0,1,1,4,2,1,1,0,6
53,786318,36,7,19,3,5,4,14,3,4,1,5,4,2,3,4,1,21
53,784268,31,0,4,0,2,0,2,4,4,1,0,4,1,1,2,0,4
53,780223,29,1,4,0,2,1,2,2,3,0,2,0,2,0,0,0,5
53,791481,9,0,1,0,0,0,1,0,0,0,2,0,0,0,1,0,0
53,786319,13,2,3,2,3,0,0,0,3,2,0,0,2,0,1,0,4
53,780225,27,2,8,1,2,1,6,0,0,0,6,3,0,0,1,0,5
53,797199,6,0,1,0,1,0,0,0,0,0,0,0,1,0,0,0,0
53,797201,3,0,0,0,0,0,0,0,0,0,0,0,0,0,0,0,0
54,790856,22,4,5,4,5,0,0,4,6,3,5,0,0,0,1,3,12
54,780452,28,3,10,3,10,0,0,0,0,2,9,1,2,0,4,2,6
54,796409,27,4,9,3,6,1,3,2,4,2,2,1,3,1,1,0,11
54,796408,26,4,11,3,7,1,4,8,8,0,1,4,3,2,1,0,17
54,796407,28,2,8,2,6,0,2,0,0,1,1,1,1,1,1,1,4
54,796410,22,4,8,4,8,0,0,5,6,5,5,2,3,2,0,1,13
54,796413,11,0,3,0,2,0,1,0,0,0,2,2,0,0,0,0,0
54,780450,21,2,9,1,4,1,5,0,0,1,2,1,2,4,0,2,5
54,796412,3,1,1,0,0,1,1,0,0,0,0,0,0,0,0,0,3
54,796411,5,3,4,3,3,0,1,0,0,2,2,0,1,0,1,0,6
54,780454,2,1,2,1,2,0,0,0,0,0,0,0,1,0,0,0,2
54,781286,1,0,1,0,0,0,1,0,0,0,0,0,0,0,0,0,0
54,796414,1,0,0,0,0,0,0,0,0,0,1,0,0,0,0,0,0
54,775941,2,0,0,0,0,0,0,0,0,0,0,0,0,0,0,0,0
54,798137,1,0,0,0,0,0,0,0,0,0,0,0,0,0,0,0,0
55,775820,26,1,4,0,0,1,4,0,0,0,4,3,4,3,2,2,3
55,775538,34,3,4,3,4,0,0,0,2,4,8,1,2,0,1,0,6
55,785603,23,4,9,3,6,1,3,0,0,1,5,3,2,0,1,0,9
55,775534,27,6,14,3,8,3,6,0,2,0,2,3,0,2,2,1,15
55,776425,34,4,10,2,4,2,6,3,4,0,3,2,0,0,2,0,13
55,791107,8,3,4,2,3,1,1,0,0,0,0,0,5,0,0,0,7
55,791106,17,1,4,1,3,0,1,0,0,0,0,0,1,0,3,0,2
55,791110,18,1,8,1,8,0,0,0,0,1,1,0,3,0,2,0,2
55,796763,3,0,1,0,0,0,1,0,0,0,0,0,2,0,0,0,0
55,786494,7,1,1,1,1,0,0,0,0,0,1,1,1,0,0,0,2
55,796762,2,0,1,0,0,0,1,1,2,0,1,0,0,0,0,0,1
55,780801,1,0,0,0,0,0,0,0,0,0,0,0,0,0,0,0,0
56,797222,17,4,5,4,5,0,0,1,2,2,2,1,3,0,1,2,9
56,781526,21,4,6,4,6,0,0,0,0,2,1,1,3,0,1,2,8
56,797217,27,5,9,3,6,2,3,0,0,0,3,4,1,0,4,0,12
56,797218,33,7,14,7,10,0,4,1,1,2,5,1,3,1,2,0,15
56,797219,31,5,9,5,7,0,2,2,5,1,3,4,1,3,2,0,12
56,775697,17,2,4,0,1,2,3,4,4,0,1,3,1,1,2,0,10
56,797223,19,0,0,0,0,0,0,0,0,0,5,0,3,1,0,2,0
56,791846,9,1,4,1,4,0,0,0,0,0,2,1,0,1,2,0,2
56,797221,17,4,5,3,4,1,1,0,0,1,4,3,2,1,0,0,9
56,791453,6,1,3,0,0,1,3,1,2,1,0,0,1,0,1,0,4
56,791455,1,0,0,0,0,0,0,0,0,0,0,0,0,0,0,0,0
56,786291,1,0,0,0,0,0,0,0,0,0,0,0,0,0,0,0,0
56,781529,1,0,0,0,0,0,0,0,0,0,0,0,0,0,0,0,0
57,780509,26,3,12,3,9,0,3,4,4,2,0,0,2,1,3,1,10
57,791658,13,1,4,1,4,0,0,0,0,1,1,0,3,0,1,0,2
57,797290,27,1,5,0,1,1,4,1,2,0,2,1,3,1,2,0,4
57,791660,34,1,1,1,1,0,0,1,2,2,1,4,3,1,5,0,3
57,797291,26,2,7,2,3,0,4,0,2,0,2,2,1,1,2,0,4
57,791661,28,4,10,2,3,2,7,1,2,1,2,0,2,0,0,0,11
57,797292,25,5,6,5,6,0,0,1,2,2,3,0,3,1,2,0,11
57,797295,11,0,3,0,1,0,2,0,1,0,1,0,1,0,1,0,0
57,785658,3,0,2,0,1,0,1,0,1,1,1,0,0,0,2,0,0
57,797294,2,0,0,0,0,0,0,0,0,0,0,0,0,0,1,0,0
57,791663,5,0,0,0,0,0,0,0,0,0,0,0,0,0,0,0,0
58,785374,15,1,1,1,1,0,0,0,0,0,1,2,1,0,0,0,2
58,785372,25,2,3,2,2,0,1,2,2,0,4,7,2,2,2,1,6
58,786384,23,6,9,6,7,0,2,3,4,2,7,2,2,0,5,0,15
58,785371,25,6,10,0,0,6,10,2,2,0,2,2,4,0,1,0,20
58,774905,21,3,8,1,1,2,7,2,2,2,0,1,0,0,4,0,10
58,790827,17,3,6,3,6,0,0,0,0,0,4,5,1,0,0,0,6
58,785375,15,2,3,2,3,0,0,2,2,1,1,3,0,0,0,2,6
58,785373,17,4,7,0,1,4,6,0,0,0,0,1,1,0,1,0,12
58,790825,23,1,6,1,4,0,2,0,0,0,2,3,1,0,1,0,2
58,796387,6,0,0,0,0,0,0,0,4,0,2,0,0,0,1,2,0
58,790828,3,1,1,1,1,0,0,0,0,0,2,0,1,0,0,0,2
58,790826,2,0,0,0,0,0,0,0,0,0,0,0,0,0,1,0,0
58,796385,3,0,0,0,0,0,0,0,0,0,1,0,1,0,1,0,0
58,780007,3,1,1,1,1,0,0,0,0,0,0,0,0,0,0,0,2
58,796386,2,0,0,0,0,0,0,0,0,0,0,1,1,0,0,0,0
59,776209,36,6,13,6,12,0,1,2,4,0,3,1,3,0,1,3,14
59,796938,30,2,8,1,3,1,5,0,0,2,1,4,4,2,2,0,5
59,791235,31,4,11,3,8,1,3,2,2,1,3,0,3,1,2,0,11
59,791237,31,7,11,6,9,1,2,1,2,2,4,1,4,1,1,0,16
59,791351,30,3,12,2,4,1,8,2,2,0,2,3,3,2,2,0,9
59,791236,22,0,4,0,2,0,2,0,2,1,4,2,2,1,1,0,0
59,791240,20,4,5,4,5,0,0,4,4,2,0,3,1,1,0,0,12
60,792041,26,3,7,2,3,1,4,2,2,1,2,0,3,0,1,0,9
60,786054,24,4,8,4,7,0,1,4,4,5,7,3,1,0,2,0,12
60,791964,28,3,9,1,3,2,6,2,4,0,5,2,4,2,4,0,10
60,781339,31,6,11,1,1,5,10,2,2,1,3,1,0,1,2,1,19
60,781337,29,7,10,5,5,2,5,3,3,0,5,3,0,2,1,0,19
60,797713,13,1,2,1,2,0,0,2,4,2,2,2,0,3,1,0,4
60,797712,23,2,5,2,4,0,1,6,8,3,4,2,1,1,0,0,10
60,791966,10,1,1,1,1,0,0,0,2,2,2,1,0,0,2,1,2
60,797714,3,0,1,0,0,0,1,0,0,0,0,0,0,0,0,0,0
60,791963,13,1,2,0,0,1,2,0,0,0,1,1,3,0,0,0,3
62,789048,36,8,13,8,13,0,0,0,1,7,8,1,1,2,2,0,16
62,791785,20,5,7,2,3,3,4,2,2,1,0,1,4,1,0,1,15
62,789046,19,1,9,0,4,1,5,0,0,3,0,1,2,0,0,0,3
62,789041,32,4,15,2,7,2,8,8,8,2,3,5,1,2,2,0,18
62,791786,31,5,9,4,6,1,3,4,6,1,6,5,0,0,0,0,15
62,797629,18,4,7,4,7,0,0,0,0,2,5,2,5,1,2,0,8
62,789044,15,4,7,4,4,0,3,2,3,2,0,1,4,1,0,1,10
62,797631,13,1,4,0,3,1,1,2,2,0,4,1,0,2,0,0,5
62,797630,12,3,7,1,3,2,4,0,0,0,0,0,0,0,0,0,8
62,797632,4,0,0,0,0,0,0,0,0,0,1,0,0,0,0,1,0
64,796347,30,4,6,3,4,1,2,3,4,3,6,1,2,0,1,0,12
64,790788,37,8,14,3,4,5,10,2,2,1,4,9,2,0,3,2,23
64,785243,32,3,6,3,5,0,1,1,1,2,5,1,1,0,2,3,7
64,781028,39,9,20,7,12,2,8,0,0,0,6,4,1,1,4,0,20
64,781026,26,5,8,3,4,2,4,3,4,1,2,5,3,0,0,0,15
64,785242,11,1,2,1,2,0,0,0,0,1,0,1,3,0,0,0,2
64,781027,7,0,0,0,0,0,0,0,0,0,1,0,3,0,1,0,0
64,796348,16,1,3,0,1,1,2,0,1,1,1,0,0,1,1,0,3
64,796349,2,0,0,0,0,0,0,0,0,0,0,0,0,0,0,0,0
65,797877,18,1,5,1,3,0,2,1,2,0,3,0,4,0,1,0,3
65,781599,25,2,6,2,6,0,0,2,2,3,2,0,3,0,0,0,6
65,797872,31,6,10,5,8,1,2,1,2,0,2,1,1,0,1,0,14
65,791338,26,1,3,1,3,0,0,0,0,0,0,2,3,0,3,0,2
65,791339,32,10,18,4,10,6,8,3,4,1,3,2,2,2,1,1,29
65,797873,22,1,5,1,5,0,0,3,3,2,4,0,0,0,2,0,5
65,791337,15,1,3,1,3,0,0,0,0,0,2,0,3,0,2,1,2
65,797874,10,0,1,0,0,0,1,0,0,0,1,2,1,0,0,0,0
65,781595,21,5,7,3,3,2,4,0,0,0,2,2,0,0,0,0,12
66,780991,34,6,14,4,9,2,5,4,5,0,5,1,4,3,4,0,18
66,780521,32,4,7,2,2,2,5,4,4,0,2,1,1,0,4,0,14
66,791370,25,0,4,0,0,0,4,2,2,2,4,1,1,1,2,0,2
66,786199,7,0,1,0,0,0,1,0,0,0,0,2,0,0,0,0,0
66,775163,6,0,0,0,0,0,0,0,0,0,1,1,4,0,0,0,0
66,791371,34,4,4,3,3,1,1,4,5,0,5,3,3,2,6,0,13
66,797271,28,4,8,2,3,2,5,1,2,0,2,4,1,0,4,0,11
66,781611,25,3,3,3,3,0,0,1,2,1,5,0,4,0,4,0,7
66,743593,21,0,0,0,0,0,0,2,2,0,1,0,3,1,3,0,2
66,780145,8,0,2,0,2,0,0,0,0,1,1,0,5,0,3,0,0
66,797269,5,0,1,0,1,0,0,0,2,1,1,0,1,0,0,1,0
67,792047,35,8,15,7,11,1,4,3,5,4,1,0,2,0,4,1,20
67,786825,33,3,7,3,7,0,0,4,5,5,4,1,3,1,1,0,10
67,785347,29,4,12,4,10,0,2,2,2,0,2,2,1,2,5,0,10
67,775601,39,2,15,2,9,0,6,5,8,3,3,1,3,4,0,0,9
67,792050,16,2,4,2,2,0,2,0,0,0,1,0,3,1,2,0,4
67,792052,30,3,9,3,5,0,4,0,0,2,1,1,1,1,2,1,6
67,775476,14,1,6,1,3,0,3,0,1,3,1,1,2,0,1,0,2
67,792045,4,0,0,0,0,0,0,2,2,0,0,0,2,0,1,0,2
67,792051,10,0,5,0,1,0,4,0,0,0,0,0,2,0,0,0,0
67,780862,10,0,3,0,0,0,3,0,0,0,3,0,2,0,0,0,0
67,797647,4,0,0,0,0,0,0,0,0,1,0,0,1,0,1,0,0
67,797648,1,0,0,0,0,0,0,0,0,0,0,0,2,0,1,0,0
68,786204,14,2,7,2,4,0,3,0,1,1,5,1,3,0,1,1,4
68,785608,19,3,9,3,8,0,1,6,6,3,6,0,2,0,2,0,12
68,797708,30,5,8,5,7,0,1,6,8,2,5,2,3,5,3,0,16
68,786198,29,0,5,0,3,0,2,6,6,0,3,3,1,4,2,0,6
68,775779,22,2,7,1,4,1,3,0,0,1,0,5,0,0,3,0,5
68,776327,19,2,4,2,3,0,1,2,2,2,1,1,2,1,1,0,6
68,797707,24,2,4,1,2,1,2,1,2,0,1,1,3,1,3,1,6
68,797709,26,8,12,3,6,5,6,0,0,0,2,0,1,0,1,1,21
68,786180,12,0,3,0,3,0,0,0,0,3,2,0,1,0,0,1,0
68,781631,5,0,0,0,0,0,0,0,0,0,0,0,0,0,1,0,0
69,792128,29,5,11,4,9,1,2,1,2,0,5,1,4,1,0,1,12
69,786838,32,7,9,7,9,0,0,2,4,3,4,1,2,3,2,3,16
69,792127,19,5,7,2,3,3,4,0,0,0,0,0,3,0,1,0,13
69,792132,26,4,11,3,7,1,4,2,3,0,1,5,3,2,3,1,11
69,786267,30,1,4,0,1,1,3,1,2,0,3,7,3,1,3,0,4
69,797736,8,2,2,0,0,2,2,0,0,0,2,1,2,0,1,0,6
69,792126,13,0,6,0,2,0,4,0,0,0,0,2,2,0,2,0,0
69,791668,14,0,1,0,1,0,0,0,1,1,0,2,1,0,1,0,0
69,792131,19,4,6,4,5,0,1,0,0,1,2,0,2,0,0,0,8
69,797739,10,2,2,1,1,1,1,0,0,0,1,2,0,2,2,0,5
70,796455,22,0,1,0,1,0,0,1,4,1,3,1,1,1,3,0,1
70,787175,35,3,4,1,1,2,3,0,0,0,8,1,2,1,1,0,8
70,782126,34,5,6,3,4,2,2,4,4,1,3,3,0,1,2,1,16
70,790909,38,4,14,3,8,1,6,3,5,1,8,0,2,3,5,1,12
70,781393,36,6,9,3,5,3,4,5,6,0,3,2,2,1,3,0,20
70,790907,5,0,0,0,0,0,0,0,0,0,0,0,0,0,0,0,0
70,796453,5,1,2,1,2,0,0,1,1,0,0,0,0,1,1,0,3
70,790910,1,0,0,0,0,0,0,0,0,0,0,0,0,0,0,0,0
70,775351,24,4,5,4,5,0,0,0,0,0,1,0,4,0,1,0,8
71,775651,16,1,2,1,2,0,0,0,0,0,1,0,1,0,0,0,2
71,791070,31,6,12,3,6,3,6,0,1,4,3,3,3,4,3,0,15
71,791627,37,7,13,0,3,7,10,4,4,1,1,5,2,1,3,1,25
71,785665,23,1,10,0,0,1,10,1,2,0,0,2,2,2,1,0,4
71,776178,27,3,5,2,4,1,1,0,1,0,5,0,2,1,2,0,7
71,796505,4,0,1,0,1,0,0,0,0,0,0,0,0,0,1,0,0
71,785660,20,1,2,1,2,0,0,2,2,2,1,0,3,0,1,2,4
71,776253,22,2,9,2,5,0,4,0,0,2,4,0,4,1,1,0,4
71,796504,9,2,5,1,1,1,4,0,0,2,1,1,1,0,0,0,5
71,796502,4,0,1,0,1,0,0,0,0,0,0,1,0,1,0,0,0
71,796501,7,0,1,0,0,0,1,0,0,0,1,1,0,0,0,0,0
72,785294,25,4,5,4,5,0,0,0,0,1,3,2,4,0,6,0,8
72,791081,14,2,2,2,2,0,0,1,3,0,4,0,2,0,0,0,5
72,785675,35,6,12,5,7,1,5,0,0,1,3,2,2,4,2,0,13
72,786446,19,4,7,3,4,1,3,0,0,0,3,1,3,0,5,0,9
72,791085,19,3,7,2,4,1,3,0,0,0,3,1,2,0,3,0,7
72,791083,15,5,6,4,4,1,2,0,0,1,3,0,1,0,1,2,11
72,796514,21,1,2,1,1,0,1,0,0,0,0,4,0,3,4,0,2
72,791080,19,2,3,1,2,1,1,0,0,0,4,3,2,0,1,0,5
72,796511,15,0,0,0,0,0,0,0,0,1,0,3,1,1,0,0,0
72,791077,7,0,2,0,0,0,2,0,0,0,0,0,0,1,0,0,0
72,796512,11,2,5,1,1,1,4,0,0,0,0,0,0,0,0,0,5
73,781656,31,4,8,4,8,0,0,1,2,1,3,0,1,0,1,1,9
73,796962,28,3,10,2,3,1,7,0,0,0,0,0,3,0,4,0,7
73,780129,34,5,10,1,2,4,8,1,2,0,0,3,2,3,3,0,15
73,786798,35,3,10,3,10,0,0,2,5,2,4,2,3,3,3,0,8
73,781658,23,2,3,2,3,0,0,0,0,1,1,0,2,2,3,0,4
73,791264,19,0,0,0,0,0,0,0,0,0,0,3,2,1,2,0,0
73,798206,22,6,8,5,5,1,3,0,0,2,6,0,1,0,2,3,13
73,796964,3,0,1,0,0,0,1,0,0,0,0,0,0,0,1,0,0
73,796961,5,0,0,0,0,0,0,0,0,0,0,0,0,0,1,0,0
74,790863,18,2,6,1,4,1,2,0,1,3,5,0,3,0,1,0,5
74,780021,28,4,5,4,5,0,0,0,2,4,8,1,1,2,3,0,8
74,785412,21,7,12,6,7,1,5,2,3,0,3,4,0,1,5,0,17
74,780099,29,7,10,3,4,4,6,0,0,0,3,2,0,0,2,0,18
74,776214,32,5,9,4,7,1,2,5,6,1,4,6,2,4,3,1,16
74,775686,11,1,2,0,1,1,1,0,0,0,2,0,3,0,0,0,3
74,785413,20,3,7,3,5,0,2,5,5,2,1,2,2,2,2,0,11
74,785411,15,3,6,1,1,2,5,1,1,0,0,1,2,1,0,0,9
74,785417,7,1,1,1,1,0,0,0,0,1,0,0,0,0,0,0,2
74,776221,13,0,3,0,1,0,2,0,0,0,1,2,2,1,1,0,0
74,796420,6,1,3,1,3,0,0,0,0,1,2,0,1,0,0,0,2
75,786547,20,1,5,1,2,0,3,1,2,3,2,1,4,0,1,1,3
75,786544,29,5,13,4,7,1,6,6,6,2,7,0,3,1,3,0,17
75,797507,29,4,7,3,6,1,1,0,0,1,3,1,1,1,4,0,9
75,792012,35,6,16,4,7,2,9,4,4,0,2,5,1,2,1,1,18
75,775084,28,2,8,1,4,1,4,0,0,2,2,1,2,1,1,0,5
75,786860,20,2,8,1,1,1,7,0,0,1,1,0,3,0,1,0,5
75,797509,11,1,1,1,1,0,0,0,0,1,0,1,2,1,2,0,2
75,797510,16,2,7,1,3,1,4,0,0,1,0,1,1,1,1,0,5
75,786546,10,0,1,0,0,0,1,0,0,0,1,0,2,0,1,1,0
75,792013,2,0,0,0,0,0,0,0,0,0,0,0,1,0,0,0,0
76,780323,18,4,6,4,6,0,0,2,2,5,7,1,1,1,1,1,10
76,792233,19,5,10,4,7,1,3,5,6,0,5,0,1,2,0,0,16
76,797894,18,7,10,7,10,0,0,0,1,1,5,3,1,3,1,0,14
76,785954,21,4,7,3,4,1,3,1,2,0,5,6,1,1,0,0,10
76,785811,20,6,9,4,6,2,3,6,6,1,0,3,1,3,0,0,20
76,786016,22,2,5,2,4,0,1,0,0,0,1,4,1,0,2,0,4
76,797892,19,1,7,1,5,0,2,0,0,0,1,2,1,1,2,0,2
76,792234,12,3,4,3,4,0,0,1,3,3,1,0,2,0,0,1,7
76,785484,21,3,6,0,2,3,4,0,0,1,6,2,2,0,2,0,9
76,792230,11,0,0,0,0,0,0,1,2,0,4,0,2,1,1,0,1
76,781356,8,1,2,1,1,0,1,1,4,1,1,1,0,1,1,0,3
76,797891,11,2,4,1,1,1,3,0,0,1,1,0,1,0,0,0,5
77,791923,18,4,8,3,6,1,2,2,2,0,4,0,2,1,1,0,11
77,786529,13,2,2,2,2,0,0,0,0,0,3,0,2,0,0,1,4
77,791925,18,3,8,2,5,1,3,1,2,1,1,0,1,0,4,0,8
77,791926,22,2,9,1,2,1,7,2,3,0,1,1,1,1,2,0,7
77,781112,18,2,3,2,2,0,1,1,3,0,2,4,2,0,3,0,5
77,791927,18,1,5,1,4,0,1,0,0,0,4,0,3,0,1,0,2
77,786858,13,1,2,1,2,0,0,0,1,0,0,0,1,0,1,0,2
77,786527,19,2,3,0,0,2,3,0,0,1,1,0,2,0,2,0,6
77,781122,13,1,5,1,5,0,0,2,4,0,0,2,1,0,1,0,4
77,797542,14,0,8,0,3,0,5,0,0,0,0,1,0,0,2,0,0
77,797541,15,3,7,3,7,0,0,2,3,5,5,0,2,0,0,0,8
77,791922,7,0,0,0,0,0,0,0,0,1,1,0,1,0,1,0,0
77,778952,12,0,1,0,0,0,1,1,2,0,1,0,3,0,1,0,1
78,791975,14,3,5,3,5,0,0,1,2,1,2,0,4,1,0,0,7
78,785972,15,3,7,2,4,1,3,0,0,1,1,0,1,0,0,0,7
78,785967,30,3,8,3,8,0,0,1,2,3,11,2,2,2,1,4,7
78,791977,32,6,16,4,7,2,9,2,2,2,3,2,0,0,1,0,16
78,791978,36,9,19,8,13,1,6,4,4,0,1,3,1,2,0,1,23
78,780160,20,1,3,1,3,0,0,1,2,5,3,1,4,3,0,0,3
78,791980,10,0,2,0,0,0,2,0,0,1,1,0,2,0,1,1,0
78,797799,5,1,3,1,2,0,1,0,0,1,0,0,0,0,0,0,2
78,791976,25,4,9,0,3,4,6,2,2,1,0,2,0,1,0,0,14
78,785973,11,0,4,0,0,0,4,0,0,0,0,1,2,0,0,0,0
78,797800,2,0,1,0,0,0,1,0,0,0,1,0,0,0,0,0,0
79,792035,31,6,13,6,13,0,0,5,7,2,1,2,2,0,2,1,17
79,780833,19,5,9,5,9,0,0,0,0,3,4,0,4,0,1,1,10
79,792034,36,5,9,2,4,3,5,2,2,0,4,3,2,0,3,0,15
79,792033,37,6,15,3,7,3,8,1,2,3,5,6,1,2,4,0,16
79,780830,35,2,8,2,7,0,1,0,0,0,9,4,2,0,2,0,4
79,791688,13,1,1,1,1,0,0,0,0,1,1,1,3,0,0,0,2
79,785381,23,1,6,0,1,1,5,2,2,1,2,0,2,0,1,0,5
79,785980,4,0,0,0,0,0,0,0,0,0,0,0,1,0,0,0,0
79,797645,2,1,1,1,1,0,0,0,0,0,0,0,0,0,0,0,2
80,786080,20,5,10,1,2,4,8,0,2,0,1,1,2,2,3,3,14
80,786216,22,2,7,2,7,0,0,2,4,2,5,2,2,1,4,1,6
80,780150,26,1,7,0,0,1,7,0,0,0,7,2,1,1,3,1,3
80,791348,21,0,2,0,0,0,2,2,2,2,6,5,0,1,2,0,2
80,786218,23,6,8,1,3,5,5,2,3,3,2,3,2,1,5,1,19
80,785256,12,6,8,6,8,0,0,4,4,0,0,1,0,1,0,0,16
80,791350,23,4,7,1,1,3,6,2,4,1,1,5,4,3,0,0,13
80,781645,13,1,1,1,1,0,0,0,1,0,3,4,0,0,0,0,2
80,797258,9,2,2,2,2,0,0,0,0,0,2,0,0,0,2,1,4
80,797257,7,4,4,4,4,0,0,2,2,0,2,0,1,1,0,2,10
80,780156,13,2,3,1,1,1,2,1,2,1,1,0,0,1,1,0,6
80,797256,5,2,3,2,2,0,1,0,0,0,2,1,0,0,1,0,4
80,786221,3,0,0,0,0,0,0,0,0,0,0,0,0,0,0,0,0
80,797259,3,0,0,0,0,0,0,0,0,0,0,0,3,0,0,0,0
82,780095,23,1,3,1,3,0,0,0,2,4,0,0,3,1,1,3,2
82,776321,26,6,11,5,9,1,2,1,2,0,7,0,1,0,0,1,14
82,786081,29,8,17,8,13,0,4,0,2,1,9,0,0,1,2,0,16
82,785431,26,4,11,3,6,1,5,3,4,0,5,9,1,3,0,0,12
82,780232,28,8,14,5,7,3,7,4,6,0,1,4,1,2,1,0,23
82,797917,1,1,1,1,1,0,0,0,0,1,0,0,0,0,0,0,2
82,786020,17,3,3,3,3,0,0,0,0,0,3,1,5,1,3,0,6
82,785356,13,4,5,2,2,2,3,2,2,0,1,0,3,1,0,0,12
82,781328,2,0,0,0,0,0,0,0,0,0,0,1,0,0,0,0,0
82,789019,18,4,4,1,1,3,3,0,1,0,0,1,0,1,1,0,11
82,797918,17,1,7,1,4,0,3,0,0,1,1,4,1,0,2,0,2
84,781407,34,8,11,7,10,1,1,2,3,2,6,3,4,1,2,0,19
84,786659,24,4,7,4,7,0,0,0,0,1,1,0,1,3,4,0,8
84,780580,25,3,13,2,7,1,6,5,7,0,4,6,5,1,1,0,12
84,776150,32,7,9,3,5,4,4,1,2,0,1,3,3,0,3,0,19
84,791584,16,2,4,2,4,0,0,0,4,3,4,0,4,2,3,0,4
84,791583,12,0,0,0,0,0,0,3,5,1,2,1,5,0,1,0,3
84,797448,18,2,3,0,0,2,3,6,8,0,7,0,4,0,0,1,12
84,797445,15,0,1,0,1,0,0,2,2,0,0,0,3,0,1,0,2
84,785623,24,3,8,2,4,1,4,2,4,0,1,1,0,1,1,1,9
85,796344,29,2,7,0,3,2,4,10,14,3,4,0,3,0,1,0,16
85,790781,11,2,2,2,2,0,0,1,2,0,1,0,5,0,1,1,5
85,790785,23,2,9,2,8,0,1,4,6,2,2,3,3,0,4,0,8
85,796340,27,3,10,3,6,0,4,5,6,1,3,0,3,0,0,0,11
85,780037,37,9,15,9,13,0,2,8,10,1,5,5,2,1,4,0,26
85,796343,25,1,2,1,2,0,0,2,3,4,2,1,2,1,0,3,4
85,785239,16,4,7,1,2,3,5,0,0,2,3,0,5,1,0,0,11
85,781232,20,3,6,2,3,1,3,4,5,0,0,0,1,2,1,0,11
85,796339,8,0,2,0,1,0,1,0,0,0,2,0,1,2,1,0,0
85,796345,4,1,1,1,1,0,0,0,0,0,0,0,1,0,0,0,2
86,785685,30,7,13,5,8,2,5,8,14,2,5,4,4,2,4,1,24
86,785977,25,5,12,2,4,3,8,2,2,3,4,0,1,3,1,0,15
86,791265,26,2,6,0,2,2,4,4,4,2,0,4,4,1,3,0,10
86,791269,25,3,9,1,1,2,8,2,2,2,5,4,1,1,0,1,10
86,791266,21,3,6,3,5,0,1,2,6,2,4,0,3,2,2,3,8
86,781294,20,1,6,1,3,0,3,1,1,1,1,1,3,0,1,0,3
86,796523,10,1,4,0,0,1,4,3,4,3,2,0,2,0,3,0,6
86,791271,12,2,3,2,3,0,0,0,2,2,1,0,4,0,2,0,4
86,796522,14,1,5,0,0,1,5,0,0,0,1,0,0,0,2,0,3
86,781313,12,1,5,1,2,0,3,0,0,0,0,1,0,1,0,0,2
86,796524,5,0,1,0,1,0,0,0,0,1,1,0,1,0,0,0,0
88,776110,15,2,6,2,3,0,3,0,0,3,0,1,3,0,1,1,4
88,780059,25,3,11,2,9,1,2,5,6,5,7,0,3,1,0,2,12
88,790944,26,6,13,5,9,1,4,5,5,3,9,2,1,2,2,0,18
88,780061,26,6,14,4,6,2,8,0,1,2,4,1,1,2,1,0,14
88,786754,26,7,12,5,7,2,5,2,2,0,1,3,1,1,1,0,18
88,790943,21,3,8,2,6,1,2,1,2,4,3,1,1,0,1,0,8
88,780058,13,0,4,0,0,0,4,0,0,0,1,0,0,0,2,0,0
88,796496,18,0,0,0,0,0,0,0,0,0,2,2,2,1,0,1,0
88,796497,6,0,1,0,1,0,0,0,2,1,0,0,2,0,1,0,0
88,796494,17,2,4,2,2,0,2,1,2,0,3,1,3,1,0,0,5
88,790941,3,0,2,0,2,0,0,0,0,0,0,0,0,0,0,0,0
88,796495,4,1,2,1,1,0,1,0,0,1,1,0,0,0,1,0,2
89,791352,20,2,12,2,8,0,4,3,3,1,5,0,1,1,1,0,7
89,785837,12,3,8,2,6,1,2,1,1,2,2,0,2,0,3,1,8
89,780455,11,1,1,1,1,0,0,0,2,2,2,0,2,0,3,0,2
89,797247,27,0,5,0,2,0,3,0,0,1,1,2,4,1,4,0,0
89,776297,20,0,7,0,5,0,2,1,2,2,1,1,5,0,2,0,1
89,791355,19,3,9,1,2,2,7,0,0,3,5,0,1,0,1,0,8
89,791354,12,2,4,2,4,0,0,2,2,1,1,2,0,0,1,1,6
89,797251,23,1,3,0,1,1,2,0,0,2,5,1,2,0,1,0,3
89,797248,23,5,12,1,4,4,8,1,2,0,1,0,2,1,1,0,15
89,786227,9,1,3,1,3,0,0,0,1,1,1,0,0,2,1,0,2
89,797250,8,0,0,0,0,0,0,0,2,2,2,1,1,0,1,0,0
89,797249,8,1,2,0,0,1,2,0,0,0,1,2,0,0,1,0,3
89,797252,6,0,2,0,0,0,2,0,0,0,1,1,0,0,0,0,0
89,797255,1,0,1,0,1,0,0,2,2,1,0,0,0,0,0,0,2
89,797253,1,0,0,0,0,0,0,0,0,0,0,0,0,0,0,0,0
90,780874,21,3,8,2,4,1,4,4,5,2,7,0,2,2,1,1,11
90,785638,18,4,7,3,4,1,3,0,0,2,1,1,3,0,0,1,9
90,781326,28,2,3,2,3,0,0,2,2,1,9,1,2,1,1,3,6
90,797870,21,6,12,5,9,1,3,0,0,0,1,5,0,3,1,0,13
90,792209,25,2,6,0,1,2,5,0,0,0,1,2,1,0,0,0,6
90,792210,20,4,8,4,5,0,3,0,2,1,4,2,0,1,2,1,8
90,797869,9,0,1,0,1,0,0,0,2,1,1,1,3,1,1,1,0
90,792213,19,1,4,1,2,0,2,0,2,0,2,1,0,0,1,0,2
90,792214,18,3,6,3,4,0,2,0,0,4,2,0,0,0,2,0,6
90,792215,13,3,5,1,2,2,3,0,0,0,0,2,1,0,1,0,8
90,797868,7,0,1,0,0,0,1,0,0,0,0,0,2,0,0,0,0
90,786688,1,0,0,0,0,0,0,0,0,0,0,0,0,0,0,0,0
91,775739,18,1,1,1,1,0,0,0,0,0,1,0,1,0,0,0,2
91,791441,21,2,7,2,6,0,1,0,0,0,4,3,0,1,3,0,4
91,781378,34,5,13,4,12,1,1,2,2,2,8,1,0,0,2,1,13
91,774959,28,3,7,3,6,0,1,0,0,0,1,2,0,2,1,0,6
91,775267,31,4,11,2,4,2,7,0,0,1,5,1,1,0,2,0,10
91,797019,18,0,6,0,5,0,1,0,0,1,2,1,4,0,2,0,0
91,797013,11,0,3,0,1,0,2,0,0,0,0,1,0,1,1,0,0
91,791440,22,2,5,2,5,0,0,4,5,3,0,0,3,0,0,1,8
91,781629,6,1,2,1,2,0,0,0,0,0,1,2,0,0,0,0,2
91,797015,9,0,1,0,1,0,0,0,0,0,1,0,0,0,1,0,0
91,789009,2,0,0,0,0,0,0,0,0,0,0,0,0,0,0,0,0
92,786358,19,0,3,0,0,0,3,0,0,0,1,3,0,0,1,0,0
92,775418,23,6,9,6,9,0,0,7,9,3,2,0,3,0,2,1,19
92,786357,35,5,8,3,5,2,3,4,6,2,3,1,1,2,3,0,16
92,780306,35,4,11,4,9,0,2,3,7,1,7,7,3,0,3,0,11
92,780312,33,3,6,2,4,1,2,1,1,0,0,0,1,0,0,0,8
92,775565,7,2,3,1,2,1,1,2,2,0,0,0,2,0,1,0,7
92,791537,17,5,9,5,8,0,1,2,4,4,1,0,5,1,1,0,12
92,797116,31,4,7,2,3,2,4,2,2,0,3,3,4,2,1,0,12
93,775738,24,3,5,1,2,2,3,1,1,3,4,2,3,0,0,4,9
93,786091,25,6,8,4,5,2,3,0,0,2,5,1,4,1,2,1,14
93,786728,31,6,15,6,14,0,1,7,11,2,2,10,1,0,4,0,19
93,785904,25,5,12,3,6,2,6,5,5,0,3,0,4,2,3,0,17
93,780892,31,2,6,0,1,2,5,0,0,0,0,1,1,1,3,0,6
93,786350,11,0,0,0,0,0,0,0,0,1,1,0,3,0,1,0,0
93,786788,5,1,1,0,0,1,1,0,0,0,1,0,2,0,0,0,3
93,786096,27,5,9,3,5,2,4,1,1,1,5,0,3,1,2,0,13
93,781030,19,1,4,1,2,0,2,0,0,0,0,2,3,0,0,0,2
93,792087,2,0,0,0,0,0,0,0,0,0,0,0,1,0,0,0,0
94,785409,13,1,3,1,3,0,0,2,2,2,1,0,4,0,1,2,4
94,785407,21,4,7,4,6,0,1,2,2,1,1,0,2,1,2,0,10
94,780539,24,4,6,1,2,3,4,2,2,0,1,6,2,4,1,0,13
94,780560,18,2,5,1,2,1,3,0,0,0,0,0,1,2,1,0,5
94,776484,30,11,16,7,11,4,5,3,4,4,6,3,1,2,2,0,29
94,785408,21,3,8,1,6,2,2,0,0,0,2,2,4,1,2,0,8
94,796416,18,1,4,1,1,0,3,2,2,0,0,4,0,4,1,1,4
94,796415,15,4,10,3,7,1,3,0,4,1,3,0,2,4,0,0,9
94,790861,15,3,3,3,3,0,0,1,2,1,1,2,1,1,1,0,7
94,796418,10,1,2,1,2,0,0,0,0,0,1,0,1,0,0,0,2
94,796417,9,1,3,1,2,0,1,0,0,2,3,0,2,0,1,1,2
94,790859,3,0,0,0,0,0,0,0,0,0,0,0,1,0,0,0,0
94,790860,3,0,1,0,0,0,1,2,2,0,0,0,0,0,0,0,2
95,791113,20,0,1,0,1,0,0,0,0,0,6,2,5,0,6,0,0
95,785614,9,0,0,0,0,0,0,0,0,0,0,0,1,0,0,1,0
95,796767,22,4,11,4,9,0,2,4,8,2,3,1,3,0,3,1,12
95,791111,23,4,4,2,2,2,2,2,2,0,0,1,2,1,0,0,12
95,785613,10,1,1,0,0,1,1,4,5,0,0,1,0,0,4,0,7
95,780813,30,5,10,5,10,0,0,2,4,1,5,0,4,3,3,0,12
95,780809,24,3,4,1,1,2,3,2,2,1,2,2,2,1,4,0,10
95,796765,26,1,4,1,3,0,1,0,0,0,3,1,1,0,9,0,2
95,785618,18,1,5,1,3,0,2,0,0,1,3,0,1,1,1,0,2
95,796766,16,2,4,2,4,0,0,0,1,0,2,0,1,0,0,0,4
95,791112,2,0,0,0,0,0,0,0,0,0,1,0,0,0,1,0,0
96,785999,36,3,8,3,8,0,0,6,12,4,6,1,3,0,2,2,12
96,796398,34,3,4,1,2,2,2,0,4,3,2,0,4,3,2,0,8
96,775654,16,0,4,0,4,0,0,0,0,3,4,1,5,0,3,0,0
96,785389,38,5,18,4,15,1,3,1,3,3,3,2,2,2,6,0,12
96,796399,29,1,6,1,3,0,3,0,0,0,4,1,1,1,1,0,2
96,775171,19,2,4,1,2,1,2,0,0,1,1,1,0,0,1,0,5
96,791640,2,0,0,0,0,0,0,0,0,0,0,0,1,0,1,0,0
96,785255,24,1,6,1,3,0,3,1,8,2,5,0,3,1,1,0,3
96,796400,2,0,0,0,0,0,0,0,0,0,0,0,1,0,1,0,0
97,780879,8,1,5,1,2,0,3,2,2,0,1,0,5,1,2,0,4
97,790769,16,1,5,1,4,0,1,1,2,0,3,1,1,1,0,0,3
97,780875,21,2,4,1,2,1,2,0,0,1,3,4,1,0,2,0,5
97,785224,23,1,4,0,1,1,3,2,3,2,6,0,3,0,2,1,5
97,790768,26,3,9,2,6,1,3,3,4,1,1,1,1,1,3,0,10
97,796325,7,0,0,0,0,0,0,2,2,0,0,1,3,0,1,0,2
97,775785,17,1,2,1,2,0,0,0,0,0,1,2,2,0,1,0,2
97,796326,23,5,6,5,5,0,1,0,0,3,4,0,2,0,2,1,10
97,785226,18,0,4,0,3,0,1,0,0,1,2,1,2,0,0,0,0
97,785743,16,3,9,1,1,2,8,0,0,0,0,2,0,1,1,0,8
97,790767,23,2,3,2,2,0,1,0,0,0,4,0,1,1,0,0,4
97,796324,2,0,3,0,1,0,2,0,2,2,0,1,0,0,0,0,0
98,797812,15,4,6,4,6,0,0,1,4,1,1,1,1,2,1,1,9
98,797798,32,4,7,4,6,0,1,2,4,0,1,5,3,4,1,0,10
98,797809,9,1,3,1,1,0,2,5,5,0,2,1,2,0,2,0,7
98,797811,14,1,6,1,5,0,1,1,2,1,1,0,3,0,1,0,3
98,792264,25,8,14,6,10,2,4,0,0,2,7,3,2,4,1,0,18
98,795730,12,3,7,3,4,0,3,1,1,3,2,0,1,1,0,0,7
98,791868,18,5,6,5,6,0,0,5,8,1,1,1,1,5,2,1,15
98,797802,30,2,8,2,6,0,2,3,4,2,6,5,2,5,2,2,7
98,797804,2,1,2,1,2,0,0,0,0,0,0,0,0,0,0,0,2
98,797810,18,4,9,2,5,2,4,3,4,3,0,2,5,4,0,1,13
98,797814,6,1,2,1,2,0,0,0,0,0,3,1,0,0,0,0,2
98,797807,13,2,2,1,1,1,1,3,4,0,5,2,0,2,2,0,8
98,786058,6,0,2,0,2,0,0,2,2,0,0,0,1,0,0,0,2
98,781113,0,0,0,0,0,0,0,0,0,0,0,0,0,0,0,0,0
100,797855,33,6,7,4,5,2,2,6,6,0,4,1,1,2,3,0,20
100,792208,32,4,7,4,7,0,0,6,7,1,13,0,1,1,1,0,14
100,776018,21,6,9,6,9,0,0,0,1,3,4,0,4,0,2,2,12
100,781314,29,2,9,2,4,0,5,0,0,1,4,4,4,1,3,1,4
100,792204,24,2,7,2,5,0,2,0,0,1,2,2,1,0,1,0,4
100,797856,19,2,6,2,5,0,1,0,0,1,2,0,3,0,2,0,4
100,797859,23,1,6,1,2,0,4,1,2,1,0,1,2,0,0,1,3
100,786262,15,1,2,0,0,1,2,0,0,0,3,1,2,2,1,1,3
100,797862,4,0,3,0,3,0,0,0,0,0,0,0,3,0,1,0,0
100,781317,0,0,0,0,0,0,0,0,0,0,0,0,0,0,0,0,0
102,780876,39,5,11,5,8,0,3,5,8,5,5,1,4,1,4,1,15
102,781462,53,8,18,7,16,1,2,14,22,11,8,2,5,2,1,0,31
102,791305,7,0,1,0,1,0,0,0,0,0,1,0,4,0,1,1,0
102,781457,58,8,24,6,17,2,7,11,12,5,5,4,5,6,4,0,29
102,785353,57,9,26,6,14,3,12,3,4,5,8,3,3,0,8,0,24
102,796365,7,0,0,0,0,0,0,0,0,1,1,0,1,0,0,0,0
102,781673,47,6,13,5,7,1,6,3,5,1,4,2,3,1,1,0,16
102,785355,30,0,6,0,4,0,2,5,8,1,4,0,4,2,2,2,5
102,790895,2,0,0,0,0,0,0,0,0,0,0,0,0,0,0,0,0
103,780870,33,10,13,10,13,0,0,2,3,7,0,0,5,0,0,3,22
103,781079,44,8,22,3,11,5,11,5,6,1,8,6,2,1,6,0,26
103,775822,50,9,16,6,9,3,7,1,3,1,8,2,4,0,2,0,22
103,791316,36,3,5,3,4,0,1,0,0,5,3,1,5,0,1,4,6
103,781443,47,7,22,6,16,1,6,6,16,1,11,1,4,3,4,0,21
103,796625,24,5,8,5,6,0,2,2,2,3,0,1,2,1,2,1,12
103,785831,26,1,3,1,3,0,0,2,4,1,2,1,4,2,1,1,4
103,796621,21,1,4,0,1,1,3,3,4,0,2,4,3,0,2,0,6
103,785380,15,2,2,2,2,0,0,0,0,1,1,0,5,1,1,0,4
103,796626,3,0,0,0,0,0,0,0,0,0,0,0,2,0,0,0,0
103,791314,1,0,0,0,0,0,0,0,0,0,0,0,0,0,0,0,0
104,783072,20,4,5,4,5,0,0,5,5,1,2,0,1,0,0,0,13
104,781463,21,3,4,1,2,2,2,2,2,0,4,3,2,0,2,0,10
104,791540,23,2,7,2,4,0,3,0,0,1,1,1,2,0,4,0,4
104,787782,19,2,3,0,0,2,3,2,2,2,3,1,3,1,3,0,8
104,776068,29,7,14,4,8,3,6,9,10,1,3,4,1,1,2,0,26
104,797817,19,2,5,2,3,0,2,0,1,1,5,1,3,3,3,0,4
104,785647,14,0,5,0,3,0,2,5,6,2,5,0,2,0,0,0,5
104,785962,7,1,2,1,2,0,0,4,4,2,2,1,1,0,0,0,6
104,792153,23,2,6,0,2,2,4,0,0,0,0,2,1,0,0,0,6
104,785856,14,2,3,1,1,1,2,0,0,0,2,1,1,1,3,0,5
104,781202,11,0,0,0,0,0,0,1,2,1,0,0,0,2,0,1,1
106,781560,30,1,1,1,1,0,0,0,0,2,3,1,2,0,1,1,2
106,791375,34,3,8,0,0,3,8,4,5,0,2,2,3,1,3,0,13
106,785487,32,3,8,2,7,1,1,1,1,0,3,5,5,1,4,0,8
106,785482,39,10,19,9,16,1,3,6,8,3,5,4,3,0,6,0,27
106,780837,29,2,9,1,4,1,5,2,3,1,3,3,5,0,1,0,7
106,796479,4,0,1,0,0,0,1,0,0,0,0,0,4,0,2,0,0
106,796477,23,5,7,1,1,4,6,2,2,1,3,3,1,1,1,0,16
106,786164,8,1,2,0,1,1,1,2,2,0,0,0,1,1,0,0,5
106,796473,1,0,0,0,0,0,0,0,0,0,0,0,0,0,0,0,0
107,791653,26,3,6,3,5,0,1,1,2,1,5,2,1,0,2,0,7
107,791652,32,4,10,4,9,0,1,6,6,2,6,1,1,0,4,1,14
107,797285,20,3,3,0,0,3,3,0,0,0,2,0,2,2,0,0,9
107,791650,31,4,7,3,6,1,1,5,6,0,1,6,2,2,2,0,14
107,776384,26,6,9,4,5,2,4,8,8,0,5,4,2,1,1,0,22
107,791654,8,0,0,0,0,0,0,1,2,1,1,1,1,0,2,0,1
107,786495,13,4,5,4,5,0,0,0,0,0,0,0,4,0,0,0,8
107,797289,15,2,4,1,2,1,2,0,0,0,1,3,1,0,1,0,5
107,797286,7,0,2,0,1,0,1,0,0,0,1,1,4,0,1,0,0
107,797283,22,4,8,1,3,3,5,0,0,0,1,1,0,1,0,0,11
108,775806,26,7,11,5,7,2,4,2,2,1,4,1,4,1,0,0,18
108,775563,26,6,11,6,11,0,0,6,6,4,5,0,2,1,1,0,18
108,781011,17,3,4,3,4,0,0,0,0,3,3,0,4,0,1,0,6
108,797601,31,8,12,4,7,4,5,3,3,1,2,9,3,2,5,0,23
108,781012,21,2,7,2,5,0,2,7,10,1,0,4,3,5,1,0,11
108,775188,10,0,0,0,0,0,0,0,0,0,1,1,3,0,0,0,0
108,797604,4,0,0,0,0,0,0,0,0,0,0,0,2,0,0,0,0
108,797603,2,0,0,0,0,0,0,0,0,0,0,0,1,0,0,0,0
108,786466,16,0,2,0,0,0,2,3,4,0,1,1,1,0,0,0,3
108,781424,27,5,10,2,5,3,5,5,6,0,4,2,4,2,3,0,18
108,776157,20,1,8,1,3,0,5,2,3,0,1,0,3,0,0,0,4
109,792299,31,4,7,2,3,2,4,1,2,2,3,5,4,0,3,0,11
109,792304,12,2,3,2,2,0,1,0,0,0,3,0,2,0,1,0,4
109,792301,34,5,9,5,7,0,2,15,19,0,4,5,4,0,4,0,25
109,786278,23,3,6,3,3,0,3,2,2,0,3,2,2,0,4,0,8
109,786275,36,6,10,4,5,2,5,7,11,0,2,4,4,1,4,0,21
109,798092,13,2,2,2,2,0,0,0,0,1,0,1,4,0,1,0,4
109,792302,11,3,3,3,3,0,0,1,2,2,2,0,0,0,2,0,7
109,792295,5,0,1,0,0,0,1,0,0,0,0,0,1,0,0,0,0
109,786286,29,3,6,0,0,3,6,2,2,1,3,0,1,1,0,2,11
109,786280,6,1,2,1,2,0,0,0,1,0,2,0,1,0,1,0,2
110,797050,28,5,8,4,6,1,2,8,10,1,3,4,3,0,1,1,19
110,780394,23,5,12,3,4,2,8,4,4,2,4,0,0,2,0,0,16
110,780391,23,2,4,2,4,0,0,9,10,4,8,1,2,1,2,5,13
110,791573,26,2,4,0,0,2,4,0,2,0,7,3,1,1,2,1,6
110,776473,27,3,8,1,2,2,6,4,6,0,3,4,4,1,2,1,12
110,797048,15,4,7,4,7,0,0,2,3,3,1,1,4,0,0,1,10
110,790871,19,1,5,1,3,0,2,1,2,0,2,2,3,3,2,1,3
110,780392,13,3,4,1,1,2,3,2,4,0,2,3,1,1,3,0,10
110,785783,13,2,2,1,1,1,1,1,2,0,0,1,2,0,1,0,6
110,797049,13,2,2,2,2,0,0,0,0,2,2,1,3,0,1,0,4
111,789484,35,9,25,8,18,1,7,8,14,2,3,1,2,1,3,0,27
111,792418,12,0,5,0,3,0,2,2,2,0,1,0,5,0,0,0,2
111,782654,9,0,3,0,2,0,1,0,0,2,0,0,1,0,3,1,0
111,796693,33,2,12,1,7,1,5,2,2,1,5,1,3,0,0,0,7
111,792422,21,1,2,1,2,0,0,0,0,1,2,1,2,0,3,0,2
111,796692,7,0,1,0,1,0,0,5,6,0,1,0,0,2,0,0,5
111,796691,16,0,7,0,5,0,2,1,2,2,0,0,0,0,3,0,1
111,792423,2,1,1,1,1,0,0,0,0,0,0,0,0,1,1,0,2
111,792424,18,3,4,3,4,0,0,0,0,2,4,0,5,0,1,1,6
111,792419,21,0,2,0,1,0,1,0,0,3,1,3,5,1,0,1,0
111,782206,9,0,1,0,1,0,0,0,0,0,0,0,3,0,1,0,0
111,792421,12,2,3,1,1,1,2,0,0,0,2,0,0,1,0,0,5
111,796694,5,0,0,0,0,0,0,0,0,0,0,0,0,0,0,0,0
112,791756,28,3,6,2,4,1,2,1,2,2,2,6,2,0,2,0,8
112,780676,31,6,15,3,8,3,7,0,1,0,2,2,3,2,3,0,15
112,780677,32,4,8,1,3,3,5,4,4,0,3,0,3,0,0,0,15
112,786157,19,2,5,2,4,0,1,0,0,1,6,1,4,1,0,1,4
112,786150,23,4,9,4,7,0,2,2,2,3,1,1,2,0,0,0,10
112,780992,20,3,7,1,3,2,4,2,2,0,1,2,1,1,3,0,10
112,775533,15,4,5,4,4,0,1,1,1,2,1,1,4,1,0,0,9
112,791754,13,1,2,1,2,0,0,0,0,2,1,2,0,0,0,1,2
112,780673,17,0,1,0,0,0,1,0,0,0,3,1,1,0,0,0,0
112,797348,2,0,0,0,0,0,0,0,0,0,0,0,1,0,0,0,0
113,785474,26,0,2,0,0,0,2,2,2,1,4,0,2,0,0,0,2
113,780283,31,3,7,3,7,0,0,8,13,3,9,1,3,0,3,1,14
113,790925,36,6,10,3,5,3,5,2,3,2,4,0,3,0,4,0,17
113,780285,27,3,7,1,4,2,3,2,2,0,0,3,5,0,2,0,10
113,785476,34,3,9,3,4,0,5,3,4,0,0,4,3,0,3,0,9
113,785480,26,2,6,0,1,2,5,0,0,0,1,1,1,0,1,0,6
113,785478,6,0,0,0,0,0,0,0,0,0,1,0,1,0,1,1,0
113,790926,11,0,2,0,1,0,1,0,0,0,1,1,0,1,0,0,0
113,796470,3,0,0,0,0,0,0,0,0,0,0,0,0,0,0,0,0
114,797482,28,3,6,3,6,0,0,1,3,0,3,1,2,0,3,1,7
114,797485,35,3,7,2,3,1,4,2,2,0,6,3,2,0,2,0,9
114,797481,24,2,7,1,5,1,2,2,3,1,4,1,3,0,2,0,7
114,797480,28,3,6,3,5,0,1,1,2,0,4,1,2,0,2,0,7
114,785944,22,4,9,2,5,2,4,3,3,0,0,2,4,1,3,0,13
114,797478,17,3,4,2,3,1,1,3,3,0,2,0,0,0,2,0,10
114,797483,5,0,1,0,1,0,0,0,0,0,1,1,1,1,0,0,0
114,797479,4,1,1,0,0,1,1,0,0,0,2,1,0,0,1,0,3
114,791873,18,4,9,4,9,0,0,5,6,1,3,2,1,0,2,0,13
114,781217,19,1,1,1,1,0,0,1,1,0,3,0,1,0,2,0,3
115,797326,5,0,1,0,1,0,0,0,0,0,0,1,1,0,0,0,0
115,797329,28,4,6,2,3,2,3,0,0,5,4,0,3,0,0,2,10
115,786236,31,10,19,6,12,4,7,4,5,0,6,4,3,0,1,2,28
115,786233,10,1,6,1,4,0,2,2,2,0,2,0,1,2,0,0,4
115,780759,33,3,9,1,2,2,7,0,0,0,0,4,3,3,2,0,8
115,797325,27,6,7,6,7,0,0,0,2,2,4,0,1,0,0,2,12
115,781002,8,0,1,0,1,0,0,0,0,0,0,0,1,1,2,0,0
115,776478,6,1,3,0,0,1,3,0,0,0,0,0,2,0,0,0,3
115,797324,10,0,2,0,1,0,1,2,2,0,1,1,0,0,0,0,2
115,797323,34,6,13,3,7,3,6,2,2,1,4,9,4,2,3,0,17
115,797322,8,0,1,0,1,0,0,0,0,0,2,0,2,0,0,0,0
124,780853,26,6,10,5,7,1,3,4,6,0,3,5,0,3,2,0,17
124,785996,22,4,10,4,9,0,1,3,4,2,1,0,3,0,0,0,11
124,792235,13,3,5,3,5,0,0,2,2,1,2,0,0,0,1,1,8
124,786001,9,0,1,0,0,0,1,0,0,0,0,1,1,0,2,0,0
124,780776,20,3,5,3,3,0,2,0,0,0,3,0,1,0,1,1,6
124,780849,26,6,11,3,4,3,7,0,0,0,3,3,0,2,0,0,15
124,797646,24,2,9,2,9,0,0,1,2,0,4,7,3,0,3,0,5
124,780858,12,3,3,1,1,2,2,1,2,2,2,0,1,0,0,0,9
124,791374,9,0,1,0,0,0,1,0,0,0,1,0,0,0,1,0,0
124,785998,14,3,5,2,2,1,3,2,2,2,3,1,1,1,0,0,9
124,792039,25,5,7,3,3,2,4,2,2,2,5,0,2,0,0,0,14
126,781322,24,5,11,2,4,3,7,0,0,3,3,1,2,0,1,0,13
126,785989,22,4,7,4,5,0,2,6,8,2,4,6,2,3,2,4,14
126,786571,19,5,9,3,7,2,2,2,3,1,2,3,3,3,2,0,14
126,780563,26,3,9,1,4,2,5,0,0,1,1,1,0,1,1,0,8
126,781439,24,6,10,5,8,1,2,1,3,1,4,2,2,3,2,0,14
126,791690,24,3,12,3,12,0,0,3,5,3,4,0,2,2,1,0,9
126,781419,23,5,7,4,4,1,3,2,2,0,2,2,0,2,0,0,13
126,781207,22,4,4,4,4,0,0,6,8,3,3,2,3,2,0,0,14
126,797300,9,0,2,0,0,0,2,0,0,0,2,2,0,0,0,0,0
126,791691,4,1,1,0,0,1,1,0,0,0,0,0,0,0,0,0,3
126,791692,3,0,0,0,0,0,0,0,0,0,1,0,1,0,0,0,0
127,796996,23,5,7,5,7,0,0,0,2,2,0,0,1,0,3,1,10
127,780471,24,1,6,1,5,0,1,4,6,2,9,3,4,0,5,2,6
127,791613,21,1,5,0,3,1,2,0,0,0,2,2,3,2,7,0,3
127,791608,34,4,11,1,3,3,8,0,1,0,1,0,5,0,1,0,11
127,776011,31,2,6,1,3,1,3,1,3,1,2,1,3,0,4,0,6
127,786413,17,3,7,3,5,0,2,1,2,3,4,0,1,0,2,2,7
127,786353,30,4,9,2,4,2,5,0,0,1,1,3,3,1,1,0,10
127,785680,8,0,1,0,0,0,1,0,0,0,1,1,3,0,0,0,0
127,791610,10,1,3,1,3,0,0,0,0,0,1,0,2,0,0,0,2
127,780417,1,0,0,0,0,0,0,0,0,0,0,0,0,0,1,0,0
127,791611,1,0,0,0,0,0,0,0,0,0,0,0,1,0,1,0,0
128,788113,22,1,4,1,2,0,2,0,0,0,2,1,2,0,2,1,2
128,776497,22,7,13,5,8,2,5,1,2,1,4,0,2,0,1,0,17
128,785729,20,0,3,0,3,0,0,0,0,1,0,3,3,1,2,1,0
128,785731,33,8,12,8,12,0,0,3,5,1,7,0,2,1,3,0,19
128,780864,24,4,11,3,5,1,6,0,0,0,3,1,5,0,1,0,9
128,785725,20,0,4,0,2,0,2,6,6,0,1,4,3,1,2,0,6
128,792402,5,0,0,0,0,0,0,0,0,0,1,1,0,0,1,0,0
128,792408,1,0,0,0,0,0,0,0,0,0,0,0,0,0,0,0,0
128,796211,3,0,0,0,0,0,0,0,0,0,0,1,0,0,0,0,0
128,786231,26,1,4,1,2,0,2,0,0,1,1,1,2,0,3,1,2
128,792407,11,0,0,0,0,0,0,0,0,0,2,0,2,0,1,0,0
128,762035,13,0,1,0,0,0,1,0,0,0,0,0,1,0,0,0,0
129,780530,23,4,7,3,5,1,2,0,0,1,2,0,5,0,0,0,9
129,785740,30,5,10,5,10,0,0,3,6,3,4,0,2,0,3,0,13
129,781121,36,5,9,5,6,0,3,8,9,2,3,3,1,2,3,0,18
129,785809,32,0,9,0,3,0,6,1,2,2,5,3,1,2,1,1,1
129,785738,38,4,10,3,6,1,4,4,6,0,6,3,3,1,3,0,13
129,797399,16,1,3,1,1,0,2,0,0,1,0,1,1,0,1,0,2
129,797402,18,2,5,0,0,2,5,0,0,0,3,0,2,0,2,0,6
129,797396,7,0,0,0,0,0,0,0,0,0,1,0,0,0,1,0,0
130,785766,28,5,12,1,2,4,10,3,4,2,4,2,1,2,1,0,17
130,780543,33,7,14,6,10,1,4,0,1,0,2,7,0,1,1,0,15
130,785772,27,6,10,6,10,0,0,0,0,4,1,1,2,2,0,0,12
130,792486,21,5,8,3,5,2,3,0,0,1,2,4,2,0,1,0,12
130,785778,29,1,6,1,3,0,3,3,4,1,3,4,2,1,0,0,5
130,780546,14,4,5,3,4,1,1,0,0,0,4,2,1,0,2,1,9
130,792482,13,1,3,0,1,1,2,0,0,1,2,1,1,0,1,0,3
130,792489,10,1,1,0,0,1,1,0,0,0,4,1,2,0,1,0,3
130,792481,13,1,5,1,5,0,0,0,0,1,0,3,2,0,1,1,2
130,792487,7,0,0,0,0,0,0,0,0,0,0,0,1,0,0,0,0
130,792488,5,0,1,0,1,0,0,0,0,0,1,1,0,0,0,0,0
131,791519,36,7,16,4,8,3,8,3,8,1,1,9,2,0,3,0,20
131,791296,35,6,10,2,2,4,8,4,6,0,7,0,0,1,5,1,20
131,791298,30,6,10,5,6,1,4,5,6,0,3,3,4,1,2,1,18
131,775871,31,1,5,1,3,0,2,0,0,4,6,1,4,0,4,1,2
131,791299,24,1,1,1,1,0,0,0,0,0,4,0,3,1,2,1,2
131,786276,20,1,4,0,1,1,3,2,3,0,2,1,0,0,0,0,5
131,781390,15,1,4,1,1,0,3,0,0,0,1,0,0,0,0,0,2
131,796593,7,1,1,1,1,0,0,0,0,1,1,0,0,0,0,0,2
131,780525,2,0,0,0,0,0,0,0,0,0,0,0,0,0,0,0,0
131,796590,0,0,0,0,0,0,0,0,0,0,0,0,0,0,0,0,0
131,780529,0,0,0,0,0,0,0,0,0,0,0,0,0,0,0,0,0
132,775604,27,6,10,3,4,3,6,0,0,0,2,1,1,0,1,1,15
132,785505,25,5,9,3,6,2,3,3,4,0,2,6,1,0,7,0,15
132,776418,18,6,8,6,8,0,0,2,3,2,2,0,2,1,0,2,14
132,780797,27,3,8,2,5,1,3,1,2,2,13,4,3,1,2,0,8
132,780555,30,1,4,0,1,1,3,0,0,1,0,3,0,1,1,0,3
132,796981,23,6,11,5,6,1,5,2,2,2,6,3,3,1,3,0,15
132,796983,15,3,4,3,4,0,0,0,0,1,4,0,2,0,1,0,6
132,796986,17,1,3,0,0,1,3,0,0,0,5,1,1,1,1,0,3
132,791616,11,0,4,0,3,0,1,0,0,1,1,0,2,0,0,0,0
132,786429,4,0,0,0,0,0,0,0,0,0,2,1,0,1,0,0,0
132,791617,3,0,1,0,0,0,1,0,0,0,1,0,0,0,0,0,0
134,786324,37,3,17,1,8,2,9,9,9,3,2,5,1,6,5,0,17
134,789036,31,6,9,6,9,0,0,5,6,4,5,0,3,1,5,1,17
134,791493,37,7,10,7,9,0,1,2,6,4,6,2,1,1,1,2,16
134,776494,14,1,4,1,3,0,1,2,2,1,0,0,1,0,1,0,4
134,791495,18,0,1,0,0,0,1,0,0,1,1,0,0,0,0,0,0
134,791492,25,3,5,1,1,2,4,3,4,1,0,0,1,2,0,0,11
134,791494,23,2,4,2,4,0,0,0,0,0,1,0,2,3,4,0,4
134,781307,12,0,0,0,0,0,0,2,2,2,0,0,2,0,3,1,2
134,797191,3,0,1,0,0,0,1,0,0,0,1,0,0,0,0,0,0
135,786592,37,9,15,9,13,0,2,0,0,1,1,5,2,1,7,0,18
135,791864,34,6,11,4,9,2,2,0,0,3,4,1,0,2,3,0,14
135,781081,34,3,8,3,7,0,1,2,2,0,4,4,4,2,6,0,8
135,797472,31,3,9,2,2,1,7,0,0,1,2,2,0,3,1,0,7
135,776447,6,0,1,0,1,0,0,0,0,0,0,0,2,0,1,0,0
135,797470,24,3,5,0,0,3,5,2,2,1,1,2,5,2,1,0,11
135,786307,10,3,3,1,1,2,2,0,0,1,0,0,3,0,3,0,8
135,791863,10,0,2,0,1,0,1,0,0,0,0,0,3,0,1,0,0
135,797473,8,0,0,0,0,0,0,0,0,0,2,0,2,2,1,1,0
135,780195,6,0,1,0,0,0,1,0,0,0,1,0,0,0,0,0,0
136,786759,26,3,6,3,6,0,0,1,1,0,0,3,1,0,1,0,7
136,792294,22,1,4,1,4,0,0,0,0,0,5,3,0,0,0,0,2
136,775510,26,7,9,4,6,3,3,2,2,4,4,3,0,0,2,0,19
136,792293,19,2,6,1,3,1,3,0,0,2,2,2,1,2,0,0,5
136,774976,17,6,8,4,5,2,3,0,0,1,3,0,3,0,0,3,14
136,797865,20,1,3,0,2,1,1,0,0,0,2,2,1,2,0,0,3
136,792292,9,1,2,1,2,0,0,0,0,0,0,1,1,1,0,2,2
136,786614,17,7,9,1,1,6,8,1,1,0,3,0,1,1,2,0,21
136,792291,12,2,4,1,1,1,3,0,0,0,2,1,2,1,1,0,5
136,786762,12,4,5,4,4,0,1,0,0,0,2,0,1,0,0,0,8
136,797864,4,1,2,0,0,1,2,0,0,0,0,0,1,0,0,0,3
136,786761,3,0,0,0,0,0,0,0,0,0,1,0,0,0,0,0,0
136,797867,5,0,2,0,0,0,2,0,0,1,0,2,1,0,0,0,0
136,786760,2,0,0,0,0,0,0,0,0,0,1,0,1,0,0,0,0
136,797866,2,0,1,0,0,0,1,0,0,0,0,0,0,0,0,0,0
136,792296,2,0,0,0,0,0,0,0,0,0,1,0,0,0,0,0,0
136,780349,2,0,2,0,0,0,2,0,0,0,0,0,0,0,0,0,0
137,776284,24,3,9,3,5,0,4,0,0,0,2,3,0,0,3,0,6
137,792258,18,3,4,2,2,1,2,2,2,0,2,1,2,0,1,0,9
137,786124,16,0,3,0,3,0,0,0,0,1,0,1,0,0,0,0,0
137,786122,26,6,12,1,5,5,7,2,2,1,1,1,0,0,0,0,19
137,792261,20,1,2,1,2,0,0,0,0,0,0,0,2,0,0,0,2
137,780308,21,1,4,0,2,1,2,0,0,1,3,1,2,0,2,0,3
137,775206,22,1,4,1,3,0,1,1,2,0,2,0,1,1,1,0,3
137,780877,17,1,7,1,7,0,0,0,0,3,3,1,2,0,0,0,2
137,786113,14,1,1,1,1,0,0,2,2,0,3,0,0,0,2,0,4
137,786331,14,0,1,0,1,0,0,3,4,0,1,1,0,0,0,0,3
137,797980,2,1,1,1,1,0,0,0,0,0,1,0,0,0,0,0,2
137,786845,2,0,1,0,1,0,0,0,0,0,0,0,0,0,0,0,0
137,797982,3,0,0,0,0,0,0,1,2,0,0,0,0,0,0,0,1
137,784073,1,0,0,0,0,0,0,0,0,0,0,0,0,0,0,0,0
138,790873,23,5,9,5,9,0,0,6,9,2,1,3,3,2,1,1,16
138,780054,21,8,9,7,8,1,1,2,3,4,4,1,0,3,3,0,19
138,781140,19,3,5,3,5,0,0,2,3,1,7,1,3,0,0,0,8
138,786851,27,4,12,2,7,2,5,2,2,0,2,3,0,1,0,0,12
138,776357,24,3,8,3,6,0,2,4,4,0,2,6,1,1,2,0,10
138,796433,17,3,4,3,4,0,0,6,9,3,2,1,1,0,2,1,12
138,796432,18,1,4,0,0,1,4,0,0,0,4,0,1,0,0,0,3
138,780343,10,0,1,0,1,0,0,0,0,1,0,2,5,0,0,0,0
138,781139,12,0,4,0,2,0,2,0,0,0,3,0,1,1,2,1,0
138,785429,14,2,4,0,0,2,4,0,0,0,0,0,0,0,0,0,6
138,796102,7,0,1,0,1,0,0,1,2,1,1,0,0,0,0,0,1
138,790527,5,2,3,2,3,0,0,0,0,0,0,0,1,0,0,0,4
138,799139,3,0,0,0,0,0,0,3,4,0,0,0,0,0,0,0,3
139,797102,16,0,2,0,2,0,0,0,0,2,3,1,2,0,2,0,0
139,785911,18,2,5,1,2,1,3,0,0,0,1,0,3,0,0,2,5
139,791413,28,5,11,3,7,2,4,5,7,1,6,1,0,1,1,0,17
139,791411,29,4,12,2,8,2,4,0,0,0,2,1,2,1,2,0,10
139,785776,30,5,11,2,6,3,5,2,2,0,1,2,4,0,1,2,15
139,791414,15,0,3,0,2,0,1,0,0,1,1,0,5,0,2,1,0
139,797099,18,2,2,2,2,0,0,0,1,0,0,0,3,0,2,0,4
139,797100,18,2,3,1,2,1,1,3,4,0,5,7,1,0,5,0,8
139,781209,13,1,5,1,4,0,1,3,4,0,1,0,4,0,0,0,5
139,797105,15,1,3,1,2,0,1,1,1,1,4,0,2,0,1,0,3
140,780570,12,2,4,2,4,0,0,1,2,1,0,0,4,0,1,0,5
140,780569,37,3,8,3,8,0,0,0,0,6,8,0,1,1,4,1,6
140,781556,21,5,7,5,7,0,0,0,0,0,3,1,5,0,1,0,10
140,780565,27,1,5,1,4,0,1,1,3,0,5,3,2,1,2,0,3
140,780564,19,1,7,1,5,0,2,0,0,0,1,0,1,1,2,1,2
140,797434,17,2,4,2,4,0,0,2,4,1,4,0,4,1,0,0,6
140,797432,2,0,1,0,0,0,1,0,0,0,0,0,0,0,0,0,0
140,797438,19,1,5,1,3,0,2,3,5,0,2,1,0,0,1,0,5
140,791697,23,7,13,5,8,2,5,4,5,2,1,0,1,2,4,0,20
140,791696,10,3,4,2,3,1,1,0,0,0,0,0,3,0,2,0,7
140,791695,13,1,3,1,3,0,0,0,0,1,1,0,2,1,2,0,2
141,791306,21,2,5,1,3,1,2,2,2,2,3,0,4,1,0,4,7
141,792432,28,1,2,1,2,0,0,0,2,0,2,9,3,0,4,0,2
141,792427,32,6,13,4,10,2,3,4,4,2,1,0,0,4,4,1,18
141,792433,9,1,4,0,1,1,3,0,0,0,2,1,2,1,0,0,3
141,780210,36,9,17,8,14,1,3,2,4,4,8,1,2,1,4,1,21
141,796592,19,1,4,1,2,0,2,0,0,1,3,1,1,1,2,0,2
141,789632,4,0,0,0,0,0,0,0,0,0,2,0,0,0,1,0,0
141,796594,11,1,3,1,1,0,2,0,0,0,1,0,0,0,0,0,2
141,792431,9,1,1,1,1,0,0,0,0,0,1,1,3,1,1,0,2
141,786422,10,0,2,0,1,0,1,1,2,0,0,1,3,2,0,0,1
141,775005,21,3,6,2,4,1,2,7,10,1,3,0,2,0,3,0,14
142,780404,22,5,10,4,9,1,1,1,2,2,6,4,0,1,1,1,12
142,786394,27,5,12,4,6,1,6,1,2,0,5,2,1,0,1,0,12
142,785228,21,1,7,0,4,1,3,2,2,0,2,2,3,1,1,0,5
142,780062,20,3,5,3,5,0,0,0,0,3,1,0,4,0,0,0,6
142,786395,25,6,6,2,2,4,4,3,3,0,5,3,2,0,0,0,19
142,791581,19,0,4,0,2,0,2,2,2,0,3,1,1,0,2,0,2
142,791585,16,4,6,1,1,3,5,3,3,1,6,0,2,0,0,0,14
142,780403,12,1,1,1,1,0,0,0,0,1,0,0,0,0,1,0,2
142,791582,17,3,5,3,5,0,0,1,1,3,1,1,1,1,2,2,7
142,797041,15,2,6,2,4,0,2,2,2,0,1,0,0,0,1,0,6
142,797037,3,0,0,0,0,0,0,0,1,0,0,0,1,0,0,0,0
142,797042,2,0,1,0,1,0,0,0,0,0,1,0,2,0,0,0,0
142,797040,1,0,0,0,0,0,0,0,0,0,0,0,0,0,0,0,0
143,775995,26,2,10,2,6,0,4,1,1,3,3,3,2,0,1,0,5
143,792019,24,3,8,1,1,2,7,0,0,0,2,0,3,0,1,0,8
143,786542,19,2,7,1,2,1,5,0,0,2,0,0,3,0,1,0,5
143,786540,23,8,13,8,11,0,2,3,4,4,9,0,3,3,2,1,19
143,792015,31,6,13,4,7,2,6,3,4,0,3,3,4,0,3,0,17
143,785364,15,1,3,1,3,0,0,2,3,3,3,0,2,1,1,0,4
143,792016,23,2,6,2,2,0,4,1,2,1,2,2,1,1,0,0,5
143,781147,21,1,2,0,0,1,2,0,0,0,0,0,1,0,0,0,3
143,797515,16,0,3,0,1,0,2,0,0,0,1,0,2,0,1,0,0
143,797513,1,0,1,0,0,0,1,0,0,0,0,0,0,0,0,0,0
143,797514,1,0,0,0,0,0,0,1,2,1,1,0,0,0,0,0,1
144,780176,36,8,15,5,7,3,8,3,3,1,5,1,1,0,0,0,22
144,786013,29,3,7,3,7,0,0,3,8,1,4,1,5,1,2,3,9
144,790816,12,0,1,0,1,0,0,0,0,3,1,0,0,0,1,0,0
144,796379,32,3,6,0,1,3,5,0,0,0,1,5,2,1,1,0,9
144,790815,30,4,10,2,5,2,5,5,7,2,3,2,4,1,3,0,15
144,796372,8,1,3,1,3,0,0,1,2,1,2,0,2,0,2,0,3
144,790814,28,2,6,2,3,0,3,0,0,4,3,2,2,0,2,0,4
144,796378,8,1,1,1,1,0,0,0,0,0,0,0,0,0,1,0,2
144,796377,15,1,5,1,4,0,1,0,0,0,1,1,1,0,2,0,2
144,796375,2,2,2,2,2,0,0,0,0,2,0,0,0,0,0,0,4
145,785630,18,2,7,2,2,0,5,2,2,1,0,5,0,1,1,0,6
145,780777,34,3,7,2,5,1,2,2,2,1,3,8,0,1,1,0,9
145,785631,28,5,12,3,7,2,5,0,0,5,2,1,2,0,2,0,12
145,785863,22,4,9,4,9,0,0,2,3,2,2,0,3,1,0,0,10
145,786248,17,3,6,3,5,0,1,0,1,1,2,1,4,1,1,1,6
145,791197,9,2,2,2,2,0,0,0,0,0,0,0,1,0,1,1,4
145,785632,36,3,3,3,3,0,0,9,10,1,9,2,3,4,1,0,15
145,791198,15,3,8,0,0,3,8,0,0,0,0,0,0,0,0,0,9
145,791200,6,2,3,2,3,0,0,0,0,0,2,0,0,1,0,0,4
145,791196,2,1,2,0,0,1,2,0,0,0,0,0,0,0,0,0,3
145,791199,13,1,1,1,1,0,0,0,0,0,0,0,2,0,0,2,2
146,797725,8,1,3,1,3,0,0,0,0,0,0,0,2,0,0,1,2
146,786263,19,1,6,0,3,1,3,3,4,1,1,0,1,0,1,0,6
146,792121,21,2,2,2,2,0,0,1,2,2,6,0,1,0,2,0,5
146,786257,31,6,11,6,11,0,0,3,5,2,4,3,1,0,2,1,15
146,775825,35,4,10,4,8,0,2,0,0,1,4,4,2,1,2,0,8
146,785661,28,2,8,2,6,0,2,4,5,1,4,1,4,0,4,0,8
146,797722,6,1,5,1,1,0,4,0,0,0,1,0,0,0,0,0,2
146,792122,29,3,10,3,6,0,4,4,4,1,5,1,1,1,1,0,10
146,797724,13,0,3,0,1,0,2,0,0,0,1,1,1,0,0,0,0
146,797721,5,0,1,0,0,0,1,0,0,0,0,0,0,0,0,0,0
146,792356,1,0,0,0,0,0,0,0,0,0,1,0,0,0,0,0,0
146,786249,4,0,0,0,0,0,0,0,0,0,0,0,0,0,0,0,0
147,796390,20,4,7,4,7,0,0,2,4,3,4,0,3,0,0,2,10
147,790831,9,0,1,0,1,0,0,0,0,0,3,0,2,0,1,2,0
147,790833,28,2,10,2,9,0,1,0,0,2,7,1,3,1,3,1,4
147,790834,22,1,6,1,4,0,2,0,0,1,2,1,0,1,1,0,2
147,785377,24,2,7,2,6,0,1,0,0,1,4,3,2,2,3,1,4
147,790832,31,8,13,2,6,6,7,2,4,0,2,2,1,1,1,0,24
147,785451,24,5,12,4,9,1,3,0,1,0,1,0,1,0,1,0,11
147,790830,22,4,6,4,6,0,0,2,2,1,4,2,1,2,0,0,10
147,780297,17,3,5,3,3,0,2,2,2,2,1,1,5,0,0,1,8
147,785379,3,0,0,0,0,0,0,0,0,0,0,0,0,0,0,0,0
148,776286,17,3,6,3,6,0,0,0,0,2,2,0,2,0,0,0,6
148,775557,20,2,5,2,5,0,0,0,0,2,2,2,1,1,0,0,4
148,791445,26,9,11,2,2,7,9,0,0,0,1,1,2,1,2,0,25
148,785357,27,3,15,1,8,2,7,0,0,2,5,4,2,0,1,0,8
148,775560,25,3,11,3,7,0,4,3,5,3,5,2,2,3,1,1,9
148,785287,13,0,0,0,0,0,0,2,2,3,2,1,1,1,2,1,2
148,797010,17,5,8,3,5,2,3,10,13,2,6,2,3,1,2,0,22
148,791444,17,2,4,2,4,0,0,1,1,3,3,0,1,2,0,2,5
148,785895,15,2,6,0,0,2,6,0,0,1,0,1,2,1,1,0,6
148,797012,18,1,5,1,1,0,4,0,0,0,1,3,1,1,0,4,2
148,797011,5,0,1,0,1,0,0,0,0,0,2,0,1,0,0,0,0
149,780201,33,4,6,4,6,0,0,0,0,2,5,0,1,0,3,0,8
149,791469,25,1,2,1,2,0,0,0,0,0,2,1,2,0,1,0,2
149,797208,34,2,8,2,8,0,0,1,2,2,4,3,2,1,6,0,5
149,791467,35,3,9,2,4,1,5,8,9,0,4,1,2,1,3,0,15
149,775516,29,2,7,2,4,0,3,2,4,0,1,1,2,1,3,0,6
149,798344,24,3,10,3,9,0,1,2,5,1,4,1,4,0,2,0,8
149,791471,12,0,6,0,2,0,4,0,0,0,0,1,1,0,1,0,0
149,797209,2,0,0,0,0,0,0,0,0,0,0,0,2,0,1,0,0
149,791470,6,0,2,0,2,0,0,1,2,2,1,0,3,0,2,0,1
150,785828,20,4,6,3,5,1,1,2,2,0,4,1,1,0,0,1,11
150,785402,23,1,4,1,4,0,0,0,0,0,5,1,2,0,0,2,2
150,791700,34,3,5,3,4,0,1,1,2,0,4,4,0,1,2,0,7
150,792118,32,5,14,4,12,1,2,3,4,0,1,4,1,1,2,0,14
150,782593,19,3,8,1,3,2,5,0,0,0,3,1,4,1,3,0,8
150,791699,16,1,8,0,6,1,2,0,2,2,4,0,0,0,1,0,3
150,791702,19,1,7,1,7,0,0,2,2,3,7,1,4,1,2,0,4
150,797523,24,5,5,2,2,3,3,0,1,1,0,1,0,3,0,1,13
150,797526,11,0,3,0,0,0,3,0,0,0,1,0,0,1,0,0,0
150,797525,2,0,0,0,0,0,0,0,0,0,0,0,0,0,0,0,0
151,781044,28,2,9,1,6,1,3,1,2,1,9,1,2,0,2,2,6
151,791795,25,1,5,1,3,0,2,3,4,0,4,1,3,0,2,0,5
151,786489,21,3,6,2,3,1,3,2,2,0,2,0,3,1,1,0,9
151,786488,29,3,6,3,4,0,2,3,4,0,5,2,2,2,1,0,9
151,781038,32,4,10,1,5,3,5,0,0,2,2,2,1,1,3,0,11
151,791796,12,0,4,0,4,0,0,1,2,4,3,0,1,1,1,0,1
151,797621,22,3,8,2,4,1,4,0,0,1,3,2,1,0,1,0,7
151,797619,13,0,3,0,2,0,1,0,0,0,0,0,2,0,2,0,0
151,797620,18,0,4,0,3,0,1,0,0,0,4,1,2,0,3,1,0
152,791367,16,4,5,4,5,0,0,1,2,1,3,4,0,1,1,0,9
152,785446,19,3,4,3,3,0,1,0,0,0,4,0,0,0,1,0,6
152,797239,17,5,8,3,3,2,5,1,1,0,4,1,1,0,2,1,13
152,786251,12,1,4,1,2,0,2,1,1,2,2,1,0,1,1,0,3
152,797235,19,3,4,3,4,0,0,2,2,2,7,1,0,1,0,1,8
152,791369,9,1,4,0,1,1,3,0,0,0,3,0,0,0,0,1,3
152,797232,15,6,10,1,1,5,9,0,0,0,1,1,1,0,3,1,17
152,797233,19,1,3,1,2,0,1,1,2,1,3,0,3,0,0,2,3
152,797234,18,1,6,1,2,0,4,1,2,1,3,2,2,3,1,0,3
152,797236,2,0,0,0,0,0,0,1,2,0,0,0,1,1,0,0,1
152,797237,24,5,10,4,7,1,3,0,0,1,3,3,2,3,2,0,11
152,797238,11,0,2,0,1,0,1,1,2,0,0,1,2,0,1,0,1
152,791368,16,3,4,3,4,0,0,1,2,2,5,0,0,0,1,0,7
152,797240,3,1,1,1,1,0,0,0,0,0,1,0,1,0,0,0,2
154,797895,15,2,3,2,3,0,0,4,8,1,5,0,1,0,1,0,8
154,789058,23,1,8,0,0,1,8,0,0,0,2,2,3,2,0,0,3
154,792236,35,5,15,5,12,0,3,2,5,2,6,5,3,0,2,0,12
154,792237,10,0,6,0,5,0,1,0,0,0,1,0,0,1,0,0,0
154,781374,22,6,10,5,7,1,3,1,1,0,1,0,4,2,2,0,14
154,785286,20,2,8,1,6,1,2,1,2,2,2,1,1,1,0,0,6
154,797898,31,9,13,7,10,2,3,1,2,1,5,2,2,5,0,0,21
154,792240,15,1,2,1,1,0,1,0,0,0,3,1,5,0,0,0,2
154,792359,11,0,5,0,0,0,5,0,0,0,0,1,0,0,0,0,0
154,792238,6,0,0,0,0,0,0,0,0,0,0,0,0,1,0,0,0
154,776337,9,1,1,1,1,0,0,0,0,1,0,0,1,0,0,0,2
154,785818,3,0,0,0,0,0,0,0,0,0,0,0,1,0,0,0,0
155,790884,15,1,4,1,4,0,0,3,4,3,2,0,3,0,2,0,5
155,796436,36,7,16,5,11,2,5,5,7,2,8,3,3,0,5,0,21
155,790885,30,4,9,3,3,1,6,1,2,3,9,1,2,0,2,0,10
155,785436,37,3,4,2,2,1,2,2,5,1,12,7,2,0,4,0,9
155,781262,18,3,8,1,1,2,7,0,0,0,1,0,2,0,2,0,8
155,790886,6,2,4,2,2,0,2,0,0,0,0,0,0,1,0,0,4
155,796439,25,5,9,5,9,0,0,1,7,4,3,1,3,0,0,0,11
155,796438,11,0,0,0,0,0,0,0,0,0,1,0,1,0,0,0,0
155,790883,16,2,4,1,2,1,2,2,2,0,4,1,1,0,3,0,7
155,796437,5,0,1,0,0,0,1,0,0,0,0,0,0,0,0,0,0
155,796442,1,0,0,0,0,0,0,0,0,0,0,0,0,0,0,0,0
156,781400,38,9,22,7,14,2,8,3,3,5,3,4,2,0,4,0,23
156,781403,35,3,15,1,7,2,8,2,4,0,8,2,1,2,5,1,10
156,780524,35,5,12,2,4,3,8,0,0,2,2,1,2,2,2,0,13
156,792654,21,6,8,6,8,0,0,0,1,4,8,0,4,1,3,2,12
156,775893,28,0,6,0,5,0,1,0,0,1,2,6,4,2,2,0,0
156,797301,7,1,2,1,1,0,1,0,1,0,0,1,2,0,0,0,2
156,792653,16,2,5,2,5,0,0,0,0,1,4,0,4,0,3,0,4
156,797305,12,0,2,0,1,0,1,1,2,4,6,1,0,1,0,0,1
156,797304,4,1,2,1,2,0,0,1,2,1,1,0,0,0,1,0,3
156,797306,4,1,1,1,1,0,0,0,1,3,1,0,0,0,0,0,2
157,786034,33,3,10,2,5,1,5,0,0,0,5,2,2,3,0,0,7
157,786419,22,5,13,5,12,0,1,1,2,0,2,2,3,4,6,0,11
157,781652,36,6,12,5,7,1,5,0,0,3,7,3,3,0,1,0,13
157,781653,24,3,4,3,4,0,0,2,4,3,4,0,4,0,2,1,8
157,781283,31,3,11,1,6,2,5,5,6,0,1,2,2,2,2,0,13
157,791615,27,2,9,0,4,2,5,0,0,0,6,1,1,1,3,1,6
157,781158,13,1,2,1,2,0,0,0,0,0,1,2,2,1,1,0,2
157,791614,3,0,0,0,0,0,0,0,0,1,0,0,0,0,0,0,0
157,796993,9,0,2,0,0,0,2,2,2,0,3,1,2,1,1,0,2
157,785419,2,0,2,0,1,0,1,0,0,0,0,0,0,0,0,0,0
158,792340,25,9,12,7,8,2,4,1,3,2,4,4,0,2,2,0,21
158,792341,38,8,13,6,7,2,6,0,0,1,3,5,4,2,0,0,18
158,792342,22,3,6,1,2,2,4,2,2,0,1,2,2,1,1,0,10
158,792346,15,4,5,3,4,1,1,0,0,1,0,5,2,0,0,1,9
158,781553,22,6,6,6,6,0,0,3,3,1,6,4,1,6,0,0,15
158,798086,25,4,5,4,4,0,1,0,0,2,3,4,4,0,0,0,8
158,798083,23,3,8,2,5,1,3,1,2,0,1,2,2,0,0,0,8
158,798085,15,4,6,4,5,0,1,1,2,0,7,2,2,3,0,0,9
158,798088,15,3,4,2,2,1,2,0,0,0,1,2,2,1,1,0,7
160,797127,28,1,4,0,1,1,3,3,4,1,2,0,2,1,0,3,6
160,791533,34,8,12,7,8,1,4,0,0,1,5,5,3,0,4,0,17
160,791534,17,3,6,2,4,1,2,1,2,1,4,0,4,0,1,0,8
160,791528,23,2,7,2,5,0,2,0,0,0,7,5,4,0,4,0,4
160,775045,31,6,11,4,9,2,2,4,5,1,7,7,0,1,1,0,18
160,797124,19,5,5,5,5,0,0,1,1,1,4,0,1,0,0,0,11
160,791531,30,4,6,3,3,1,3,1,2,0,4,1,3,0,1,0,10
160,791527,8,2,2,2,2,0,0,1,2,3,2,0,1,0,1,0,5
160,797129,5,0,0,0,0,0,0,0,0,1,1,1,1,0,0,0,0
160,791530,1,0,0,0,0,0,0,0,0,0,1,0,1,0,0,0,0
160,797123,4,0,0,0,0,0,0,0,0,0,0,0,0,0,0,0,0
161,796951,27,2,7,0,3,2,4,3,5,0,2,1,2,0,1,0,9
161,781249,24,3,8,1,3,2,5,2,2,0,2,1,2,0,0,0,10
161,781253,27,2,5,1,3,1,2,2,2,0,1,0,1,2,1,0,7
161,785515,25,4,8,4,6,0,2,2,3,0,3,0,2,0,3,0,10
161,775165,29,1,3,0,0,1,3,0,0,2,2,2,2,1,0,0,3
161,791251,17,0,4,0,0,0,4,0,0,0,0,1,2,0,2,0,0
161,796950,8,0,2,0,0,0,2,0,1,0,1,0,0,0,0,0,0
161,796953,10,0,0,0,0,0,0,1,4,0,1,0,4,0,2,0,1
161,791252,15,1,4,1,3,0,1,0,4,1,2,1,0,0,0,0,2
161,796952,18,1,6,1,3,0,3,0,0,0,1,0,1,0,0,0,2
162,786179,30,10,20,7,10,3,10,8,8,0,1,0,3,1,1,0,31
162,780238,34,5,10,5,8,0,2,5,6,1,1,4,5,2,4,0,15
162,781500,29,2,6,2,5,0,1,3,4,2,1,1,1,1,2,0,7
162,780244,25,2,5,1,3,1,2,0,0,1,2,0,4,1,1,0,5
162,785909,21,2,3,2,3,0,0,0,1,1,5,1,4,1,0,2,4
162,791749,16,1,8,1,3,0,5,1,2,3,1,0,4,0,2,0,3
162,790773,12,0,5,0,2,0,3,0,0,0,2,0,0,0,1,0,0
162,791750,7,0,0,0,0,0,0,0,0,0,1,0,5,0,2,0,0
162,786177,16,1,3,0,0,1,3,0,0,1,0,0,4,0,0,0,3
162,791752,10,0,1,0,1,0,0,0,0,2,1,0,1,0,2,0,0
163,791603,20,0,3,0,1,0,2,1,2,0,2,1,2,0,4,0,1
163,791606,35,6,9,3,6,3,3,0,0,1,3,4,4,1,3,1,15
163,780414,34,4,12,4,8,0,4,14,21,3,5,4,3,1,5,0,22
163,786410,27,3,4,1,2,2,2,1,4,0,1,0,2,1,1,0,9
163,775095,11,3,3,3,3,0,0,1,2,0,2,1,2,0,2,0,7
163,786406,26,0,0,0,0,0,0,4,4,2,1,2,0,0,2,0,4
163,791605,21,0,3,0,2,0,1,4,4,1,7,1,4,1,0,0,4
163,797020,14,5,6,5,6,0,0,2,4,2,2,1,3,0,2,2,12
163,792392,12,1,2,1,2,0,0,0,0,0,2,0,2,1,0,0,2
164,791905,36,9,15,0,2,9,13,1,2,1,6,2,3,0,0,0,28
164,781103,34,2,5,1,3,1,2,2,2,3,2,3,4,0,2,0,7
164,797568,24,5,12,2,5,3,7,3,3,0,2,4,2,0,1,0,16
164,786517,38,10,20,4,8,6,12,2,3,1,6,5,2,2,5,1,28
164,781102,27,0,0,0,0,0,0,0,0,0,2,0,3,2,6,0,0
164,791904,6,0,2,0,2,0,0,0,0,0,1,1,1,0,1,0,0
164,797566,18,1,4,0,1,1,3,0,0,0,2,0,2,0,1,0,3
164,791908,17,2,5,2,3,0,2,1,1,0,3,1,4,0,1,0,5
165,776100,26,2,5,1,4,1,1,0,0,2,4,1,3,0,2,0,5
165,785991,26,5,13,4,8,1,5,0,0,3,5,2,3,2,2,2,11
165,781406,32,8,18,8,14,0,4,10,13,1,2,2,1,2,0,0,26
165,781401,23,3,6,3,5,0,1,1,2,1,3,1,1,1,0,1,7
165,775317,16,0,3,0,2,0,1,2,2,0,1,2,2,1,1,0,2
165,797760,14,1,2,1,1,0,1,0,0,1,4,0,0,1,0,0,2
165,792133,10,1,3,1,1,0,2,3,3,0,2,1,3,0,1,0,5
165,797762,25,7,10,6,9,1,1,6,6,1,3,3,2,3,1,0,21
165,781029,28,3,5,0,1,3,4,5,5,0,4,2,1,0,2,0,14
166,786550,31,7,11,3,4,4,7,7,8,1,2,1,4,2,4,0,25
166,780177,20,2,5,2,5,0,0,0,3,3,2,0,3,0,1,1,4
166,792007,29,2,3,2,2,0,1,1,2,2,4,2,0,2,0,0,5
166,792009,26,4,13,4,10,0,3,2,2,2,0,2,0,0,0,1,10
166,792006,30,4,7,4,7,0,0,2,4,0,3,6,3,0,1,0,10
166,792011,8,0,1,0,1,0,0,0,0,0,1,0,4,0,1,1,0
166,776054,20,2,5,1,2,1,3,0,2,0,1,0,1,1,0,0,5
166,791689,9,0,2,0,2,0,0,0,0,1,0,0,0,0,0,0,0
166,786552,16,1,5,1,5,0,0,0,0,1,3,0,1,0,2,0,2
166,776273,11,2,3,2,3,0,0,1,2,1,1,0,0,0,2,0,5
167,776344,27,7,10,6,9,1,1,1,4,0,1,0,4,0,4,0,16
167,775821,34,5,11,4,6,1,5,2,2,1,4,0,3,0,3,0,13
167,792453,28,1,4,1,4,0,0,2,2,0,4,4,3,0,1,0,4
167,785131,30,3,8,1,4,2,4,0,0,4,4,2,2,1,1,0,8
167,781538,28,0,3,0,1,0,2,0,0,0,3,1,2,0,2,0,0
167,798113,2,0,1,0,0,0,1,0,0,0,0,0,0,0,0,0,0
167,785152,13,0,0,0,0,0,0,0,0,0,1,1,5,0,2,0,0
167,798115,29,4,8,2,3,2,5,4,4,0,0,0,2,0,0,0,14
167,792323,5,1,1,1,1,0,0,1,1,0,0,0,2,0,3,0,3
167,776233,4,1,1,1,1,0,0,0,2,1,1,0,1,0,0,0,2
168,791881,18,3,5,1,3,2,2,2,2,0,2,0,4,0,4,0,10
168,797613,6,0,4,0,1,0,3,2,2,0,1,0,0,0,1,0,2
168,797614,10,0,1,0,0,0,1,0,0,0,0,1,1,0,1,0,0
168,781258,12,0,2,0,0,0,2,0,0,0,3,0,1,0,1,0,0
168,797618,17,2,5,2,5,0,0,0,0,0,3,0,1,1,1,2,4
168,786493,32,7,16,2,4,5,12,1,1,0,7,0,2,1,4,0,20
168,786491,27,2,3,2,3,0,0,0,0,1,8,3,3,0,3,1,4
168,781052,22,2,5,0,0,2,5,0,0,1,0,0,1,0,1,0,6
168,786420,31,3,9,2,6,1,3,6,6,0,1,5,1,1,4,0,13
168,797616,20,2,4,2,4,0,0,4,7,4,3,0,3,1,0,0,8
168,797617,5,0,0,0,0,0,0,0,1,0,0,0,0,0,0,0,0
169,791227,29,3,7,1,1,2,6,0,0,1,2,4,3,0,3,0,8
169,781201,12,1,3,1,2,0,1,2,2,3,1,1,1,0,0,0,4
169,791226,11,3,5,3,5,0,0,3,4,0,2,0,1,0,0,3,9
169,781211,1,0,0,0,0,0,0,0,0,0,0,0,0,0,0,0,0
169,791230,26,2,6,1,3,1,3,0,0,3,3,0,3,1,0,0,5
169,785557,29,6,18,5,15,1,3,2,4,6,4,0,2,4,2,2,15
169,791228,18,6,9,6,7,0,2,1,1,1,4,3,2,3,0,0,13
169,785624,32,3,14,3,12,0,2,4,4,3,5,1,5,5,2,0,10
169,796932,28,4,12,3,7,1,5,3,4,2,1,6,1,2,1,0,12
169,796935,14,1,8,1,2,0,6,2,2,1,2,0,1,1,1,1,4
170,785498,30,2,8,2,5,0,3,2,2,1,2,0,2,0,0,1,6
170,776469,22,4,9,3,8,1,1,0,2,1,2,1,2,2,1,1,9
170,796708,31,2,6,2,3,0,3,0,1,0,4,0,3,0,1,0,4
170,780701,38,6,9,5,8,1,1,8,11,0,2,4,2,2,1,0,21
170,776322,31,6,15,4,8,2,7,1,2,1,8,1,2,1,0,0,15
170,785500,4,0,1,0,0,0,1,0,0,0,1,0,0,0,0,0,0
170,796705,20,2,6,2,3,0,3,3,4,0,3,1,0,1,1,0,7
170,791036,5,0,1,0,1,0,0,0,0,0,0,0,2,0,1,0,0
170,796709,19,1,2,0,1,1,1,1,2,2,3,0,1,1,1,0,4
171,775455,24,3,10,3,8,0,2,0,0,0,7,2,4,0,3,0,6
171,792124,28,4,9,4,9,0,0,0,3,0,3,1,2,0,1,1,8
171,792123,35,5,8,2,4,3,4,4,4,0,7,5,2,1,2,1,17
171,786002,16,0,1,0,0,0,1,0,0,0,2,0,1,0,0,0,0
171,781397,21,1,2,1,2,0,0,1,1,1,2,2,1,0,1,0,3
171,786003,23,4,8,1,1,3,7,0,0,0,7,1,1,1,1,2,11
171,797749,11,1,2,0,1,1,1,0,0,0,1,0,3,0,2,0,3
171,792119,8,0,1,0,1,0,0,0,0,0,1,2,1,0,0,1,0
171,792120,27,5,7,3,4,2,3,2,2,0,2,0,3,0,2,0,14
171,797747,3,0,2,0,2,0,0,0,0,0,0,0,1,0,1,0,0
171,797752,1,0,0,0,0,0,0,0,0,0,0,0,0,0,0,0,0
171,786005,3,0,0,0,0,0,0,0,0,0,0,0,0,0,0,0,0
172,791281,23,6,10,6,10,0,0,4,6,2,8,2,2,0,3,1,16
172,792276,23,6,8,4,6,2,2,2,3,0,0,2,1,1,2,1,16
172,791278,30,1,7,1,1,0,6,0,0,0,6,0,3,1,0,0,2
172,786026,29,5,8,3,6,2,2,1,4,2,1,1,1,1,4,0,13
172,775814,23,3,4,3,4,0,0,2,3,0,4,3,1,2,2,0,8
172,785764,12,2,4,2,4,0,0,4,5,2,4,1,2,0,0,0,8
172,796536,10,1,1,1,1,0,0,1,4,3,1,0,2,0,0,2,3
172,785763,10,1,1,1,1,0,0,0,0,0,1,0,2,0,1,1,2
172,796535,19,3,4,2,3,1,1,2,3,0,7,1,2,3,1,1,9
172,785398,21,3,6,3,6,0,0,4,5,1,4,0,0,1,3,1,10
174,786520,24,6,11,5,8,1,3,4,5,2,2,2,3,0,2,0,17
174,797556,35,6,16,4,8,2,8,0,1,1,3,4,1,1,1,0,14
174,786519,31,4,8,4,8,0,0,2,8,10,9,1,1,3,0,0,10
174,791911,26,3,8,0,0,3,8,1,1,0,2,0,2,0,2,0,10
174,791913,38,2,6,1,3,1,3,1,2,1,2,4,4,1,1,0,6
174,797555,21,4,9,4,7,0,2,3,4,1,2,4,2,0,2,0,11
174,797558,13,1,5,0,2,1,3,0,0,0,1,1,1,0,0,0,3
174,797557,3,0,1,0,0,0,1,0,0,0,0,0,1,0,1,0,0
174,791912,9,1,1,1,1,0,0,1,2,2,0,0,5,0,0,0,3
175,767245,27,11,21,11,21,0,0,6,10,6,5,1,2,2,0,0,28
175,780212,36,6,13,4,7,2,6,1,1,0,1,3,5,4,4,0,15
175,780406,16,3,4,2,2,1,2,2,4,0,3,0,2,0,1,0,9
175,775087,6,0,3,0,1,0,2,1,2,0,1,0,1,0,1,0,1
175,790984,33,0,6,0,2,0,4,0,2,1,1,1,1,0,1,0,0
175,780214,7,2,2,0,0,2,2,0,0,0,1,1,2,0,0,0,6
175,780215,22,2,3,2,3,0,0,1,2,5,3,0,5,0,0,3,5
175,791168,11,2,5,1,2,1,3,0,0,1,2,0,0,0,2,1,5
175,785297,29,2,7,2,3,0,4,0,0,0,3,5,2,1,0,0,4
175,790985,9,0,0,0,0,0,0,0,0,0,2,0,1,0,0,0,0
175,796596,4,0,0,0,0,0,0,0,0,0,0,0,0,0,0,0,0
176,796585,14,2,5,2,5,0,0,0,1,2,5,0,0,0,0,2,4
176,790974,20,6,9,4,5,2,4,0,0,0,2,0,0,0,0,2,14
176,798138,14,3,4,2,2,1,2,0,0,1,0,2,1,2,1,1,7
176,798139,20,1,8,1,4,0,4,0,0,0,2,5,1,1,0,0,2
176,786818,17,4,5,2,2,2,3,2,2,2,5,5,1,4,1,1,12
176,796587,4,1,2,1,2,0,0,2,2,0,1,0,1,0,1,1,4
176,786821,8,2,3,2,3,0,0,0,0,0,3,0,2,0,0,0,4
176,780192,14,4,6,4,4,0,2,0,0,1,3,0,1,0,1,0,8
176,780186,14,2,3,2,3,0,0,2,2,2,5,2,0,0,0,0,6
176,796584,11,4,4,1,1,3,3,0,0,0,2,0,1,0,0,0,11
176,796582,14,0,0,0,0,0,0,0,0,0,2,8,0,0,1,0,0
176,786820,11,0,2,0,0,0,2,0,0,0,1,1,0,0,2,0,0
176,780188,14,2,3,1,1,1,2,0,0,0,2,1,1,0,0,1,5
176,780184,14,3,8,1,1,2,7,0,0,0,1,2,2,1,0,0,8
176,780182,11,3,6,1,1,2,5,0,0,0,2,1,0,1,1,0,8
178,786566,33,6,12,4,9,2,3,6,6,4,3,2,1,0,3,1,20
178,781204,27,3,8,1,1,2,7,2,2,0,3,0,3,0,0,2,10
178,786568,21,4,7,4,7,0,0,0,0,3,3,0,2,1,1,0,8
178,781189,24,4,5,3,4,1,1,4,4,2,5,1,2,2,0,0,13
178,781188,34,6,11,5,9,1,2,0,1,0,6,8,4,1,4,0,13
178,791997,18,4,12,2,3,2,9,2,2,1,0,0,3,0,1,0,12
178,786567,1,0,0,0,0,0,0,0,0,0,0,0,0,0,0,0,0
178,798155,1,0,0,0,0,0,0,0,0,0,0,0,0,0,0,0,0
178,791993,24,4,6,4,6,0,0,0,0,2,0,3,3,0,0,0,8
178,791995,6,1,2,1,1,0,1,0,0,0,1,0,1,1,0,0,2
178,786565,1,0,0,0,0,0,0,0,0,0,1,0,0,0,0,0,0
178,786562,9,0,1,0,0,0,1,0,0,0,3,3,0,0,0,0,0
178,781186,1,0,0,0,0,0,0,0,0,0,0,0,0,0,1,0,0
179,786296,10,0,3,0,2,0,1,0,0,0,1,1,2,0,0,0,0
179,781530,21,4,16,3,14,1,2,2,3,1,4,0,1,1,1,0,11
179,776423,23,10,16,10,16,0,0,0,0,5,4,1,4,0,2,0,20
179,792307,17,2,6,1,2,1,4,0,0,1,1,1,1,1,1,0,5
179,792319,21,1,3,0,1,1,2,0,0,1,0,4,2,0,2,0,3
179,798109,1,0,0,0,0,0,0,0,0,0,1,0,0,0,0,0,0
179,792314,22,1,6,1,6,0,0,0,0,2,3,0,3,0,0,0,2
179,792320,11,3,5,2,4,1,1,0,0,1,2,0,0,1,0,0,7
179,798106,17,1,3,1,2,0,1,2,2,0,1,1,0,1,1,0,4
179,798104,23,1,5,0,2,1,3,4,5,1,0,1,0,0,1,0,7
179,798096,24,4,6,3,5,1,1,4,4,1,0,6,1,1,3,0,13
179,792321,10,0,0,0,0,0,0,0,0,0,1,1,1,1,0,0,0
180,792227,22,8,11,8,10,0,1,1,2,6,2,1,1,2,1,1,17
180,781352,14,3,6,3,6,0,0,2,2,1,4,1,3,0,1,0,8
180,785935,26,6,10,5,8,1,2,2,2,0,3,5,2,1,3,0,15
180,781340,19,4,7,4,6,0,1,0,0,0,1,1,3,2,1,0,8
180,776128,24,4,7,3,5,1,2,1,2,0,5,4,1,1,0,0,10
180,797881,14,3,4,3,4,0,0,1,2,2,3,0,2,0,0,0,7
180,797889,11,3,5,3,5,0,0,2,4,3,1,0,2,1,1,0,8
180,781351,18,1,5,1,5,0,0,5,6,1,2,2,1,0,0,0,7
180,797884,4,0,0,0,0,0,0,0,0,0,0,0,0,0,1,0,0
180,797882,8,0,2,0,0,0,2,0,0,0,0,0,1,0,2,0,0
180,792223,16,3,6,1,2,2,4,2,2,0,7,3,0,1,0,0,10
180,792228,15,3,5,2,4,1,1,1,3,0,3,0,3,3,2,1,8
180,786453,9,0,3,0,2,0,1,0,0,0,1,0,2,1,2,0,0
182,785523,18,5,6,5,6,0,0,3,4,1,3,1,3,0,3,0,13
182,791250,26,0,3,0,2,0,1,3,4,1,2,3,1,0,1,0,3
182,780703,25,7,14,7,10,0,4,5,6,5,4,2,3,1,0,0,19
182,791249,28,5,12,0,1,5,11,3,4,0,1,4,0,1,1,0,18
182,775358,23,1,3,1,1,0,2,1,4,0,3,0,4,2,1,0,3
182,796949,10,2,4,2,4,0,0,0,1,1,7,1,3,0,0,0,4
182,785522,12,1,1,1,1,0,0,0,0,2,3,0,3,0,0,0,2
182,781247,7,1,2,1,1,0,1,0,0,0,1,0,4,0,1,0,2
182,796947,17,3,4,3,4,0,0,1,2,0,1,2,0,1,0,0,7
182,796946,1,0,1,0,0,0,1,0,0,0,0,0,0,0,0,0,0
182,796944,12,1,4,1,3,0,1,1,2,0,1,1,1,0,2,1,3
182,785521,18,3,6,3,3,0,3,2,2,0,0,0,1,0,0,0,8
182,796945,1,0,0,0,0,0,0,0,0,0,0,0,0,0,0,0,0
182,796948,1,0,0,0,0,0,0,0,0,0,0,0,0,0,0,0,0
182,791247,1,0,0,0,0,0,0,0,0,0,0,0,0,0,0,0,0
184,781669,22,5,6,2,2,3,4,0,0,0,4,4,1,1,0,0,13
184,781672,13,5,6,5,6,0,0,3,4,1,4,2,1,1,1,0,13
184,792380,15,4,8,1,1,3,7,0,0,0,1,1,1,2,0,0,11
184,792379,17,2,6,1,2,1,4,0,0,3,2,2,1,2,0,0,5
184,786765,17,0,3,0,1,0,2,0,0,1,2,4,1,3,3,3,0
184,781671,18,6,7,3,3,3,4,0,0,0,0,1,1,1,1,0,15
184,792383,19,3,7,2,5,1,2,3,4,1,4,0,0,1,1,0,10
184,797852,17,5,10,5,7,0,3,0,0,0,0,1,0,3,2,0,10
184,797854,17,2,3,1,1,1,2,1,1,0,2,2,4,0,0,0,6
184,786764,13,1,6,0,0,1,6,0,0,0,2,3,1,1,0,0,3
184,797853,12,1,4,1,1,0,3,0,0,0,1,0,0,0,2,0,2
184,797860,9,1,2,1,2,0,0,0,0,0,4,3,3,0,4,0,2
184,781668,5,0,0,0,0,0,0,0,0,0,2,0,2,0,1,0,0
184,792384,3,0,2,0,1,0,1,0,0,1,1,0,0,0,2,0,0
184,797857,3,0,0,0,0,0,0,0,0,0,0,0,1,0,0,0,0
186,797490,20,3,10,3,9,0,1,1,1,4,4,0,3,0,4,0,7
186,791876,31,5,16,5,12,0,4,2,3,3,4,0,4,0,2,1,12
186,785667,20,2,5,1,2,1,3,0,0,1,1,2,3,0,2,1,5
186,786572,37,8,11,4,5,4,6,0,2,5,2,1,4,3,3,1,20
186,786570,32,2,9,2,4,0,5,5,7,1,4,10,4,0,7,0,9
186,791877,10,2,3,2,3,0,0,0,0,3,2,1,0,0,0,1,4
186,797486,8,0,1,0,0,0,1,0,0,0,1,1,0,0,2,0,0
186,797491,20,3,5,2,3,1,2,0,0,0,4,1,3,1,1,0,7
186,781205,10,2,5,2,5,0,0,1,1,0,2,0,1,0,0,2,5
186,797487,7,0,0,0,0,0,0,1,2,0,0,0,0,0,0,0,1
186,791878,5,0,3,0,1,0,2,0,0,2,0,0,0,0,1,1,0
187,786131,32,6,16,5,11,1,5,0,0,2,6,3,0,1,0,0,13
187,780904,29,5,5,5,5,0,0,1,2,3,3,3,4,1,1,2,11
187,797688,22,4,9,1,4,3,5,1,2,1,2,1,1,0,2,0,12
187,786145,21,3,5,0,0,3,5,0,0,0,0,1,0,0,2,0,9
187,786128,35,5,9,3,6,2,3,9,11,1,4,5,3,4,4,0,21
187,797685,22,3,8,3,7,0,1,4,5,1,1,2,1,1,1,0,10
187,792100,4,0,1,0,1,0,0,0,0,2,0,0,2,0,0,0,0
187,797686,16,1,4,1,2,0,2,2,4,0,1,1,0,2,0,0,4
187,775251,9,0,4,0,2,0,2,0,0,2,0,0,1,1,0,0,0
187,797684,6,0,0,0,0,0,0,0,0,1,4,0,4,1,1,0,0
187,792096,4,0,2,0,0,0,2,0,0,0,0,1,0,0,1,0,0
188,780717,33,8,16,6,11,2,5,6,11,2,4,4,4,2,2,0,24
188,786203,35,2,6,1,4,1,2,0,0,0,5,0,1,3,2,0,5
188,786197,12,1,5,1,5,0,0,2,2,1,3,0,3,0,1,0,4
188,776266,31,3,6,3,6,0,0,0,0,0,1,2,1,1,1,0,6
188,791742,35,6,12,5,9,1,3,0,0,2,2,1,1,4,2,2,13
188,776328,12,1,3,1,2,0,1,0,0,1,0,1,4,0,1,0,2
188,791741,5,0,1,0,1,0,0,0,0,0,0,1,0,1,1,0,0
188,791740,9,0,0,0,0,0,0,0,0,0,1,1,0,0,0,0,0
188,791738,25,3,6,3,6,0,0,2,5,3,6,0,2,0,0,2,8
188,786200,3,0,1,0,0,0,1,0,0,0,1,0,1,0,0,0,0
189,791425,23,3,5,2,4,1,1,3,4,2,3,1,1,0,1,0,10
189,791424,15,1,4,1,2,0,2,0,0,2,3,1,5,0,3,0,2
189,791421,33,4,8,2,5,2,3,1,2,0,4,2,1,1,5,0,11
189,785899,31,2,5,1,3,1,2,2,2,0,0,1,1,1,0,0,7
189,797085,22,1,6,0,1,1,5,0,0,0,3,2,4,0,2,0,3
189,797087,18,0,5,0,4,0,1,0,0,0,1,3,4,0,5,0,0
189,797088,6,0,1,0,0,0,1,0,0,0,1,0,0,0,1,0,0
189,785509,24,3,8,0,2,3,6,1,1,2,4,0,4,0,1,0,10
189,797086,3,0,1,0,0,0,1,0,0,0,1,0,0,0,0,0,0
189,797090,18,3,6,3,6,0,0,0,3,1,3,0,2,0,0,1,6
189,797079,7,0,0,0,0,0,0,0,0,1,0,1,1,0,1,0,0
190,797389,22,6,6,6,6,0,0,2,4,2,9,0,3,1,2,0,14
190,786785,30,9,18,9,15,0,3,0,1,4,6,2,1,0,1,1,18
190,786784,30,8,15,7,11,1,4,0,0,1,1,3,1,3,0,0,17
190,780633,9,0,1,0,0,0,1,1,2,0,1,1,0,0,0,1,1
190,776009,31,2,7,2,7,0,0,1,2,1,2,8,2,2,2,0,5
190,797387,8,0,1,0,1,0,0,0,2,0,2,0,2,1,1,0,0
190,780634,16,5,5,5,5,0,0,0,1,1,3,2,0,0,0,1,10
190,791826,33,7,7,7,7,0,0,1,3,0,4,7,2,2,1,0,15
190,797388,12,1,3,1,3,0,0,0,0,2,2,0,2,0,1,0,2
190,780635,4,0,0,0,0,0,0,0,0,0,1,0,0,1,0,0,0
190,797390,3,2,3,2,3,0,0,0,0,0,1,0,0,0,1,1,4
190,778644,2,0,0,0,0,0,0,0,0,1,0,0,0,0,0,0,0
190,791825,0,0,0,0,0,0,0,0,0,0,0,0,0,0,0,0,0
191,797378,21,1,3,1,3,0,0,0,0,0,1,3,1,0,4,0,2
191,797382,24,4,10,4,7,0,3,1,3,1,3,1,2,1,0,1,9
191,797379,18,3,5,3,5,0,0,0,2,4,4,1,0,0,1,0,6
191,786636,32,7,18,4,9,3,9,0,0,0,0,4,1,3,2,0,17
191,780646,24,1,4,1,3,0,1,0,0,1,1,3,4,1,1,0,2
191,789043,22,2,8,2,8,0,0,0,0,4,7,1,2,0,2,2,4
191,797380,16,3,8,0,2,3,6,1,1,0,2,0,2,0,0,0,10
191,797375,14,0,2,0,1,0,1,2,2,0,1,0,0,0,0,0,2
191,797376,9,0,2,0,1,0,1,0,0,0,0,1,1,0,1,0,0
191,797377,20,4,7,1,3,3,4,0,1,0,0,1,0,1,1,0,11
192,791903,24,2,5,1,3,1,2,0,0,0,5,2,0,1,1,0,5
192,797575,18,1,3,1,3,0,0,3,4,2,3,0,5,1,1,0,5
192,786514,17,1,3,1,1,0,2,0,0,0,2,0,1,0,1,0,2
192,786512,29,4,6,3,4,1,2,1,2,0,5,0,0,0,1,0,10
192,786032,27,4,12,4,11,0,1,5,6,2,1,2,2,1,2,1,13
192,797574,13,1,4,1,3,0,1,1,2,1,1,0,0,0,0,0,3
192,797573,19,1,4,1,4,0,0,2,2,2,4,0,3,1,1,1,4
192,791900,3,0,1,0,0,0,1,0,0,0,0,0,0,0,0,0,0
192,797571,13,2,3,2,3,0,0,0,0,0,3,2,0,0,2,0,4
192,791899,23,6,10,5,9,1,1,0,1,3,2,1,1,0,1,0,13
192,786435,14,1,6,1,6,0,0,0,0,2,2,1,1,0,2,0,2
193,785914,15,2,2,2,2,0,0,0,2,3,1,0,2,0,0,0,4
193,786183,31,4,8,1,4,3,4,0,0,1,2,1,3,0,2,0,11
193,780105,25,2,8,2,4,0,4,4,4,0,4,2,0,1,1,1,8
193,785915,27,1,8,0,0,1,8,2,2,0,2,0,2,1,0,0,5
193,785894,37,4,13,0,3,4,10,0,0,0,3,2,2,0,0,0,12
193,791408,25,5,9,5,9,0,0,0,0,0,4,2,3,1,1,0,10
193,791409,3,1,2,0,0,1,2,0,0,0,0,0,1,0,0,0,3
193,781131,37,5,10,3,5,2,5,0,1,1,5,9,0,1,4,0,12
194,791170,24,8,17,4,6,4,11,2,2,0,6,5,0,1,0,1,22
194,796837,29,8,13,6,9,2,4,2,2,5,7,0,3,0,2,0,20
194,780269,21,4,10,1,4,3,6,0,0,0,1,4,2,2,3,1,11
194,791171,15,3,5,3,5,0,0,1,1,2,2,2,5,0,3,1,7
194,785700,29,2,5,0,2,2,3,0,0,2,3,8,2,1,1,1,6
194,796838,13,3,6,3,5,0,1,1,1,4,1,1,5,1,1,1,7
194,796833,11,3,6,3,4,0,2,1,1,0,1,2,2,0,1,0,7
194,790511,20,3,8,3,8,0,0,0,2,4,6,3,3,0,1,1,6
194,796834,15,2,3,1,1,1,2,1,2,0,2,0,1,0,1,0,6
194,785706,12,1,4,0,1,1,3,2,2,0,1,1,1,0,0,0,5
194,796832,4,0,0,0,0,0,0,0,0,0,0,0,0,0,0,0,0
194,796835,4,0,1,0,0,0,1,0,0,0,0,0,0,0,0,0,0
194,791172,3,0,1,0,0,0,1,0,0,0,0,0,1,0,0,0,0
196,791815,20,8,11,4,6,4,5,2,2,1,3,2,1,0,0,0,22
196,781596,19,2,4,2,4,0,0,7,8,2,0,0,0,1,2,0,11
196,780650,23,5,11,5,8,0,3,2,3,2,9,4,3,2,4,0,12
196,791810,21,1,3,1,2,0,1,0,0,1,2,6,2,3,1,0,2
196,791814,15,4,6,1,3,3,3,0,0,1,1,0,0,0,0,0,11
196,797372,15,1,6,1,6,0,0,1,2,2,2,0,1,2,0,0,3
196,797373,13,1,3,0,0,1,3,0,0,1,0,0,2,2,2,0,3
196,791813,4,0,0,0,0,0,0,0,0,0,0,0,1,0,1,0,0
196,789086,3,0,0,0,0,0,0,0,0,0,0,0,0,0,0,0,0
196,786644,22,1,3,1,1,0,2,7,10,0,5,1,0,1,2,0,9
196,786645,5,0,0,0,0,0,0,0,0,0,1,0,0,0,0,0,0
196,791812,19,4,9,2,6,2,3,1,1,1,1,1,3,1,1,0,11
196,797374,6,0,2,0,0,0,2,2,2,0,1,0,0,1,0,0,2
196,791809,15,1,3,1,3,0,0,1,2,1,1,3,0,0,1,0,3
197,780956,29,6,11,6,10,0,1,2,3,2,5,0,1,0,5,1,14
197,797311,29,3,8,3,7,0,1,0,0,0,1,0,2,2,1,2,6
197,781617,14,1,6,1,5,0,1,0,0,2,2,0,5,2,2,0,2
197,797310,16,2,6,2,5,0,1,0,0,1,2,1,1,1,4,0,4
197,791724,18,1,3,1,2,0,1,0,0,0,1,1,5,0,1,1,2
197,797308,19,1,2,0,0,1,2,2,4,0,0,0,0,1,1,0,5
197,786277,1,0,0,0,0,0,0,0,0,0,0,0,0,0,0,0,0
197,786285,29,3,8,3,6,0,2,0,0,0,5,3,4,1,3,0,6
197,780706,25,2,4,1,2,1,2,2,2,0,4,1,0,1,4,0,7
197,791723,20,1,1,1,1,0,0,4,6,1,1,2,4,2,4,2,6
198,775642,15,2,5,2,3,0,2,0,0,0,3,2,3,0,1,0,4
198,785635,18,4,10,4,8,0,2,2,3,4,5,0,4,1,2,1,10
198,786440,32,6,17,5,9,1,8,4,4,0,1,1,1,2,0,1,17
198,786720,29,4,7,4,5,0,2,6,6,1,4,4,2,1,4,0,14
198,781199,30,12,22,8,12,4,10,7,7,1,6,4,1,0,3,0,35
198,796974,14,2,6,2,3,0,3,1,2,0,0,2,0,1,1,0,5
198,791628,22,2,6,0,1,2,5,0,0,1,1,1,3,2,1,0,6
198,786439,19,1,2,1,2,0,0,0,2,3,5,3,2,5,1,1,2
198,776462,13,1,3,1,2,0,1,2,4,2,5,0,4,1,0,1,4
198,796972,4,0,1,0,0,0,1,0,0,0,0,0,1,0,0,0,0
198,791626,4,0,0,0,0,0,0,2,2,0,1,0,0,0,0,0,2
199,796656,28,5,8,5,8,0,0,0,0,5,2,1,2,0,1,0,10
199,791321,12,1,1,1,1,0,0,2,2,2,0,0,5,1,2,0,4
199,791320,31,5,16,5,14,0,2,7,8,0,4,0,2,1,2,0,17
199,785912,28,4,12,4,9,0,3,6,7,0,4,1,4,1,6,0,14
199,781511,32,6,19,5,13,1,6,0,0,0,6,5,2,1,4,0,13
199,796657,12,1,3,0,1,1,2,0,0,0,3,0,5,0,3,0,3
199,796653,20,1,2,0,1,1,1,2,2,0,4,1,2,2,1,1,5
199,796652,7,1,2,1,2,0,0,0,0,0,2,0,0,0,2,0,2
199,796655,5,0,1,0,0,0,1,0,0,0,0,0,1,0,2,0,0
199,791323,17,0,1,0,1,0,0,1,2,1,3,3,1,1,0,0,1
199,796651,7,0,1,0,0,0,1,0,0,0,0,0,1,0,0,0,0
199,796654,1,0,0,0,0,0,0,0,0,0,0,0,0,0,0,0,0
200,796404,34,7,10,7,9,0,1,2,3,4,4,2,1,2,2,1,16
200,785434,27,3,8,1,5,2,3,0,0,0,4,0,4,0,3,1,8
200,790853,10,1,2,1,2,0,0,0,0,0,2,0,2,0,0,1,2
200,781164,27,4,6,3,4,1,2,2,2,0,2,4,3,0,2,0,11
200,781163,34,6,17,5,14,1,3,2,4,3,4,6,0,1,3,0,15
200,796406,23,2,3,2,3,0,0,0,2,4,7,0,1,0,2,0,4
200,790850,24,2,9,2,8,0,1,7,7,1,0,1,1,0,0,0,11
200,781162,12,1,2,0,1,1,1,1,4,1,1,1,1,2,0,0,4
200,796405,3,0,0,0,0,0,0,0,0,0,1,0,0,0,0,0,0
200,790854,6,0,1,0,1,0,0,0,0,0,3,0,1,0,1,0,0
201,780063,35,2,7,2,3,0,4,0,0,0,10,0,2,0,1,2,4
201,791058,10,1,3,1,3,0,0,0,0,1,2,0,3,0,1,0,2
201,775926,28,3,7,0,1,3,6,0,0,0,4,2,3,0,3,0,9
201,785530,37,5,16,4,9,1,7,10,11,0,4,1,4,1,0,0,21
201,791055,29,1,2,1,2,0,0,0,0,1,1,4,1,4,3,0,2
201,785532,22,4,8,4,8,0,0,1,3,2,3,0,2,0,0,1,9
201,796733,5,1,2,1,1,0,1,0,0,0,0,1,1,1,0,0,2
201,791056,3,0,0,0,0,0,0,0,0,0,0,0,0,1,1,0,0
201,791057,5,0,1,0,1,0,0,0,0,0,0,0,1,0,1,0,0
201,775573,19,4,10,2,3,2,7,0,0,0,0,1,2,1,1,0,10
201,791059,7,2,2,2,2,0,0,0,0,1,1,0,1,0,0,0,4
202,780119,20,6,9,6,9,0,0,1,3,3,1,2,0,3,0,0,13
202,775679,15,5,9,1,3,4,6,1,1,2,5,0,0,0,1,0,15
202,776097,17,4,7,2,4,2,3,2,3,1,4,6,3,1,2,0,12
202,796559,24,3,12,2,6,1,6,9,10,2,1,2,3,3,0,0,16
202,785280,20,8,10,6,7,2,3,1,1,1,1,2,0,3,0,0,19
202,796560,20,3,5,1,1,2,4,1,1,2,8,1,0,0,1,0,9
202,796561,18,5,8,2,3,3,5,2,2,0,2,3,0,1,1,0,15
202,780149,24,3,7,1,2,2,5,5,8,2,3,7,4,0,1,0,13
202,785536,18,8,11,4,6,4,5,3,3,3,5,0,0,0,0,3,23
202,796558,12,2,5,2,4,0,1,1,1,1,2,2,1,0,1,0,5
202,785285,7,1,1,1,1,0,0,0,0,2,1,0,1,0,0,1,2
202,781908,3,0,1,0,0,0,1,0,0,0,1,1,0,0,0,0,0
202,796562,1,0,1,0,0,0,1,0,0,0,0,0,0,0,0,0,0
202,792636,1,0,0,0,0,0,0,0,0,0,1,0,0,0,0,0,0
203,799130,37,5,17,2,8,3,9,0,2,1,1,2,1,0,5,0,13
203,799136,11,0,1,0,1,0,0,0,0,1,3,0,5,0,2,0,0
203,799129,36,6,18,3,6,3,12,0,0,1,1,3,2,2,6,1,15
203,799134,15,3,9,2,6,1,3,0,0,1,1,1,4,0,3,2,7
203,792634,28,3,9,0,4,3,5,1,2,2,1,1,4,0,2,1,10
203,799133,26,2,7,1,3,1,4,2,2,1,4,3,2,0,1,1,7
203,799131,15,0,1,0,1,0,0,0,0,1,4,1,3,0,1,0,0
203,799132,23,4,9,2,3,2,6,0,0,2,2,0,4,0,1,0,10
203,799135,9,0,1,0,1,0,0,0,0,1,1,1,1,1,0,1,0
204,780125,16,2,4,2,4,0,0,1,4,2,1,1,3,2,1,1,5
204,791401,30,10,16,10,16,0,0,6,11,7,4,3,2,0,2,1,26
204,780118,28,4,9,3,4,1,5,0,2,0,6,4,0,1,2,0,9
204,791400,22,3,4,3,3,0,1,2,2,0,2,2,1,1,1,0,8
204,785931,25,5,8,3,5,2,3,0,0,0,5,2,1,0,0,0,12
204,786837,21,4,6,3,4,1,2,0,0,0,1,3,0,2,0,0,9
204,797130,14,2,5,1,1,1,4,0,0,0,0,2,0,1,0,0,5
204,797126,11,1,2,1,2,0,0,0,2,0,1,0,1,1,2,2,2
204,797125,19,6,9,6,7,0,2,1,1,0,2,2,3,0,0,0,13
204,797132,11,0,2,0,0,0,2,0,0,0,1,3,0,1,0,0,0
204,792671,1,0,0,0,0,0,0,0,0,0,0,0,0,0,0,0,0
204,791399,2,0,0,0,0,0,0,0,0,0,0,0,0,0,0,0,0
205,797825,10,1,1,1,1,0,0,2,2,1,0,0,4,0,1,0,4
205,775116,30,3,11,2,4,1,7,0,0,2,4,0,3,0,2,0,7
205,797830,32,5,10,4,5,1,5,2,4,0,3,1,2,1,6,0,13
205,781266,18,0,4,0,2,0,2,0,0,0,0,1,0,0,0,0,0
205,792190,36,7,14,6,12,1,2,2,3,1,3,3,2,1,3,1,17
205,792192,23,2,3,2,3,0,0,2,2,3,9,2,3,1,0,1,6
205,797824,20,4,8,2,2,2,6,0,0,0,2,0,2,0,1,0,10
205,797827,15,1,5,1,2,0,3,0,0,0,0,1,0,0,3,0,2
205,792191,15,0,1,0,1,0,0,0,0,0,3,1,1,0,1,0,0
205,799164,1,0,0,0,0,0,0,0,0,0,0,0,0,0,0,0,0
206,796469,24,2,9,2,6,0,3,7,9,2,8,0,3,0,5,0,11
206,790923,23,6,6,6,6,0,0,2,2,0,8,0,4,1,1,0,14
206,779981,19,1,3,1,3,0,0,2,6,2,8,0,4,1,2,1,4
206,785463,36,7,11,5,7,2,4,4,5,1,4,7,2,1,4,1,20
206,779978,34,6,10,4,5,2,5,3,4,0,1,5,2,1,1,1,17
206,785466,16,1,4,1,3,0,1,1,2,2,3,1,3,1,2,0,3
206,779980,9,2,2,2,2,0,0,1,3,1,6,0,2,0,0,1,5
206,790924,13,2,3,1,2,1,1,2,3,0,0,0,3,0,1,0,7
206,785462,26,4,6,2,3,2,3,0,0,1,5,3,1,0,1,0,10
207,781319,16,3,6,3,6,0,0,0,1,2,0,0,4,1,1,0,6
207,792220,29,4,12,3,7,1,5,1,2,3,2,0,1,0,2,0,10
207,786691,23,2,5,1,2,1,3,8,14,0,7,1,1,2,2,0,13
207,786693,18,2,9,2,8,0,1,0,0,1,2,0,3,1,0,0,4
207,781329,24,0,7,0,6,0,1,2,3,0,4,0,5,1,1,0,2
207,792219,9,1,2,1,2,0,0,0,0,0,1,0,2,0,0,0,2
207,792046,19,4,13,2,6,2,7,0,0,0,1,2,1,2,1,1,10
207,792221,2,0,1,0,1,0,0,0,0,0,0,0,0,0,0,0,0
207,792222,12,1,4,1,2,0,2,0,1,2,0,0,5,1,1,0,2
207,781455,16,0,4,0,4,0,0,0,0,0,1,0,1,0,0,0,0
207,786843,9,1,2,1,2,0,0,0,1,1,0,0,0,0,0,0,2
207,797876,20,0,4,0,2,0,2,4,4,5,2,1,3,1,0,0,4
207,776059,2,0,0,0,0,0,0,0,0,0,0,0,1,0,0,0,0
207,792447,1,0,0,0,0,0,0,0,0,0,0,0,0,0,0,0,0
208,775640,15,4,6,4,6,0,0,0,0,2,5,2,5,0,1,1,8
208,780919,20,3,8,3,7,0,1,1,2,1,3,2,4,1,1,0,7
208,785803,25,3,5,1,1,2,4,0,0,0,1,2,2,0,0,1,8
208,780920,30,8,12,7,10,1,2,3,3,1,2,5,2,2,2,0,20
208,791142,28,3,7,1,3,2,4,1,1,2,4,3,2,1,1,0,9
208,791141,21,3,8,2,4,1,4,4,4,2,5,3,0,0,0,0,11
208,775816,24,4,14,1,9,3,5,0,0,2,2,1,2,0,1,0,11
208,796797,15,2,8,1,5,1,3,5,5,3,3,1,3,0,1,1,10
208,796799,12,0,2,0,1,0,1,0,0,0,0,1,2,0,1,2,0
208,796801,3,0,2,0,2,0,0,0,0,0,0,0,0,0,0,0,0
208,775639,3,0,0,0,0,0,0,0,0,1,0,0,0,0,0,0,0
208,796802,1,0,0,0,0,0,0,0,0,0,1,0,0,0,0,0,0
208,796796,3,0,1,0,0,0,1,0,0,0,1,0,0,0,0,0,0
209,780828,35,7,22,6,15,1,7,9,11,2,4,1,1,0,3,3,24
209,792027,24,5,10,4,8,1,2,1,2,4,5,3,3,1,2,0,12
209,792032,35,3,11,3,6,0,5,3,4,1,5,3,3,0,1,0,9
209,785822,17,0,2,0,2,0,0,0,2,2,3,1,1,0,0,3,0
209,792031,27,2,7,2,3,0,4,1,1,0,6,0,2,0,3,0,5
209,792030,15,0,1,0,1,0,0,0,0,0,2,0,2,0,0,0,0
209,792029,6,0,1,0,1,0,0,0,0,0,0,0,3,0,2,1,0
209,797641,14,2,2,2,2,0,0,2,2,3,2,1,1,0,2,0,6
209,797637,8,1,3,0,1,1,2,0,0,0,0,0,0,0,0,0,3
209,761149,17,0,1,0,1,0,0,2,2,0,0,0,0,1,0,0,2
209,797636,1,0,0,0,0,0,0,0,0,0,0,0,0,0,0,0,0
209,797642,1,0,0,0,0,0,0,0,0,0,0,0,0,0,0,0,0
210,785126,18,2,3,1,1,1,2,0,0,2,1,7,2,1,1,0,5
210,785338,16,5,5,5,5,0,0,1,2,1,5,2,1,0,0,1,11
210,785339,19,3,6,1,2,2,4,0,0,0,3,1,1,0,0,0,8
210,774990,21,6,13,3,6,3,7,0,0,0,0,4,4,0,0,0,15
210,779976,22,10,14,7,9,3,5,2,2,1,4,2,0,0,0,0,25
210,781586,14,2,2,2,2,0,0,0,0,3,4,1,2,0,1,0,4
210,796673,13,2,3,0,0,2,3,0,1,2,0,0,1,0,0,0,6
210,796674,17,2,7,2,3,0,4,1,2,0,5,3,1,4,2,0,5
210,791014,19,3,8,1,1,2,7,0,2,0,3,3,1,1,1,0,8
210,785961,11,3,3,1,1,2,2,2,2,0,2,1,0,0,0,0,10
210,786737,10,1,4,0,1,1,3,2,2,0,3,0,1,0,0,0,5
210,796672,7,1,1,0,0,1,1,0,0,1,1,0,1,0,1,1,3
210,780142,9,1,2,0,1,1,1,0,1,0,0,2,3,0,0,0,3
210,791016,4,0,0,0,0,0,0,0,0,0,1,1,0,0,0,0,0
212,786041,29,3,5,3,5,0,0,2,2,0,7,2,1,1,1,1,8
212,780881,22,4,7,1,1,3,6,1,4,0,4,6,2,1,0,1,12
212,780275,21,3,5,3,5,0,0,0,0,3,1,2,1,0,2,2,6
212,792075,30,1,7,0,2,1,5,6,6,1,3,3,4,0,6,1,9
212,786686,34,11,15,8,11,3,4,8,8,0,4,5,0,0,4,0,33
212,780882,20,6,9,5,6,1,3,2,2,1,2,1,2,2,2,0,15
212,792074,24,3,5,0,0,3,5,2,2,1,4,1,1,0,0,0,11
212,780884,8,0,2,0,0,0,2,0,0,1,4,1,2,0,1,0,0
212,786051,10,0,2,0,2,0,0,3,4,4,2,1,1,0,0,0,3
212,792076,2,0,2,0,0,0,2,0,0,0,0,0,0,0,0,0,0
213,797367,18,2,4,2,4,0,0,2,4,0,0,3,3,0,2,1,6
213,797364,18,2,4,2,3,0,1,0,0,1,1,2,2,1,1,1,4
213,797369,13,0,3,0,1,0,2,1,2,0,2,4,3,0,1,0,1
213,791807,25,3,6,1,1,2,5,0,0,1,2,0,4,2,0,0,8
213,786130,29,12,23,6,11,6,12,6,8,0,2,1,1,0,1,0,36
213,797368,18,2,2,2,2,0,0,0,0,3,1,0,4,0,1,0,4
213,786127,7,0,1,0,1,0,0,0,0,1,1,0,2,0,2,0,0
213,797363,24,1,8,1,5,0,3,1,2,0,1,2,2,1,2,0,3
213,797366,12,0,2,0,2,0,0,0,0,1,1,1,1,1,1,0,0
213,791808,16,0,4,0,2,0,2,0,0,1,1,1,1,1,0,1,0
213,791804,13,1,2,1,2,0,0,0,0,0,1,0,2,1,0,0,2
213,797365,4,0,2,0,0,0,2,1,2,0,1,0,0,1,1,1,1
213,797371,3,1,1,1,1,0,0,0,0,0,1,0,1,0,0,0,2
214,780950,26,5,10,3,4,2,6,2,2,3,4,1,1,1,0,1,14
214,780952,17,5,6,5,6,0,0,2,4,3,4,0,3,0,1,1,12
214,791155,31,7,12,6,8,1,4,5,7,3,5,2,2,3,2,1,20
214,796810,30,5,13,2,5,3,8,4,4,0,0,6,2,4,4,0,17
214,791156,24,2,5,1,3,1,2,1,2,1,0,3,2,0,1,1,6
214,785752,26,6,10,3,5,3,5,0,0,0,2,3,2,1,3,0,15
214,796814,19,2,4,2,3,0,1,0,0,1,4,6,3,0,3,1,4
214,796812,17,4,6,4,6,0,0,0,1,5,2,1,2,0,1,1,8
214,780945,3,0,0,0,0,0,0,2,2,0,0,0,2,0,0,0,2
214,796813,3,2,2,2,2,0,0,0,0,1,1,0,1,0,0,0,4
214,791158,2,0,0,0,0,0,0,0,0,1,1,0,1,0,0,0,0
214,796811,2,0,0,0,0,0,0,0,0,0,0,0,0,0,0,0,0
215,791089,17,3,4,2,3,1,1,0,0,0,2,0,2,1,4,0,7
215,791097,19,0,3,0,2,0,1,1,4,0,2,1,3,1,2,1,1
215,785569,27,2,8,2,6,0,2,3,4,0,1,0,2,0,0,0,7
215,796753,18,2,7,1,3,1,4,0,2,1,2,1,3,1,0,0,5
215,796752,21,2,6,2,5,0,1,0,1,1,1,5,3,1,4,0,4
215,791090,27,7,11,5,8,2,3,1,1,0,1,0,1,1,2,0,17
215,791091,24,3,4,3,3,0,1,0,0,0,0,2,2,1,2,0,6
215,791094,27,4,5,0,1,4,4,2,3,0,4,1,3,3,3,0,14
215,785577,20,3,4,3,4,0,0,8,8,2,0,1,4,0,2,2,14
216,781505,30,6,8,4,6,2,2,4,5,4,4,2,2,0,4,0,18
216,791317,36,5,15,4,10,1,5,0,0,0,4,8,0,5,3,1,11
216,777573,22,3,5,1,2,2,3,0,0,0,0,2,0,0,0,0,8
216,780353,25,2,8,2,7,0,1,2,4,4,13,0,2,0,1,1,6
216,776279,22,1,6,0,2,1,4,1,2,2,1,2,4,1,2,0,4
216,790851,18,3,5,3,4,0,1,2,2,1,0,1,1,0,0,1,8
216,796648,14,1,5,1,2,0,3,3,3,0,2,0,1,0,0,0,5
216,786222,10,2,2,2,2,0,0,1,2,1,4,0,0,0,1,0,5
216,785966,12,1,5,1,4,0,1,2,4,1,3,1,3,0,0,0,4
216,796649,3,0,0,0,0,0,0,0,0,0,0,0,1,0,1,0,0
216,796647,3,0,0,0,0,0,0,0,0,0,0,0,2,0,0,0,0
216,796646,3,0,1,0,0,0,1,0,0,0,0,0,1,0,0,0,0
216,791318,2,0,1,0,0,0,1,0,0,0,1,0,0,0,0,0,0
217,792627,19,5,10,5,8,0,2,2,3,2,2,0,0,1,1,1,12
217,792632,29,5,8,5,8,0,0,0,2,1,1,1,1,7,0,2,10
217,781491,27,2,7,1,5,1,2,3,4,1,3,0,2,0,1,0,8
217,781289,28,1,2,1,2,0,0,0,0,1,5,0,3,0,0,3,2
217,792626,22,0,4,0,4,0,0,1,2,1,5,4,1,0,3,0,1
217,780250,26,4,9,4,5,0,4,4,6,0,2,0,3,2,0,0,12
217,796645,14,3,8,3,7,0,1,0,2,0,1,0,2,0,0,0,6
217,796638,18,1,7,1,6,0,1,0,0,2,2,0,0,0,1,0,2
217,796634,8,0,4,0,4,0,0,0,0,1,0,0,3,0,1,0,0
217,796642,4,0,1,0,1,0,0,0,0,0,0,0,0,0,2,0,0
217,796637,3,0,0,0,0,0,0,0,0,0,1,0,0,0,0,0,0
217,792631,2,0,0,0,0,0,0,0,0,0,0,0,0,0,0,0,0
218,790893,30,6,12,6,9,0,3,2,9,5,5,1,3,0,0,1,14
218,796444,39,10,15,9,13,1,2,0,2,4,5,3,3,1,5,3,21
218,790890,34,4,7,3,4,1,3,2,2,0,5,4,3,1,4,0,11
218,786615,30,4,8,4,7,0,1,4,7,1,8,3,1,0,1,0,12
218,775260,35,5,8,3,3,2,5,6,6,0,1,4,2,1,3,0,18
218,775536,12,1,4,1,4,0,0,1,2,1,0,1,1,0,2,0,3
218,786732,18,4,6,3,4,1,2,1,2,4,3,0,0,0,2,0,10
218,790889,12,1,3,1,1,0,2,0,0,0,1,2,0,1,0,0,2
218,780702,15,2,3,2,2,0,1,0,0,1,2,1,0,0,0,0,4
219,774806,28,6,11,6,11,0,0,1,2,1,7,1,5,1,0,1,13
219,775823,30,2,4,2,4,0,0,1,1,3,2,3,3,0,2,0,5
219,791041,32,3,11,0,2,3,9,0,0,2,3,0,5,1,5,0,9
219,791038,41,4,15,1,4,3,11,0,1,0,1,9,4,0,1,0,11
219,789023,43,11,21,2,6,9,15,1,1,0,1,4,2,1,1,0,32
219,796714,11,1,2,1,2,0,0,0,0,0,2,0,3,1,0,0,2
219,775205,30,5,7,0,1,5,6,0,0,1,2,1,1,2,0,0,15
219,796716,8,0,0,0,0,0,0,0,0,1,1,0,2,0,2,0,0
219,785922,2,0,0,0,0,0,0,0,0,0,0,0,0,0,0,0,0
220,790771,28,3,4,2,2,1,2,0,0,2,2,0,0,2,0,4,7
220,780271,37,0,2,0,1,0,1,3,4,2,10,0,1,2,0,4,3
220,790772,33,7,14,5,6,2,8,0,0,1,3,2,2,0,0,1,16
220,785230,21,4,13,2,8,2,5,1,1,0,1,0,4,0,2,0,11
220,780022,27,6,11,4,6,2,5,1,2,1,5,3,3,1,1,0,15
220,796328,9,0,0,0,0,0,0,0,0,0,1,2,2,1,2,0,0
220,767736,16,3,5,3,4,0,1,0,1,0,1,1,1,0,2,0,6
220,790774,5,0,0,0,0,0,0,0,0,0,1,0,0,0,0,0,0
220,780375,24,3,6,2,2,1,4,2,3,0,0,2,3,0,3,0,9
220,796329,0,0,0,0,0,0,0,0,0,0,0,0,0,0,0,0,0
221,791981,26,9,14,9,14,0,0,0,0,6,4,1,3,1,2,2,18
221,780342,28,3,6,2,5,1,1,0,3,1,8,1,4,0,1,1,7
221,791982,36,5,10,3,4,2,6,2,3,0,0,1,4,0,1,0,14
221,780333,38,5,16,4,10,1,6,4,4,1,2,7,0,1,1,0,15
221,781493,36,5,9,3,3,2,6,2,2,0,3,1,3,1,1,0,14
221,791984,4,0,0,0,0,0,0,0,0,0,1,0,1,0,2,0,0
221,786756,16,2,4,0,0,2,4,0,0,1,4,1,1,0,0,0,6
221,786755,16,1,1,1,1,0,0,0,0,0,1,0,1,0,0,0,2
222,781579,31,5,8,5,6,0,2,3,4,0,4,3,3,0,3,0,13
222,786731,28,5,12,5,12,0,0,7,12,5,5,1,2,0,2,1,17
222,798023,24,4,9,4,7,0,2,2,2,0,1,0,4,0,4,0,10
222,781584,21,3,7,1,2,2,5,0,0,2,1,1,1,0,1,0,8
222,780347,34,2,5,2,4,0,1,2,4,0,5,0,2,1,4,0,6
222,792361,0,0,1,0,0,0,1,0,0,0,0,0,0,0,0,0,0
222,775696,14,0,2,0,1,0,1,0,0,1,0,1,1,0,0,0,0
222,798026,1,1,1,1,1,0,0,0,0,0,0,0,0,0,0,0,2
222,776481,5,0,0,0,0,0,0,0,0,0,1,1,0,0,0,0,0
222,798017,4,0,2,0,0,0,2,0,0,1,1,0,1,0,0,0,0
222,798008,20,2,4,1,2,1,2,0,0,1,3,0,2,0,2,0,5
222,792358,18,2,5,1,4,1,1,3,4,0,0,1,3,2,2,0,8
223,780178,8,1,3,1,3,0,0,0,0,0,1,0,3,0,2,0,2
223,775075,18,3,4,3,4,0,0,2,2,0,0,0,3,0,0,3,8
223,792376,30,6,12,1,2,5,10,6,7,0,2,1,2,2,2,0,23
223,797883,25,1,6,1,5,0,1,1,2,1,3,7,1,2,2,0,3
223,786747,31,4,8,2,3,2,5,0,0,1,5,1,3,1,1,0,10
223,797890,9,1,1,0,0,1,1,2,2,0,2,0,1,0,1,0,5
223,792378,11,1,2,1,2,0,0,0,0,0,1,1,0,0,0,4,2
223,797888,9,1,2,1,1,0,1,4,4,0,1,2,1,0,0,0,6
223,786746,28,6,10,4,5,2,5,1,1,1,4,4,3,1,3,0,15
223,785744,6,0,0,0,0,0,0,1,2,0,1,0,3,0,1,0,1
223,792374,18,4,4,4,4,0,0,0,0,0,2,0,2,4,1,0,8
223,797885,7,0,1,0,0,0,1,2,2,0,0,0,1,0,1,0,2
224,776004,23,3,7,2,5,1,2,2,2,2,6,2,3,0,2,0,9
224,780358,30,6,10,4,7,2,3,4,5,2,7,1,2,1,0,5,18
224,775011,18,0,4,0,2,0,2,1,2,1,2,2,1,0,1,1,1
224,780357,30,2,8,0,3,2,5,0,0,0,5,1,2,0,1,0,6
224,775018,29,2,6,1,2,1,4,6,8,0,2,5,1,3,0,0,11
224,796480,15,4,7,4,6,0,1,0,0,1,1,1,1,1,2,1,8
224,796484,17,4,5,3,3,1,2,4,4,0,2,1,1,0,0,1,13
224,790930,19,2,6,2,3,0,3,5,6,0,0,0,1,1,0,2,9
224,776270,11,0,1,0,1,0,0,0,2,0,3,3,1,0,0,0,0
224,796485,5,1,2,1,2,0,0,0,0,1,0,0,1,0,1,0,2
224,796483,2,0,1,0,0,0,1,0,0,0,0,0,1,0,0,0,0
224,785496,1,0,0,0,0,0,0,0,0,0,0,0,0,0,0,0,0
225,775324,11,1,2,1,2,0,0,0,0,3,1,0,3,0,1,0,2
225,791223,24,3,9,3,9,0,0,2,2,5,5,0,3,0,1,1,8
225,785571,31,9,16,8,15,1,1,3,3,0,4,3,0,0,2,1,22
225,786436,25,1,6,0,4,1,2,6,6,1,2,2,3,0,1,0,9
225,781181,31,1,10,0,1,1,9,0,0,0,2,0,4,1,2,1,3
225,791225,23,5,10,3,7,2,3,2,2,0,5,0,0,3,1,1,14
225,791224,20,2,5,2,5,0,0,2,2,1,1,3,3,0,1,0,6
225,785564,15,1,5,0,2,1,3,0,0,0,3,0,1,0,0,0,3
225,791811,10,0,2,0,2,0,0,0,0,0,0,0,1,0,0,0,0
225,796927,10,0,1,0,0,0,1,0,0,0,2,0,2,0,1,0,0
226,791823,22,2,2,2,2,0,0,3,4,1,2,1,3,0,0,0,7
226,786635,18,4,6,4,5,0,1,1,1,2,1,3,1,0,1,0,9
226,791822,31,5,12,1,1,4,11,0,1,1,2,4,1,1,0,0,14
226,780642,28,6,11,5,8,1,3,3,4,1,4,5,1,0,4,1,16
226,776449,25,7,10,5,7,2,3,0,2,2,8,4,4,3,2,1,16
226,798157,20,1,1,1,1,0,0,4,8,1,3,2,1,0,0,2,6
226,797383,19,5,8,4,7,1,1,1,1,4,3,0,0,0,1,0,12
226,791821,5,0,0,0,0,0,0,0,0,0,0,0,0,0,0,0,0
226,797384,18,5,10,4,7,1,3,5,6,4,1,1,1,1,3,0,16
226,786632,14,2,5,1,1,1,4,0,0,0,3,3,1,0,2,0,5
228,797823,20,4,5,3,4,1,1,0,0,3,5,0,3,0,1,1,9
228,780505,38,7,25,4,11,3,14,11,13,0,7,3,2,0,7,0,28
228,792283,26,2,5,1,2,1,3,3,4,0,1,0,2,0,0,1,8
228,792280,23,0,5,0,2,0,3,0,3,0,3,2,2,1,3,0,0
228,785950,31,1,1,1,1,0,0,9,9,2,4,0,3,2,0,0,11
228,785701,16,0,1,0,0,0,1,0,2,2,2,0,0,0,1,0,0
228,792284,24,0,5,0,1,0,4,0,0,0,6,3,1,0,2,1,0
228,792286,12,0,0,0,0,0,0,0,0,0,2,0,2,0,1,0,0
228,797831,4,0,2,0,1,0,1,0,0,1,2,0,0,1,0,0,0
228,792287,1,0,0,0,0,0,0,0,0,0,0,0,0,0,1,0,0
228,797826,5,0,1,0,0,0,1,0,0,0,0,0,1,0,0,0,0
229,780263,27,3,8,2,4,1,4,3,3,1,6,0,3,2,4,1,10
229,786697,24,3,6,1,2,2,4,0,0,0,5,4,4,0,5,0,8
229,775628,37,3,14,3,13,0,1,4,5,2,7,0,3,4,2,1,10
229,785471,25,4,7,3,5,1,2,1,2,3,4,2,5,0,0,0,10
229,799000,23,1,8,1,8,0,0,0,0,1,3,0,3,2,2,1,2
229,792399,18,3,6,2,5,1,1,0,0,0,1,0,5,1,2,0,7
229,775547,8,0,4,0,0,0,4,0,0,1,1,0,0,0,0,0,0
229,775198,19,1,6,1,5,0,1,3,3,1,3,0,2,1,2,0,5
229,792400,11,0,0,0,0,0,0,0,0,0,1,0,2,0,0,0,0
229,780571,3,0,1,0,0,0,1,0,0,0,0,0,0,0,0,0,0
229,792397,5,0,1,0,0,0,1,0,0,0,1,1,1,1,0,0,0
230,781034,33,4,8,2,3,2,5,3,6,0,6,1,2,2,3,1,13
230,776200,19,2,8,2,8,0,0,2,3,2,1,0,2,2,1,0,6
230,780446,22,5,10,1,1,4,9,0,0,0,2,0,0,1,1,0,14
230,791622,6,1,1,1,1,0,0,0,0,0,0,1,3,1,1,0,2
230,780925,14,1,2,1,2,0,0,2,2,1,1,2,3,1,0,0,4
230,791625,6,0,1,0,0,0,1,0,0,1,0,0,1,0,0,0,0
230,791624,9,1,2,0,1,1,1,0,0,0,1,0,1,0,0,0,3
230,786437,13,0,1,0,1,0,0,1,4,1,0,0,0,0,1,0,1
230,796979,20,1,6,1,4,0,2,0,1,0,5,2,2,1,2,1,2
230,791637,2,0,0,0,0,0,0,0,0,0,0,0,0,0,0,0,0
230,796980,26,2,11,2,11,0,0,2,2,3,4,1,3,2,3,1,6
230,785620,30,2,9,2,7,0,2,4,4,1,3,1,2,3,3,0,8
231,780564,22,1,3,1,3,0,0,0,0,2,4,1,1,1,1,0,2
231,780565,33,1,5,1,3,0,2,3,6,1,2,2,1,1,3,0,5
231,780570,25,5,11,5,11,0,0,0,0,1,8,1,2,0,3,0,10
231,781556,19,0,3,0,3,0,0,0,0,0,3,0,3,1,4,0,0
231,780569,33,7,12,7,12,0,0,2,2,2,7,2,3,1,5,0,16
231,797438,23,1,4,1,2,0,2,0,1,1,4,0,3,1,1,0,2
231,791695,10,2,3,2,3,0,0,1,2,0,2,0,1,0,1,0,5
231,797434,8,0,2,0,1,0,1,2,2,1,1,1,3,0,2,1,2
231,791697,27,5,11,4,9,1,2,7,7,0,4,1,1,2,2,1,18
232,791416,22,4,6,4,6,0,0,6,9,4,7,0,1,0,3,2,14
232,797096,24,5,9,3,4,2,5,3,3,1,1,0,3,0,2,0,15
232,785906,27,8,13,8,11,0,2,6,7,1,5,7,2,2,2,0,22
232,780100,23,2,2,1,1,1,1,0,1,3,6,2,0,0,1,0,5
232,780096,27,4,7,0,0,4,7,2,2,0,4,1,1,1,1,1,14
232,785907,13,2,3,2,3,0,0,0,0,2,1,1,2,1,1,0,4
232,781614,16,1,3,1,2,0,1,0,0,0,5,2,0,1,0,0,2
232,797093,20,9,13,9,12,0,1,0,0,2,5,1,3,1,4,0,18
232,797094,10,0,1,0,0,0,1,0,0,0,0,1,0,0,0,0,0
232,785903,5,1,1,1,1,0,0,0,0,1,0,0,1,0,1,0,2
232,797095,4,0,2,0,2,0,0,0,0,1,1,1,0,0,2,0,0
232,791417,4,0,0,0,0,0,0,1,2,0,2,0,1,0,0,0,1
232,797097,2,0,0,0,0,0,0,0,0,0,0,0,0,0,0,0,0
232,797098,3,0,0,0,0,0,0,0,0,0,0,0,0,0,1,0,0
233,796774,24,0,1,0,0,0,1,0,0,0,1,0,2,0,0,0,0
233,792695,17,3,7,3,6,0,1,1,5,1,0,0,1,1,2,1,7
233,792699,22,0,4,0,2,0,2,1,3,0,1,1,4,1,3,0,1
233,792701,30,3,9,2,5,1,4,0,0,0,1,4,3,0,1,0,7
233,792700,2,0,0,0,0,0,0,0,0,0,0,0,0,0,0,0,0
233,796776,19,4,7,3,5,1,2,0,0,0,0,0,5,2,2,0,9
233,796775,22,2,8,2,5,0,3,0,0,0,1,0,2,1,2,0,4
233,792698,28,3,8,1,3,2,5,2,2,0,0,1,1,1,4,0,10
233,792702,18,0,6,0,3,0,3,0,0,0,2,0,2,3,1,0,0
233,792704,18,0,4,0,1,0,3,0,0,0,1,0,2,0,0,0,0
234,790799,19,1,1,1,1,0,0,0,0,1,3,0,2,1,3,0,2
234,790798,32,11,15,11,14,0,1,3,4,2,4,1,3,2,5,0,25
234,780140,38,8,13,5,5,3,8,4,4,0,4,0,3,0,0,0,23
234,796355,24,9,15,7,12,2,3,4,5,1,3,8,3,2,1,0,24
234,780137,32,7,9,7,7,0,2,1,2,1,8,1,1,2,1,0,15
234,790796,5,0,1,0,1,0,0,0,0,0,1,0,2,0,2,0,0
234,785245,32,3,6,2,3,1,3,4,5,0,1,3,0,0,0,0,11
234,775553,11,1,2,1,1,0,1,0,0,0,0,3,0,1,0,0,2
234,796354,2,0,0,0,0,0,0,0,0,0,0,0,1,0,1,0,0
234,790800,1,0,0,0,0,0,0,0,0,0,0,0,0,0,0,0,0
234,796359,3,0,0,0,0,0,0,0,0,0,0,0,0,0,0,0,0
234,790795,1,0,0,0,0,0,0,0,0,0,0,0,0,0,0,0,0
235,790810,22,5,11,5,8,0,3,1,3,3,1,2,3,0,2,0,11
235,785362,20,3,9,3,9,0,0,2,2,1,5,0,2,1,4,0,8
235,790808,28,3,6,1,3,2,3,0,2,0,2,0,1,0,3,0,8
235,785361,31,5,11,3,7,2,4,5,6,0,0,4,4,2,0,1,17
235,779997,37,7,9,5,7,2,2,6,7,0,2,2,3,1,4,0,22
235,774854,9,2,2,2,2,0,0,0,0,0,4,0,1,0,0,1,4
235,796368,10,1,2,0,0,1,2,0,0,0,0,0,2,0,1,0,3
235,796370,28,5,10,4,6,1,4,1,2,1,2,1,3,2,0,1,12
235,790811,10,2,2,2,2,0,0,1,2,0,1,1,0,0,1,0,5
235,796371,1,0,0,0,0,0,0,0,0,0,1,0,0,0,0,0,0
235,796369,1,0,0,0,0,0,0,0,0,0,0,0,0,0,0,0,0
235,790809,3,0,0,0,0,0,0,0,0,0,0,0,0,0,0,0,0
236,781439,28,3,11,1,4,2,7,9,13,4,2,1,3,5,0,0,17
236,781322,27,2,9,0,0,2,9,1,3,0,5,1,4,1,1,0,7
236,786571,23,0,5,0,2,0,3,0,0,1,1,2,4,0,2,0,0
236,780563,28,0,4,0,0,0,4,0,0,0,4,2,3,1,0,0,0
236,785989,38,6,17,3,6,3,11,3,4,2,5,5,1,1,1,1,18
236,781207,21,3,5,3,4,0,1,3,3,0,3,0,3,0,2,0,9
236,781419,20,4,10,2,4,2,6,3,4,0,0,1,2,3,2,0,13
236,791690,15,0,1,0,1,0,0,2,3,3,0,1,4,1,1,0,2
237,791700,15,2,3,2,3,0,0,0,1,0,3,0,4,0,0,0,4
237,792118,36,4,13,2,9,2,4,9,12,1,5,6,1,1,6,0,19
237,782593,34,7,17,5,6,2,11,2,2,0,5,1,4,1,3,0,18
237,785828,17,2,3,2,3,0,0,4,4,2,6,1,5,0,5,0,8
237,785402,15,1,1,1,1,0,0,0,2,1,3,0,3,0,2,0,2
237,791702,26,1,2,1,2,0,0,0,0,2,7,2,2,0,0,0,2
237,797523,29,2,3,1,1,1,2,0,1,1,1,1,4,1,4,1,5
237,791699,15,4,6,4,4,0,2,0,0,1,4,1,2,0,1,0,8
237,797526,9,1,2,0,0,1,2,0,0,1,1,0,1,0,0,0,3
237,797525,4,0,0,0,0,0,0,0,0,0,3,0,1,0,0,0,0
238,791975,29,4,9,4,9,0,0,3,7,8,8,0,0,0,2,1,11
238,785972,26,1,4,1,2,0,2,2,2,0,1,1,4,0,2,1,4
238,785967,29,8,14,8,14,0,0,7,9,8,7,2,3,1,1,2,23
238,791977,35,5,15,1,6,4,9,2,2,0,2,0,2,1,1,0,16
238,791978,24,4,11,3,9,1,2,3,4,2,0,4,3,1,2,0,12
238,780160,13,0,1,0,1,0,0,1,2,2,4,1,4,0,3,1,1
238,791976,20,4,7,3,5,1,2,0,0,1,0,1,1,1,4,0,9
238,785973,15,0,0,0,0,0,0,2,2,0,0,5,2,1,4,0,2
238,791980,4,0,1,0,0,0,1,0,0,0,0,0,2,0,0,0,0
238,797799,3,0,0,0,0,0,0,0,1,0,2,0,0,0,0,0,0
238,797800,1,0,1,0,1,0,0,0,0,0,0,0,0,0,1,0,0
238,797803,1,0,0,0,0,0,0,0,0,0,0,0,0,0,0,0,0
239,780178,15,3,4,3,4,0,0,0,2,2,0,1,3,0,2,0,6
239,775075,18,3,4,3,3,0,1,0,0,1,2,0,2,1,0,0,6
239,792376,27,5,16,5,11,0,5,3,3,0,3,2,3,3,2,0,13
239,797883,25,1,3,0,2,1,1,0,0,0,2,6,4,2,2,0,3
239,786747,27,3,8,3,6,0,2,2,6,1,3,0,3,1,1,1,8
239,785744,5,0,1,0,1,0,0,0,0,1,0,0,3,0,1,1,0
239,792374,20,3,10,3,8,0,2,1,2,1,2,1,0,2,0,0,7
239,797890,12,2,6,1,1,1,5,2,4,3,1,0,1,1,0,0,7
239,786746,22,1,7,0,4,1,3,8,8,1,2,0,1,1,4,0,11
239,792378,9,0,0,0,0,0,0,0,0,1,1,1,3,1,1,1,0
239,797888,11,1,2,1,2,0,0,1,2,1,1,0,2,1,1,0,3
239,797885,9,1,3,1,1,0,2,0,0,2,0,0,0,0,0,0,2
240,797529,24,1,2,1,2,0,0,0,1,1,3,1,1,1,2,0,2
240,791936,27,3,7,3,7,0,0,5,9,3,1,0,1,1,1,0,11
240,791933,23,1,8,1,2,0,6,5,5,2,0,1,0,3,0,0,7
240,785688,10,1,6,0,1,1,5,0,0,0,1,0,1,0,2,0,3
240,785988,16,1,5,1,1,0,4,2,2,1,1,0,4,0,0,0,4
240,797530,9,0,0,0,0,0,0,0,0,0,0,0,3,0,2,0,0
240,797528,5,1,2,1,1,0,1,1,2,2,1,0,0,0,0,0,3
240,797527,18,1,2,1,2,0,0,0,0,2,3,0,2,1,0,0,2
240,791931,12,1,2,0,1,1,1,0,0,0,0,0,0,0,1,1,3
240,786532,4,0,1,0,1,0,0,0,0,0,0,0,1,0,0,0,0
240,797532,26,5,10,5,7,0,3,6,9,0,4,2,0,0,3,0,16
240,791932,20,0,5,0,2,0,3,0,0,0,1,1,1,2,3,0,0
240,791935,6,1,1,1,1,0,0,0,0,0,2,0,1,0,1,0,2
241,797967,27,4,10,4,8,0,2,3,4,4,5,4,1,0,6,0,11
241,786087,16,0,2,0,2,0,0,0,0,2,6,1,1,0,1,2,0
241,797970,27,6,15,3,7,3,8,2,2,1,2,2,3,2,2,0,17
241,781453,25,4,11,0,1,4,10,0,0,1,2,8,3,2,3,0,12
241,774869,28,8,11,0,0,8,11,0,0,1,1,1,2,1,2,0,24
241,792254,17,2,3,2,3,0,0,2,2,0,2,3,3,0,0,0,6
241,797962,20,1,1,1,1,0,0,0,0,2,6,2,2,0,1,1,2
241,797961,17,0,2,0,2,0,0,1,2,2,2,2,3,1,0,0,1
241,786098,21,3,6,2,4,1,2,0,0,2,1,2,3,2,1,0,7
241,786106,2,0,1,0,0,0,1,0,0,0,0,0,0,0,0,0,0
242,775323,43,7,17,5,9,2,8,4,6,0,2,5,4,3,2,0,20
242,792055,20,5,7,5,7,0,0,4,5,2,2,0,5,1,3,1,14
242,789028,38,5,10,5,9,0,1,2,2,3,5,7,4,1,3,0,12
242,792059,21,2,5,1,3,1,2,0,0,0,2,2,5,2,0,0,5
242,792062,30,1,4,1,4,0,0,1,1,1,4,0,4,0,2,1,3
242,789053,25,5,8,3,3,2,5,5,6,0,2,2,1,0,0,0,17
242,776426,11,1,3,0,2,1,1,0,0,0,3,2,1,0,2,1,3
242,775523,10,1,1,1,1,0,0,0,0,1,1,0,1,0,2,0,2
242,786836,8,0,2,0,2,0,0,2,4,0,2,0,0,0,0,0,2
242,789029,7,0,1,0,1,0,0,0,0,0,0,0,0,0,1,0,0
242,790779,6,0,2,0,2,0,0,0,0,1,2,0,0,0,1,0,0
242,792067,3,0,0,0,0,0,0,0,0,0,1,0,0,0,0,0,0
242,792058,2,0,1,0,1,0,0,0,0,0,0,0,0,0,1,0,0
242,797649,1,0,0,0,0,0,0,0,0,0,0,0,1,0,0,0,0
243,780193,33,4,12,2,8,2,4,5,5,0,2,3,1,0,2,0,15
243,782157,39,4,7,4,6,0,1,4,5,1,5,4,3,2,3,0,12
243,789025,34,2,5,2,4,0,1,4,5,0,2,2,5,0,1,1,8
243,792670,22,3,5,1,2,2,3,0,0,0,3,0,2,1,2,1,8
243,798153,18,0,0,0,0,0,0,1,3,0,5,0,5,0,3,0,1
243,774985,32,12,16,9,11,3,5,6,9,0,1,1,2,2,2,1,33
243,792666,27,1,3,0,0,1,3,0,0,0,4,0,3,1,0,1,3
243,775276,14,1,4,0,2,1,2,0,0,1,2,1,1,0,0,0,3
243,792669,6,1,2,1,2,0,0,0,0,0,0,1,3,0,1,0,2
244,786257,25,4,5,4,5,0,0,0,1,1,2,1,4,1,2,0,8
244,786263,29,2,7,0,2,2,5,6,8,2,4,1,2,0,3,0,12
244,792122,30,2,7,1,1,1,6,4,4,2,8,0,0,1,4,1,9
244,785661,16,2,6,1,3,1,3,0,0,0,0,0,1,3,0,0,5
244,775825,38,8,15,5,10,3,5,0,1,3,3,5,4,3,2,3,19
244,792121,13,0,3,0,1,0,2,0,0,2,0,0,2,0,0,0,0
244,797725,15,2,2,1,1,1,1,0,0,0,2,0,2,1,1,0,5
244,797722,8,0,1,0,0,0,1,0,0,0,1,0,0,0,0,0,0
244,797724,24,3,10,2,4,1,6,1,2,0,2,1,1,2,1,0,8
244,786249,2,0,0,0,0,0,0,0,0,0,0,0,0,0,0,0,0
245,791905,31,1,4,1,3,0,1,0,0,0,5,1,2,1,1,0,2
245,781103,31,5,8,5,7,0,1,4,6,0,3,3,3,0,5,1,14
245,797568,20,5,9,2,4,3,5,0,0,0,1,0,3,0,0,0,13
245,786517,34,7,13,6,9,1,4,0,1,1,4,2,1,1,4,1,15
245,781102,25,0,2,0,2,0,0,0,0,1,1,0,1,1,2,0,0
245,791904,11,2,3,2,2,0,1,0,0,0,1,0,3,0,1,0,4
245,797566,24,1,3,0,1,1,2,0,0,0,0,2,1,1,0,0,3
245,791908,24,5,9,3,7,2,2,1,1,0,5,1,0,0,2,0,13
246,785999,33,7,11,7,11,0,0,6,8,4,3,1,4,0,2,2,20
246,775654,34,5,5,5,5,0,0,4,5,1,4,1,3,0,2,1,14
246,796398,32,1,2,1,1,0,1,0,0,1,1,2,2,1,2,0,2
246,796399,30,3,7,1,5,2,2,2,2,0,5,5,2,2,2,1,10
246,785389,37,8,15,7,12,1,3,3,4,1,2,4,2,0,4,0,20
246,775171,19,3,5,2,2,1,3,0,0,0,4,2,1,0,1,0,7
246,785255,13,0,2,0,1,0,1,0,0,1,2,2,2,0,0,0,0
246,796400,2,0,0,0,0,0,0,0,0,0,0,0,0,0,0,0,0
247,797198,20,3,6,0,1,3,5,1,2,0,1,0,4,0,1,0,10
247,791482,17,0,2,0,0,0,2,1,2,1,0,3,3,1,0,0,1
247,786318,35,8,12,1,1,7,11,0,0,0,3,1,0,1,0,0,23
247,784268,36,3,8,2,4,1,4,3,4,0,1,10,0,1,1,0,10
247,780223,34,6,8,1,2,5,6,0,0,0,2,5,2,0,1,0,17
247,786319,23,4,5,4,5,0,0,3,4,4,1,0,3,0,1,2,11
247,780225,19,2,7,0,0,2,7,0,0,0,3,1,2,0,0,0,6
247,797199,6,0,0,0,0,0,0,0,0,0,0,1,1,0,1,0,0
247,791481,10,2,5,1,1,1,4,1,2,0,1,1,2,0,1,1,6
248,791522,35,2,7,2,6,0,1,9,10,4,3,9,1,3,1,1,13
248,786351,34,9,11,5,6,4,5,2,2,2,4,0,2,2,0,0,24
248,786348,13,0,2,0,0,0,2,0,0,1,0,0,2,0,2,0,0
248,797146,33,10,21,6,12,4,9,3,4,1,1,2,2,2,2,0,27
248,797143,34,4,8,2,3,2,5,0,0,0,4,5,3,0,2,0,10
248,785479,13,1,3,0,1,1,2,0,0,0,5,0,4,0,1,0,3
248,797142,13,1,1,1,1,0,0,1,2,1,0,1,2,1,0,0,3
248,797147,12,1,3,1,2,0,1,5,6,0,0,1,0,2,0,0,7
248,797144,10,1,1,0,0,1,1,2,2,0,3,1,1,0,1,0,5
248,786771,3,1,1,1,1,0,0,0,0,1,0,0,0,0,0,0,2
249,797311,33,6,11,6,11,0,0,1,1,5,5,0,0,0,0,2,13
249,780956,19,0,3,0,2,0,1,0,0,1,3,0,3,0,4,0,0
249,797310,28,2,4,1,2,1,2,0,0,1,4,5,2,0,0,0,5
249,791724,30,4,9,2,4,2,5,2,4,0,4,3,4,1,2,0,12
249,781617,26,7,10,4,5,3,5,6,8,0,2,0,4,0,3,1,23
249,791723,8,0,2,0,2,0,0,0,0,1,0,0,3,0,1,1,0
249,780706,14,2,3,0,0,2,3,0,0,0,0,5,3,0,1,0,6
249,786285,26,5,7,2,2,3,5,1,2,0,2,4,2,0,4,0,14
249,797308,16,3,8,1,2,2,6,0,0,0,0,2,0,0,0,0,8
250,792033,24,3,8,1,3,2,5,2,2,0,6,5,3,0,2,0,10
250,792034,34,9,13,4,4,5,9,0,0,0,4,2,0,3,0,0,23
250,780833,25,0,1,0,1,0,0,0,0,0,0,3,1,0,1,1,0
250,780830,29,5,8,2,3,3,5,0,1,1,3,1,2,0,2,0,13
250,792035,23,7,10,7,10,0,0,2,2,1,3,4,2,0,1,1,16
250,785980,11,1,2,0,0,1,2,0,0,0,0,1,1,0,1,0,3
250,797645,13,0,1,0,1,0,0,0,0,0,2,0,4,0,1,1,0
250,791688,18,3,5,2,4,1,1,0,0,1,2,3,2,2,0,0,7
250,785381,17,4,9,1,4,3,5,0,0,0,1,0,1,1,1,1,11
250,785982,2,0,0,0,0,0,0,0,0,0,0,0,0,0,0,0,0
250,797644,4,0,0,0,0,0,0,0,0,0,1,0,0,1,2,0,0
251,781584,17,2,3,1,1,1,2,0,0,0,2,1,0,1,1,0,5
251,786731,25,6,8,6,8,0,0,0,0,2,6,3,1,0,2,3,12
251,798023,28,4,9,3,7,1,2,0,0,0,2,3,2,0,0,0,9
251,781579,19,2,7,2,6,0,1,1,1,2,0,0,2,0,0,0,5
251,780347,23,3,9,1,4,2,5,2,2,0,1,1,0,0,1,0,10
251,798017,14,0,1,0,1,0,0,2,2,0,5,1,0,0,2,0,2
251,775696,20,2,7,1,2,1,5,2,2,1,2,0,0,0,0,0,7
251,792358,14,0,2,0,2,0,0,1,2,1,1,1,0,0,5,0,1
251,798008,19,2,7,0,1,2,6,2,2,0,1,0,2,2,1,0,8
251,776481,8,0,2,0,2,0,0,0,0,0,1,0,1,0,1,0,0
251,798026,7,0,1,0,1,0,0,0,1,1,0,1,0,1,3,0,0
251,792361,4,0,1,0,0,0,1,0,0,0,1,0,0,1,0,0,0
251,798019,1,0,0,0,0,0,0,0,0,0,0,0,0,0,0,0,0
251,798021,1,0,0,0,0,0,0,0,0,0,0,0,0,0,0,0,0
252,780695,24,8,11,3,4,5,7,0,0,0,4,1,3,1,3,0,21
252,797594,20,6,8,0,1,6,7,3,4,0,1,3,1,3,2,0,21
252,791884,24,4,8,2,4,2,4,3,3,0,2,11,3,1,4,0,13
252,791883,19,1,2,1,2,0,0,0,0,1,8,1,0,1,2,0,2
252,781066,19,7,8,7,8,0,0,2,2,2,5,3,1,1,1,0,16
252,791885,16,1,4,0,2,1,2,1,2,0,2,4,2,1,0,0,4
252,797596,28,3,5,1,1,2,4,2,2,0,3,2,3,2,4,1,10
252,786497,16,2,5,0,1,2,4,0,0,1,4,0,1,0,0,1,6
252,797598,8,5,5,5,5,0,0,0,0,0,4,0,0,1,1,1,10
252,797600,13,1,2,1,2,0,0,2,2,0,1,2,0,1,0,0,4
252,786496,8,2,4,0,0,2,4,0,0,0,1,1,1,1,0,0,6
252,797597,5,1,1,0,0,1,1,0,0,1,1,0,2,0,0,0,3
253,792634,33,3,14,1,6,2,8,0,0,0,3,3,4,5,3,2,8
253,799129,35,3,11,1,4,2,7,1,2,1,5,3,3,4,4,0,9
253,799136,16,0,1,0,1,0,0,0,0,1,1,0,3,1,1,0,0
253,799133,29,3,8,1,4,2,4,0,0,1,2,1,3,1,4,0,8
253,799130,23,1,4,0,2,1,2,1,3,0,3,0,2,0,5,1,4
253,799134,19,7,14,5,7,2,7,3,3,0,2,0,2,1,3,0,19
253,799132,28,5,9,3,4,2,5,0,1,1,0,0,1,0,1,0,12
253,799135,11,0,0,0,0,0,0,0,0,0,1,0,1,0,1,1,0
253,799128,4,0,1,0,1,0,0,0,0,0,0,0,0,0,0,0,0
253,799131,2,1,1,1,1,0,0,0,0,1,0,0,0,0,0,0,2
254,785338,12,1,2,1,1,0,1,0,2,2,0,0,0,0,1,0,2
254,785126,20,6,8,6,8,0,0,0,0,2,2,2,4,0,2,0,12
254,785339,27,4,9,2,3,2,6,2,2,1,3,2,1,2,1,1,12
254,779976,29,8,12,5,8,3,4,0,1,0,7,4,2,1,2,0,19
254,774990,23,4,6,1,2,3,4,0,0,0,4,0,3,0,5,0,11
254,780142,12,0,4,0,1,0,3,0,0,0,1,1,1,0,0,0,0
254,781586,19,3,6,3,6,0,0,5,13,7,3,2,3,0,2,0,11
254,796674,12,3,5,3,4,0,1,0,1,4,5,2,5,0,2,0,6
254,791014,16,3,3,1,1,2,2,0,0,0,1,2,2,2,0,1,8
254,785961,11,0,4,0,1,0,3,1,2,0,2,3,0,0,0,0,1
254,786737,6,1,3,1,1,0,2,0,0,0,1,0,1,0,0,0,2
254,796673,11,1,4,1,3,0,1,0,0,1,2,0,3,0,2,0,2
254,796672,1,0,0,0,0,0,0,0,0,0,1,0,0,0,0,0,0
254,791016,1,0,0,0,0,0,0,0,0,0,0,0,0,0,0,0,0
255,791768,22,1,5,1,4,0,1,2,2,1,3,2,3,0,3,0,4
255,786460,15,1,3,1,3,0,0,2,4,0,0,1,3,1,1,0,4
255,780604,23,2,6,2,6,0,0,4,6,1,3,2,4,0,2,0,8
255,780603,28,5,8,2,5,3,3,2,2,0,1,2,2,2,2,0,15
255,780602,29,5,12,5,12,0,0,5,6,1,8,1,3,1,2,0,15
255,786462,10,0,2,0,1,0,1,0,0,1,0,1,2,0,1,0,0
255,786230,20,1,5,0,4,1,1,2,3,0,2,3,2,0,0,0,5
255,791766,17,1,5,1,5,0,0,0,2,0,0,0,0,3,0,0,2
255,786071,18,0,1,0,1,0,0,3,5,1,3,0,3,1,1,0,3
255,791767,11,1,2,0,1,1,1,0,0,0,0,0,3,0,2,0,3
255,797565,4,0,1,0,1,0,0,2,2,0,1,0,1,0,0,0,2
255,797564,3,0,1,0,1,0,0,0,0,0,0,0,0,0,0,0,0
256,791949,33,8,15,5,11,3,4,0,0,3,4,0,2,0,2,0,19
256,776014,27,1,3,1,2,0,1,0,0,5,6,0,2,1,1,1,2
256,797691,25,2,10,2,10,0,0,0,0,1,3,4,1,1,0,0,4
256,780747,39,6,17,5,10,1,7,4,8,0,1,7,3,2,4,1,17
256,776363,39,1,7,0,3,1,4,0,0,2,6,0,3,1,0,0,3
256,784336,11,1,2,1,2,0,0,0,0,2,7,0,0,0,2,1,2
256,791946,17,2,7,2,3,0,4,0,0,1,0,1,1,0,1,0,4
256,791948,9,0,1,0,1,0,0,0,0,2,0,0,0,0,0,1,0
257,785335,20,2,5,2,5,0,0,0,0,3,1,1,3,0,1,2,4
257,780303,27,8,20,7,18,1,2,0,0,2,5,0,2,4,2,1,17
257,791594,24,2,6,1,4,1,2,0,0,1,4,3,1,0,3,0,5
257,786349,17,1,2,1,2,0,0,0,0,0,1,0,1,0,1,0,2
257,781385,32,2,7,1,3,1,4,0,1,1,2,2,3,2,2,0,5
257,791011,14,1,5,1,3,0,2,0,0,2,3,0,0,0,0,0,2
257,785337,21,1,3,1,2,0,1,2,4,3,3,0,2,0,1,0,4
257,781221,15,0,4,0,4,0,0,0,0,0,1,0,0,1,0,0,0
257,791012,26,4,9,1,4,3,5,0,1,1,2,1,0,0,0,0,11
257,796671,4,0,2,0,2,0,0,0,0,1,0,1,0,0,0,0,0
258,790833,33,3,9,3,8,0,1,0,0,3,7,2,2,0,2,0,6
258,796390,19,3,6,3,6,0,0,0,0,1,2,0,1,0,0,2,6
258,790834,19,1,5,0,3,1,2,2,4,1,2,3,5,0,1,0,5
258,785377,24,2,5,2,5,0,0,1,2,1,0,4,5,2,0,1,5
258,785451,34,9,17,3,7,6,10,1,1,0,2,4,5,0,2,0,25
258,790832,27,5,13,3,7,2,6,2,4,0,1,1,1,2,2,2,14
258,790830,19,3,6,3,6,0,0,0,0,1,3,1,1,1,1,0,6
258,790831,14,1,4,1,4,0,0,0,0,1,1,0,1,0,1,0,2
258,785379,4,0,0,0,0,0,0,0,0,0,0,0,1,0,0,0,0
258,780297,7,0,1,0,0,0,1,0,0,0,2,0,1,0,0,0,0
259,776100,26,5,8,3,5,2,3,2,3,4,5,2,0,0,0,0,14
259,785991,31,8,13,7,11,1,2,4,6,4,10,1,4,0,5,7,21
259,781406,35,6,11,4,7,2,4,4,4,1,2,2,1,1,2,0,18
259,781401,27,2,6,2,5,0,1,2,2,1,3,1,1,1,1,0,6
259,775317,26,1,4,0,1,1,3,5,7,0,5,4,2,1,3,0,8
259,781029,24,1,6,0,0,1,6,0,0,0,1,2,3,0,1,0,3
259,792133,9,1,2,0,0,1,2,0,0,0,1,0,1,0,0,0,3
259,797760,6,0,1,0,1,0,0,0,0,0,1,0,0,0,1,0,0
259,797762,16,0,3,0,3,0,0,2,2,0,4,0,3,0,1,0,2
260,797708,29,2,7,2,7,0,0,4,4,1,2,4,2,4,5,0,8
260,786180,16,2,3,2,3,0,0,0,0,2,2,1,1,1,1,2,4
260,785608,28,3,8,3,7,0,1,3,4,2,5,0,3,1,2,0,9
260,797709,33,6,14,5,7,1,7,6,6,0,5,4,3,3,0,1,19
260,786198,22,4,10,3,8,1,2,4,6,0,4,2,2,1,5,0,13
260,792106,9,1,3,0,2,1,1,0,0,1,0,1,2,0,1,0,3
260,786204,21,5,8,3,5,2,3,2,2,0,3,3,4,3,1,0,14
260,776327,10,1,1,1,1,0,0,0,0,1,1,0,2,1,1,0,2
260,797707,26,4,7,3,4,1,3,1,2,2,4,1,3,3,2,0,10
260,781631,6,0,1,0,0,0,1,0,0,0,0,1,1,0,1,0,0
261,780792,18,2,8,1,3,1,5,0,2,0,2,0,4,2,2,0,5
261,775598,20,0,4,0,1,0,3,1,2,3,3,3,1,0,5,0,1
261,786299,29,2,2,2,2,0,0,0,0,1,2,1,1,1,1,1,4
261,791461,26,3,5,2,3,1,2,5,7,3,3,1,2,1,3,0,12
261,786295,17,1,7,1,3,0,4,1,2,1,3,1,1,2,2,0,3
261,791460,22,2,9,0,3,2,6,4,7,0,3,1,2,3,4,1,10
261,780122,17,1,2,0,0,1,2,0,0,0,4,0,4,1,2,3,3
261,797215,18,5,6,4,5,1,1,0,0,1,0,0,3,1,1,0,11
261,791462,11,1,1,1,1,0,0,0,0,0,2,0,2,0,4,1,2
261,791459,22,4,10,4,10,0,0,6,6,0,2,3,2,2,2,0,14
262,791306,30,3,10,3,9,0,1,3,4,3,5,1,2,1,1,2,9
262,780210,40,11,17,11,17,0,0,3,3,10,6,0,2,2,2,0,25
262,792432,25,0,6,0,3,0,3,2,2,1,3,1,0,1,2,0,2
262,792427,32,2,11,1,7,1,4,2,2,2,2,1,1,0,3,0,7
262,792433,11,0,3,0,2,0,1,0,0,2,0,0,4,0,1,0,0
262,796592,3,1,1,1,1,0,0,1,1,0,0,0,3,0,2,0,3
262,790880,2,0,0,0,0,0,0,0,0,0,2,1,1,0,0,0,0
262,789632,2,1,1,1,1,0,0,2,2,1,0,0,2,0,0,0,4
262,796594,7,1,3,1,2,0,1,0,0,0,0,0,0,1,1,0,2
262,792431,7,1,1,1,1,0,0,0,1,1,0,0,1,0,1,0,2
262,786422,15,1,3,1,3,0,0,0,3,0,1,4,3,1,1,0,2
262,775005,26,3,6,1,2,2,4,3,4,0,4,1,0,1,2,0,11
263,791220,23,2,6,2,4,0,2,2,4,5,3,0,3,1,1,0,6
263,776217,20,1,2,1,2,0,0,0,0,1,5,1,5,0,2,0,2
263,790818,30,3,7,2,4,1,3,2,4,1,1,5,1,0,4,0,9
263,786396,25,3,8,2,4,1,4,2,4,0,2,2,2,1,2,0,9
263,780730,29,6,10,5,6,1,4,3,3,0,1,1,1,1,4,0,16
263,796923,6,0,0,0,0,0,0,0,0,0,3,0,4,0,0,0,0
263,786824,26,5,12,1,3,4,9,0,1,1,3,0,0,0,1,0,14
263,791221,2,0,0,0,0,0,0,0,1,0,1,0,0,0,0,0,0
263,791219,27,3,10,1,3,2,7,0,0,4,2,0,1,4,0,0,8
263,796921,9,1,1,1,1,0,0,0,1,0,1,1,1,0,2,0,2
263,796920,3,0,1,0,1,0,0,0,0,0,0,0,2,1,0,0,0
264,787522,7,1,3,1,3,0,0,1,2,0,2,0,3,0,1,0,3
264,787524,21,3,6,2,4,1,2,4,5,0,7,1,2,0,2,1,11
264,791772,18,1,3,0,0,1,3,0,0,0,0,0,0,1,4,0,3
264,781019,36,4,10,4,9,0,1,0,0,1,2,8,2,5,1,0,8
264,780017,17,2,5,1,2,1,3,3,3,0,2,1,4,0,3,0,8
264,775541,5,0,2,0,1,0,1,0,0,0,0,0,0,0,0,0,0
264,797611,11,3,6,1,2,2,4,0,0,0,0,0,2,0,2,1,8
264,783269,19,2,6,1,2,1,4,0,0,1,3,0,3,1,2,0,5
264,791774,17,6,9,5,8,1,1,0,0,3,0,0,3,0,1,1,13
264,797610,6,1,3,0,0,1,3,3,3,0,0,0,0,1,1,0,6
264,791722,18,1,6,0,3,1,3,0,0,1,3,0,2,0,1,0,3
264,780328,25,1,4,1,4,0,0,2,2,2,3,3,0,2,1,0,4
265,792197,28,7,10,1,1,6,9,2,4,1,3,0,2,1,1,0,22
265,781132,32,3,9,2,4,1,5,4,4,3,5,3,0,2,0,0,11
265,797517,26,6,11,6,11,0,0,2,3,3,3,0,1,0,4,0,14
265,791940,28,1,7,1,4,0,3,1,2,3,1,4,2,0,4,0,3
265,786534,34,8,13,5,6,3,7,2,3,1,8,7,0,0,5,0,21
265,797521,8,1,5,1,3,0,2,0,0,1,2,0,4,1,1,0,2
265,797519,8,0,3,0,1,0,2,0,0,0,2,1,1,0,0,0,0
265,791939,6,0,0,0,0,0,0,0,1,1,1,0,2,0,2,0,0
265,797520,4,1,2,0,0,1,2,0,0,0,0,0,1,0,1,0,3
265,797518,6,0,2,0,0,0,2,2,2,1,0,1,1,1,1,0,2
265,791938,20,2,2,0,0,2,2,0,2,0,3,2,0,1,1,0,6
266,780238,33,7,12,6,8,1,4,5,7,0,3,6,1,2,2,0,20
266,781500,30,4,7,1,3,3,4,0,0,1,2,2,1,3,2,1,11
266,785909,25,4,5,4,5,0,0,2,2,3,4,0,1,0,1,2,10
266,786179,29,2,11,1,5,1,6,0,0,0,3,1,3,1,1,0,5
266,780244,26,2,9,2,5,0,4,1,2,2,0,4,1,0,0,0,5
266,786177,24,6,11,0,0,6,11,0,1,2,8,0,4,1,1,1,18
266,791750,22,2,4,0,1,2,3,2,2,1,4,2,3,0,1,1,8
266,790773,5,1,2,1,1,0,1,0,0,1,0,0,2,0,0,0,2
266,791749,0,0,0,0,0,0,0,0,0,0,0,0,0,0,0,0,0
266,791752,6,0,0,0,0,0,0,0,0,0,0,1,2,0,0,0,0
267,776284,32,10,17,8,14,2,3,3,5,1,4,2,3,2,3,0,25
267,786122,30,3,10,2,5,1,5,5,5,0,4,0,3,0,3,0,12
267,780877,26,2,3,2,3,0,0,7,8,5,5,0,0,1,2,2,11
267,792258,32,3,10,2,7,1,3,0,3,1,3,2,4,0,1,0,7
267,775206,24,1,4,1,2,0,2,0,0,3,3,0,0,0,1,1,2
267,786331,17,2,5,1,3,1,2,0,0,2,0,0,5,2,0,0,5
267,792261,14,2,4,2,4,0,0,0,0,1,1,0,1,0,1,0,4
267,780308,17,1,5,1,4,0,1,0,0,0,1,0,0,1,0,0,2
267,786113,7,0,2,0,2,0,0,0,0,1,1,0,0,0,0,0,0
267,786124,1,0,0,0,0,0,0,0,0,0,0,0,2,0,0,0,0
268,780937,36,11,16,7,7,4,9,2,2,4,3,0,2,0,1,2,28
268,775754,42,6,20,5,11,1,9,5,10,0,7,7,1,1,2,0,18
268,791950,28,4,8,0,1,4,7,2,2,3,1,7,3,1,5,0,14
268,785350,37,4,11,3,6,1,5,2,2,1,3,2,3,0,0,0,11
268,797715,20,0,1,0,0,0,1,1,4,0,3,3,5,0,2,0,1
268,791149,20,5,9,3,5,2,4,3,3,1,1,0,5,0,2,0,15
268,780938,9,1,1,1,1,0,0,0,0,0,3,0,2,0,0,0,2
268,792113,18,0,5,0,1,0,4,0,0,0,0,1,5,0,0,0,0
268,792115,12,1,2,1,1,0,1,0,0,1,1,0,5,0,0,0,2
268,797717,3,0,1,0,1,0,0,0,0,0,0,0,1,1,1,0,0
269,796699,15,2,6,1,2,1,4,2,4,1,0,0,5,0,3,0,7
269,790978,29,4,12,3,3,1,9,4,8,2,8,2,2,0,2,0,13
269,790981,17,3,8,1,4,2,4,3,5,0,3,2,2,1,2,0,11
269,790979,35,3,8,3,6,0,2,6,7,3,2,2,4,0,1,0,12
269,796701,11,0,0,0,0,0,0,0,0,3,1,3,3,0,3,1,0
269,790983,37,8,13,7,10,1,3,1,3,3,8,3,1,2,5,1,18
269,788820,15,1,6,1,2,0,4,2,2,0,0,1,2,0,0,0,4
269,790976,26,2,3,1,2,1,1,2,5,5,3,1,4,2,1,3,7
269,796700,28,4,10,1,5,3,5,6,6,1,6,0,1,0,0,0,17
269,796698,12,2,2,2,2,0,0,3,3,2,0,2,1,0,1,0,7
270,776137,18,1,4,0,0,1,4,0,0,1,0,0,2,0,1,0,3
270,797051,29,5,10,5,8,0,2,1,2,1,7,2,3,0,5,1,11
270,791437,22,2,2,2,2,0,0,0,0,2,1,3,2,1,0,1,4
270,781641,25,4,11,2,4,2,7,0,0,0,0,3,1,0,2,2,10
270,797059,9,3,5,1,1,2,4,0,1,0,2,3,1,0,0,0,8
270,797053,16,3,4,3,4,0,0,0,1,2,1,0,0,0,0,0,6
270,797038,25,5,11,3,8,2,3,2,4,2,5,5,4,2,3,0,14
270,786305,15,4,5,3,3,1,2,1,3,1,2,0,0,0,0,0,10
270,791439,10,0,1,0,1,0,0,0,0,0,2,0,2,1,1,0,0
270,791436,4,0,1,0,1,0,0,0,0,0,0,0,0,0,1,0,0
270,791438,27,4,10,1,4,3,6,1,2,0,5,2,1,2,3,1,12
271,782133,21,3,6,3,4,0,2,0,0,1,1,1,3,0,1,0,6
271,785123,22,7,13,7,10,0,3,1,2,3,2,1,0,1,2,2,15
271,785059,27,6,9,4,5,2,4,0,0,2,11,7,0,3,0,0,14
271,789219,35,7,11,4,5,3,6,3,4,0,2,2,1,3,2,0,20
271,796623,35,8,14,5,8,3,6,2,2,0,4,2,3,4,2,0,21
271,796622,11,0,0,0,0,0,0,0,0,0,0,0,2,0,2,0,0
271,790988,23,1,10,1,4,0,6,4,5,3,2,1,3,0,0,1,6
271,785305,14,2,3,2,2,0,1,1,2,1,4,1,3,0,0,1,5
271,796624,12,3,7,2,2,1,5,1,1,1,1,2,0,0,1,0,8
272,791057,12,2,2,2,2,0,0,2,2,0,2,0,1,0,1,0,6
272,791059,10,2,5,2,5,0,0,2,2,2,4,0,2,0,1,0,6
272,775926,25,5,8,2,2,3,6,1,1,1,8,1,1,1,0,1,14
272,785530,22,5,11,5,9,0,2,1,5,4,3,3,2,1,1,1,11
272,775573,22,3,8,1,2,2,6,2,3,0,3,6,1,2,1,0,10
272,780063,17,1,3,1,1,0,2,0,0,1,1,1,0,1,3,1,2
272,796733,18,2,4,2,4,0,0,0,0,0,0,1,1,1,0,0,4
272,791055,18,3,4,2,3,1,1,3,5,1,1,5,1,0,2,0,10
272,785532,13,4,7,4,7,0,0,3,7,0,6,0,2,0,0,0,11
272,796734,10,0,1,0,0,0,1,0,0,0,1,0,3,0,1,0,0
272,791058,12,3,3,3,3,0,0,3,4,1,3,1,1,2,1,0,9
272,791056,15,1,1,1,1,0,0,0,0,0,1,1,4,0,2,0,2
272,791054,4,0,3,0,1,0,2,0,0,1,1,0,0,0,2,0,0
272,785538,2,0,1,0,1,0,0,1,2,2,2,0,0,0,0,0,1
274,781407,28,2,5,2,5,0,0,0,0,0,6,2,2,0,1,0,4
274,791584,20,3,6,3,6,0,0,0,3,1,5,0,4,0,4,0,6
274,786659,28,3,6,3,5,0,1,2,4,0,1,1,3,1,3,0,8
274,780580,37,9,20,7,12,2,8,3,4,0,3,3,2,4,1,0,23
274,776150,27,4,9,4,5,0,4,2,2,0,5,0,4,2,3,0,10
274,791583,13,0,1,0,1,0,0,1,3,0,2,0,5,0,2,0,1
274,797448,19,2,4,1,1,1,3,0,0,1,2,0,4,0,0,1,5
274,797445,15,3,4,3,4,0,0,1,2,1,0,0,1,1,1,0,7
274,785623,13,0,2,0,0,0,2,0,0,0,1,1,2,0,0,0,0
275,790771,24,2,3,1,1,1,2,4,8,1,3,0,4,1,2,0,9
275,780271,37,6,10,4,6,2,4,1,5,2,6,1,1,1,0,0,15
275,796328,35,2,6,2,6,0,0,3,4,1,4,2,3,0,3,0,7
275,785230,35,4,11,3,6,1,5,7,10,1,9,1,1,1,5,0,16
275,780022,20,2,5,2,3,0,2,0,0,0,1,1,4,0,2,1,4
275,790774,9,0,3,0,0,0,3,0,0,1,0,0,0,0,0,1,0
275,780375,26,3,8,2,4,1,4,4,5,1,1,2,4,1,1,0,11
275,767736,9,1,2,0,1,1,1,1,2,0,0,0,2,0,1,1,4
275,780267,5,1,2,0,1,1,1,0,0,0,1,1,2,0,0,1,3
276,791295,25,6,10,6,10,0,0,1,1,0,3,2,1,0,4,0,13
276,776345,30,1,4,1,3,0,1,0,0,0,3,1,1,3,6,5,2
276,791293,32,3,6,0,2,3,4,0,0,0,0,0,1,1,1,0,9
276,785794,23,4,9,4,7,0,2,3,4,2,2,1,2,0,1,1,11
276,785792,18,0,5,0,5,0,0,0,0,0,2,2,1,1,2,0,0
276,781379,7,0,0,0,0,0,0,0,0,0,2,0,0,0,0,0,0
276,796577,1,0,0,0,0,0,0,0,0,0,0,0,1,0,0,0,0
276,791292,8,2,3,2,3,0,0,0,0,3,0,0,1,1,1,0,4
276,796579,23,3,7,1,1,2,6,0,0,0,3,2,1,0,0,0,8
276,781373,30,5,8,4,5,1,3,8,9,2,1,2,3,0,3,0,19
276,796578,3,0,0,0,0,0,0,0,0,0,0,0,0,0,0,0,0
278,785224,13,1,5,0,0,1,5,0,0,0,4,0,0,2,2,0,3
278,780879,27,8,13,6,9,2,4,6,7,1,2,4,3,2,1,0,24
278,790769,10,0,0,0,0,0,0,0,0,0,2,1,2,1,2,0,0
278,785743,26,6,10,2,3,4,7,1,1,0,1,3,2,4,2,0,17
278,780875,29,4,8,4,7,0,1,1,2,1,3,2,0,0,0,0,9
278,796326,8,2,3,1,1,1,2,0,0,0,1,0,2,0,0,0,5
278,790768,29,3,6,3,3,0,3,4,4,1,4,3,2,2,0,0,10
278,785226,17,1,5,1,4,0,1,0,0,1,0,1,4,1,2,0,2
278,796324,9,0,2,0,1,0,1,0,0,0,0,0,0,0,0,0,0
278,775785,23,4,7,2,3,2,4,1,1,0,0,2,2,1,1,1,11
278,790767,7,0,0,0,0,0,0,0,0,0,0,0,0,0,0,0,0
278,796325,2,0,0,0,0,0,0,0,0,0,0,0,0,0,0,0,0
279,785388,18,4,11,4,11,0,0,2,2,3,5,2,5,1,2,0,10
279,780370,23,1,4,1,2,0,2,0,0,0,6,2,1,0,1,1,2
279,790840,37,6,14,3,7,3,7,0,0,2,3,1,2,2,3,0,15
279,790841,30,6,10,3,5,3,5,0,0,1,1,1,3,1,5,0,15
279,780373,28,2,5,0,1,2,4,2,2,0,2,0,1,0,2,0,8
279,790839,18,1,4,0,1,1,3,0,0,1,1,0,1,0,1,0,3
279,796393,21,6,8,6,8,0,0,5,7,5,3,0,3,0,4,2,17
279,796396,25,0,2,0,2,0,0,0,0,0,1,5,0,0,3,0,0
280,796344,31,3,11,0,3,3,8,1,2,0,4,0,5,2,1,0,10
280,790781,22,1,3,1,3,0,0,0,0,1,3,0,4,0,3,3,2
280,790785,32,7,14,5,9,2,5,6,11,0,7,3,2,1,3,1,22
280,796340,32,11,17,8,12,3,5,3,3,1,3,2,4,1,2,0,28
280,780037,37,2,8,1,3,1,5,0,0,0,1,2,1,1,0,0,5
280,785239,12,1,2,1,1,0,1,0,0,0,1,0,3,0,0,0,2
280,781232,19,1,5,0,1,1,4,0,0,0,1,1,1,0,0,0,3
280,796343,15,0,0,0,0,0,0,2,5,0,2,0,2,0,0,0,2
280,796345,0,0,0,0,0,0,0,0,0,0,0,0,0,0,0,0,0
281,791981,37,11,17,9,13,2,4,4,6,2,6,0,2,1,3,0,28
281,780342,20,1,3,1,2,0,1,5,5,3,2,1,5,0,1,0,7
281,791982,38,5,12,2,7,3,5,3,4,3,9,1,2,2,3,0,16
281,780333,36,3,8,2,4,1,4,4,5,1,3,4,3,1,0,0,11
281,781493,29,5,9,3,5,2,4,2,3,0,5,4,3,1,3,0,14
281,786756,23,2,7,2,2,0,5,0,2,0,3,0,1,1,1,0,4
281,786755,8,0,0,0,0,0,0,1,2,0,3,0,1,0,0,0,1
281,791984,8,1,2,1,1,0,1,0,0,0,1,0,1,0,0,0,2
281,791985,1,0,0,0,0,0,0,0,0,0,0,0,1,0,0,0,0
288,790983,20,0,3,0,2,0,1,0,0,1,1,0,4,1,1,2,0
288,790981,18,1,7,0,2,1,5,2,2,0,0,2,3,1,2,1,5
288,796699,16,2,4,2,2,0,2,7,7,1,2,2,3,1,3,0,11
288,790979,29,7,11,3,4,4,7,2,3,1,4,1,0,1,1,0,20
288,790978,21,2,8,0,3,2,5,0,0,0,1,1,1,3,3,0,6
288,796701,14,0,0,0,0,0,0,0,0,1,3,1,2,1,1,2,0
288,788820,21,4,12,1,1,3,11,0,0,0,2,1,1,0,1,0,11
288,796700,22,3,8,2,5,1,3,0,0,1,5,3,0,1,2,0,7
288,790976,18,2,3,2,2,0,1,0,1,2,2,1,1,0,0,1,4
288,796698,13,0,2,0,2,0,0,1,2,2,2,0,2,0,2,0,1
288,790980,8,1,1,1,1,0,0,0,0,0,1,0,0,0,1,1,2
289,790799,27,3,7,3,5,0,2,0,0,3,2,2,3,0,1,1,6
289,780140,29,9,14,5,6,4,8,3,3,2,4,2,1,2,2,0,25
289,790798,30,11,16,10,15,1,1,5,6,3,7,0,1,0,2,1,28
289,796355,26,6,9,6,7,0,2,0,1,0,4,6,4,2,2,1,12
289,780137,33,2,9,1,5,1,4,0,0,1,6,3,3,1,1,0,5
289,785245,24,1,5,1,2,0,3,3,4,0,1,3,1,0,4,0,5
289,775553,18,2,4,2,3,0,1,1,3,1,3,3,2,1,0,1,5
289,790796,7,2,3,2,3,0,0,0,0,0,1,0,2,1,1,0,4
289,790800,2,0,1,0,1,0,0,0,0,0,0,0,0,0,0,0,0
289,794905,1,0,0,0,0,0,0,0,0,0,1,0,0,0,0,0,0
289,790795,2,0,0,0,0,0,0,0,0,0,0,0,0,0,1,0,0
289,788844,1,0,0,0,0,0,0,0,0,0,0,0,0,0,0,0,0
290,791949,16,4,10,4,6,0,4,1,2,0,4,0,4,0,2,1,9
290,776014,30,2,7,1,3,1,4,0,0,4,9,0,2,3,0,1,5
290,797691,32,4,8,4,6,0,2,0,0,1,4,6,1,1,1,2,8
290,780747,39,6,10,5,7,1,3,2,4,1,5,7,4,4,1,1,15
290,776363,35,1,6,0,3,1,3,2,2,0,2,0,2,2,1,0,5
290,784336,11,3,6,3,5,0,1,2,2,3,1,0,1,0,1,0,8
290,791946,32,7,17,4,12,3,5,7,9,1,2,3,2,1,1,0,24
290,791948,5,1,1,1,1,0,0,0,0,0,1,0,2,0,0,1,2
291,797967,35,5,11,4,9,1,2,6,8,3,12,2,1,0,3,0,17
291,797962,27,0,2,0,2,0,0,0,0,1,4,0,4,0,0,1,0
291,797970,32,7,14,4,11,3,3,3,5,0,5,2,1,1,3,0,20
291,781453,33,5,18,1,9,4,9,5,5,0,3,6,3,1,3,0,19
291,774869,31,2,5,2,3,0,2,0,0,0,2,0,4,1,2,0,4
291,792254,8,1,1,0,0,1,1,0,0,0,0,1,0,0,1,0,3
291,786098,17,1,5,0,3,1,2,3,4,0,1,2,3,0,1,0,6
291,792256,10,1,1,1,1,0,0,2,2,1,2,0,3,0,0,0,4
291,797961,7,0,0,0,0,0,0,0,0,0,0,0,0,0,0,0,0
292,792140,29,5,6,5,6,0,0,0,0,1,2,0,4,0,3,2,10
292,792144,21,1,4,0,2,1,2,2,4,1,7,0,3,0,4,1,5
292,792148,33,5,14,3,8,2,6,2,4,0,4,2,2,3,1,1,14
292,776092,35,4,16,3,13,1,3,4,4,1,8,5,5,0,4,0,13
292,781429,38,3,8,0,0,3,8,2,3,0,3,0,2,0,0,0,11
292,792146,11,1,1,1,1,0,0,0,2,2,2,0,3,1,0,0,2
292,797786,13,2,6,1,3,1,3,2,2,0,0,2,2,0,1,0,7
292,797789,14,0,2,0,0,0,2,0,0,0,4,0,2,0,1,0,0
292,785975,1,0,1,0,0,0,1,0,0,0,0,0,1,0,0,0,0
292,781431,5,0,1,0,0,0,1,2,2,0,2,0,0,0,0,0,2
293,792265,31,3,11,1,6,2,5,0,2,1,8,1,5,1,1,2,8
293,792266,13,1,6,0,5,1,1,0,0,1,0,0,0,0,0,0,3
293,786152,25,5,13,4,10,1,3,4,6,2,7,2,3,1,2,1,15
293,798009,34,8,14,7,11,1,3,3,5,0,6,3,3,1,2,0,20
293,798006,16,1,5,0,2,1,3,0,0,0,0,2,1,0,0,0,3
293,798007,14,1,2,1,1,0,1,0,0,1,1,0,3,0,1,0,2
293,798002,6,0,0,0,0,0,0,0,0,0,1,2,0,0,1,0,0
293,798005,4,0,0,0,0,0,0,0,0,0,0,1,1,0,0,0,0
293,797998,17,2,4,1,2,1,2,3,4,0,4,0,2,0,1,0,8
293,798003,6,0,0,0,0,0,0,0,2,0,1,0,2,0,3,0,0
293,792267,24,2,4,1,2,1,2,2,4,0,0,0,1,1,0,0,7
293,792263,10,0,2,0,2,0,0,0,1,0,5,2,0,2,0,0,0
294,780096,35,2,3,1,2,1,1,3,6,0,3,3,2,1,1,0,8
294,785906,38,10,21,9,17,1,4,6,7,4,3,8,3,1,3,0,27
294,780100,24,3,6,0,2,3,4,2,2,2,8,1,2,0,2,0,11
294,791416,28,6,10,6,10,0,0,1,2,2,12,1,2,1,3,0,13
294,797096,33,4,11,4,7,0,4,3,5,1,1,0,1,0,2,0,11
294,785907,20,2,4,2,4,0,0,0,2,0,1,0,2,0,2,1,4
294,781614,8,0,2,0,1,0,1,0,0,1,1,1,1,0,0,0,0
294,797093,11,1,1,0,0,1,1,0,0,0,2,0,1,0,2,0,3
294,797094,2,0,0,0,0,0,0,0,0,0,1,0,0,0,0,0,0
294,785903,1,0,0,0,0,0,0,0,0,0,0,0,0,0,0,0,0
295,786534,37,13,23,10,19,3,4,2,4,0,6,8,3,1,0,0,31
295,791940,34,1,3,1,3,0,0,2,4,0,0,3,1,1,1,0,4
295,792197,31,2,5,1,1,1,4,0,0,0,3,0,4,0,2,1,5
295,797517,30,6,12,6,12,0,0,0,1,3,5,2,4,1,1,1,12
295,781132,39,8,18,4,8,4,10,0,0,0,5,2,3,4,1,1,20
295,791939,10,0,1,0,1,0,0,0,0,0,0,0,1,0,0,0,0
295,797518,3,0,0,0,0,0,0,0,0,0,0,0,0,1,0,0,0
295,797519,3,0,0,0,0,0,0,0,0,0,0,0,2,1,0,0,0
295,791938,13,1,3,0,2,1,1,0,0,0,0,1,0,1,1,0,3
296,781081,14,1,4,1,4,0,0,0,0,5,3,0,4,0,2,0,2
296,791864,28,2,4,1,1,1,3,8,10,1,5,0,2,1,3,0,13
296,786592,13,1,4,1,4,0,0,2,3,0,0,2,4,1,3,0,4
296,797472,31,3,13,1,5,2,8,0,2,2,4,1,0,2,2,0,8
296,776447,9,1,4,1,4,0,0,0,0,0,1,0,1,0,0,0,2
296,797473,23,4,6,4,6,0,0,0,1,3,4,0,4,0,2,1,8
296,797471,5,0,1,0,1,0,0,0,0,1,1,0,0,0,0,1,0
296,797470,31,6,13,5,10,1,3,2,4,3,0,3,3,1,2,1,15
296,786307,15,0,2,0,1,0,1,0,0,1,1,1,3,0,0,0,0
296,791863,23,4,5,4,5,0,0,1,2,1,5,2,1,2,0,0,9
296,780195,8,1,1,0,0,1,1,0,0,0,1,0,1,0,1,1,3
296,791865,0,0,0,0,0,0,0,0,0,0,0,0,0,0,0,0,0
297,796951,29,3,14,2,9,1,5,1,3,3,5,1,3,0,2,0,8
297,781249,23,2,4,1,2,1,2,2,2,2,2,1,4,0,1,0,7
297,775165,30,1,2,0,0,1,2,1,3,1,6,2,4,1,1,0,4
297,785515,35,4,9,3,6,1,3,4,5,2,2,1,3,4,5,0,13
297,781253,32,6,15,3,5,3,10,5,5,1,1,2,2,1,1,1,20
297,796953,12,2,2,2,2,0,0,1,2,2,4,0,2,0,1,2,5
297,796952,13,1,4,1,2,0,2,0,2,4,2,0,3,0,2,1,2
297,791252,18,0,4,0,2,0,2,0,0,1,2,2,2,0,1,0,0
297,791251,8,1,2,1,1,0,1,0,0,0,0,1,0,0,0,0,2
298,792432,28,3,6,2,4,1,2,3,4,0,1,4,3,0,3,0,10
298,792427,28,4,12,3,10,1,2,5,5,0,4,1,1,0,0,0,14
298,791306,25,5,8,3,5,2,3,0,0,0,4,3,3,0,1,1,12
298,780210,36,10,15,9,12,1,3,1,1,4,6,2,3,0,6,0,22
298,792433,10,0,1,0,0,0,1,0,0,0,0,1,2,1,0,0,0
298,796592,16,1,1,1,1,0,0,0,0,1,2,0,2,0,3,0,2
298,796594,18,2,5,2,3,0,2,0,0,2,0,0,0,0,3,0,4
298,792431,5,0,1,0,1,0,0,2,2,1,0,0,1,0,0,0,2
298,789632,1,0,0,0,0,0,0,0,0,0,0,0,2,0,0,0,0
298,790880,2,0,1,0,0,0,1,0,0,1,0,0,0,0,0,0,0
298,775005,20,1,6,1,4,0,2,1,2,1,3,1,2,1,1,0,3
298,786422,11,1,3,1,2,0,1,1,2,1,1,0,4,0,1,0,3
299,781345,29,3,5,1,3,2,2,2,5,0,5,2,2,2,2,0,10
299,786803,27,4,6,4,5,0,1,1,2,0,1,2,2,1,2,0,9
299,790932,29,5,7,4,5,1,2,3,4,0,1,2,1,0,3,0,14
299,786805,30,4,9,4,9,0,0,4,6,2,3,1,2,2,2,0,12
299,774936,21,4,8,4,8,0,0,2,3,1,1,1,2,0,1,0,10
299,796487,7,2,2,1,1,1,1,0,0,0,0,0,0,0,0,0,5
299,790934,9,1,1,1,1,0,0,1,1,0,4,1,3,1,0,0,3
299,780033,2,0,0,0,0,0,0,0,0,0,0,1,0,0,0,0,0
299,790933,15,1,3,0,1,1,2,2,4,0,1,1,2,2,2,0,5
299,790931,11,1,2,1,2,0,0,2,2,0,2,1,3,0,1,0,4
299,786804,20,4,10,4,9,0,1,0,2,2,2,0,1,4,2,1,8
300,786818,20,3,8,3,7,0,1,1,2,2,2,1,2,1,2,1,7
300,798139,19,5,7,3,4,2,3,0,0,0,1,6,2,0,2,0,12
300,780182,31,8,13,0,1,8,12,0,0,0,8,4,2,0,2,1,24
300,796585,15,2,3,2,3,0,0,0,4,0,5,1,0,0,0,0,4
300,780192,28,4,7,2,3,2,4,1,2,0,7,5,3,0,3,0,11
300,790974,7,0,0,0,0,0,0,0,0,0,0,0,0,0,0,0,0
300,780184,11,2,5,0,0,2,5,0,0,0,1,1,0,1,0,0,6
300,780186,25,4,5,4,5,0,0,0,0,1,9,3,0,0,2,0,8
300,786820,11,0,2,0,1,0,1,2,2,0,0,2,1,0,1,0,2
300,798138,21,0,4,0,1,0,3,0,0,0,1,0,1,0,0,0,0
300,780188,2,0,0,0,0,0,0,0,0,0,0,0,0,0,0,0,0
300,796582,10,2,3,1,1,1,2,0,0,0,1,0,1,0,1,0,5
301,796752,29,3,9,3,7,0,2,4,4,0,2,1,2,1,3,0,10
301,785569,29,2,10,1,3,1,7,4,4,0,5,0,0,1,0,0,9
301,791097,11,1,4,1,3,0,1,0,0,0,3,2,1,0,1,0,2
301,796753,21,2,7,1,3,1,4,0,0,0,1,0,0,1,0,0,5
301,791089,17,0,1,0,0,0,1,2,2,2,4,1,1,0,0,0,2
301,791093,17,6,11,6,9,0,2,0,2,2,2,0,2,1,0,0,12
301,791090,12,0,3,0,2,0,1,0,0,0,0,0,1,2,2,1,0
301,791091,16,2,4,1,1,1,3,0,0,0,1,0,1,1,2,0,5
301,791094,25,3,7,3,4,0,3,0,1,0,4,0,0,2,1,0,6
301,785577,23,3,7,3,7,0,0,0,0,1,2,1,2,0,1,1,6
302,791227,26,0,3,0,1,0,2,2,2,1,0,2,1,2,0,0,2
302,785557,31,7,13,6,10,1,3,0,0,2,6,0,3,1,5,1,15
302,791228,27,1,8,1,4,0,4,2,4,3,4,0,4,2,4,0,4
302,785624,28,1,6,1,2,0,4,0,0,2,1,3,4,0,1,0,2
302,791230,29,5,12,5,6,0,6,0,2,2,3,1,0,0,0,1,10
302,781201,11,1,2,0,1,1,1,0,0,0,0,0,0,1,0,0,3
302,796932,29,3,13,3,10,0,3,3,3,1,5,4,2,4,4,0,9
302,791226,7,1,1,1,1,0,0,0,0,0,2,0,1,0,0,2,2
302,781211,1,0,0,0,0,0,0,0,0,0,0,0,0,0,0,0,0
302,796935,11,5,9,3,4,2,5,1,1,1,0,0,0,0,1,0,13
303,791113,25,3,7,3,5,0,2,1,2,0,5,0,4,1,4,0,7
303,796765,29,2,8,2,5,0,3,0,0,0,1,3,2,2,6,0,4
303,796767,33,6,15,4,12,2,3,5,6,2,8,1,3,1,6,2,19
303,785614,21,0,4,0,4,0,0,1,2,3,3,0,2,0,1,0,1
303,791111,25,1,3,0,1,1,2,0,0,0,1,1,0,0,3,0,3
303,796766,24,3,8,3,5,0,3,0,0,2,2,1,4,1,3,1,6
303,785618,10,0,2,0,0,0,2,0,0,0,2,0,0,0,0,0,0
303,780813,33,4,6,4,5,0,1,2,2,0,8,1,1,1,1,0,10
304,797715,22,2,9,0,5,2,4,0,0,1,4,5,3,2,0,0,6
304,780937,24,3,7,2,3,1,4,0,0,4,2,3,2,1,0,1,7
304,791950,23,5,12,1,4,4,8,0,0,0,1,0,1,1,4,0,14
304,785350,22,1,9,1,6,0,3,0,0,1,4,2,0,0,2,0,2
304,775754,24,4,11,3,6,1,5,5,7,1,6,3,4,3,6,0,14
304,797716,6,1,2,1,1,0,1,0,0,0,0,0,1,0,0,1,2
304,791149,23,7,14,3,6,4,8,0,0,0,2,0,3,0,1,0,18
304,797717,5,1,1,1,1,0,0,2,2,1,1,0,3,0,2,0,4
304,792115,17,0,1,0,1,0,0,0,0,0,1,0,0,1,0,0,0
304,792113,25,2,7,1,3,1,4,0,0,3,0,0,2,2,0,0,5
304,780938,9,0,2,0,2,0,0,0,0,0,1,1,2,0,0,0,0
305,785362,12,2,6,2,6,0,0,4,6,1,2,0,2,0,3,0,8
305,796370,21,3,7,2,5,1,2,0,0,0,4,2,2,0,4,0,7
305,790808,36,10,13,5,5,5,8,5,5,1,8,3,2,4,3,0,30
305,785361,34,7,13,5,8,2,5,2,2,2,2,1,1,1,2,1,18
305,779997,29,1,5,1,5,0,0,3,4,2,5,3,2,3,0,0,5
305,796371,1,0,0,0,0,0,0,0,0,0,0,0,0,0,0,1,0
305,790810,24,4,8,4,6,0,2,6,9,3,6,3,1,0,1,1,14
305,774854,5,0,0,0,0,0,0,1,2,0,2,0,1,0,1,0,1
305,796368,12,1,5,1,4,0,1,0,0,1,2,0,1,0,1,1,2
305,790809,16,1,1,0,0,1,1,0,0,1,2,5,2,2,1,0,3
305,790811,10,3,6,3,5,0,1,0,0,0,3,0,0,0,0,0,6
306,791686,22,1,4,1,2,0,2,4,5,1,3,0,4,0,3,0,6
306,792269,33,2,3,2,3,0,0,2,4,3,2,0,4,0,1,2,6
306,790940,31,4,12,0,4,4,8,3,4,0,7,0,3,0,0,0,15
306,786060,17,2,11,2,6,0,5,1,1,1,2,1,1,1,1,1,5
306,780770,30,3,11,1,5,2,6,0,0,1,0,4,3,1,2,0,8
306,798028,24,0,5,0,5,0,0,4,6,0,6,1,1,1,5,0,4
306,792271,21,5,10,4,8,1,2,1,1,5,5,1,4,1,0,1,12
306,798022,14,3,5,0,0,3,5,0,0,0,0,0,1,2,1,0,9
306,792305,3,0,1,0,0,0,1,1,2,1,0,0,0,0,1,0,1
306,792270,5,0,0,0,0,0,0,0,0,0,2,1,1,0,0,0,0
307,780201,30,3,9,3,9,0,0,0,0,3,5,1,4,0,3,0,6
307,798344,25,1,8,1,7,0,1,0,2,1,2,0,2,3,3,0,2
307,797208,31,3,6,3,6,0,0,8,11,2,3,0,3,2,3,0,14
307,791467,39,5,16,3,6,2,10,6,8,3,4,2,3,0,1,0,18
307,775516,34,5,11,4,8,1,3,2,6,1,3,5,2,1,3,0,13
307,791469,20,2,4,2,4,0,0,0,0,2,4,1,2,0,1,1,4
307,791471,2,0,1,0,0,0,1,0,0,0,0,0,1,0,1,0,0
307,791470,19,0,0,0,0,0,0,0,0,0,8,1,4,1,1,1,0
308,785988,30,3,11,0,3,3,8,0,0,0,4,2,1,1,2,0,9
308,797529,30,2,3,1,2,1,1,0,0,1,5,0,3,2,0,1,5
308,797527,29,2,6,0,3,2,3,4,5,5,3,2,5,2,0,1,10
308,797532,38,5,17,3,11,2,6,5,10,0,3,5,1,7,4,0,17
308,791936,20,1,3,1,3,0,0,1,4,2,3,0,1,0,7,0,3
308,791933,25,3,13,0,1,3,12,2,2,1,4,0,1,1,0,0,11
308,791932,9,0,3,0,1,0,2,0,0,0,0,0,0,1,1,0,0
308,791931,17,2,4,1,2,1,2,0,0,1,1,0,2,0,1,0,5
308,797530,2,0,2,0,2,0,0,0,0,0,0,0,0,0,0,0,0
309,786349,20,3,8,2,5,1,3,1,1,0,2,3,3,0,2,0,8
309,785335,11,0,0,0,0,0,0,3,4,0,5,0,1,0,1,1,3
309,780303,36,8,14,8,13,0,1,0,0,2,8,6,2,2,2,3,16
309,781385,26,3,5,0,0,3,5,0,0,0,4,3,4,3,4,0,9
309,791594,30,4,7,2,4,2,3,0,1,0,3,4,3,2,2,0,10
309,791013,2,0,1,0,0,0,1,0,0,0,0,0,0,0,0,0,0
309,796668,3,1,3,0,1,1,2,0,0,1,0,0,0,0,0,0,3
309,781221,20,3,5,1,2,2,3,0,0,0,2,3,2,0,4,0,8
309,791012,21,1,3,0,0,1,3,0,0,0,2,2,3,0,0,0,3
309,796671,19,6,7,6,7,0,0,0,5,2,6,0,2,1,0,1,12
309,791011,12,0,3,0,3,0,0,2,2,0,3,1,0,1,5,1,2
310,781204,27,2,4,2,2,0,2,6,6,1,4,2,5,1,2,0,10
310,786566,33,6,13,4,6,2,7,3,4,0,5,2,5,0,0,0,17
310,786568,13,2,2,2,2,0,0,0,0,0,0,0,4,0,2,0,4
310,781188,55,10,25,7,14,3,11,10,12,0,6,3,2,2,6,0,33
310,781189,43,4,12,2,5,2,7,2,2,1,3,3,5,1,3,1,12
310,791993,30,1,4,1,1,0,3,0,0,0,5,6,1,0,1,1,2
310,791997,33,3,7,2,2,1,5,7,7,1,4,1,3,0,0,0,14
310,786562,36,2,7,1,2,1,5,1,2,1,5,2,2,1,1,0,6
310,791995,5,0,1,0,0,0,1,0,0,1,1,0,2,0,0,1,0
311,780283,28,5,7,5,7,0,0,3,5,1,2,4,5,0,2,0,13
311,785474,35,7,15,6,11,1,4,6,8,3,3,0,5,1,1,1,21
311,785476,52,8,19,5,10,3,9,3,4,2,4,7,4,1,1,0,22
311,790925,55,5,13,4,6,1,7,5,11,3,8,5,4,1,1,1,16
311,780285,51,8,17,6,13,2,4,8,9,2,10,6,4,1,4,1,26
311,785480,43,3,9,0,0,3,9,0,0,1,6,0,3,1,1,0,9
311,790926,11,0,2,0,1,0,1,0,0,0,1,0,0,0,0,0,0
311,796470,0,0,0,0,0,0,0,0,0,0,0,0,0,0,0,0,0
312,791585,20,1,2,1,2,0,0,0,0,0,5,0,1,2,0,0,2
312,780062,21,6,6,6,6,0,0,0,0,0,1,0,1,0,3,1,12
312,786395,29,6,10,3,4,3,6,0,0,0,3,6,1,2,2,0,15
312,786394,25,5,7,2,3,3,4,1,1,0,0,6,1,2,2,0,14
312,780404,26,6,6,5,5,1,1,2,2,0,5,4,1,0,2,0,15
312,791582,14,1,3,1,3,0,0,2,4,0,2,0,0,0,0,1,4
312,797041,14,0,1,0,1,0,0,1,2,0,3,1,3,0,2,0,1
312,791581,19,3,5,2,2,1,3,4,4,1,2,2,3,1,2,0,11
312,785228,20,1,3,1,2,0,1,4,4,0,5,1,2,0,2,1,6
312,780403,9,0,0,0,0,0,0,0,2,1,1,1,1,0,0,0,0
312,797037,3,1,1,1,1,0,0,0,0,0,0,0,0,0,0,0,2
313,792486,16,1,4,1,3,0,1,0,0,0,0,1,0,0,0,0,2
313,785772,13,0,1,0,1,0,0,1,2,0,0,0,2,1,0,1,1
313,785778,17,2,4,2,4,0,0,0,0,2,1,0,1,0,0,0,4
313,785766,24,3,8,2,2,1,6,0,0,0,1,2,1,1,3,0,7
313,780546,17,3,4,3,3,0,1,1,2,1,0,0,1,0,0,0,7
313,797419,14,1,2,0,0,1,2,0,0,0,1,0,0,0,3,0,3
313,792482,12,0,2,0,0,0,2,0,0,0,1,0,0,1,0,0,0
313,792481,19,3,8,3,7,0,1,0,0,0,2,2,2,1,1,0,6
313,780543,21,4,9,2,5,2,4,0,0,0,0,1,0,1,2,0,10
313,792489,18,0,4,0,3,0,1,0,0,1,1,0,1,0,1,0,0
313,792488,9,1,4,0,0,1,4,0,0,0,0,0,0,0,1,0,3
313,780544,6,0,0,0,0,0,0,0,0,0,1,0,4,0,0,0,0
313,792484,5,1,2,0,0,1,2,0,0,0,0,0,3,0,0,0,3
313,792487,5,1,1,1,1,0,0,0,0,0,1,1,0,0,0,0,2
313,785774,4,2,2,2,2,0,0,0,0,0,0,0,0,0,0,0,4
314,785676,35,6,13,4,7,2,6,0,0,1,5,2,5,2,3,0,14
314,774974,35,6,11,5,9,1,2,2,4,0,5,2,2,2,3,1,15
314,780824,26,1,5,1,5,0,0,5,6,2,1,0,2,0,2,0,7
314,791117,20,2,6,1,2,1,4,0,0,0,3,3,1,0,1,0,5
314,791118,35,3,8,3,5,0,3,4,4,1,4,3,1,2,2,0,10
314,796769,26,1,6,0,2,1,4,0,0,1,1,1,2,1,0,0,3
314,791116,18,1,4,1,4,0,0,1,2,0,4,0,1,0,0,1,3
314,791115,5,0,0,0,0,0,0,0,1,0,1,0,2,0,1,0,0
315,791209,14,3,4,3,4,0,0,0,0,0,0,0,4,0,1,1,6
315,791213,19,3,7,3,4,0,3,0,0,0,4,2,0,0,2,1,6
315,785589,36,7,14,7,14,0,0,4,5,1,4,1,1,0,2,0,18
315,791214,32,7,13,7,11,0,2,1,1,2,4,2,0,1,2,1,15
315,791216,22,2,5,2,4,0,1,1,2,0,5,3,2,1,1,0,5
315,791207,2,0,1,0,1,0,0,0,0,0,0,0,1,0,0,0,0
315,776364,27,3,5,3,3,0,2,2,2,1,6,1,3,2,2,0,8
315,791215,23,0,2,0,0,0,2,0,0,0,1,5,2,1,0,0,0
315,776313,25,3,6,1,1,2,5,0,0,0,4,0,1,2,0,1,8
316,791534,31,3,6,3,5,0,1,5,6,0,6,1,3,0,2,0,11
316,797127,24,5,9,5,7,0,2,1,2,4,1,0,5,1,1,0,11
316,791533,21,2,3,2,2,0,1,2,2,0,3,1,2,0,1,1,6
316,791528,34,4,10,3,6,1,4,0,0,0,4,1,3,0,1,0,9
316,775045,40,6,17,6,16,0,1,6,7,2,9,6,2,1,2,0,18
316,797124,16,1,5,1,4,0,1,2,4,2,1,0,1,0,0,0,4
316,791531,29,3,7,2,3,1,4,3,3,0,7,0,2,0,1,0,10
316,791527,5,1,1,1,1,0,0,0,0,0,0,0,3,1,0,1,2
317,780765,36,8,17,6,13,2,4,4,5,6,4,2,2,0,2,1,22
317,781301,23,1,3,1,3,0,0,4,6,5,3,0,4,0,2,2,6
317,786255,33,3,12,2,7,1,5,4,5,1,5,3,5,1,2,1,11
317,780762,27,2,8,2,4,0,4,2,3,1,2,0,0,0,0,0,6
317,780768,29,4,8,3,6,1,2,2,2,0,3,3,3,0,1,0,11
317,791729,11,1,2,0,1,1,1,0,0,1,1,1,4,0,0,0,3
317,780755,29,2,12,1,7,1,5,3,5,0,6,1,2,1,2,0,8
317,776241,8,1,4,1,2,0,2,1,1,0,0,0,0,0,0,0,3
317,797320,4,0,0,0,0,0,0,0,0,0,1,0,0,0,0,0,0
318,776266,26,1,4,0,2,1,2,0,0,0,2,3,5,0,3,0,3
318,791738,31,3,5,3,5,0,0,4,6,6,8,0,1,0,0,0,10
318,780717,20,3,9,2,8,1,1,5,7,0,6,3,4,0,6,0,12
318,786203,38,4,13,3,6,1,7,2,4,0,10,3,0,2,1,0,11
318,791741,6,0,0,0,0,0,0,0,0,0,0,0,0,0,0,0,0
318,776328,26,4,12,3,6,1,6,0,3,1,7,2,2,0,3,0,9
318,791742,35,4,9,3,6,1,3,5,7,0,2,2,3,1,2,1,14
318,791740,15,2,3,1,2,1,1,0,0,0,1,0,2,0,1,0,5
318,786200,1,1,1,1,1,0,0,0,2,1,0,0,0,0,0,0,2
318,797337,2,0,0,0,0,0,0,0,0,0,1,0,1,0,1,0,0
319,786275,26,3,9,3,8,0,1,1,1,0,4,2,1,2,1,0,7
319,792301,34,7,19,6,14,1,5,6,6,0,3,4,4,0,4,0,21
319,792299,25,2,7,0,1,2,6,2,2,0,2,1,5,2,0,2,8
319,786278,12,0,2,0,1,0,1,0,0,0,1,1,2,0,3,0,0
319,792304,26,3,11,3,8,0,3,3,4,1,8,1,2,1,0,0,9
319,798092,9,0,1,0,1,0,0,0,0,1,3,0,2,0,0,0,0
319,792302,3,1,1,1,1,0,0,0,1,0,1,0,1,0,0,0,2
319,786280,10,0,0,0,0,0,0,0,0,0,4,1,3,1,1,0,0
319,792295,3,0,0,0,0,0,0,0,0,0,0,0,1,1,1,0,0
319,786286,29,5,10,3,3,2,7,2,2,1,1,0,2,1,0,0,14
319,781220,23,0,2,0,2,0,0,2,2,0,3,0,3,1,2,1,2
320,791905,19,1,4,1,2,0,2,0,0,0,1,1,4,0,1,0,2
320,781103,20,1,2,0,1,1,1,0,0,0,1,3,5,0,2,0,3
320,797568,32,5,13,1,4,4,9,0,0,0,2,2,4,0,1,0,14
320,786517,37,9,23,5,12,4,11,2,2,1,4,1,3,1,2,0,24
320,781102,29,3,7,3,5,0,2,3,5,4,6,0,3,1,0,0,9
320,791909,1,0,0,0,0,0,0,0,0,0,1,0,0,0,0,0,0
320,791907,3,0,1,0,1,0,0,0,0,0,0,1,1,0,1,0,0
320,791904,17,5,8,1,3,4,5,0,0,0,3,0,3,1,1,0,14
320,797566,26,1,5,0,2,1,3,2,2,0,6,1,2,0,2,2,5
320,791908,15,0,6,0,2,0,4,0,0,0,0,4,0,0,0,0,0
320,791906,1,0,0,0,0,0,0,0,0,0,0,0,0,0,0,0,0
321,781579,36,6,12,6,10,0,2,3,4,4,6,4,2,1,0,0,15
321,786731,31,3,6,3,6,0,0,9,11,1,9,2,3,1,2,4,15
321,798023,38,5,11,3,7,2,4,5,5,1,3,3,1,1,4,0,17
321,781584,31,3,8,1,4,2,4,1,2,0,2,2,2,1,1,0,9
321,780347,35,8,16,6,10,2,6,4,7,1,5,2,2,1,1,1,22
321,775696,4,0,1,0,1,0,0,0,0,0,0,0,0,0,2,0,0
321,776481,3,0,0,0,0,0,0,1,2,0,1,0,2,0,1,1,1
321,798017,8,1,1,0,0,1,1,0,0,0,3,0,0,0,0,0,3
321,798008,6,0,0,0,0,0,0,0,0,0,1,1,1,0,0,0,0
321,792358,8,0,1,0,1,0,0,0,0,0,0,0,0,0,1,1,0
322,797611,19,6,10,4,6,2,4,0,0,1,3,0,1,1,0,0,14
322,781019,26,1,3,1,3,0,0,0,0,2,7,11,2,1,0,1,2
322,791774,16,1,6,1,5,0,1,0,1,1,1,1,2,0,0,0,2
322,787524,24,5,6,2,2,3,4,1,2,0,5,0,1,0,0,0,14
322,780017,26,2,5,1,4,1,1,2,2,1,2,3,1,0,3,0,7
322,780328,15,4,7,4,7,0,0,2,3,0,0,0,1,1,0,0,10
322,791772,19,3,5,1,2,2,3,3,3,0,0,2,3,2,1,0,11
322,791722,12,0,1,0,0,0,1,1,2,0,0,2,0,0,1,0,1
322,787522,9,0,1,0,1,0,0,0,0,0,1,0,3,0,2,0,0
322,775541,15,2,5,1,3,1,2,3,4,1,4,1,2,0,0,0,8
322,783269,12,2,5,1,2,1,3,0,0,0,1,0,3,0,1,0,5
322,797610,7,0,4,0,0,0,4,0,0,1,0,0,1,0,1,0,0
323,792699,25,4,8,3,6,1,2,3,3,1,4,1,2,0,2,0,12
323,796774,20,0,2,0,1,0,1,2,4,0,3,0,2,0,1,2,2
323,796776,37,5,15,3,11,2,4,0,0,1,2,1,2,1,2,0,12
323,792695,23,1,3,1,3,0,0,1,3,1,7,0,5,0,3,1,3
323,792702,24,2,5,1,2,1,3,2,4,0,3,0,2,0,3,0,7
323,792704,1,0,0,0,0,0,0,0,0,0,1,0,0,0,0,0,0
323,796772,8,0,0,0,0,0,0,0,0,0,0,1,1,0,1,0,0
323,796775,11,1,2,1,2,0,0,0,0,1,1,0,2,0,1,1,2
323,792698,28,1,8,1,3,0,5,4,5,0,2,4,3,0,5,0,6
323,792701,23,0,3,0,1,0,2,0,0,0,2,1,1,0,1,0,0
324,785495,35,12,22,10,18,2,4,2,5,4,8,2,2,1,4,0,28
324,785958,22,1,6,1,4,0,2,4,7,4,4,1,0,0,1,1,6
324,775377,31,4,5,4,5,0,0,0,0,7,5,1,3,0,1,4,8
324,785494,34,2,10,1,5,1,5,2,2,0,2,5,1,3,2,1,7
324,780698,38,7,18,6,11,1,7,5,9,2,4,5,3,5,5,1,20
324,785490,17,1,2,0,0,1,2,0,0,1,0,0,4,0,0,0,3
324,785659,10,0,0,0,0,0,0,0,0,1,2,1,5,1,1,0,0
324,791033,2,0,0,0,0,0,0,0,0,0,0,0,3,0,1,0,0
324,780427,11,1,3,1,2,0,1,0,0,0,1,0,2,0,0,0,2
325,775206,25,2,5,1,3,1,2,0,0,0,5,0,5,0,0,0,5
325,780877,20,0,2,0,2,0,0,2,3,3,6,1,3,0,1,1,2
325,792258,26,1,9,1,2,0,7,1,2,1,0,1,3,1,4,0,3
325,786122,24,1,9,1,5,0,4,2,2,1,4,1,0,2,4,0,4
325,776284,35,9,21,7,15,2,6,7,9,3,2,6,2,1,2,1,27
325,792261,21,7,8,7,8,0,0,3,6,5,0,0,1,1,0,1,17
325,786124,20,2,4,2,4,0,0,0,0,1,3,0,3,0,2,1,4
325,786113,16,0,3,0,3,0,0,1,2,0,3,1,2,1,2,0,1
325,786331,9,1,1,1,1,0,0,0,0,0,0,0,0,0,0,0,2
325,780308,4,0,2,0,2,0,0,0,0,0,2,0,0,0,0,0,0
326,792340,19,12,16,12,16,0,0,5,8,3,3,1,0,2,2,0,29
326,792342,16,3,5,3,4,0,1,3,4,0,3,2,3,1,3,0,9
326,792346,20,4,7,4,7,0,0,1,1,0,0,5,3,1,1,0,9
326,781553,21,7,7,7,7,0,0,0,0,3,8,7,2,2,2,1,14
326,781552,19,3,7,3,7,0,0,0,0,0,3,6,3,0,2,0,6
326,798085,3,1,1,1,1,0,0,0,0,0,1,2,0,0,0,0,2
326,798080,8,5,6,5,6,0,0,2,4,1,0,4,1,1,0,0,12
326,798076,8,7,8,7,8,0,0,0,1,0,2,2,0,0,2,0,14
326,790887,10,7,7,7,7,0,0,0,2,1,6,0,3,0,1,1,14
326,798086,22,3,3,3,3,0,0,2,2,0,2,2,1,2,1,0,8
326,798088,9,1,1,1,1,0,0,0,0,0,1,1,2,0,3,0,2
326,798083,3,0,0,0,0,0,0,0,0,0,1,0,0,1,1,1,0
326,792345,9,2,4,2,4,0,0,0,1,1,2,1,0,1,0,0,4
326,792344,14,3,4,3,3,0,1,0,0,0,2,7,5,0,1,0,6
326,792341,19,4,4,4,4,0,0,1,5,1,1,3,3,1,1,0,9
328,785827,33,8,10,8,9,0,1,3,5,2,13,2,3,1,2,3,19
328,790776,22,3,8,3,8,0,0,1,3,5,4,0,1,0,2,0,7
328,785813,38,6,14,2,5,4,9,3,5,1,0,3,4,1,3,0,19
328,786289,16,1,8,0,2,1,6,0,0,0,4,1,5,0,0,0,3
328,796332,29,1,5,0,2,1,3,4,5,0,3,3,3,2,1,0,7
328,796330,23,2,7,1,3,1,4,7,8,3,2,1,2,1,3,0,12
328,796334,14,2,4,2,4,0,0,1,1,0,1,0,3,0,1,0,5
328,796337,25,0,4,0,2,0,2,2,2,0,3,7,0,2,2,0,2
329,781491,30,2,5,1,2,1,3,2,2,0,6,1,2,0,4,0,7
329,792632,16,1,4,1,3,0,1,1,2,1,1,0,3,0,0,0,3
329,781289,28,3,3,3,3,0,0,0,1,1,0,0,4,0,0,1,6
329,792626,32,2,11,2,6,0,5,4,4,3,6,8,4,1,1,1,8
329,792627,16,0,6,0,4,0,2,0,0,0,0,0,0,0,1,0,0
329,780250,22,3,12,3,7,0,5,1,1,1,2,0,4,0,3,0,7
329,796645,23,6,11,5,9,1,2,6,7,1,6,0,2,0,3,0,19
329,796637,6,1,2,1,2,0,0,0,0,0,2,0,2,0,1,0,2
329,796638,15,1,2,0,0,1,2,0,0,0,1,1,1,1,2,0,3
329,796634,7,0,1,0,0,0,1,0,2,0,1,0,1,1,1,0,0
329,796642,2,0,0,0,0,0,0,0,0,0,0,1,1,1,1,0,0
329,792631,3,0,1,0,0,0,1,0,0,0,0,0,0,0,0,0,0
330,797292,22,3,8,3,8,0,0,0,0,2,4,0,1,0,1,0,6
330,780509,15,2,5,2,3,0,2,0,0,1,1,0,4,0,1,0,4
330,797290,31,5,10,3,5,2,5,2,2,0,6,3,1,1,5,0,14
330,797291,23,2,3,1,1,1,2,4,4,0,1,1,0,1,3,1,9
330,791660,31,5,10,4,4,1,6,0,2,0,1,4,1,1,1,0,11
330,791658,18,1,1,1,1,0,0,0,0,0,2,0,0,0,0,1,2
330,791663,3,0,1,0,0,0,1,0,0,0,0,1,1,0,0,0,0
330,791661,22,4,8,2,3,2,5,0,0,0,4,0,1,0,4,0,10
330,797295,6,0,1,0,0,0,1,0,0,0,1,0,0,0,0,0,0
330,797294,1,1,1,0,0,1,1,0,0,0,0,0,0,0,0,0,3
330,786064,28,2,10,1,3,1,7,0,1,3,1,2,5,0,4,0,5
331,791837,29,2,8,1,4,1,4,2,2,3,9,0,1,2,3,0,7
331,780613,30,10,10,9,9,1,1,2,4,1,0,1,1,0,0,2,23
331,775097,23,8,10,8,9,0,1,0,2,2,2,4,1,0,3,0,16
331,780609,33,6,13,5,7,1,6,0,0,0,5,5,1,3,2,0,13
331,776395,34,5,11,2,5,3,6,0,1,0,4,5,1,1,0,0,13
331,786621,17,2,4,1,1,1,3,1,2,1,2,1,2,0,1,1,6
331,786619,17,1,4,1,2,0,2,0,0,0,1,0,3,0,2,0,2
331,797439,4,0,0,0,0,0,0,0,0,0,1,0,1,0,0,0,0
331,797437,13,1,3,1,2,0,1,0,1,1,1,0,0,2,1,0,2
332,786257,19,5,9,5,9,0,0,0,1,1,4,1,3,1,0,2,10
332,786263,13,1,2,1,1,0,1,0,0,1,2,0,2,0,1,0,2
332,797724,31,4,7,1,2,3,5,4,4,0,1,3,1,0,3,1,15
332,792122,33,9,17,5,8,4,9,3,4,1,7,1,1,3,0,0,25
332,775825,37,2,8,1,6,1,2,3,3,1,1,7,4,1,3,0,8
332,797721,1,0,0,0,0,0,0,0,0,0,1,0,0,0,0,0,0
332,792121,26,0,4,0,1,0,3,2,2,0,7,0,2,0,0,1,2
332,797725,20,2,4,2,4,0,0,0,0,2,10,2,3,1,3,1,4
332,792356,1,0,0,0,0,0,0,0,0,0,0,0,0,0,1,0,0
332,797720,1,0,0,0,0,0,0,0,0,0,0,0,0,0,0,0,0
332,797722,6,1,2,0,0,1,2,0,0,0,1,0,0,0,0,0,3
332,786249,12,1,4,0,0,1,4,0,0,0,0,0,4,0,0,0,3
333,792035,33,3,12,3,12,0,0,3,11,5,3,1,2,3,4,1,9
333,780833,17,1,4,1,4,0,0,0,0,1,0,0,0,0,1,1,2
333,792034,33,3,10,3,7,0,3,0,0,1,5,0,1,0,0,1,6
333,792033,33,8,14,6,9,2,5,4,6,0,2,0,3,2,3,0,22
333,780830,33,3,7,3,7,0,0,5,5,0,7,1,5,0,1,0,11
333,797645,4,1,2,1,2,0,0,1,2,0,0,0,0,0,0,0,3
333,785982,1,0,0,0,0,0,0,0,0,0,0,0,0,0,0,0,0
333,797644,1,0,0,0,0,0,0,0,0,0,0,1,0,0,0,0,0
333,791688,15,2,3,2,2,0,1,1,1,0,0,0,1,0,1,0,5
333,785980,14,0,1,0,0,0,1,1,2,0,1,1,1,0,0,0,1
333,785381,16,0,5,0,3,0,2,0,0,0,3,1,0,0,0,0,0
334,791493,29,2,4,2,4,0,0,0,0,0,3,1,4,0,0,1,4
334,789036,29,9,9,9,9,0,0,3,4,1,1,0,4,1,2,0,21
334,791495,9,0,1,0,1,0,0,0,0,1,0,0,2,1,0,0,0
334,786324,34,4,14,2,9,2,5,0,0,1,2,6,5,3,6,0,10
334,776494,29,2,5,1,3,1,2,0,1,1,5,0,2,2,3,0,5
334,781307,17,2,5,2,5,0,0,2,2,1,1,0,3,1,1,0,6
334,797191,1,0,0,0,0,0,0,0,0,0,1,0,0,0,1,0,0
334,791492,33,4,8,2,4,2,4,9,10,0,3,4,2,0,2,0,19
334,791494,19,1,2,1,2,0,0,3,4,0,1,0,1,1,1,0,5
335,785799,18,3,4,3,4,0,0,1,2,3,4,0,4,0,2,0,7
335,780760,25,3,6,1,1,2,5,6,7,2,4,0,1,1,1,7,14
335,791676,18,1,3,1,1,0,2,1,2,0,0,2,5,1,2,0,3
335,780554,29,4,11,4,9,0,2,2,5,2,1,5,3,2,1,0,10
335,780553,30,10,13,9,12,1,1,3,6,0,4,4,1,5,5,0,24
335,797426,4,1,1,1,1,0,0,0,0,0,0,0,0,0,0,0,2
335,791678,14,0,2,0,0,0,2,1,2,2,0,1,2,0,1,0,1
335,791679,10,1,3,1,3,0,0,2,2,3,1,0,4,0,3,0,4
335,785807,14,1,3,0,0,1,3,0,0,3,1,0,3,0,0,0,3
335,785800,28,3,11,0,1,3,10,0,0,0,5,1,1,0,1,0,9
335,791677,10,0,2,0,1,0,1,0,0,1,0,0,0,0,1,0,0
336,792306,31,2,6,2,3,0,3,2,5,2,9,0,3,2,0,2,6
336,786618,10,0,0,0,0,0,0,0,0,2,2,2,4,0,1,0,0
336,781603,25,6,12,3,7,3,5,1,2,3,3,4,2,0,2,1,16
336,780456,25,3,8,1,3,2,5,0,0,1,4,0,2,2,5,0,8
336,792303,30,5,11,4,8,1,3,14,14,0,3,4,0,3,5,0,25
336,776424,14,1,3,1,2,0,1,0,0,1,0,0,0,0,1,0,2
336,792300,10,1,5,1,5,0,0,0,0,0,4,1,0,2,1,0,2
336,797912,17,1,4,0,0,1,4,0,0,0,3,0,0,0,1,0,3
336,797914,6,0,1,0,1,0,0,2,2,0,0,1,0,0,1,0,2
336,796155,10,0,1,0,1,0,0,0,0,0,1,1,0,1,0,0,0
336,790813,10,1,3,0,0,1,3,4,4,0,2,1,0,0,1,0,7
336,781605,12,3,3,3,3,0,0,0,0,1,1,0,0,0,1,0,6
337,792370,32,6,12,4,5,2,7,0,0,1,4,2,1,1,3,2,14
337,792373,34,5,10,5,8,0,2,3,5,0,3,0,3,2,3,0,13
337,781598,23,7,12,3,5,4,7,0,0,1,2,1,1,0,4,0,18
337,797951,18,2,8,1,2,1,6,0,0,0,1,3,2,1,1,0,5
337,786739,31,3,8,3,8,0,0,0,0,2,3,6,1,4,3,0,6
337,775809,18,1,3,0,1,1,2,0,0,0,2,2,5,1,1,1,3
337,775303,29,2,5,1,2,1,3,1,3,1,7,2,3,1,1,2,6
337,792368,7,1,6,0,0,1,6,0,0,1,1,1,1,0,0,0,3
337,797958,4,1,1,0,0,1,1,0,0,0,0,0,0,0,0,0,3
337,790499,3,0,0,0,0,0,0,0,0,0,1,1,2,0,0,0,0
337,797960,1,0,1,0,0,0,1,0,0,0,0,0,1,0,0,0,0
338,797389,22,1,2,1,2,0,0,3,4,1,3,0,2,0,1,1,5
338,791826,32,0,4,0,3,0,1,2,2,1,6,3,2,0,1,2,2
338,786785,33,11,16,6,7,5,9,3,4,1,3,2,3,2,0,0,30
338,786784,31,6,12,5,8,1,4,2,5,2,2,3,0,3,4,0,15
338,776009,30,11,17,10,14,1,3,1,2,0,4,7,1,4,5,0,24
338,797388,17,3,4,3,3,0,1,0,2,1,4,0,0,0,1,1,6
338,780634,15,3,4,3,4,0,0,2,4,2,2,2,3,2,2,4,8
338,797390,13,0,1,0,1,0,0,2,2,1,3,0,1,1,1,1,2
338,797387,3,0,1,0,0,0,1,0,0,0,0,1,0,0,0,0,0
338,778644,1,1,1,1,1,0,0,0,0,0,0,0,0,0,0,0,2
338,780635,3,1,3,1,3,0,0,0,0,3,1,0,1,0,0,0,2
339,796959,34,6,11,6,9,0,2,2,3,5,5,1,3,0,1,0,14
339,781272,24,3,5,3,4,0,1,0,0,1,4,4,4,2,2,0,6
339,791261,30,6,12,3,5,3,7,1,2,0,1,0,2,1,0,0,16
339,791258,29,4,11,1,6,3,5,0,0,0,2,3,2,1,2,0,11
339,781270,37,6,15,4,10,2,5,2,2,0,2,1,1,2,7,0,16
339,796960,17,1,1,1,1,0,0,3,3,2,1,3,2,1,2,1,5
339,791260,11,1,4,1,3,0,1,0,0,0,0,0,5,1,2,0,2
339,796958,15,2,9,2,8,0,1,0,0,1,4,1,2,2,1,1,4
339,785503,3,0,0,0,0,0,0,1,2,0,1,0,1,0,0,0,1
340,796455,31,3,8,3,8,0,0,3,6,5,4,2,3,0,1,1,9
340,787175,29,4,7,2,3,2,4,0,0,3,3,1,4,1,1,2,10
340,782126,2,0,1,0,1,0,0,2,2,0,1,0,0,0,0,0,2
340,790909,34,5,13,2,6,3,7,2,5,2,6,4,3,6,2,0,15
340,781393,39,7,13,2,4,5,9,6,7,0,3,3,2,4,2,0,25
340,790907,14,1,3,1,3,0,0,1,2,2,3,2,1,1,1,0,3
340,796453,19,4,9,3,6,1,3,0,0,3,1,0,1,0,0,0,9
340,775351,32,10,15,10,15,0,0,2,2,1,7,0,1,0,2,0,22
342,797050,28,5,10,2,6,3,4,3,3,0,8,0,2,0,2,1,16
342,780394,21,2,7,2,7,0,0,2,4,3,4,1,3,1,1,0,6
342,780391,29,3,3,2,2,1,1,2,3,2,7,1,3,1,0,2,9
342,791573,28,1,5,1,2,0,3,4,6,0,3,6,0,1,3,0,6
342,776473,24,4,8,2,5,2,3,4,4,0,5,1,4,1,2,0,14
342,797048,21,2,4,1,2,1,2,5,10,2,6,0,0,1,2,0,10
342,790871,30,5,10,3,5,2,5,1,2,2,5,4,2,1,3,1,13
342,780392,14,0,1,0,0,0,1,0,0,0,1,2,2,0,1,0,0
342,785783,2,0,1,0,1,0,0,1,2,0,0,0,1,0,0,0,1
342,797049,3,0,1,0,1,0,0,0,0,0,0,0,0,0,0,0,0
343,791225,29,2,7,2,5,0,2,0,3,2,3,1,2,0,1,2,4
343,791223,24,2,9,2,8,0,1,1,3,2,3,2,2,3,2,0,5
343,786436,19,0,4,0,3,0,1,0,0,1,1,2,2,0,3,0,0
343,785571,31,4,9,3,8,1,1,6,7,0,4,1,0,2,1,0,15
343,781181,28,3,13,0,3,3,10,3,4,0,4,2,4,0,0,0,12
343,775324,10,0,2,0,2,0,0,0,0,3,0,1,3,0,1,0,0
343,791224,24,2,10,2,7,0,3,0,0,1,1,2,4,1,3,1,4
343,785564,16,3,6,0,1,3,5,1,1,0,1,0,1,1,0,0,10
343,796927,16,0,1,0,0,0,1,0,0,0,1,0,5,0,1,0,0
343,791811,3,0,0,0,0,0,0,0,0,0,0,0,0,0,0,0,0
344,780952,29,5,10,5,10,0,0,0,0,3,7,4,1,1,2,5,10
344,780950,15,0,2,0,2,0,0,0,0,1,1,1,4,0,1,1,0
344,791156,36,4,10,3,7,1,3,6,8,1,1,2,3,2,0,2,15
344,791155,33,7,15,5,8,2,7,2,3,3,1,0,5,1,2,0,18
344,796810,22,4,7,2,3,2,4,0,0,0,2,1,4,1,2,0,10
344,796814,5,0,1,0,0,0,1,0,0,0,0,0,3,0,0,1,0
344,785752,24,1,7,1,3,0,4,0,0,1,3,1,3,1,2,0,2
344,796812,11,4,7,4,7,0,0,0,1,1,1,0,0,1,2,0,8
344,786609,25,3,4,3,4,0,0,0,2,5,5,3,1,0,1,0,6
345,796870,33,1,2,1,2,0,0,0,1,3,3,2,1,0,6,0,2
345,786861,39,2,4,1,2,1,2,9,11,1,8,0,1,1,0,0,14
345,792415,30,8,18,6,11,2,7,6,8,3,4,1,3,3,5,0,24
345,780387,20,1,5,1,4,0,1,0,0,1,1,0,5,1,0,0,2
345,767033,28,1,12,1,9,0,3,0,0,0,2,1,3,2,0,0,2
345,786866,18,2,4,1,2,1,2,3,3,1,1,0,1,0,0,0,8
345,792416,19,1,5,1,5,0,0,3,4,0,1,0,1,1,2,0,5
345,785801,4,0,0,0,0,0,0,0,0,0,2,0,0,0,1,0,0
345,786867,9,0,0,0,0,0,0,0,0,0,0,0,0,0,1,0,0
345,796864,0,0,0,0,0,0,0,0,0,0,0,0,0,0,0,0,0
345,796867,0,0,0,0,0,0,0,0,0,0,0,0,0,0,0,0,0
346,776004,20,6,9,5,7,1,2,6,8,2,3,3,0,3,1,1,19
346,780358,21,5,7,5,7,0,0,4,6,2,0,1,4,1,1,1,14
346,775011,25,3,7,1,4,2,3,2,2,1,3,2,0,1,0,0,10
346,780357,15,2,5,1,2,1,3,0,0,1,2,2,1,1,0,0,5
346,775018,19,6,9,3,3,3,6,0,0,0,3,3,0,0,0,0,15
346,796484,16,0,1,0,1,0,0,3,4,0,2,2,4,0,1,1,3
346,796480,25,3,10,2,8,1,2,2,3,0,8,2,1,0,0,1,9
346,790930,18,2,3,1,2,1,1,0,0,0,1,0,1,1,0,2,5
346,776270,21,3,4,2,3,1,1,2,2,0,4,1,3,2,2,0,9
346,796485,11,1,1,1,1,0,0,0,0,0,1,1,4,0,1,1,2
346,796483,3,0,1,0,0,0,1,0,0,0,2,0,0,0,0,0,0
346,785496,3,0,1,0,1,0,0,1,2,0,0,0,1,0,0,0,1
346,796486,3,0,0,0,0,0,0,0,0,0,0,0,0,0,0,0,0
346,785491,0,0,1,0,1,0,0,0,0,0,0,0,0,0,1,0,0
347,792424,29,1,4,1,4,0,0,1,2,1,2,0,5,0,0,0,3
347,789484,34,6,17,3,8,3,9,1,2,1,3,2,2,0,7,0,16
347,792418,26,2,11,1,9,1,2,4,4,2,3,1,5,0,3,1,9
347,796693,26,5,9,4,8,1,1,2,2,1,6,4,0,1,0,0,13
347,792422,23,2,4,2,4,0,0,6,7,1,5,0,2,2,2,0,10
347,796691,12,1,3,0,2,1,1,0,0,0,0,0,2,0,1,0,3
347,792419,28,0,2,0,1,0,1,0,0,0,2,0,2,0,0,1,0
347,782206,3,0,0,0,0,0,0,0,0,0,0,0,0,0,1,0,0
347,792421,9,1,2,1,2,0,0,2,4,0,0,0,1,0,1,0,4
347,792423,8,0,1,0,1,0,0,0,0,0,1,0,0,0,0,0,0
347,796694,2,0,0,0,0,0,0,0,0,0,0,0,0,0,0,0,0
352,791220,18,0,4,0,3,0,1,1,2,2,0,1,2,1,0,0,1
352,776217,22,4,5,4,5,0,0,0,0,0,7,1,4,0,3,2,8
352,790818,22,2,7,1,5,1,2,2,4,0,1,3,2,2,2,0,7
352,786396,33,0,5,0,4,0,1,4,4,2,2,2,2,4,3,0,4
352,780730,35,7,19,4,10,3,9,3,4,0,8,1,2,2,5,0,20
352,796923,13,1,1,1,1,0,0,1,3,0,2,0,2,0,0,0,3
352,786824,21,3,7,3,5,0,2,2,2,0,4,1,1,2,1,0,8
352,791219,16,2,9,2,2,0,7,0,0,3,3,2,1,1,1,0,4
352,796921,14,1,1,1,1,0,0,0,0,0,3,0,0,0,1,0,2
352,796920,6,0,0,0,0,0,0,0,0,0,0,0,1,0,2,0,0
353,791622,17,3,5,3,5,0,0,2,3,0,3,0,4,0,4,0,8
353,776200,21,4,6,4,6,0,0,2,3,3,3,0,0,0,1,1,10
353,780925,27,1,4,0,1,1,3,0,0,0,3,3,3,1,3,0,3
353,780446,18,1,6,0,2,1,4,2,2,0,0,1,3,2,2,1,5
353,781034,31,1,8,0,3,1,5,0,0,0,7,2,2,3,5,0,3
353,796980,19,1,1,1,1,0,0,2,2,1,3,0,4,0,3,0,4
353,791625,8,1,2,1,1,0,1,0,0,0,0,0,1,0,0,0,2
353,796979,12,0,4,0,3,0,1,0,0,1,3,0,1,1,3,0,0
353,791624,11,0,3,0,2,0,1,0,0,1,1,1,2,1,3,0,0
353,791637,5,1,4,0,0,1,4,0,0,0,0,0,0,0,0,0,3
353,786437,7,0,0,0,0,0,0,0,0,0,2,0,1,0,1,1,0
353,785620,24,2,7,2,5,0,2,1,2,0,2,1,3,2,2,0,5
354,786179,27,5,11,2,7,3,4,1,1,1,4,1,1,0,1,0,14
354,780238,35,8,15,5,9,3,6,0,0,0,3,6,2,2,0,0,19
354,781500,23,0,5,0,4,0,1,0,0,1,2,4,1,1,1,0,0
354,780244,31,3,9,1,5,2,4,0,0,2,3,1,4,1,3,0,8
354,785909,9,0,1,0,1,0,0,0,0,1,1,0,1,0,0,1,0
354,791750,29,3,5,1,3,2,2,0,1,0,7,0,3,1,1,1,8
354,786177,34,3,10,0,0,3,10,1,2,0,4,2,3,1,0,1,10
354,791749,2,0,1,0,0,0,1,0,0,1,0,0,1,0,1,0,0
354,791752,10,1,1,1,1,0,0,0,0,0,1,0,0,0,0,0,2
355,786759,32,1,5,1,3,0,2,7,10,0,2,2,2,1,3,0,9
355,792294,18,4,8,3,6,1,2,2,2,0,6,1,1,0,1,0,11
355,775510,34,5,11,5,8,0,3,0,0,0,6,0,1,0,3,1,10
355,792293,13,2,5,2,5,0,0,0,0,1,0,0,0,0,1,1,4
355,774976,26,1,2,1,1,0,1,2,2,0,7,1,1,0,0,2,4
355,786614,25,0,6,0,5,0,1,4,4,0,1,0,1,1,0,0,4
355,792291,10,2,2,1,1,1,1,0,0,0,0,1,1,0,0,0,5
355,792292,8,0,3,0,2,0,1,0,0,1,2,0,1,0,0,1,0
355,797865,27,5,6,4,5,1,1,0,0,0,4,0,4,0,0,1,11
355,786762,7,1,3,1,3,0,0,0,0,0,1,0,0,1,0,0,2
356,791366,33,3,10,1,4,2,6,2,3,0,4,2,1,1,2,0,10
356,797243,22,1,5,1,5,0,0,2,2,2,3,1,3,1,3,0,4
356,785742,35,6,13,3,5,3,8,1,2,0,2,4,3,0,3,0,16
356,780163,36,5,14,1,5,4,9,13,14,1,3,4,2,0,1,1,27
356,797241,26,4,7,4,7,0,0,2,2,3,2,0,3,0,1,0,10
356,780170,17,1,2,1,2,0,0,2,2,1,3,0,1,0,0,0,4
356,797244,14,1,2,1,1,0,1,0,1,1,3,1,5,0,1,0,2
356,791363,14,0,4,0,0,0,4,0,0,1,1,0,3,0,1,0,0
356,797242,0,0,0,0,0,0,0,0,0,0,0,0,1,0,0,0,0
356,786155,3,0,1,0,1,0,0,0,0,1,0,0,0,0,0,0,0
357,776285,27,3,6,3,6,0,0,12,14,0,11,0,2,2,1,2,18
357,791783,21,1,1,1,1,0,0,0,0,1,3,0,3,0,0,0,2
357,791780,24,4,9,2,3,2,6,1,2,0,0,1,4,2,1,0,11
357,791777,38,7,14,6,11,1,3,2,5,0,7,4,1,0,1,2,17
357,780488,17,2,9,1,4,1,5,4,4,1,2,3,4,0,0,0,9
357,791781,11,0,0,0,0,0,0,0,0,0,0,1,1,0,0,0,0
357,786476,2,0,0,0,0,0,0,0,0,0,0,0,1,0,0,1,0
357,791776,16,3,4,0,0,3,4,0,0,1,1,1,2,0,2,0,9
357,781025,25,1,2,1,2,0,0,2,2,0,1,4,1,3,2,0,4
357,775503,19,3,4,0,0,3,4,4,4,1,3,0,2,1,2,0,13
358,776297,34,7,14,5,9,2,5,2,5,1,1,3,1,2,4,0,18
358,797247,36,2,3,2,3,0,0,4,6,1,5,3,2,0,3,0,8
358,780455,22,3,6,3,6,0,0,1,3,3,6,0,2,0,1,2,7
358,785837,19,2,6,1,3,1,3,2,2,1,2,1,5,0,3,0,7
358,791352,26,2,5,1,2,1,3,0,0,1,5,3,3,0,3,0,5
358,791355,14,2,4,0,0,2,4,0,0,0,1,0,1,0,0,0,6
358,791354,12,2,4,2,4,0,0,2,2,4,0,0,0,0,1,0,6
358,797251,26,0,3,0,1,0,2,3,4,0,1,1,4,0,1,1,3
358,797248,11,0,4,0,1,0,3,0,0,0,2,0,2,2,1,0,0
358,786227,0,0,0,0,0,0,0,0,0,0,1,0,0,0,0,0,0
359,775651,26,4,9,3,7,1,2,3,5,2,5,0,4,1,1,0,12
359,776178,31,3,5,3,3,0,2,3,3,0,4,3,1,0,2,0,9
359,776253,25,4,13,4,11,0,2,0,0,2,3,1,3,1,2,0,8
359,791070,25,0,5,0,2,0,3,2,2,1,2,0,2,2,3,0,2
359,791627,24,0,3,0,2,0,1,1,3,0,0,0,4,0,3,0,1
359,785665,27,3,11,1,2,2,9,1,1,0,4,1,1,0,1,0,9
359,785660,16,2,4,2,4,0,0,0,0,2,1,0,2,1,0,1,4
359,796504,8,1,2,0,0,1,2,0,0,0,1,0,0,0,0,0,3
359,796502,9,1,1,1,1,0,0,0,0,0,1,1,3,1,1,0,2
359,796505,7,0,2,0,2,0,0,0,0,0,1,0,0,0,0,0,0
359,796501,2,0,0,0,0,0,0,0,0,0,0,0,0,0,0,0,0
360,796404,15,4,5,4,5,0,0,1,1,2,7,3,1,3,2,1,9
360,785434,18,5,5,4,4,1,1,1,1,2,4,4,2,0,2,0,12
360,781164,18,5,6,3,3,2,3,0,0,0,1,5,2,1,2,0,12
360,781163,19,7,9,4,6,3,3,0,0,2,4,2,1,0,0,1,17
360,781223,18,4,5,2,3,2,2,0,0,0,1,3,3,2,0,2,10
360,796406,13,3,5,3,5,0,0,3,4,2,5,0,3,0,0,1,9
360,790848,20,2,5,2,3,0,2,0,2,0,2,4,0,2,0,0,4
360,796405,22,5,8,5,7,0,1,0,1,0,3,4,2,3,1,1,10
360,781162,14,3,5,3,4,0,1,1,1,0,4,2,1,0,1,0,7
360,790854,10,0,3,0,3,0,0,3,6,1,1,0,0,0,0,0,3
360,790850,21,4,7,2,2,2,5,4,4,1,2,2,0,2,1,0,14
360,790853,7,0,1,0,1,0,0,2,2,0,0,0,0,0,0,1,2
360,790852,5,2,3,2,3,0,0,1,1,2,1,0,0,0,0,0,5
362,791975,17,2,5,2,5,0,0,1,2,2,5,0,3,1,0,0,5
362,785972,23,2,3,1,2,1,1,2,2,0,4,0,0,0,1,0,7
362,785967,30,7,12,7,12,0,0,1,1,0,1,2,3,0,1,0,15
362,791977,37,2,9,1,4,1,5,4,4,0,3,1,1,1,2,0,9
362,791978,36,4,11,3,9,1,2,5,6,1,1,3,2,0,2,1,14
362,780160,23,3,5,3,5,0,0,2,4,1,7,5,1,1,0,1,8
362,797799,4,0,3,0,3,0,0,0,0,2,0,0,0,0,1,1,0
362,791980,3,0,1,0,0,0,1,0,0,0,0,0,0,0,0,0,0
362,791976,23,5,8,3,5,2,3,0,0,1,1,0,1,0,3,0,12
362,785973,4,0,0,0,0,0,0,0,0,0,2,1,0,0,0,0,0
363,776100,31,4,9,4,7,0,2,2,2,2,3,1,3,0,0,1,10
363,785991,19,7,11,7,10,0,1,1,1,2,6,0,3,0,2,2,15
363,781406,31,5,13,3,9,2,4,1,2,1,0,3,0,0,1,0,13
363,781401,26,5,7,5,6,0,1,0,0,0,3,2,2,2,1,0,10
363,775317,26,1,8,1,6,0,2,2,3,1,2,2,2,0,0,0,4
363,797760,12,1,2,1,1,0,1,0,0,1,1,0,1,1,0,0,2
363,792133,14,1,3,1,2,0,1,0,0,0,1,1,0,0,1,0,2
363,797762,14,1,3,1,3,0,0,0,0,0,0,3,2,1,2,0,2
363,781029,24,2,6,0,1,2,5,0,0,0,3,1,3,0,1,0,6
363,792129,3,0,0,0,0,0,0,0,0,0,0,0,0,0,0,0,0
364,782133,29,5,7,2,3,3,4,4,5,0,1,1,3,0,1,0,17
364,785059,37,5,8,4,7,1,1,0,0,2,8,5,0,1,6,0,11
364,796623,32,1,4,1,2,0,2,2,2,0,2,2,1,0,3,0,4
364,789219,38,5,10,3,4,2,6,4,5,0,0,4,2,4,2,0,16
364,785123,31,8,13,8,12,0,1,1,2,1,4,1,1,0,3,0,17
364,796622,4,1,3,1,3,0,0,2,3,0,1,0,1,0,0,0,4
364,790988,11,3,6,1,3,2,3,0,0,2,2,0,2,1,0,0,8
364,785305,14,0,1,0,0,0,1,0,0,0,2,0,2,0,2,0,0
364,796624,4,0,1,0,0,0,1,0,0,0,1,0,1,0,0,0,0
365,785792,24,2,9,2,3,0,6,0,0,1,2,1,0,0,2,0,4
365,785794,35,8,15,7,11,1,4,2,2,3,6,0,0,4,2,1,19
365,791295,22,6,10,6,9,0,1,0,0,3,2,0,3,3,2,0,12
365,791293,34,2,5,2,3,0,2,2,3,0,2,4,3,2,1,0,6
365,781373,34,3,10,3,4,0,6,5,5,1,4,1,3,4,3,0,11
365,796579,19,2,5,2,3,0,2,0,0,0,1,3,3,1,1,0,4
365,791292,8,1,1,1,1,0,0,0,0,3,1,0,2,0,0,0,2
365,781379,9,1,1,1,1,0,0,0,0,0,0,0,3,0,2,0,2
365,796578,8,2,2,2,2,0,0,0,4,1,1,1,2,0,1,2,4
365,796577,7,1,2,0,0,1,2,0,0,0,0,1,0,0,0,1,3
366,785863,24,5,13,5,13,0,0,3,4,2,2,3,2,2,0,0,13
366,785631,23,2,7,2,4,0,3,0,0,0,6,4,2,1,1,1,4
366,786248,12,1,3,1,3,0,0,0,0,2,3,1,1,1,0,0,2
366,785630,21,2,9,1,4,1,5,0,0,0,2,0,1,1,1,0,5
366,780777,13,3,6,1,3,2,3,0,2,1,0,3,3,0,4,0,8
366,791199,9,1,2,1,2,0,0,0,1,2,1,0,4,0,1,0,2
366,791197,18,1,2,1,2,0,0,0,0,1,1,1,0,0,0,2,2
366,796898,3,0,1,0,1,0,0,0,0,0,0,0,0,0,0,0,0
366,791198,11,2,2,0,0,2,2,0,0,0,2,0,0,0,0,0,6
366,791196,9,0,1,0,0,0,1,0,0,0,1,0,2,0,0,0,0
366,791195,2,0,0,0,0,0,0,0,0,0,1,0,1,0,0,0,0
366,791200,25,5,7,3,4,2,3,2,3,0,3,3,1,3,1,0,14
366,785632,27,5,8,5,8,0,0,3,3,1,4,2,1,0,0,0,13
366,781129,2,0,1,0,1,0,0,0,0,0,0,0,0,0,0,0,0
366,796899,1,0,0,0,0,0,0,0,0,0,0,0,0,0,0,0,0
367,785822,18,1,6,1,5,0,1,0,1,0,1,0,2,0,2,2,2
367,792032,32,5,9,4,7,1,2,3,3,1,3,1,4,1,3,0,14
367,792027,26,1,4,1,4,0,0,5,8,0,3,0,2,1,1,0,7
367,792031,23,2,5,1,1,1,4,0,0,0,0,0,0,0,1,0,5
367,780828,33,3,14,3,10,0,4,4,4,1,5,1,2,1,3,0,10
367,797641,15,2,4,2,4,0,0,0,0,3,5,2,2,0,2,0,4
367,792029,10,0,1,0,0,0,1,0,0,1,3,1,0,0,0,0,0
367,797642,2,0,1,0,1,0,0,0,0,0,0,0,0,0,0,0,0
367,797637,11,0,0,0,0,0,0,0,0,0,0,2,1,0,0,0,0
367,761149,19,4,5,4,4,0,1,0,0,0,3,0,0,0,0,0,8
367,792030,11,1,2,1,1,0,1,1,2,1,0,1,0,0,0,0,3
368,791266,25,3,5,3,5,0,0,3,8,1,6,1,2,2,1,3,9
368,785977,27,10,12,3,3,7,9,1,1,2,7,2,1,5,1,0,28
368,791265,27,2,4,2,2,0,2,0,0,1,4,3,2,1,1,0,4
368,791269,15,1,9,1,2,0,7,0,0,1,1,2,2,0,0,0,2
368,785685,32,7,16,4,10,3,6,4,7,1,3,3,1,4,3,0,21
368,796524,3,0,1,0,1,0,0,0,0,0,0,1,0,0,0,0,0
368,796523,8,1,4,1,2,0,2,0,0,0,0,0,0,0,0,0,2
368,796522,13,0,3,0,0,0,3,0,0,0,2,1,0,1,1,0,0
368,791270,11,1,1,0,0,1,1,0,0,0,1,1,0,0,0,0,3
368,791271,11,0,1,0,1,0,0,0,0,1,2,0,4,0,2,0,0
368,781313,15,3,10,1,3,2,7,1,1,0,1,1,0,0,0,0,9
368,781294,13,2,6,2,2,0,4,0,0,0,0,0,3,0,1,1,4
370,797109,30,2,2,1,1,1,1,2,7,0,3,0,4,0,3,0,7
370,791403,28,1,7,1,7,0,0,0,0,1,7,0,4,0,2,2,2
370,791404,39,4,11,4,8,0,3,3,3,1,0,5,1,0,4,0,11
370,791407,37,9,17,8,14,1,3,3,6,0,5,1,2,1,1,0,22
370,785923,29,0,4,0,4,0,0,1,2,1,2,3,2,2,3,0,1
370,797111,9,2,7,1,6,1,1,1,2,1,2,0,2,0,0,1,6
370,797115,4,0,0,0,0,0,0,0,0,0,0,0,0,0,0,0,0
370,785928,24,1,3,0,1,1,2,1,2,1,3,0,4,0,3,0,4
371,791839,29,6,9,6,9,0,0,2,4,3,10,4,3,1,3,1,14
371,792381,29,3,12,1,3,2,9,2,2,3,1,0,1,1,0,0,10
371,786616,30,6,11,6,8,0,3,3,3,1,4,3,2,3,1,0,15
371,776341,24,3,5,3,4,0,1,0,2,3,3,2,3,3,5,1,6
371,786736,18,1,1,1,1,0,0,0,0,0,2,2,0,0,1,0,2
371,791840,5,0,1,0,0,0,1,0,0,0,0,0,0,0,0,0,0
371,797444,9,1,3,0,0,1,3,0,1,0,2,0,1,0,0,1,3
371,785322,10,1,2,0,0,1,2,2,2,0,1,0,3,0,2,0,5
371,797442,9,1,2,1,1,0,1,0,1,1,1,0,1,0,0,0,2
371,791842,19,3,9,3,4,0,5,0,0,0,1,0,1,0,0,0,6
371,786613,18,1,2,1,1,0,1,3,6,1,0,2,2,1,2,1,5
372,780323,19,5,6,5,6,0,0,2,2,4,6,1,1,1,1,0,12
372,792233,22,4,6,4,5,0,1,2,3,1,4,3,1,0,1,0,10
372,797894,17,0,2,0,2,0,0,0,2,1,0,2,3,0,1,0,0
372,785954,21,1,6,0,2,1,4,6,6,0,3,2,1,0,2,0,9
372,785811,21,7,12,5,9,2,3,2,2,0,2,2,1,1,0,1,18
372,786016,19,2,4,0,2,2,2,2,2,0,3,2,1,0,0,0,8
372,797892,20,2,5,1,2,1,3,3,4,0,1,0,3,2,2,0,8
372,785484,15,2,4,2,3,0,1,1,2,0,4,1,1,0,2,0,5
372,792234,12,1,1,1,1,0,0,2,2,0,2,0,1,0,0,0,4
372,792230,13,0,2,0,1,0,1,5,5,0,0,1,3,2,3,0,5
372,781356,10,1,1,1,1,0,0,0,0,1,0,2,2,0,0,0,2
372,797891,11,1,3,0,1,1,2,0,1,0,2,0,1,0,0,0,3
373,797367,30,3,8,3,7,0,1,1,2,2,4,0,4,1,5,1,7
373,797364,15,1,3,1,3,0,0,0,1,1,0,1,5,0,0,1,2
373,797369,17,1,1,0,0,1,1,0,0,0,1,2,3,0,2,0,3
373,791807,25,4,12,2,3,2,9,2,2,0,3,0,1,1,0,0,12
373,786130,31,5,17,5,14,0,3,4,4,2,4,1,1,0,3,0,14
373,791804,18,1,3,1,2,0,1,0,0,2,2,0,1,0,1,0,2
373,797368,12,0,0,0,0,0,0,0,2,0,1,0,4,1,1,0,0
373,797363,21,2,6,1,5,1,1,6,6,0,0,1,5,1,5,0,11
373,797366,23,0,3,0,2,0,1,1,4,2,2,0,2,3,1,0,1
373,791808,6,0,1,0,0,0,1,0,0,0,0,0,1,0,0,0,0
373,797365,2,0,0,0,0,0,0,0,0,0,0,0,0,0,0,0,0
374,792181,33,7,12,7,10,0,2,1,3,5,8,1,2,2,1,0,15
374,792179,35,2,14,0,5,2,9,0,0,1,6,4,3,3,2,0,6
374,780986,36,6,12,6,12,0,0,8,9,2,3,10,4,4,3,1,20
374,780989,4,0,0,0,0,0,0,2,4,1,0,0,0,0,0,0,2
374,786662,38,7,17,3,6,4,11,3,3,2,0,4,0,1,4,0,21
374,785902,37,6,15,2,5,4,10,1,3,4,9,3,0,0,2,1,17
374,797796,9,1,1,1,1,0,0,2,2,0,3,1,3,1,1,0,4
374,786661,3,0,3,0,1,0,2,0,0,0,0,0,1,1,0,0,0
374,797788,4,0,0,0,0,0,0,0,0,0,0,0,1,0,0,0,0
374,792177,1,0,0,0,0,0,0,0,0,0,0,0,0,0,0,0,0
375,781519,11,2,6,1,4,1,2,0,0,1,3,1,2,0,3,0,5
375,791024,36,6,17,5,10,1,7,2,3,1,4,7,1,1,5,0,15
375,777572,37,5,17,3,7,2,10,0,0,1,7,3,1,1,4,1,12
375,791023,20,4,5,4,5,0,0,3,5,2,6,0,5,1,2,5,11
375,791027,31,5,8,3,3,2,5,3,3,1,6,1,1,0,0,0,15
375,791028,13,1,2,0,1,1,1,0,0,1,1,1,1,0,1,0,3
375,781507,24,2,5,1,4,1,1,0,0,2,3,6,3,2,3,1,5
375,796685,28,6,11,1,2,5,9,1,1,1,1,0,3,1,3,0,18
376,776286,16,1,1,1,1,0,0,0,0,3,3,0,3,1,1,0,2
376,775557,22,1,4,1,4,0,0,0,0,5,4,0,3,0,2,0,2
376,791445,35,4,12,2,5,2,7,0,0,1,0,2,3,2,3,0,10
376,785357,35,9,15,8,9,1,6,6,7,1,7,0,3,0,4,0,25
376,775560,20,2,9,1,8,1,1,1,2,0,5,0,4,1,2,0,6
376,790516,17,4,6,4,5,0,1,4,4,0,0,0,3,0,1,0,12
376,791444,21,1,5,1,5,0,0,0,0,5,9,0,2,2,1,1,2
376,797010,24,2,6,1,4,1,2,4,4,0,2,1,3,0,1,0,9
376,785287,10,0,1,0,1,0,0,0,0,0,1,0,0,1,1,0,0
377,781174,32,5,8,5,8,0,0,1,2,1,5,1,2,1,2,0,11
377,781159,33,2,9,2,6,0,3,4,9,0,3,2,4,2,3,1,8
377,791001,38,8,13,8,9,0,4,2,4,0,3,3,4,1,2,0,18
377,781215,33,4,11,4,7,0,4,8,9,1,6,1,1,3,2,0,16
377,775255,32,0,6,0,3,0,3,0,0,0,1,3,2,1,2,1,0
377,785320,20,1,3,0,1,1,2,0,0,1,1,1,1,1,1,0,3
377,796643,4,0,0,0,0,0,0,0,0,0,0,0,1,0,1,0,0
377,796644,8,1,1,1,1,0,0,0,2,2,0,0,1,0,0,0,2
379,786233,18,3,5,1,1,2,4,0,0,0,4,2,2,0,1,1,8
379,780759,29,2,11,2,6,0,5,1,2,0,2,3,4,0,0,0,5
379,786236,32,6,12,4,8,2,4,0,0,2,2,2,2,2,1,0,14
379,776478,11,0,5,0,1,0,4,0,0,1,1,0,0,0,0,0,0
379,797329,24,2,6,2,4,0,2,2,2,1,3,1,3,1,1,3,6
379,797322,11,1,1,1,1,0,0,0,0,1,1,0,2,0,0,0,2
379,786246,7,2,4,1,1,1,3,0,0,0,1,0,2,0,0,0,5
379,797323,28,7,12,5,8,2,4,3,5,0,7,4,2,2,2,0,19
379,797324,8,1,3,1,2,0,1,2,2,0,0,0,1,2,1,0,4
379,797325,23,5,8,5,8,0,0,1,4,7,1,0,1,0,2,2,11
379,781002,9,1,2,1,2,0,0,1,2,2,2,0,0,1,1,0,3
380,780538,23,0,6,0,3,0,3,0,0,0,3,5,3,0,2,0,0
380,775606,17,6,8,6,8,0,0,0,0,0,1,0,4,1,0,1,12
380,780550,29,5,12,5,11,0,1,0,1,1,7,4,3,2,4,2,10
380,780552,37,5,14,5,8,0,6,2,3,1,1,0,0,0,3,1,12
380,791674,36,5,7,4,5,1,2,3,5,0,3,5,4,1,4,0,14
380,791672,25,5,8,5,8,0,0,1,2,3,1,1,4,1,2,1,11
380,797423,14,1,2,1,2,0,0,1,1,1,3,0,4,0,0,1,3
380,785793,11,2,4,0,0,2,4,0,0,0,3,0,2,1,1,2,6
380,791673,1,0,0,0,0,0,0,0,0,0,0,0,0,0,0,0,0
380,785790,4,0,2,0,1,0,1,0,0,0,0,0,0,0,0,0,0
380,797424,3,0,0,0,0,0,0,0,0,1,1,0,2,0,0,0,0
381,785812,34,3,8,2,7,1,1,5,5,0,0,1,3,3,0,0,12
381,797431,35,0,5,0,4,0,1,0,2,1,2,3,4,2,3,0,0
381,785815,39,7,9,5,5,2,4,8,9,0,7,2,1,1,1,0,24
381,780104,28,3,10,3,10,0,0,8,8,1,9,3,3,0,4,1,14
381,791680,32,8,12,7,9,1,3,2,4,2,3,0,3,0,0,3,19
381,791684,20,3,6,3,4,0,2,0,2,0,0,0,0,1,1,0,6
381,790530,6,0,0,0,0,0,0,1,2,0,0,1,0,0,0,0,1
381,791682,6,0,0,0,0,0,0,0,0,0,1,0,1,0,1,0,0
382,780870,22,8,12,8,12,0,0,2,2,5,4,0,0,1,0,2,18
382,785380,17,4,8,2,2,2,6,2,3,2,3,1,0,0,1,0,12
382,781079,22,9,10,4,4,5,6,0,0,0,4,6,1,3,0,0,23
382,781443,21,1,3,1,2,0,1,0,0,0,5,2,1,0,0,2,2
382,775822,25,6,10,0,1,6,9,0,0,0,1,5,0,1,0,0,18
382,796626,18,2,4,2,3,0,1,1,2,2,2,1,2,0,0,0,5
382,796625,19,3,9,3,4,0,5,1,3,0,4,2,1,2,1,0,7
382,796621,16,5,8,3,4,2,4,0,0,0,4,2,1,1,2,1,12
382,796202,5,0,1,0,0,0,1,0,0,0,3,0,0,0,0,0,0
382,791314,12,1,5,0,1,1,4,0,0,1,2,2,3,0,2,0,3
382,785831,23,2,3,2,3,0,0,1,4,1,2,1,3,0,1,0,5
384,792128,34,8,11,7,9,1,2,2,3,2,6,1,3,3,2,0,19
384,786838,33,4,11,4,10,0,1,3,4,4,3,1,3,0,2,1,11
384,792132,29,1,4,1,2,0,2,0,0,2,1,10,2,1,1,0,2
384,792127,30,4,11,0,3,4,8,2,2,1,2,1,1,1,2,0,14
384,786267,19,3,7,3,4,0,3,0,0,0,2,1,3,0,1,0,6
384,799273,4,0,1,0,0,0,1,2,2,0,1,0,0,0,0,0,2
384,792131,9,1,5,1,4,0,1,0,0,0,5,1,1,2,0,0,2
384,797736,9,0,1,0,1,0,0,0,0,0,0,0,0,0,0,0,0
384,797739,6,1,4,1,4,0,0,0,0,1,0,0,0,0,1,0,2
384,792126,22,0,3,0,1,0,2,2,2,1,5,2,1,1,1,0,2
384,791668,5,1,1,1,1,0,0,0,0,0,2,0,0,0,0,0,2
385,786299,18,2,4,2,4,0,0,0,0,0,3,0,3,0,2,2,4
385,791461,28,2,6,1,4,1,2,0,2,0,2,0,0,1,0,1,5
385,791460,13,0,3,0,0,0,3,0,0,0,0,1,2,0,3,0,0
385,786295,21,1,7,1,3,0,4,2,3,1,4,2,0,0,0,1,4
385,780792,27,2,5,0,0,2,5,0,0,0,5,1,2,0,1,0,6
385,791462,15,0,2,0,2,0,0,0,0,1,4,1,2,0,2,3,0
385,780122,21,4,8,4,8,0,0,1,1,2,3,1,0,1,0,2,9
385,797215,17,4,5,2,2,2,3,0,0,0,1,1,1,2,2,0,10
385,791459,19,1,3,1,3,0,0,0,3,1,0,6,2,0,1,0,2
385,775598,21,4,8,1,2,3,6,0,0,0,2,0,2,0,1,0,11
386,797047,24,3,9,2,5,1,4,1,2,0,3,0,3,2,1,3,8
386,775515,21,1,8,0,3,1,5,0,0,1,4,1,1,0,2,3,3
386,791579,26,4,11,3,6,1,5,0,0,1,3,2,3,2,2,1,9
386,786387,30,7,11,7,10,0,1,3,4,3,4,3,2,1,1,1,17
386,780399,36,4,11,3,6,1,5,0,0,0,2,8,1,5,3,0,9
386,786846,16,4,7,3,4,1,3,0,0,0,5,1,2,0,2,1,9
386,780400,21,6,6,6,6,0,0,3,3,1,4,1,2,1,1,1,15
386,791575,2,0,0,0,0,0,0,0,0,0,0,0,1,0,0,0,0
386,797046,6,0,2,0,1,0,1,0,0,0,1,0,2,0,1,0,0
386,791577,7,0,1,0,0,0,1,0,0,0,1,0,0,0,1,0,0
386,786391,11,0,0,0,0,0,0,0,0,0,1,0,0,0,0,0,0
387,796568,31,4,7,4,7,0,0,1,2,2,4,0,1,2,4,1,9
387,790971,14,0,5,0,5,0,0,1,2,0,0,1,3,0,1,0,1
387,790969,32,5,11,5,9,0,2,2,7,2,4,5,3,3,6,0,12
387,780166,33,4,10,4,8,0,2,5,8,0,8,1,1,1,5,0,13
387,775107,19,1,5,1,4,0,1,0,0,1,2,0,1,1,0,0,2
387,781380,22,2,3,2,3,0,0,0,0,1,7,0,1,1,2,2,4
387,796569,11,0,2,0,2,0,0,0,0,0,1,0,1,0,0,0,0
387,796563,19,3,8,1,3,2,5,0,2,0,2,1,1,0,0,1,8
387,790968,19,2,4,1,2,1,2,2,2,0,2,0,1,1,0,0,7
388,781624,25,3,11,2,8,1,3,0,0,2,3,3,0,1,1,1,7
388,792246,24,6,11,6,11,0,0,3,4,6,4,1,2,0,3,2,15
388,791701,28,7,11,5,7,2,4,4,6,0,4,2,2,4,3,1,20
388,792245,28,2,3,0,0,2,3,1,2,0,3,1,3,2,3,0,7
388,781420,34,8,15,6,11,2,4,1,3,1,7,5,1,3,3,1,19
388,797924,11,3,6,3,5,0,1,0,0,2,0,1,1,0,1,0,6
388,792244,13,2,4,1,2,1,2,4,4,2,3,0,0,1,0,0,9
388,781417,13,2,2,2,2,0,0,2,2,2,1,0,3,0,1,1,6
388,780615,5,1,1,1,1,0,0,0,0,1,1,0,1,0,0,0,2
388,797925,17,3,10,3,9,0,1,0,1,3,3,2,1,0,1,0,6
388,797933,2,0,1,0,0,0,1,0,0,0,1,0,0,0,1,0,0
391,797038,31,2,7,2,5,0,2,3,3,1,6,6,4,2,3,0,7
391,791438,21,3,8,3,4,0,4,6,6,1,6,0,3,0,3,2,12
391,776137,32,5,10,3,6,2,4,0,0,3,6,0,2,0,2,1,12
391,797051,19,2,4,2,3,0,1,8,8,1,3,2,4,0,4,1,12
391,781641,18,2,8,2,5,0,3,0,0,0,0,0,1,0,1,0,4
391,791436,7,1,1,1,1,0,0,1,2,0,0,0,2,0,0,0,3
391,791439,5,1,1,1,1,0,0,1,2,1,1,0,0,0,0,0,3
391,797043,2,1,1,1,1,0,0,0,0,0,0,0,0,0,0,1,2
391,797053,25,3,4,3,3,0,1,1,2,0,1,1,1,0,0,0,7
391,797059,9,0,1,0,1,0,0,0,0,0,0,1,0,1,0,0,0
391,791437,24,4,6,4,4,0,2,1,2,1,3,0,4,0,1,0,9
391,786305,7,0,3,0,1,0,2,0,0,0,1,0,2,1,3,0,0
392,780027,29,14,15,11,12,3,3,10,12,1,8,0,4,0,2,3,41
392,774828,28,2,7,1,2,1,5,0,0,1,1,7,1,0,0,0,5
392,786173,25,2,6,1,2,1,4,2,2,1,1,6,2,0,1,0,7
392,780028,26,2,2,1,1,1,1,2,2,2,4,5,2,0,1,1,7
392,786176,23,5,12,1,6,4,6,2,4,2,5,3,0,0,1,0,16
392,791380,17,2,5,1,4,1,1,0,0,0,0,4,1,0,2,0,5
392,791379,20,3,7,3,5,0,2,1,4,1,2,2,3,1,1,0,7
392,797175,16,3,4,2,3,1,1,2,3,0,4,0,2,3,1,2,9
392,797179,10,1,2,1,1,0,1,4,4,0,0,1,1,0,0,0,6
392,797178,6,0,1,0,1,0,0,0,0,1,0,0,1,0,0,0,0
393,792055,18,3,8,3,8,0,0,4,4,2,0,0,4,0,3,1,10
393,792062,19,3,4,3,4,0,0,2,2,3,5,1,4,0,2,1,8
393,792059,25,4,7,1,3,3,4,0,0,2,2,2,3,0,0,0,11
393,789028,31,4,10,4,9,0,1,4,6,2,3,5,4,0,2,0,12
393,775323,30,5,12,4,7,1,5,2,2,0,4,3,1,1,1,0,13
393,790779,5,0,0,0,0,0,0,0,0,0,0,0,2,0,1,0,0
393,786836,14,1,4,1,4,0,0,2,2,2,2,1,0,1,1,0,4
393,775523,15,3,7,2,5,1,2,1,2,3,1,0,5,0,3,0,8
393,789029,5,0,4,0,0,0,4,0,0,0,0,0,2,1,2,0,0
393,789053,14,2,6,1,4,1,2,0,1,0,1,0,0,1,0,0,5
393,792067,3,0,1,0,0,0,1,0,0,0,1,0,2,0,1,0,0
393,797649,14,1,6,0,4,1,2,0,0,0,2,0,0,1,0,0,3
393,792058,7,1,1,1,1,0,0,0,0,1,0,0,1,0,0,0,2
394,785409,27,5,9,5,9,0,0,0,0,4,4,2,1,0,0,5,10
394,785408,23,7,12,6,11,1,1,2,2,1,2,2,2,2,2,0,17
394,785407,20,4,6,4,4,0,2,3,3,2,3,0,2,0,0,0,11
394,780539,23,3,4,1,1,2,3,0,0,0,0,3,0,2,0,0,8
394,780560,16,2,4,0,2,2,2,0,0,0,2,0,0,1,1,0,6
394,796416,19,6,8,5,6,1,2,0,0,0,0,6,2,2,0,0,13
394,796415,13,1,2,1,1,0,1,0,0,0,1,0,2,0,1,0,2
394,776484,29,2,8,1,4,1,4,2,4,0,4,6,2,2,1,0,7
394,790861,12,3,5,2,3,1,2,1,1,1,2,3,0,1,0,0,8
394,796418,8,0,2,0,2,0,0,0,0,0,0,0,1,0,0,1,0
394,796417,8,1,1,1,1,0,0,0,2,1,2,0,0,0,0,0,2
394,790859,1,0,0,0,0,0,0,2,2,0,0,0,0,0,0,0,2
394,790860,1,0,0,0,0,0,0,0,0,0,0,0,0,0,0,0,0
395,791882,25,2,8,2,7,0,1,2,4,5,1,0,2,1,1,0,6
395,786493,31,4,13,1,7,3,6,0,0,2,3,1,1,0,1,0,11
395,786491,21,0,1,0,1,0,0,0,0,0,3,2,2,1,3,0,0
395,797614,12,0,1,0,1,0,0,0,0,0,1,0,0,0,1,0,0
395,781258,19,1,1,1,1,0,0,0,0,1,1,2,1,1,2,0,2
395,797616,15,1,4,1,3,0,1,0,0,0,1,1,2,0,3,1,2
395,786420,31,5,10,4,7,1,3,0,0,0,3,3,3,1,2,0,11
395,791881,21,1,3,1,2,0,1,0,0,1,0,3,1,0,3,0,2
395,797613,7,1,3,0,0,1,3,0,0,0,2,0,0,0,0,0,3
395,797618,15,5,11,4,9,1,2,0,0,3,1,1,2,0,2,0,11
395,797617,3,1,1,0,0,1,1,0,0,1,1,0,0,0,1,0,3
396,796556,18,3,7,3,3,0,4,4,4,0,2,0,0,0,0,1,10
396,780832,13,4,4,4,4,0,0,4,5,3,3,0,0,0,0,1,12
396,790961,13,3,6,3,5,0,1,2,2,1,2,3,0,2,0,0,8
396,785278,13,3,5,2,3,1,2,0,0,1,3,1,1,0,0,1,7
396,780146,13,2,3,2,3,0,0,1,1,0,3,4,2,2,0,0,5
396,796554,12,1,2,1,1,0,1,0,0,0,0,0,0,1,2,0,2
396,790965,16,4,5,3,4,1,1,0,0,2,0,0,0,0,0,0,9
396,790962,12,2,4,2,3,0,1,3,3,2,2,3,0,3,1,1,7
396,796557,15,5,9,5,7,0,2,1,1,8,5,0,2,1,1,1,11
396,796555,16,2,7,1,3,1,4,0,0,1,5,2,1,0,1,0,5
396,790960,11,2,5,1,2,1,3,0,0,1,0,0,0,1,0,0,5
396,790963,11,3,9,0,1,3,8,0,0,1,2,1,1,1,2,0,9
396,796553,15,2,4,2,4,0,0,1,2,1,3,2,2,0,1,1,5
396,780363,11,1,5,1,3,0,2,0,0,0,3,2,0,1,0,0,2
396,775860,11,2,3,2,2,0,1,4,4,0,4,1,1,1,2,1,8
398,786157,19,4,7,4,7,0,0,1,3,3,2,1,2,1,0,0,9
398,786150,23,0,3,0,3,0,0,4,8,3,4,2,4,1,1,0,4
398,780676,26,3,8,2,4,1,4,4,4,1,3,2,1,2,0,0,11
398,791756,22,4,6,3,4,1,2,0,1,0,2,1,0,0,0,0,9
398,780677,24,1,7,0,2,1,5,0,0,0,2,1,2,1,1,0,3
398,775533,16,2,4,1,1,1,3,0,0,0,1,3,3,1,3,0,5
398,797350,3,0,1,0,0,0,1,0,0,0,0,0,1,0,0,0,0
398,791730,1,0,0,0,0,0,0,0,0,0,0,0,0,0,0,0,0
398,791754,17,4,8,1,3,3,5,3,4,2,2,0,0,1,1,0,14
398,791753,1,0,0,0,0,0,0,0,0,0,1,0,0,0,1,0,0
398,797349,4,2,4,0,1,2,3,0,0,0,0,0,0,0,0,0,6
398,797348,16,2,5,1,3,1,2,0,0,0,0,1,2,1,1,0,5
398,780992,16,2,5,0,0,2,5,2,2,0,0,1,0,2,1,0,8
398,780673,12,1,4,0,2,1,2,0,0,2,0,2,3,1,1,0,3
399,786296,22,3,5,2,4,1,1,1,2,0,4,4,2,0,4,0,8
399,781530,23,4,5,3,4,1,1,1,2,1,3,1,2,0,1,0,10
399,776423,23,5,8,5,8,0,0,1,2,2,6,3,3,0,2,2,11
399,792307,16,0,4,0,2,0,2,0,0,1,2,0,2,0,1,0,0
399,792319,22,0,2,0,0,0,2,0,0,0,2,2,2,0,4,0,0
399,798109,4,0,0,0,0,0,0,0,0,0,1,0,0,0,1,0,0
399,792314,16,1,2,1,2,0,0,1,2,0,2,0,4,1,2,2,3
399,792320,12,1,2,1,2,0,0,0,0,2,2,0,0,0,3,0,2
399,798106,20,3,4,3,3,0,1,1,2,0,3,2,1,0,0,1,7
399,798104,16,2,6,0,0,2,6,1,2,1,3,1,2,1,3,0,7
399,798096,20,4,9,3,4,1,5,1,2,0,0,1,0,0,1,0,10
399,792321,6,0,1,0,1,0,0,0,0,0,0,0,0,0,1,0,0
400,796723,26,3,7,2,4,1,3,0,0,0,3,7,1,2,0,0,7
400,785512,21,4,5,4,5,0,0,3,5,1,1,1,1,0,0,1,11
400,774834,22,7,7,7,7,0,0,3,4,1,6,0,1,0,2,3,17
400,796717,15,2,3,2,3,0,0,0,0,1,3,5,1,3,0,0,4
400,775412,25,5,13,1,2,4,11,1,2,3,4,3,1,0,1,1,15
400,796719,18,2,4,1,1,1,3,2,2,0,6,1,0,0,2,1,7
400,791042,7,0,2,0,2,0,0,3,4,1,1,1,0,0,0,0,3
400,766998,6,3,3,3,3,0,0,2,2,1,1,0,1,0,1,1,8
400,796718,22,6,10,2,2,4,8,0,0,0,5,4,1,0,3,0,16
400,796722,3,2,2,1,1,1,1,0,0,0,0,0,0,0,0,0,5
400,796720,17,3,10,3,9,0,1,1,1,0,1,0,2,0,2,0,7
400,776374,18,0,1,0,0,0,1,0,0,0,5,9,3,1,2,0,0
402,791425,29,1,4,1,4,0,0,3,6,0,3,0,1,0,2,0,5
402,791424,27,2,5,2,3,0,2,1,2,1,5,1,1,1,5,2,5
402,797085,27,4,7,1,2,3,5,2,2,2,2,3,3,0,7,0,13
402,791421,33,0,7,0,4,0,3,6,7,0,3,3,3,0,4,0,6
402,785899,30,2,5,1,1,1,4,4,5,0,5,1,1,0,2,1,9
402,797079,3,1,1,1,1,0,0,0,1,1,0,0,0,0,0,0,2
402,797081,2,0,0,0,0,0,0,0,0,0,0,0,1,0,0,0,0
402,797086,4,0,2,0,1,0,1,0,0,1,0,0,0,0,0,0,0
402,785509,12,1,3,1,1,0,2,1,2,0,2,1,4,0,1,0,3
402,797089,1,0,0,0,0,0,0,0,0,0,0,0,0,0,0,0,0
402,797090,9,1,1,1,1,0,0,0,0,0,1,0,4,0,4,1,2
402,797084,3,0,2,0,1,0,1,1,2,0,1,0,0,0,1,0,1
402,797083,2,0,0,0,0,0,0,0,0,0,0,0,0,0,0,0,0
402,797088,2,0,0,0,0,0,0,0,0,0,0,0,0,0,0,0,0
402,797087,16,2,3,1,2,1,1,0,0,0,1,1,2,0,2,0,5
403,775806,10,1,4,0,3,1,1,0,0,0,1,1,3,0,0,0,3
403,775563,22,5,11,4,9,1,2,1,3,1,4,0,4,1,3,0,12
403,781011,22,4,6,4,6,0,0,1,2,3,0,0,2,0,4,2,9
403,797601,22,6,8,4,5,2,3,2,4,0,2,1,3,2,3,0,16
403,775188,14,4,4,4,4,0,0,0,0,0,6,0,4,0,1,0,8
403,797604,7,0,0,0,0,0,0,0,0,0,1,0,3,0,1,0,0
403,797605,1,0,0,0,0,0,0,0,0,0,0,0,0,0,0,0,0
403,797603,3,0,0,0,0,0,0,0,0,0,0,0,0,0,1,0,0
403,791770,2,0,0,0,0,0,0,0,0,0,0,0,0,0,0,0,0
403,786466,25,2,4,0,1,2,3,2,2,1,0,1,1,3,0,0,8
403,781424,18,0,6,0,3,0,3,0,1,0,3,0,3,1,1,0,0
403,776157,23,1,6,0,4,1,2,2,2,1,2,2,2,0,1,0,5
403,781012,31,3,7,3,7,0,0,3,4,0,2,6,2,6,1,0,9
404,775959,20,1,4,1,2,0,2,2,4,1,2,1,2,0,0,1,4
404,790897,17,2,6,1,3,1,3,5,5,1,2,0,2,2,1,0,10
404,785442,23,2,7,2,4,0,3,0,1,0,2,0,2,1,4,0,4
404,781628,32,4,7,3,5,1,2,5,6,0,4,5,2,3,1,0,14
404,785579,33,3,6,3,4,0,2,2,3,0,3,1,3,2,4,0,8
404,790898,23,5,7,5,7,0,0,2,2,0,1,0,1,0,1,0,12
404,790896,7,1,2,1,2,0,0,1,1,0,0,0,3,0,0,0,3
404,775737,23,5,7,1,1,4,6,0,0,1,1,1,0,2,1,1,14
404,785448,21,1,3,1,1,0,2,0,0,0,1,1,1,0,0,0,2
404,796446,1,0,0,0,0,0,0,0,0,0,0,0,0,0,0,0,0
405,797174,32,2,5,2,4,0,1,0,0,1,0,0,4,0,3,0,4
405,797168,30,5,8,5,6,0,2,1,2,0,2,4,3,3,3,0,11
405,791507,25,4,6,4,6,0,0,0,0,2,2,1,3,1,2,0,8
405,775357,33,4,11,2,6,2,5,3,4,0,7,1,1,1,4,0,13
405,791510,26,3,5,2,4,1,1,2,3,1,4,1,0,0,1,0,9
405,786699,11,2,3,2,3,0,0,0,0,1,3,0,4,0,2,0,4
405,791505,12,0,3,0,0,0,3,0,0,0,3,0,1,0,2,0,0
405,797169,18,0,0,0,0,0,0,3,4,0,2,1,3,1,5,0,3
405,791506,9,2,2,0,0,2,2,0,0,0,1,0,0,0,0,0,6
405,791509,4,0,0,0,0,0,0,2,2,0,0,0,1,0,0,0,2
406,791524,17,0,5,0,3,0,2,2,3,0,4,0,3,1,2,1,2
406,786354,12,1,3,1,3,0,0,0,0,1,3,0,1,0,1,0,2
406,791526,36,3,7,1,4,2,3,0,0,0,2,2,2,0,2,0,8
406,780272,35,5,15,4,10,1,5,1,2,0,6,5,4,3,1,0,12
406,775592,35,5,12,2,4,3,8,0,1,0,3,2,2,0,3,0,13
406,797139,12,1,4,1,4,0,0,2,2,1,4,0,2,0,1,0,4
406,785970,11,6,7,6,7,0,0,2,3,3,1,0,0,0,0,1,14
406,797141,1,0,0,0,0,0,0,0,0,0,0,0,0,0,0,0,0
406,780273,14,0,2,0,0,0,2,2,3,0,1,3,0,0,1,0,2
406,775394,27,7,9,4,6,3,3,2,3,2,10,1,3,0,1,0,19
407,797895,12,0,1,0,1,0,0,2,2,2,2,1,5,0,3,0,2
407,789058,11,0,2,0,0,0,2,0,0,0,2,0,0,0,2,0,0
407,797898,34,7,16,5,11,2,5,2,4,2,5,1,0,2,2,0,18
407,792236,30,3,7,3,6,0,1,2,2,1,3,6,2,1,1,0,8
407,781374,33,6,16,4,12,2,4,4,5,1,11,1,2,1,0,1,18
407,792238,13,2,3,2,3,0,0,0,0,3,0,0,5,1,0,1,4
407,785818,8,0,3,0,1,0,2,0,0,0,1,1,1,1,1,1,0
407,785286,19,3,6,2,5,1,1,0,2,1,3,0,0,0,0,0,7
407,776337,7,0,4,0,3,0,1,0,0,0,2,0,0,0,0,0,0
407,792240,7,0,0,0,0,0,0,0,0,0,1,1,0,0,1,0,0
407,792359,4,0,0,0,0,0,0,0,0,0,1,0,2,0,0,1,0
407,792237,22,5,12,1,3,4,9,0,0,1,1,1,1,1,1,0,14
408,791305,14,2,5,2,5,0,0,2,2,0,4,0,0,0,2,0,6
408,781462,39,9,15,7,12,2,3,0,1,1,4,1,0,1,3,1,20
408,780876,22,5,10,4,7,1,3,0,0,1,7,3,3,0,3,0,11
408,785353,34,4,9,2,5,2,4,4,5,1,4,3,4,0,3,0,14
408,781457,31,3,6,2,2,1,4,1,1,1,2,7,3,1,1,0,8
408,790895,10,0,2,0,1,0,1,0,0,1,1,1,1,0,0,0,0
408,796367,8,0,1,0,1,0,0,0,0,0,1,0,0,0,0,0,0
408,785355,14,1,4,1,1,0,3,0,0,1,1,0,0,1,1,0,2
408,781673,28,4,9,2,3,2,6,2,2,1,1,1,4,2,1,0,12
409,780797,36,6,16,1,5,5,11,0,0,1,4,3,2,1,3,0,17
409,776418,16,2,6,2,6,0,0,0,0,2,1,1,1,1,1,2,4
409,785505,36,3,12,2,8,1,4,10,11,1,7,9,1,1,2,0,17
409,780555,33,2,5,0,2,2,3,2,2,0,3,3,3,4,2,0,8
409,775604,35,5,7,2,3,3,4,3,3,0,2,4,2,0,1,0,16
409,791616,24,6,7,6,7,0,0,2,2,2,4,2,0,1,0,1,14
409,796981,20,3,8,2,5,1,3,0,0,1,3,0,2,0,0,1,7
410,790814,32,3,5,1,1,2,4,0,0,0,3,2,3,0,1,0,8
410,786013,24,4,5,4,5,0,0,0,2,1,0,0,4,1,4,2,8
410,796379,26,4,8,0,2,4,6,0,0,1,1,1,3,0,2,0,12
410,790815,23,2,7,2,3,0,4,0,0,0,7,1,1,0,1,0,4
410,780176,36,3,11,1,5,2,6,0,0,0,3,5,2,2,2,0,8
410,790816,13,1,2,1,1,0,1,3,4,1,0,0,2,0,0,0,5
410,796377,21,1,3,0,0,1,3,3,4,0,3,1,1,0,3,0,6
410,796372,8,1,2,1,2,0,0,0,0,0,0,1,2,0,1,0,2
410,796378,16,2,4,1,2,1,2,0,0,0,3,3,1,0,2,0,5
410,796375,1,0,0,0,0,0,0,0,0,0,0,0,2,0,0,0,0
411,775640,14,2,3,2,2,0,1,3,4,0,0,1,3,0,1,0,7
411,780919,29,1,5,1,4,0,1,3,4,1,3,2,2,0,1,0,5
411,791142,27,3,10,2,3,1,7,3,3,0,2,0,4,0,1,0,10
411,785803,37,3,5,1,2,2,3,1,1,0,4,1,1,0,2,1,9
411,780920,39,10,16,8,11,2,5,2,2,2,3,5,1,1,2,0,24
411,796801,9,0,2,0,1,0,1,0,0,0,0,1,1,2,0,0,0
411,796796,8,1,2,1,1,0,1,1,2,0,0,0,0,0,0,0,3
411,775816,20,3,5,2,3,1,2,2,2,1,5,3,1,1,0,0,9
411,796797,17,3,5,3,5,0,0,3,3,1,2,0,0,2,1,0,9
412,790833,30,6,15,5,10,1,5,4,5,2,3,1,4,0,4,1,17
412,796390,18,2,3,2,3,0,0,1,3,2,3,0,3,0,2,0,5
412,785451,30,2,7,1,3,1,4,0,0,1,3,0,2,0,3,0,5
412,790834,29,3,11,1,3,2,8,3,4,1,2,2,2,1,2,0,11
412,785377,17,0,3,0,3,0,0,0,0,0,1,3,0,2,3,0,0
412,790830,22,1,4,1,3,0,1,0,0,1,4,5,3,1,2,0,2
412,790832,22,3,6,2,4,1,2,3,4,0,1,1,5,1,0,0,10
412,785379,13,2,4,1,2,1,2,0,0,0,0,1,0,0,1,0,5
412,780297,9,1,2,1,1,0,1,2,2,2,0,0,2,0,1,0,4
412,790831,10,0,2,0,2,0,0,0,0,0,2,0,3,1,1,0,0
413,780178,8,0,0,0,0,0,0,0,0,0,2,0,2,0,1,0,0
413,775075,22,0,3,0,3,0,0,3,4,2,2,1,2,1,0,2,3
413,792376,30,4,12,3,5,1,7,3,3,0,1,1,2,1,5,0,12
413,797883,27,1,2,0,1,1,1,0,0,1,5,6,1,2,3,0,3
413,786747,30,4,9,3,4,1,5,5,6,0,5,1,3,1,1,1,14
413,792378,21,4,5,4,5,0,0,1,1,2,5,2,4,1,2,2,9
413,786746,26,3,5,0,0,3,5,6,8,0,3,0,1,0,3,0,15
413,797890,10,1,3,1,1,0,2,0,0,1,2,0,0,1,0,0,2
413,792374,13,2,4,1,2,1,2,1,2,1,1,3,2,1,1,0,6
413,797885,10,2,5,2,2,0,3,2,3,0,0,0,1,1,1,0,6
413,797888,3,0,0,0,0,0,0,0,0,0,0,0,1,0,0,0,0
418,780570,24,4,6,4,6,0,0,0,0,2,3,0,5,0,5,1,8
418,780569,22,3,4,3,4,0,0,1,1,0,6,0,5,0,3,1,7
418,781556,15,1,2,1,1,0,1,1,2,0,1,0,2,1,3,0,3
418,780565,33,4,6,4,5,0,1,0,0,0,3,5,3,3,1,0,8
418,780564,21,6,7,5,6,1,1,0,1,0,1,0,1,1,2,0,13
418,797434,20,0,6,0,4,0,2,1,2,1,5,1,3,1,3,0,1
418,797432,12,1,3,0,0,1,3,0,0,0,0,3,0,0,1,0,3
418,797438,6,0,2,0,1,0,1,0,0,0,1,0,0,0,1,0,0
418,791697,25,2,9,2,6,0,3,7,7,1,3,2,1,1,1,0,11
418,791696,6,1,2,1,1,0,1,0,0,0,0,0,0,2,2,0,2
418,791695,13,1,5,1,4,0,1,0,0,1,2,0,1,0,0,0,2
418,785824,1,0,0,0,0,0,0,0,0,0,0,0,0,0,1,0,0
418,797433,1,0,0,0,0,0,0,0,0,0,0,0,0,0,0,0,0
418,791694,1,0,0,0,0,0,0,0,0,0,0,0,0,0,0,0,0
419,786805,24,4,10,4,10,0,0,3,4,0,4,2,0,1,2,0,11
419,774936,17,6,13,5,11,1,2,2,2,3,3,1,1,1,0,0,15
419,790932,25,1,3,1,3,0,0,0,0,1,1,1,2,0,2,0,2
419,781345,34,0,1,0,0,0,1,2,4,0,6,5,2,3,2,0,2
419,786803,20,1,6,1,5,0,1,1,2,0,0,1,0,2,3,0,3
419,790934,16,3,6,2,4,1,2,0,0,0,3,0,0,0,1,0,7
419,786804,22,4,8,2,5,2,3,4,6,1,2,2,2,0,1,0,14
419,796487,5,0,0,0,0,0,0,0,0,0,1,0,2,0,0,0,0
419,790931,14,5,8,5,8,0,0,0,2,3,0,1,3,2,0,0,10
419,790933,17,2,2,0,0,2,2,0,0,1,1,2,2,0,2,0,6
419,780033,3,0,1,0,0,0,1,0,0,1,1,0,0,0,1,0,0
419,796488,1,0,0,0,0,0,0,0,0,0,0,0,0,0,0,0,0
419,780030,1,0,0,0,0,0,0,0,0,0,0,0,0,0,0,0,0
419,796490,1,0,0,0,0,0,0,0,0,0,0,0,0,0,0,0,0
421,782133,31,3,10,2,3,1,7,2,2,2,11,3,1,1,0,0,9
421,785123,22,5,8,5,7,0,1,2,4,0,1,1,4,0,1,3,12
421,796623,35,3,5,1,1,2,4,7,10,0,3,4,3,0,5,0,15
421,789219,37,6,11,2,2,4,9,2,2,0,1,3,3,3,3,0,18
421,785059,37,4,9,3,4,1,5,0,1,1,10,5,1,2,3,2,9
421,796624,5,0,0,0,0,0,0,0,0,0,1,0,0,0,0,0,0
421,785305,15,0,1,0,0,0,1,0,0,0,0,0,1,0,1,0,0
421,796622,7,4,5,4,5,0,0,0,0,1,0,0,1,0,0,0,8
421,790988,11,1,4,1,2,0,2,0,0,1,0,1,0,0,0,0,2
422,792005,26,3,7,1,3,2,4,4,4,0,2,1,1,2,0,1,12
422,781175,21,3,5,3,4,0,1,0,0,4,5,2,1,1,3,0,6
422,786553,25,4,11,4,6,0,5,4,4,0,2,2,4,2,2,0,12
422,780895,31,6,11,6,10,0,1,3,4,4,4,0,2,3,1,2,15
422,781172,34,6,13,2,4,4,9,2,2,2,4,3,1,5,1,0,18
422,781177,9,0,1,0,0,0,1,0,0,2,1,0,2,0,0,0,0
422,786555,19,3,9,1,1,2,8,0,0,2,1,1,3,1,1,0,8
422,785312,27,5,12,3,8,2,4,0,0,0,2,4,2,4,1,0,12
422,797503,2,0,0,0,0,0,0,0,0,0,1,0,1,0,0,1,0
422,797502,2,0,2,0,0,0,2,0,0,0,0,0,1,0,1,0,0
422,797501,2,1,1,0,0,1,1,0,0,0,1,0,0,0,0,0,3
422,797500,2,0,0,0,0,0,0,0,0,1,0,0,0,0,1,0,0
423,786765,30,3,10,3,5,0,5,1,2,1,6,3,2,0,4,0,7
423,792379,31,3,8,2,3,1,5,0,0,2,3,1,2,0,1,0,7
423,792380,35,5,10,0,1,5,9,2,2,0,3,2,1,1,1,0,17
423,781672,21,2,5,2,5,0,0,3,5,4,2,0,1,2,3,0,7
423,781669,35,7,10,4,5,3,5,4,8,0,3,3,1,2,5,0,21
423,797852,9,0,2,0,2,0,0,2,2,1,1,0,0,0,4,0,2
423,792383,19,2,4,2,3,0,1,0,0,2,5,0,5,0,2,0,4
423,786764,6,0,2,0,0,0,2,0,0,0,1,0,1,0,2,0,0
423,797854,8,0,1,0,0,0,1,0,0,0,0,0,0,0,0,0,0
423,781668,1,0,0,0,0,0,0,0,0,0,0,0,0,0,0,0,0
423,797853,1,0,0,0,0,0,0,0,0,0,0,0,0,0,0,0,0
423,781671,2,0,0,0,0,0,0,0,0,0,0,0,0,0,0,0,0
423,797860,2,0,0,0,0,0,0,0,0,0,0,0,0,0,0,0,0
424,791876,38,7,11,6,9,1,2,4,5,1,6,1,1,2,2,2,19
424,791877,29,2,2,2,2,0,0,0,0,0,3,1,3,2,0,3,4
424,785667,18,2,5,1,2,1,3,0,0,0,0,0,1,0,3,0,5
424,786572,35,7,11,7,8,0,3,6,11,2,2,6,2,1,3,0,20
424,786570,37,9,13,6,6,3,7,6,6,0,6,8,3,2,3,0,27
424,797490,10,1,1,1,1,0,0,0,0,0,1,0,1,0,0,0,2
424,797491,18,1,4,1,1,0,3,0,0,0,1,0,0,0,1,0,2
424,797486,7,1,2,1,1,0,1,0,0,0,0,1,1,1,1,0,2
424,797487,1,0,0,0,0,0,0,0,0,0,0,0,1,0,0,0,0
424,791878,7,1,1,1,1,0,0,0,0,0,1,0,1,1,0,0,2
425,791201,34,7,15,7,13,0,2,5,5,5,0,2,3,1,2,0,19
425,791202,32,1,6,0,1,1,5,0,0,0,1,1,3,2,0,0,3
425,775767,34,5,9,5,9,0,0,2,2,0,8,2,3,0,2,0,12
425,785628,34,10,16,9,11,1,5,3,3,1,4,4,3,3,1,0,24
425,785627,26,6,11,5,7,1,4,0,0,1,2,2,0,1,2,0,13
425,796902,6,1,1,1,1,0,0,0,0,0,0,0,1,0,2,0,2
425,785629,22,0,2,0,0,0,2,1,2,2,1,5,2,3,3,0,1
425,796901,6,0,1,0,1,0,0,0,0,0,0,0,1,0,0,0,0
425,796904,6,0,1,0,0,0,1,0,2,0,0,1,0,0,0,0,0
426,791414,26,4,7,4,7,0,0,0,0,3,7,0,3,0,0,0,8
426,785911,18,3,3,2,2,1,1,0,0,1,3,0,1,1,1,2,7
426,791413,29,6,14,5,7,1,7,0,0,2,3,1,3,0,2,1,13
426,791411,31,5,14,3,7,2,7,3,4,1,2,2,2,5,3,0,15
426,785776,32,6,14,3,6,3,8,6,6,0,5,2,2,0,0,0,21
426,797102,7,0,1,0,1,0,0,0,0,0,1,0,1,0,1,0,0
426,797099,9,1,2,1,2,0,0,0,0,0,1,0,3,0,1,0,2
426,786403,15,4,6,4,6,0,0,1,1,0,0,0,3,0,0,0,9
426,797105,13,1,2,0,1,1,1,0,2,0,1,1,3,0,0,0,3
426,797100,13,1,1,1,1,0,0,2,3,0,1,0,2,0,0,0,4
426,781209,7,0,3,0,0,0,3,0,1,0,2,2,0,0,0,0,0
427,791606,37,4,9,4,6,0,3,3,4,1,8,1,4,3,3,1,11
427,786410,30,1,7,1,4,0,3,2,4,1,0,0,1,0,1,0,4
427,775095,7,0,0,0,0,0,0,0,0,0,1,1,1,0,0,0,0
427,791603,11,1,4,1,1,0,3,0,0,0,2,0,1,0,2,0,2
427,780414,37,12,19,8,9,4,10,7,9,2,3,2,1,1,1,1,35
427,797020,16,2,5,2,4,0,1,0,1,0,2,1,3,0,1,1,4
427,792392,15,3,9,3,9,0,0,3,4,3,4,0,1,0,1,1,9
427,791605,17,2,4,1,2,1,2,0,1,0,4,0,5,1,1,0,5
427,786406,30,0,1,0,0,0,1,2,4,0,3,2,2,0,3,0,2
428,786080,30,5,10,1,2,4,8,7,8,1,7,2,4,1,3,2,21
428,786216,16,4,8,4,8,0,0,3,3,4,3,1,5,0,1,1,11
428,791348,38,1,7,1,5,0,2,4,8,1,3,2,1,1,2,0,6
428,786218,35,4,7,2,3,2,4,0,2,0,4,2,2,1,2,0,10
428,780150,13,0,1,0,0,0,1,0,0,0,2,0,1,0,0,0,0
428,797257,12,0,2,0,2,0,0,1,2,2,1,1,1,0,1,0,1
428,791350,23,2,3,0,0,2,3,0,0,0,3,1,3,2,1,1,6
428,785256,27,3,12,2,10,1,2,4,5,0,4,0,3,0,2,0,11
428,797258,4,0,0,0,0,0,0,0,0,0,0,0,0,0,0,1,0
428,781645,2,0,0,0,0,0,0,0,0,0,0,0,0,0,0,0,0
429,797662,15,2,4,2,4,0,0,0,0,0,2,0,1,1,1,0,4
429,786067,25,3,6,3,6,0,0,1,5,5,3,3,4,0,1,0,7
429,797660,29,5,11,5,10,0,1,0,0,3,1,1,1,0,2,0,10
429,785591,29,5,16,3,12,2,4,3,6,2,5,2,3,2,2,0,15
429,780258,26,1,6,1,3,0,3,0,0,0,6,1,1,1,2,0,2
429,792082,9,0,3,0,3,0,0,0,0,0,1,0,3,0,0,0,0
429,792078,17,1,3,1,2,0,1,1,2,2,5,0,2,1,1,0,3
429,791952,13,0,1,0,1,0,0,0,2,3,0,0,3,0,0,0,0
429,797661,25,3,13,2,5,1,8,1,2,0,2,0,2,2,1,0,8
429,792083,12,0,2,0,1,0,1,2,2,0,1,1,0,0,2,0,2
429,792079,0,0,0,0,0,0,0,0,0,0,0,0,1,0,0,0,0
430,796318,35,8,8,7,7,1,1,2,2,4,15,5,2,0,7,4,19
430,790761,26,6,11,5,9,1,2,0,0,2,2,2,4,0,3,0,13
430,790764,29,5,11,3,6,2,5,0,2,2,5,1,4,1,1,0,12
430,785219,15,1,4,1,1,0,3,0,0,1,3,1,2,0,2,0,2
430,779993,24,1,5,1,2,0,3,0,0,0,1,4,3,2,3,1,2
430,796322,4,1,1,1,1,0,0,0,0,0,0,1,0,0,0,0,2
430,796319,33,10,18,6,9,4,9,0,0,2,7,2,1,1,1,1,24
430,796320,29,2,5,1,2,1,3,1,4,2,3,4,3,2,3,0,6
430,796321,4,0,1,0,0,0,1,1,2,1,0,0,0,0,1,1,1
430,796323,1,0,0,0,0,0,0,0,0,0,0,0,0,0,0,0,0
431,791161,34,3,12,2,3,1,9,3,4,3,5,0,1,1,0,0,10
431,780629,31,4,11,1,7,3,4,0,2,1,2,1,2,3,2,0,11
431,796816,27,2,3,0,0,2,3,0,0,2,1,1,4,2,0,0,6
431,774845,38,5,17,3,10,2,7,10,10,1,3,2,1,1,3,0,22
431,775888,37,9,20,7,14,2,6,2,4,4,5,3,3,5,3,2,22
431,791159,6,0,1,0,0,0,1,0,1,0,1,0,0,0,0,0,0
431,792111,6,0,5,0,1,0,4,0,0,0,0,0,0,0,0,0,0
431,785346,20,0,1,0,0,0,1,0,0,0,2,0,1,0,0,0,0
431,796815,1,0,0,0,0,0,0,0,0,0,0,0,0,0,0,0,0
432,776178,4,0,1,0,1,0,0,0,0,0,2,1,0,0,0,0,0
432,791627,24,1,3,0,0,1,3,0,1,0,0,3,2,2,1,0,3
432,791070,17,2,5,2,4,0,1,0,0,1,3,2,1,1,2,0,4
432,776253,22,8,13,5,9,3,4,3,4,3,5,1,0,1,0,1,22
432,775651,14,3,5,3,4,0,1,0,0,1,5,2,0,0,0,3,6
432,796501,26,6,11,3,5,3,6,2,2,1,0,2,1,0,1,0,17
432,785660,17,1,4,1,4,0,0,0,0,4,2,0,1,0,0,1,2
432,796505,13,2,3,2,2,0,1,4,4,1,4,2,2,0,2,1,8
432,796502,18,2,3,1,1,1,2,2,2,0,5,1,3,1,2,1,7
432,785665,19,3,8,2,3,1,5,0,0,1,3,1,1,0,1,0,7
432,796504,20,1,6,0,2,1,4,4,4,2,6,2,2,2,2,0,7
432,791073,4,0,0,0,0,0,0,0,0,0,0,0,1,0,0,0,0
432,791076,2,0,0,0,0,0,0,0,0,0,2,0,0,0,0,0,0
434,797060,28,4,13,1,4,3,9,0,0,2,3,1,4,2,0,1,11
434,791438,30,3,9,3,7,0,2,0,0,1,4,2,2,0,1,1,6
434,776137,32,1,5,0,0,1,5,0,0,0,6,1,0,1,0,2,3
434,797038,25,2,6,1,4,1,2,3,3,1,3,3,4,1,1,0,8
434,781641,33,8,16,4,6,4,10,3,5,0,3,1,2,0,5,0,23
434,797053,11,1,2,1,2,0,0,3,3,1,2,0,2,0,0,0,5
434,791437,14,1,4,0,3,1,1,0,0,0,0,4,0,0,1,0,3
434,791436,14,1,2,1,2,0,0,4,4,1,2,0,1,0,0,1,6
434,791439,4,1,2,1,2,0,0,0,0,2,1,0,1,0,0,1,2
434,797043,2,0,1,0,1,0,0,0,0,0,0,0,0,0,0,0,0
434,797059,4,1,1,0,0,1,1,0,0,0,1,0,1,0,1,0,3
434,786305,3,0,0,0,0,0,0,0,0,0,0,0,0,0,0,0,0
435,791295,25,2,5,2,5,0,0,1,2,3,5,1,2,0,0,2,5
435,791293,24,4,9,1,2,3,7,2,3,0,4,1,3,0,1,0,13
435,785794,30,10,15,2,5,8,10,2,2,2,6,2,0,0,1,0,30
435,785792,28,2,9,1,2,1,7,2,2,0,2,9,3,1,0,0,7
435,781373,26,3,7,1,1,2,6,3,3,0,7,2,3,2,1,0,11
435,781379,6,2,2,2,2,0,0,0,0,0,2,0,0,0,0,0,4
435,776345,14,0,3,0,3,0,0,0,0,2,2,4,1,1,2,1,0
435,796577,6,0,2,0,0,0,2,0,0,0,0,0,2,0,0,0,0
435,791292,13,1,4,1,4,0,0,0,2,4,1,1,1,1,1,0,2
435,796579,22,3,9,0,0,3,9,0,0,1,1,2,1,0,1,0,9
435,796578,4,0,1,0,0,0,1,3,4,0,0,0,1,0,0,0,3
435,791294,1,0,0,0,0,0,0,0,0,0,0,0,0,0,0,0,0
435,781372,1,0,0,0,0,0,0,0,0,0,0,0,0,0,0,0,0
436,792288,22,2,6,1,3,1,3,0,0,1,2,1,4,0,2,0,5
436,785227,26,6,7,6,7,0,0,0,0,2,4,1,3,1,2,2,12
436,786237,22,5,8,5,8,0,0,4,6,0,8,3,5,3,2,0,14
436,780287,23,4,9,4,7,0,2,2,2,1,0,1,2,0,0,0,10
436,776309,35,8,15,7,10,1,5,1,3,1,7,4,3,5,3,0,18
436,798067,16,2,3,2,2,0,1,0,0,1,4,1,3,1,1,0,4
436,792278,22,6,12,2,3,4,9,0,0,0,1,2,0,2,0,0,16
436,786232,25,2,6,2,3,0,3,1,1,0,2,2,4,0,3,0,5
436,798077,1,0,0,0,0,0,0,0,0,0,0,0,0,0,0,0,0
436,798072,4,0,0,0,0,0,0,0,0,0,0,0,0,0,0,0,0
436,798068,3,0,0,0,0,0,0,0,0,0,0,0,0,0,0,0,0
436,798066,1,0,0,0,0,0,0,0,0,0,0,0,0,0,0,0,0
436,792282,0,0,0,0,0,0,0,0,0,0,0,0,0,0,0,0,0
437,791512,17,4,8,4,8,0,0,0,2,3,5,0,2,0,0,0,8
437,786338,19,1,8,1,3,0,5,2,4,2,2,0,3,1,4,0,4
437,792052,21,2,5,0,1,2,4,1,1,0,2,2,1,0,2,0,7
437,792050,13,2,5,2,4,0,1,0,0,0,4,1,2,0,1,0,4
437,785347,32,3,7,3,3,0,4,1,2,0,2,2,0,0,3,0,7
437,786825,7,0,0,0,0,0,0,0,2,0,3,0,1,0,2,0,0
437,797648,15,5,8,4,6,1,2,1,2,2,4,0,0,0,2,0,12
437,797647,4,1,1,1,1,0,0,0,1,0,0,1,0,0,0,0,2
437,792047,16,1,3,1,2,0,1,1,2,0,0,1,0,0,1,0,3
437,775476,14,2,6,1,3,1,3,0,0,0,1,1,3,0,1,0,5
437,775601,22,1,4,1,4,0,0,2,3,0,2,1,3,1,3,0,4
437,792048,1,0,1,0,0,0,1,0,0,0,0,0,0,0,0,0,0
437,792045,13,0,1,0,1,0,0,1,2,1,0,0,0,0,0,0,1
437,792051,1,0,0,0,0,0,0,0,0,0,0,0,0,0,0,0,0
437,780862,5,1,1,1,1,0,0,0,0,0,0,0,0,0,1,0,2
438,785490,12,0,0,0,0,0,0,0,0,0,1,0,1,0,0,0,0
438,785495,24,6,12,6,11,0,1,3,4,1,6,5,4,1,0,1,15
438,775377,21,2,5,2,5,0,0,0,1,0,5,0,0,2,1,1,4
438,785494,39,7,16,6,12,1,4,3,4,0,4,3,3,4,3,1,18
438,780698,37,5,16,3,10,2,6,1,3,1,5,2,2,1,3,1,13
438,785659,23,3,4,3,4,0,0,1,1,1,5,0,3,0,1,0,7
438,791033,27,2,7,1,2,1,5,1,1,0,1,0,4,1,1,1,6
438,785486,1,0,0,0,0,0,0,0,0,0,0,0,1,0,0,0,0
438,780427,16,5,6,4,4,1,2,0,0,2,2,1,4,0,3,0,11
439,796585,25,5,5,5,5,0,0,0,0,1,1,3,2,0,2,2,10
439,780192,30,7,11,6,6,1,5,1,3,0,8,4,3,0,2,1,16
439,798139,23,2,9,2,7,0,2,3,5,0,3,5,3,0,1,0,7
439,786818,31,7,9,7,8,0,1,5,7,1,9,3,1,5,2,0,19
439,780182,30,3,12,1,4,2,8,2,2,0,2,1,2,1,0,0,10
439,790974,4,0,1,0,1,0,0,0,0,0,0,0,2,0,0,0,0
439,780186,15,1,1,1,1,0,0,0,1,0,2,1,1,0,2,0,2
439,798138,12,1,4,1,2,0,2,0,0,0,0,0,1,0,2,0,2
439,796582,2,0,0,0,0,0,0,0,0,0,1,0,1,1,0,0,0
439,786820,15,2,3,1,1,1,2,2,2,0,2,1,0,1,3,0,7
439,780188,5,0,1,0,0,0,1,0,0,0,0,0,0,0,0,0,0
439,780184,8,2,3,2,2,0,1,1,1,0,1,0,0,0,0,0,5
440,780650,35,5,13,4,9,1,4,0,0,2,9,4,3,1,6,0,11
440,791810,25,1,3,1,1,0,2,0,0,1,1,6,4,0,2,0,2
440,791815,37,10,18,6,10,4,8,8,8,1,2,5,2,0,0,0,32
440,791814,35,6,11,2,2,4,9,0,0,0,3,2,2,0,2,0,16
440,781596,19,1,2,1,2,0,0,3,4,1,1,1,4,1,0,0,5
440,791809,17,2,3,2,3,0,0,0,0,1,1,3,2,1,0,0,4
440,786644,23,5,5,4,4,1,1,2,2,1,3,0,1,0,0,1,13
440,791812,9,1,1,1,1,0,0,0,0,0,2,0,1,0,0,1,2
440,797372,0,0,0,0,0,0,0,0,0,0,1,0,0,0,0,1,0
441,797143,36,6,8,2,3,4,5,2,2,0,1,2,3,1,2,0,18
441,791522,36,8,12,7,10,1,2,7,9,0,1,6,3,3,1,0,24
441,786351,33,4,9,4,4,0,5,1,3,2,9,0,2,0,2,1,9
441,786348,15,0,3,0,1,0,2,4,4,0,0,1,1,0,0,0,4
441,797146,31,10,18,6,8,4,10,1,1,0,1,2,2,1,0,0,25
441,785479,12,0,0,0,0,0,0,0,0,1,2,0,3,0,1,1,0
441,797147,10,0,1,0,1,0,0,0,0,0,1,1,1,0,1,0,0
441,797142,18,0,1,0,1,0,0,1,2,1,1,0,0,0,0,0,1
441,797144,4,0,0,0,0,0,0,0,0,0,0,0,2,0,1,0,0
441,786771,5,0,0,0,0,0,0,0,0,0,0,0,1,0,1,0,0
442,780892,22,6,9,4,4,2,5,1,2,0,3,2,1,2,0,0,15
442,785904,20,9,10,5,6,4,4,0,0,0,1,1,0,1,1,0,22
442,786091,20,3,6,1,1,2,5,2,2,1,3,2,1,1,2,0,10
442,786096,24,3,6,2,2,1,4,4,4,0,7,4,1,0,3,2,11
442,775738,16,0,0,0,0,0,0,0,0,0,1,0,0,0,2,1,0
442,792087,10,2,6,2,4,0,2,0,0,0,1,0,1,1,1,0,4
442,797666,18,2,6,2,3,0,3,0,0,0,2,4,1,0,0,0,4
442,786728,23,5,8,3,4,2,4,0,3,0,2,6,1,1,1,0,12
442,797669,12,2,4,2,4,0,0,0,0,3,1,0,0,2,1,1,4
442,797665,4,1,2,0,0,1,2,0,0,0,0,0,1,0,0,0,3
442,786350,12,0,0,0,0,0,0,1,2,0,2,2,2,0,1,1,1
442,797670,4,2,2,2,2,0,0,1,1,0,1,0,0,0,0,0,5
442,786788,15,2,4,2,3,0,1,0,0,4,3,2,2,1,0,0,4
444,791131,20,1,2,0,0,1,2,2,2,0,2,0,1,1,2,5,5
444,791135,22,8,10,8,10,0,0,5,6,2,5,1,1,0,0,0,21
444,786090,25,4,9,2,3,2,6,3,4,0,5,5,2,3,3,1,13
444,786088,28,1,2,0,1,1,1,0,2,1,4,9,0,4,2,0,3
444,774921,27,7,9,4,6,3,3,3,4,0,0,6,2,1,0,0,20
444,791133,8,3,6,3,6,0,0,0,0,2,0,0,2,0,0,0,6
444,786097,2,0,0,0,0,0,0,0,0,1,0,1,4,0,0,0,0
444,791521,17,4,4,4,4,0,0,5,6,1,2,0,1,0,0,1,13
444,796792,5,0,1,0,0,0,1,0,0,0,1,1,0,0,0,0,0
444,796790,23,11,14,5,6,6,8,0,0,0,2,3,1,2,1,0,28
444,792585,5,0,0,0,0,0,0,0,0,0,0,0,0,0,0,0,0
444,791132,11,2,4,0,0,2,4,0,0,0,1,2,2,0,0,0,6
444,786092,7,1,1,1,1,0,0,0,0,0,1,1,0,1,0,0,2
446,797198,15,1,3,1,2,0,1,2,2,0,2,0,1,0,0,0,4
446,791482,30,4,7,2,2,2,5,8,9,4,2,1,2,2,2,0,18
446,780223,24,5,7,2,2,3,5,0,0,1,2,0,4,1,1,1,13
446,786318,28,4,11,2,3,2,8,0,2,0,3,3,2,0,2,0,10
446,780225,24,5,6,2,2,3,4,0,0,1,5,2,2,0,1,0,13
446,784268,30,5,8,4,6,1,2,1,2,0,0,5,1,0,2,0,12
446,786319,12,2,4,2,4,0,0,2,3,0,4,4,1,0,0,2,6
446,797199,12,1,2,1,1,0,1,0,0,0,1,0,2,0,3,0,2
446,791481,14,0,0,0,0,0,0,0,0,0,2,1,3,0,1,1,0
446,786320,2,0,0,0,0,0,0,0,0,0,0,0,0,0,0,0,0
446,796079,1,0,0,0,0,0,0,0,0,0,0,0,0,0,0,0,0
446,791480,2,0,0,0,0,0,0,0,0,0,0,0,0,0,0,0,0
446,786317,1,0,0,0,0,0,0,0,0,0,0,0,0,0,0,0,0
446,797201,5,0,0,0,0,0,0,0,0,0,0,0,0,0,0,0,0
447,785458,30,3,8,3,6,0,2,4,6,4,3,0,3,0,3,0,10
447,785457,16,1,3,1,2,0,1,2,2,1,0,0,0,0,0,0,4
447,780798,30,1,4,1,1,0,3,0,0,0,6,2,1,0,1,1,2
447,785455,26,4,13,4,10,0,3,2,4,0,0,1,2,1,2,0,10
447,785453,21,5,11,3,5,2,6,0,1,0,1,1,2,3,0,0,12
447,790914,18,1,4,1,4,0,0,4,4,3,2,0,4,0,0,0,6
447,774940,17,4,7,4,7,0,0,0,0,1,0,0,1,0,2,0,8
447,785454,21,1,3,0,1,1,2,0,1,1,1,1,0,1,2,0,3
447,790915,9,2,3,2,3,0,0,0,0,0,1,0,3,0,1,1,4
447,790913,11,1,3,1,3,0,0,1,1,0,2,2,0,2,1,0,3
447,790911,1,0,0,0,0,0,0,0,0,0,0,0,0,0,0,0,0
448,797235,18,2,4,2,4,0,0,0,0,1,3,0,1,1,0,0,4
448,797233,15,4,7,4,5,0,2,1,1,2,2,0,1,0,2,0,9
448,797237,22,3,5,1,1,2,4,2,2,0,4,6,2,4,1,0,10
448,785446,18,2,5,0,2,2,3,0,0,0,2,2,1,1,0,0,6
448,797239,18,7,8,1,1,6,7,1,2,0,1,3,1,3,0,0,21
448,791368,13,2,5,2,5,0,0,2,2,1,0,1,1,0,1,0,6
448,797238,16,2,3,1,2,1,1,0,0,2,2,0,3,0,1,0,5
448,786251,16,4,7,4,7,0,0,0,0,2,3,0,5,0,3,1,8
448,797232,16,6,13,3,4,3,9,0,0,1,1,2,2,1,0,0,15
448,797240,8,2,3,0,0,2,3,0,0,0,1,3,3,0,2,0,6
448,791367,16,1,1,1,1,0,0,1,2,1,1,8,0,1,1,1,3
448,791369,14,1,6,1,3,0,3,1,1,3,3,1,0,0,0,0,3
448,797234,10,4,5,2,3,2,2,0,0,1,3,2,0,1,1,0,10
450,781319,19,6,10,5,9,1,1,7,9,2,4,0,3,0,0,2,20
450,792220,22,1,6,0,4,1,2,2,2,0,2,1,0,1,0,0,5
450,786691,31,4,14,1,5,3,9,2,2,2,5,5,1,0,1,1,13
450,786693,23,6,7,3,4,3,3,0,0,1,6,4,1,0,0,0,15
450,781329,34,5,10,5,9,0,1,2,4,1,3,4,1,3,4,0,12
450,797876,19,0,3,0,1,0,2,5,6,2,4,1,2,1,1,1,5
450,792219,5,0,1,0,1,0,0,0,0,1,0,0,2,0,1,0,0
450,792222,11,0,1,0,0,0,1,0,0,0,0,0,1,0,0,0,0
450,792046,20,3,8,2,5,1,3,1,2,0,1,3,3,2,0,0,8
450,781455,16,1,1,0,0,1,1,0,1,0,0,1,0,0,1,0,3
451,781624,23,0,3,0,2,0,1,0,0,0,2,2,0,0,0,0,0
451,792246,14,2,8,2,8,0,0,2,2,4,1,0,2,0,1,2,6
451,791701,26,2,6,2,4,0,2,0,0,2,3,1,3,0,1,2,4
451,792245,28,3,5,0,0,3,5,0,0,0,4,3,1,0,0,0,9
451,781420,32,2,7,2,4,0,3,2,2,0,6,4,4,1,5,0,6
451,797924,6,2,2,2,2,0,0,0,0,1,1,0,0,0,0,1,4
451,792244,15,4,8,3,4,1,4,0,0,0,0,3,0,0,2,0,9
451,781417,13,2,2,2,2,0,0,0,0,0,2,1,3,0,1,0,4
451,797925,15,4,10,4,8,0,2,4,6,1,2,2,3,1,1,0,12
451,781405,28,4,9,4,6,0,3,2,2,0,4,1,4,0,1,0,10
452,785523,30,5,8,5,8,0,0,2,3,1,4,0,4,0,1,2,12
452,791250,21,3,6,1,2,2,4,1,2,1,3,1,4,3,1,0,9
452,780703,29,4,9,4,6,0,3,8,12,3,3,2,4,0,1,0,16
452,791249,35,6,14,1,3,5,11,4,4,1,0,2,1,0,2,0,21
452,775358,23,2,5,2,4,0,1,0,0,0,2,1,3,2,1,0,4
452,796949,3,1,1,1,1,0,0,2,2,0,1,0,0,0,0,0,4
452,785522,7,0,0,0,0,0,0,0,0,1,0,0,1,0,0,0,0
452,781247,13,0,4,0,1,0,3,2,3,0,0,0,3,1,1,0,2
452,796947,12,1,6,1,5,0,1,1,1,0,1,0,0,0,0,0,3
452,796944,8,1,2,1,2,0,0,0,0,0,1,0,2,0,0,0,2
452,785521,19,1,4,0,1,1,3,0,0,0,0,4,2,0,0,0,3
453,797877,20,3,3,3,3,0,0,0,0,1,2,0,4,1,0,0,6
453,781599,24,1,5,0,3,1,2,5,8,0,4,2,2,0,2,0,8
453,797872,37,2,5,2,3,0,2,5,6,0,5,2,2,1,2,2,9
453,791338,20,2,5,2,4,0,1,1,3,0,5,0,4,0,1,0,5
453,791339,38,4,10,2,4,2,6,10,14,0,2,4,2,0,3,0,20
453,797873,9,1,2,1,2,0,0,0,0,0,0,0,1,0,0,0,2
453,791337,26,4,4,4,4,0,0,8,8,1,2,1,4,0,1,1,16
453,797875,2,0,0,0,0,0,0,0,0,0,1,0,2,0,1,0,0
453,797874,2,1,1,0,0,1,1,0,0,0,0,0,1,0,0,0,3
453,781595,22,2,6,1,3,1,3,1,2,0,3,0,1,0,0,0,6
454,780229,31,7,11,7,11,0,0,1,4,0,5,7,4,1,5,0,15
454,795572,31,6,14,5,11,1,3,2,4,1,3,0,1,0,3,0,15
454,786323,18,1,2,0,0,1,2,0,0,0,1,1,1,1,0,0,3
454,786322,23,2,6,2,3,0,3,1,3,0,2,1,4,0,1,0,5
454,780228,30,4,7,0,1,4,6,0,1,1,1,5,0,2,1,0,12
454,781592,26,1,3,1,2,0,1,2,2,0,8,3,3,1,3,0,4
454,791488,22,4,6,3,3,1,3,0,1,0,2,5,2,1,0,0,9
454,791485,19,5,5,2,2,3,3,0,2,0,0,1,3,0,2,0,13
455,780201,36,6,13,6,11,0,2,8,8,2,6,1,2,0,2,0,20
455,798344,23,1,5,1,5,0,0,0,0,0,6,0,2,0,4,1,2
455,797208,37,5,9,5,8,0,1,1,3,1,3,2,2,0,3,0,11
455,791467,36,8,15,4,8,4,7,4,6,1,2,1,3,1,2,0,24
455,775516,40,3,7,2,4,1,3,1,2,0,2,11,3,4,2,0,8
455,791470,8,0,2,0,1,0,1,0,0,1,2,0,1,0,0,0,0
455,791469,19,4,6,4,6,0,0,0,0,2,4,1,3,0,1,3,8
455,791471,1,0,0,0,0,0,0,0,0,0,0,0,0,0,0,0,0
456,780858,30,2,4,0,0,2,4,4,6,1,5,0,5,0,2,0,10
456,785996,26,4,9,4,9,0,0,2,3,4,3,0,3,0,5,0,10
456,780853,33,6,14,5,11,1,3,3,4,0,2,4,4,3,7,1,16
456,780849,23,0,4,0,1,0,3,5,5,0,0,0,4,0,0,0,5
456,785998,12,1,4,0,2,1,2,0,1,3,1,0,1,0,1,0,3
456,792039,26,3,8,3,7,0,1,0,1,2,3,2,3,0,1,0,6
456,792235,9,0,2,0,2,0,0,1,2,1,1,0,3,0,0,0,1
456,780776,10,1,3,1,3,0,0,0,3,2,1,0,1,0,0,1,2
456,797646,31,6,11,6,11,0,0,3,5,0,5,0,2,1,0,0,15
457,791583,20,4,5,4,5,0,0,3,5,0,3,0,3,0,1,4,11
457,781407,15,1,2,1,1,0,1,6,6,1,2,1,5,0,1,0,8
457,780580,32,5,13,5,9,0,4,5,6,1,3,3,3,1,3,0,15
457,776150,31,4,7,3,4,1,3,2,2,0,2,5,2,3,4,0,11
457,785623,22,0,3,0,1,0,2,2,2,0,1,1,3,0,0,1,2
457,786659,20,5,7,5,7,0,0,2,2,1,4,0,2,1,1,1,12
457,797445,12,2,6,2,4,0,2,0,0,0,1,0,2,0,0,0,4
457,791584,19,0,0,0,0,0,0,7,8,0,3,0,3,1,1,0,7
457,797448,18,3,4,1,1,2,3,0,0,1,2,0,0,2,0,0,8
457,786608,11,1,2,0,0,1,2,3,4,0,2,1,2,0,0,0,6
458,775642,10,2,5,2,5,0,0,0,0,0,2,1,0,0,1,0,4
458,785635,19,3,6,1,4,2,2,2,2,2,6,2,4,1,1,2,10
458,786440,25,3,8,3,8,0,0,3,3,0,3,1,3,1,2,0,9
458,786720,33,6,12,4,8,2,4,3,4,1,5,6,1,3,1,0,17
458,781199,37,10,19,7,13,3,6,5,9,1,1,8,0,1,4,0,28
458,791628,14,0,3,0,2,0,1,0,0,1,0,0,1,1,0,0,0
458,786439,16,1,3,1,3,0,0,4,4,0,3,3,2,0,1,1,6
458,776462,21,2,3,1,2,1,1,3,4,1,6,0,3,0,0,0,8
458,791629,14,2,5,2,4,0,1,0,2,2,1,0,2,0,1,0,4
458,796974,11,1,1,1,1,0,0,0,0,0,1,1,1,0,0,0,2
459,786358,16,1,2,1,1,0,1,0,0,0,0,1,4,0,1,0,2
459,775418,24,2,6,2,6,0,0,2,3,1,3,0,4,2,2,0,6
459,786357,34,4,9,4,9,0,0,2,4,1,8,3,3,0,5,1,10
459,780306,37,5,15,5,12,0,3,4,6,1,8,4,3,1,5,2,14
459,780312,23,5,8,2,3,3,5,6,6,0,1,1,4,0,2,0,19
459,791537,16,5,7,3,4,2,3,0,0,2,1,0,5,0,1,0,12
459,797116,28,4,11,3,6,1,5,1,1,1,1,2,2,1,2,1,10
459,775565,22,0,1,0,1,0,0,0,0,0,1,0,2,1,1,0,0
460,785622,36,3,12,2,7,1,5,4,8,1,5,0,2,2,1,0,11
460,781058,31,2,5,2,5,0,0,2,3,2,8,0,3,3,5,0,6
460,780327,23,0,1,0,1,0,0,0,0,2,1,1,2,1,3,2,0
460,797451,19,3,8,1,4,2,4,1,2,0,1,0,5,1,4,0,9
460,786607,25,1,9,1,3,0,6,2,2,1,4,0,1,1,1,0,4
460,797455,5,0,0,0,0,0,0,0,0,0,4,0,0,0,0,0,0
460,797458,22,3,3,2,2,1,1,3,5,0,3,2,2,0,1,0,10
460,797453,6,1,1,1,1,0,0,0,0,0,1,0,0,0,0,0,2
460,797452,4,0,1,0,0,0,1,0,0,0,0,0,1,0,0,0,0
460,791849,29,3,9,0,1,3,8,3,5,0,2,4,3,0,0,0,12
461,776285,10,1,4,1,4,0,0,0,0,0,3,0,5,0,0,1,2
461,791783,13,0,4,0,4,0,0,0,0,0,2,0,3,1,3,1,0
461,791780,18,1,3,0,2,1,1,1,2,1,1,1,0,0,0,0,4
461,791777,35,4,15,3,13,1,2,1,2,1,2,3,2,0,3,0,10
461,780488,18,1,5,1,3,0,2,2,2,0,2,1,2,0,2,0,4
461,791781,24,2,2,2,2,0,0,0,1,2,4,2,0,1,1,1,4
461,791778,4,0,1,0,1,0,0,0,0,1,0,1,0,0,0,0,0
461,786476,5,0,0,0,0,0,0,0,0,1,0,0,1,0,0,0,0
461,791776,18,4,6,1,1,3,5,1,1,0,4,2,1,0,1,0,12
461,781025,21,2,4,1,2,1,2,2,2,0,2,2,1,2,0,0,7
461,786474,14,1,4,1,3,0,1,0,0,0,0,0,1,0,2,0,2
461,775503,20,3,5,0,0,3,5,3,3,0,4,0,3,0,1,1,12
462,786203,37,5,14,1,3,4,11,0,1,0,6,1,1,0,0,1,14
462,780717,35,9,19,9,16,0,3,10,13,3,12,3,2,0,2,1,28
462,791738,25,3,5,3,5,0,0,2,3,5,5,0,5,2,1,2,8
462,776266,33,3,9,3,8,0,1,2,3,1,7,3,3,0,2,2,8
462,791742,23,4,10,4,6,0,4,0,0,2,2,1,4,1,1,0,8
462,776328,19,1,6,1,4,0,2,0,0,2,4,3,2,0,1,1,2
462,791741,12,2,2,2,2,0,0,1,2,0,1,1,3,2,2,1,5
462,774859,8,0,0,0,0,0,0,0,0,1,1,0,0,0,0,1,0
462,786315,7,0,1,0,1,0,0,0,1,0,0,1,2,0,1,0,0
462,786200,1,0,0,0,0,0,0,0,0,1,0,0,0,0,0,0,0
463,775806,32,5,14,3,7,2,7,2,2,1,3,0,1,0,2,0,14
463,775563,22,2,11,2,9,0,2,0,1,3,8,0,3,0,2,0,4
463,781011,26,4,6,3,4,1,2,4,6,2,7,0,4,1,1,3,13
463,781012,33,1,10,1,6,0,4,1,2,0,0,6,3,1,0,0,3
463,797601,26,3,10,2,6,1,4,2,3,0,1,5,4,0,5,0,9
463,786466,27,2,6,0,0,2,6,3,3,0,5,1,3,1,0,1,9
463,776157,14,2,5,1,2,1,3,0,0,0,1,0,0,0,0,0,5
463,781424,11,0,5,0,3,0,2,0,0,0,0,0,0,0,0,0,0
463,775188,9,0,0,0,0,0,0,0,0,1,3,0,5,0,1,1,0
464,780874,15,2,7,1,4,1,3,2,3,2,3,0,1,1,1,0,7
464,785638,32,3,10,1,5,2,5,0,0,5,1,3,1,0,1,0,8
464,781326,36,5,8,5,8,0,0,6,11,8,10,0,2,1,0,2,16
464,792209,30,3,5,0,0,3,5,1,4,0,2,3,1,3,0,0,10
464,781323,35,2,11,1,7,1,4,3,4,0,0,2,0,0,4,0,8
464,792214,2,0,0,0,0,0,0,0,0,0,0,0,0,0,2,0,0
464,797870,17,3,7,1,3,2,4,4,4,0,2,3,4,0,1,0,12
464,797869,1,0,0,0,0,0,0,0,0,0,0,0,1,0,0,0,0
464,792210,4,0,0,0,0,0,0,0,0,0,1,0,1,0,1,0,0
464,792213,9,0,2,0,1,0,1,0,0,0,0,0,1,0,0,0,0
464,792215,18,2,5,0,0,2,5,3,4,0,2,2,1,1,1,0,9
464,797868,1,0,0,0,0,0,0,0,0,0,0,0,1,0,1,0,0
465,792277,15,1,1,1,1,0,0,2,2,0,0,0,2,0,0,0,4
465,781464,18,0,2,0,1,0,1,0,0,1,1,1,2,1,0,0,0
465,785282,33,6,13,4,6,2,7,0,0,1,1,1,1,0,1,0,14
465,781502,34,4,10,3,7,1,3,1,4,1,6,5,4,3,3,0,10
465,780259,33,9,13,8,9,1,4,0,0,1,7,1,3,1,2,2,19
465,781501,22,3,4,3,4,0,0,0,0,1,2,2,2,1,0,0,6
465,798058,19,1,6,1,4,0,2,2,2,0,2,2,1,0,4,0,4
465,786516,2,0,1,0,0,0,1,0,0,0,0,0,0,0,0,0,0
465,785913,24,3,4,3,4,0,0,2,6,3,2,1,5,0,1,0,8
466,785374,15,2,3,2,3,0,0,2,2,2,1,1,2,0,1,0,6
466,785372,26,4,11,3,8,1,3,5,5,0,8,3,4,1,2,4,14
466,786384,23,4,11,4,7,0,4,2,4,4,12,4,1,0,1,0,10
466,785371,17,1,1,1,1,0,0,1,1,0,2,3,3,1,0,0,3
466,774905,26,3,7,1,4,2,3,0,0,0,0,4,2,1,0,0,8
466,790827,18,2,3,2,2,0,1,0,1,1,3,3,0,0,2,1,4
466,785375,15,3,8,3,8,0,0,1,1,2,5,1,2,1,2,4,7
466,785373,22,4,8,3,3,1,5,0,0,0,2,1,0,5,0,2,9
466,790825,20,5,11,2,6,3,5,0,0,0,2,6,2,0,3,0,13
466,790828,3,1,1,1,1,0,0,1,1,0,0,0,0,0,0,0,3
466,796385,4,0,2,0,2,0,0,0,0,0,0,0,1,0,0,0,0
466,796387,3,1,1,1,1,0,0,1,1,1,0,0,3,0,0,0,3
466,796386,3,0,0,0,0,0,0,0,0,0,0,0,0,0,0,1,0
466,790826,2,0,2,0,1,0,1,0,0,1,0,0,0,0,1,0,0
466,780007,3,0,1,0,1,0,0,0,0,0,0,0,1,0,0,0,0
467,785423,32,4,6,3,5,1,1,3,5,2,7,0,4,0,1,0,12
467,775676,30,2,7,2,7,0,0,0,0,0,5,3,2,1,0,3,4
467,786298,36,3,12,0,5,3,7,4,4,0,1,3,2,1,3,0,13
467,785425,37,3,10,3,8,0,2,6,7,2,6,4,1,1,1,0,12
467,785422,36,7,22,3,11,4,11,5,7,1,5,2,0,0,5,0,23
467,774957,16,1,1,1,1,0,0,0,0,0,3,1,1,0,0,0,2
467,796431,6,0,0,0,0,0,0,1,2,1,0,0,1,1,0,1,1
467,793801,1,1,2,1,2,0,0,1,1,0,0,0,0,0,0,0,3
467,796429,6,0,0,0,0,0,0,0,0,0,0,0,0,0,0,0,0
468,785298,20,2,4,2,4,0,0,2,4,5,2,0,2,0,1,0,6
468,775224,15,2,2,2,2,0,0,1,3,1,1,2,3,3,1,0,5
468,778046,28,7,13,4,8,3,5,0,0,0,3,4,2,3,2,1,17
468,775793,32,9,18,6,11,3,7,0,0,2,5,4,0,0,2,0,21
468,782121,27,7,9,5,7,2,2,2,4,0,4,6,3,3,1,0,18
468,786594,28,5,9,3,4,2,5,0,0,1,2,7,2,0,0,0,12
468,785485,16,2,5,2,5,0,0,2,2,1,6,0,3,0,2,0,6
468,785302,13,4,10,4,9,0,1,0,0,2,1,1,0,0,1,0,8
468,796598,15,6,9,1,2,5,7,0,0,0,2,1,0,2,0,0,17
468,796599,4,1,1,1,1,0,0,0,0,0,0,0,0,1,0,0,2
468,790987,2,0,0,0,0,0,0,0,0,0,0,0,0,0,0,0,0
469,781666,33,10,17,7,9,3,8,3,4,0,3,1,1,1,5,0,26
469,786575,33,9,9,8,8,1,1,3,4,4,4,1,3,0,2,2,22
469,792338,34,4,12,4,9,0,3,0,0,0,3,2,2,2,2,1,8
469,792334,24,2,9,2,8,0,1,2,2,2,6,3,2,0,3,0,6
469,798094,36,5,8,3,3,2,5,4,5,0,3,1,1,1,5,0,16
469,798097,12,1,3,1,3,0,0,0,1,0,1,1,5,1,1,0,2
469,791636,15,1,1,1,1,0,0,0,0,0,1,1,1,0,1,0,2
469,798095,13,0,2,0,1,0,1,0,0,0,0,2,0,0,0,0,0
470,780956,21,4,7,1,3,3,4,4,6,0,2,1,1,0,1,1,15
470,797311,20,2,5,2,4,0,1,0,0,3,4,1,0,2,2,3,4
470,797310,26,1,4,1,1,0,3,0,0,0,5,8,0,1,1,0,2
470,791724,17,3,5,1,3,2,2,0,1,3,2,1,2,1,2,1,8
470,781617,23,6,11,5,9,1,2,1,1,3,4,1,2,0,2,0,14
470,797312,11,2,4,1,2,1,2,0,0,0,2,0,0,0,1,0,5
470,791723,19,4,4,4,4,0,0,2,2,0,3,1,3,0,2,3,10
470,786277,4,1,1,1,1,0,0,1,2,1,1,0,3,0,2,1,3
470,786285,19,3,7,2,3,1,4,0,0,1,4,1,0,0,2,1,7
470,797308,20,2,6,1,3,1,3,1,2,0,2,1,1,1,1,0,6
470,790085,4,0,0,0,0,0,0,1,3,0,1,1,0,0,0,1,1
470,780706,16,2,4,1,3,1,1,0,0,0,7,1,0,2,1,0,5
472,796674,19,2,5,2,3,0,2,2,2,3,5,3,2,0,1,0,6
472,785126,11,2,5,2,4,0,1,0,0,1,0,3,1,0,1,0,4
472,785339,26,3,5,0,1,3,4,2,2,0,1,1,1,1,3,0,11
472,779976,31,7,12,2,6,5,6,1,2,0,7,3,3,0,4,0,20
472,774990,36,5,13,4,8,1,5,0,0,0,5,6,3,2,3,1,11
472,779857,12,4,5,4,4,0,1,2,4,0,1,0,3,0,2,1,10
472,796673,15,1,3,1,2,0,1,0,0,0,1,1,2,0,1,3,2
472,791014,24,3,6,1,1,2,5,2,2,1,4,3,4,1,1,0,10
472,780142,3,0,0,0,0,0,0,0,0,0,0,1,0,0,0,0,0
472,781586,17,2,2,2,2,0,0,2,2,1,3,1,2,2,1,0,6
472,785961,3,1,1,1,1,0,0,0,0,0,0,0,0,0,1,0,2
472,786737,3,0,0,0,0,0,0,0,0,0,0,0,0,0,0,0,0
473,786424,31,1,9,1,9,0,0,1,2,4,3,1,4,0,6,0,3
473,797979,12,0,0,0,0,0,0,0,0,0,0,0,0,0,0,0,0
473,792366,32,6,13,6,12,0,1,9,12,1,7,2,5,1,3,0,21
473,792279,25,1,6,1,6,0,0,1,3,1,3,1,2,0,4,0,3
473,785483,38,10,17,7,12,3,5,1,2,0,5,3,2,3,3,0,24
473,797991,23,2,4,1,1,1,3,1,2,1,2,1,0,1,0,0,6
473,791015,21,1,3,0,0,1,3,0,0,0,0,2,1,1,0,0,3
473,797983,9,0,3,0,2,0,1,0,0,2,0,0,0,0,1,0,0
473,797988,9,0,2,0,1,0,1,0,0,0,0,1,2,0,1,1,0
478,781322,22,4,7,1,1,3,6,1,2,1,3,1,3,0,1,0,12
478,785989,30,4,7,4,6,0,1,4,5,2,7,8,0,1,2,1,12
478,786571,34,7,14,5,9,2,5,3,4,1,4,1,2,1,3,1,19
478,780563,29,1,5,0,1,1,4,0,0,0,3,1,3,3,0,0,3
478,781439,31,9,17,6,7,3,10,1,3,0,7,2,2,5,1,0,22
478,791690,19,2,5,2,5,0,0,0,2,5,2,0,1,0,0,1,4
478,781419,17,1,4,1,1,0,3,2,2,0,4,2,1,0,1,0,4
478,781207,12,1,3,1,1,0,2,1,2,0,1,0,4,0,1,0,3
478,797300,2,0,1,0,0,0,1,0,0,0,0,0,0,1,1,0,0
478,791691,2,0,0,0,0,0,0,0,0,1,0,0,0,0,0,0,0
478,791692,2,0,0,0,0,0,0,0,0,0,0,0,0,0,0,1,0
479,781044,21,1,6,0,4,1,2,4,4,0,4,1,4,1,2,0,7
479,797621,25,1,7,1,4,0,3,0,0,1,3,1,0,0,1,0,2
479,786489,30,3,12,2,6,1,6,0,0,2,1,3,1,0,2,1,7
479,786488,32,3,8,3,7,0,1,3,4,5,7,1,1,1,1,1,9
479,781038,28,3,10,2,6,1,4,0,0,4,9,1,1,0,5,0,7
479,797620,18,3,9,3,9,0,0,0,1,3,0,0,2,1,1,1,6
479,791796,13,0,1,0,1,0,0,1,2,2,1,1,3,0,1,1,1
479,797619,9,0,1,0,1,0,0,2,2,0,1,0,1,0,1,0,2
479,786487,23,6,15,3,7,3,8,1,3,3,2,0,4,0,2,0,16
479,786490,1,0,0,0,0,0,0,0,0,0,1,0,0,1,0,0,0
480,780291,32,7,12,7,8,0,4,5,6,4,12,2,2,3,2,1,19
480,775305,28,4,13,2,8,2,5,6,6,1,5,6,1,3,1,0,16
480,785333,20,5,7,3,4,2,3,3,3,1,1,2,0,5,2,0,15
480,796665,21,3,7,0,1,3,6,4,4,0,1,1,0,1,4,0,13
480,785607,13,1,2,1,2,0,0,2,4,2,1,0,1,1,0,0,4
480,791004,27,3,8,0,2,3,6,8,9,1,2,0,0,1,1,1,17
480,791007,17,1,3,1,2,0,1,2,2,1,2,3,1,1,4,0,4
480,796664,16,2,3,2,3,0,0,0,0,0,2,1,0,1,2,0,4
480,791006,4,2,2,2,2,0,0,0,0,1,0,0,0,0,0,0,4
480,796666,12,1,2,1,2,0,0,0,0,2,3,0,3,0,1,0,2
480,796663,5,1,1,1,1,0,0,0,0,0,0,0,0,0,2,0,2
480,791005,3,0,2,0,0,0,2,1,2,0,2,0,0,0,0,0,1
480,796667,2,0,1,0,0,0,1,0,0,0,0,0,0,0,0,0,0
481,791718,32,4,10,0,3,4,7,0,0,0,3,5,0,0,2,0,12
481,791719,27,4,8,2,4,2,4,0,0,0,1,2,1,2,1,0,10
481,798965,19,3,6,1,2,2,4,0,0,1,2,1,4,0,5,0,8
481,798963,13,1,3,1,1,0,2,0,0,0,1,2,1,2,3,0,2
481,798964,5,0,0,0,0,0,0,0,0,0,0,0,2,0,0,0,0
481,781446,27,5,13,3,7,2,6,0,0,0,1,3,3,2,1,0,12
481,798962,19,4,11,4,7,0,4,3,4,2,3,2,5,2,2,2,11
481,798968,28,3,8,1,4,2,4,0,1,2,4,4,2,1,3,3,8
481,791717,9,3,4,2,3,1,1,0,0,1,0,0,4,0,2,0,7
481,787996,15,3,5,3,5,0,0,0,0,0,2,0,3,1,1,0,6
481,791720,5,1,2,1,2,0,0,0,0,1,1,0,1,1,0,0,2
481,798969,1,0,1,0,0,0,1,0,0,0,0,0,0,0,0,0,0
482,776425,22,5,6,4,4,1,2,5,5,0,0,2,0,1,0,0,16
482,791106,25,1,5,1,3,0,2,0,0,0,1,2,3,0,0,1,2
482,785603,23,8,14,3,5,5,9,0,0,2,2,2,1,1,0,0,21
482,775820,17,3,4,3,3,0,1,0,0,2,3,1,2,2,0,0,6
482,775538,20,2,4,2,4,0,0,0,0,0,5,1,0,1,0,0,4
482,796762,11,2,4,2,2,0,2,0,0,1,2,0,5,0,1,0,4
482,791107,18,6,9,6,8,0,1,3,5,3,3,1,3,0,1,1,15
482,791110,25,2,6,2,4,0,2,5,10,0,3,3,3,1,1,0,9
482,786494,21,7,10,6,9,1,1,3,3,2,7,0,2,2,1,0,18
482,780801,9,2,3,2,3,0,0,0,0,0,2,1,1,0,0,0,4
482,796763,9,0,2,0,1,0,1,0,0,1,2,1,2,0,1,1,0
484,785812,37,6,12,2,4,4,8,2,3,2,3,2,2,1,1,0,18
484,797431,29,2,11,2,8,0,3,0,0,0,3,1,3,0,1,0,4
484,785815,38,10,14,4,6,6,8,3,5,0,9,2,3,1,1,0,29
484,780104,29,4,10,2,7,2,3,2,2,1,7,4,3,1,2,0,12
484,791680,3,0,1,0,1,0,0,0,0,1,0,0,1,0,0,1,0
484,791684,24,0,2,0,1,0,1,0,0,0,0,2,1,0,1,0,0
484,790530,2,0,0,0,0,0,0,0,0,0,1,0,0,0,0,0,0
484,791682,25,3,6,3,6,0,0,0,0,2,2,1,1,0,1,2,6
484,791681,13,2,2,2,2,0,0,0,0,1,1,0,0,1,0,0,4
485,798006,17,1,6,1,3,0,3,3,3,1,2,0,0,0,1,1,5
485,786152,34,4,9,4,9,0,0,0,0,3,6,0,0,0,5,1,8
485,792266,12,2,5,2,3,0,2,3,4,1,1,0,2,0,0,0,7
485,792265,32,1,4,1,3,0,1,1,3,1,4,0,0,0,0,0,3
485,798009,25,2,10,0,5,2,5,2,2,2,2,2,0,2,3,0,8
485,792267,23,5,9,2,3,3,6,2,2,0,2,1,2,0,1,0,15
485,792263,14,0,5,0,5,0,0,0,0,1,1,0,2,0,1,0,0
485,798003,17,0,2,0,2,0,0,2,3,0,0,0,1,0,1,0,2
485,797998,10,1,3,1,2,0,1,0,0,3,1,1,3,0,1,0,2
485,798007,8,0,0,0,0,0,0,0,0,1,2,0,2,0,0,0,0
485,798002,2,0,0,0,0,0,0,0,0,0,0,1,0,0,0,0,0
485,798005,2,0,1,0,1,0,0,0,0,1,0,0,0,0,0,0,0
485,797999,2,0,0,0,0,0,0,0,0,0,0,1,0,0,0,0,0
485,797997,2,0,0,0,0,0,0,0,2,0,0,0,0,0,0,0,0
486,792381,24,6,10,1,2,5,8,3,3,0,1,3,1,1,1,0,20
486,791839,19,3,6,3,5,0,1,6,7,3,7,3,1,0,1,1,12
486,786616,22,4,9,3,7,1,2,2,2,1,0,4,3,2,1,0,11
486,786736,21,3,7,0,2,3,5,0,0,2,4,3,1,1,2,0,9
486,776341,22,3,7,3,6,0,1,1,2,5,9,2,1,0,4,0,7
486,786613,17,5,7,4,5,1,2,3,6,1,4,2,3,0,3,0,14
486,785322,20,3,10,1,3,2,7,2,2,0,5,0,2,0,4,0,10
486,791842,17,3,5,2,3,1,2,2,2,0,4,0,3,0,3,0,9
486,797444,17,3,6,3,4,0,2,0,0,2,5,1,3,0,1,0,6
486,797442,15,1,5,0,2,1,3,0,0,1,2,1,2,0,0,0,3
486,791840,6,1,1,1,1,0,0,0,0,1,0,0,0,0,0,0,2
488,791964,30,4,5,4,5,0,0,1,1,0,7,6,3,3,1,0,9
488,781339,22,4,10,2,4,2,6,0,0,0,2,5,0,3,2,0,10
488,786054,15,7,9,7,8,0,1,0,0,2,3,1,0,2,0,0,14
488,792041,23,3,4,2,2,1,2,1,2,3,6,0,0,1,3,0,8
488,781337,18,6,10,5,6,1,4,3,3,0,3,4,0,1,0,0,16
488,797712,20,7,10,7,10,0,0,1,1,4,3,2,1,0,1,0,15
488,791966,19,5,7,5,7,0,0,2,3,3,2,0,0,0,0,0,12
488,791963,19,1,4,1,2,0,2,0,2,0,2,1,1,1,2,0,2
488,797713,24,8,10,8,9,0,1,1,3,5,6,0,2,2,2,0,17
488,797714,10,3,3,1,1,2,2,0,2,0,0,1,1,1,0,0,8
490,785770,31,7,12,6,8,1,4,9,9,1,2,5,2,4,3,0,24
490,781335,22,3,7,2,4,1,3,0,0,0,6,2,4,2,6,2,7
490,781341,32,6,8,2,2,4,6,6,6,0,6,4,4,1,2,0,22
490,785775,30,2,5,2,4,0,1,6,9,0,4,3,2,2,1,2,10
490,776351,28,4,10,4,7,0,3,1,1,2,3,1,0,1,1,0,9
490,785767,8,1,2,0,0,1,2,2,3,0,0,1,2,0,1,0,5
490,791283,16,0,1,0,0,0,1,2,4,1,5,0,1,0,1,0,2
490,791285,4,0,1,0,0,0,1,0,0,0,3,0,1,0,0,0,0
490,796542,21,4,5,4,5,0,0,1,2,3,2,1,0,0,1,0,9
490,796538,8,1,1,0,0,1,1,0,0,0,0,2,2,1,3,0,3
491,785938,22,1,5,0,2,1,3,0,0,1,1,2,1,1,5,0,3
491,785941,29,3,10,0,3,3,7,0,0,2,4,0,2,0,0,0,9
491,785939,27,2,10,2,9,0,1,0,2,1,2,4,3,3,5,0,4
491,785946,16,0,1,0,1,0,0,0,0,0,1,0,3,1,2,1,0
491,785948,28,5,8,5,8,0,0,2,3,1,8,0,5,1,2,1,12
491,785940,9,2,3,2,3,0,0,0,1,2,2,1,0,1,1,0,4
491,792023,9,4,9,0,3,4,6,0,0,1,0,0,3,1,0,0,12
491,792022,11,1,5,1,3,0,2,0,0,2,0,0,2,0,1,0,2
491,792025,19,4,4,4,4,0,0,0,1,1,2,0,2,0,1,1,8
491,792020,28,3,11,3,9,0,2,3,3,0,0,4,4,2,4,0,9
491,797634,2,0,0,0,0,0,0,0,0,0,0,0,0,0,0,0,0
492,786131,22,3,11,3,7,0,4,0,1,3,2,0,4,0,2,0,6
492,780904,36,8,12,8,12,0,0,0,5,2,6,0,3,0,3,1,16
492,797688,28,3,5,2,4,1,1,3,4,0,4,1,1,1,0,0,10
492,786145,30,3,6,2,4,1,2,0,0,0,2,3,2,0,1,0,7
492,786128,22,3,9,3,8,0,1,0,0,0,4,3,0,2,2,0,6
492,797686,23,2,3,2,2,0,1,2,2,0,0,4,4,1,2,0,6
492,792096,11,0,0,0,0,0,0,2,2,0,0,0,4,0,0,0,2
492,775251,24,4,8,1,4,3,4,1,2,1,4,0,5,1,5,0,12
492,792100,3,0,0,0,0,0,0,0,0,0,0,0,0,0,0,0,0
492,797684,1,0,0,0,0,0,0,0,0,0,0,0,0,0,0,0,0
493,781653,22,2,3,2,3,0,0,4,7,2,2,2,4,2,0,0,8
493,781652,29,7,11,7,7,0,4,4,6,3,9,2,1,0,0,1,18
493,786034,28,1,6,0,2,1,4,2,2,0,4,1,3,1,1,0,5
493,786419,25,2,5,2,4,0,1,4,4,0,3,2,3,0,5,1,8
493,781283,27,5,9,3,4,2,5,3,3,0,1,1,1,3,2,0,15
493,791614,9,1,2,1,1,0,1,0,0,0,1,1,1,0,1,0,2
493,781158,20,5,6,5,6,0,0,2,3,0,3,2,2,0,1,0,12
493,796993,15,1,4,0,0,1,4,0,0,0,0,1,2,0,0,0,3
493,791615,25,3,8,2,5,1,3,2,2,2,2,3,1,0,1,0,9
493,785419,0,0,0,0,0,0,0,0,0,0,0,0,0,0,0,0,0
493,796992,0,0,0,0,0,0,0,0,0,0,0,0,0,0,0,0,0
493,796991,0,0,0,0,0,0,0,0,0,0,0,0,0,0,0,0,0
493,796990,0,0,0,0,0,0,0,0,0,0,0,0,0,0,0,0,0
494,776018,17,1,2,1,2,0,0,2,4,2,1,1,5,0,1,0,4
494,797855,33,3,8,2,4,1,4,4,4,3,5,3,2,2,3,0,11
494,792208,27,1,2,1,2,0,0,7,10,1,5,3,5,0,1,1,9
494,792204,21,1,6,0,0,1,6,2,4,1,1,2,2,0,4,0,5
494,786983,2,0,0,0,0,0,0,0,0,0,0,0,1,0,0,0,0
494,797862,5,0,2,0,2,0,0,2,2,0,0,0,1,0,0,0,2
494,797859,14,0,2,0,1,0,1,0,2,1,0,0,0,0,1,1,0
494,797856,18,2,7,1,2,1,5,3,4,0,3,0,3,0,1,0,8
494,786682,4,1,1,0,0,1,1,0,0,0,0,0,0,1,0,0,3
494,786262,21,2,5,1,1,1,4,3,3,0,1,0,1,1,1,0,8
494,781317,6,0,0,0,0,0,0,0,1,0,1,0,0,0,1,0,0
494,781314,32,5,12,3,6,2,6,1,2,1,4,1,0,4,2,0,13
495,792227,21,0,0,0,0,0,0,0,2,1,5,3,2,0,1,1,0
495,781352,20,4,8,4,8,0,0,6,7,0,2,1,4,0,1,1,14
495,785935,35,7,13,5,9,2,4,2,3,1,1,2,2,2,5,0,18
495,781340,31,3,6,3,6,0,0,2,2,1,2,2,2,1,1,2,8
495,776128,23,1,3,1,2,0,1,2,4,0,3,2,3,0,2,0,4
495,797881,12,4,5,4,5,0,0,1,2,0,4,0,4,0,1,0,9
495,797889,8,1,2,1,2,0,0,2,2,1,1,1,2,0,1,0,4
495,781351,19,2,5,2,4,0,1,2,2,0,1,2,1,0,1,0,6
495,792223,14,4,6,0,2,4,4,0,0,0,4,1,4,2,0,0,12
495,792228,8,0,0,0,0,0,0,0,0,0,1,1,0,0,2,0,0
495,786453,9,0,0,0,0,0,0,0,0,0,2,0,1,0,0,0,0
496,785740,20,1,2,1,2,0,0,0,0,1,1,0,3,0,1,1,2
496,785809,21,3,5,2,2,1,3,0,0,1,2,1,5,0,3,1,7
496,780530,37,4,11,3,6,1,5,1,3,2,6,2,2,0,1,1,10
496,785738,37,8,19,6,12,2,7,0,0,0,4,4,3,2,3,0,18
496,781121,36,4,14,0,5,4,9,4,5,1,4,2,0,2,0,0,16
496,797396,11,0,0,0,0,0,0,0,0,1,1,0,2,0,1,0,0
496,785739,8,1,1,1,1,0,0,0,0,1,2,0,2,0,0,0,2
496,797402,9,0,0,0,0,0,0,0,0,1,1,0,0,0,1,0,0
496,797399,21,4,4,1,1,3,3,1,2,0,1,1,5,1,3,1,12
497,792486,27,3,9,3,7,0,2,1,2,2,7,1,1,1,1,0,7
497,785772,24,2,3,2,3,0,0,1,2,4,1,0,0,0,0,0,5
497,785778,19,3,5,3,4,0,1,2,2,1,1,0,1,0,0,0,8
497,785766,32,4,11,2,6,2,5,0,0,0,4,0,1,0,0,0,10
497,780543,31,8,14,8,12,0,2,10,10,1,2,0,2,3,2,0,26
497,792481,14,2,3,2,3,0,0,3,3,0,0,2,4,0,3,1,7
497,780546,13,1,2,1,1,0,1,2,2,0,2,1,1,0,0,0,4
497,797419,14,0,1,0,1,0,0,0,1,0,1,2,3,1,0,0,0
497,792482,20,2,5,0,1,2,4,0,0,0,4,0,0,1,0,0,6
497,792487,2,0,0,0,0,0,0,0,0,0,0,0,0,0,0,0,0
497,792489,4,0,0,0,0,0,0,0,0,0,2,0,0,0,0,0,0
498,797482,28,3,8,2,5,1,3,4,6,3,4,1,1,0,5,0,11
498,797485,27,1,5,1,4,0,1,6,6,1,2,1,1,1,1,0,8
498,797481,31,4,8,3,6,1,2,2,3,0,1,2,1,1,0,1,11
498,797480,12,3,5,3,5,0,0,0,0,0,2,0,4,0,2,0,6
498,785944,35,7,12,4,4,3,8,5,7,1,6,5,1,1,2,0,22
498,797484,1,1,1,1,1,0,0,0,0,1,0,0,0,0,0,0,2
498,797483,11,2,2,2,2,0,0,3,3,0,1,0,1,0,0,0,7
498,797478,22,4,6,3,5,1,1,0,0,0,1,0,2,4,1,0,9
498,791873,19,2,4,2,4,0,0,0,0,0,1,4,1,3,1,0,4
498,781217,14,1,3,0,0,1,3,0,0,1,1,0,0,0,1,0,3
500,791185,34,5,10,2,3,3,7,2,3,0,8,5,3,1,0,1,15
500,791187,33,10,19,10,19,0,0,3,5,4,4,2,3,0,1,2,23
500,796857,34,2,5,2,4,0,1,2,2,2,6,2,2,0,1,0,6
500,785650,33,2,4,1,1,1,3,0,1,0,3,5,2,0,1,1,5
500,785649,34,9,16,8,11,1,5,5,5,0,8,0,0,1,3,0,24
500,796859,20,3,4,1,2,2,2,1,2,0,2,4,1,1,1,1,9
500,793803,12,0,0,0,0,0,0,0,0,0,1,0,1,0,1,0,0
502,792232,19,5,7,3,4,2,3,0,0,1,7,5,2,1,2,1,12
502,785664,21,5,7,5,7,0,0,1,2,1,2,1,1,1,2,0,11
502,785841,32,2,5,2,4,0,1,9,10,0,3,4,3,1,3,0,13
502,796609,30,4,7,4,5,0,2,3,9,0,2,5,4,4,3,0,11
502,786685,25,4,7,3,5,1,2,5,6,0,3,1,4,1,1,0,14
502,796613,26,6,6,4,4,2,2,0,0,0,5,3,1,0,3,0,14
502,791312,6,0,0,0,0,0,0,0,0,0,1,0,1,0,0,1,0
502,785840,9,1,2,0,0,1,2,0,0,0,0,0,1,0,1,0,3
502,780728,7,0,0,0,0,0,0,0,0,0,2,0,3,0,0,1,0
502,796611,25,5,12,2,5,3,7,0,0,0,2,3,3,0,0,1,13
504,780043,40,3,5,2,2,1,3,2,2,1,3,4,2,0,2,2,9
504,792473,30,4,12,2,8,2,4,2,6,1,6,4,4,0,1,0,12
504,780036,24,1,2,1,1,0,1,2,4,0,2,1,5,0,4,0,4
504,780035,40,7,15,3,6,4,9,5,5,0,2,1,1,3,3,0,23
504,785249,39,4,9,1,3,3,6,2,2,1,9,3,3,2,1,0,13
504,799276,15,0,0,0,0,0,0,0,0,0,2,1,0,0,0,0,0
504,785251,7,0,3,0,2,0,1,0,0,0,1,0,2,0,2,0,0
504,792477,5,2,2,1,1,1,1,0,0,0,0,0,0,0,0,0,5
505,796837,36,2,7,1,3,1,4,4,6,3,9,1,3,2,2,0,9
505,791170,29,3,12,1,3,2,9,5,5,1,3,0,1,2,1,0,13
505,791171,18,2,4,2,4,0,0,0,0,1,4,0,4,0,1,0,4
505,785700,37,3,7,3,4,0,3,0,0,0,3,3,4,1,0,0,6
505,780269,35,8,18,5,10,3,8,3,4,0,2,2,0,1,2,0,22
505,796838,17,0,0,0,0,0,0,2,3,1,3,0,2,0,1,0,2
505,785706,13,1,4,1,2,0,2,0,0,0,0,0,1,0,0,0,2
505,796834,12,1,3,0,0,1,3,0,0,0,1,1,1,0,2,0,3
505,796833,3,0,0,0,0,0,0,0,0,0,0,0,0,0,1,0,0
506,775606,30,2,7,2,7,0,0,3,8,1,3,1,5,0,0,2,7
506,791674,41,3,9,3,6,0,3,5,7,0,4,4,1,2,5,0,11
506,780552,39,8,15,3,5,5,10,3,7,2,4,0,2,0,1,2,24
506,780550,29,4,8,3,6,1,2,3,4,2,1,2,4,0,3,0,12
506,780538,21,1,6,1,5,0,1,4,4,0,2,0,4,1,6,0,6
506,797424,14,1,1,1,1,0,0,0,0,0,3,0,0,0,2,0,2
506,785793,11,0,3,0,0,0,3,0,0,0,2,0,1,0,0,0,0
506,797423,10,0,0,0,0,0,0,1,2,0,1,1,3,0,1,0,1
506,791672,30,7,8,7,8,0,0,4,6,7,3,1,4,2,2,1,18
507,792140,31,6,11,6,11,0,0,4,4,3,3,2,5,0,3,3,16
507,792144,18,2,6,2,5,0,1,0,0,1,0,0,4,0,3,1,4
507,792148,38,4,10,4,5,0,5,3,4,1,3,1,2,2,2,0,11
507,781429,43,4,15,0,2,4,13,9,9,0,3,2,4,1,1,0,21
507,776092,36,5,10,4,6,1,4,4,4,1,5,7,5,2,4,0,15
507,792146,14,4,6,4,6,0,0,0,2,3,3,0,2,0,0,0,8
507,797786,15,0,2,0,1,0,1,1,2,1,1,0,3,2,2,0,1
507,797789,9,0,1,0,0,0,1,1,2,0,0,0,0,0,0,0,1
507,781431,21,2,4,2,3,0,1,2,2,0,3,0,1,1,0,0,6
508,792299,32,2,5,1,1,1,4,1,1,1,5,2,2,1,3,0,6
508,781220,17,2,4,2,4,0,0,0,0,0,1,1,1,1,1,2,4
508,792301,35,10,20,9,16,1,4,2,2,0,1,3,2,1,1,0,23
508,792304,35,5,10,4,7,1,3,2,2,1,5,2,2,3,4,0,13
508,786275,28,1,3,1,3,0,0,6,7,1,3,3,3,4,1,0,8
508,786286,20,1,2,0,0,1,2,0,0,0,4,1,1,1,0,0,3
508,786278,20,5,8,3,4,2,4,0,0,1,2,1,5,1,2,1,12
508,798092,10,0,2,0,1,0,1,0,0,0,0,2,1,0,1,0,0
508,792295,3,0,0,0,0,0,0,1,2,0,0,1,0,0,0,0,1
509,791425,31,6,13,6,13,0,0,2,4,6,4,2,2,0,1,2,14
509,791424,34,4,8,4,6,0,2,1,3,2,4,2,2,0,5,2,9
509,791421,38,7,16,3,6,4,10,0,0,1,5,1,3,1,6,0,18
509,797085,35,4,11,3,7,1,4,3,5,3,4,4,3,2,3,0,12
509,785899,31,1,4,0,0,1,4,0,0,0,1,0,4,0,1,0,3
509,785509,13,0,1,0,1,0,0,0,0,0,3,2,2,0,2,0,0
509,797087,13,1,2,0,0,1,2,0,0,1,1,2,0,0,1,0,3
509,797090,5,1,2,1,1,0,1,0,0,0,0,0,1,0,1,0,2
510,797895,24,4,8,4,8,0,0,4,5,4,6,1,3,3,0,2,12
510,789058,23,5,10,2,5,3,5,0,2,2,10,0,2,0,0,1,13
510,797898,27,6,15,6,13,0,2,3,5,0,2,3,1,3,1,1,15
510,792236,32,4,9,3,7,1,2,2,2,1,4,1,2,0,3,0,11
510,781374,28,3,10,2,7,1,3,5,6,1,6,3,1,2,4,0,12
510,792238,10,1,3,1,3,0,0,0,0,3,1,0,2,1,0,0,2
510,785818,6,1,1,1,1,0,0,0,0,0,1,0,2,0,1,0,2
510,785286,20,1,4,1,4,0,0,0,0,0,3,2,0,3,0,0,2
510,792240,5,0,1,0,0,0,1,0,0,0,0,0,0,0,0,0,0
510,792359,7,1,2,1,1,0,1,0,0,0,0,0,0,0,0,0,2
510,792237,18,4,9,3,5,1,4,0,0,0,2,2,0,0,2,0,9
511,791923,25,4,14,3,11,1,3,2,5,1,3,0,2,0,3,0,11
511,781122,9,1,2,1,2,0,0,0,0,0,2,0,2,0,0,0,2
511,791925,24,5,9,3,7,2,2,3,4,1,4,2,1,2,2,1,15
511,791926,28,6,15,3,6,3,9,0,0,0,4,3,2,0,4,0,15
511,781112,18,1,1,1,1,0,0,0,0,0,0,1,0,0,1,0,2
511,786529,13,1,2,1,2,0,0,0,0,2,7,1,3,0,0,1,2
511,797541,17,2,5,2,5,0,0,0,1,4,7,1,2,1,0,0,4
511,797542,15,4,7,3,4,1,3,0,0,0,0,0,0,1,2,0,9
511,791927,17,1,6,0,2,1,4,3,4,0,3,0,3,0,2,0,6
511,786858,16,0,2,0,1,0,1,0,0,0,2,2,1,0,2,0,0
511,786527,14,2,5,1,3,1,2,0,0,1,1,2,1,0,0,0,5
511,778952,4,0,2,0,1,0,1,0,0,0,0,0,1,0,0,0,0
512,797698,26,2,5,2,3,0,2,1,1,0,5,2,1,1,2,0,5
512,780844,26,9,13,4,6,5,7,2,2,2,4,0,4,1,1,1,25
512,797699,34,8,12,7,9,1,3,3,5,0,4,8,1,2,2,1,20
512,797694,35,6,15,0,0,6,15,1,1,1,7,2,1,2,0,0,19
512,780846,32,3,8,3,7,0,1,4,4,1,6,8,2,1,3,0,10
512,782128,12,1,3,0,0,1,3,2,2,0,3,1,0,0,0,0,5
512,797696,8,4,5,4,5,0,0,1,2,2,1,0,1,0,1,0,9
512,797693,1,0,0,0,0,0,0,0,0,0,0,0,0,0,0,0,0
512,797692,26,2,6,2,2,0,4,0,0,0,3,3,1,1,1,0,4
513,799135,2,0,0,0,0,0,0,0,0,0,0,0,3,0,1,0,0
513,799129,34,5,13,3,8,2,5,1,1,0,3,0,5,1,3,0,13
513,799130,35,10,21,6,12,4,9,0,1,1,6,1,0,1,1,0,24
513,799133,31,2,8,0,4,2,4,1,2,2,7,0,3,1,5,0,7
513,792634,31,3,13,3,8,0,5,0,2,3,3,2,1,1,4,0,6
513,799136,7,0,0,0,0,0,0,0,0,1,0,0,0,0,0,0,0
513,799131,5,0,0,0,0,0,0,0,0,0,3,0,2,0,1,0,0
513,799132,33,2,7,2,4,0,3,0,0,1,4,1,3,0,1,1,4
513,799134,22,3,6,2,3,1,3,0,0,0,2,2,3,1,0,0,7
514,792340,21,3,4,2,2,1,2,0,0,1,3,0,4,2,0,1,7
514,792342,34,1,7,1,5,0,2,6,8,0,3,3,3,2,2,0,8
514,792346,33,5,9,5,8,0,1,0,0,1,3,5,4,4,5,0,10
514,781553,38,7,12,6,10,1,2,0,3,3,5,1,3,1,1,1,15
514,781552,30,5,12,4,9,1,3,5,8,0,2,2,5,2,4,0,16
514,798076,1,0,0,0,0,0,0,0,0,0,0,0,0,0,0,0,0
514,790887,16,2,4,1,2,1,2,3,4,0,3,0,1,0,3,0,8
514,798086,6,0,2,0,1,0,1,0,0,0,0,2,2,0,0,0,0
514,792344,7,0,0,0,0,0,0,0,0,0,2,0,1,1,1,0,0
514,792341,14,1,2,1,2,0,0,0,0,0,0,0,2,1,1,0,2
515,797331,10,0,2,0,1,0,1,0,0,0,0,0,4,0,1,0,0
515,775913,25,2,4,2,4,0,0,6,6,1,6,0,3,0,1,0,10
515,791737,20,2,3,2,2,0,1,4,4,0,1,0,5,1,4,0,8
515,783524,35,5,9,2,3,3,6,5,11,1,2,4,1,0,4,0,18
515,786223,32,3,5,0,0,3,5,5,8,0,7,1,4,2,1,2,14
515,797332,14,0,0,0,0,0,0,0,1,1,3,2,2,0,0,1,0
515,797333,5,0,0,0,0,0,0,0,0,0,0,0,1,1,2,0,0
515,786220,27,2,6,2,5,0,1,0,3,0,3,3,0,4,1,0,4
515,780561,32,6,12,2,3,4,9,1,2,0,6,2,2,3,2,2,17
516,785536,34,3,4,3,3,0,1,0,0,2,14,2,2,0,2,6,6
516,780119,36,7,13,5,10,2,3,2,6,3,3,1,2,3,2,1,18
516,776097,26,1,5,1,5,0,0,0,0,2,2,2,4,1,3,0,2
516,796559,29,2,9,1,5,1,4,6,6,1,1,1,1,3,1,1,11
516,785280,36,4,7,3,4,1,3,5,8,0,3,1,2,1,5,0,14
516,796561,6,0,1,0,0,0,1,2,2,0,0,0,1,0,0,0,2
516,780149,24,6,14,4,6,2,8,2,4,2,4,3,2,1,3,0,16
516,775679,9,0,2,0,0,0,2,0,0,0,0,0,0,0,0,0,0
517,791883,17,4,8,4,7,0,1,0,0,0,3,1,2,0,3,0,8
517,781066,28,5,10,5,9,0,1,0,0,1,6,2,3,0,3,1,10
517,797594,30,2,6,2,4,0,2,4,4,1,6,1,1,0,2,1,8
517,791884,30,1,4,1,4,0,0,3,4,1,2,4,3,1,2,0,5
517,780695,33,2,12,1,7,1,5,0,0,2,3,1,0,0,1,0,5
517,786497,8,0,2,0,2,0,0,0,0,1,1,0,2,0,1,0,0
517,797600,15,4,7,3,6,1,1,3,3,2,2,0,2,3,0,0,12
517,791885,16,3,6,3,5,0,1,0,0,0,2,1,0,0,1,0,6
517,797596,22,0,3,0,1,0,2,0,2,2,0,0,4,1,3,0,0
517,786496,1,0,0,0,0,0,0,0,0,0,0,0,0,0,0,0,0
518,780105,25,3,6,3,3,0,3,0,0,1,2,2,5,0,1,1,6
518,785914,5,0,1,0,0,0,1,1,4,0,1,1,0,0,0,0,1
518,785894,37,6,10,2,5,4,5,7,9,0,4,1,2,1,4,1,23
518,785915,31,1,4,0,0,1,4,0,0,1,5,2,3,2,3,2,3
518,791409,22,3,6,2,5,1,1,0,0,1,3,1,2,1,2,2,7
518,791408,33,6,11,6,11,0,0,5,5,6,7,1,0,0,4,0,17
518,781131,28,1,13,1,12,0,1,3,5,0,8,6,3,0,5,0,5
518,786183,15,4,8,3,7,1,1,1,2,1,1,2,4,0,0,0,10
518,780106,4,1,1,1,1,0,0,0,0,1,1,0,1,0,0,1,2
519,791103,18,0,3,0,0,0,3,2,3,1,1,0,3,0,0,1,2
519,796758,29,5,13,5,12,0,1,2,2,1,3,0,2,5,1,0,12
519,791101,28,5,14,5,11,0,3,5,8,3,5,0,3,1,0,0,15
519,791105,29,2,8,2,5,0,3,2,4,1,7,3,2,2,3,0,6
519,780794,20,2,7,2,3,0,4,0,0,0,0,0,1,2,2,0,4
519,796757,24,7,12,5,9,2,3,3,4,0,2,2,3,3,1,1,19
519,796759,17,3,3,3,3,0,0,1,3,2,2,0,3,1,0,3,7
519,780109,16,2,5,2,4,0,1,3,4,1,1,1,3,1,0,0,7
519,785597,12,0,2,0,2,0,0,0,0,0,0,1,1,1,0,0,0
519,775124,7,0,0,0,0,0,0,0,0,0,0,0,1,0,0,0,0
520,786542,30,5,7,4,6,1,1,2,3,0,5,0,2,0,1,0,13
520,786540,17,3,5,3,5,0,0,1,3,0,6,1,4,0,3,1,7
520,792019,35,7,15,4,7,3,8,2,2,3,2,2,2,0,2,0,19
520,792015,33,9,15,9,15,0,0,6,8,1,3,6,0,1,0,0,24
520,775995,27,1,5,1,4,0,1,2,2,2,1,4,5,0,1,0,4
520,785364,22,2,7,2,7,0,0,0,0,4,1,1,1,0,0,0,4
520,781147,12,1,1,1,1,0,0,0,0,0,1,1,1,2,0,0,2
520,797515,6,1,3,1,1,0,2,0,0,0,0,1,1,0,0,0,2
520,792016,18,3,6,0,2,3,4,2,2,0,3,4,0,3,0,0,11
521,792110,12,0,1,0,0,0,1,0,0,0,1,0,3,0,1,0,0
521,786031,28,4,11,3,7,1,4,0,1,1,9,1,2,0,1,0,9
521,797734,30,3,11,3,8,0,3,7,8,0,2,4,4,0,4,0,13
521,797735,35,6,9,0,2,6,7,1,2,1,2,2,5,1,1,1,19
521,781386,35,5,9,3,5,2,4,4,5,1,2,10,1,2,3,0,16
521,786033,28,4,5,4,5,0,0,0,0,1,6,0,1,1,0,3,8
521,797733,16,1,1,0,0,1,1,0,0,0,1,1,3,0,4,0,3
521,792109,4,2,2,1,1,1,1,0,1,0,1,0,2,0,0,0,5
521,792105,12,2,4,1,1,1,3,0,0,0,0,0,0,0,1,0,5
522,790884,15,0,1,0,1,0,0,5,6,0,5,2,4,0,1,4,5
522,796436,27,7,12,6,10,1,2,5,5,2,2,4,3,2,2,2,20
522,790885,19,1,6,0,2,1,4,1,2,2,3,0,2,0,0,0,4
522,785436,22,2,4,1,2,1,2,3,4,3,3,4,3,0,1,0,8
522,781262,22,3,5,0,0,3,5,2,3,0,4,0,1,0,0,0,11
522,790883,26,3,9,2,6,1,3,2,3,0,3,2,1,0,2,0,9
522,796439,21,3,8,3,8,0,0,1,2,2,1,2,4,2,3,0,7
522,796438,24,7,12,4,5,3,7,2,2,1,2,0,0,0,1,0,19
522,791635,3,0,0,0,0,0,0,0,0,0,0,0,1,0,0,1,0
522,796442,8,1,2,1,2,0,0,0,0,0,1,0,0,0,0,0,2
522,796437,13,0,2,0,1,0,1,0,0,0,0,0,1,1,0,1,0
523,792399,22,3,11,2,8,1,3,0,0,0,3,1,2,0,1,0,7
523,785471,22,6,10,6,9,0,1,1,1,0,4,3,3,0,2,1,13
523,780263,32,6,16,4,10,2,6,4,5,0,2,1,3,2,0,1,18
523,786697,18,0,1,0,1,0,0,0,0,0,0,2,4,1,0,0,0
523,775628,30,6,10,6,9,0,1,1,2,2,5,4,1,1,2,0,13
523,799000,22,4,8,4,8,0,0,2,4,4,5,2,3,2,3,1,10
523,775198,22,0,3,0,2,0,1,1,2,2,3,0,1,0,1,0,1
523,780571,9,0,4,0,3,0,1,0,0,0,0,0,0,0,0,0,0
523,775547,12,1,3,1,2,0,1,1,4,1,1,0,2,0,1,0,3
523,792400,5,0,0,0,0,0,0,0,0,0,0,0,1,0,0,0,0
523,786695,3,0,1,0,0,0,1,0,0,0,0,0,0,0,0,0,0
523,792397,3,0,1,0,1,0,0,0,3,0,1,0,0,0,0,0,0
524,786544,26,5,9,4,8,1,1,7,8,0,11,3,3,0,1,1,18
524,775084,22,6,9,4,4,2,5,3,3,0,1,2,1,0,2,0,17
524,797507,26,2,4,1,2,1,2,1,3,1,2,3,2,2,2,0,6
524,786547,18,1,2,0,0,1,2,0,0,0,2,1,4,0,0,0,3
524,792012,27,6,12,3,5,3,7,2,3,0,2,4,4,3,1,1,17
524,786546,19,1,3,1,1,0,2,3,3,0,2,3,3,1,1,0,5
524,787622,4,3,3,0,0,3,3,0,0,0,0,0,0,0,0,0,9
524,797509,17,0,2,0,2,0,0,2,2,2,5,0,2,0,1,3,2
524,786860,16,4,6,2,2,2,4,0,0,1,3,0,1,0,1,0,10
524,797510,15,1,4,1,2,0,2,0,0,0,2,1,0,0,1,0,2
524,797511,4,0,2,0,1,0,1,0,0,0,1,1,0,0,0,0,0
524,792013,6,2,2,2,2,0,0,0,1,0,0,1,0,1,3,0,4
526,781493,40,7,14,5,9,2,5,1,1,0,2,1,4,0,3,0,17
526,780333,43,8,14,4,7,4,7,5,8,0,3,4,4,2,2,0,25
526,780342,38,1,6,1,3,0,3,0,1,0,6,2,4,0,0,0,2
526,791981,41,5,15,5,12,0,3,4,4,4,5,2,3,0,2,1,14
526,791982,39,2,8,1,3,1,5,2,3,0,4,1,5,0,1,0,7
526,786755,4,0,0,0,0,0,0,0,0,0,0,0,2,0,0,1,0
526,786756,18,3,4,1,2,2,2,0,0,2,3,1,1,0,0,1,8
526,791984,2,0,0,0,0,0,0,0,0,0,0,0,0,0,0,1,0
527,790902,13,1,3,0,1,1,2,2,2,0,1,0,0,0,0,0,5
527,781342,39,9,14,8,13,1,1,4,7,2,6,1,2,0,3,2,23
527,785452,44,3,6,3,6,0,0,2,2,2,11,5,1,0,2,0,8
527,781593,39,3,3,1,1,2,2,4,6,1,5,1,4,2,4,0,12
527,781620,22,3,8,1,4,2,4,0,0,1,2,3,5,0,1,0,8
527,790901,30,7,12,3,6,4,6,2,2,0,1,1,2,0,0,0,20
527,774864,25,1,8,1,5,0,3,3,4,2,1,3,5,0,3,0,5
527,774835,7,0,1,0,1,0,0,0,0,0,1,0,0,0,0,0,0
527,796449,6,0,2,0,0,0,2,0,0,0,0,0,0,0,0,0,0
528,776279,20,3,4,3,3,0,1,0,0,0,0,1,3,0,1,1,6
528,781505,20,4,10,4,9,0,1,4,4,4,0,5,0,0,0,1,12
528,780353,20,10,12,10,11,0,1,0,1,1,8,1,1,0,0,1,20
528,791317,12,1,2,0,0,1,2,0,0,0,1,5,4,0,0,0,3
528,777573,16,3,6,3,4,0,2,0,2,0,2,2,1,0,0,0,6
528,791318,11,0,1,0,0,0,1,0,0,1,3,0,1,0,0,2,0
528,791319,2,0,0,0,0,0,0,0,0,1,0,0,0,0,0,0,0
528,788965,2,0,0,0,0,0,0,0,0,0,0,0,0,0,0,0,0
528,786222,19,4,8,4,7,0,1,1,2,3,5,3,4,2,1,0,9
528,785966,6,1,2,1,2,0,0,0,0,0,0,0,3,0,0,0,2
528,796646,5,0,2,0,1,0,1,1,2,1,1,0,1,0,0,0,1
528,796647,8,2,3,1,2,1,1,2,2,0,1,0,0,1,0,0,7
528,796649,23,4,5,1,1,3,4,0,0,0,3,1,3,0,0,0,11
528,790851,18,4,6,4,6,0,0,1,3,2,1,3,0,1,0,0,9
528,796648,18,3,8,3,7,0,1,2,2,0,2,3,0,3,2,0,8
530,790893,24,1,7,1,6,0,1,4,8,7,6,3,3,0,3,2,6
530,796444,32,3,4,3,4,0,0,5,9,2,5,2,2,1,1,1,11
530,790890,26,3,5,1,2,2,3,1,2,0,1,5,2,0,3,1,9
530,786615,23,3,4,1,1,2,3,5,6,0,0,2,2,0,3,0,13
530,775260,23,1,3,0,1,1,2,1,2,0,2,2,3,0,0,0,4
530,786732,14,1,1,1,1,0,0,8,10,0,1,0,5,0,1,0,10
530,775536,18,4,8,4,8,0,0,0,0,1,6,2,3,0,2,0,8
530,790889,21,3,7,3,5,0,2,0,2,0,6,1,2,0,2,0,6
530,780702,14,1,3,0,0,1,3,0,0,1,2,0,1,0,0,1,3
530,796445,5,3,4,3,4,0,0,0,0,1,0,0,1,0,1,0,6
531,797281,35,5,11,4,10,1,1,2,4,1,3,0,5,1,2,0,13
531,791647,15,1,2,1,2,0,0,3,4,0,1,0,4,0,2,0,5
531,786195,22,3,8,3,8,0,0,1,3,2,0,0,3,0,2,0,7
531,786640,21,2,7,2,7,0,0,0,0,0,1,2,4,2,0,0,4
531,785697,11,1,3,0,1,1,2,0,0,1,0,0,1,0,2,0,3
531,791648,26,4,10,3,8,1,2,2,6,4,3,0,4,0,1,0,11
531,791649,15,0,2,0,0,0,2,0,0,1,3,2,3,1,0,0,0
531,797280,34,4,10,3,7,1,3,8,9,1,0,3,1,0,0,0,17
531,775442,18,1,9,1,2,0,7,0,0,1,0,1,1,2,2,0,2
531,785694,3,0,0,0,0,0,0,0,0,0,0,0,3,0,1,1,0
531,785695,0,0,0,0,0,0,0,0,0,0,0,0,0,0,0,0,0
532,780505,35,3,16,1,10,2,6,3,4,0,4,1,2,0,2,0,11
532,792280,29,7,13,4,9,3,4,2,2,1,7,3,0,4,2,0,19
532,785950,25,2,6,1,2,1,4,1,3,2,3,1,2,0,0,1,6
532,792283,20,0,3,0,1,0,2,0,0,2,3,1,3,1,1,0,0
532,797823,10,4,5,3,4,1,1,1,1,1,3,0,5,2,1,1,10
532,797831,31,2,9,0,3,2,6,0,0,2,4,3,0,0,3,0,6
532,792284,6,0,3,0,0,0,3,0,0,0,0,1,0,0,1,0,0
532,797826,16,4,5,3,4,1,1,0,0,2,4,3,4,0,1,0,9
532,792287,9,2,2,2,2,0,0,0,0,0,0,0,3,0,0,0,4
532,792286,7,1,1,1,1,0,0,0,0,0,1,0,0,0,0,0,2
532,799468,12,2,5,2,2,0,3,0,0,0,1,2,1,0,1,0,4
533,776205,22,4,10,2,4,2,6,2,2,0,3,3,4,0,5,0,12
533,781237,40,2,7,0,1,2,6,2,3,2,3,2,1,0,4,0,8
533,781243,38,5,10,3,4,2,6,2,3,2,6,2,4,0,3,0,14
533,791241,38,6,16,5,11,1,5,3,5,1,7,1,2,3,1,0,16
533,781244,34,7,12,5,7,2,5,1,1,1,8,3,3,0,0,1,17
533,785537,28,0,3,0,2,0,1,1,2,0,1,3,1,1,1,0,1
538,792277,12,1,4,1,4,0,0,1,1,1,1,0,0,1,2,0,3
538,785282,29,4,10,2,4,2,6,1,6,0,2,0,2,0,0,0,11
538,781464,19,0,4,0,1,0,3,0,0,1,1,2,1,0,3,0,0
538,781502,31,3,6,3,5,0,1,5,6,2,5,2,4,2,4,0,11
538,780259,29,4,10,2,5,2,5,4,5,1,2,1,3,0,5,1,14
538,785913,26,4,6,4,6,0,0,0,0,1,3,0,1,1,3,0,8
538,781501,29,2,3,2,3,0,0,1,2,1,2,4,0,3,3,0,5
538,786516,11,0,2,0,0,0,2,0,0,0,1,0,0,0,0,0,0
538,798058,14,3,7,3,7,0,0,0,0,0,2,1,0,1,3,0,6
539,785458,18,1,7,1,6,0,1,0,0,0,1,1,0,1,5,0,2
539,785457,28,2,4,2,3,0,1,0,2,2,7,0,3,0,3,1,4
539,780798,32,5,10,4,5,1,5,0,0,3,6,1,1,2,4,1,11
539,785455,31,7,15,3,7,4,8,2,3,1,1,4,2,2,2,0,20
539,785453,31,5,8,1,1,4,7,3,4,0,3,2,1,0,1,0,17
539,790913,11,2,3,2,3,0,0,0,0,0,2,0,0,0,2,0,4
539,790914,7,1,1,1,1,0,0,1,2,0,1,0,3,2,1,0,3
539,790915,9,0,1,0,1,0,0,0,0,1,2,0,3,0,2,0,0
539,785454,24,3,4,3,4,0,0,2,2,0,1,2,1,4,2,0,8
539,774940,9,0,1,0,0,0,1,0,0,0,0,3,3,2,2,0,0
540,797221,15,2,3,2,3,0,0,0,0,2,4,0,2,1,2,0,4
540,781526,38,5,13,5,13,0,0,7,11,4,7,0,3,0,5,1,17
540,797219,35,5,10,5,8,0,2,5,9,1,5,1,2,1,4,0,15
540,797217,36,0,3,0,1,0,2,2,2,0,3,2,1,0,3,0,2
540,797218,38,8,20,8,17,0,3,4,6,5,5,2,2,1,2,0,20
540,797223,2,0,0,0,0,0,0,0,0,0,0,0,3,0,1,0,0
540,797222,25,2,8,2,7,0,1,2,5,7,7,0,1,0,3,2,6
540,775697,9,0,4,0,2,0,2,0,0,1,0,0,1,1,0,0,0
540,791846,2,0,0,0,0,0,0,0,0,0,1,0,0,0,1,0,0
541,791837,26,4,8,3,5,1,3,2,2,0,4,0,3,0,1,1,11
541,780613,36,8,13,8,13,0,0,2,5,2,4,1,3,1,4,0,18
541,775097,20,4,9,3,8,1,1,4,4,2,5,5,4,1,1,0,13
541,780609,36,3,13,3,5,0,8,0,0,0,4,6,3,5,1,0,6
541,776395,39,6,19,3,9,3,10,3,3,1,2,2,2,3,2,0,18
541,797437,5,0,0,0,0,0,0,0,0,0,0,0,1,0,0,0,0
541,786622,17,3,3,2,2,1,1,0,0,0,3,1,0,0,0,0,7
541,786619,7,0,0,0,0,0,0,0,0,0,0,0,3,0,1,1,0
541,786621,14,1,2,0,0,1,2,0,0,0,1,0,5,0,0,0,3
542,785228,26,5,6,2,2,3,4,0,0,0,5,2,3,0,2,0,13
542,791582,7,1,2,1,2,0,0,0,0,0,0,0,1,0,1,0,2
542,786395,32,6,9,5,5,1,4,2,2,0,2,2,0,1,2,0,15
542,786394,32,5,11,5,9,0,2,2,2,1,3,1,1,2,0,0,12
542,780404,27,3,5,3,4,0,1,4,4,0,4,4,2,1,0,2,10
542,780062,19,2,2,2,2,0,0,0,0,0,4,1,4,0,1,2,4
542,791585,29,7,10,6,7,1,3,2,2,3,2,2,1,0,2,1,17
542,797041,11,0,2,0,1,0,1,0,0,0,1,1,1,0,0,0,0
542,791581,17,2,5,0,1,2,4,0,0,1,1,1,2,0,2,0,6
543,785740,30,8,9,8,9,0,0,2,2,3,6,0,1,1,1,1,18
543,785809,30,1,7,0,5,1,2,0,0,0,3,2,4,1,1,0,3
543,780530,37,4,7,3,6,1,1,1,2,2,2,1,1,0,1,1,10
543,785738,34,4,10,3,7,1,3,0,0,0,0,7,0,0,2,0,9
543,781121,34,5,13,0,4,5,9,4,5,0,1,1,3,0,2,0,19
543,797399,18,0,3,0,0,0,3,0,0,1,1,1,2,0,1,0,0
543,797402,9,0,1,0,0,0,1,2,2,0,0,1,1,1,0,0,2
543,797396,6,0,0,0,0,0,0,0,0,0,0,0,0,0,0,0,0
543,797400,1,0,1,0,1,0,0,0,0,0,0,0,0,0,0,0,0
543,785739,1,0,0,0,0,0,0,0,0,0,0,0,0,0,0,0,0
544,791686,30,4,12,3,7,1,5,0,1,1,6,2,4,1,2,2,9
544,792269,13,0,0,0,0,0,0,0,0,0,1,0,2,2,1,0,0
544,798028,32,3,6,3,5,0,1,5,6,1,4,3,3,2,2,1,11
544,790940,39,6,13,2,4,4,9,0,0,3,1,3,0,1,1,0,16
544,780770,38,6,13,4,7,2,6,2,2,1,2,6,2,1,3,0,16
544,798022,3,0,3,0,0,0,3,0,0,0,0,0,1,0,1,0,0
544,792271,5,1,2,1,1,0,1,0,0,0,0,0,1,0,0,0,2
544,792270,34,4,6,2,3,2,3,2,5,3,5,2,3,0,0,1,12
544,792305,6,1,1,1,1,0,0,0,0,0,1,0,1,0,0,0,2
545,780229,36,6,11,6,11,0,0,1,1,3,6,7,2,0,2,1,13
545,795572,33,6,12,4,8,2,4,4,4,3,4,0,3,2,2,0,18
545,786323,11,1,1,1,1,0,0,0,0,0,0,0,1,0,2,0,2
545,786322,24,2,3,2,3,0,0,4,5,0,1,2,1,1,2,0,8
545,780228,37,5,11,1,1,4,10,4,5,1,2,2,1,0,2,0,18
545,781592,24,2,5,2,4,0,1,3,4,0,4,1,1,0,0,0,7
545,791488,24,0,5,0,3,0,2,0,0,0,3,2,2,0,1,0,0
545,791485,10,0,2,0,0,0,2,0,0,0,1,0,3,0,0,0,0
545,791484,1,0,1,0,0,0,1,0,0,0,0,0,0,0,0,0,0
546,791302,18,2,6,2,2,0,4,0,0,0,1,2,4,2,2,1,4
546,781622,20,1,3,0,0,1,3,2,2,1,1,1,2,0,0,0,5
546,791309,35,5,13,5,9,0,4,2,4,1,3,12,4,3,6,0,12
546,785835,24,9,10,8,9,1,1,2,4,4,6,0,0,0,1,0,21
546,776334,28,2,6,0,2,2,4,0,0,0,3,5,1,1,2,0,6
546,796602,13,2,4,2,4,0,0,1,2,1,0,0,1,0,1,0,5
546,775862,23,6,8,6,7,0,1,10,11,4,0,0,2,2,2,1,22
546,791308,7,0,2,0,0,0,2,0,0,0,3,0,1,0,0,0,0
546,791301,17,2,8,1,5,1,3,3,3,2,3,0,3,0,0,0,8
546,796604,5,0,0,0,0,0,0,0,0,0,1,0,0,0,0,0,0
546,796603,6,1,2,1,2,0,0,0,0,0,0,0,0,0,1,0,2
546,791304,1,0,0,0,0,0,0,0,0,0,0,0,0,0,0,0,0
546,796605,3,0,0,0,0,0,0,0,0,0,0,0,0,0,0,0,0
547,781656,31,7,7,7,7,0,0,1,2,1,3,2,4,0,1,0,15
547,781658,31,6,12,6,12,0,0,2,2,1,1,1,4,1,1,0,14
547,796962,27,3,8,3,3,0,5,3,3,0,2,4,2,1,2,0,9
547,786798,38,9,13,9,13,0,0,3,8,3,6,3,1,3,2,0,21
547,780129,34,5,12,3,7,2,5,2,2,0,3,2,2,2,3,0,14
547,791264,10,0,3,0,1,0,2,0,0,1,0,1,2,0,2,0,0
547,798206,15,0,1,0,0,0,1,0,0,0,2,0,4,1,1,1,0
547,796964,8,0,2,0,2,0,0,0,0,0,2,0,0,0,2,0,0
547,790256,3,1,1,1,1,0,0,0,0,1,0,0,1,0,0,0,2
547,796965,1,0,0,0,0,0,0,0,0,0,0,0,0,0,0,0,0
547,796961,2,0,0,0,0,0,0,0,0,0,0,0,0,0,0,0,0
548,780043,36,4,8,4,6,0,2,1,2,1,3,1,5,1,2,0,9
548,792473,25,4,8,3,5,1,3,0,0,2,4,1,4,1,4,0,9
548,785249,34,2,5,1,3,1,2,0,0,0,3,2,2,0,1,0,5
548,780035,38,0,2,0,0,0,2,4,4,0,3,1,0,0,3,0,4
548,780036,13,1,6,0,2,1,4,0,0,0,1,0,1,0,2,0,3
548,799276,31,4,8,1,3,3,5,0,0,1,4,2,2,0,2,0,11
548,785251,16,1,2,1,1,0,1,2,2,0,0,1,0,0,0,0,4
548,792477,5,0,0,0,0,0,0,0,0,0,0,1,1,0,1,0,0
548,799281,2,0,1,0,0,0,1,0,0,0,0,0,0,0,0,0,0
549,786236,37,6,13,5,9,1,4,0,0,0,1,3,2,0,1,1,13
549,780759,32,4,13,0,4,4,9,0,0,0,4,5,2,2,2,0,12
549,786233,28,4,10,0,1,4,9,0,0,0,4,0,1,0,1,0,12
549,797329,37,5,7,4,5,1,2,0,0,3,3,0,4,1,0,2,11
549,797325,26,1,3,1,3,0,0,1,2,2,3,3,4,0,1,0,3
549,797323,29,4,10,3,6,1,4,3,4,0,2,5,0,1,0,0,12
549,797322,4,0,1,0,0,0,1,0,0,1,1,0,0,0,0,0,0
549,797324,4,0,0,0,0,0,0,0,0,0,0,0,0,0,0,0,0
549,786246,3,0,0,0,0,0,0,0,0,0,0,0,0,0,0,0,0
550,786578,10,0,5,0,3,0,2,0,0,2,1,1,1,0,0,1,0
550,781145,10,1,1,1,1,0,0,0,0,0,1,0,1,0,0,0,2
550,797358,15,1,6,0,1,1,5,2,4,0,2,0,3,1,1,0,5
550,776236,29,2,5,2,3,0,2,0,0,0,3,2,4,3,2,0,4
550,785669,30,1,10,0,3,1,7,0,0,0,3,3,3,0,3,0,3
550,785416,33,10,14,10,14,0,0,2,3,3,7,2,1,2,4,0,22
550,797357,6,0,0,0,0,0,0,0,0,0,0,1,0,0,1,0,0
550,786138,23,5,16,5,12,0,4,6,6,0,1,1,2,1,1,0,16
550,786136,22,8,9,6,7,2,2,3,5,2,5,0,2,0,2,0,21
550,775195,18,1,4,0,2,1,2,0,0,0,1,3,0,2,0,0,3
550,786140,4,0,0,0,0,0,0,0,0,0,0,0,1,0,0,0,0
550,791365,0,0,0,0,0,0,0,0,0,0,0,0,0,0,0,0,0
551,791988,28,13,17,13,17,0,0,2,2,2,5,1,3,0,3,1,28
551,792443,20,0,1,0,1,0,0,1,2,2,2,2,2,0,2,2,1
551,791987,36,3,8,2,5,1,3,2,4,0,6,10,1,0,2,0,9
551,791989,34,7,15,5,9,2,6,2,2,2,6,0,0,3,1,1,18
551,796507,11,0,2,0,0,0,2,0,0,0,2,1,5,1,5,0,0
551,785292,19,3,5,1,1,2,4,2,2,0,1,3,4,1,1,0,10
551,780076,20,1,2,0,0,1,2,0,0,0,2,3,1,0,2,1,3
551,796509,24,3,6,3,3,0,3,1,4,0,4,1,2,1,2,1,7
551,791991,3,0,1,0,1,0,0,0,0,0,0,0,0,0,0,1,0
551,796506,3,1,1,1,1,0,0,0,0,1,0,0,1,0,0,0,2
551,785258,2,0,0,0,0,0,0,0,0,0,0,0,0,0,0,0,0
552,797290,34,4,11,3,7,1,4,5,7,1,11,4,1,0,4,0,14
552,797291,26,1,4,1,3,0,1,1,1,0,1,1,3,0,2,0,3
552,780509,20,2,4,1,3,1,1,0,0,2,0,1,4,0,1,1,5
552,797292,28,11,17,11,17,0,0,3,6,7,5,0,2,0,3,5,25
552,791660,32,2,5,1,3,1,2,3,4,0,4,3,4,1,1,3,8
552,786064,25,2,8,0,2,2,6,0,0,2,4,1,4,1,2,0,6
552,791661,21,2,5,2,3,0,2,1,2,0,3,1,2,0,2,0,5
552,791663,1,0,0,0,0,0,0,0,0,0,0,0,0,0,0,0,0
552,791658,11,1,2,1,2,0,0,1,2,1,0,0,1,0,0,0,3
552,797295,2,0,0,0,0,0,0,0,0,0,0,0,0,0,0,0,0
553,790969,36,6,12,5,9,1,3,9,9,0,1,0,0,0,3,0,22
553,775107,32,5,9,4,7,1,2,3,8,1,0,1,3,0,0,0,14
553,796568,23,3,5,2,4,1,1,0,0,0,3,1,5,2,1,0,7
553,780166,34,1,5,1,3,0,2,4,4,0,2,4,1,1,2,1,6
553,790971,18,1,5,1,5,0,0,2,2,0,1,0,1,3,0,0,4
553,796563,5,0,0,0,0,0,0,0,0,0,0,0,0,0,0,0,0
553,790968,11,0,2,0,0,0,2,0,0,0,2,0,0,0,1,0,0
553,790967,3,0,0,0,0,0,0,0,0,0,0,0,0,0,0,0,0
553,781380,12,0,2,0,2,0,0,0,0,0,5,0,1,0,0,2,0
553,796565,3,1,1,0,0,1,1,0,0,0,0,0,0,0,0,0,3
553,796566,19,2,5,2,4,0,1,1,2,1,5,0,4,1,1,0,5
553,796569,4,0,0,0,0,0,0,0,0,0,0,0,0,0,1,0,0
554,796344,21,6,9,2,3,4,6,5,7,2,3,3,3,0,3,0,21
554,790781,21,3,6,3,6,0,0,1,4,3,1,2,2,0,0,3,7
554,785239,15,2,3,1,1,1,2,0,0,0,2,1,1,1,0,0,5
554,796340,22,8,11,7,8,1,3,0,1,0,6,1,3,0,0,0,17
554,780037,20,4,7,2,4,2,3,6,7,0,1,4,1,1,0,0,16
554,780040,16,6,9,6,8,0,1,1,1,1,2,1,1,2,3,0,13
554,796339,22,4,7,1,3,3,4,2,2,0,0,4,1,4,3,0,13
554,781232,18,1,5,0,1,1,4,0,0,0,3,3,1,1,0,0,3
554,790780,10,1,5,1,3,0,2,0,0,0,1,1,1,0,1,0,2
554,796343,15,1,2,1,2,0,0,0,0,1,3,1,0,0,0,1,2
554,796345,9,0,0,0,0,0,0,1,2,0,0,0,2,0,1,0,1
554,792440,4,0,0,0,0,0,0,0,0,0,0,0,2,0,0,0,0
554,785236,4,0,2,0,0,0,2,0,0,0,0,0,1,0,0,0,0
554,790783,3,0,0,0,0,0,0,0,0,0,0,0,0,0,0,0,0
555,775739,13,0,2,0,2,0,0,0,0,0,1,0,1,0,1,1,0
555,791441,18,0,3,0,1,0,2,0,0,0,1,1,2,0,5,0,0
555,781378,31,3,9,1,5,2,4,0,0,2,5,4,1,0,1,0,8
555,774959,25,7,14,4,8,3,6,2,5,2,2,3,1,0,1,1,19
555,775267,23,2,9,1,3,1,6,8,8,2,3,3,2,2,3,0,13
555,791440,10,1,2,1,2,0,0,0,0,0,2,0,4,1,2,0,2
555,781629,16,0,1,0,1,0,0,3,3,2,1,2,1,0,1,0,3
555,797013,23,4,9,0,1,4,8,0,0,0,3,2,1,0,4,0,12
555,797019,11,1,3,1,3,0,0,0,0,0,0,1,4,1,3,0,2
555,797015,22,4,7,3,5,1,2,4,5,3,3,1,2,2,2,1,13
555,797016,7,2,2,1,1,1,1,0,0,0,3,0,3,0,0,0,5
555,789009,1,0,0,0,0,0,0,0,0,0,0,0,0,0,0,0,0
556,791669,15,5,5,5,5,0,0,0,0,1,4,3,0,0,2,1,10
556,785762,12,11,12,11,12,0,0,0,0,0,3,1,1,0,1,1,22
556,780531,18,4,7,2,2,2,5,0,1,1,7,9,0,2,2,0,10
556,797409,18,3,5,2,3,1,2,0,0,0,10,11,0,0,2,0,7
556,780535,13,3,6,2,3,1,3,0,0,0,3,5,3,0,0,0,7
556,791666,14,7,10,7,10,0,0,0,0,0,5,4,0,0,4,1,14
556,780534,14,9,11,9,11,0,0,2,2,2,7,2,1,0,2,2,20
556,785760,16,4,5,4,4,0,1,1,1,1,3,5,1,1,1,1,9
556,791670,12,4,7,4,7,0,0,0,0,1,4,1,2,0,1,0,8
556,797414,12,8,11,8,11,0,0,0,0,3,1,0,2,0,0,0,16
556,797411,16,5,6,5,6,0,0,0,0,2,7,2,2,1,1,1,10
556,797407,15,5,6,4,5,1,1,2,3,1,1,2,2,2,2,1,13
556,797415,13,5,9,5,9,0,0,5,5,2,4,0,1,2,3,0,15
556,791671,12,4,5,4,4,0,1,4,4,1,1,0,2,0,1,0,12
558,775557,28,0,1,0,1,0,0,0,0,3,3,0,3,2,2,3,0
558,776286,33,2,3,1,1,1,2,4,4,3,4,0,3,1,0,0,9
558,791445,34,5,15,2,7,3,8,4,4,1,2,1,3,1,3,0,17
558,785357,38,5,18,2,10,3,8,2,4,4,3,2,3,1,3,1,15
558,775560,31,3,10,2,6,1,4,1,2,2,7,5,4,3,1,0,8
558,790516,11,2,5,2,5,0,0,0,0,0,1,1,1,2,1,0,4
558,791444,3,0,0,0,0,0,0,0,0,0,0,0,2,0,0,0,0
558,797010,18,3,5,3,3,0,2,5,7,0,2,0,4,0,2,0,11
558,797012,2,0,0,0,0,0,0,0,0,0,0,0,1,1,0,0,0
558,785287,2,0,0,0,0,0,0,0,0,0,0,0,0,0,0,0,0
559,780323,24,2,3,2,3,0,0,0,1,2,3,1,3,1,6,1,4
559,792233,26,2,8,1,5,1,3,0,0,1,3,0,2,1,1,1,5
559,797894,28,6,8,6,8,0,0,0,3,2,2,1,5,0,2,0,12
559,785954,34,2,7,1,2,1,5,0,3,1,5,3,3,0,1,0,5
559,785811,37,3,11,3,5,0,6,10,14,1,2,1,4,0,1,0,16
559,785484,5,0,2,0,2,0,0,0,0,0,0,0,1,0,0,0,0
559,786016,25,2,3,1,2,1,1,1,1,0,1,1,2,1,3,0,6
559,792234,5,0,1,0,0,0,1,2,2,1,3,0,1,0,1,1,2
559,797892,9,0,2,0,1,0,1,0,0,0,0,0,0,0,2,0,0
559,792230,2,0,0,0,0,0,0,0,0,0,0,0,1,0,0,0,0
559,797891,3,1,1,0,0,1,1,0,0,0,0,0,0,0,1,0,3
559,781356,2,0,0,0,0,0,0,0,0,0,1,0,0,0,0,0,0
560,786772,29,3,7,3,7,0,0,0,0,2,3,0,3,1,2,4,6
560,781484,13,1,3,1,1,0,2,0,0,1,0,1,5,1,2,0,2
560,786769,24,2,4,1,1,1,3,3,3,1,1,0,0,0,1,1,8
560,786024,26,2,6,0,1,2,5,2,2,0,0,1,2,3,4,0,8
560,780002,25,1,5,1,2,0,3,0,0,0,0,2,0,2,2,0,2
560,791967,14,0,3,0,2,0,1,0,0,0,1,4,0,0,1,0,0
560,785441,14,3,6,3,5,0,1,0,0,0,2,0,0,0,0,0,6
560,791970,29,3,11,1,3,2,8,2,3,0,3,3,1,1,1,1,10
560,797840,11,2,5,2,4,0,1,0,2,0,0,0,0,0,0,0,4
560,790823,12,1,1,1,1,0,0,2,2,0,1,0,2,0,0,0,4
560,786773,3,1,1,1,1,0,0,0,0,0,0,1,1,0,0,0,2
561,785298,15,0,1,0,1,0,0,0,2,1,1,0,2,0,0,1,0
561,775224,27,4,8,4,8,0,0,0,0,7,8,4,2,0,4,3,8
561,778046,26,8,12,4,5,4,7,0,0,0,3,5,3,2,3,1,20
561,782121,31,2,8,1,3,1,5,1,2,1,3,7,1,1,4,0,6
561,775793,29,6,12,4,6,2,6,1,2,3,3,1,0,0,2,0,15
561,785485,19,5,9,5,9,0,0,2,2,4,5,1,2,0,1,1,12
561,786594,24,6,11,1,2,5,9,0,0,2,1,1,1,0,1,0,17
561,785302,11,2,4,1,2,1,2,1,2,2,2,2,1,0,1,0,6
561,796598,10,0,0,0,0,0,0,0,0,0,0,0,1,0,0,0,0
561,785301,2,0,1,0,1,0,0,0,1,0,1,0,0,0,0,0,0
561,778469,2,1,1,1,1,0,0,0,0,0,0,0,1,0,0,0,2
561,796599,2,0,0,0,0,0,0,0,0,0,1,0,0,0,0,0,0
561,790987,2,0,0,0,0,0,0,0,0,0,0,0,0,0,0,0,0
562,796381,26,4,5,2,2,2,3,0,0,2,5,2,1,1,0,2,10
562,775585,26,3,8,3,8,0,0,1,2,1,3,0,2,0,2,2,7
562,790822,35,9,14,9,11,0,3,2,2,2,5,2,2,2,1,1,20
562,780443,34,3,13,1,7,2,6,3,4,0,4,6,2,3,1,1,11
562,774980,33,3,8,3,6,0,2,4,4,1,6,4,1,1,5,0,10
562,790821,20,3,4,3,3,0,1,2,2,0,3,2,1,1,1,0,8
562,790820,21,4,7,3,6,1,1,2,9,1,10,2,2,3,5,0,11
562,775634,5,0,0,0,0,0,0,0,0,1,0,0,0,0,1,0,0
563,797616,25,4,10,3,6,1,4,3,6,3,2,0,1,0,1,4,12
563,791882,32,2,8,1,5,1,3,0,0,2,5,3,2,1,1,0,5
563,786493,37,7,22,2,5,5,17,2,2,2,2,1,2,2,3,0,21
563,791881,31,3,8,1,4,2,4,0,0,1,3,4,2,1,3,0,8
563,786420,27,1,5,1,3,0,2,0,0,0,2,5,3,2,3,0,2
563,781052,23,3,9,0,0,3,9,0,0,1,4,0,0,0,1,1,9
563,797618,13,0,2,0,2,0,0,0,0,0,2,0,4,0,2,1,0
563,781258,12,1,3,1,2,0,1,0,0,0,1,2,3,2,1,0,2
564,780163,37,5,11,4,5,1,6,7,10,1,9,2,2,0,3,1,18
564,785742,33,8,19,3,8,5,11,5,7,0,0,0,3,0,2,0,26
564,797244,23,1,1,1,1,0,0,0,0,1,3,2,3,2,0,0,2
564,780170,12,0,1,0,0,0,1,0,0,0,1,1,2,0,0,0,0
564,791366,31,5,10,4,9,1,1,2,3,1,5,1,5,2,2,0,13
564,797241,14,1,2,1,2,0,0,0,0,0,1,0,4,0,0,0,2
564,797243,10,2,3,2,3,0,0,0,0,1,1,0,1,1,0,0,4
564,786340,8,0,3,0,1,0,2,0,0,0,1,0,2,0,0,0,0
564,791363,22,0,3,0,3,0,0,1,2,0,0,0,2,1,1,0,1
564,791361,3,0,0,0,0,0,0,0,0,0,0,0,0,0,0,0,0
564,786155,7,0,1,0,1,0,0,1,2,1,1,0,1,0,0,0,1
565,791849,30,4,12,1,4,3,8,0,1,0,3,0,1,0,2,0,11
565,786607,9,0,2,0,0,0,2,0,0,0,1,0,3,0,2,0,0
565,781058,14,0,0,0,0,0,0,0,0,2,2,0,1,0,2,0,0
565,785622,23,1,2,1,2,0,0,0,1,1,1,2,3,0,2,0,2
565,780327,24,4,10,4,10,0,0,2,4,6,5,0,0,0,2,1,10
565,797451,26,4,11,3,6,1,5,6,9,1,4,4,3,2,4,0,15
565,797452,0,0,0,0,0,0,0,0,0,0,0,0,0,0,0,0,0
565,791847,7,0,0,0,0,0,0,0,0,0,1,0,0,0,2,0,0
565,797453,13,3,5,3,4,0,1,1,1,0,4,0,2,1,1,0,7
565,791848,12,0,0,0,0,0,0,0,0,1,0,2,1,0,1,0,0
565,797455,15,2,3,2,3,0,0,3,4,0,5,0,4,0,1,0,7
565,797458,27,2,5,2,3,0,2,3,6,0,1,1,1,0,2,0,7
567,781577,29,5,12,5,10,0,2,5,7,2,2,0,3,0,3,1,15
567,781387,19,1,4,0,2,1,2,2,2,0,3,2,4,1,0,0,5
567,786451,30,7,11,4,4,3,7,3,3,2,3,0,2,1,2,0,20
567,780600,36,6,12,6,9,0,3,2,2,6,3,4,3,2,2,1,14
567,775910,23,3,8,3,6,0,2,2,4,2,5,3,4,0,2,1,8
567,780020,24,3,3,2,2,1,1,1,2,0,2,1,4,0,3,0,8
567,797554,9,0,1,0,1,0,0,0,0,0,1,1,0,0,0,0,0
567,791763,18,3,7,2,4,1,3,2,2,2,3,1,0,1,2,1,9
567,786456,12,2,3,2,3,0,0,0,0,0,0,1,1,1,1,1,4
570,790873,27,4,8,4,7,0,1,3,4,3,5,0,4,1,2,2,11
570,780054,35,4,9,3,7,1,2,6,9,2,4,1,3,3,2,0,15
570,781140,30,2,8,2,7,0,1,2,2,2,6,0,2,0,0,0,6
570,786851,35,7,17,4,6,3,11,4,4,0,3,1,1,1,0,0,21
570,776357,34,2,7,2,6,0,1,9,10,0,3,5,4,1,2,0,13
570,796433,17,3,4,3,4,0,0,2,4,2,2,1,2,0,2,2,8
570,780343,8,0,0,0,0,0,0,0,0,0,0,1,2,0,1,0,0
570,796432,8,0,1,0,0,0,1,0,0,1,3,0,0,0,0,0,0
570,785429,6,0,1,0,0,0,1,0,0,0,0,1,0,0,0,0,0
571,791606,19,2,10,1,4,1,6,0,0,0,3,4,5,0,0,1,5
571,786410,33,3,6,0,2,3,4,2,2,0,1,1,4,0,1,0,11
571,775095,15,0,2,0,2,0,0,2,2,0,3,1,3,1,0,2,2
571,791603,7,0,1,0,0,0,1,1,2,0,0,0,0,0,3,0,1
571,780414,40,5,21,2,8,3,13,2,4,2,5,5,3,0,4,0,15
571,792392,19,3,6,3,6,0,0,2,2,2,1,0,2,1,0,0,8
571,791605,24,2,4,0,0,2,4,0,0,0,4,0,1,0,1,0,6
571,797020,9,2,2,1,1,1,1,0,0,0,0,0,4,0,1,2,5
571,786406,34,4,4,3,3,1,1,2,2,2,2,4,2,1,2,0,11
572,781480,27,3,10,1,3,2,7,0,0,0,3,5,3,1,1,1,8
572,774846,19,1,3,1,3,0,0,0,0,0,0,0,1,2,1,0,2
572,786558,34,7,11,5,6,2,5,0,0,1,6,7,3,2,2,0,16
572,766611,28,7,14,4,5,3,9,0,0,1,3,2,1,2,4,0,17
572,797272,29,5,10,1,2,4,8,0,0,0,3,3,1,0,1,1,14
572,786185,13,1,2,1,2,0,0,0,0,0,4,1,1,1,1,1,2
572,797182,22,3,7,3,6,0,1,1,2,6,2,1,2,1,0,0,7
572,797181,8,0,0,0,0,0,0,3,5,0,0,2,0,1,0,0,3
572,797273,8,2,4,1,3,1,1,0,0,0,0,0,0,0,0,0,5
572,797183,9,2,4,2,3,0,1,0,0,0,1,0,0,0,0,0,4
572,791377,3,1,1,1,1,0,0,0,0,0,0,0,0,0,0,0,2
573,792418,30,7,13,6,10,1,3,0,0,4,6,1,3,1,3,2,15
573,792424,32,1,3,1,3,0,0,0,2,4,2,0,2,0,5,2,2
573,789484,33,7,13,7,11,0,2,1,2,0,3,3,1,0,2,0,15
573,796693,35,2,10,2,9,0,1,2,2,0,2,2,0,1,3,0,6
573,792422,30,6,8,6,8,0,0,2,2,3,7,1,1,3,1,1,14
573,796691,14,2,5,0,0,2,5,1,2,0,1,0,0,0,0,0,7
573,792421,18,0,3,0,1,0,2,4,5,0,0,3,0,0,2,0,4
573,792419,8,0,1,0,0,0,1,0,0,0,2,0,0,0,1,0,0
574,791524,31,7,12,4,8,3,4,2,2,0,2,4,2,2,1,0,19
574,786354,5,0,0,0,0,0,0,0,0,0,1,0,2,0,0,0,0
574,791526,30,3,9,3,5,0,4,2,2,0,3,4,0,3,0,0,8
574,780272,29,1,8,0,4,1,4,0,0,0,6,1,1,0,2,0,3
574,775592,34,6,8,2,3,4,5,7,8,0,5,0,1,0,2,0,23
574,785970,3,1,1,1,1,0,0,0,0,0,0,0,2,0,1,0,2
574,780273,21,2,3,0,0,2,3,0,0,0,0,2,1,0,2,0,6
574,775394,28,5,8,4,5,1,3,3,6,4,7,5,5,0,1,1,14
574,797139,19,5,9,5,9,0,0,6,7,4,2,0,3,0,2,0,16
574,791523,0,0,0,0,0,0,0,0,0,0,0,0,0,0,0,0,0
575,791923,27,9,16,7,13,2,3,1,3,1,7,1,4,0,2,0,21
575,791925,30,2,7,2,5,0,2,3,4,2,3,2,3,1,2,0,7
575,791927,22,3,6,2,4,1,2,1,1,2,1,0,3,1,1,0,8
575,791926,26,4,12,2,6,2,6,2,2,0,1,2,3,0,2,0,12
575,781112,16,1,1,0,0,1,1,2,2,0,1,4,0,0,0,0,5
575,786529,15,0,1,0,1,0,0,0,0,3,3,0,2,0,0,0,0
575,797541,21,3,11,3,11,0,0,0,1,2,4,0,1,0,2,4,6
575,781122,4,0,2,0,2,0,0,0,0,0,0,0,3,1,0,0,0
575,797542,3,0,1,0,1,0,0,0,0,0,0,0,0,0,0,0,0
575,786858,13,3,4,2,3,1,1,0,0,0,0,2,0,0,0,0,7
575,786527,14,3,4,0,0,3,4,2,2,0,0,0,0,0,0,0,11
575,778952,9,0,1,0,0,0,1,0,0,1,0,1,2,0,0,0,0
576,791403,25,8,10,8,10,0,0,0,1,1,6,3,3,0,1,2,16
576,791404,23,4,5,4,5,0,0,0,0,0,2,2,3,1,2,0,8
576,791407,34,4,7,3,4,1,3,9,10,1,6,3,2,3,4,0,18
576,785928,24,3,6,2,3,1,3,0,1,1,3,0,1,0,1,1,7
576,785923,27,4,6,3,5,1,1,0,0,2,6,3,0,0,3,1,9
576,797112,1,1,1,1,1,0,0,0,0,0,0,0,0,0,0,0,2
576,797111,20,3,5,3,5,0,0,1,2,2,5,0,3,0,0,0,7
576,797110,7,0,2,0,0,0,2,0,0,0,1,0,0,0,0,0,0
576,797115,1,0,0,0,0,0,0,0,0,0,0,0,1,0,0,0,0
576,797109,4,0,1,0,0,0,1,0,0,1,0,0,1,0,1,0,0
576,797114,32,5,12,3,8,2,4,5,6,0,3,3,2,0,2,0,17
576,797113,1,0,0,0,0,0,0,0,0,0,0,0,0,0,0,0,0
576,797117,1,0,0,0,0,0,0,0,0,0,0,0,0,0,0,0,0
578,786130,31,7,18,5,12,2,6,6,6,1,2,2,3,1,7,0,22
578,797364,17,2,2,2,2,0,0,1,2,2,0,0,4,0,2,0,5
578,797367,27,2,6,2,6,0,0,0,0,2,3,1,3,2,2,0,4
578,791807,21,2,5,2,3,0,2,0,1,0,2,1,1,0,0,0,4
578,797369,14,1,1,0,0,1,1,0,0,0,1,0,3,1,4,0,3
578,791808,14,1,2,1,2,0,0,4,6,2,0,1,1,1,0,0,6
578,797363,19,1,7,1,4,0,3,1,1,0,0,2,2,1,4,0,3
578,797365,6,1,5,1,1,0,4,0,0,0,0,0,0,0,1,0,2
578,786127,4,1,1,1,1,0,0,0,0,1,0,0,0,0,0,0,2
578,797371,2,1,1,1,1,0,0,0,0,0,0,0,0,0,0,0,2
578,797366,18,0,2,0,1,0,1,1,2,0,4,1,1,0,0,0,1
578,797368,12,0,1,0,1,0,0,1,3,1,1,0,4,0,1,2,1
578,791804,15,0,2,0,1,0,1,0,0,0,1,0,1,1,0,0,0
579,775255,33,7,16,3,6,4,10,9,9,1,0,2,0,0,2,0,27
579,781215,28,4,10,2,5,2,5,8,10,4,2,2,5,2,4,1,18
579,791001,36,5,12,3,4,2,8,1,2,1,6,7,1,2,1,1,13
579,781159,27,5,9,4,6,1,3,0,0,1,6,3,4,3,3,0,11
579,781174,22,1,4,1,4,0,0,4,4,4,8,1,4,0,2,2,6
579,796643,18,2,5,2,3,0,2,0,0,4,1,1,1,0,0,0,4
579,785320,21,1,8,1,3,0,5,0,0,3,3,1,1,0,1,0,2
579,796644,7,0,1,0,1,0,0,0,0,1,0,1,3,0,0,0,0
579,796639,2,0,1,0,0,0,1,0,0,0,1,0,0,0,0,0,0
579,796640,2,0,0,0,0,0,0,0,0,0,0,0,0,0,1,0,0
579,796641,4,2,2,1,1,1,1,0,0,0,0,0,0,0,0,0,5
579,799299,0,0,0,0,0,0,0,0,0,0,0,0,0,0,0,0,0
580,792560,17,2,2,2,2,0,0,2,2,1,4,0,1,1,1,0,6
580,792563,30,11,13,7,8,4,5,2,5,2,5,2,0,3,3,1,28
580,792561,30,6,12,3,7,3,5,0,0,1,0,2,3,1,2,0,15
580,789634,5,0,0,0,0,0,0,0,0,0,0,0,0,0,0,0,0
580,780270,31,3,9,2,4,1,5,2,3,6,5,6,1,1,3,0,9
580,798134,24,3,8,2,5,1,3,7,8,0,0,4,0,6,3,0,14
580,780266,16,0,2,0,0,0,2,1,2,0,1,1,1,0,4,0,1
580,776333,11,0,0,0,0,0,0,0,0,0,2,0,2,2,2,0,0
580,798132,23,3,7,0,2,3,5,0,0,0,1,2,2,2,0,0,9
580,798135,8,0,0,0,0,0,0,0,0,0,1,1,1,0,1,1,0
580,798133,5,0,2,0,0,0,2,0,0,0,0,1,1,0,0,1,0
581,791768,22,0,0,0,0,0,0,0,0,1,2,4,5,0,7,0,0
581,786460,24,3,6,3,6,0,0,0,0,1,2,2,2,1,2,1,6
581,780604,25,4,10,3,8,1,2,2,2,0,2,4,2,2,6,0,11
581,780603,24,1,4,0,0,1,4,0,1,1,2,5,3,1,2,0,3
581,780602,31,5,11,5,10,0,1,0,0,0,3,3,2,1,2,1,10
581,786230,19,1,5,0,1,1,4,0,0,0,3,2,2,1,1,0,3
581,786071,20,7,8,7,8,0,0,0,1,3,2,1,1,0,1,0,14
581,791767,14,2,8,0,3,2,5,0,0,3,3,0,4,2,3,0,6
581,786462,2,0,1,0,0,0,1,0,0,0,0,0,0,0,1,0,0
581,797564,2,0,0,0,0,0,0,0,0,0,0,0,0,0,1,0,0
581,791766,16,0,1,0,1,0,0,0,0,0,1,0,1,0,0,0,0
581,797565,1,0,1,0,0,0,1,0,0,0,0,0,0,0,0,0,0
582,797482,30,5,8,4,7,1,1,2,3,2,2,0,3,2,3,0,13
582,797485,26,4,7,3,3,1,4,1,1,1,4,0,3,1,3,0,10
582,785944,28,5,12,4,6,1,6,7,9,2,2,2,0,0,3,0,18
582,797480,29,5,15,4,11,1,4,3,4,1,1,1,1,5,2,0,14
582,797481,17,0,7,0,2,0,5,2,2,2,1,1,3,0,1,3,2
582,781217,13,3,3,2,2,1,1,0,3,0,1,1,1,2,0,0,7
582,797484,4,0,0,0,0,0,0,0,0,2,0,0,0,0,0,0,0
582,797478,16,0,1,0,1,0,0,2,2,0,4,0,1,0,2,0,2
582,791873,18,0,3,0,3,0,0,3,4,0,0,5,0,0,0,0,3
582,797483,10,1,1,1,1,0,0,0,0,1,2,0,0,0,0,2,2
582,797479,9,1,1,0,0,1,1,0,0,0,1,1,0,0,0,0,3
584,785638,29,3,7,3,5,0,2,1,2,0,7,0,1,0,1,0,7
584,780874,10,0,3,0,1,0,2,0,0,0,1,0,2,0,0,0,0
584,781326,26,4,7,4,7,0,0,0,0,1,4,0,3,1,1,1,8
584,792209,34,3,7,1,4,2,3,0,0,0,3,2,3,1,1,0,8
584,781323,33,3,10,3,6,0,4,8,9,1,5,4,1,1,3,0,14
584,792213,17,1,1,0,0,1,1,0,0,0,1,0,1,0,1,0,3
584,792215,14,3,6,2,5,1,1,1,3,2,0,0,0,1,0,0,8
584,797870,28,3,6,3,5,0,1,0,0,0,7,0,1,0,3,0,6
584,792210,8,0,3,0,2,0,1,2,2,0,1,0,1,0,0,0,2
584,797868,1,0,0,0,0,0,0,0,0,0,0,0,0,0,0,0,0
585,797198,17,2,7,1,4,1,3,1,3,0,2,0,1,0,0,0,6
585,791482,19,0,4,0,1,0,3,0,0,1,2,1,1,0,0,0,0
585,786318,33,6,16,4,6,2,10,1,1,1,8,1,0,2,1,1,15
585,784268,34,5,10,3,6,2,4,1,2,1,3,1,3,0,2,0,13
585,780223,36,3,7,3,4,0,3,0,0,0,4,1,3,0,2,0,6
585,786319,18,2,3,2,3,0,0,1,2,0,4,2,2,0,1,0,5
585,780225,27,2,6,1,1,1,5,0,0,0,3,1,3,1,2,0,5
585,791481,11,1,2,1,2,0,0,0,0,0,1,0,0,0,0,1,2
585,797199,5,0,0,0,0,0,0,0,0,0,0,0,0,0,0,0,0
585,797201,0,0,0,0,0,0,0,0,0,0,0,0,0,0,0,0,0
586,797389,21,3,4,3,4,0,0,1,4,0,7,2,2,2,0,0,7
586,791826,34,1,4,1,2,0,2,1,2,2,7,7,1,2,4,1,3
586,786785,29,6,11,5,7,1,4,2,3,2,7,4,4,0,1,1,15
586,786784,37,6,12,6,10,0,2,2,5,1,5,1,3,0,4,0,14
586,776009,37,5,14,3,10,2,4,5,6,1,2,2,1,2,2,0,17
586,780634,19,1,5,1,5,0,0,2,3,1,8,1,2,1,3,5,4
586,797388,12,1,2,1,2,0,0,3,4,1,1,0,2,1,0,0,5
586,797387,6,1,3,0,1,1,2,0,0,0,0,0,1,0,1,0,3
586,797390,5,0,0,0,0,0,0,2,2,0,0,0,0,0,0,0,2
587,781425,27,2,10,2,10,0,0,3,3,7,10,0,4,2,3,0,7
587,797000,15,0,5,0,2,0,3,0,0,0,1,0,2,0,2,0,0
587,791343,27,0,4,0,1,0,3,0,0,0,0,3,3,2,3,0,0
587,781602,31,9,13,6,8,3,5,1,1,0,1,2,3,1,1,1,22
587,775746,26,2,9,1,4,1,5,2,5,0,3,0,2,1,0,0,7
587,791344,23,3,8,2,3,1,5,1,4,0,4,0,2,3,1,0,8
587,781601,13,1,3,1,3,0,0,0,0,0,5,0,2,0,0,1,2
587,796999,13,0,1,0,0,0,1,2,2,0,0,2,1,2,3,0,2
587,786611,21,2,6,1,3,1,3,3,4,0,1,1,2,1,1,0,8
587,797001,4,0,4,0,2,0,2,0,0,0,1,0,0,0,0,0,0
588,785714,21,6,7,6,6,0,1,4,5,0,4,0,0,1,0,0,16
588,775894,25,2,7,0,2,2,5,0,0,0,4,2,2,0,0,0,6
588,785711,36,5,15,3,4,2,11,0,0,0,2,6,1,0,1,0,12
588,785378,26,4,10,3,6,1,4,2,2,2,3,4,3,0,1,0,11
588,780985,37,4,12,2,3,2,9,1,2,0,7,4,0,1,0,1,11
588,796829,11,4,6,4,6,0,0,0,0,2,0,1,2,0,0,1,8
588,791167,26,2,4,1,1,1,3,0,0,0,2,1,1,2,1,0,5
588,780988,8,0,2,0,0,0,2,0,0,0,0,0,2,0,0,2,0
588,791169,1,0,0,0,0,0,0,0,0,0,0,0,1,0,0,0,0
588,785710,7,0,0,0,0,0,0,0,0,0,0,0,0,0,1,0,0
588,796827,1,0,0,0,0,0,0,0,0,0,0,0,0,0,0,0,0
588,796828,1,0,0,0,0,0,0,0,0,0,0,0,0,0,0,0,0
589,781044,23,7,12,5,8,2,4,0,0,2,2,3,3,0,2,0,16
589,791795,26,4,6,2,4,2,2,1,2,1,5,1,1,0,0,0,11
589,786489,29,2,9,2,5,0,4,0,0,0,3,1,2,0,0,0,4
589,786488,30,2,6,2,6,0,0,0,0,3,6,4,1,0,4,0,4
589,781038,30,4,7,4,7,0,0,4,5,3,4,0,0,1,2,0,12
589,791796,11,2,4,2,4,0,0,0,0,0,2,0,0,0,1,0,4
589,797620,10,0,2,0,1,0,1,2,2,0,0,0,0,0,3,1,2
589,797621,15,0,2,0,1,0,1,0,0,0,2,1,0,0,2,0,0
589,786487,16,0,5,0,2,0,3,1,2,0,4,0,0,0,2,0,1
589,797619,10,1,2,1,1,0,1,2,2,0,0,0,4,0,0,0,4
589,786490,0,0,0,0,0,0,0,0,0,0,0,0,0,0,0,0,0
590,781393,38,6,15,3,7,3,8,4,6,2,4,6,2,1,4,0,19
590,787175,40,5,8,1,2,4,6,3,3,0,3,0,2,1,0,0,17
590,775351,34,8,11,8,11,0,0,1,2,1,1,0,3,3,2,0,17
590,790909,39,3,7,2,4,1,3,0,0,2,4,3,4,1,0,0,7
590,796455,29,3,8,3,8,0,0,0,1,0,5,1,1,0,2,0,6
590,796453,18,3,7,3,7,0,0,1,5,1,1,1,3,0,0,0,7
590,790907,2,0,0,0,0,0,0,0,0,0,0,0,0,0,0,0,0
591,776297,34,6,15,1,2,5,13,0,1,1,5,4,4,0,0,0,17
591,797247,35,3,9,2,6,1,3,1,2,1,5,9,0,3,3,0,8
591,785837,19,2,5,2,2,0,3,2,2,2,5,0,1,1,4,1,6
591,791352,18,1,3,0,0,1,3,0,0,1,3,2,3,0,2,1,3
591,780455,3,0,0,0,0,0,0,0,0,1,0,0,0,0,0,0,0
591,797248,32,8,11,0,0,8,11,0,0,0,1,0,2,0,1,0,24
591,791354,24,4,7,4,7,0,0,0,0,3,4,1,3,0,3,0,8
591,797251,20,2,3,2,2,0,1,1,2,2,2,2,3,0,1,1,5
591,791355,9,1,4,1,2,0,2,2,2,2,2,1,0,0,1,0,4
591,797252,0,0,0,0,0,0,0,2,2,0,0,0,0,0,0,0,2
591,797249,5,0,1,0,0,0,1,0,0,0,0,0,0,0,0,0,0
591,797250,1,0,0,0,0,0,0,0,0,0,0,0,0,0,0,0,0
592,780580,34,4,11,2,5,2,6,11,11,0,5,4,1,1,2,0,21
592,781407,25,6,7,6,6,0,1,2,2,2,9,0,2,1,4,1,14
592,785623,20,2,3,1,2,1,1,2,2,0,2,1,2,2,0,0,7
592,776150,35,1,7,1,5,0,2,2,2,0,5,2,3,1,3,0,4
592,791583,8,2,2,2,2,0,0,0,0,0,2,0,3,0,1,1,4
592,786659,17,3,7,3,6,0,1,5,6,0,2,0,0,1,0,0,11
592,797445,15,3,3,3,3,0,0,5,6,1,2,0,2,0,1,1,11
592,791584,14,0,4,0,4,0,0,5,6,0,5,1,2,1,1,1,5
592,786608,7,1,3,1,2,0,1,2,5,0,0,0,1,0,1,0,4
592,797448,25,1,3,0,0,1,3,0,0,1,2,1,0,0,0,0,3
593,780238,38,8,17,5,9,3,8,3,3,2,2,5,2,0,2,0,22
593,786179,27,5,20,2,8,3,12,2,3,2,1,1,4,1,1,0,15
593,780244,29,3,6,3,5,0,1,0,2,2,2,4,5,0,1,1,6
593,781500,18,1,6,1,2,0,4,1,1,0,3,0,1,0,0,0,3
593,785909,5,0,1,0,1,0,0,0,0,1,1,0,0,0,1,0,0
593,786177,34,6,13,1,2,5,11,2,2,3,7,1,5,0,1,1,19
593,791750,32,2,9,2,7,0,2,0,0,1,4,0,4,2,1,0,4
593,791752,11,0,0,0,0,0,0,2,2,0,2,0,4,1,2,0,2
593,791749,6,0,3,0,1,0,2,0,0,1,1,0,0,0,1,0,0
594,797127,36,3,7,1,2,2,5,4,5,2,4,2,2,1,0,1,12
594,791531,26,1,6,1,2,0,4,5,5,2,4,2,2,1,2,0,7
594,791534,32,8,10,7,8,1,2,3,5,1,8,1,2,0,1,0,20
594,791528,37,6,10,5,7,1,3,6,6,1,2,6,1,1,4,2,19
594,775045,35,6,9,5,7,1,2,2,2,0,3,4,1,0,3,0,15
594,797124,14,2,2,2,2,0,0,1,1,1,2,0,5,0,1,0,5
594,791527,10,1,1,1,1,0,0,2,4,0,1,0,2,0,0,0,4
594,797129,8,0,0,0,0,0,0,1,4,1,1,1,2,0,0,0,1
594,791530,1,1,1,0,0,1,1,0,0,0,0,0,0,0,0,0,3
594,797123,1,0,0,0,0,0,0,0,0,0,0,0,0,0,0,0,0
595,791864,29,1,4,0,1,1,3,0,0,1,2,1,3,0,1,0,3
595,776447,5,0,0,0,0,0,0,0,0,0,0,0,0,0,0,0,0
595,781081,18,1,4,1,3,0,1,0,0,1,0,0,3,0,0,0,2
595,797472,29,7,12,1,1,6,11,0,2,1,1,0,3,2,3,0,20
595,786592,38,3,15,3,13,0,2,0,1,2,4,11,3,2,2,0,6
595,797470,24,1,9,0,5,1,4,5,6,2,0,1,5,1,1,0,8
595,797473,22,4,5,4,5,0,0,1,2,5,0,0,3,2,0,0,9
595,786307,3,0,0,0,0,0,0,0,0,0,0,0,2,0,0,0,0
595,791863,21,2,3,2,3,0,0,4,7,2,4,0,3,1,2,0,8
595,780195,10,3,4,2,2,1,2,1,2,1,1,0,2,0,0,0,8
595,791865,1,0,0,0,0,0,0,0,0,0,0,0,0,0,0,0,0
596,780012,32,8,12,3,5,5,7,1,1,1,2,3,4,0,2,4,22
596,774895,13,2,4,2,4,0,0,2,3,2,0,0,1,1,1,0,6
596,790824,32,2,5,2,3,0,2,2,2,1,12,3,2,2,5,0,6
596,780011,41,2,6,0,1,2,5,0,0,0,2,5,3,1,5,0,6
596,775667,18,1,4,1,1,0,3,0,0,0,3,4,4,0,3,0,2
596,796309,25,6,8,6,8,0,0,7,9,2,2,4,2,1,1,0,19
596,781524,28,2,14,1,4,1,10,0,0,1,5,1,0,0,2,1,5
596,796382,8,0,0,0,0,0,0,0,0,0,1,2,2,0,0,0,0
596,785370,14,3,5,3,5,0,0,2,2,0,4,0,1,1,0,0,8
596,796383,14,3,4,3,4,0,0,1,5,2,2,2,1,1,1,0,7
597,797529,35,5,6,5,5,0,1,3,4,2,2,1,5,2,1,0,13
597,797527,38,2,2,0,0,2,2,2,3,2,6,0,2,1,0,0,8
597,791936,19,3,7,3,6,0,1,0,1,2,1,0,4,2,1,1,6
597,797532,42,4,19,3,13,1,6,12,13,1,8,6,4,2,6,0,21
597,785988,16,3,8,0,1,3,7,0,0,0,1,0,1,1,2,0,9
597,797530,2,0,0,0,0,0,0,0,0,0,1,0,0,0,1,0,0
597,791932,13,0,1,0,0,0,1,0,0,0,1,1,0,0,0,0,0
597,785688,24,2,10,1,2,1,8,4,4,0,1,1,0,1,3,0,9
597,791933,32,2,10,1,2,1,8,0,0,0,1,0,2,2,1,0,5
597,791931,4,0,1,0,1,0,0,0,0,0,0,0,0,0,0,0,0
598,775840,20,2,4,0,1,2,3,0,0,0,1,7,1,1,1,0,6
598,785395,22,5,12,3,7,2,5,0,0,1,5,1,0,0,0,0,12
598,775811,15,2,3,1,1,1,2,0,0,1,0,3,1,0,0,0,5
598,786704,19,10,12,10,12,0,0,0,1,3,2,2,1,0,2,0,20
598,786551,20,5,8,4,5,1,3,0,0,0,2,3,0,3,0,0,11
598,786702,20,3,6,2,3,1,3,0,0,1,3,0,1,2,1,0,7
598,786703,21,2,6,1,1,1,5,0,0,0,4,4,1,1,1,0,5
598,790921,19,5,9,5,7,0,2,2,2,1,5,2,2,1,1,1,12
598,775287,15,2,8,2,5,0,3,0,2,1,0,0,2,0,1,0,4
598,786706,13,1,1,1,1,0,0,2,5,4,7,0,0,0,0,1,4
598,792327,8,2,2,2,2,0,0,0,0,1,0,1,0,1,0,0,4
598,798110,4,0,0,0,0,0,0,0,0,0,0,1,0,0,1,0,0
598,798111,2,1,1,1,1,0,0,0,0,0,0,0,0,1,0,0,2
598,798112,2,0,0,0,0,0,0,0,0,0,0,0,0,0,0,0,0
600,781342,24,5,8,3,5,2,3,0,0,1,3,0,4,1,4,0,12
600,781593,26,1,5,1,3,0,2,1,2,1,8,2,5,0,1,0,3
600,790901,24,2,7,1,4,1,3,2,2,0,2,1,2,0,0,0,7
600,785452,26,9,12,8,9,1,3,2,2,0,3,0,1,0,1,1,21
600,781620,25,0,1,0,1,0,0,0,0,0,1,3,1,2,1,0,0
600,790902,21,3,5,2,2,1,3,6,8,0,1,2,1,0,2,0,13
600,774864,16,3,5,3,4,0,1,4,5,1,1,3,0,0,0,0,10
600,774835,19,4,5,4,5,0,0,2,2,3,3,0,3,0,1,0,10
600,796449,11,0,2,0,1,0,1,0,0,0,0,0,0,0,1,0,0
600,796450,8,0,0,0,0,0,0,0,0,0,0,0,2,0,0,1,0
601,785996,26,5,10,5,9,0,1,0,0,1,6,0,5,2,0,0,10
601,780858,28,3,6,2,4,1,2,2,2,3,4,0,3,1,1,0,9
601,797646,32,4,13,4,12,0,1,3,3,0,1,2,1,1,5,0,11
601,780849,29,2,6,2,3,0,3,1,1,1,1,0,4,0,0,0,5
601,780853,27,3,7,2,6,1,1,3,6,0,1,1,4,0,5,0,10
601,780776,3,0,2,0,2,0,0,0,0,0,0,0,1,0,0,0,0
601,785990,16,1,3,1,3,0,0,2,2,0,1,1,1,0,1,0,4
601,792235,9,0,2,0,2,0,0,1,2,0,0,1,0,0,0,0,1
601,792039,14,0,1,0,1,0,0,0,0,1,1,0,0,0,0,0,0
601,785998,8,1,1,1,1,0,0,2,2,1,0,0,1,0,0,0,4
601,791374,6,1,2,0,0,1,2,1,2,0,0,0,1,1,0,0,4
601,786001,2,0,0,0,0,0,0,0,0,0,0,0,2,0,0,0,0
606,792140,23,4,6,4,6,0,0,2,3,3,7,1,2,2,0,2,10
606,797786,27,7,11,1,3,6,8,0,0,0,4,2,0,1,1,0,20
606,792144,23,4,7,3,5,1,2,1,2,2,0,3,0,0,1,1,10
606,792148,22,3,10,2,5,1,5,0,1,0,6,3,2,1,1,0,7
606,781429,31,5,14,1,2,4,12,6,6,0,3,3,0,2,0,0,20
606,792146,12,2,3,2,3,0,0,0,3,1,1,0,2,1,2,0,4
606,797793,18,1,6,0,1,1,5,0,0,0,0,2,0,0,0,0,3
606,797789,16,1,5,1,4,0,1,4,6,3,5,2,0,1,1,1,6
606,781431,8,1,3,0,0,1,3,1,2,0,1,0,1,0,0,0,4
606,797791,5,1,1,1,1,0,0,5,6,2,2,0,3,1,0,0,7
606,797797,5,1,2,1,1,0,1,0,0,0,1,0,2,1,1,0,2
606,797787,7,1,3,1,1,0,2,1,1,0,0,1,2,0,0,0,3
606,785975,3,0,0,0,0,0,0,0,0,0,0,0,0,0,0,0,0
608,785383,33,3,12,2,7,1,5,5,7,1,1,3,4,1,4,0,12
608,786228,34,3,8,3,4,0,4,3,4,1,1,1,2,0,1,0,9
608,785385,27,3,8,2,3,1,5,1,1,0,3,1,4,1,3,0,8
608,790837,19,2,3,2,3,0,0,1,2,2,2,1,3,0,2,0,5
608,780025,29,4,11,4,11,0,0,4,6,3,2,1,3,0,2,3,12
608,781046,22,2,4,1,3,1,1,2,2,1,8,0,4,0,0,0,7
608,785382,5,0,2,0,0,0,2,0,0,0,1,0,0,0,0,0,0
608,786297,11,2,3,2,3,0,0,1,5,3,1,0,0,0,0,0,5
608,785384,6,0,0,0,0,0,0,0,0,0,1,0,1,0,1,0,0
608,796391,8,0,0,0,0,0,0,0,0,0,1,0,0,0,0,1,0
608,792180,6,0,0,0,0,0,0,0,0,0,0,0,0,0,0,0,0
609,780118,31,6,9,3,4,3,5,4,4,1,5,3,2,0,0,0,19
609,791400,28,3,7,2,5,1,2,1,2,0,5,2,3,2,2,0,8
609,785931,28,4,5,4,5,0,0,3,4,0,0,5,3,0,0,0,11
609,791401,29,5,15,5,15,0,0,2,2,2,5,1,2,1,1,3,12
609,780125,36,8,12,8,12,0,0,6,10,8,5,2,3,0,0,1,22
609,786837,8,0,3,0,2,0,1,0,0,0,2,0,5,0,2,0,0
609,797125,24,1,6,1,4,0,2,2,2,1,2,2,3,3,2,0,4
609,797130,9,0,3,0,1,0,2,0,0,0,1,1,0,1,1,0,0
609,797126,7,1,2,0,0,1,2,0,0,2,0,0,1,0,0,0,3
610,785609,11,0,1,0,1,0,0,2,2,1,1,1,2,0,2,1,2
610,775626,28,5,10,5,9,0,1,2,4,1,3,2,1,2,1,0,12
610,791203,24,2,7,1,3,1,4,0,0,3,1,0,3,1,0,0,5
610,785610,37,5,7,4,6,1,1,1,1,1,4,4,0,0,4,0,12
610,785604,23,2,8,0,0,2,8,3,3,0,2,0,3,2,1,0,9
610,796912,7,1,3,1,2,0,1,2,2,0,0,0,5,0,0,0,4
610,796910,11,0,3,0,1,0,2,2,4,2,0,0,2,0,0,0,2
610,785606,1,0,0,0,0,0,0,0,0,0,0,0,1,0,0,0,0
610,774964,28,2,5,2,4,0,1,3,4,4,4,0,3,2,0,1,7
610,796907,6,0,1,0,0,0,1,0,0,0,2,1,0,0,1,0,0
610,796906,2,1,1,1,1,0,0,0,0,0,0,0,0,0,1,0,2
610,774962,22,4,12,1,2,3,10,0,0,1,2,1,2,2,7,0,11
611,791493,31,4,6,4,6,0,0,2,7,4,9,2,3,2,2,1,10
611,789036,30,7,11,7,11,0,0,2,3,3,5,1,4,1,5,0,16
611,791495,15,4,5,3,3,1,2,0,1,1,0,0,2,0,1,0,9
611,786324,37,3,10,2,7,1,3,6,7,1,8,11,0,2,7,0,13
611,776494,13,2,5,2,3,0,2,2,2,0,1,1,1,0,1,0,6
611,781307,10,2,2,2,2,0,0,0,0,0,1,0,4,0,1,0,4
611,797192,9,2,2,2,2,0,0,0,0,1,1,0,0,0,0,0,4
611,797191,27,3,6,3,6,0,0,3,4,0,1,2,1,2,0,0,9
611,791492,23,1,4,0,1,1,3,0,0,0,0,0,1,0,2,0,3
611,791494,5,1,1,1,1,0,0,0,0,0,0,1,1,0,0,0,2
612,796837,30,2,7,1,4,1,3,2,2,1,5,1,4,1,4,0,7
612,791171,22,2,2,2,2,0,0,1,3,1,3,0,2,0,1,2,5
612,791170,26,4,6,4,6,0,0,5,6,0,6,2,2,0,0,0,13
612,785700,33,3,10,3,8,0,2,2,4,1,4,8,3,3,1,1,8
612,780269,32,7,15,5,10,2,5,4,4,0,6,3,2,2,2,0,20
612,796838,18,3,7,3,7,0,0,2,3,2,2,0,2,0,0,0,8
612,796834,25,4,5,3,4,1,1,3,3,1,2,1,2,1,2,0,12
612,796833,2,0,1,0,0,0,1,0,0,0,0,0,0,0,0,0,0
612,785706,12,1,2,0,0,1,2,0,0,0,1,0,2,1,2,0,3
613,797325,29,0,2,0,2,0,0,0,0,3,5,4,1,0,3,0,0
613,797329,22,0,4,0,0,0,4,0,2,3,6,1,3,2,2,0,0
613,786236,36,7,15,6,11,1,4,3,4,3,5,0,2,1,2,0,18
613,786233,17,2,8,0,3,2,5,0,0,0,0,1,2,0,0,0,6
613,780759,33,4,10,2,2,2,8,0,0,0,2,0,3,0,0,0,10
613,786246,2,1,1,0,0,1,1,0,0,0,0,0,0,0,0,0,3
613,781002,8,1,1,1,1,0,0,0,0,1,3,0,3,0,1,0,2
613,776478,5,0,2,0,0,0,2,0,0,1,1,0,0,1,0,0,0
613,797324,5,0,2,0,2,0,0,0,0,0,0,0,1,1,0,0,0
613,797323,35,8,17,7,12,1,5,8,9,1,1,5,3,0,5,2,25
613,797322,6,0,0,0,0,0,0,1,2,0,1,0,1,0,0,0,1
613,786239,2,0,0,0,0,0,0,0,0,0,0,0,0,0,0,0,0
614,780022,23,4,8,3,4,1,4,4,7,0,2,4,5,1,0,0,13
614,790772,30,5,12,2,5,3,7,0,0,0,1,1,4,0,0,0,13
614,785230,29,8,15,7,11,1,4,6,6,1,3,2,4,1,4,0,23
614,790771,29,7,9,4,4,3,5,1,4,0,4,1,3,0,2,3,18
614,780271,30,2,4,1,2,1,2,0,1,1,7,3,1,3,4,1,5
614,767736,18,2,5,1,2,1,3,1,2,0,5,0,2,1,2,0,6
614,796328,18,1,1,1,1,0,0,2,2,1,2,0,2,0,2,0,4
614,780375,22,3,5,2,3,1,2,4,4,0,0,2,1,2,5,0,11
614,780267,1,0,1,0,0,0,1,0,0,0,0,0,1,0,0,0,0
615,797708,33,7,11,5,8,2,3,2,2,1,3,5,2,1,4,0,18
615,786198,35,5,6,5,5,0,1,7,10,2,1,6,2,2,1,1,17
615,797709,21,4,10,4,7,0,3,0,0,0,1,0,5,1,2,1,8
615,786180,4,1,1,1,1,0,0,0,0,0,1,1,0,0,0,0,2
615,785608,18,3,5,3,5,0,0,1,2,0,6,1,5,0,0,0,7
615,792104,29,11,20,9,15,2,5,5,5,4,6,1,2,1,3,0,29
615,797707,21,2,3,1,2,1,1,4,5,0,1,6,5,1,4,0,9
615,786204,17,3,10,3,9,0,1,0,0,1,4,1,2,1,1,0,6
615,776327,17,0,2,0,2,0,0,0,0,1,2,1,2,0,0,0,0
615,781631,2,0,0,0,0,0,0,0,0,0,0,0,0,0,0,0,0
615,792106,3,0,0,0,0,0,0,1,2,0,1,0,0,0,0,0,1
616,781560,21,2,2,2,2,0,0,0,0,2,3,0,4,0,0,1,4
616,791375,31,3,10,0,1,3,9,1,3,0,4,1,2,4,2,0,10
616,785487,29,2,4,1,1,1,3,1,4,0,0,3,4,2,1,0,6
616,785482,30,7,19,6,13,1,6,0,1,0,4,2,1,1,3,0,15
616,780837,20,1,9,0,1,1,8,1,2,1,1,0,2,0,3,0,4
616,796479,15,0,3,0,1,0,2,0,0,1,0,0,5,2,1,0,0
616,786164,22,1,8,0,3,1,5,0,0,3,3,0,2,0,1,0,3
616,796476,8,0,0,0,0,0,0,0,0,1,0,0,4,1,1,1,0
616,796477,14,2,5,1,2,1,3,2,2,1,2,0,1,0,2,1,7
616,796472,4,0,2,0,1,0,1,0,0,0,0,1,0,0,0,0,0
616,796473,6,0,0,0,0,0,0,2,3,2,1,0,0,0,1,0,2
617,790856,20,4,4,4,4,0,0,4,4,2,3,1,3,0,3,0,12
617,780452,23,5,13,5,13,0,0,4,8,3,4,1,1,3,1,0,14
617,796409,28,5,9,2,5,3,4,3,3,2,4,1,1,0,1,0,16
617,796408,27,2,9,2,4,0,5,2,4,0,3,4,1,1,3,3,6
617,796407,25,1,9,0,6,1,3,2,2,4,6,2,1,2,0,1,5
617,796410,16,0,0,0,0,0,0,1,4,1,5,1,1,0,4,1,1
617,796413,13,1,2,0,0,1,2,0,0,0,2,1,0,0,0,0,3
617,780450,15,4,6,2,2,2,4,1,2,1,2,0,3,0,2,0,11
617,796411,14,3,3,3,3,0,0,1,1,4,2,0,0,1,0,0,7
617,796412,3,0,1,0,0,0,1,0,0,0,1,0,2,0,1,0,0
617,780454,5,0,1,0,1,0,0,2,2,1,0,0,2,0,0,0,2
617,775941,3,0,1,0,1,0,0,1,2,0,1,0,0,0,0,0,1
617,796414,2,0,1,0,0,0,1,0,0,0,0,0,0,0,0,0,0
617,798137,2,0,0,0,0,0,0,0,0,0,1,0,0,0,0,0,0
617,781286,4,0,1,0,1,0,0,0,0,0,0,0,0,0,1,0,0
618,780797,39,6,12,2,5,4,7,1,2,2,5,4,5,3,2,1,17
618,776418,13,2,5,2,5,0,0,2,5,3,1,0,5,0,0,0,6
618,785505,31,5,11,4,7,1,4,5,6,0,8,3,2,3,5,1,16
618,780555,23,1,4,0,1,1,3,0,0,2,5,4,2,1,2,0,3
618,775604,23,4,7,1,3,3,4,0,0,1,3,1,3,0,1,0,11
618,791616,19,3,8,3,7,0,1,0,0,3,2,0,1,1,3,2,6
618,786429,0,0,0,0,0,0,0,0,0,0,0,0,1,0,0,0,0
618,796983,4,1,2,1,2,0,0,1,2,0,1,0,2,0,1,0,3
618,796986,16,2,4,2,2,0,2,0,0,0,1,1,2,0,1,1,4
618,796984,4,1,1,0,0,1,1,0,2,1,1,0,3,0,1,0,3
618,796981,25,7,13,6,9,1,4,2,3,3,6,5,0,0,2,0,17
618,791617,3,0,0,0,0,0,0,0,0,0,1,1,0,0,0,0,0
619,780870,31,1,2,1,2,0,0,6,11,2,5,0,0,0,1,2,8
619,785380,20,2,4,2,4,0,0,3,4,3,1,0,1,0,0,0,7
619,781079,24,2,7,2,4,0,3,6,6,0,3,4,2,2,4,0,10
619,781443,29,6,20,6,15,0,5,6,11,0,3,2,4,2,3,0,18
619,775822,21,3,4,1,1,2,3,0,0,0,4,0,5,0,2,0,8
619,796626,8,0,0,0,0,0,0,0,0,0,1,0,2,0,0,0,0
619,796625,22,2,6,1,4,1,2,1,2,2,2,0,2,2,2,0,6
619,796621,20,4,8,2,3,2,5,0,0,1,1,1,3,1,0,0,10
619,785831,21,1,6,1,6,0,0,0,0,0,3,1,0,1,3,0,2
619,791314,4,0,0,0,0,0,0,0,0,0,0,0,0,0,0,0,0
620,781425,32,5,9,5,9,0,0,6,8,4,5,0,2,0,1,0,16
620,797000,11,0,4,0,2,0,2,0,0,1,0,0,1,0,1,0,0
620,791343,19,1,6,1,4,0,2,0,0,1,3,3,2,2,1,0,2
620,781602,35,3,12,3,7,0,5,0,0,1,3,9,3,0,2,1,6
620,775746,32,7,13,3,3,4,10,3,3,0,3,2,2,2,1,2,21
620,791344,28,6,11,6,10,0,1,0,0,4,6,1,1,4,0,1,12
620,781601,8,1,1,1,1,0,0,2,4,0,1,0,1,0,0,0,4
620,797001,3,0,1,0,0,0,1,0,0,0,0,0,0,0,0,0,0
620,796999,10,1,2,1,1,0,1,0,0,0,2,2,1,0,1,0,2
620,786611,22,4,10,2,5,2,5,0,0,3,2,1,0,1,1,0,10
621,796960,17,0,2,0,2,0,0,3,4,1,2,0,4,2,0,0,3
621,796959,27,3,6,3,6,0,0,0,0,1,4,0,2,0,1,2,6
621,791261,33,5,11,1,2,4,9,2,4,0,5,1,3,0,4,0,16
621,791258,35,3,8,2,3,1,5,0,1,1,2,3,0,3,6,1,7
621,781270,39,8,19,7,15,1,4,0,0,0,4,3,0,0,3,0,17
621,785503,6,0,0,0,0,0,0,0,0,0,0,0,0,0,0,0,0
621,785502,11,1,2,1,2,0,0,0,0,1,2,0,3,0,1,1,2
621,796958,32,3,7,2,4,1,3,0,0,1,5,2,2,0,2,1,7
622,780063,33,3,9,0,3,3,6,2,2,1,4,2,1,2,2,2,11
622,775926,29,2,8,0,1,2,7,0,0,1,3,1,1,1,1,1,6
622,775573,35,2,10,0,2,2,8,0,0,2,4,5,1,1,2,0,6
622,785530,35,8,13,5,8,3,5,7,8,3,3,0,3,0,7,0,26
622,791058,9,0,0,0,0,0,0,0,0,0,0,1,1,0,2,0,0
622,785532,30,2,6,2,6,0,0,0,2,1,8,1,1,1,1,0,4
622,791055,20,1,2,1,2,0,0,1,2,0,2,2,3,2,5,0,3
622,796733,0,1,1,1,1,0,0,0,0,0,0,0,0,0,0,0,2
622,791057,8,1,1,1,1,0,0,0,1,0,1,0,0,0,0,0,2
622,791059,1,0,0,0,0,0,0,0,0,0,0,0,0,0,0,0,0
623,797601,36,5,14,3,7,2,7,0,2,0,4,2,4,0,4,0,12
623,781012,32,1,3,0,2,1,1,0,0,0,1,2,0,3,3,0,3
623,775806,14,0,5,0,3,0,2,0,0,0,0,0,0,1,1,1,0
623,775563,33,7,15,7,13,0,2,1,2,2,7,0,4,2,3,0,15
623,781011,24,2,5,2,4,0,1,0,0,4,3,0,3,2,1,2,4
623,775188,13,0,1,0,1,0,0,0,0,0,2,0,2,0,1,0,0
623,781424,15,2,7,0,4,2,3,0,0,1,3,2,2,1,0,0,6
623,776157,11,0,1,0,1,0,0,0,0,1,1,0,1,0,0,0,0
623,786466,2,0,1,0,0,0,1,0,0,1,0,0,0,0,0,0,0
623,775119,20,3,8,2,6,1,2,2,2,1,3,3,4,1,4,1,9
624,786041,24,8,11,7,10,1,1,2,3,1,6,2,1,1,2,2,19
624,780881,27,2,4,1,2,1,2,7,7,0,11,3,1,2,2,0,12
624,780275,21,3,7,3,7,0,0,0,0,2,3,0,1,1,2,0,6
624,792075,25,6,10,3,4,3,6,2,2,1,1,3,0,1,1,0,17
624,786686,23,5,12,4,9,1,3,0,0,0,4,11,1,2,3,0,11
624,792074,19,4,6,1,1,3,5,0,0,0,3,1,0,0,2,0,11
624,780882,21,1,3,1,1,0,2,0,0,0,0,5,2,1,4,1,2
624,780052,24,1,5,0,1,1,4,2,2,3,2,1,1,0,2,1,5
624,786051,13,2,2,2,2,0,0,2,4,2,3,0,1,2,1,1,6
624,792076,3,1,3,1,3,0,0,0,0,0,0,0,1,0,0,0,2
625,776018,18,4,8,4,8,0,0,0,2,1,1,4,3,0,1,1,8
625,797859,21,1,5,1,3,0,2,3,3,1,2,1,2,0,2,1,5
625,797855,22,3,6,2,4,1,2,1,1,1,3,1,2,1,4,0,8
625,792208,27,2,8,2,8,0,0,2,4,0,4,1,3,2,5,0,6
625,781314,20,2,6,1,2,1,4,2,2,0,3,3,4,0,2,0,7
625,797862,6,0,0,0,0,0,0,0,0,0,0,0,0,1,0,1,0
625,792204,23,3,13,1,4,2,9,0,0,0,1,1,0,1,2,0,8
625,786262,23,1,6,0,0,1,6,2,2,0,1,1,0,2,0,1,5
625,797856,16,1,2,1,1,0,1,0,0,1,2,0,3,2,0,0,2
625,786682,12,2,6,1,1,1,5,0,0,0,1,1,1,1,3,0,5
625,781317,8,0,1,0,1,0,0,0,0,0,0,1,1,0,0,0,0
625,786983,4,0,0,0,0,0,0,0,0,0,1,0,1,0,0,1,0
626,780176,31,2,9,0,4,2,5,1,2,1,2,2,3,1,1,0,7
626,786013,23,2,3,2,3,0,0,7,9,3,2,1,2,0,4,3,11
626,790814,25,1,2,1,2,0,0,2,2,1,3,1,2,0,1,3,4
626,790815,36,4,6,4,6,0,0,6,7,1,8,2,2,2,3,0,14
626,796379,27,5,10,2,4,3,6,1,2,0,6,3,1,1,3,0,14
626,796372,9,0,0,0,0,0,0,1,2,0,1,0,1,0,0,0,1
626,796377,18,1,1,0,0,1,1,2,3,2,0,1,1,0,3,0,5
626,790816,18,3,6,3,6,0,0,0,0,1,0,1,0,0,1,0,6
626,796375,0,0,0,0,0,0,0,0,0,0,0,0,2,0,0,0,0
626,796378,13,0,1,0,0,0,1,0,0,0,0,0,0,0,0,0,0
627,792346,29,3,5,3,4,0,1,0,0,1,4,3,5,1,2,1,6
627,781552,39,10,17,6,9,4,8,0,0,0,0,3,3,1,5,0,24
627,790887,23,3,7,1,2,2,5,0,0,0,3,1,3,1,3,0,8
627,792340,20,0,7,0,4,0,3,1,2,1,0,0,4,1,1,1,1
627,781553,36,3,4,2,2,1,2,1,2,3,2,3,2,2,3,2,8
627,792342,33,3,7,1,4,2,3,3,4,1,3,1,4,4,1,0,11
627,792344,2,0,0,0,0,0,0,0,0,0,0,1,0,0,0,0,0
627,792341,18,0,2,0,1,0,1,0,0,0,0,0,3,0,1,0,0
628,780765,34,8,18,7,12,1,6,1,2,1,6,2,3,1,3,0,18
628,781301,14,0,0,0,0,0,0,0,0,3,2,0,3,0,0,3,0
628,786255,32,7,14,4,8,3,6,9,10,5,5,1,1,3,3,0,26
628,780762,30,6,9,5,5,1,4,2,2,1,4,1,3,2,2,0,15
628,780768,29,2,3,2,2,0,1,1,2,1,1,8,1,5,3,0,5
628,780755,21,3,4,3,4,0,0,1,1,1,1,3,1,2,1,0,7
628,791729,24,5,7,3,3,2,4,0,4,0,0,0,1,0,1,1,12
628,797320,11,1,2,1,2,0,0,0,0,1,1,0,1,0,2,0,2
628,797319,3,0,1,0,0,0,1,1,2,0,0,0,1,0,0,0,1
628,798260,2,0,0,0,0,0,0,0,0,0,0,0,0,0,0,0,0
629,797163,29,5,7,5,7,0,0,3,3,1,5,1,2,0,4,2,13
629,791385,17,0,0,0,0,0,0,0,0,3,1,1,5,0,3,0,0
629,797161,22,2,7,1,1,1,6,0,0,0,3,2,2,1,2,0,5
629,786450,30,2,9,1,6,1,3,0,0,4,0,2,2,2,1,3,5
629,776396,38,8,18,4,11,4,7,3,4,1,3,0,1,3,4,0,23
629,797164,23,2,3,1,2,1,1,0,0,0,2,2,2,1,2,0,5
629,780599,10,2,4,2,4,0,0,0,0,0,0,0,4,0,3,0,4
629,797165,20,3,6,1,3,2,3,1,2,0,0,2,2,0,0,0,9
629,797162,1,0,0,0,0,0,0,0,0,0,0,0,2,0,1,0,0
629,797166,10,0,0,0,0,0,0,0,0,0,2,1,3,1,1,0,0
630,797698,33,4,6,3,4,1,2,1,1,2,9,1,4,1,1,1,10
630,780844,18,3,4,3,3,0,1,1,2,1,2,1,5,1,1,1,7
630,797699,34,7,14,6,9,1,5,2,4,0,2,4,1,1,3,0,17
630,797694,37,2,10,0,2,2,8,0,0,2,6,0,0,0,0,0,6
630,780846,37,4,12,4,11,0,1,10,13,1,4,5,4,0,3,2,18
630,797696,9,1,2,1,2,0,0,2,3,1,2,0,1,1,0,0,4
630,782128,18,4,6,0,0,4,6,0,0,0,1,1,2,0,0,0,12
630,797692,14,0,2,0,0,0,2,0,0,1,1,0,3,0,1,0,0
631,792399,22,4,9,4,9,0,0,1,2,1,3,0,1,1,1,2,9
631,785471,33,6,9,5,8,1,1,3,6,2,4,1,2,1,0,0,16
631,780263,37,4,8,3,5,1,3,2,4,2,4,0,4,1,3,0,11
631,786697,15,0,2,0,1,0,1,1,2,0,1,0,2,1,0,0,1
631,775628,31,10,19,10,17,0,2,1,1,2,5,3,4,1,0,0,21
631,775198,35,2,4,1,3,1,1,4,4,0,3,1,3,0,1,0,9
631,775547,9,0,3,0,2,0,1,2,4,1,3,1,1,0,0,0,2
631,792400,3,0,1,0,0,0,1,0,0,0,0,1,0,0,1,0,0
631,799000,15,3,7,3,6,0,1,1,1,1,3,1,4,0,3,1,7
636,790788,28,1,3,1,1,0,2,4,4,0,1,3,4,1,1,0,6
636,781026,30,3,7,3,4,0,3,4,4,0,4,5,4,0,2,1,10
636,781028,34,5,10,5,9,0,1,4,4,1,3,1,0,2,1,0,14
636,796347,30,6,10,4,4,2,6,3,4,0,5,0,4,1,4,0,17
636,785243,24,5,6,4,4,1,2,1,2,0,4,0,4,0,0,0,12
636,781027,17,2,2,1,1,1,1,2,2,1,0,0,3,0,1,0,7
636,796348,16,2,3,2,2,0,1,0,2,0,0,1,0,1,0,0,4
636,796349,11,1,2,0,0,1,2,1,2,1,2,0,2,0,0,0,4
636,785242,10,1,3,1,2,0,1,0,2,0,0,0,0,1,0,0,2
637,776003,30,5,10,4,6,1,4,2,4,1,2,3,4,0,1,0,13
637,779978,39,3,9,1,3,2,6,2,2,1,3,9,2,2,3,0,10
637,785463,29,4,11,2,4,2,7,4,4,2,0,2,3,0,0,0,14
637,796469,17,4,11,4,7,0,4,3,4,2,4,1,4,0,1,1,11
637,779981,34,5,5,5,5,0,0,2,3,0,6,0,3,0,1,0,12
637,785466,20,2,5,1,1,1,4,0,0,3,1,2,4,0,0,0,5
637,790923,18,4,4,2,2,2,2,3,5,2,0,1,3,1,2,0,13
637,785462,11,0,1,0,0,0,1,0,2,0,0,0,1,1,1,0,0
637,779980,2,0,0,0,0,0,0,0,0,0,0,0,1,0,0,0,0
638,791352,21,2,4,2,4,0,0,0,0,0,5,1,4,0,0,0,4
638,791354,18,5,5,4,4,1,1,0,0,3,0,0,1,2,0,1,11
638,780455,16,5,9,5,9,0,0,4,5,1,1,0,2,0,0,2,14
638,776297,33,3,9,2,5,1,4,9,12,1,1,4,3,3,2,0,16
638,797247,30,5,8,5,7,0,1,7,8,1,5,7,2,3,0,0,17
638,797248,25,3,4,0,1,3,3,0,0,2,2,0,1,1,1,0,9
638,797251,20,1,3,0,0,1,3,0,0,0,3,1,2,0,0,0,3
638,785837,11,2,8,2,7,0,1,3,6,2,2,1,1,1,1,0,7
638,797250,7,2,4,2,4,0,0,0,0,1,1,0,0,0,1,0,4
638,797249,7,0,2,0,1,0,1,0,0,0,1,0,0,0,2,0,0
638,791355,3,0,3,0,2,0,1,0,0,0,0,0,0,0,0,0,0
638,786227,3,0,1,0,1,0,0,0,0,0,1,0,0,0,0,0,0
638,797253,2,0,0,0,0,0,0,0,0,0,0,0,0,0,0,0,0
638,797252,2,0,1,0,1,0,0,0,0,0,2,0,1,0,0,0,0
638,797255,2,0,0,0,0,0,0,0,0,0,0,0,0,0,0,0,0
640,791062,25,5,8,5,6,0,2,3,6,2,6,0,2,3,2,1,13
640,791063,16,3,6,3,5,0,1,4,6,2,5,1,2,0,0,0,10
640,785542,20,1,6,1,3,0,3,2,2,2,1,1,0,0,3,0,4
640,780743,23,4,9,2,5,2,4,1,2,0,3,2,2,0,1,0,11
640,780055,23,0,3,0,1,0,2,4,5,2,2,1,2,2,0,0,4
640,796741,5,1,1,1,1,0,0,0,0,0,0,1,1,0,2,0,2
640,791060,20,4,8,4,5,0,3,0,0,1,4,5,3,2,1,0,8
640,796735,16,5,5,4,4,1,1,3,4,2,1,1,1,0,0,0,14
640,796742,4,0,0,0,0,0,0,0,0,0,1,1,2,0,0,0,0
640,796740,1,0,0,0,0,0,0,0,0,0,1,0,0,0,0,0,0
640,796736,10,1,4,1,2,0,2,0,0,0,1,0,3,1,1,0,2
640,796737,7,1,3,1,2,0,1,2,2,1,0,1,1,0,0,0,4
640,796739,3,1,3,1,2,0,1,0,0,1,1,0,0,0,0,0,2
640,791061,4,1,2,0,0,1,2,0,0,0,0,0,0,0,0,0,3
640,791064,23,3,7,2,3,1,4,1,2,0,2,6,2,1,0,0,8
642,790962,22,2,7,1,4,1,3,4,4,1,3,2,2,0,5,0,9
642,780832,32,4,5,4,5,0,0,6,6,1,7,1,2,2,1,2,14
642,790961,42,3,12,3,11,0,1,4,6,0,4,5,0,2,1,0,10
642,785278,37,6,16,1,6,5,10,0,0,1,4,0,1,1,4,0,17
642,780146,21,2,8,1,3,1,5,0,0,0,0,2,2,0,3,1,5
642,796556,23,0,0,0,0,0,0,0,0,3,2,2,1,1,1,1,0
642,796554,3,0,0,0,0,0,0,0,0,0,0,0,0,0,0,0,0
642,790965,9,0,2,0,0,0,2,0,0,1,1,1,0,0,0,0,0
642,775860,36,7,12,1,4,6,8,1,1,0,2,3,3,3,2,0,21
643,780291,34,4,7,2,5,2,2,0,0,0,8,3,4,0,3,2,10
643,785607,23,4,8,4,8,0,0,1,1,3,1,1,1,1,1,0,9
643,796665,29,3,8,1,1,2,7,0,0,0,1,1,4,2,2,0,8
643,785333,38,4,8,2,2,2,6,0,1,1,2,2,0,0,1,0,10
643,775305,37,9,15,9,14,0,1,7,8,0,3,3,4,4,3,1,25
643,796663,3,0,1,0,1,0,0,0,0,0,1,0,0,0,0,0,0
643,791004,31,4,6,3,3,1,3,1,1,1,5,1,2,1,2,0,10
643,796666,9,0,2,0,1,0,1,0,0,0,1,1,1,0,1,0,0
643,796664,14,3,5,3,4,0,1,0,0,1,2,1,0,0,2,1,6
643,791007,7,0,1,0,1,0,0,0,0,0,1,0,1,0,3,0,0
644,797830,27,3,9,2,5,1,4,0,2,0,2,0,2,1,4,2,7
644,797824,27,4,9,4,7,0,2,0,0,1,3,2,4,1,1,1,8
644,775116,25,5,12,4,7,1,5,0,2,1,6,1,1,0,3,1,11
644,792190,36,4,10,4,7,0,3,4,4,0,10,6,2,0,6,1,12
644,781266,15,0,0,0,0,0,0,0,0,0,1,0,0,0,1,0,0
644,792192,15,2,4,2,4,0,0,0,0,0,3,0,3,1,1,3,4
644,797825,12,2,2,2,2,0,0,0,2,2,2,1,2,0,2,0,4
644,797827,11,1,1,0,0,1,1,0,0,0,0,0,1,0,1,0,3
644,792191,32,1,5,1,5,0,0,3,5,1,7,1,3,0,1,0,5
645,780890,33,2,11,2,7,0,4,7,9,1,6,0,2,1,0,1,11
645,775757,15,1,5,1,5,0,0,2,2,3,1,0,2,0,1,0,4
645,786066,39,4,11,4,9,0,2,7,7,1,13,2,1,5,2,0,15
645,785636,13,1,3,0,2,1,1,0,0,0,2,0,0,1,0,0,3
645,775574,37,5,19,4,10,1,9,1,2,1,4,2,3,4,3,0,12
645,791119,5,1,1,1,1,0,0,0,0,1,0,0,1,1,0,1,2
645,781068,11,0,3,0,1,0,2,0,0,0,1,0,2,0,2,0,0
645,791123,27,2,4,1,2,1,2,2,2,1,0,0,3,0,0,0,7
645,785969,20,4,8,4,7,0,1,0,0,1,1,0,1,1,2,0,8
646,791949,40,11,12,10,10,1,2,1,2,3,10,2,1,0,3,1,24
646,776014,38,6,12,5,10,1,2,7,8,1,10,4,3,1,3,0,20
646,797691,29,3,5,3,5,0,0,0,2,0,7,6,2,0,7,3,6
646,780747,21,3,6,3,3,0,3,3,3,1,2,4,5,0,3,0,9
646,776363,44,7,12,4,6,3,6,1,2,0,5,3,2,2,5,0,18
646,784336,9,2,2,2,2,0,0,0,0,2,1,0,2,0,1,0,4
646,791946,41,3,10,2,4,1,6,11,13,0,1,3,3,1,3,1,18
646,791948,3,0,1,0,1,0,0,0,0,0,3,0,1,0,0,1,0
647,791230,19,2,4,1,2,1,2,0,0,2,3,2,0,2,0,0,5
647,785557,40,11,21,8,16,3,5,0,0,6,7,0,3,4,2,1,25
647,791228,30,7,14,6,10,1,4,5,6,2,2,3,4,3,1,1,20
647,796932,38,3,18,3,10,0,8,3,4,0,1,7,3,2,3,0,9
647,785624,39,6,13,2,2,4,11,3,3,1,0,1,3,0,0,0,19
647,785556,25,4,13,4,10,0,3,4,4,1,4,5,3,2,3,0,12
647,796935,8,1,4,0,1,1,3,0,0,2,1,0,4,0,1,0,3
647,791226,5,0,1,0,1,0,0,0,0,0,0,0,3,0,0,0,0
647,791227,21,1,3,0,1,1,2,0,0,0,0,0,1,0,0,0,3
647,781198,0,0,0,0,0,0,0,0,0,0,0,0,0,0,0,0,0
648,796755,7,1,2,1,2,0,0,0,0,0,1,1,3,0,2,0,2
648,790846,31,3,9,2,7,1,2,2,2,2,6,0,2,1,4,0,9
648,780315,24,0,3,0,1,0,2,0,0,1,3,2,4,1,3,0,0
648,791099,36,4,13,2,7,2,6,0,0,1,2,1,0,1,1,1,10
648,785470,24,4,9,4,6,0,3,4,4,0,2,1,2,3,1,0,12
648,785586,37,3,8,2,6,1,2,6,8,1,6,5,0,3,3,0,13
648,796754,14,4,6,3,3,1,3,0,3,0,3,0,4,2,2,0,9
648,780795,12,0,3,0,1,0,2,0,0,1,2,0,4,0,0,1,0
648,780814,0,0,0,0,0,0,0,0,0,0,0,0,0,0,0,0,0
648,791100,15,2,4,0,0,2,4,2,2,0,1,1,1,1,2,0,8
649,796699,17,1,6,1,2,0,4,1,2,1,0,1,3,0,4,0,3
649,790981,17,0,2,0,1,0,1,1,3,0,2,0,0,2,2,0,1
649,790976,20,1,4,1,4,0,0,2,3,4,1,0,2,0,2,1,4
649,796700,23,3,11,2,4,1,7,1,4,0,7,3,4,2,3,0,8
649,790979,30,1,6,0,1,1,5,0,1,1,6,3,2,1,3,0,3
649,796701,15,3,4,3,4,0,0,0,0,1,0,0,3,0,4,2,6
649,788820,29,6,14,1,2,5,12,1,3,2,3,2,4,0,0,0,18
649,790983,23,3,5,3,4,0,1,2,4,2,6,2,2,1,1,2,8
649,790978,17,2,9,2,6,0,3,0,2,2,2,1,0,0,2,0,4
649,790980,5,0,0,0,0,0,0,0,0,0,1,0,0,1,0,0,0
649,796698,4,0,1,0,0,0,1,0,0,0,0,0,0,1,0,0,0
650,792167,32,4,10,4,10,0,0,2,5,5,9,1,3,0,2,4,10
650,797766,21,1,3,0,1,1,2,0,0,0,6,0,3,0,1,1,3
650,797767,18,1,2,1,2,0,0,0,1,0,1,2,3,1,2,0,2
650,791372,30,4,11,1,1,3,10,0,0,0,1,1,3,0,1,0,11
650,792164,33,8,17,6,11,2,6,8,12,1,3,1,1,1,4,1,26
650,797777,7,2,3,2,3,0,0,0,0,1,1,0,1,1,1,0,4
650,792170,3,0,0,0,0,0,0,0,0,0,0,0,2,0,0,0,0
650,797772,22,1,3,1,2,0,1,0,0,2,1,4,4,0,3,0,2
650,792163,18,0,2,0,2,0,0,0,0,1,3,0,1,0,0,0,0
650,797764,8,1,1,0,0,1,1,0,0,0,0,1,0,1,0,0,3
650,780974,8,0,6,0,4,0,2,0,0,2,2,0,1,0,2,0,0
652,776462,18,1,3,1,2,0,1,0,0,1,3,0,5,0,0,1,2
652,785635,22,2,4,2,4,0,0,1,3,2,3,1,5,1,2,0,5
652,786440,30,1,11,1,7,0,4,6,6,1,0,2,1,1,1,1,8
652,786720,34,4,8,4,5,0,3,2,3,0,3,4,3,1,1,0,10
652,781199,36,9,16,7,12,2,4,6,8,2,5,3,1,1,1,0,26
652,775642,24,2,5,2,5,0,0,2,4,0,3,0,2,0,1,0,6
652,791629,9,1,1,0,0,1,1,0,0,0,1,1,3,1,3,0,3
652,786439,10,2,2,2,2,0,0,0,0,1,0,0,5,2,0,0,4
652,796974,12,1,4,0,1,1,3,0,0,0,0,1,0,0,1,0,3
652,791628,5,0,0,0,0,0,0,0,0,0,1,0,0,0,0,2,0
653,775418,11,3,4,3,4,0,0,0,2,0,2,0,3,0,0,0,6
653,786357,34,3,5,2,4,1,1,3,5,0,7,0,4,0,2,0,10
653,780306,37,4,14,4,12,0,2,5,8,7,5,2,2,0,2,0,13
653,797116,31,3,13,2,7,1,6,3,4,2,3,1,4,0,3,0,10
653,780312,27,2,6,0,1,2,5,1,2,1,3,2,5,2,3,0,7
653,786358,10,0,2,0,0,0,2,2,2,1,2,1,2,2,1,0,2
653,791537,28,3,8,2,4,1,4,9,9,2,2,2,2,0,2,0,16
653,775565,22,0,1,0,0,0,1,0,0,0,1,1,2,0,1,0,0
654,785999,30,3,6,3,6,0,0,6,7,2,3,1,0,0,2,1,12
654,785389,30,9,14,4,8,5,6,0,0,0,3,2,2,0,5,0,23
654,775654,14,2,2,2,2,0,0,3,4,2,3,1,3,0,2,2,7
654,796399,29,1,4,1,2,0,2,0,0,0,5,3,2,0,3,1,2
654,796398,26,0,3,0,2,0,1,0,0,1,2,5,3,2,0,0,0
654,791640,16,4,9,3,5,1,4,0,1,2,3,3,4,0,1,2,9
654,775171,21,2,9,0,2,2,7,0,0,0,4,1,0,0,0,0,6
654,785255,19,3,5,2,3,1,2,0,0,3,5,0,5,0,1,1,7
654,796400,7,0,2,0,2,0,0,0,0,2,1,0,0,0,1,0,0
654,796403,4,1,3,1,3,0,0,0,0,0,0,1,0,0,0,0,2
654,796402,2,0,1,0,0,0,1,0,0,0,1,0,1,0,0,0,0
654,796401,2,0,0,0,0,0,0,0,0,0,0,0,0,0,0,0,0
655,785935,33,5,13,2,9,3,4,2,2,1,0,1,0,0,1,0,15
655,781352,14,2,5,2,5,0,0,3,4,0,1,0,3,0,2,1,7
655,776128,29,1,7,0,3,1,4,0,0,1,1,2,2,3,0,0,3
655,781340,29,2,6,2,4,0,2,4,6,1,5,1,1,2,1,0,8
655,792227,30,0,3,0,1,0,2,0,0,0,3,0,3,0,0,1,0
655,797881,6,1,3,1,3,0,0,0,0,1,0,1,0,0,0,0,2
655,797889,18,1,4,1,4,0,0,0,2,2,3,0,0,0,0,0,2
655,781351,13,1,4,1,3,0,1,2,2,1,2,1,3,1,0,0,4
655,792228,3,0,1,0,1,0,0,0,0,0,1,1,0,0,0,0,0
655,792223,25,4,7,4,5,0,2,2,2,0,3,0,2,0,1,0,10
656,791522,26,7,8,5,5,2,3,4,5,1,8,3,2,1,3,1,20
656,786351,23,3,9,2,2,1,7,4,4,2,5,2,2,3,1,0,11
656,786348,22,2,5,0,1,2,4,2,2,1,2,1,1,1,0,0,8
656,797146,25,4,10,0,2,4,8,9,10,1,3,2,1,0,3,0,21
656,797143,29,4,9,2,3,2,6,0,2,0,5,5,2,0,2,0,10
656,785479,19,2,3,1,1,1,2,0,0,1,8,0,4,0,1,1,5
656,797142,14,5,8,5,7,0,1,2,2,5,1,0,3,1,0,1,12
656,797147,24,1,4,0,0,1,4,2,4,1,2,3,3,2,0,0,5
656,797148,8,2,3,2,3,0,0,0,0,1,3,0,2,0,1,0,4
656,786826,6,0,1,0,0,0,1,0,0,0,1,0,0,0,0,0,0
656,786771,2,0,0,0,0,0,0,0,0,0,1,0,0,0,1,0,0
656,797145,2,0,0,0,0,0,0,0,0,0,0,0,0,0,0,0,0
657,791512,11,0,1,0,1,0,0,2,4,2,3,0,5,0,1,0,2
657,786338,18,0,7,0,3,0,4,0,0,4,2,1,0,0,1,0,0
657,792050,18,1,5,1,3,0,2,1,2,0,0,0,0,1,1,0,3
657,785347,23,4,11,1,4,3,7,2,4,0,0,0,1,3,1,0,13
657,775601,28,5,11,4,7,1,4,6,9,0,8,3,3,0,2,0,17
657,792052,15,0,5,0,3,0,2,0,0,0,1,0,1,0,2,0,0
657,786825,11,1,2,1,2,0,0,0,0,0,1,0,5,0,2,0,2
657,792047,10,1,3,1,3,0,0,0,0,1,0,0,2,0,0,1,2
657,797648,13,1,2,0,0,1,2,0,0,0,1,0,0,0,3,0,3
657,775476,14,0,4,0,1,0,3,0,0,0,0,0,1,0,0,0,0
657,792045,12,0,3,0,3,0,0,1,2,3,0,1,1,0,1,0,1
657,792051,5,0,1,0,0,0,1,0,0,0,0,0,1,0,0,0,0
657,780862,13,0,2,0,0,0,2,0,0,3,1,0,0,0,1,0,0
657,797647,7,0,2,0,0,0,2,0,0,0,1,1,0,0,0,0,0
657,792048,2,0,0,0,0,0,0,0,0,0,0,0,0,0,0,0,0
658,785828,19,2,7,1,4,1,3,0,0,3,3,0,1,0,2,0,5
658,785402,18,2,3,2,3,0,0,3,4,1,6,2,3,0,2,1,7
658,791700,27,1,4,0,2,1,2,1,3,0,1,2,2,0,2,1,4
658,792118,35,6,12,4,9,2,3,3,3,0,6,6,2,3,4,0,17
658,782593,23,3,9,2,3,1,6,0,0,0,2,3,5,0,1,0,7
658,791699,24,6,10,2,3,4,7,2,2,3,8,2,2,0,1,1,18
658,791702,18,0,3,0,2,0,1,0,0,0,5,0,1,1,1,0,0
658,797523,23,2,2,2,2,0,0,1,5,2,2,1,0,0,1,0,5
658,797526,13,1,3,0,0,1,3,4,4,0,2,0,0,0,0,0,7
659,786550,34,4,9,2,3,2,6,2,4,2,6,1,5,2,1,2,12
659,780177,12,1,2,1,2,0,0,0,0,1,2,0,2,0,2,0,2
659,792007,26,4,11,2,7,2,4,0,1,4,5,2,4,0,0,1,10
659,792009,28,8,18,8,14,0,4,3,7,2,3,2,0,1,0,0,19
659,792006,26,1,6,1,4,0,2,0,0,0,1,3,0,2,2,0,2
659,792011,7,1,2,1,2,0,0,0,0,0,0,0,3,0,0,1,2
659,776054,24,3,7,1,3,2,4,1,2,2,2,1,4,2,0,0,9
659,791689,10,0,3,0,1,0,2,0,0,0,2,1,0,0,0,0,0
659,786552,20,0,7,0,3,0,4,0,2,1,1,3,2,1,1,0,0
659,776273,13,1,3,1,3,0,0,0,0,0,2,2,0,0,0,0,2
660,780059,21,4,8,4,8,0,0,0,0,1,3,2,4,1,5,1,8
660,776110,20,2,4,1,1,1,3,3,3,0,3,1,1,1,0,1,8
660,790944,23,3,13,1,8,2,5,2,2,1,2,0,3,0,2,0,10
660,780061,29,3,7,2,3,1,4,0,1,3,3,0,3,0,0,1,7
660,786754,24,6,11,5,8,1,3,1,1,0,0,2,3,3,3,0,14
660,790943,20,1,6,1,4,0,2,1,2,0,3,1,2,1,1,0,3
660,780058,13,2,6,1,2,1,4,0,0,0,5,1,1,0,0,1,5
660,796496,18,1,3,1,1,0,2,1,2,0,1,0,1,1,2,0,3
660,796494,18,0,2,0,1,0,1,0,2,0,2,3,2,2,2,0,0
660,796495,5,1,4,0,1,1,3,0,0,0,0,0,0,1,0,1,3
660,796497,4,0,0,0,0,0,0,0,0,0,1,0,0,0,0,0,0
660,790941,4,0,1,0,0,0,1,1,2,0,0,0,0,0,0,0,1
660,796499,1,1,2,1,1,0,1,0,0,2,0,0,0,0,0,0,2
661,792143,31,1,4,0,2,1,2,0,0,1,7,0,2,3,2,2,3
661,797753,29,8,15,5,10,3,5,0,0,0,8,3,3,1,6,0,19
661,780953,29,6,10,5,8,1,2,0,0,2,5,3,5,0,3,3,13
661,786287,31,7,12,6,10,1,2,0,4,0,6,2,2,0,3,0,15
661,780955,34,4,9,3,7,1,2,4,5,2,2,4,0,1,3,0,13
661,786293,14,1,4,1,4,0,0,3,4,1,0,2,2,2,0,0,5
661,792147,9,1,1,1,1,0,0,1,2,0,2,1,1,1,0,0,3
661,797748,7,1,1,1,1,0,0,4,4,0,2,0,0,0,1,0,6
661,797750,4,1,1,0,0,1,1,0,0,0,0,0,1,0,2,0,3
661,797751,3,1,2,1,2,0,0,0,0,0,0,0,1,0,0,0,2
661,786302,3,0,0,0,0,0,0,0,0,0,1,0,0,0,0,0,0
661,786301,2,0,0,0,0,0,0,0,0,0,0,0,1,0,0,0,0
661,797742,3,0,1,0,0,0,1,0,0,0,1,0,0,0,0,0,0
661,786294,1,0,0,0,0,0,0,0,0,0,0,0,0,0,0,0,0
664,791401,28,5,12,5,12,0,0,7,9,2,2,0,3,1,5,1,17
664,780125,31,1,5,1,4,0,1,2,4,2,4,1,2,1,3,2,4
664,785931,17,0,4,0,4,0,0,3,4,0,2,1,3,0,0,0,3
664,780118,28,2,7,2,7,0,0,4,5,0,2,2,1,0,0,0,8
664,791400,31,2,7,1,3,1,4,1,2,1,6,1,0,0,0,0,6
664,786837,17,1,4,0,2,1,2,1,3,0,1,0,2,0,1,0,4
664,797125,20,0,3,0,2,0,1,2,2,1,4,0,2,0,2,1,2
664,797130,16,0,4,0,2,0,2,0,0,0,0,1,4,0,1,0,0
664,797126,4,0,0,0,0,0,0,0,0,0,2,0,0,0,1,0,0
664,797132,8,0,0,0,0,0,0,0,0,0,0,0,0,0,0,0,0
665,796469,12,1,4,1,1,0,3,0,0,0,6,0,5,0,3,1,2
665,779981,14,1,5,1,5,0,0,6,8,1,6,0,4,0,2,1,8
665,785463,35,3,11,2,8,1,3,6,6,0,3,2,2,0,1,0,13
665,779978,35,6,11,4,6,2,5,2,2,1,1,3,3,2,4,0,16
665,776003,25,5,16,3,6,2,10,0,0,0,2,2,3,1,2,0,12
665,790923,13,2,2,2,2,0,0,0,0,3,2,2,5,0,0,0,4
665,785462,12,0,1,0,0,0,1,1,3,1,1,0,3,0,0,1,1
665,779980,20,2,4,2,4,0,0,0,0,2,5,0,1,0,0,0,4
665,785466,31,2,3,0,0,2,3,0,0,3,8,4,2,3,1,0,6
665,790924,3,0,0,0,0,0,0,0,0,0,0,0,0,0,1,0,0
666,785388,21,4,12,4,12,0,0,0,0,5,9,2,2,0,4,1,8
666,780370,23,4,8,3,4,1,4,0,0,2,4,0,1,1,1,0,9
666,790840,27,7,11,3,4,4,7,3,3,1,3,3,2,0,1,0,21
666,790841,30,2,5,0,1,2,4,0,0,0,2,6,3,1,0,0,6
666,780373,29,6,9,0,0,6,9,2,2,0,1,7,1,0,0,0,20
666,796393,19,4,5,4,5,0,0,5,6,3,4,0,4,0,3,0,13
666,790839,20,3,4,2,2,1,2,0,0,1,1,1,1,1,1,0,7
666,796396,22,1,3,0,0,1,3,0,0,0,2,6,0,1,2,0,3
666,790838,3,1,1,0,0,1,1,0,0,0,0,1,0,0,0,0,3
666,788752,3,1,1,0,0,1,1,0,0,0,0,1,0,0,0,0,3
666,796394,3,0,1,0,0,0,1,0,0,0,0,0,0,0,0,0,0
667,797529,18,1,4,1,2,0,2,2,2,0,0,0,3,2,2,0,4
667,797527,30,2,6,2,5,0,1,2,2,1,2,1,0,1,2,0,6
667,791936,29,4,8,4,8,0,0,0,1,7,1,3,0,0,2,0,8
667,797532,34,3,9,2,4,1,5,7,10,0,3,7,2,4,2,0,14
667,785988,24,2,11,1,5,1,6,0,0,0,2,0,1,0,0,0,5
667,791932,6,0,1,0,0,0,1,0,0,0,0,0,1,1,0,0,0
667,791933,15,0,2,0,0,0,2,0,1,0,0,0,0,0,0,0,0
667,791931,6,1,3,0,1,1,2,0,0,0,0,0,1,0,2,0,3
667,785688,1,0,0,0,0,0,0,0,0,0,0,0,0,0,0,0,0
667,797530,12,1,4,1,3,0,1,0,0,0,0,0,3,0,0,0,2
667,797531,12,3,4,3,4,0,0,0,0,1,0,0,0,0,0,0,6
667,797528,7,0,1,0,0,0,1,0,0,0,0,0,1,0,0,0,0
667,791935,6,1,1,1,1,0,0,0,0,0,0,0,0,0,1,0,2
668,786772,12,0,0,0,0,0,0,1,2,1,2,0,1,0,0,0,1
668,781484,37,2,12,1,2,1,10,2,3,0,6,1,3,4,0,3,7
668,786769,35,1,5,1,4,0,1,2,2,1,3,0,1,0,2,1,4
668,786024,31,3,10,3,7,0,3,0,0,0,2,2,3,1,3,0,6
668,780002,39,8,17,6,14,2,3,0,1,1,7,4,3,2,3,0,18
668,785441,4,0,0,0,0,0,0,0,0,0,2,0,2,0,2,1,0
668,791967,16,1,5,1,4,0,1,0,0,0,2,0,1,1,1,0,2
668,790823,3,0,1,0,1,0,0,0,0,0,0,0,1,0,0,0,0
668,791970,23,1,4,1,2,0,2,2,2,1,1,0,1,0,0,0,4
669,776344,25,4,13,4,11,0,2,0,0,6,6,1,3,0,4,0,8
669,775821,26,9,15,9,14,0,1,3,4,1,3,0,3,0,3,0,21
669,792453,35,1,4,0,3,1,1,1,2,0,9,9,2,0,1,0,4
669,785131,35,2,9,1,3,1,6,0,2,1,8,4,1,1,4,0,5
669,781538,30,3,5,1,2,2,3,1,2,0,1,3,3,2,1,0,9
669,785152,21,1,6,1,6,0,0,0,0,5,4,0,3,0,0,0,2
669,798115,24,2,9,0,1,2,8,0,0,0,2,1,2,0,2,0,6
669,792323,3,0,0,0,0,0,0,2,3,0,1,0,0,0,0,0,2
669,776233,1,0,0,0,0,0,0,0,0,0,0,0,1,0,0,0,0
670,792143,35,1,9,0,0,1,9,0,0,0,5,2,2,3,2,2,3
670,797753,30,4,9,2,5,2,4,0,0,2,2,1,4,2,3,1,10
670,780953,22,4,8,3,5,1,3,4,5,0,1,0,4,1,2,1,13
670,786287,36,5,9,5,8,0,1,2,4,0,1,1,2,3,1,1,12
670,780955,39,6,13,5,11,1,2,5,5,0,4,4,3,4,2,0,18
670,792147,16,0,2,0,2,0,0,3,4,0,2,1,2,1,1,1,3
670,797748,5,0,1,0,0,0,1,0,0,0,0,0,0,0,1,0,0
670,786302,9,0,0,0,0,0,0,3,4,1,1,0,1,0,0,1,3
670,797751,8,0,0,0,0,0,0,1,2,0,1,0,1,0,1,0,1
671,790856,20,4,5,4,5,0,0,2,3,2,4,0,2,0,4,0,10
671,780452,30,4,8,4,8,0,0,2,5,5,4,1,4,0,0,0,10
671,796409,27,3,8,1,4,2,4,3,3,1,3,1,3,0,3,0,11
671,796408,36,6,18,4,12,2,6,2,2,1,2,2,3,0,5,1,16
671,796407,34,3,5,3,5,0,0,4,6,1,6,1,1,1,4,0,10
671,796410,19,2,3,2,3,0,0,0,0,1,6,4,2,2,3,4,4
671,780450,16,1,3,1,2,0,1,2,2,0,1,0,1,2,2,0,4
671,796411,9,0,0,0,0,0,0,0,3,0,0,0,4,1,0,0,0
671,796413,7,0,1,0,0,0,1,0,0,1,0,2,2,0,2,0,0
671,796412,2,1,1,1,1,0,0,0,0,0,0,0,0,0,0,0,2
672,776004,24,6,8,6,7,0,1,2,3,3,5,2,1,0,2,0,14
672,780358,19,5,9,2,5,3,4,0,0,0,4,0,3,0,1,2,13
672,775011,23,5,9,3,4,2,5,1,1,0,3,0,2,0,3,1,13
672,780357,23,3,6,1,3,2,3,2,2,0,3,1,1,1,0,0,10
672,775018,23,2,6,2,5,0,1,0,0,0,4,5,0,0,0,0,4
672,796484,16,2,4,2,3,0,1,0,0,0,1,1,1,1,0,1,4
672,790930,20,5,7,4,5,1,2,0,0,3,12,4,1,2,3,2,11
672,796480,19,1,4,1,4,0,0,0,0,2,3,1,2,0,1,1,2
672,776270,15,2,2,2,2,0,0,0,0,0,1,3,1,0,0,0,4
672,796485,7,1,2,1,1,0,1,0,0,0,0,0,2,0,0,0,2
672,796483,3,1,1,1,1,0,0,0,0,0,0,0,0,0,0,0,2
672,785496,2,0,0,0,0,0,0,0,0,1,0,0,1,0,0,0,0
672,796482,2,0,1,0,0,0,1,0,0,0,0,0,0,0,0,0,0
672,796486,2,1,1,0,0,1,1,0,0,0,0,0,0,0,0,0,3
672,785491,2,0,1,0,1,0,0,0,0,0,0,1,0,0,0,0,0
673,791321,28,2,6,2,6,0,0,0,0,1,2,0,2,0,2,0,4
673,796656,27,4,11,4,11,0,0,0,0,1,4,0,2,0,0,1,8
673,791320,30,3,12,2,9,1,3,2,3,1,1,0,1,1,2,1,9
673,785912,27,4,12,2,5,2,7,2,6,0,3,1,2,1,2,0,12
673,781511,37,2,12,2,7,0,5,2,2,0,5,2,1,1,1,0,6
673,796653,14,0,2,0,1,0,1,0,0,0,0,0,2,0,1,0,0
673,796657,11,1,1,1,1,0,0,0,0,1,0,0,0,0,0,0,2
673,791323,17,0,1,0,0,0,1,1,2,0,2,1,0,0,0,0,1
673,796652,3,0,0,0,0,0,0,0,0,0,0,0,0,0,2,0,0
673,796654,1,0,0,0,0,0,0,0,0,0,1,1,0,0,0,0,0
673,796651,1,0,0,0,0,0,0,0,0,0,0,0,0,0,0,0,0
673,796655,4,0,0,0,0,0,0,0,0,0,0,0,0,0,0,0,0
674,781669,37,8,15,4,8,4,7,2,2,0,6,4,3,2,5,0,22
674,792380,33,4,6,4,5,0,1,3,3,0,3,1,1,1,2,0,11
674,781672,23,2,6,2,6,0,0,2,4,2,9,1,3,1,1,0,6
674,792379,36,8,14,6,8,2,6,1,1,3,2,1,3,3,2,1,19
674,786765,25,3,8,3,6,0,2,7,7,0,7,1,3,1,3,1,13
674,792383,17,2,5,2,4,0,1,5,6,2,6,2,1,1,1,0,9
674,781668,3,0,0,0,0,0,0,0,0,0,0,0,1,0,1,0,0
674,797852,8,0,1,0,1,0,0,0,0,0,0,1,3,0,0,0,0
674,781671,2,0,0,0,0,0,0,0,0,0,0,0,0,0,0,0,0
674,786764,7,2,2,2,2,0,0,0,0,0,1,1,0,0,3,0,4
674,797854,9,0,3,0,1,0,2,0,0,0,1,1,1,0,0,0,0
675,791507,13,3,4,3,4,0,0,0,0,1,1,0,5,0,1,0,6
675,797168,38,6,21,5,13,1,8,2,2,1,1,6,1,3,2,0,15
675,797174,32,3,8,1,5,2,3,0,1,3,4,2,3,1,0,0,8
675,775357,38,5,15,3,7,2,8,6,9,0,4,2,2,0,2,0,18
675,791505,12,1,2,1,1,0,1,0,0,0,0,0,0,2,1,0,2
675,786699,27,3,5,3,5,0,0,2,3,2,6,1,3,1,2,2,8
675,791506,9,1,2,0,0,1,2,0,0,0,0,0,2,1,2,1,3
675,797169,7,0,0,0,0,0,0,0,0,0,1,0,2,0,1,0,0
675,791510,24,4,9,4,5,0,4,3,7,2,5,2,3,1,1,1,11
676,781403,34,7,12,4,4,3,8,0,0,0,6,1,2,0,2,0,17
676,792654,29,7,11,7,11,0,0,2,3,2,5,1,4,0,2,0,16
676,781400,38,5,15,3,4,2,11,5,6,2,4,3,3,1,2,0,17
676,780524,29,3,4,1,2,2,2,0,0,5,4,1,3,2,5,0,8
676,786857,12,0,4,0,2,0,2,1,4,2,1,0,0,0,1,1,1
676,792653,11,0,1,0,1,0,0,0,0,1,4,0,0,0,0,3,0
676,775893,28,3,7,0,2,3,5,3,4,0,1,7,3,0,1,0,12
676,797305,7,0,2,0,1,0,1,0,0,0,1,0,0,0,0,0,0
676,797301,12,0,4,0,2,0,2,0,0,0,0,0,0,0,0,0,0
677,792486,27,3,6,3,3,0,3,0,0,1,5,1,0,2,0,0,6
677,785772,25,4,7,4,7,0,0,0,1,2,4,1,3,0,2,1,8
677,785766,34,8,14,5,7,3,7,1,1,1,7,3,1,1,0,0,20
677,780543,32,10,15,5,8,5,7,3,5,1,2,1,2,2,1,0,28
677,785778,17,1,3,1,2,0,1,0,0,0,2,1,3,0,3,0,2
677,792481,15,3,6,2,4,1,2,0,2,3,0,0,0,1,1,0,7
677,792482,12,0,3,0,0,0,3,0,0,0,1,1,0,1,0,0,0
677,797419,16,1,2,1,2,0,0,0,0,0,3,2,2,1,0,0,2
677,792489,9,0,3,0,2,0,1,0,0,0,0,0,3,0,0,0,0
677,780546,13,2,5,2,3,0,2,1,1,1,2,0,0,0,0,0,5
678,791531,18,0,4,0,1,0,3,0,0,0,3,0,1,1,0,0,0
678,791534,27,3,9,3,7,0,2,2,2,2,7,2,5,3,1,1,8
678,797127,35,7,9,5,6,2,3,5,6,2,0,2,2,0,3,0,21
678,791528,39,5,10,3,6,2,4,5,8,0,6,8,3,4,3,0,17
678,775045,39,7,16,4,11,3,5,1,2,2,4,4,2,1,3,0,18
678,797124,27,3,5,2,4,1,1,2,2,1,4,0,0,0,0,0,9
678,791527,11,1,2,1,2,0,0,0,0,1,1,0,5,0,0,0,2
678,797131,1,0,0,0,0,0,0,0,0,0,0,0,0,0,1,0,0
678,797129,1,0,0,0,0,0,0,0,0,0,0,0,0,0,0,0,0
678,791530,1,0,0,0,0,0,0,0,0,0,0,0,0,0,0,0,0
678,797123,1,0,0,0,0,0,0,0,0,0,0,0,0,0,0,0,0
679,776100,35,1,2,0,1,1,1,0,1,3,4,1,2,0,2,0,3
679,785991,29,5,11,5,8,0,3,3,3,4,11,0,1,0,6,5,13
679,781406,30,9,14,9,13,0,1,1,2,0,2,1,2,1,1,0,19
679,781401,22,2,4,2,3,0,1,1,2,0,0,0,4,3,4,1,5
679,775317,24,0,4,0,2,0,2,0,2,0,2,0,4,0,3,0,0
679,781029,25,1,6,0,0,1,6,0,0,0,1,1,2,0,2,0,3
679,797762,16,2,5,2,4,0,1,0,1,0,2,3,2,1,1,0,4
679,792133,10,2,5,1,3,1,2,0,0,0,0,0,0,0,0,0,5
679,797760,9,1,2,1,1,0,1,0,0,0,0,1,0,0,0,0,2
680,797967,35,6,15,6,13,0,2,5,6,2,5,1,2,2,2,0,17
680,797962,29,1,2,1,2,0,0,2,5,4,6,1,0,1,1,1,4
680,797970,29,4,12,2,5,2,7,5,6,0,3,3,2,0,3,0,15
680,781453,36,3,9,3,6,0,3,8,8,0,5,5,1,3,1,0,14
680,774869,36,4,9,0,1,4,8,0,0,1,2,2,1,2,0,0,12
680,792254,5,0,2,0,2,0,0,0,0,0,1,1,1,0,1,0,0
680,792256,11,1,4,1,4,0,0,0,0,2,3,0,0,2,0,0,2
680,797961,4,0,0,0,0,0,0,0,0,0,0,1,1,0,0,0,0
680,786098,15,2,6,0,2,2,4,0,0,0,0,1,0,0,0,0,6
681,785681,28,3,4,3,4,0,0,0,0,4,6,3,2,0,0,5,6
681,796782,23,3,8,1,4,2,4,0,0,0,4,1,4,2,0,0,8
681,791126,27,5,8,5,7,0,1,1,2,3,5,3,5,0,2,0,11
681,791124,36,7,15,7,14,0,1,0,0,2,2,2,2,0,2,0,14
681,780050,31,0,7,0,5,0,2,1,2,1,6,1,2,0,6,0,1
681,784479,8,0,5,0,1,0,4,0,0,1,2,1,3,0,2,0,0
681,796786,19,4,8,1,1,3,7,0,1,1,2,1,1,0,1,0,11
681,796788,2,0,0,0,0,0,0,0,0,0,0,0,2,0,1,0,0
681,796784,12,1,4,0,1,1,3,0,0,1,1,0,0,0,1,0,3
681,796783,10,2,3,2,2,0,1,0,0,0,1,0,1,1,0,0,4
681,791125,4,1,1,0,0,1,1,0,0,0,0,0,0,0,1,0,3
682,791113,22,2,5,2,5,0,0,0,1,2,6,2,2,1,2,3,4
682,780809,32,4,9,4,7,0,2,2,2,3,7,5,1,3,5,1,10
682,796767,34,5,13,4,11,1,2,4,7,0,2,0,3,0,6,0,15
682,791111,33,2,8,1,5,1,3,6,7,0,2,2,1,0,0,0,11
682,796765,20,0,1,0,1,0,0,0,0,0,1,0,4,0,2,0,0
682,796766,25,3,7,1,2,2,5,4,4,1,3,0,2,0,2,1,12
682,785614,3,0,0,0,0,0,0,0,0,0,0,0,1,0,0,0,0
682,780813,29,4,8,4,7,0,1,3,4,0,8,2,4,0,4,2,11
682,785618,2,0,0,0,0,0,0,0,0,0,0,0,0,0,0,0,0
683,797611,14,2,5,2,3,0,2,0,0,1,3,0,2,0,0,1,4
683,787524,30,2,6,0,2,2,4,6,7,0,6,0,3,1,3,3,12
683,791774,11,0,5,0,4,0,1,0,0,0,1,0,1,1,0,1,0
683,781019,31,4,14,4,14,0,0,3,3,1,3,6,3,6,1,0,11
683,780328,31,6,11,6,11,0,0,2,2,1,4,2,1,2,2,0,14
683,775541,14,1,2,1,1,0,1,2,4,0,3,1,1,1,0,0,4
683,787522,17,1,1,1,1,0,0,0,0,1,1,0,2,0,0,0,2
683,783269,19,3,5,1,2,2,3,0,0,1,0,0,3,1,3,1,8
683,791772,25,4,7,2,3,2,4,5,6,0,2,1,2,3,0,0,15
683,791722,8,0,1,0,1,0,0,0,0,0,0,0,2,0,2,0,0
684,791408,23,5,8,5,8,0,0,2,3,2,2,1,3,0,1,1,12
684,785894,37,3,9,0,2,3,7,1,1,0,2,2,3,1,1,0,10
684,780105,27,3,6,3,5,0,1,3,3,0,6,1,3,0,2,0,9
684,786183,31,1,8,0,1,1,7,0,0,0,4,1,1,0,1,0,3
684,785915,16,1,4,0,0,1,4,0,0,0,3,0,0,0,1,0,3
684,781131,34,4,9,3,7,1,2,5,7,2,6,14,2,1,1,0,14
684,791409,23,4,7,1,2,3,5,0,0,0,2,0,3,0,1,0,11
684,785914,7,1,1,1,1,0,0,0,0,1,1,0,1,1,0,0,2
684,780106,2,1,1,1,1,0,0,0,0,0,0,0,0,0,0,0,2
685,792370,36,4,10,4,7,0,3,4,7,0,1,2,0,1,2,0,12
685,792373,28,4,5,4,5,0,0,3,5,1,1,1,4,1,1,1,11
685,786739,32,4,8,4,8,0,0,0,0,0,1,2,3,1,1,0,8
685,797951,16,1,7,1,3,0,4,0,0,0,3,0,1,0,1,1,2
685,781598,13,1,7,1,6,0,1,0,0,0,3,0,4,0,3,0,2
685,775809,28,2,8,2,6,0,2,2,2,1,5,1,2,0,2,0,6
685,775303,20,2,2,2,2,0,0,0,2,0,3,0,0,0,0,0,4
685,797960,10,1,2,0,0,1,2,0,0,1,2,2,2,0,0,0,3
685,792368,5,1,3,1,1,0,2,0,0,1,0,1,0,0,0,0,2
685,797958,8,0,1,0,1,0,0,0,0,0,3,0,1,0,0,0,0
685,790499,4,0,0,0,0,0,0,0,0,0,1,0,0,0,0,0,0
686,774894,37,6,11,4,5,2,6,2,2,0,6,1,0,0,2,0,16
686,780107,34,5,6,2,3,3,3,1,2,2,5,4,2,0,2,1,14
686,781036,36,4,9,2,5,2,4,3,5,0,5,6,1,1,4,0,13
686,775833,26,3,7,3,7,0,0,4,4,1,7,0,3,0,1,1,10
686,775571,35,4,9,4,8,0,1,1,3,1,1,4,1,4,4,0,9
686,791178,10,1,2,1,2,0,0,0,0,0,0,1,1,0,1,0,2
686,796846,6,1,2,1,1,0,1,0,0,1,0,0,2,0,0,0,2
686,789925,13,0,1,0,1,0,0,0,0,0,0,0,1,1,1,0,0
686,796847,3,0,0,0,0,0,0,0,0,0,0,0,0,0,0,0,0
687,781181,27,5,6,2,3,3,3,0,0,0,2,1,2,0,0,0,13
687,791223,20,3,7,3,7,0,0,2,5,4,2,0,4,0,0,0,8
687,785571,29,3,14,3,12,0,2,0,0,1,1,4,0,0,2,0,6
687,791225,25,2,5,2,5,0,0,0,0,1,5,2,1,0,1,0,4
687,786436,23,0,3,0,3,0,0,1,2,1,2,2,0,0,2,1,1
687,791224,28,6,9,4,6,2,3,0,0,0,3,3,3,1,6,0,14
687,785564,17,4,10,3,5,1,5,0,0,2,1,0,2,1,0,0,9
687,775324,15,2,4,2,4,0,0,2,2,2,2,0,0,1,2,0,6
687,791811,10,1,2,1,2,0,0,0,0,0,1,0,2,0,0,0,2
687,796927,6,0,1,0,1,0,0,0,0,1,1,0,2,0,1,0,0
688,780138,22,11,14,11,13,0,1,1,2,3,4,0,1,1,1,1,23
688,780581,21,8,8,7,7,1,1,0,0,0,3,4,2,1,1,1,17
688,792152,18,5,10,2,4,3,6,0,0,0,0,1,2,3,1,0,13
688,792154,22,4,7,3,4,1,3,0,0,0,6,6,2,1,2,0,9
688,792158,20,1,2,1,2,0,0,0,0,3,7,3,4,1,0,1,2
688,797756,19,6,10,4,5,2,5,1,1,0,4,4,2,0,2,0,15
688,792162,12,3,4,2,3,1,1,0,0,0,6,1,0,1,2,0,7
688,792157,14,1,3,1,2,0,1,2,2,2,5,5,0,2,4,1,4
688,797755,12,2,2,2,2,0,0,0,1,0,0,0,2,0,1,1,4
688,792159,10,1,4,1,3,0,1,2,2,0,0,1,0,2,1,0,4
688,786014,15,1,3,1,1,0,2,0,0,0,2,2,2,2,2,0,2
688,785358,11,1,2,1,1,0,1,0,0,0,0,0,1,0,0,0,2
688,797759,4,0,0,0,0,0,0,0,0,0,0,0,0,0,0,0,0
690,785335,16,3,6,3,6,0,0,3,5,4,6,0,1,0,1,4,9
690,780303,23,4,6,4,5,0,1,4,7,1,6,0,0,1,0,2,12
690,791594,18,3,6,0,1,3,5,0,0,1,4,3,1,0,0,0,9
690,786349,19,4,6,4,5,0,1,0,0,0,1,4,0,1,0,1,8
690,781385,23,3,7,3,3,0,4,6,7,4,3,3,2,2,2,0,12
690,796670,5,0,0,0,0,0,0,1,2,2,2,0,1,1,1,1,1
690,796669,3,0,1,0,0,0,1,1,2,1,1,0,0,0,0,0,1
690,791011,12,4,9,3,7,1,2,2,3,4,1,3,1,0,1,0,11
690,796671,14,2,3,2,3,0,0,0,2,3,5,3,0,1,1,2,4
690,785337,18,6,10,6,7,0,3,0,0,2,1,2,2,1,0,2,12
690,796668,6,1,3,1,1,0,2,0,0,0,0,0,0,0,1,0,2
690,791013,6,1,1,1,1,0,0,1,2,0,3,0,1,1,2,0,3
690,791012,18,4,7,0,0,4,7,0,0,0,2,2,0,0,0,0,12
690,781221,19,3,9,2,4,1,5,2,2,1,2,1,0,1,0,0,9
692,780760,25,5,9,2,3,3,6,4,4,1,6,0,4,0,1,3,17
692,785799,17,1,3,1,3,0,0,2,2,1,3,0,2,2,1,0,4
692,791679,7,0,0,0,0,0,0,1,2,0,1,0,2,0,3,0,1
692,785800,24,3,13,1,7,2,6,1,2,0,2,0,2,1,1,0,9
692,797426,11,1,1,0,0,1,1,1,2,0,2,0,0,0,0,0,4
692,791678,11,0,0,0,0,0,0,0,0,0,0,0,2,0,0,0,0
692,785807,16,3,5,3,3,0,2,0,0,2,4,0,3,0,1,0,6
692,780553,27,8,17,8,14,0,3,3,4,2,2,3,3,1,3,0,19
692,791676,25,1,11,0,3,1,8,2,2,0,5,4,4,0,4,0,5
692,780554,27,1,6,1,3,0,3,0,0,7,3,1,4,3,3,0,2
692,791677,10,0,2,0,2,0,0,0,0,0,1,3,2,1,3,0,0
693,785459,14,3,10,3,9,0,1,0,0,1,1,0,1,0,1,1,6
693,797731,16,4,5,4,5,0,0,4,6,1,3,0,4,2,1,1,12
693,792064,6,1,2,0,0,1,2,0,0,0,0,0,1,0,0,0,3
693,788037,24,3,8,2,5,1,3,7,10,0,4,1,2,1,6,0,14
693,789102,37,3,5,3,5,0,0,8,11,0,8,7,3,3,1,0,14
693,792061,19,3,3,1,1,2,2,0,0,2,3,0,2,0,0,0,8
693,797730,12,0,6,0,5,0,1,0,0,2,4,0,0,1,1,0,0
693,789101,19,1,3,1,2,0,1,3,6,3,3,1,4,0,3,0,5
693,781367,28,3,10,2,7,1,3,2,2,0,2,1,0,3,2,0,9
693,781371,25,1,2,0,0,1,2,1,2,0,3,1,1,0,3,0,4
694,781439,22,7,15,5,10,2,5,7,11,3,2,1,3,1,4,0,23
694,781322,31,2,8,0,4,2,4,0,0,4,8,4,2,1,4,1,6
694,786571,30,3,9,2,5,1,4,6,7,0,6,0,4,1,2,0,13
694,780563,22,0,2,0,1,0,1,0,0,1,2,0,1,1,2,0,0
694,785989,27,3,7,3,6,0,1,4,5,0,5,4,3,3,1,0,10
694,781207,27,4,7,4,5,0,2,3,5,1,3,1,3,2,2,0,11
694,781419,23,4,11,2,4,2,7,1,2,0,4,0,2,0,0,0,11
694,791690,18,1,1,1,1,0,0,0,0,1,4,0,2,0,0,2,2
695,780828,30,8,19,7,13,1,6,8,9,1,10,5,3,0,0,0,25
695,792027,18,0,2,0,1,0,1,0,2,0,2,1,2,0,3,0,0
695,792032,36,7,16,3,7,4,9,6,7,1,4,2,5,2,4,0,24
695,785822,14,1,2,1,2,0,0,0,0,0,0,2,0,2,0,2,2
695,792031,33,3,8,1,3,2,5,0,0,1,3,1,0,0,2,0,8
695,761149,21,0,4,0,2,0,2,2,2,3,3,0,3,2,0,0,2
695,792029,12,0,3,0,2,0,1,0,0,0,1,0,1,0,1,1,0
695,792030,7,0,0,0,0,0,0,0,0,0,0,0,1,0,0,0,0
695,797636,16,2,5,2,5,0,0,0,0,1,2,1,2,0,2,0,4
695,797641,9,2,4,2,4,0,0,0,1,2,0,2,2,0,0,0,4
695,797637,4,0,2,0,0,0,2,0,0,0,0,0,2,0,0,0,0
696,797217,24,1,5,1,3,0,2,5,6,1,1,1,3,1,4,0,7
696,797218,31,4,13,4,9,0,4,4,4,1,5,1,1,1,3,0,12
696,797219,35,3,11,3,7,0,4,0,0,1,2,2,5,0,3,1,6
696,797222,30,3,7,3,6,0,1,1,1,3,9,0,4,0,1,8,7
696,781526,14,4,6,4,6,0,0,0,0,2,4,1,4,0,0,2,8
696,775697,23,4,11,2,6,2,5,2,4,2,0,2,0,2,3,0,12
696,797221,13,0,2,0,0,0,2,0,0,0,2,0,3,2,0,0,0
696,797223,10,0,0,0,0,0,0,1,2,0,1,1,3,1,0,1,1
696,791453,8,1,2,0,0,1,2,0,0,0,0,0,1,0,0,0,3
696,791846,12,2,4,2,3,0,1,2,3,2,1,0,2,0,1,0,6
697,779997,35,4,11,4,10,0,1,0,0,1,4,1,2,1,3,0,8
697,790808,38,2,10,2,6,0,4,4,8,6,7,0,3,2,0,2,8
697,785361,37,5,17,2,8,3,9,4,6,1,4,3,1,1,2,1,17
697,790810,31,8,16,6,11,2,5,5,8,3,7,0,4,0,3,0,23
697,785362,19,1,9,1,9,0,0,5,6,2,3,0,1,0,2,0,7
697,796370,9,0,2,0,1,0,1,0,0,0,0,0,3,0,0,0,0
697,790809,25,0,1,0,1,0,0,2,2,0,1,5,2,4,0,1,2
697,796368,2,0,1,0,0,0,1,0,0,1,0,0,0,0,0,0,0
697,774854,2,0,0,0,0,0,0,0,0,0,0,0,0,0,0,0,0
697,790811,2,0,0,0,0,0,0,0,0,0,0,0,0,0,0,0,0
698,786257,23,1,3,1,3,0,0,2,4,0,5,2,0,2,2,1,4
698,786263,21,5,13,5,10,0,3,0,0,2,4,2,1,0,0,0,10
698,797724,26,2,6,1,4,1,2,0,0,0,4,1,0,0,2,0,5
698,792122,24,7,9,2,2,5,7,0,0,1,6,0,0,0,1,0,19
698,775825,32,4,9,4,9,0,0,0,0,0,1,10,2,0,1,0,8
698,797721,9,0,4,0,1,0,3,0,0,1,1,0,1,0,0,1,0
698,792121,16,4,6,2,3,2,3,0,0,1,5,1,2,0,1,0,10
698,797725,15,1,3,1,2,0,1,1,2,2,0,0,1,2,1,0,3
698,792356,5,0,0,0,0,0,0,0,0,0,2,0,0,0,0,0,0
698,797722,12,2,2,0,0,2,2,2,2,0,1,0,3,0,2,0,8
698,786249,17,2,3,0,0,2,3,0,0,0,1,0,0,1,1,0,6
699,775806,29,2,9,2,7,0,2,2,3,0,2,0,0,0,0,0,6
699,775563,31,5,12,5,12,0,0,0,0,0,3,0,2,0,1,0,10
699,781011,19,1,4,1,4,0,0,0,0,3,3,3,4,2,0,1,2
699,797601,24,4,8,2,3,2,5,0,0,0,1,1,1,0,2,0,10
699,781012,19,1,4,1,3,0,1,0,0,0,1,1,0,1,4,0,2
699,775188,17,1,2,1,2,0,0,0,0,0,4,0,1,1,0,0,2
699,797604,12,2,3,1,1,1,2,0,0,1,1,2,0,0,0,1,5
699,786466,19,0,3,0,2,0,1,0,0,2,1,0,1,1,2,0,0
699,781424,6,0,1,0,0,0,1,0,0,1,0,0,0,0,1,0,0
699,775119,7,1,5,1,5,0,0,0,0,1,1,0,0,1,0,0,2
699,776157,17,4,8,1,2,3,6,0,0,0,1,0,1,0,1,0,11
702,774990,22,1,7,1,5,0,2,0,0,0,1,2,3,0,1,0,2
702,779976,25,3,11,1,6,2,5,0,1,0,4,4,0,0,0,0,8
702,785339,24,0,6,0,2,0,4,0,0,0,2,2,1,0,0,0,0
702,779857,24,5,13,4,9,1,4,0,0,4,2,0,0,0,2,3,11
702,785126,20,2,7,1,4,1,3,2,2,2,2,0,2,1,2,0,7
702,781586,13,0,3,0,3,0,0,2,2,2,0,0,0,0,3,0,2
702,791014,15,2,5,1,2,1,3,0,1,1,2,0,3,0,1,0,5
702,796674,17,0,4,0,0,0,4,0,0,2,1,2,0,0,2,0,0
702,796673,22,4,8,4,7,0,1,3,3,3,3,1,2,0,1,0,11
702,780142,7,1,2,0,0,1,2,1,2,0,1,0,1,1,0,0,4
702,796672,4,0,0,0,0,0,0,0,0,0,0,1,2,0,0,0,0
702,785961,4,0,1,0,1,0,0,0,0,1,0,0,0,2,1,0,0
702,786737,3,1,2,0,0,1,2,0,0,0,1,0,0,0,0,0,3
703,775260,32,7,13,5,9,2,4,0,0,0,2,4,2,0,3,0,16
703,786615,30,7,10,4,6,3,4,2,4,0,5,2,1,1,3,0,19
703,790890,9,0,2,0,1,0,1,0,0,0,1,0,0,0,1,0,0
703,790893,25,5,8,5,7,0,1,1,2,2,9,1,3,1,3,0,11
703,796444,29,8,12,7,11,1,1,0,0,3,8,0,1,0,1,2,17
703,775536,21,4,5,4,5,0,0,1,3,1,7,1,2,1,1,1,9
703,786732,25,1,5,1,3,0,2,3,3,0,1,3,4,0,0,0,5
703,790889,11,0,4,0,3,0,1,2,4,1,0,0,2,0,2,1,2
703,780702,14,0,1,0,1,0,0,0,0,1,0,0,1,0,0,0,0
703,796445,4,0,0,0,0,0,0,0,0,0,0,0,1,0,0,0,0
704,792294,19,2,3,2,3,0,0,3,3,1,1,1,1,2,2,0,7
704,775510,18,5,7,4,4,1,3,0,0,0,6,0,1,0,0,0,11
704,774976,14,6,7,6,6,0,1,1,2,2,3,0,1,0,0,3,13
704,792291,23,2,5,0,1,2,4,2,2,0,3,4,0,0,1,0,8
704,797865,22,1,3,1,2,0,1,0,0,0,2,4,0,3,0,0,2
704,792292,18,5,6,5,6,0,0,2,2,4,4,0,3,0,2,0,12
704,792293,15,3,6,2,3,1,3,0,0,0,0,2,1,0,1,0,7
704,786614,17,3,7,2,3,1,4,3,3,1,3,1,3,0,0,0,10
704,786762,14,2,4,2,3,0,1,0,0,0,4,2,0,0,0,0,4
704,786759,15,0,2,0,1,0,1,0,0,0,0,3,2,0,3,0,0
704,797864,11,0,3,0,1,0,2,0,0,0,1,1,1,0,0,0,0
704,797866,1,0,1,0,0,0,1,0,0,0,0,0,0,0,0,0,0
704,780349,1,0,1,0,1,0,0,0,0,1,0,0,0,0,0,0,0
704,797867,5,1,2,1,1,0,1,0,0,0,2,0,0,0,0,0,2
704,786761,6,0,1,0,1,0,0,0,0,0,0,0,2,0,0,0,0
704,792296,1,0,0,0,0,0,0,0,0,0,0,0,0,0,0,0,0
705,786131,24,3,8,1,2,2,6,1,2,0,3,0,2,0,3,0,9
705,780904,23,5,8,5,8,0,0,1,2,0,4,0,0,1,0,0,11
705,797686,31,0,2,0,1,0,1,3,4,0,3,5,1,0,2,0,3
705,797688,26,1,4,0,2,1,2,0,0,2,3,0,2,1,1,0,3
705,786145,24,5,12,3,6,2,6,0,0,0,0,0,0,1,1,0,12
705,797685,21,0,4,0,3,0,1,0,0,0,1,3,0,0,0,0,0
705,775251,19,2,7,1,1,1,6,2,2,1,0,2,2,1,2,0,7
705,797684,9,0,2,0,2,0,0,1,2,0,2,0,3,1,0,0,1
705,792096,12,0,1,0,0,0,1,0,0,0,0,0,1,0,0,0,0
705,792100,7,1,1,1,1,0,0,0,1,0,1,0,1,0,0,0,2
705,792099,2,1,1,0,0,1,1,0,0,0,0,0,0,0,0,0,3
705,786141,2,0,0,0,0,0,0,0,0,0,1,0,0,0,0,0,0
706,797533,23,4,13,2,7,2,6,8,8,2,1,2,4,0,2,0,18
706,785833,36,5,14,4,9,1,5,5,5,4,11,3,2,0,3,0,16
706,785836,22,4,8,2,5,2,3,0,1,2,1,0,5,0,0,0,10
706,775872,27,3,9,3,5,0,4,2,4,3,3,1,1,0,1,0,8
706,785838,25,3,9,1,5,2,4,0,0,0,3,3,5,0,1,0,8
706,780577,28,5,13,2,7,3,6,1,2,2,2,1,4,1,0,0,14
706,791704,19,4,7,3,6,1,1,0,0,1,5,1,2,1,2,0,9
706,791707,20,1,6,1,4,0,2,0,0,2,2,4,3,0,2,0,2
707,791024,37,8,20,5,13,3,7,4,8,0,3,2,2,2,5,0,23
707,777572,36,9,14,7,9,2,5,2,2,0,9,0,2,1,2,0,22
707,791027,33,3,9,2,4,1,5,10,12,1,7,2,3,1,1,0,17
707,791023,18,5,7,5,7,0,0,3,3,4,7,0,4,0,0,0,13
707,781507,24,1,5,1,5,0,0,2,4,1,6,1,2,0,0,0,4
707,796685,25,2,5,1,2,1,3,7,7,2,1,0,1,0,1,0,12
707,791028,21,1,1,1,1,0,0,0,0,0,2,0,4,0,0,0,2
707,796684,3,0,3,0,3,0,0,0,0,0,0,0,1,0,0,0,0
707,791727,3,0,0,0,0,0,0,0,0,0,0,0,0,0,0,0,0
708,785589,28,11,12,11,12,0,0,5,7,1,3,1,3,1,3,0,27
708,791216,22,5,9,3,7,2,2,2,4,3,2,1,1,3,1,0,14
708,791209,19,3,5,3,5,0,0,0,1,3,1,1,1,0,1,2,6
708,791215,23,1,4,0,1,1,3,0,0,0,0,9,0,1,0,0,3
708,791214,33,3,10,2,4,1,6,4,4,2,6,7,1,4,3,0,11
708,776313,22,3,9,2,7,1,2,3,6,2,4,0,2,1,1,1,10
708,776364,17,3,7,2,3,1,4,0,0,0,1,0,2,1,0,0,7
708,796917,16,2,6,0,1,2,5,0,0,0,0,3,1,0,0,0,6
708,791207,9,1,1,1,1,0,0,0,0,0,2,0,1,0,0,0,2
708,791211,2,2,2,1,1,1,1,0,0,0,0,0,0,0,0,0,5
708,791217,2,0,1,0,1,0,0,0,0,0,0,2,0,0,0,0,0
708,785592,2,0,0,0,0,0,0,0,0,0,0,0,0,0,0,0,0
708,791210,5,0,0,0,0,0,0,0,0,0,0,0,0,0,0,0,0
710,785714,17,7,10,7,10,0,0,4,4,1,7,0,1,1,2,0,18
710,775894,25,3,5,2,3,1,2,4,4,2,2,3,0,0,1,0,11
710,785711,29,4,8,1,1,3,7,0,1,0,3,11,2,1,2,1,11
710,780985,25,2,3,1,1,1,2,0,0,0,2,3,0,0,2,0,5
710,775266,22,6,9,1,2,5,7,0,0,0,2,2,4,1,0,0,17
710,796829,15,5,10,5,9,0,1,0,0,1,3,1,2,0,1,1,10
710,785378,22,4,7,3,4,1,3,3,5,0,6,4,1,0,0,0,12
710,791167,21,0,0,0,0,0,0,2,2,0,5,4,1,0,1,0,2
710,780988,8,3,6,3,6,0,0,0,0,1,5,0,0,0,0,1,6
710,785710,7,0,0,0,0,0,0,0,0,0,0,0,0,0,1,0,0
710,791169,4,0,0,0,0,0,0,2,2,1,1,0,1,0,2,0,2
710,796828,3,0,1,0,1,0,0,0,0,0,0,0,0,0,0,0,0
710,796827,2,0,0,0,0,0,0,0,0,0,0,0,0,0,0,0,0
711,780570,24,2,8,2,8,0,0,1,2,0,3,0,1,1,2,1,5
711,780569,25,1,3,1,3,0,0,1,5,2,7,1,3,0,1,1,3
711,781556,10,3,6,2,3,1,3,0,0,0,0,0,3,1,0,0,7
711,780565,30,3,13,1,9,2,4,0,0,2,0,2,1,1,0,0,8
711,780564,27,4,8,3,6,1,2,0,0,0,1,1,0,1,0,0,9
711,791697,21,7,12,6,8,1,4,3,3,0,4,2,3,1,0,0,18
711,791695,4,0,1,0,1,0,0,0,0,0,0,0,1,0,0,0,0
711,797434,7,0,2,0,0,0,2,0,0,0,0,0,0,0,0,0,0
711,797438,14,3,6,2,5,1,1,0,0,1,2,0,0,0,0,0,7
711,791696,10,1,5,0,2,1,3,0,0,0,0,0,1,1,2,0,3
711,797432,21,2,9,1,3,1,6,2,2,0,1,3,3,1,1,0,7
711,785824,3,0,0,0,0,0,0,0,0,0,0,1,0,0,0,0,0
711,791694,1,0,0,0,0,0,0,0,0,1,0,0,0,0,0,0,0
711,797433,3,0,0,0,0,0,0,0,0,0,0,0,0,0,0,0,0
712,796870,33,3,5,3,5,0,0,3,4,2,4,2,2,0,1,0,9
712,786861,32,2,8,1,6,1,2,1,3,1,1,0,0,0,3,0,6
712,792415,28,1,9,1,5,0,4,0,0,2,3,1,3,1,3,0,2
712,780387,28,5,7,4,5,1,2,0,0,0,3,0,0,2,0,0,11
712,767033,25,5,10,4,6,1,4,2,2,0,4,0,1,1,3,0,13
712,792416,15,0,1,0,0,0,1,0,0,0,0,1,2,0,0,0,0
712,786867,16,2,5,0,1,2,4,0,0,0,1,3,1,0,0,0,6
712,786866,16,2,5,0,1,2,4,0,0,0,1,0,1,0,0,0,6
712,785801,5,0,1,0,0,0,1,0,0,0,0,0,0,0,0,0,0
712,796867,2,0,1,0,0,0,1,0,0,0,0,0,0,1,0,0,0
713,791981,36,1,5,1,2,0,3,0,0,2,8,3,3,1,3,0,2
713,780342,21,4,5,3,3,1,2,0,0,1,3,3,1,0,0,1,9
713,791982,28,5,12,2,2,3,10,2,2,0,3,5,3,1,1,1,15
713,780333,30,4,10,2,4,2,6,0,0,0,2,3,1,1,2,0,10
713,781493,18,4,5,1,1,3,4,0,0,0,4,0,2,0,0,0,11
713,786756,22,5,10,2,3,3,7,0,0,0,2,2,1,1,1,0,13
713,786755,17,5,7,2,4,3,3,0,0,1,1,1,3,0,0,0,13
713,791984,21,6,10,6,9,0,1,2,2,6,4,3,2,0,1,1,14
713,791985,7,0,1,0,0,0,1,0,0,1,0,1,0,0,0,0,0
714,792128,30,5,10,2,6,3,4,0,0,1,7,0,2,3,2,1,13
714,786838,26,4,11,4,10,0,1,4,5,1,2,3,4,3,1,3,12
714,792132,21,0,4,0,2,0,2,0,0,0,3,2,5,2,3,0,0
714,792127,27,4,10,3,8,1,2,0,0,1,2,3,1,1,1,0,9
714,786267,27,6,10,4,7,2,3,4,5,1,2,2,1,2,0,0,18
714,799273,11,2,4,2,4,0,0,0,0,1,1,0,2,1,0,1,4
714,792131,13,2,2,1,1,1,1,0,0,0,4,0,4,0,3,0,5
714,797736,15,4,7,2,3,2,4,0,0,1,2,1,2,0,1,0,10
714,797739,10,1,2,0,1,1,1,0,0,1,1,3,1,0,0,0,3
714,792126,11,3,5,1,1,2,4,0,0,0,1,0,1,0,0,0,8
714,791668,9,0,1,0,1,0,0,0,0,1,0,4,2,0,1,0,0
715,792171,24,1,6,1,4,0,2,0,2,0,5,3,1,0,6,3,2
715,785674,28,5,9,1,3,4,6,2,4,2,4,3,2,2,4,1,16
715,780049,27,5,6,5,6,0,0,4,7,3,3,5,3,0,2,2,14
715,797784,30,3,10,1,4,2,6,1,2,1,2,2,3,0,3,0,9
715,789059,32,2,5,1,4,1,1,2,3,3,6,0,0,0,0,0,7
715,797782,25,5,8,4,6,1,2,2,4,3,4,1,2,3,4,1,13
715,797783,3,0,1,0,1,0,0,0,0,0,0,0,0,0,0,0,0
715,797785,1,0,1,0,0,0,1,0,0,0,0,0,0,0,0,0,0
715,792174,10,1,4,1,1,0,3,0,0,0,1,0,0,0,2,0,2
715,780527,2,1,1,1,1,0,0,0,1,1,0,0,0,0,0,0,2
715,780980,13,1,3,1,3,0,0,1,2,0,0,1,1,0,1,0,3
715,792173,5,0,0,0,0,0,0,0,0,0,0,0,0,0,0,0,0
716,788113,36,7,11,5,7,2,4,3,4,3,6,7,1,2,2,1,19
716,776497,16,6,9,4,4,2,5,0,2,0,5,1,4,1,2,0,14
716,785731,34,5,7,4,6,1,1,4,5,3,7,4,3,3,5,2,15
716,785729,34,5,10,5,10,0,0,2,2,2,1,3,2,2,2,0,12
716,780864,30,3,13,1,7,2,6,2,2,0,1,3,2,3,3,0,10
716,792407,3,1,1,1,1,0,0,0,0,2,0,0,1,0,0,0,2
716,762035,7,0,3,0,0,0,3,0,0,0,0,0,1,0,2,0,0
716,792408,6,0,0,0,0,0,0,2,2,0,0,1,2,2,0,0,2
716,786231,22,8,13,2,5,6,8,2,3,1,4,1,1,1,0,0,24
716,785443,12,1,6,0,2,1,4,1,2,0,1,2,2,0,2,0,4
718,797050,26,2,9,2,8,0,1,0,2,0,2,1,2,1,1,0,4
718,780394,33,5,14,2,7,3,7,0,0,6,7,2,5,1,2,0,13
718,780391,32,2,2,1,1,1,1,2,2,3,5,3,4,0,6,2,7
718,791573,19,1,6,1,2,0,4,0,0,1,0,1,1,1,0,0,2
718,776473,38,6,15,3,6,3,9,6,9,1,3,4,4,0,3,0,21
718,797048,22,2,4,1,3,1,1,1,2,4,9,1,0,1,3,1,6
718,790871,20,2,7,2,3,0,4,3,4,0,0,1,2,2,4,1,7
718,791570,4,0,1,0,0,0,1,0,0,0,0,0,1,0,2,0,0
718,780392,6,0,1,0,0,0,1,2,2,0,0,0,0,1,0,0,2
719,790884,15,2,2,2,2,0,0,1,1,1,3,2,5,0,5,1,5
719,796436,31,5,10,5,9,0,1,3,4,1,5,3,2,3,3,1,13
719,790885,19,1,5,1,2,0,3,0,0,1,4,1,1,0,1,2,2
719,785436,37,5,9,4,8,1,1,0,0,1,5,3,3,1,4,0,11
719,781262,22,2,7,1,1,1,6,0,0,0,0,0,0,0,0,0,5
719,796439,23,2,9,2,9,0,0,1,2,1,3,1,1,1,1,0,5
719,791635,22,4,8,1,3,3,5,2,2,0,2,4,3,4,1,1,13
719,796438,26,4,9,4,7,0,2,8,9,0,1,0,2,1,2,1,16
719,796437,3,0,1,0,1,0,0,0,0,0,2,0,0,1,1,0,0
719,796442,2,0,0,0,0,0,0,0,0,0,0,0,0,0,0,0,0
720,796455,28,1,4,1,4,0,0,10,16,6,3,1,5,2,1,0,12
720,787175,31,5,11,1,2,4,9,0,0,0,8,0,3,1,1,4,14
720,790909,25,3,8,2,3,1,5,5,7,2,6,3,2,0,0,0,12
720,781393,25,6,10,4,5,2,5,3,4,0,3,5,2,2,1,0,17
720,775351,28,3,5,3,5,0,0,1,2,0,1,5,2,3,2,0,7
720,790907,23,4,10,4,10,0,0,2,2,2,3,0,3,2,0,2,10
720,796454,6,0,0,0,0,0,0,0,0,1,2,1,1,0,0,0,0
720,796453,29,5,14,1,7,4,7,0,1,1,3,1,0,1,2,0,14
720,790910,5,0,0,0,0,0,0,0,0,0,2,1,0,0,1,0,0
722,790837,20,1,5,0,1,1,4,0,0,1,4,4,0,1,0,0,3
722,780025,35,10,16,10,16,0,0,2,3,0,3,0,2,0,2,0,22
722,786228,36,5,8,5,6,0,2,4,6,0,1,5,1,1,0,0,14
722,785385,33,0,4,0,1,0,3,5,6,0,4,0,3,1,0,0,5
722,785383,29,6,13,5,12,1,1,0,0,2,3,0,4,1,0,0,13
722,781046,26,2,7,2,3,0,4,0,0,3,5,1,2,0,1,0,4
722,785382,17,1,3,1,1,0,2,0,0,1,1,0,1,0,0,0,2
722,786297,4,0,0,0,0,0,0,0,0,0,0,0,1,0,0,0,0
722,785384,0,0,0,0,0,0,0,0,0,0,0,0,0,0,0,0,0
723,796347,34,1,5,1,3,0,2,2,2,1,3,0,1,0,2,0,4
723,790788,31,6,9,3,5,3,4,2,2,1,5,2,3,0,3,0,17
723,785243,31,4,9,3,8,1,1,0,0,0,4,0,2,0,1,1,9
723,781028,36,5,14,3,9,2,5,5,6,1,6,2,0,0,3,0,17
723,781026,22,1,5,1,2,0,3,2,2,1,5,3,4,0,2,0,4
723,796348,5,0,0,0,0,0,0,0,0,0,0,0,2,0,0,0,0
723,781027,6,1,1,0,0,1,1,0,0,0,0,1,0,0,0,0,3
723,785244,2,0,1,0,0,0,1,0,0,1,0,0,0,0,0,0,0
723,796349,23,3,7,2,3,1,4,0,1,1,2,2,1,0,0,0,7
723,785242,10,0,1,0,1,0,0,1,2,1,0,0,2,0,0,0,1
724,791269,16,7,11,1,1,6,10,0,0,0,1,0,3,0,2,0,20
724,791265,22,5,6,1,2,4,4,0,0,2,1,3,2,1,1,0,14
724,785685,31,4,9,3,7,1,2,2,2,0,3,12,1,3,2,0,11
724,791271,23,3,3,3,3,0,0,4,4,1,3,1,2,1,1,0,10
724,785977,22,2,6,2,3,0,3,0,0,1,4,1,1,0,1,1,4
724,796525,10,3,5,1,1,2,4,2,2,0,0,0,1,1,2,1,10
724,781313,13,3,8,1,2,2,6,0,0,1,1,1,1,0,0,0,8
724,796524,15,3,4,3,4,0,0,1,2,3,4,0,3,0,2,5,7
724,781294,15,2,4,0,2,2,2,0,0,4,3,1,2,0,1,0,6
724,796522,15,1,8,0,0,1,8,0,0,0,0,2,1,0,0,0,3
724,796523,10,1,3,1,1,0,2,1,2,1,2,0,1,0,2,0,3
724,791270,5,0,0,0,0,0,0,0,0,0,1,0,0,0,1,0,0
724,788872,3,0,0,0,0,0,0,0,0,1,1,0,3,0,2,0,0
725,791101,27,5,13,3,11,2,2,7,7,3,1,2,0,0,0,0,19
725,780794,25,3,10,1,3,2,7,0,0,0,1,2,1,0,2,0,8
725,796758,21,3,10,3,9,0,1,1,4,0,3,1,0,2,1,0,7
725,791103,16,1,4,1,3,0,1,1,4,2,1,0,1,0,2,0,3
725,791105,26,1,7,1,7,0,0,0,0,0,2,0,1,2,3,0,2
725,796759,17,5,7,5,6,0,1,0,0,1,2,1,2,0,2,0,10
725,780109,22,3,5,1,3,2,2,0,2,3,2,2,0,2,2,0,8
725,785597,13,3,4,1,2,2,2,0,0,0,0,2,1,0,2,0,8
725,796757,22,2,4,2,2,0,2,3,5,0,4,0,4,1,1,0,7
725,775124,6,2,3,2,3,0,0,0,0,0,1,0,1,0,0,0,4
725,796760,3,0,0,0,0,0,0,0,0,0,1,1,1,0,0,0,0
725,791104,2,0,0,0,0,0,0,0,0,0,0,0,0,0,0,0,0
725,798158,0,0,0,0,0,0,0,0,0,0,0,0,0,0,0,0,0
726,796318,22,4,11,4,9,0,2,3,6,0,4,1,2,1,1,2,11
726,790761,30,0,9,0,3,0,6,4,4,1,2,2,2,1,3,0,4
726,790764,36,6,14,5,11,1,3,8,8,2,11,0,2,0,1,0,21
726,796319,29,0,7,0,4,0,3,6,6,0,1,2,1,0,1,0,6
726,796320,26,2,4,1,3,1,1,1,2,0,2,2,5,1,3,0,6
726,796322,4,0,1,0,1,0,0,0,0,1,2,0,0,0,0,0,0
726,779993,26,4,7,2,5,2,2,0,0,1,4,1,4,2,2,0,10
726,796321,15,4,6,3,3,1,3,2,4,3,1,1,1,0,0,0,11
726,785219,12,0,3,0,0,0,3,0,0,1,0,0,5,4,1,0,0
727,785375,10,0,1,0,0,0,1,0,0,0,3,0,1,2,0,0,0
727,785374,5,0,0,0,0,0,0,0,0,1,1,0,3,0,1,0,0
727,785372,35,7,21,7,18,0,3,0,2,0,5,5,4,3,4,3,14
727,790825,25,7,16,6,12,1,4,5,7,0,3,2,4,0,3,0,20
727,774905,29,1,2,0,0,1,2,0,0,1,2,0,1,0,2,0,3
727,786384,23,4,6,2,3,2,3,1,2,3,7,0,5,1,2,0,11
727,785373,17,0,4,0,1,0,3,0,0,2,1,0,1,0,2,0,0
727,785371,15,1,3,0,0,1,3,2,4,0,5,0,1,0,0,0,5
727,790827,29,2,5,2,4,0,1,6,8,4,6,2,1,0,1,0,10
727,790828,12,5,5,5,5,0,0,2,2,1,1,0,1,0,0,0,12
728,791299,28,2,4,2,4,0,0,0,0,1,6,0,1,1,3,0,4
728,791296,37,5,11,5,6,0,5,1,1,0,9,1,4,1,2,0,11
728,775871,26,5,8,5,8,0,0,5,7,1,6,1,3,0,4,0,15
728,791298,28,4,7,3,6,1,1,5,8,0,4,3,3,3,2,0,14
728,791519,33,7,14,7,12,0,2,8,10,0,0,7,1,0,3,0,22
728,786276,14,0,4,0,1,0,3,0,0,0,0,0,1,0,0,0,0
728,796593,5,0,1,0,1,0,0,0,2,1,1,0,0,1,2,0,0
728,796590,4,1,3,1,2,0,1,0,0,0,0,0,0,0,0,0,2
728,796591,4,1,1,1,1,0,0,0,0,0,1,0,0,0,0,0,2
728,781390,21,2,5,0,1,2,4,2,2,1,2,0,2,2,0,1,8
729,792492,23,8,12,8,10,0,2,2,2,3,5,1,4,0,1,0,18
729,788128,24,5,12,2,4,3,8,1,3,1,4,0,1,1,1,0,14
729,792493,39,7,17,2,5,5,12,0,0,3,2,1,1,0,1,0,19
729,792495,32,8,22,6,14,2,8,2,2,4,6,6,3,5,3,0,20
729,792491,37,0,6,0,6,0,0,5,7,0,3,7,4,4,5,2,5
729,798960,16,2,4,2,4,0,0,0,0,2,3,0,3,0,1,1,4
729,798959,8,0,2,0,1,0,1,0,0,2,2,2,1,0,1,0,0
729,792490,21,1,3,1,1,0,2,0,0,0,1,1,3,1,0,1,2
730,786804,15,2,4,1,2,1,2,0,0,2,2,2,0,0,1,2,5
730,774936,17,6,10,6,10,0,0,0,0,4,2,1,1,2,2,1,12
730,790932,15,2,6,2,4,0,2,2,2,1,2,1,1,0,0,0,6
730,781345,21,2,2,1,1,1,1,2,4,1,2,4,1,5,3,0,7
730,786803,19,0,4,0,0,0,4,0,0,0,1,3,2,2,2,0,0
730,796490,16,4,10,3,5,1,5,1,2,2,2,0,2,0,3,0,10
730,796488,15,2,7,2,4,0,3,2,2,0,1,2,2,0,0,0,6
730,790934,17,3,5,3,4,0,1,1,3,1,8,3,0,1,1,0,7
730,796489,4,1,2,1,1,0,1,0,0,0,0,0,1,1,0,0,2
730,796487,21,6,11,1,3,5,8,0,0,4,6,1,1,1,3,0,17
730,790931,11,0,3,0,1,0,2,3,4,2,1,0,3,0,3,0,3
730,790933,16,1,3,0,0,1,3,1,2,0,0,2,1,1,1,0,4
730,780033,8,1,2,1,1,0,1,0,2,0,1,0,0,1,0,0,2
730,780030,5,0,1,0,1,0,0,0,0,0,0,0,1,0,0,1,0
732,776279,19,2,6,1,4,1,2,0,2,0,4,5,0,2,0,0,5
732,781505,26,9,15,7,10,2,5,0,0,0,6,1,1,0,1,0,20
732,780353,24,8,8,8,8,0,0,1,4,6,7,1,1,0,4,0,17
732,791317,29,6,12,6,8,0,4,1,2,2,4,6,2,1,2,0,13
732,777573,16,1,5,1,2,0,3,0,1,1,0,0,1,0,0,0,2
732,791318,2,0,1,0,1,0,0,0,0,0,0,0,0,0,1,0,0
732,786222,12,2,2,2,2,0,0,0,0,1,4,0,2,0,0,0,4
732,785966,12,3,4,3,4,0,0,1,3,3,4,0,2,0,2,0,7
732,796646,10,1,3,1,1,0,2,0,1,0,1,1,1,1,1,0,2
732,796647,7,2,2,1,1,1,1,2,2,1,1,1,0,0,0,0,7
732,796649,8,1,3,0,0,1,3,0,0,0,2,2,0,0,0,0,3
732,790851,19,1,4,1,2,0,2,0,0,2,1,2,2,0,3,1,2
732,796648,15,2,4,0,0,2,4,0,0,0,2,1,1,0,0,0,6
732,788965,1,0,0,0,0,0,0,0,0,0,0,0,0,0,0,0,0
733,799129,38,4,12,1,2,3,10,2,4,1,6,1,1,1,3,0,13
733,799132,18,4,7,0,0,4,7,0,0,1,1,1,5,0,1,0,12
733,799133,27,1,7,0,3,1,4,0,0,1,3,2,1,1,2,0,3
733,792634,36,3,12,1,5,2,7,0,2,2,2,6,1,0,2,0,8
733,799130,32,3,13,1,5,2,8,0,0,0,3,1,3,1,4,1,8
733,799135,7,0,0,0,0,0,0,0,0,0,0,1,1,0,0,0,0
733,799136,7,0,0,0,0,0,0,0,0,0,0,0,4,0,1,0,0
733,799131,6,0,1,0,1,0,0,0,0,0,1,0,0,0,0,0,0
733,799134,26,2,7,1,4,1,3,0,0,0,3,1,1,1,1,1,5
733,799128,3,0,0,0,0,0,0,0,0,0,0,0,0,0,0,0,0
734,780059,35,7,9,6,6,1,3,1,3,1,3,2,3,1,2,0,16
734,790944,28,4,10,1,3,3,7,2,5,0,5,4,0,1,0,0,13
734,780061,33,7,12,1,2,6,10,2,3,0,4,6,0,0,1,1,22
734,776110,26,0,1,0,0,0,1,2,2,1,6,4,2,2,4,2,2
734,780058,15,1,6,0,0,1,6,0,0,0,5,0,1,0,0,1,3
734,796494,17,4,8,1,2,3,6,0,0,1,2,0,1,0,1,0,11
734,790943,16,0,3,0,0,0,3,0,0,0,3,1,1,0,1,0,0
734,786754,30,6,11,5,7,1,4,6,6,1,3,4,2,0,2,0,19
735,791375,36,10,17,3,5,7,12,0,0,1,5,2,3,3,2,0,27
735,780837,25,4,14,0,4,4,10,0,0,0,0,1,4,0,2,0,12
735,785482,38,7,21,6,16,1,5,2,2,1,6,4,5,2,2,0,17
735,785487,36,5,11,5,8,0,3,1,2,1,2,5,3,0,1,0,11
735,781560,34,1,1,1,1,0,0,0,0,1,8,0,1,0,1,1,2
735,786164,21,1,4,1,2,0,2,0,0,2,6,1,2,1,1,1,2
735,796477,3,0,0,0,0,0,0,0,0,0,1,0,0,0,0,0,0
735,796479,7,1,1,0,0,1,1,0,0,0,1,0,1,0,0,0,3
742,792143,28,1,5,1,2,0,3,2,2,2,1,0,3,1,2,0,4
742,797753,23,1,10,1,5,0,5,2,2,0,4,0,5,1,1,2,4
742,780953,32,5,8,4,6,1,2,6,6,1,3,4,3,1,3,0,17
742,786287,27,1,4,1,4,0,0,0,1,0,3,1,2,1,2,0,2
742,780955,36,5,15,3,9,2,6,6,8,1,3,0,3,1,1,0,18
742,797751,15,3,7,1,3,2,4,0,1,0,0,0,0,0,0,0,8
742,797748,2,0,1,0,1,0,0,0,0,0,0,0,0,0,0,0,0
742,792147,27,2,2,2,2,0,0,4,6,1,5,1,3,0,0,1,8
742,786302,8,1,1,1,1,0,0,0,0,0,1,0,2,0,0,0,2
742,797750,2,0,0,0,0,0,0,0,0,0,0,0,0,0,0,0,0
743,791401,34,10,16,10,16,0,0,11,14,1,5,2,1,0,0,0,31
743,780125,32,6,7,5,6,1,1,2,2,1,7,3,2,2,0,4,15
743,797125,21,2,3,1,2,1,1,0,0,0,1,1,4,0,1,0,5
743,791400,40,4,10,4,7,0,3,5,6,1,7,5,2,0,3,1,13
743,785931,23,2,4,0,1,2,3,0,0,0,1,2,4,0,5,0,6
743,797130,18,1,6,0,1,1,5,2,2,0,1,4,3,0,2,3,5
743,786837,14,2,4,2,3,0,1,0,1,1,3,1,2,0,0,0,4
743,797132,18,0,1,0,0,0,1,0,0,1,2,2,1,0,2,0,0
744,790856,25,3,5,3,5,0,0,4,7,6,6,0,1,0,1,1,10
744,780452,30,7,12,7,12,0,0,4,7,3,4,0,3,0,1,2,18
744,796409,33,3,11,3,9,0,2,5,7,1,3,3,2,1,3,0,11
744,796408,30,2,13,2,9,0,4,1,2,0,1,0,2,0,4,0,5
744,796407,35,3,7,3,7,0,0,2,3,2,8,2,2,1,1,0,8
744,796411,9,1,1,1,1,0,0,2,5,0,2,0,1,0,1,0,4
744,796410,16,4,6,4,6,0,0,0,1,4,1,1,2,0,1,1,8
744,796412,5,0,1,0,0,0,1,0,0,0,1,0,0,0,0,0,0
744,796413,8,1,2,0,0,1,2,0,0,0,0,0,0,0,0,0,3
744,775941,3,0,0,0,0,0,0,0,0,0,1,0,0,0,0,0,0
744,780450,6,0,0,0,0,0,0,0,0,1,0,0,1,0,1,0,0
745,796469,19,3,9,2,4,1,5,3,4,1,5,0,4,2,0,0,10
745,779981,13,0,1,0,1,0,0,0,0,0,3,0,2,1,0,0,0
745,785463,37,5,17,3,13,2,4,1,2,0,3,3,0,3,1,0,13
745,779978,37,9,16,6,10,3,6,1,2,0,0,3,2,1,1,0,22
745,776003,19,1,7,0,3,1,4,2,2,1,1,1,1,0,5,0,5
745,790923,26,4,5,3,4,1,1,3,3,2,6,2,3,1,2,0,12
745,785466,21,1,2,0,0,1,2,0,0,0,0,0,4,1,0,0,3
745,785462,8,1,1,1,1,0,0,0,1,0,0,0,4,0,1,0,2
745,779980,20,1,2,1,2,0,0,0,0,2,3,1,5,1,1,4,2
746,796674,18,1,7,1,5,0,2,1,1,2,5,1,3,2,1,0,3
746,779857,27,2,5,2,3,0,2,0,0,0,2,2,0,0,4,3,4
746,785339,26,4,10,2,4,2,6,1,1,1,1,3,0,0,1,0,11
746,779976,36,8,11,5,5,3,6,1,3,0,3,5,0,2,1,0,20
746,774990,26,4,9,2,5,2,4,2,4,1,3,1,2,0,5,0,12
746,796673,22,4,12,4,10,0,2,5,6,4,11,0,2,1,1,0,13
746,785126,2,0,0,0,0,0,0,0,0,0,0,1,0,0,0,0,0
746,791014,25,4,6,1,1,3,5,0,0,1,3,1,4,0,3,0,11
746,785961,7,0,0,0,0,0,0,0,0,0,2,0,0,0,1,0,0
746,781586,11,0,0,0,0,0,0,0,0,0,2,1,0,0,1,0,0
747,785608,20,5,11,4,6,1,5,0,0,1,2,0,1,1,2,2,11
747,797709,27,2,7,2,5,0,2,0,0,1,3,0,4,0,2,0,4
747,792104,31,10,20,9,15,1,5,4,4,1,4,3,2,1,1,0,25
747,797708,36,2,7,2,6,0,1,0,0,2,4,7,2,2,2,0,4
747,786198,34,3,6,3,5,0,1,4,6,0,5,3,3,4,1,0,10
747,786204,13,2,8,2,5,0,3,0,1,0,1,0,0,0,1,0,4
747,797707,17,3,5,1,2,2,3,0,0,1,1,2,5,2,2,0,8
747,792106,3,0,1,0,1,0,0,0,0,0,1,0,1,0,1,0,0
747,781631,3,0,1,0,0,0,1,0,0,0,1,0,0,0,0,0,0
747,776327,9,0,1,0,1,0,0,0,0,0,0,1,1,0,0,0,0
747,786180,7,1,2,1,2,0,0,0,0,1,1,0,0,0,0,0,2
748,786550,31,3,8,2,6,1,2,3,4,3,7,1,2,1,0,0,10
748,780177,8,1,1,1,1,0,0,0,0,1,0,0,4,1,0,0,2
748,792007,38,6,12,5,10,1,2,6,7,6,3,2,3,2,1,1,19
748,792009,38,4,16,2,10,2,6,7,9,3,2,1,0,2,1,1,17
748,792006,18,1,6,1,4,0,2,0,0,0,2,2,0,0,3,0,2
748,797505,12,0,1,0,1,0,0,1,2,0,2,1,1,0,0,0,1
748,792011,12,2,2,2,2,0,0,2,4,1,1,0,3,0,1,0,6
748,776054,26,2,8,2,5,0,3,2,2,0,4,0,2,1,0,0,6
748,791689,2,0,0,0,0,0,0,0,0,0,0,0,0,0,0,0,0
748,786552,14,2,5,2,4,0,1,0,0,1,2,0,2,0,1,0,4
748,776273,26,3,11,3,10,0,1,1,2,0,1,1,0,2,0,0,7
749,791653,28,4,8,2,5,2,3,0,2,1,4,0,4,0,2,0,10
749,791652,30,4,5,4,5,0,0,0,2,3,5,0,3,0,3,1,8
749,797285,26,3,4,0,1,3,3,0,0,0,1,0,1,0,1,3,9
749,791650,33,8,16,7,13,1,3,0,0,0,2,3,4,1,2,1,17
749,776384,38,4,16,3,9,1,7,6,8,0,6,3,3,1,2,0,15
749,797284,4,0,1,0,0,0,1,0,0,0,0,0,0,1,0,0,0
749,786495,12,0,1,0,0,0,1,0,0,0,1,1,3,0,1,0,0
749,775705,14,1,1,1,1,0,0,1,2,0,2,0,3,0,0,1,3
749,797289,8,0,1,0,1,0,0,0,0,0,3,1,1,0,0,0,0
749,797286,7,1,4,1,2,0,2,0,0,0,0,0,0,0,0,0,2
749,797283,25,2,5,0,0,2,5,0,0,0,0,0,1,0,0,0,6
750,776069,26,5,9,5,8,0,1,1,1,2,4,0,1,0,0,0,11
750,781107,32,6,7,6,7,0,0,0,3,5,2,1,3,0,2,3,12
750,791974,33,6,14,5,9,1,5,3,3,1,2,2,1,0,1,0,16
750,785366,34,3,7,1,2,2,5,0,0,0,6,4,1,0,0,0,8
750,780863,22,2,10,2,7,0,3,3,6,0,0,2,3,2,2,0,7
750,796778,8,1,3,1,2,0,1,0,0,2,1,1,2,0,4,2,2
750,791971,15,3,6,2,3,1,3,0,0,1,1,1,0,0,0,0,7
750,780867,7,0,1,0,0,0,1,0,0,0,2,0,4,0,0,0,0
750,796781,5,0,2,0,0,0,2,0,0,0,1,0,1,1,0,0,0
750,791972,14,2,3,2,2,0,1,0,0,0,2,4,0,2,2,0,4
750,796777,4,0,0,0,0,0,0,0,0,0,0,0,0,0,1,0,0
751,780229,34,4,11,4,11,0,0,0,4,1,5,3,2,1,8,0,8
751,795572,35,4,8,4,8,0,0,4,4,1,4,5,4,2,2,0,12
751,791488,34,1,2,1,1,0,1,4,4,0,2,3,1,3,3,0,6
751,786322,31,3,8,2,5,1,3,0,0,0,6,0,2,0,1,0,7
751,780228,37,3,7,1,3,2,4,4,5,0,4,2,2,0,2,0,12
751,781592,18,3,4,3,4,0,0,2,2,0,1,1,5,1,2,0,8
751,791485,3,0,0,0,0,0,0,2,2,0,1,0,0,0,0,0,2
751,791484,2,0,1,0,0,0,1,0,0,0,0,0,1,0,0,0,0
751,786323,6,0,0,0,0,0,0,0,0,0,1,0,0,0,0,0,0
751,791487,0,0,0,0,0,0,0,0,0,0,0,0,0,0,0,0,0
751,797194,0,0,0,0,0,0,0,0,0,0,0,0,0,0,0,0,0
752,785948,16,3,6,3,6,0,0,0,0,1,1,0,2,0,3,0,6
752,785946,23,2,3,1,1,1,2,2,2,0,2,0,2,1,0,0,7
752,785941,26,3,9,1,2,2,7,2,3,1,5,3,1,1,1,0,10
752,785939,32,3,15,1,7,2,8,5,6,3,4,1,1,2,2,0,13
752,785938,31,1,4,0,1,1,3,2,2,0,1,6,3,1,4,0,5
752,792026,3,2,3,2,3,0,0,0,0,2,1,0,0,0,0,0,4
752,792025,17,3,5,3,5,0,0,0,0,3,4,1,1,0,0,1,6
752,785940,5,0,0,0,0,0,0,0,0,0,1,0,1,0,0,0,0
752,797634,7,0,1,0,1,0,0,0,0,0,0,0,0,0,0,0,0
752,792020,27,4,14,3,10,1,4,10,12,0,2,3,4,0,5,0,19
752,792022,13,1,3,1,3,0,0,6,7,0,2,0,3,0,0,0,8
753,791230,28,7,11,3,4,4,7,0,0,1,5,5,2,1,2,0,18
753,785557,29,6,12,6,11,0,1,5,6,2,5,1,4,2,2,0,17
753,791228,27,3,5,2,2,1,3,0,0,0,5,3,1,0,2,0,7
753,796932,20,3,6,2,4,1,2,5,6,1,2,6,3,1,5,1,12
753,785624,22,1,8,1,6,0,2,0,0,1,0,0,4,1,0,0,2
753,796935,11,1,3,1,1,0,2,0,0,0,5,0,3,0,0,1,2
753,796933,2,0,0,0,0,0,0,0,0,0,0,0,0,0,0,0,0
753,791226,11,4,4,4,4,0,0,1,4,3,1,0,3,0,1,3,9
753,791229,1,0,0,0,0,0,0,0,0,0,0,0,0,0,0,0,0
753,791227,13,4,6,2,3,2,3,0,0,1,0,2,1,1,1,0,10
753,785556,22,7,12,5,8,2,4,2,3,0,3,4,4,2,2,0,18
753,781211,2,0,0,0,0,0,0,0,0,0,0,0,0,0,0,0,0
753,781201,12,0,0,0,0,0,0,0,0,0,1,1,3,0,1,1,0
754,785609,12,1,1,1,1,0,0,2,4,0,3,0,2,0,1,0,4
754,775626,27,7,15,7,14,0,1,4,6,2,5,1,3,1,1,0,18
754,785610,33,3,8,2,5,1,3,8,11,0,4,5,3,1,6,0,15
754,785604,33,1,6,0,1,1,5,0,0,0,0,0,0,0,0,0,3
754,774962,28,5,7,1,1,4,6,7,8,0,3,0,0,4,0,0,21
754,796910,13,2,5,2,4,0,1,0,0,1,2,2,1,1,1,1,4
754,785606,6,0,0,0,0,0,0,0,0,0,0,0,0,0,0,0,0
754,774964,22,6,9,6,9,0,0,2,2,3,7,1,3,2,2,0,14
754,796908,16,0,0,0,0,0,0,0,0,1,1,0,1,1,1,0,0
754,796907,9,0,3,0,2,0,1,2,2,1,0,0,2,0,0,0,2
754,796906,1,0,0,0,0,0,0,0,0,0,0,0,0,0,0,0,0
755,785799,18,0,4,0,4,0,0,0,0,2,4,2,4,0,2,0,0
755,780760,27,1,5,1,3,0,2,1,2,0,4,0,1,0,1,3,3
755,791676,18,2,5,2,2,0,3,0,0,0,0,1,5,0,0,0,4
755,780554,22,1,4,1,2,0,2,1,2,3,0,0,2,0,4,0,3
755,780553,32,11,20,11,17,0,3,0,0,1,3,4,4,3,5,0,22
755,797426,6,0,1,0,0,0,1,0,0,0,0,0,0,0,1,1,0
755,791678,11,1,3,1,2,0,1,0,1,3,2,2,0,0,0,1,2
755,791679,7,1,2,1,2,0,0,0,0,1,1,0,3,0,3,1,2
755,785807,16,2,7,1,4,1,3,0,0,0,5,0,2,2,0,1,5
755,785800,18,5,7,1,3,4,4,0,0,2,1,2,2,0,1,0,14
755,797427,17,4,5,0,0,4,5,1,4,0,0,2,0,0,0,0,13
755,791677,8,0,1,0,0,0,1,0,0,0,1,2,2,0,2,0,0
756,780012,29,8,11,7,9,1,2,4,4,0,3,2,3,1,2,0,21
756,774895,13,3,3,3,3,0,0,0,0,1,2,0,2,0,1,1,6
756,790824,25,4,6,3,5,1,1,5,5,0,6,2,3,1,0,0,14
756,780011,27,3,7,2,2,1,5,0,0,0,3,3,2,1,1,0,7
756,775667,30,5,8,5,7,0,1,0,0,0,3,3,1,1,1,0,10
756,796309,22,5,9,5,8,0,1,2,5,3,8,0,2,0,2,1,12
756,785370,9,0,2,0,1,0,1,0,0,4,1,2,2,0,3,0,0
756,796382,10,0,3,0,2,0,1,3,4,0,1,0,0,0,0,0,3
756,781524,16,4,7,3,5,1,2,0,0,1,1,0,3,0,2,1,9
756,796383,10,0,2,0,1,0,1,0,1,0,2,0,0,0,0,0,0
756,785367,3,0,0,0,0,0,0,0,0,0,1,0,0,0,0,1,0
756,780941,3,1,1,1,1,0,0,0,0,0,0,0,0,0,0,0,2
756,796384,3,0,0,0,0,0,0,0,0,0,0,0,0,0,0,0,0
757,780215,10,0,0,0,0,0,0,1,4,0,0,0,4,0,1,0,1
757,790984,27,4,9,1,4,3,5,2,3,0,1,2,1,0,0,0,13
757,785297,16,0,1,0,0,0,1,0,0,0,2,0,1,0,3,0,0
757,780212,32,5,17,5,12,0,5,0,0,0,0,4,2,2,4,0,10
757,767245,27,9,15,9,15,0,0,2,3,2,5,0,1,2,0,0,20
757,775087,16,1,4,1,3,0,1,5,6,2,0,0,4,1,1,0,7
757,790985,14,1,1,1,1,0,0,0,0,1,4,0,2,0,1,0,2
757,791168,21,2,8,0,4,2,4,0,0,1,2,0,1,0,2,0,6
757,780214,24,2,4,0,0,2,4,0,0,1,4,0,1,0,0,1,6
757,796596,13,0,2,0,2,0,0,0,0,0,1,1,1,0,1,0,0
758,785775,21,5,7,5,5,0,2,3,3,1,9,1,2,2,1,0,13
758,781335,25,5,9,5,7,0,2,1,2,1,5,4,3,1,2,0,11
758,776351,26,5,11,5,7,0,4,1,1,3,3,6,1,2,1,2,11
758,785770,27,7,12,7,9,0,3,3,4,1,5,2,1,4,2,0,17
758,781341,25,3,6,1,1,2,5,0,0,0,2,0,1,0,1,0,8
758,796542,20,3,5,3,5,0,0,0,2,2,4,3,1,1,1,0,6
758,791282,5,0,1,0,1,0,0,1,2,1,0,0,2,0,0,0,1
758,791285,8,0,2,0,0,0,2,2,2,1,5,0,2,0,0,0,2
758,796538,12,2,4,1,2,1,2,0,0,0,0,0,1,3,0,0,5
758,791286,2,0,0,0,0,0,0,0,0,0,1,1,0,0,0,0,0
758,791284,4,0,2,0,1,0,1,0,0,0,0,0,0,0,0,0,0
758,791283,13,3,6,3,6,0,0,3,5,4,1,0,2,0,1,0,9
758,785767,10,2,3,0,0,2,3,0,0,0,1,1,3,0,1,0,6
758,785773,2,0,0,0,0,0,0,0,0,0,0,0,0,0,0,0,0
760,790799,23,0,3,0,1,0,2,1,2,0,4,2,5,0,2,0,1
760,790798,34,7,17,7,15,0,2,3,5,1,2,1,5,1,2,1,17
760,780140,32,6,11,4,7,2,4,5,7,1,4,2,4,0,1,1,19
760,796355,26,2,6,2,5,0,1,0,0,1,5,5,3,3,2,1,4
760,780137,33,10,15,9,12,1,3,0,0,3,4,4,3,4,2,0,21
760,785245,35,8,14,7,11,1,3,2,2,0,5,6,1,1,2,0,19
760,790796,10,1,1,1,1,0,0,4,5,2,1,0,1,0,0,0,6
760,775553,7,0,2,0,1,0,1,0,0,0,1,2,3,0,0,0,0
761,791975,21,5,8,5,8,0,0,4,4,3,6,0,5,0,1,1,14
761,785972,23,1,5,1,5,0,0,5,5,2,2,2,1,1,1,0,7
761,785967,34,6,13,6,13,0,0,6,11,5,10,2,4,0,4,1,18
761,791977,27,1,9,0,3,1,6,0,0,0,0,1,1,0,0,0,3
761,791978,33,4,14,2,10,2,4,0,0,0,3,5,3,0,0,0,10
761,780160,14,3,3,2,2,1,1,3,3,1,2,2,5,0,1,0,10
761,791976,22,3,9,2,6,1,3,5,5,0,1,2,3,0,4,0,12
761,791980,3,0,1,0,0,0,1,0,0,0,0,0,0,0,1,0,0
761,797799,11,2,3,2,2,0,1,2,3,0,1,1,0,1,1,1,6
761,785973,8,0,1,0,0,0,1,2,2,0,1,0,1,0,2,0,2
761,797800,4,0,0,0,0,0,0,0,0,0,0,1,0,0,0,0,0
762,792560,9,0,0,0,0,0,0,2,2,0,2,0,1,1,1,0,2
762,792563,25,3,8,2,5,1,3,1,4,1,3,2,4,0,4,1,8
762,792561,25,1,6,1,3,0,3,1,3,0,1,4,2,0,3,0,3
762,789634,4,0,0,0,0,0,0,0,0,0,0,0,0,0,1,0,0
762,780270,37,6,10,4,5,2,5,7,8,5,4,1,3,1,0,1,21
762,792565,34,4,8,4,6,0,2,15,16,4,6,2,2,1,3,0,23
762,776333,14,0,1,0,1,0,0,1,2,2,3,0,0,0,1,1,1
762,798134,18,0,4,0,2,0,2,4,5,0,1,1,2,0,4,0,4
762,780266,23,3,9,1,3,2,6,0,0,0,5,3,4,0,2,0,8
762,798132,11,1,2,0,0,1,2,0,0,0,1,0,5,0,1,0,3
763,791868,22,0,2,0,2,0,0,2,2,0,4,3,5,2,1,2,2
763,797802,24,5,7,5,5,0,2,1,3,1,1,2,4,0,3,1,11
763,797809,21,1,3,1,2,0,1,3,6,1,1,2,5,1,4,0,5
763,797807,40,6,11,2,6,4,5,7,9,0,4,2,1,3,2,0,23
763,786058,29,0,3,0,2,0,1,0,0,0,2,1,5,0,1,0,0
763,795730,31,5,12,2,3,3,9,2,4,0,3,2,3,0,2,0,15
763,792264,16,3,5,2,4,1,1,0,0,1,1,0,5,0,4,0,7
763,797810,12,0,0,0,0,0,0,1,2,0,1,0,1,0,4,0,1
763,797812,4,0,0,0,0,0,0,0,0,0,1,0,0,0,0,1,0
763,797811,1,1,1,1,1,0,0,0,0,0,0,0,0,0,0,0,2
763,797798,0,0,0,0,0,0,0,0,0,0,0,0,0,0,0,0,0
764,781480,32,5,11,4,5,1,6,2,2,0,7,8,2,0,0,3,13
764,774846,30,11,17,11,17,0,0,2,2,2,3,0,3,1,2,1,24
764,786558,39,5,10,5,7,0,3,0,0,0,7,5,2,4,1,0,10
764,797272,30,2,8,1,3,1,5,0,0,1,1,0,2,1,1,0,5
764,766611,35,5,12,3,4,2,8,0,0,1,2,1,3,2,6,0,12
764,786185,8,0,0,0,0,0,0,1,2,0,0,0,2,0,1,0,1
764,797182,14,1,2,1,1,0,1,1,1,1,1,0,1,1,1,0,3
764,797273,7,0,0,0,0,0,0,0,0,0,1,0,2,1,2,0,0
764,797181,4,0,0,0,0,0,0,0,0,0,0,0,0,0,0,0,0
764,797183,1,0,0,0,0,0,0,0,0,0,0,0,0,0,0,0,0
765,792035,32,7,12,7,12,0,0,2,4,6,3,1,2,0,5,0,16
765,780833,19,0,3,0,3,0,0,0,0,0,3,1,1,1,2,1,0
765,792034,35,6,11,3,5,3,6,3,3,1,9,2,2,4,1,0,18
765,792033,39,8,20,3,9,5,11,2,3,1,2,0,3,1,3,0,23
765,780830,35,3,7,3,3,0,4,4,5,0,4,7,3,0,4,0,10
765,791688,15,0,0,0,0,0,0,0,0,0,1,0,1,0,0,0,0
765,785381,10,1,2,0,0,1,2,1,2,1,0,0,0,0,0,0,4
765,785980,15,0,2,0,0,0,2,0,0,0,0,2,2,1,1,0,0
766,797574,19,2,5,2,3,0,2,0,0,1,1,1,1,0,1,0,4
766,797575,22,1,2,1,2,0,0,2,2,0,1,0,3,0,2,0,4
766,791899,32,7,16,7,15,0,1,1,2,2,2,1,3,3,2,1,15
766,786512,22,3,7,2,3,1,4,0,0,0,5,1,5,0,4,0,7
766,786032,37,5,10,5,6,0,4,3,5,2,4,1,3,3,2,0,13
766,797573,12,0,2,0,2,0,0,1,3,1,0,0,0,0,1,0,1
766,791900,5,0,2,0,2,0,0,0,0,0,0,0,1,0,1,0,0
766,797571,30,2,5,1,2,1,3,2,4,0,4,4,0,0,2,0,7
766,786435,21,1,3,1,3,0,0,0,1,1,5,2,1,1,4,1,2
767,791723,28,3,8,3,8,0,0,2,2,1,3,1,4,1,0,5,8
767,780956,29,8,14,6,10,2,4,4,4,1,2,1,1,0,1,1,22
767,797310,32,2,3,2,2,0,1,2,4,0,2,7,1,5,3,0,6
767,791724,11,1,2,1,2,0,0,0,0,0,2,1,4,2,1,0,2
767,781617,34,5,9,4,5,1,4,4,7,0,12,3,4,0,2,0,15
767,797312,1,0,0,0,0,0,0,0,0,0,0,0,2,0,0,0,0
767,786277,1,0,1,0,1,0,0,0,0,0,0,0,2,0,1,0,0
767,786285,33,3,7,2,3,1,4,1,1,0,2,3,1,2,2,0,8
767,785580,2,0,0,0,0,0,0,0,0,0,0,0,0,0,1,0,0
767,797308,21,3,5,0,1,3,4,0,0,1,2,0,1,0,1,0,9
767,780706,8,1,2,0,0,1,2,0,0,0,0,2,0,0,0,0,3
768,792288,18,1,5,1,4,0,1,0,0,4,2,0,2,0,1,1,2
768,785227,27,3,4,3,4,0,0,7,9,7,7,0,1,1,1,3,13
768,786237,30,4,10,4,10,0,0,1,5,1,3,1,3,0,1,0,9
768,780287,30,6,13,4,10,2,3,2,3,0,3,1,2,3,1,0,16
768,776309,31,4,11,4,10,0,1,2,2,0,7,2,1,4,2,0,10
768,798066,1,0,0,0,0,0,0,0,0,0,0,0,1,0,0,0,0
768,798067,16,1,1,1,1,0,0,1,2,3,2,0,1,0,1,0,3
768,798068,1,0,0,0,0,0,0,0,0,0,0,0,0,0,0,0,0
768,792278,26,4,10,1,5,3,5,0,1,0,3,0,2,1,1,0,11
768,786232,20,4,10,3,3,1,7,0,0,0,3,3,1,3,0,0,9
769,797235,18,0,5,0,5,0,0,0,1,2,3,0,3,0,5,0,0
769,786251,12,1,3,1,2,0,1,0,0,4,1,0,1,1,1,1,2
769,785446,26,1,6,0,3,1,3,1,1,0,2,0,0,0,1,0,4
769,791367,14,1,2,1,1,0,1,0,0,0,0,1,1,0,0,0,2
769,797239,35,6,14,5,8,1,6,4,5,0,5,0,3,0,4,0,17
769,797233,24,1,7,1,4,0,3,0,0,1,3,0,3,0,1,3,2
769,791368,13,3,4,3,4,0,0,0,0,1,2,0,1,0,0,1,6
769,797238,5,0,0,0,0,0,0,0,0,0,0,0,1,0,2,1,0
769,797232,17,1,3,1,1,0,2,4,5,1,0,0,2,1,2,0,6
769,797237,23,2,7,2,6,0,1,0,0,2,5,2,0,0,2,0,4
769,797234,13,2,6,1,3,1,3,0,1,1,3,1,1,2,0,0,5
770,775913,22,6,11,6,11,0,0,2,5,2,5,2,3,0,0,0,14
770,797331,38,6,10,3,5,3,5,2,3,4,1,0,3,1,0,1,17
770,791737,32,2,12,2,11,0,1,3,5,0,3,4,3,0,2,0,7
770,783524,22,6,15,5,9,1,6,2,2,1,0,5,5,1,2,0,15
770,786223,38,0,6,0,5,0,1,0,0,4,7,2,5,2,2,1,0
770,797332,14,3,5,3,5,0,0,0,0,1,2,1,0,0,0,2,6
770,797333,8,1,3,1,2,0,1,0,0,1,3,3,3,0,0,0,2
770,786220,19,4,5,3,4,1,1,1,4,0,3,3,1,1,2,1,10
770,780561,32,3,7,2,3,1,4,1,2,1,7,1,5,1,5,2,8
771,792068,44,6,11,5,8,1,3,11,12,1,4,3,1,0,6,2,24
771,784640,23,4,7,2,4,2,3,3,3,1,3,0,3,0,0,3,13
771,792072,30,1,5,0,3,1,2,1,2,0,4,2,3,1,1,0,4
771,792069,25,3,10,2,6,1,4,0,2,1,3,2,1,2,1,1,7
771,785572,35,5,11,2,5,3,6,9,10,0,7,3,2,0,0,1,22
771,797655,12,1,2,1,2,0,0,0,0,0,1,1,4,0,0,0,2
771,797657,14,0,2,0,1,0,1,1,3,0,2,1,0,0,0,0,1
771,797652,39,5,9,4,7,1,2,3,3,0,1,1,4,2,1,0,14
771,774844,3,0,1,0,1,0,0,0,0,0,1,0,0,0,0,0,0
772,791201,25,4,7,2,5,2,2,1,3,1,2,1,2,2,2,1,11
772,791202,25,1,3,1,1,0,2,0,0,0,0,4,3,0,0,0,2
772,775767,26,4,9,4,9,0,0,0,1,3,9,2,3,1,2,2,8
772,785628,31,7,14,5,12,2,2,1,2,1,3,5,0,1,3,0,17
772,785627,28,3,6,1,2,2,4,5,5,1,4,1,2,0,2,0,13
772,796904,3,1,1,1,1,0,0,0,0,0,0,0,3,0,1,0,2
772,781138,1,0,1,0,0,0,1,0,0,0,0,0,0,0,0,0,0
772,781135,10,1,3,1,3,0,0,0,0,1,2,0,3,0,0,0,2
772,796902,10,2,7,1,5,1,2,0,0,3,1,1,1,0,0,0,5
772,796901,18,2,5,2,3,0,2,2,2,0,1,1,3,0,1,1,6
772,788869,1,0,0,0,0,0,0,0,0,0,0,0,0,0,0,0,0
772,789974,1,0,0,0,0,0,0,0,0,0,0,0,0,0,0,0,0
772,785629,21,0,3,0,2,0,1,0,1,0,2,0,1,1,2,0,0
773,780377,26,1,8,1,4,0,4,2,2,0,5,0,1,0,1,0,4
773,791852,17,1,1,1,1,0,0,2,2,0,2,0,3,0,1,2,4
773,786602,25,1,4,1,1,0,3,0,0,0,3,1,2,0,1,0,2
773,786600,25,5,12,5,12,0,0,4,5,0,5,3,1,1,2,0,14
773,786599,24,1,2,1,2,0,0,0,0,0,1,0,3,0,2,1,2
773,797462,21,1,1,0,0,1,1,3,4,3,3,0,2,0,3,0,6
773,791851,17,1,2,1,2,0,0,0,0,0,1,1,1,2,4,0,2
773,797461,17,1,8,1,4,0,4,4,7,0,2,0,0,1,1,1,6
773,797460,13,2,4,2,4,0,0,2,4,0,1,0,4,0,0,0,6
773,797459,15,1,2,1,2,0,0,0,0,1,3,0,2,0,2,0,2
774,792366,30,7,10,6,8,1,2,1,4,0,3,1,4,2,2,1,16
774,797979,27,5,8,2,3,3,5,3,4,2,2,1,4,1,1,0,16
774,791015,28,3,6,2,2,1,4,6,7,0,0,6,1,1,0,0,13
774,786424,33,6,13,6,13,0,0,0,2,5,13,3,2,0,1,1,12
774,785483,25,3,10,2,6,1,4,4,4,1,3,5,5,1,1,0,11
774,797988,21,1,5,0,3,1,2,0,0,0,2,4,4,2,2,0,3
774,797991,22,1,4,1,1,0,3,1,2,1,2,1,2,1,2,0,3
774,775335,7,1,4,0,0,1,4,0,1,0,1,1,0,0,2,0,3
774,797983,7,0,0,0,0,0,0,2,2,1,0,0,1,0,1,1,2
776,786067,31,11,13,11,13,0,0,5,12,3,4,0,3,1,2,0,27
776,785591,34,5,10,5,9,0,1,0,1,0,3,5,1,2,4,0,10
776,780258,20,3,9,0,2,3,7,0,0,0,3,1,0,1,2,0,9
776,792083,34,3,9,3,7,0,2,0,0,0,2,6,1,0,0,0,6
776,792078,25,1,3,1,3,0,0,1,4,5,5,1,0,2,2,0,3
776,792082,24,5,11,2,4,3,7,0,0,3,2,1,2,1,1,1,13
776,791952,16,5,6,5,6,0,0,0,0,2,2,1,3,1,1,1,10
776,774898,3,1,1,1,1,0,0,0,0,0,0,0,0,1,0,0,2
776,792079,11,0,0,0,0,0,0,0,0,0,0,1,1,1,1,0,0
776,797663,1,0,0,0,0,0,0,0,0,0,1,0,0,0,0,0,0
776,797664,1,0,0,0,0,0,0,0,0,0,0,0,0,0,0,0,0
778,776285,17,1,2,1,2,0,0,1,2,1,2,0,4,0,1,1,3
778,791783,21,1,4,1,4,0,0,1,2,0,6,0,4,0,3,1,3
778,791780,17,1,5,0,1,1,4,0,0,0,0,0,5,3,0,0,3
778,791777,36,7,18,7,18,0,0,1,2,0,4,5,4,0,5,0,15
778,780488,16,2,7,1,3,1,4,1,2,0,2,2,1,1,2,0,6
778,791781,10,1,2,1,2,0,0,0,0,0,0,0,0,0,0,0,2
778,791778,6,0,0,0,0,0,0,0,0,0,0,0,0,0,1,0,0
778,786476,14,1,1,1,1,0,0,3,4,1,0,0,3,0,0,1,5
778,791776,29,5,7,1,1,4,6,3,5,0,0,1,1,1,0,0,17
778,781025,34,4,9,2,4,2,5,2,2,0,9,3,1,1,0,1,12
779,786542,26,6,10,3,6,3,4,1,1,2,2,2,4,0,2,0,16
779,786540,17,3,4,3,4,0,0,1,2,2,6,0,4,1,1,2,7
779,792019,37,5,9,2,4,3,5,4,4,3,2,0,4,1,1,0,17
779,792015,36,3,13,3,10,0,3,11,12,1,2,5,3,1,3,1,17
779,775995,35,2,11,2,7,0,4,2,2,0,3,4,1,2,0,1,6
779,785364,24,4,5,4,5,0,0,3,4,0,10,0,1,1,1,1,11
779,797515,5,1,4,0,1,1,3,0,0,0,2,1,0,0,0,0,3
779,792016,16,1,4,1,1,0,3,1,2,1,1,2,1,0,1,0,3
779,781147,4,0,0,0,0,0,0,0,0,0,0,0,0,0,0,0,0
779,797513,0,0,0,0,0,0,0,0,0,0,0,0,0,0,0,0,0
780,781300,18,4,8,4,6,0,2,0,0,1,4,1,1,4,2,1,8
780,790803,17,4,8,4,8,0,0,5,6,2,3,1,3,1,1,2,13
780,796360,24,4,11,4,9,0,2,0,3,3,3,6,0,0,2,0,8
780,781304,27,4,8,1,3,3,5,6,6,2,2,2,3,0,0,0,17
780,781302,25,3,7,2,5,1,2,0,0,1,2,2,2,1,1,1,7
780,796363,15,3,6,1,2,2,4,0,0,1,2,0,1,1,0,0,8
780,790801,16,2,5,2,4,0,1,0,0,1,2,1,1,0,0,0,4
780,781305,16,2,5,2,2,0,3,0,0,2,3,5,0,2,0,0,4
780,796364,8,1,3,1,3,0,0,1,2,1,2,0,3,1,0,1,3
780,780598,17,2,4,2,2,0,2,2,2,3,0,0,1,2,1,0,6
780,796362,7,1,1,1,1,0,0,0,0,0,1,0,0,0,1,1,2
780,790802,10,2,4,1,1,1,3,1,2,0,0,1,1,0,2,0,6
781,797616,23,1,6,1,5,0,1,0,0,2,3,1,4,1,6,0,2
781,791882,23,3,6,1,4,2,2,0,1,4,2,2,3,0,2,0,8
781,786491,29,4,9,4,6,0,3,5,7,1,6,2,1,0,2,0,13
781,791881,28,1,4,0,2,1,2,2,2,0,3,4,2,2,4,0,5
781,786420,32,4,9,1,3,3,6,0,0,0,1,2,2,1,5,0,11
781,797618,13,1,2,1,2,0,0,0,0,0,1,0,2,0,1,0,2
781,781052,22,1,4,0,0,1,4,0,0,0,0,1,0,1,2,1,3
781,797613,20,4,6,0,0,4,6,0,0,0,1,2,0,1,1,0,12
781,797614,6,0,2,0,0,0,2,2,2,0,0,0,0,0,0,0,2
781,797617,4,0,2,0,1,0,1,0,0,1,0,0,1,0,0,0,0
782,796884,35,6,12,5,7,1,5,6,9,1,1,5,4,1,1,2,19
782,796886,30,5,8,5,8,0,0,7,9,1,7,1,3,1,0,0,17
782,796882,36,2,9,2,7,0,2,5,8,2,1,4,3,0,6,0,9
782,790447,19,4,7,4,7,0,0,0,0,0,3,0,5,0,1,0,8
782,796892,8,3,3,3,3,0,0,1,1,2,3,0,4,0,2,0,7
782,796891,24,4,11,4,11,0,0,0,0,2,3,0,4,0,1,0,8
782,785324,19,3,6,3,5,0,1,0,0,0,3,0,0,0,0,0,6
782,796888,22,0,2,0,1,0,1,0,0,2,1,1,2,0,1,0,0
782,776336,4,0,1,0,0,0,1,0,0,0,0,0,0,0,1,0,0
782,796881,3,0,0,0,0,0,0,0,0,1,0,0,2,0,1,0,0
783,797628,32,8,14,6,9,2,5,1,3,3,5,0,4,0,6,0,19
783,786481,29,6,8,6,8,0,0,3,6,2,4,1,5,0,2,0,15
783,797624,26,4,6,1,2,3,4,0,1,1,5,0,4,2,2,0,11
783,797626,33,1,5,1,5,0,0,7,10,1,7,3,3,1,3,0,9
783,785965,23,4,9,3,7,1,2,0,0,0,1,7,1,1,2,0,9
783,781032,11,1,2,0,0,1,2,1,2,0,0,0,1,0,0,0,4
783,791793,7,1,3,1,2,0,1,2,2,1,0,0,4,0,3,0,4
783,791791,24,1,4,1,1,0,3,0,1,1,3,1,5,2,0,0,2
783,797627,15,0,3,0,1,0,2,0,0,0,1,0,0,0,0,0,0
784,792118,28,3,10,2,6,1,4,5,5,0,2,0,1,1,4,0,12
784,785402,24,3,4,3,4,0,0,6,8,0,5,1,1,0,1,1,12
784,782593,25,3,12,3,7,0,5,1,2,0,3,4,1,1,1,2,7
784,785828,16,2,5,2,4,0,1,0,1,0,2,0,4,1,3,0,4
784,791700,20,0,6,0,5,0,1,1,2,0,2,0,0,0,3,0,1
784,791699,23,5,9,2,5,3,4,2,2,5,3,1,2,0,1,0,15
784,792663,8,1,1,1,1,0,0,3,3,0,0,0,1,0,0,0,5
784,797526,17,1,6,1,5,0,1,2,2,0,0,2,1,0,0,0,4
784,797523,20,0,1,0,0,0,1,0,0,0,0,2,0,0,1,1,0
784,791702,17,0,3,0,3,0,0,0,0,4,5,0,3,0,2,1,0
784,791698,2,0,0,0,0,0,0,0,0,0,0,0,0,0,0,0,0
785,786179,26,6,13,2,4,4,9,6,8,0,6,4,1,1,1,0,22
785,786177,22,5,11,3,5,2,6,0,0,1,1,2,2,0,1,1,12
785,780238,28,5,11,4,7,1,4,0,0,0,2,2,2,3,3,0,11
785,791750,25,4,4,1,1,3,3,0,0,1,6,4,2,1,1,0,11
785,780244,22,2,6,0,2,2,4,3,4,0,2,0,1,0,0,2,9
785,790773,16,1,5,0,0,1,5,2,2,0,4,0,2,2,0,0,5
785,785909,13,2,4,2,4,0,0,0,0,0,4,0,4,0,0,0,4
785,797346,4,1,3,0,2,1,1,1,2,0,0,0,2,0,0,0,4
785,791752,12,1,3,0,2,1,1,0,1,0,1,0,2,0,1,0,3
785,791749,4,1,1,1,1,0,0,0,0,0,0,0,0,0,0,0,2
785,797347,4,1,1,1,1,0,0,0,0,0,0,0,0,0,0,1,2
785,781500,16,0,1,0,0,0,1,0,0,0,0,5,2,0,2,0,0
785,791748,4,0,0,0,0,0,0,0,0,0,0,0,0,0,1,0,0
785,786171,4,0,0,0,0,0,0,0,0,0,0,0,1,0,0,0,0
786,780717,31,3,10,3,7,0,3,5,8,2,0,0,3,3,1,0,11
786,786203,33,2,10,2,4,0,6,2,2,0,7,1,1,1,1,0,6
786,791738,27,3,10,3,10,0,0,1,2,3,3,0,2,1,1,2,7
786,776266,35,1,5,1,5,0,0,7,8,0,2,4,4,1,3,1,9
786,791742,18,1,5,1,2,0,3,0,0,1,2,0,0,0,0,0,2
786,776328,16,2,3,1,1,1,2,0,1,1,3,0,0,0,1,1,5
786,786315,6,0,0,0,0,0,0,0,0,0,0,0,0,0,0,0,0
786,791741,18,2,5,2,3,0,2,3,4,1,0,0,1,1,0,0,7
786,791740,2,0,1,0,0,0,1,0,0,0,0,0,1,0,0,0,0
786,774859,0,0,0,0,0,0,0,0,0,0,0,0,0,0,0,0,0
786,786197,14,1,2,1,2,0,0,4,6,0,1,1,5,0,2,2,6
787,791051,20,2,2,2,2,0,0,1,1,2,1,0,3,0,2,2,5
787,775456,23,2,10,2,9,0,1,4,5,0,3,4,2,1,5,0,8
787,781115,30,2,7,2,7,0,0,2,2,0,2,0,4,1,2,0,6
787,785524,23,2,5,2,5,0,0,0,0,1,5,0,1,0,2,0,4
787,775094,13,1,6,1,6,0,0,0,0,0,4,0,4,0,1,0,2
787,796730,11,0,3,0,3,0,0,0,0,0,4,0,0,0,1,1,0
787,796731,11,0,1,0,0,0,1,0,0,0,2,1,3,1,0,0,0
787,785784,1,0,1,0,0,0,1,0,0,0,0,0,1,0,0,0,0
787,780739,26,3,9,3,8,0,1,1,2,1,1,1,0,0,1,1,7
787,791052,4,1,2,1,2,0,0,0,0,1,0,0,3,0,1,0,2
787,791053,16,2,3,2,3,0,0,3,3,1,3,2,4,0,2,0,7
787,786310,22,2,4,1,3,1,1,1,2,1,2,3,2,1,0,0,6
788,785536,12,5,6,3,3,2,3,0,0,1,1,0,1,1,0,2,12
788,780119,35,4,15,4,13,0,2,3,4,6,3,2,3,1,2,0,11
788,776097,33,6,12,5,9,1,3,1,1,3,3,4,2,1,1,1,14
788,796559,32,7,12,5,9,2,3,8,10,3,6,1,3,0,2,0,24
788,785280,31,1,6,1,3,0,3,1,2,1,2,2,2,4,1,0,3
788,796560,12,0,0,0,0,0,0,0,0,1,2,0,0,1,1,1,0
788,775679,20,0,5,0,2,0,3,0,0,1,4,1,0,0,3,0,0
788,780149,12,1,5,0,2,1,3,2,2,0,2,1,0,0,1,0,5
788,796561,13,1,1,0,0,1,1,0,0,0,0,1,5,0,0,0,3
789,797895,14,5,8,4,7,1,1,0,1,4,2,0,1,1,2,1,11
789,789058,16,0,4,0,2,0,2,0,0,1,3,0,2,1,0,1,0
789,797898,28,6,11,3,7,3,4,2,4,1,2,3,2,1,3,0,17
789,792236,33,4,14,4,13,0,1,1,2,0,0,3,1,1,2,0,9
789,781374,16,2,4,1,3,1,1,0,0,0,1,0,3,1,1,0,5
789,785286,11,1,1,0,0,1,1,0,0,0,0,1,2,1,1,0,3
789,792359,12,1,4,0,0,1,4,0,0,0,2,0,1,0,0,0,3
789,792237,18,2,5,2,3,0,2,4,4,0,2,0,0,1,1,0,8
789,776337,8,0,0,0,0,0,0,2,2,0,1,0,2,0,0,0,2
789,785818,16,0,1,0,0,0,1,2,2,2,0,0,1,0,1,0,2
789,792238,11,0,0,0,0,0,0,0,0,0,1,0,1,0,1,1,0
789,792240,7,0,0,0,0,0,0,0,0,1,2,0,1,0,0,0,0
789,797897,9,0,2,0,0,0,2,0,1,0,1,0,1,0,0,0,0
789,785986,1,0,0,0,0,0,0,0,0,0,0,0,0,0,0,0,0
790,781560,22,2,3,2,3,0,0,0,1,1,5,0,1,0,1,1,4
790,791375,36,2,8,0,1,2,7,0,0,2,2,2,4,1,0,0,6
790,785487,33,2,7,2,4,0,3,3,3,0,2,1,4,0,3,0,7
790,785482,32,9,17,6,10,3,7,6,8,0,4,4,3,2,2,0,27
790,780837,32,6,13,2,5,4,8,2,3,0,1,0,5,0,1,0,18
790,786164,18,1,4,0,1,1,3,0,0,1,2,0,1,1,1,1,3
790,796479,13,1,4,0,1,1,3,3,3,0,1,0,3,2,0,0,6
790,796477,7,1,2,1,1,0,1,0,0,0,0,0,0,1,0,0,2
790,796473,7,0,0,0,0,0,0,0,0,0,2,0,3,0,0,0,0
791,796347,19,1,5,1,4,0,1,0,0,1,4,1,1,0,2,0,2
791,785243,25,3,5,1,2,2,3,2,3,2,3,1,3,0,1,1,10
791,790788,35,7,13,4,5,3,8,4,4,0,6,1,1,0,4,0,21
791,781028,38,7,12,6,8,1,4,7,11,0,5,3,3,0,2,1,22
791,781026,23,3,5,1,2,2,3,10,11,0,2,2,2,1,0,0,18
791,796349,27,0,4,0,1,0,3,0,0,0,2,1,3,1,1,1,0
791,796348,4,0,0,0,0,0,0,0,0,1,1,1,0,0,0,0,0
791,785242,17,1,1,1,1,0,0,0,0,0,3,1,1,0,1,0,2
791,781027,9,0,0,0,0,0,0,2,2,1,3,0,3,1,0,0,2
791,790787,3,0,0,0,0,0,0,0,0,0,0,0,0,0,0,0,0
792,791041,40,9,17,5,8,4,9,4,4,4,5,3,4,0,7,0,26
792,774806,27,7,14,7,13,0,1,2,5,6,7,0,3,1,3,2,16
792,775823,28,2,5,2,4,0,1,5,6,6,3,4,4,0,4,0,9
792,789023,40,2,13,0,5,2,8,2,2,0,2,7,1,0,1,0,8
792,791038,26,1,4,0,1,1,3,4,5,1,1,3,4,3,2,1,7
792,775205,26,2,8,1,1,1,7,2,2,0,3,1,2,1,1,0,7
792,796714,12,3,4,3,4,0,0,1,2,3,1,0,3,1,1,0,7
792,796716,1,0,0,0,0,0,0,0,0,0,0,0,0,0,0,0,0
793,792050,26,6,8,3,3,3,5,3,7,1,2,3,3,1,1,1,18
793,785347,31,3,9,0,4,3,5,2,4,0,2,4,2,1,1,0,11
793,786338,26,3,11,2,7,1,4,2,2,3,1,2,1,1,2,0,9
793,791512,17,2,5,2,5,0,0,2,2,1,2,0,4,0,1,0,6
793,775601,20,0,7,0,5,0,2,5,6,1,1,3,4,1,4,0,5
793,792052,20,3,5,1,3,2,2,2,2,0,0,0,2,0,2,0,10
793,786825,19,3,3,3,3,0,0,2,4,3,6,0,2,1,4,1,8
793,792047,15,3,4,2,2,1,2,0,0,0,5,0,4,1,1,0,7
793,797648,8,2,2,1,1,1,1,0,0,1,0,2,0,0,1,0,5
793,792045,4,1,1,1,1,0,0,0,0,0,0,0,2,0,1,0,2
793,775476,11,0,1,0,0,0,1,0,0,0,1,0,1,0,0,0,0
793,797647,3,0,0,0,0,0,0,0,0,0,0,1,1,0,0,0,0
800,785368,21,3,4,3,4,0,0,3,4,3,5,0,3,0,1,1,9
800,785247,28,6,10,5,7,1,3,3,6,0,3,2,4,2,5,0,16
800,790793,33,6,13,5,11,1,2,6,8,1,5,4,2,5,4,0,19
800,790792,25,2,3,2,3,0,0,4,5,0,2,0,3,2,1,1,8
800,785246,29,2,8,1,5,1,3,2,2,1,2,0,2,1,0,1,7
800,780281,13,0,3,0,1,0,2,0,2,1,3,0,1,0,1,0,0
800,780886,22,4,6,3,3,1,3,6,7,0,1,3,3,1,2,0,15
800,790794,18,1,1,1,1,0,0,0,2,0,4,0,3,1,0,1,2
800,796350,8,0,1,0,0,0,1,0,0,0,0,1,1,0,0,0,0
800,790789,3,0,1,0,0,0,1,0,0,0,0,0,0,0,0,0,0
801,796585,23,2,4,2,4,0,0,0,4,1,2,0,5,0,0,0,4
801,780192,27,3,6,1,2,2,4,1,2,0,3,0,5,2,5,0,9
801,798139,30,4,12,2,8,2,4,2,2,0,3,6,4,1,5,0,12
801,786818,32,4,9,4,7,0,2,4,6,2,2,1,1,1,2,0,12
801,780182,34,4,13,1,5,3,8,2,2,1,7,3,3,3,4,0,13
801,780186,17,2,2,2,2,0,0,0,1,3,2,1,3,0,2,0,4
801,786820,11,1,2,1,2,0,0,0,0,0,0,3,3,0,1,0,2
801,798138,16,3,6,0,0,3,6,0,0,0,3,0,2,0,1,0,9
801,780184,10,1,2,1,2,0,0,2,2,0,0,1,1,0,0,0,4
802,785996,25,6,8,5,7,1,1,1,2,3,6,0,2,0,0,2,14
802,780858,25,6,12,5,10,1,2,0,0,4,5,1,0,0,0,1,13
802,797646,20,5,9,3,6,2,3,0,1,1,0,3,2,1,3,1,12
802,792039,18,2,3,2,2,0,1,2,4,0,2,0,1,1,0,0,6
802,780849,27,4,7,2,3,2,4,0,0,0,1,3,0,1,1,0,10
802,785990,18,4,7,3,4,1,3,0,0,0,1,2,0,0,1,0,9
802,780853,23,2,7,2,7,0,0,2,2,0,3,5,2,2,1,0,6
802,792235,11,1,3,1,3,0,0,0,2,1,3,0,5,1,3,1,2
802,785998,13,1,5,1,1,0,4,0,0,2,0,0,0,1,0,0,2
802,780776,13,1,4,1,4,0,0,0,0,1,3,0,0,0,1,0,2
802,791374,5,0,0,0,0,0,0,0,0,0,2,0,1,0,0,0,0
802,786001,2,0,0,0,0,0,0,0,2,0,0,0,0,0,1,0,0
803,785294,28,2,6,2,6,0,0,0,1,3,7,1,3,0,2,0,4
803,791081,13,1,3,1,3,0,0,0,0,1,1,0,3,1,2,2,2
803,791085,24,6,10,6,9,0,1,3,4,1,1,2,0,2,3,0,15
803,786446,21,3,10,0,3,3,7,1,2,2,0,0,3,1,2,0,10
803,785675,27,1,7,0,3,1,4,0,0,1,2,4,0,0,0,0,3
803,791083,17,3,7,3,3,0,4,0,0,2,2,0,2,0,1,1,6
803,796514,16,0,1,0,0,0,1,0,0,0,0,2,0,0,3,0,0
803,791080,24,5,9,3,5,2,4,0,0,1,5,0,1,2,1,0,12
803,796511,17,0,3,0,0,0,3,2,5,1,1,2,0,0,0,0,2
803,791077,6,0,2,0,0,0,2,0,0,0,0,0,0,0,0,0,0
803,796512,5,1,3,0,0,1,3,0,0,0,1,0,0,1,1,0,3
803,796515,2,0,1,0,0,0,1,0,0,0,0,0,0,0,0,0,0
804,780993,23,3,6,2,5,1,1,1,2,7,7,1,1,0,1,0,8
804,775248,24,5,14,5,7,0,7,3,4,4,2,3,1,2,1,2,13
804,797225,23,3,9,3,8,0,1,0,0,0,4,4,2,3,1,1,6
804,791452,26,2,3,0,0,2,3,0,0,0,0,2,1,1,1,1,6
804,797224,24,7,14,6,8,1,6,2,2,1,4,0,2,5,1,1,17
804,797230,12,7,9,7,9,0,0,1,2,5,1,0,0,0,1,0,15
804,797228,2,0,0,0,0,0,0,0,0,1,0,1,0,0,1,0,0
804,791446,8,1,3,1,1,0,2,0,0,0,1,0,2,0,0,0,2
804,797226,9,2,4,2,3,0,1,1,1,0,4,1,2,0,1,0,5
804,791447,4,0,0,0,0,0,0,1,2,0,0,0,0,0,0,0,1
804,797231,14,0,3,0,2,0,1,2,2,2,5,2,3,0,0,0,2
804,797229,4,1,1,1,1,0,0,0,0,0,0,0,0,0,0,0,2
804,797227,11,0,4,0,0,0,4,0,0,0,2,0,0,0,1,0,0
804,791449,16,6,9,5,6,1,3,0,2,1,2,1,1,2,1,1,13
806,790873,28,6,9,6,8,0,1,4,4,2,5,1,3,0,2,0,16
806,780054,24,4,7,3,4,1,3,2,2,1,2,2,2,0,2,1,11
806,781140,28,3,6,2,3,1,3,3,4,3,6,1,2,2,1,1,10
806,786851,28,4,11,1,5,3,6,0,0,0,3,4,1,2,1,0,11
806,776357,33,3,8,2,5,1,3,4,4,1,3,4,3,3,1,0,11
806,785429,15,3,6,0,0,3,6,0,0,1,1,1,0,0,0,0,9
806,796432,15,2,6,2,3,0,3,0,0,0,3,0,1,0,0,0,4
806,796433,16,1,5,1,5,0,0,0,0,4,2,0,2,0,0,1,2
806,780343,11,1,1,0,0,1,1,0,0,0,1,2,1,0,0,0,3
806,790527,1,0,1,0,1,0,0,0,0,1,0,0,0,0,0,0,0
806,796102,1,0,1,0,1,0,0,0,2,1,0,0,0,0,0,0,0
807,797292,28,1,6,1,6,0,0,1,2,4,2,0,3,0,3,0,3
807,791661,20,1,5,0,1,1,4,0,0,0,0,0,3,0,0,0,3
807,780509,25,1,8,0,7,1,1,0,0,1,3,0,1,1,2,0,3
807,797290,31,2,8,1,5,1,3,6,6,1,6,3,2,0,3,0,11
807,791660,32,1,7,0,2,1,5,0,0,0,1,3,2,1,2,0,3
807,791663,12,1,3,1,3,0,0,0,0,1,1,0,3,0,3,1,2
807,797291,18,2,4,1,3,1,1,1,2,0,0,2,0,0,2,0,6
807,786064,28,4,9,2,3,2,6,3,3,1,5,0,2,0,2,0,13
807,785658,3,0,2,0,1,0,1,0,0,1,0,0,0,0,0,0,0
807,797294,3,0,0,0,0,0,0,0,0,0,0,0,0,0,0,0,0
808,792005,32,11,19,6,9,5,10,5,6,1,3,0,4,0,3,2,32
808,781175,25,2,3,2,3,0,0,1,2,1,7,0,4,0,2,1,5
808,786553,28,2,10,1,6,1,4,1,2,1,2,6,1,4,2,0,6
808,780895,31,2,9,1,6,1,3,2,2,2,1,0,2,0,2,0,7
808,781172,34,1,2,1,2,0,0,0,2,2,6,6,3,1,2,0,2
808,781177,15,0,2,0,1,0,1,0,0,2,3,0,1,2,0,0,0
808,786555,9,1,5,0,0,1,5,0,0,0,1,0,4,0,0,0,3
808,785312,26,6,11,5,8,1,3,4,5,0,2,2,0,2,4,0,17
808,797501,0,0,0,0,0,0,0,0,0,0,0,0,0,0,0,0,0
809,780178,16,5,7,5,7,0,0,3,5,0,2,0,1,0,1,0,13
809,775075,14,1,2,1,2,0,0,0,0,1,1,0,0,0,1,1,2
809,792376,28,4,14,2,7,2,7,1,1,0,6,2,1,0,1,1,11
809,797883,31,3,8,2,6,1,2,0,1,1,2,6,3,2,1,0,7
809,786747,21,1,1,1,1,0,0,0,0,0,2,0,1,2,3,0,2
809,786746,22,1,2,0,0,1,2,2,2,0,3,0,2,1,3,0,5
809,792378,17,3,6,3,6,0,0,3,5,3,2,1,2,0,2,0,9
809,792374,9,1,1,0,0,1,1,4,4,0,1,0,5,0,2,0,7
809,797890,19,1,3,1,2,0,1,3,4,0,2,1,2,1,1,0,5
809,797885,12,2,6,2,5,0,1,0,0,1,1,0,1,0,0,0,4
809,797888,11,2,4,2,4,0,0,0,0,0,2,2,2,0,1,0,4
810,780879,21,4,5,4,5,0,0,0,0,2,2,4,1,1,1,0,8
810,796324,20,4,7,4,5,0,2,3,4,1,4,0,3,0,3,1,11
810,790768,20,2,7,2,3,0,4,1,1,0,0,4,2,3,0,1,5
810,785226,22,3,5,1,2,2,3,0,0,0,1,3,0,2,1,1,8
810,780875,17,2,4,1,3,1,1,2,2,2,3,1,2,2,3,0,7
810,790767,17,2,5,1,2,1,3,0,0,0,3,1,2,0,3,0,5
810,785743,24,2,8,1,2,1,6,0,0,0,1,2,0,1,2,0,5
810,785224,17,4,5,2,3,2,2,3,4,1,5,1,0,0,0,0,13
810,775785,5,0,0,0,0,0,0,0,0,0,1,0,0,0,0,0,0
810,790769,18,2,5,2,5,0,0,1,2,1,2,1,2,1,1,0,5
810,796325,12,1,5,1,5,0,0,0,0,4,0,0,2,0,1,2,2
810,792437,2,0,0,0,0,0,0,2,2,0,1,0,0,0,0,0,2
810,796041,2,0,1,0,0,0,1,0,0,0,0,0,0,0,0,0,0
810,785225,3,1,1,0,0,1,1,1,2,1,0,0,0,0,0,0,4
811,787996,25,4,9,4,9,0,0,2,2,3,3,0,2,0,1,0,10
811,798962,20,4,9,4,9,0,0,0,0,1,0,0,3,2,2,1,8
811,798968,14,0,3,0,2,0,1,0,0,2,3,0,1,0,0,0,0
811,791718,24,2,8,2,5,0,3,2,2,1,3,2,1,0,0,0,6
811,781446,17,0,5,0,3,0,2,1,2,1,0,1,0,0,4,0,1
811,798965,23,2,5,1,3,1,2,0,0,0,4,0,1,1,1,0,5
811,798963,23,2,4,2,4,0,0,0,0,1,0,2,1,0,8,0,4
811,791717,14,0,2,0,1,0,1,0,0,0,1,0,3,1,3,1,0
811,791719,13,1,5,1,3,0,2,0,0,0,1,0,1,0,0,0,2
811,798967,12,1,2,1,1,0,1,0,0,1,1,1,0,2,1,0,2
811,791720,5,0,0,0,0,0,0,0,0,0,1,0,0,0,0,0,0
811,798964,7,0,1,0,1,0,0,0,0,1,0,0,3,0,1,2,0
811,798969,3,0,2,0,0,0,2,0,0,0,0,0,0,0,0,0,0
812,791414,16,9,9,9,9,0,0,3,5,3,4,2,2,1,4,1,21
812,785911,16,8,10,8,10,0,0,2,4,1,6,2,4,1,2,3,18
812,791413,22,5,6,3,3,2,3,4,5,2,3,5,1,0,0,0,16
812,791411,19,6,8,3,3,3,5,2,2,0,4,10,2,2,5,1,17
812,785776,22,4,5,3,3,1,2,4,7,0,6,11,3,1,3,0,13
812,797102,14,8,8,8,8,0,0,0,1,1,3,0,2,0,2,0,16
812,797099,13,7,8,7,8,0,0,0,0,0,5,3,0,1,1,1,14
812,786403,16,5,7,5,6,0,1,2,2,1,1,5,1,1,2,1,12
812,797101,9,1,1,0,0,1,1,4,4,0,2,1,0,0,0,0,7
812,797104,8,0,2,0,1,0,1,1,4,0,0,3,0,0,1,0,1
812,797105,26,12,13,11,11,1,2,5,6,1,4,7,2,1,1,0,30
812,781209,19,5,6,5,5,0,1,2,2,0,7,8,1,2,0,0,12
814,776110,21,3,5,2,3,1,2,0,0,3,4,0,2,1,0,0,7
814,780059,32,4,8,3,7,1,1,2,2,3,5,5,3,2,5,0,11
814,790944,29,4,11,1,5,3,6,4,4,3,3,1,1,0,1,0,15
814,786754,22,3,9,2,6,1,3,3,5,0,1,3,4,0,2,0,10
814,780061,28,5,11,4,5,1,6,5,6,1,4,2,4,0,1,0,16
814,780058,17,2,4,0,0,2,4,0,0,0,2,0,2,1,1,0,6
814,796494,24,5,9,2,3,3,6,2,4,1,2,1,4,1,0,0,15
814,796496,9,1,2,1,1,0,1,0,0,0,1,0,0,0,0,0,2
814,790943,9,1,1,1,1,0,0,2,2,1,2,0,3,0,0,0,4
814,796497,4,1,1,1,1,0,0,0,0,1,0,0,0,0,0,0,2
814,796495,1,0,0,0,0,0,0,0,0,0,0,0,0,0,2,0,0
814,790941,2,0,0,0,0,0,0,0,0,0,1,0,0,0,0,0,0
814,796499,1,0,1,0,1,0,0,0,0,0,0,0,0,0,0,0,0
814,785097,1,0,0,0,0,0,0,0,0,0,0,0,0,0,0,0,0
815,790837,29,1,3,0,1,1,2,0,0,0,4,1,2,0,1,0,3
815,780025,19,6,8,6,8,0,0,5,6,0,3,0,4,0,0,0,17
815,786228,26,0,7,0,3,0,4,0,1,0,1,4,3,0,1,0,0
815,785385,19,3,8,2,3,1,5,3,3,1,2,0,0,1,1,0,10
815,785383,38,5,13,3,8,2,5,7,7,2,2,6,1,1,4,0,19
815,786297,10,2,2,2,2,0,0,1,5,1,1,0,2,3,0,1,5
815,781046,6,0,0,0,0,0,0,0,1,0,1,0,1,0,0,0,0
815,785384,18,1,3,1,1,0,2,4,4,1,0,0,3,1,0,1,6
815,785382,6,0,1,0,0,0,1,0,0,0,1,0,1,0,0,0,0
815,792180,16,1,5,1,2,0,3,0,0,2,1,0,1,2,0,1,2
815,796391,13,4,5,3,4,1,1,0,0,0,3,0,2,1,1,0,9
816,796955,31,4,7,4,6,0,1,5,9,2,7,0,1,1,2,1,13
816,791257,14,1,3,1,3,0,0,0,0,0,3,0,2,0,4,1,2
816,781606,38,5,12,3,9,2,3,3,6,0,4,3,1,1,2,0,15
816,781263,36,4,12,4,8,0,4,2,2,4,7,2,1,1,4,0,10
816,781257,37,4,11,1,6,3,5,2,2,0,0,1,3,1,1,0,13
816,791255,8,0,2,0,0,0,2,0,0,0,2,0,2,1,0,0,0
816,780900,9,1,4,1,4,0,0,0,0,3,3,0,3,0,2,0,2
816,796954,23,2,5,0,2,2,3,0,0,0,4,0,1,0,1,0,6
816,785508,4,0,0,0,0,0,0,0,0,0,2,0,0,0,0,0,0
817,796870,34,2,7,2,7,0,0,0,0,3,2,0,4,0,0,0,4
817,786861,36,5,12,3,5,2,7,1,1,3,4,0,2,1,4,0,13
817,792415,38,7,13,4,7,3,6,3,4,0,8,2,3,4,4,1,20
817,780387,27,6,9,6,8,0,1,0,3,2,5,1,1,1,1,0,12
817,767033,25,3,13,2,9,1,4,2,2,1,4,2,4,1,1,1,9
817,785801,5,1,3,0,0,1,3,0,0,0,2,0,1,0,0,0,3
817,792416,14,1,2,0,1,1,1,0,0,1,0,1,1,0,0,0,3
817,786867,7,0,0,0,0,0,0,0,0,0,1,0,0,0,0,0,0
817,786866,14,1,8,1,2,0,6,0,0,0,2,1,1,0,0,1,2
818,791583,15,2,4,2,4,0,0,3,7,0,3,2,4,0,0,2,7
818,781407,21,3,4,3,4,0,0,0,0,1,3,2,0,1,1,3,6
818,785623,18,1,4,0,0,1,4,3,4,0,1,0,1,2,1,0,6
818,780580,35,4,12,1,8,3,4,6,6,1,0,2,1,4,2,1,17
818,776150,29,5,9,3,7,2,2,2,2,2,2,2,1,1,0,0,14
818,786608,21,2,9,2,6,0,3,0,2,1,4,1,2,0,1,0,4
818,797448,14,0,5,0,1,0,4,0,0,0,5,1,1,0,0,0,0
818,797445,25,4,4,2,2,2,2,1,2,0,1,1,4,0,1,0,11
818,791584,22,5,7,5,7,0,0,1,1,2,9,0,3,0,1,2,11
819,780765,38,8,17,4,9,4,8,5,9,3,7,2,2,1,3,0,25
819,786255,31,5,13,5,11,0,2,0,2,2,4,2,3,1,4,0,10
819,781301,24,1,2,1,2,0,0,3,4,1,5,0,4,0,1,1,5
819,780762,31,2,5,2,3,0,2,4,6,0,3,1,2,0,1,0,8
819,780768,34,2,6,1,5,1,1,0,0,0,1,3,5,2,0,0,5
819,791729,18,2,3,2,2,0,1,0,0,0,4,1,3,0,1,0,4
819,780755,23,2,6,1,4,1,2,1,2,1,4,1,1,0,3,0,6
819,797320,1,0,0,0,0,0,0,0,0,0,0,0,0,0,1,0,0
819,797319,0,0,0,0,0,0,0,0,0,0,0,0,0,0,0,0,0
820,791949,22,5,10,5,8,0,2,4,9,1,5,0,5,2,2,2,14
820,776014,24,3,7,3,6,0,1,2,2,4,8,2,1,1,1,1,8
820,797691,31,2,6,2,6,0,0,0,0,0,3,5,0,2,1,0,4
820,780747,29,5,9,3,6,2,3,2,2,0,4,9,2,2,1,2,14
820,776363,33,4,7,1,2,3,5,5,5,0,2,1,0,2,0,0,16
820,784336,24,4,6,4,6,0,0,1,2,3,5,1,1,0,0,3,9
820,791946,28,4,9,2,5,2,4,0,0,0,0,1,1,1,1,0,10
820,791948,9,2,2,2,2,0,0,0,0,1,0,0,1,0,2,2,4
821,797830,33,6,13,6,11,0,2,1,1,2,2,2,3,0,4,0,13
821,797824,30,2,9,2,8,0,1,1,2,3,6,2,3,1,1,1,5
821,775116,16,3,6,2,3,1,3,0,0,0,4,1,3,0,3,0,7
821,792190,33,3,9,1,6,2,3,0,0,1,3,2,1,1,4,0,8
821,781266,10,1,3,0,0,1,3,0,0,0,0,0,1,0,1,0,3
821,797827,11,0,4,0,1,0,3,0,0,0,0,0,1,0,0,0,0
821,792192,18,1,7,1,7,0,0,2,4,2,3,0,3,1,0,0,4
821,792191,31,1,4,1,4,0,0,2,2,3,1,3,0,0,2,0,4
821,797825,15,2,4,2,4,0,0,0,0,1,2,0,2,0,1,0,4
821,797828,3,0,1,0,0,0,1,0,0,0,0,0,0,1,0,0,0
822,781398,34,3,9,3,6,0,3,1,1,4,1,1,1,0,0,1,7
822,786029,27,3,10,3,9,0,1,4,6,3,3,0,2,1,3,3,10
822,792114,29,8,18,4,9,4,9,6,7,0,4,3,3,1,0,0,26
822,786018,35,1,6,1,4,0,2,0,0,1,4,2,0,1,1,0,2
822,775678,28,5,11,3,7,2,4,6,7,0,3,2,4,0,1,0,18
822,797746,18,3,5,2,4,1,1,2,2,2,6,1,3,1,1,0,9
822,786022,10,3,3,2,2,1,1,0,2,2,1,0,1,0,0,0,7
822,797744,19,1,4,0,3,1,1,3,3,0,1,3,0,1,1,1,6
823,786547,30,0,6,0,2,0,4,2,3,4,4,2,0,0,1,0,2
823,786544,32,11,22,7,12,4,10,1,3,2,5,0,3,1,3,0,27
823,797507,33,3,8,2,5,1,3,0,2,4,4,1,2,0,0,0,7
823,792012,32,10,20,4,9,6,11,2,3,2,4,8,3,1,2,0,28
823,775084,27,3,8,2,7,1,1,2,2,1,2,2,5,1,3,0,9
823,786860,10,1,2,0,0,1,2,0,0,0,0,1,2,0,1,0,3
823,797510,3,0,0,0,0,0,0,0,0,0,0,0,1,0,1,0,0
823,786546,24,0,2,0,2,0,0,0,0,0,3,1,2,2,0,0,0
823,797509,9,2,3,2,3,0,0,0,0,0,0,0,1,0,0,0,4
824,786080,21,7,13,3,7,4,6,0,0,1,5,3,3,1,2,1,18
824,786216,22,6,9,5,8,1,1,0,0,1,3,4,3,1,2,0,13
824,791348,29,0,3,0,2,0,1,1,2,0,8,0,1,1,4,0,1
824,786218,28,8,9,8,8,0,1,0,1,0,3,2,3,1,4,0,16
824,780150,19,1,4,0,1,1,3,0,0,0,1,0,2,1,0,0,3
824,797258,6,1,2,1,2,0,0,0,0,0,1,0,1,1,0,0,2
824,797257,12,0,1,0,1,0,0,0,1,1,2,0,2,0,1,2,0
824,791350,25,2,3,1,1,1,2,0,0,1,3,1,1,1,2,0,5
824,785256,25,3,7,3,7,0,0,10,13,0,2,4,2,3,2,0,16
824,781645,9,2,3,2,3,0,0,0,0,0,0,0,1,0,2,0,4
824,780156,2,0,0,0,0,0,0,0,0,0,0,0,0,0,0,0,0
824,797256,1,0,0,0,0,0,0,0,0,0,0,0,0,0,0,0,0
824,797259,1,0,0,0,0,0,0,0,0,0,0,0,0,0,0,0,0
825,791858,29,4,9,2,2,2,7,2,2,3,6,3,4,0,4,1,12
825,797469,28,0,3,0,2,0,1,2,2,0,3,2,5,0,3,0,2
825,797463,39,6,19,2,12,4,7,1,5,2,7,2,3,2,4,0,17
825,791855,31,2,5,1,3,1,2,3,7,0,4,1,4,1,6,3,8
825,791854,38,7,11,6,9,1,2,0,1,1,0,1,0,3,3,0,15
825,797467,14,2,3,2,3,0,0,0,0,2,1,0,1,0,1,1,4
825,791857,21,3,8,2,2,1,6,0,0,0,2,1,2,0,1,0,7
826,796980,12,2,4,2,4,0,0,0,1,3,2,0,4,0,2,1,4
826,776200,29,3,9,3,8,0,1,1,2,1,7,1,2,2,1,0,7
826,780925,21,2,8,2,3,0,5,0,0,0,0,0,1,1,3,0,4
826,780446,27,5,10,3,5,2,5,1,1,0,4,2,1,2,1,0,13
826,781034,28,4,9,3,6,1,3,1,1,0,3,2,1,0,4,0,10
826,791625,6,2,5,1,2,1,3,0,0,0,1,0,1,0,0,0,5
826,796978,2,0,1,0,0,0,1,0,0,0,0,0,1,0,0,0,0
826,788847,1,0,0,0,0,0,0,0,0,0,0,0,0,0,0,0,0
826,796979,22,6,12,3,4,3,8,4,5,3,4,0,2,1,1,2,19
826,791624,7,0,0,0,0,0,0,0,0,0,2,1,1,0,0,0,0
826,791637,5,0,1,0,1,0,0,0,0,0,0,0,0,0,0,0,0
826,786437,10,2,2,2,2,0,0,0,0,0,0,0,1,1,0,1,4
826,785620,30,4,5,2,2,2,3,2,2,0,2,6,1,1,2,1,12
827,791669,21,5,6,5,6,0,0,0,0,1,0,1,3,1,1,0,10
827,785762,31,3,9,3,7,0,2,1,2,1,5,2,2,2,2,0,7
827,797409,20,2,9,2,8,0,1,0,0,1,1,1,1,1,3,0,4
827,780535,17,1,3,1,2,0,1,2,2,0,1,1,0,0,1,0,4
827,780531,38,4,14,3,7,1,7,4,6,2,5,3,0,1,2,0,13
827,797414,7,0,0,0,0,0,0,0,0,0,0,0,0,0,0,0,0
827,791670,2,0,0,0,0,0,0,2,2,1,1,0,0,0,0,0,2
827,780534,19,2,2,2,2,0,0,2,3,1,6,0,4,0,1,1,6
827,791666,20,5,12,3,7,2,5,1,1,1,3,1,1,2,7,0,13
827,785760,25,1,3,1,3,0,0,0,0,0,1,2,3,0,0,0,2
828,796996,18,5,8,5,8,0,0,8,10,5,7,0,0,3,2,1,18
828,780471,22,6,9,6,9,0,0,0,1,3,10,2,4,1,2,2,12
828,791608,15,9,13,1,1,8,12,2,2,0,6,0,1,0,0,0,28
828,780417,11,1,2,1,1,0,1,0,0,1,2,4,0,1,0,0,2
828,776011,16,4,10,3,5,1,5,0,0,2,2,7,0,1,0,0,9
828,791610,17,2,4,2,4,0,0,1,2,0,4,4,0,3,0,1,5
828,786413,18,3,4,3,4,0,0,0,0,1,3,3,2,1,2,1,6
828,796994,19,4,5,1,2,3,3,2,2,0,0,10,2,3,2,0,13
828,791613,16,4,7,3,4,1,3,1,4,0,2,2,0,3,0,0,10
828,791612,5,2,3,1,2,1,1,0,0,0,1,0,0,1,0,0,5
828,791611,14,3,7,1,2,2,5,0,0,0,3,3,2,1,1,0,8
828,786353,13,4,6,2,2,2,4,2,2,0,1,1,0,0,1,0,12
828,785680,16,3,6,0,1,3,5,3,6,0,8,1,2,0,0,0,12
830,791768,8,1,2,1,1,0,1,0,0,0,0,1,3,0,3,1,2
830,786460,26,1,6,1,5,0,1,0,0,4,3,1,4,0,1,0,2
830,780604,33,5,13,5,12,0,1,2,2,1,4,1,2,2,4,0,12
830,780603,29,4,10,2,4,2,6,0,0,0,5,4,5,3,3,0,10
830,780602,37,8,17,8,14,0,3,2,3,2,8,5,3,1,2,0,18
830,786071,25,1,4,1,4,0,0,3,4,3,4,0,1,1,3,2,5
830,791766,12,4,4,1,1,3,3,0,0,0,1,0,1,0,0,0,11
830,791767,5,0,1,0,0,0,1,0,0,0,1,0,2,1,1,0,0
830,786230,25,1,4,0,0,1,4,0,0,1,0,1,1,1,3,0,3
831,786575,31,6,9,6,9,0,0,4,5,6,9,1,4,2,3,3,16
831,792334,28,3,9,3,6,0,3,1,2,2,5,3,4,1,4,1,7
831,798094,28,2,7,2,3,0,4,0,0,0,0,6,2,1,3,0,4
831,792338,36,7,17,6,13,1,4,6,7,0,6,2,2,5,2,0,21
831,781666,36,4,11,2,3,2,8,2,4,0,1,1,2,1,3,0,12
831,798097,8,1,1,1,1,0,0,1,2,0,0,0,1,0,0,2,3
831,798100,6,0,1,0,0,0,1,0,0,0,0,0,0,0,1,0,0
831,791636,24,1,6,0,2,1,4,0,0,0,1,0,1,2,1,0,3
831,798095,3,0,0,0,0,0,0,0,0,0,0,0,0,0,0,0,0
832,786041,30,7,12,7,9,0,3,4,5,4,7,0,1,1,2,2,18
832,780275,17,3,3,3,3,0,0,0,1,0,4,0,4,1,1,1,6
832,780881,23,5,12,4,10,1,2,9,10,4,5,3,3,3,1,0,20
832,786686,30,6,15,5,13,1,2,7,8,0,2,13,1,6,0,0,20
832,792075,24,5,9,3,5,2,4,0,0,0,0,0,2,0,2,1,12
832,780882,19,1,5,1,3,0,2,0,0,2,2,3,2,3,3,0,2
832,780052,15,5,8,3,5,2,3,1,2,2,1,1,3,2,1,0,13
832,786051,11,0,3,0,3,0,0,0,0,2,2,0,0,0,1,0,0
832,792074,21,3,5,2,2,1,3,1,2,1,2,1,2,1,0,0,8
832,780884,7,0,0,0,0,0,0,0,0,0,1,0,4,0,0,0,0
832,792076,3,1,2,0,0,1,2,0,0,0,0,0,0,0,0,0,3
833,797019,25,4,5,3,3,1,2,2,4,0,3,3,1,1,6,0,11
833,774959,24,3,9,0,3,3,6,3,4,1,1,2,4,3,3,1,12
833,781378,28,1,6,0,4,1,2,6,6,0,5,1,1,1,2,2,9
833,791440,24,3,5,3,5,0,0,4,7,2,3,1,2,1,0,0,10
833,775267,25,4,12,2,4,2,8,0,0,2,1,3,1,0,4,0,10
833,791443,19,3,4,2,2,1,2,0,0,1,2,1,3,0,0,0,7
833,775739,10,0,0,0,0,0,0,0,1,1,1,0,3,0,0,1,0
833,797015,8,0,1,0,1,0,0,0,0,0,0,2,1,0,1,1,0
833,791441,15,3,5,0,2,3,3,2,2,1,1,2,2,0,3,1,11
833,797013,14,2,8,1,4,1,4,0,0,2,0,0,1,0,2,0,5
833,781629,4,0,3,0,1,0,2,0,0,0,1,0,0,1,0,0,0
833,797016,4,0,2,0,1,0,1,0,0,1,0,1,0,0,0,0,0
834,781319,24,6,12,6,11,0,1,6,7,2,3,1,3,1,2,2,18
834,792220,19,0,6,0,3,0,3,1,3,1,2,2,2,1,1,0,1
834,786691,33,4,7,3,4,1,3,0,0,0,5,2,2,1,2,0,9
834,786693,25,0,4,0,2,0,2,1,2,0,4,0,0,0,1,1,1
834,781329,35,4,7,2,5,2,2,9,15,1,5,7,3,6,5,0,19
834,797876,13,2,3,2,2,0,1,1,1,1,1,0,4,0,0,0,5
834,792219,10,3,5,3,5,0,0,1,2,1,1,0,1,0,1,0,7
834,792222,6,0,0,0,0,0,0,0,0,0,1,0,0,0,0,0,0
834,792046,16,0,3,0,2,0,1,0,0,0,0,0,0,0,2,0,0
834,781455,19,1,1,1,1,0,0,0,0,0,0,3,1,1,0,0,2
835,776018,30,6,13,6,13,0,0,3,4,1,3,3,1,1,0,2,15
835,797859,20,2,4,2,4,0,0,2,2,1,4,0,4,0,1,0,6
835,797855,36,1,4,0,2,1,2,2,4,2,5,4,4,0,4,1,5
835,792208,9,1,3,1,3,0,0,4,4,1,2,0,5,0,1,0,6
835,781314,26,1,6,1,4,0,2,0,0,1,3,5,5,1,8,0,2
835,786983,1,0,1,0,0,0,1,0,0,1,0,0,0,1,0,0,0
835,797862,4,0,0,0,0,0,0,0,0,0,0,0,0,0,0,1,0
835,797856,25,0,2,0,2,0,0,0,0,1,6,1,1,3,3,0,0
835,792204,21,4,10,1,2,3,8,3,3,0,2,4,2,1,0,0,14
835,786682,14,2,5,0,0,2,5,0,0,0,0,0,1,1,0,0,6
835,786262,14,1,5,0,2,1,3,2,2,0,0,0,1,0,1,0,5
836,790833,20,2,9,2,6,0,3,4,4,0,1,1,4,0,1,2,8
836,796390,19,6,8,6,8,0,0,2,3,4,6,0,2,1,3,2,14
836,790832,18,0,4,0,1,0,3,1,2,0,1,0,4,1,3,1,1
836,790830,25,2,3,2,2,0,1,2,2,3,1,2,2,3,2,0,6
836,790834,24,5,11,3,6,2,5,3,4,2,8,6,4,0,0,0,15
836,780297,14,0,4,0,2,0,2,1,2,1,5,1,1,0,1,0,1
836,785377,20,3,6,3,5,0,1,0,0,1,2,6,2,2,1,0,6
836,785451,22,8,17,5,9,3,8,4,5,1,2,2,2,1,1,0,23
836,785379,20,2,5,1,2,1,3,0,0,0,1,3,3,1,0,1,5
836,796388,7,0,1,0,1,0,0,0,0,1,2,0,0,0,0,1,0
836,790831,9,2,2,2,2,0,0,0,0,1,4,0,0,0,0,1,4
836,796389,2,0,0,0,0,0,0,0,0,0,1,0,0,0,0,0,0
837,796568,26,3,9,3,7,0,2,0,1,0,5,0,1,0,1,0,6
837,796566,22,3,9,3,9,0,0,0,1,1,4,1,4,0,1,1,6
837,790969,31,2,5,1,4,1,1,6,10,2,3,1,0,3,4,0,11
837,780166,38,4,11,3,8,1,3,4,6,0,3,3,2,1,1,0,13
837,775107,20,0,3,0,3,0,0,1,2,2,1,2,1,1,3,0,1
837,796563,20,4,8,1,2,3,6,2,2,0,0,0,5,1,4,1,13
837,781380,9,0,2,0,2,0,0,1,2,0,2,1,1,0,0,1,1
837,796569,13,1,3,1,1,0,2,1,4,0,5,0,3,0,0,0,3
837,790971,11,0,0,0,0,0,0,0,0,0,2,0,2,0,0,0,0
837,790968,5,0,0,0,0,0,0,0,0,1,0,0,0,0,1,0,0
837,796565,3,0,2,0,1,0,1,0,0,0,0,1,0,0,0,0,0
837,796564,2,0,0,0,0,0,0,0,0,0,0,0,0,0,0,0,0
838,797843,35,6,9,3,5,3,4,9,10,0,4,3,3,1,0,0,24
838,792202,19,4,6,2,2,2,4,0,0,0,1,1,0,1,2,0,10
838,781537,37,2,4,1,2,1,2,3,5,1,6,3,3,0,2,1,8
838,779986,18,2,3,2,3,0,0,0,0,1,2,0,2,1,1,0,4
838,797846,26,1,6,1,5,0,1,0,0,0,2,1,4,0,2,0,2
838,797842,33,5,13,4,10,1,3,5,8,2,6,0,2,1,2,2,16
838,797849,26,5,11,5,8,0,3,1,2,1,4,3,1,3,1,1,11
838,786079,17,3,4,2,3,1,1,0,0,0,1,1,2,1,3,0,7
838,797835,19,1,3,0,1,1,2,2,2,0,2,0,0,0,0,0,5
838,797844,7,1,5,0,4,1,1,0,0,0,0,2,1,0,0,0,3
838,797848,5,1,2,1,2,0,0,1,1,2,0,0,4,0,1,0,3
838,797847,6,0,0,0,0,0,0,0,0,0,0,0,1,0,0,0,0
838,792201,2,0,0,0,0,0,0,0,0,0,0,0,0,0,0,0,0
839,781253,47,8,13,2,4,6,9,0,0,0,5,1,3,0,2,0,22
839,785515,46,2,9,2,5,0,4,13,15,3,5,5,3,0,3,0,17
839,775165,46,5,9,1,3,4,6,1,2,1,9,4,3,1,2,2,15
839,781249,27,3,7,2,2,1,5,0,0,2,0,1,5,0,2,0,7
839,796951,16,0,4,0,3,0,1,3,4,1,1,0,1,1,2,0,3
839,791252,20,4,6,3,4,1,2,2,6,0,5,4,5,1,1,0,11
839,791251,22,3,4,0,0,3,4,0,0,0,2,2,0,1,2,1,9
839,796953,17,1,4,1,4,0,0,0,0,1,2,1,1,0,3,2,2
839,796950,8,0,4,0,2,0,2,1,2,0,0,0,0,0,0,0,1
839,776804,1,0,1,0,0,0,1,0,0,0,0,1,2,0,0,0,0
840,791917,22,2,3,1,2,1,1,2,4,1,6,1,4,0,0,0,7
840,786526,26,5,11,4,7,1,4,0,0,1,6,0,3,1,2,2,11
840,786525,27,5,10,1,3,4,7,4,5,0,1,3,0,1,0,0,18
840,786030,21,6,12,3,4,3,8,1,4,1,4,0,3,0,1,0,16
840,786524,22,1,1,0,0,1,1,0,0,0,4,8,0,0,1,0,3
840,791914,21,3,8,2,5,1,3,1,1,0,4,7,3,1,0,0,8
840,781109,19,1,3,1,2,0,1,0,0,0,2,3,4,0,3,0,2
840,786856,11,4,5,4,5,0,0,2,3,2,5,0,0,0,2,1,10
840,797550,19,4,6,1,2,3,4,4,6,0,6,1,2,0,1,2,15
840,797551,6,1,3,1,3,0,0,0,0,1,1,1,2,0,1,0,2
840,791920,3,0,0,0,0,0,0,0,0,0,0,1,1,0,0,0,0
840,797552,1,0,0,0,0,0,0,0,0,0,1,0,0,0,0,0,0
840,791918,1,0,0,0,0,0,0,0,0,0,0,0,0,0,0,0,0
840,791919,1,0,0,0,0,0,0,0,0,0,0,0,0,0,0,0,0
841,792418,37,3,16,2,11,1,5,4,8,1,9,2,1,1,2,0,11
841,796693,25,2,6,2,3,0,3,4,4,0,0,3,5,2,1,0,8
841,796691,29,4,8,3,5,1,3,3,4,0,0,2,1,0,1,0,12
841,792422,27,2,4,2,4,0,0,2,2,0,7,0,3,1,0,1,6
841,789484,38,3,14,3,9,0,5,4,8,1,1,0,4,0,4,0,10
841,792421,13,0,4,0,4,0,0,0,0,0,2,0,2,0,0,0,0
841,792423,12,1,2,1,2,0,0,0,0,1,1,0,0,0,0,0,2
841,792424,8,0,1,0,1,0,0,0,0,0,1,0,2,0,2,1,0
841,796692,5,0,1,0,1,0,0,0,0,0,0,0,0,0,0,0,0
841,792419,3,0,0,0,0,0,0,0,0,0,0,0,0,0,0,0,0
841,796694,3,0,0,0,0,0,0,0,0,0,0,0,0,0,0,0,0
842,785412,27,5,11,2,4,3,7,9,10,0,4,3,0,0,2,0,22
842,776214,31,5,11,4,6,1,5,0,1,1,3,4,4,3,1,0,11
842,780099,30,4,8,1,2,3,6,4,4,0,1,3,4,0,1,0,15
842,780021,30,5,10,5,10,0,0,1,2,4,5,2,3,0,0,1,11
842,790863,15,2,7,1,2,1,5,0,0,0,6,0,2,0,2,0,5
842,776221,9,0,1,0,0,0,1,0,0,0,1,2,1,0,0,0,0
842,775686,25,3,5,3,3,0,2,0,0,0,4,1,3,1,0,0,6
842,785417,9,0,2,0,1,0,1,0,0,1,0,1,1,0,0,2,0
842,785413,21,6,10,5,6,1,4,0,0,1,2,1,1,1,1,0,13
842,785411,3,0,0,0,0,0,0,0,0,1,1,0,0,0,0,0,0
842,796420,0,0,0,0,0,0,0,0,0,0,0,0,0,0,0,0,0
843,790842,22,1,5,1,5,0,0,0,0,1,4,0,1,3,0,3,2
843,775142,34,10,19,8,13,2,6,9,11,7,4,1,3,0,3,1,31
843,790843,38,7,12,3,5,4,7,4,4,0,4,3,1,2,1,0,22
843,781563,29,1,4,1,2,0,2,1,2,0,2,5,4,0,4,0,3
843,780094,36,5,11,4,9,1,2,2,4,1,8,1,3,0,1,0,13
843,796914,17,0,4,0,2,0,2,0,0,0,1,1,3,0,0,0,0
843,790844,19,2,5,2,5,0,0,0,0,1,3,0,1,0,1,0,4
843,796915,0,0,0,0,0,0,0,0,0,0,0,0,1,0,0,0,0
843,790847,5,0,3,0,1,0,2,0,0,1,0,1,0,0,0,0,0
844,798096,18,8,13,7,10,1,3,4,4,3,2,2,1,4,1,0,21
844,781530,20,6,7,5,5,1,2,1,1,0,5,1,1,3,3,1,14
844,792307,18,4,5,1,1,3,4,0,0,0,1,1,0,2,3,1,11
844,776423,14,5,10,5,10,0,0,1,1,3,0,0,1,2,1,1,11
844,798106,19,0,4,0,3,0,1,0,0,1,1,1,1,1,1,1,0
844,786296,15,5,7,5,6,0,1,1,3,4,5,0,0,2,1,0,11
844,792314,18,3,4,3,4,0,0,3,4,3,5,0,3,0,1,0,9
844,792321,9,3,6,2,5,1,1,0,0,1,1,0,1,0,1,0,7
844,798102,6,2,2,2,2,0,0,3,3,0,0,2,0,2,0,0,7
844,798104,17,1,5,1,3,0,2,2,4,0,1,3,4,0,1,0,4
844,792320,16,0,0,0,0,0,0,4,4,0,2,1,2,0,0,0,4
844,792319,22,0,2,0,0,0,2,3,4,1,1,3,3,2,0,0,3
844,798109,8,1,3,1,3,0,0,0,0,0,1,0,1,0,1,0,2
846,797699,39,6,11,6,8,0,3,8,9,1,4,6,0,3,2,1,20
846,780846,39,3,10,2,8,1,2,7,10,3,4,8,2,3,1,0,14
846,780844,34,3,7,2,2,1,5,0,0,1,5,1,2,1,2,0,7
846,797698,19,2,8,2,6,0,2,0,0,0,4,0,1,0,0,1,4
846,797694,18,1,3,0,0,1,3,0,0,0,1,0,2,0,1,1,3
846,791956,24,6,8,3,5,3,3,6,7,1,2,0,3,0,1,1,21
846,791954,19,4,7,3,5,1,2,3,5,2,4,1,4,0,4,0,12
846,797692,14,3,5,0,1,3,4,2,4,0,1,0,1,1,0,0,11
846,797696,9,1,2,1,2,0,0,0,0,2,3,0,1,0,0,0,2
846,782128,10,0,1,0,0,0,1,0,0,0,1,1,0,0,0,0,0
847,791407,42,10,15,8,10,2,5,3,3,0,8,1,2,2,4,0,25
847,785928,31,3,5,1,1,2,4,1,2,1,1,0,1,0,0,0,9
847,791403,28,3,10,3,10,0,0,2,3,1,9,2,4,1,3,3,8
847,785923,25,3,6,2,5,1,1,1,1,0,1,5,4,2,1,0,8
847,791404,25,2,5,1,3,1,2,1,2,0,3,3,5,1,1,0,6
847,797114,32,7,12,3,7,4,5,0,1,0,0,1,1,0,3,0,18
847,797109,25,2,4,2,2,0,2,1,2,0,1,0,5,0,1,1,5
847,797111,17,2,5,2,5,0,0,0,0,0,1,1,3,0,1,0,4
848,785298,13,2,2,2,2,0,0,0,3,0,0,0,3,0,0,0,4
848,775224,27,2,7,2,7,0,0,2,2,4,3,1,1,1,0,1,6
848,778046,30,6,18,6,14,0,4,0,1,2,3,3,1,3,3,1,12
848,782121,31,5,8,1,3,4,5,1,2,1,3,7,4,2,3,0,15
848,775793,32,4,10,4,8,0,2,3,4,1,1,0,0,0,0,0,11
848,785485,24,2,4,2,4,0,0,5,6,6,3,0,4,0,1,0,9
848,786594,29,6,11,4,5,2,6,4,4,1,2,3,3,0,0,0,18
848,785302,14,3,6,2,5,1,1,0,2,1,6,0,0,1,0,2,7
849,791416,18,3,4,3,4,0,0,1,3,1,3,0,4,0,0,1,7
849,797096,31,2,11,2,5,0,6,0,0,0,2,1,2,0,1,0,4
849,785906,38,6,18,4,15,2,3,4,5,1,5,5,3,1,3,0,18
849,780100,33,2,3,1,1,1,2,1,2,2,5,0,2,0,1,0,6
849,780096,32,3,6,1,2,2,4,0,0,0,5,3,1,1,5,0,8
849,797094,5,0,1,0,0,0,1,0,2,2,1,0,0,0,0,1,0
849,785907,25,7,10,6,9,1,1,0,0,3,1,1,3,1,1,2,15
849,797093,16,3,6,2,5,1,1,4,4,0,2,4,4,0,1,0,11
849,781614,2,0,0,0,0,0,0,0,0,0,0,2,1,0,0,0,0
850,797831,11,0,2,0,1,0,1,0,0,0,1,0,1,0,1,0,0
850,785950,29,3,9,2,5,1,4,5,5,1,3,0,4,3,2,0,12
850,797823,21,2,5,2,4,0,1,1,2,2,5,1,3,2,0,3,5
850,792280,35,4,10,3,9,1,1,3,3,0,6,1,3,0,4,0,12
850,780505,39,4,18,2,11,2,7,5,7,0,4,7,1,3,2,0,15
850,792286,10,0,2,0,2,0,0,0,0,1,0,0,1,0,3,2,0
850,792283,22,5,7,2,3,3,4,0,0,2,3,1,1,0,0,0,13
850,797826,18,1,5,1,5,0,0,0,0,1,2,0,1,0,2,0,2
850,792284,5,0,0,0,0,0,0,0,0,0,0,1,0,0,0,0,0
850,797829,9,0,0,0,0,0,0,0,2,1,2,0,1,0,0,0,0
850,799468,1,0,0,0,0,0,0,0,0,0,0,0,1,1,0,0,0
851,796404,31,5,11,4,9,1,2,0,0,8,2,1,4,0,3,2,11
851,785434,34,3,9,2,7,1,2,0,0,2,7,1,2,2,2,1,7
851,790853,17,3,4,3,4,0,0,0,2,1,3,0,4,0,0,0,6
851,781164,31,4,8,1,2,3,6,1,2,1,4,3,2,0,2,0,12
851,781163,38,3,11,2,5,1,6,2,4,0,5,7,2,1,5,2,9
851,796406,8,0,1,0,1,0,0,0,0,0,1,0,3,0,1,1,0
851,781162,5,0,1,0,0,0,1,0,0,0,0,0,1,1,2,0,0
851,796405,4,1,2,1,2,0,0,0,0,1,0,0,1,0,0,0,2
851,790850,24,2,11,1,4,1,7,0,0,0,1,1,1,0,0,0,5
851,790849,2,0,1,0,0,0,1,0,0,0,0,0,0,0,1,0,0
851,790854,6,0,0,0,0,0,0,3,4,1,2,0,0,0,1,1,3
858,791202,38,1,6,1,2,0,4,0,0,1,2,2,1,0,0,0,2
858,775767,25,3,6,3,6,0,0,9,10,3,5,0,3,1,0,0,15
858,791201,22,3,6,3,5,0,1,4,4,2,5,0,2,1,2,0,10
858,785628,36,8,19,4,13,4,6,3,4,0,3,7,1,1,2,1,23
858,785627,33,4,9,3,5,1,4,0,0,1,6,4,2,1,0,1,9
858,796901,18,1,2,0,0,1,2,3,4,1,1,0,1,0,0,1,6
858,785629,11,0,0,0,0,0,0,0,1,0,0,1,0,1,1,0,0
858,796904,9,2,5,2,5,0,0,1,1,0,1,0,1,0,0,2,5
858,781135,5,0,1,0,1,0,0,0,0,0,1,0,1,0,2,1,0
858,796902,3,0,0,0,0,0,0,0,0,0,0,0,2,0,0,0,0
859,780377,28,1,7,0,1,1,6,0,0,0,6,1,4,2,3,1,3
859,791852,21,4,5,4,5,0,0,3,4,4,3,0,5,0,1,4,11
859,786600,29,3,11,3,11,0,0,2,4,1,3,4,2,0,2,0,8
859,786599,21,1,3,1,2,0,1,0,0,0,2,2,1,0,1,0,2
859,786602,13,0,5,0,3,0,2,0,0,0,2,1,4,0,0,0,0
859,791851,29,4,9,1,6,3,3,0,0,0,2,4,2,0,1,0,11
859,797460,27,4,10,3,6,1,4,4,4,0,4,1,4,0,2,0,13
859,797462,18,5,6,5,5,0,1,0,0,1,2,0,1,0,1,0,10
859,797459,14,0,0,0,0,0,0,0,0,0,0,2,0,0,1,0,0
860,791225,16,6,6,6,6,0,0,1,2,0,2,0,2,0,1,2,13
860,791223,27,1,6,1,6,0,0,0,0,2,5,2,2,4,1,0,2
860,786436,22,1,4,1,3,0,1,2,2,0,1,0,0,0,2,0,4
860,781181,30,3,8,1,2,2,6,1,1,2,4,3,3,3,1,0,9
860,796927,14,1,3,1,2,0,1,2,2,2,0,0,2,0,2,0,4
860,775324,19,7,11,7,11,0,0,2,4,3,4,0,1,0,0,0,16
860,796929,10,0,3,0,0,0,3,0,0,0,2,0,1,0,1,0,0
860,791224,20,5,9,4,8,1,1,0,0,2,4,3,0,2,1,0,11
860,785564,16,1,6,0,0,1,6,1,3,0,1,0,1,1,0,0,4
860,785571,26,6,8,5,7,1,1,2,2,0,2,3,1,2,1,1,15
861,796774,29,4,7,3,4,1,3,1,2,2,6,3,0,3,2,0,10
861,792695,14,1,2,1,2,0,0,0,0,0,2,1,3,0,5,0,2
861,796776,27,1,3,1,2,0,1,0,0,0,2,2,2,0,3,0,2
861,792699,24,2,3,1,2,1,1,1,4,0,0,0,2,0,2,0,6
861,792701,33,4,10,2,4,2,6,1,1,0,2,1,2,0,2,0,11
861,792702,15,1,6,0,2,1,4,0,0,2,1,2,5,2,0,0,3
861,796775,10,2,6,2,6,0,0,0,0,0,5,0,1,0,0,0,4
861,796772,24,3,6,2,4,1,2,4,4,1,0,2,1,0,2,0,11
861,792698,20,2,9,0,5,2,4,1,2,1,3,1,3,0,1,1,7
861,792704,4,0,0,0,0,0,0,0,0,0,0,0,0,0,0,0,0
862,785409,16,3,4,3,4,0,0,1,2,3,3,0,3,0,1,1,7
862,785408,25,6,9,4,6,2,3,3,5,2,3,5,2,2,0,1,17
862,780539,19,1,3,0,0,1,3,0,0,0,0,4,2,1,0,0,3
862,780560,20,3,7,0,3,3,4,0,0,1,2,0,2,1,1,0,9
862,776484,27,7,13,6,8,1,5,3,4,2,3,1,2,1,2,0,18
862,785407,18,2,4,2,3,0,1,0,1,1,3,0,2,0,1,1,4
862,796416,21,7,12,4,6,3,6,0,0,0,0,6,1,2,1,0,17
862,796415,17,1,4,1,2,0,2,0,0,0,1,2,2,1,1,0,2
862,790861,12,1,2,0,1,1,1,2,2,0,4,0,1,1,1,0,5
862,796417,7,2,2,2,2,0,0,1,4,1,1,0,1,1,1,0,5
862,796418,9,0,2,0,2,0,0,0,0,1,2,0,0,0,0,0,0
862,790859,4,0,1,0,0,0,1,0,0,0,0,0,0,0,1,0,0
862,790860,3,1,2,0,0,1,2,0,0,0,0,0,1,0,0,0,3
862,796419,2,0,0,0,0,0,0,0,0,0,0,0,0,0,0,0,0
863,791606,16,0,3,0,2,0,1,0,0,2,1,1,2,0,1,0,0
863,786410,30,0,6,0,5,0,1,0,0,0,2,1,3,0,4,0,0
863,775095,17,4,8,4,8,0,0,2,3,1,3,1,3,0,2,0,10
863,791603,23,2,8,0,3,2,5,0,0,2,1,1,1,1,2,0,6
863,780414,31,2,5,2,4,0,1,6,8,2,1,7,4,2,2,0,10
863,792392,16,5,8,5,8,0,0,2,4,1,4,0,2,0,0,0,12
863,797020,14,3,3,3,3,0,0,0,2,1,2,0,3,1,1,0,6
863,791605,15,1,4,0,0,1,4,0,0,0,3,0,0,0,1,0,3
863,786406,25,0,1,0,0,0,1,3,4,0,2,0,0,0,0,1,3
863,797021,8,3,4,3,3,0,1,1,2,1,0,0,0,1,1,0,7
863,797023,3,1,3,1,2,0,1,0,0,0,2,0,1,0,1,0,2
863,792272,2,0,0,0,0,0,0,0,0,1,2,0,1,0,1,0,0
864,791131,18,3,3,2,2,1,1,0,0,0,1,0,2,0,0,0,7
864,791135,23,11,15,11,15,0,0,3,5,5,10,0,2,1,0,1,25
864,786090,24,4,8,2,5,2,3,4,5,1,4,5,0,5,1,0,14
864,786088,28,7,11,6,9,1,2,1,2,1,4,6,0,6,1,0,16
864,774921,23,3,8,1,4,2,4,3,4,1,2,5,2,2,3,0,11
864,791133,8,0,2,0,2,0,0,0,0,0,2,1,1,0,1,0,0
864,786097,10,3,3,3,3,0,0,0,0,1,0,1,0,0,0,1,6
864,791521,13,5,5,5,5,0,0,0,1,0,1,0,2,0,1,2,10
864,796792,4,1,1,1,1,0,0,0,0,0,0,0,0,0,0,0,2
864,796790,22,5,8,3,4,2,4,3,4,1,1,3,0,1,0,0,15
864,792585,4,0,0,0,0,0,0,0,0,0,0,0,0,0,1,0,0
864,791132,15,2,3,2,2,0,1,3,4,4,4,1,1,0,1,0,7
864,786092,8,0,2,0,2,0,0,0,0,2,0,0,0,0,1,0,0
866,776174,29,5,12,5,12,0,0,1,2,4,12,2,2,0,2,0,11
866,791958,37,5,11,4,10,1,1,2,7,4,5,2,4,0,1,1,13
866,791960,38,5,14,2,8,3,6,3,4,0,1,2,2,3,2,0,16
866,785861,31,3,8,2,5,1,3,3,4,1,4,1,2,1,2,0,10
866,781332,15,0,5,0,4,0,1,0,0,0,0,0,4,1,2,0,0
866,786059,18,4,4,3,3,1,1,0,5,1,3,2,4,0,4,1,9
866,781334,7,1,3,0,1,1,2,0,0,0,0,0,0,0,0,0,3
866,797704,25,0,4,0,0,0,4,2,2,0,0,0,4,1,2,0,2
867,797047,9,0,3,0,2,0,1,0,0,1,0,0,3,0,1,1,0
867,775515,16,2,6,0,0,2,6,0,0,0,3,0,4,1,1,0,6
867,791579,32,3,10,2,7,1,3,1,2,1,5,0,1,1,2,0,8
867,786387,39,9,14,9,14,0,0,13,15,2,5,1,2,0,1,0,31
867,780399,37,6,13,6,9,0,4,7,8,0,6,9,2,4,1,0,19
867,786846,7,0,2,0,1,0,1,0,0,1,1,0,2,0,2,0,0
867,786388,9,0,2,0,2,0,0,0,0,2,3,0,4,0,3,0,0
867,780400,28,4,6,1,1,3,5,0,1,1,7,0,1,2,1,0,11
867,791575,11,1,1,1,1,0,0,0,0,0,1,0,3,0,2,0,2
867,797046,8,1,2,1,1,0,1,1,1,0,0,0,2,1,0,0,3
867,786391,4,0,1,0,0,0,1,0,0,0,1,0,0,1,0,0,0
868,797198,8,1,2,1,1,0,1,1,1,0,1,0,3,0,1,0,3
868,791482,22,2,5,2,2,0,3,0,0,0,3,3,2,0,3,1,4
868,786318,28,3,10,1,3,2,7,0,0,0,2,2,2,0,2,1,8
868,784268,31,6,11,6,9,0,2,1,2,1,2,6,0,0,1,0,13
868,780223,31,3,8,1,1,2,7,0,0,0,6,2,2,2,3,0,8
868,791481,22,2,5,1,3,1,2,3,4,2,5,1,2,0,2,0,8
868,786319,16,3,3,3,3,0,0,1,1,1,6,1,3,0,1,0,7
868,780225,26,8,11,3,4,5,7,0,0,0,2,0,2,1,0,0,21
868,797199,12,1,1,0,0,1,1,3,4,0,0,1,1,0,0,0,6
868,797201,1,0,0,0,0,0,0,0,0,0,0,0,0,0,0,0,0
868,791480,1,0,0,0,0,0,0,0,0,0,0,0,0,0,0,0,0
868,786317,1,0,0,0,0,0,0,0,0,0,0,0,0,0,0,0,0
868,786320,1,0,0,0,0,0,0,0,0,0,0,0,0,0,0,0,0
869,786131,34,4,13,4,10,0,3,4,5,2,1,2,0,2,0,0,12
869,780904,21,4,8,4,8,0,0,5,8,2,1,0,4,1,2,0,13
869,797686,33,0,4,0,3,0,1,1,2,1,5,4,2,4,4,0,1
869,797688,29,3,4,3,4,0,0,1,1,1,5,1,1,0,1,0,7
869,786145,24,2,9,1,4,1,5,0,0,0,1,0,1,0,0,0,5
869,797684,2,0,0,0,0,0,0,0,0,0,0,0,0,0,0,0,0
869,792100,6,1,1,1,1,0,0,1,2,1,0,0,3,0,0,0,3
869,797685,22,1,6,1,5,0,1,1,2,1,1,2,1,1,0,0,3
869,792099,3,0,1,0,0,0,1,0,0,0,1,0,0,0,0,0,0
869,792096,9,2,5,0,0,2,5,0,0,0,1,0,2,0,1,0,6
869,786141,2,0,0,0,0,0,0,0,0,0,0,0,0,0,0,0,0
869,775251,15,4,5,2,3,2,2,2,2,0,3,0,1,0,1,0,12
870,780291,21,3,7,3,6,0,1,2,2,2,3,0,4,1,1,0,8
870,785607,14,2,3,2,3,0,0,0,0,1,3,1,2,3,1,0,4
870,796665,26,5,7,1,1,4,6,1,2,0,3,3,0,0,4,0,15
870,785333,31,5,10,3,6,2,4,0,0,0,3,1,0,0,0,0,12
870,775305,33,7,15,7,14,0,1,5,5,2,4,5,1,0,0,0,19
870,796663,21,2,3,2,3,0,0,4,6,3,3,0,2,1,0,1,8
870,791004,23,5,9,1,1,4,8,0,1,1,6,1,1,0,4,0,14
870,791006,3,0,0,0,0,0,0,0,0,0,0,0,0,0,1,0,0
870,796666,7,1,3,1,2,0,1,0,0,1,1,0,0,0,0,0,2
870,796664,10,2,5,2,2,0,3,0,0,0,1,0,2,1,0,0,4
870,791005,1,0,1,0,1,0,0,0,0,0,0,0,0,0,0,0,0
870,791007,10,1,3,1,2,0,1,0,0,0,0,2,1,0,1,0,2
872,790893,26,2,6,2,6,0,0,3,4,2,4,0,4,0,0,1,7
872,796444,37,4,10,4,8,0,2,9,11,4,3,3,1,1,2,4,17
872,786615,29,3,6,3,5,0,1,3,4,0,5,0,2,0,0,0,9
872,786732,14,0,4,0,2,0,2,0,0,0,3,0,2,0,0,0,0
872,775260,32,2,8,1,3,1,5,0,0,0,1,1,1,0,2,0,5
872,790889,21,2,6,1,2,1,4,2,2,0,1,0,1,0,1,0,7
872,775536,14,2,3,2,3,0,0,0,0,0,1,0,4,0,0,0,4
872,780702,24,4,8,3,3,1,5,0,0,1,2,0,1,0,0,0,9
872,796445,3,0,2,0,2,0,0,0,0,0,1,0,0,0,0,0,0
873,796812,10,0,1,0,1,0,0,1,2,0,0,0,3,0,0,0,1
873,780952,36,4,10,4,9,0,1,2,2,4,1,0,3,0,0,5,10
873,791155,33,5,15,2,9,3,6,5,5,1,6,2,1,1,4,0,18
873,786609,28,3,7,2,4,1,3,4,4,1,6,1,0,1,2,0,11
873,796810,28,2,8,0,3,2,5,0,0,1,4,4,2,1,1,0,6
873,780945,30,4,6,4,6,0,0,1,4,6,5,2,3,0,0,1,9
873,780950,4,0,3,0,1,0,2,0,0,0,0,0,4,0,1,0,0
873,791156,21,1,3,0,1,1,2,3,3,1,2,0,2,0,0,0,6
873,785752,6,0,1,0,1,0,0,0,0,0,1,0,3,0,0,0,0
873,796814,4,0,1,0,1,0,0,0,0,0,0,0,0,0,0,0,0
874,785638,17,1,5,0,0,1,5,0,0,1,2,1,0,0,1,0,3
874,780874,15,3,7,2,5,1,2,0,0,4,4,0,3,0,1,1,7
874,781326,32,5,8,5,8,0,0,2,2,3,12,1,0,3,2,3,12
874,792209,25,0,2,0,0,0,2,0,0,0,0,7,0,2,0,0,0
874,781323,31,9,17,8,13,1,4,4,6,1,7,3,2,1,4,1,23
874,792214,4,0,0,0,0,0,0,0,0,0,0,0,1,0,1,0,0
874,792210,20,5,7,2,3,3,4,0,0,0,1,2,3,0,2,0,13
874,792213,9,0,3,0,0,0,3,0,0,0,4,0,0,0,0,0,0
874,797870,23,2,4,1,2,1,2,0,2,0,2,4,1,0,2,0,5
874,785430,16,5,8,5,6,0,2,1,4,2,1,0,3,0,0,0,11
874,792215,8,0,3,0,1,0,2,0,0,0,0,0,0,0,0,1,0
875,791923,29,3,11,3,10,0,1,0,0,2,1,1,0,1,2,0,6
875,781122,18,0,5,0,5,0,0,0,0,1,3,1,2,2,0,0,0
875,791925,28,8,14,6,10,2,4,3,3,1,6,3,3,2,1,0,21
875,791926,20,2,10,0,3,2,7,2,3,1,3,1,0,2,2,0,8
875,781112,14,1,2,1,2,0,0,0,0,0,2,3,1,0,1,0,2
875,797541,21,6,9,6,9,0,0,3,3,1,3,0,1,0,3,1,15
875,786858,13,2,3,2,3,0,0,2,2,1,1,2,0,0,0,0,6
875,791927,15,2,3,2,2,0,1,0,0,0,2,1,4,1,0,0,4
875,791922,6,0,2,0,1,0,1,0,0,0,0,0,1,0,1,0,0
875,778952,12,0,1,0,0,0,1,0,0,0,0,3,0,1,0,1,0
875,786527,13,1,4,0,0,1,4,1,3,0,2,0,1,0,0,0,4
875,797542,11,0,1,0,0,0,1,2,2,0,2,1,1,1,0,1,2
876,792632,21,2,4,2,4,0,0,2,5,3,7,3,3,3,2,1,6
876,781289,24,2,3,2,3,0,0,1,3,2,5,2,0,0,0,0,5
876,792626,36,4,7,3,6,1,1,0,1,0,6,7,4,3,3,1,9
876,781491,24,3,12,2,10,1,2,4,4,1,5,1,3,0,1,0,11
876,780250,30,5,14,4,7,1,7,3,4,1,7,2,0,0,3,0,14
876,796637,2,0,1,0,1,0,0,0,0,0,0,0,0,0,0,0,0
876,796638,11,1,2,0,0,1,2,0,0,0,0,0,0,1,0,0,3
876,796642,2,0,0,0,0,0,0,0,0,0,1,0,2,0,0,0,0
876,796645,29,4,7,4,6,0,1,3,5,1,4,0,2,0,0,1,11
876,792627,13,1,4,1,4,0,0,5,6,1,0,2,0,0,2,0,7
876,792631,4,1,3,1,2,0,1,0,0,0,0,0,0,0,0,0,2
876,796634,4,0,1,0,1,0,0,0,0,0,0,0,1,0,1,0,0
878,785432,23,3,4,3,4,0,0,4,5,1,2,1,2,0,4,1,10
878,779985,24,9,15,1,4,8,11,3,3,1,4,0,1,1,1,2,29
878,790882,22,2,7,2,6,0,1,1,1,2,2,1,0,1,2,0,5
878,781062,18,2,7,0,3,2,4,2,2,0,0,3,3,0,0,0,8
878,774987,21,2,5,2,4,0,1,4,6,1,7,4,0,2,1,0,8
878,796434,19,4,11,0,2,4,9,0,0,0,1,5,1,1,2,0,12
878,790876,27,7,11,4,5,3,6,5,5,0,5,4,2,2,0,0,22
878,790877,20,3,3,3,3,0,0,1,2,4,2,1,3,2,1,0,7
878,790875,14,0,2,0,1,0,1,0,0,0,3,0,2,0,1,0,0
878,779987,4,2,2,2,2,0,0,0,0,0,0,0,1,0,0,0,4
878,790874,4,0,1,0,0,0,1,0,0,0,2,1,0,0,0,0,0
878,790881,4,0,0,0,0,0,0,0,0,0,0,1,0,0,0,0,0
879,781624,18,1,6,0,3,1,3,0,0,1,2,0,0,0,2,0,3
879,792246,15,2,5,2,5,0,0,0,0,3,4,1,3,0,1,0,4
879,791701,18,0,2,0,0,0,2,2,2,0,5,0,3,3,2,1,2
879,781420,26,4,14,3,8,1,6,0,0,0,2,1,4,0,4,0,9
879,781405,32,10,21,6,9,4,12,4,4,0,5,2,4,1,5,0,28
879,792244,9,1,4,0,1,1,3,0,0,0,1,0,0,0,0,0,3
879,792245,23,2,4,1,2,1,2,2,2,0,3,0,1,0,2,0,7
879,781417,15,0,1,0,1,0,0,2,4,2,1,0,2,0,1,0,2
879,797924,11,2,4,2,4,0,0,0,0,2,2,0,2,2,0,0,4
879,797925,21,1,5,1,3,0,2,0,0,0,1,1,0,2,0,1,2
879,780615,10,0,1,0,1,0,0,2,2,3,0,1,2,0,1,1,2
879,797933,2,0,0,0,0,0,0,0,0,0,0,0,0,0,0,0,0
880,790810,20,4,6,1,1,3,5,2,4,1,5,0,1,0,2,0,13
880,785362,18,7,8,7,8,0,0,3,4,3,3,1,1,1,2,1,17
880,790808,21,3,7,0,2,3,5,0,0,2,3,2,0,1,2,0,9
880,785361,25,5,9,1,3,4,6,2,2,3,2,1,1,1,0,0,16
880,779997,22,2,5,1,2,1,3,0,0,0,4,5,0,1,0,1,5
880,774854,11,2,5,2,5,0,0,0,0,2,3,0,1,0,0,3,4
880,796370,22,4,8,3,4,1,4,2,4,0,0,1,0,2,2,0,11
880,796368,16,3,7,3,6,0,1,0,0,1,5,1,1,1,1,0,6
880,790809,17,1,2,1,2,0,0,0,0,1,1,4,0,1,1,0,2
880,790811,16,0,3,0,2,0,1,3,4,1,3,0,1,1,2,0,3
880,796371,6,0,0,0,0,0,0,0,0,0,2,0,3,0,0,0,0
880,796369,3,1,1,0,0,1,1,0,0,0,0,0,1,1,1,0,3
880,779999,3,0,0,0,0,0,0,0,0,0,1,0,0,0,0,0,0
882,785630,23,7,8,3,4,4,4,1,1,0,3,3,1,1,0,0,19
882,780777,24,4,7,4,6,0,1,2,4,1,3,10,2,0,2,0,10
882,785631,23,2,6,1,4,1,2,0,0,2,5,1,2,0,2,0,5
882,785863,23,4,5,4,5,0,0,4,6,0,3,0,1,0,1,0,12
882,786248,19,5,6,5,6,0,0,0,0,0,5,0,3,0,1,1,10
882,791200,12,4,8,3,6,1,2,0,0,0,1,3,1,0,1,0,9
882,791199,3,0,1,0,1,0,0,0,0,0,0,0,3,0,0,1,0
882,791198,14,2,5,0,0,2,5,0,0,0,2,0,0,1,0,0,6
882,791197,14,2,5,2,5,0,0,0,0,2,0,0,3,1,1,0,4
882,785632,21,4,6,4,6,0,0,2,2,1,3,0,1,2,2,0,10
882,791196,8,1,2,1,1,0,1,0,0,0,0,0,3,0,3,0,2
882,796898,4,0,2,0,2,0,0,0,0,0,1,0,1,0,1,0,0
882,796899,4,0,1,0,1,0,0,0,0,1,3,0,0,0,0,0,0
882,781129,4,0,1,0,1,0,0,0,0,0,1,0,1,0,0,0,0
882,791195,4,0,1,0,1,0,0,0,0,1,1,0,1,0,0,0,0
883,780565,26,5,10,1,3,4,7,0,0,0,3,1,3,2,2,0,14
883,780570,19,4,8,4,8,0,0,3,3,2,4,0,1,3,3,0,11
883,781556,29,1,4,1,1,0,3,1,2,0,1,4,0,0,2,1,3
883,780569,28,5,8,5,8,0,0,7,8,4,5,1,2,1,0,2,17
883,780564,15,0,3,0,2,0,1,0,0,0,0,1,3,1,0,0,0
883,797438,22,1,5,0,3,1,2,0,2,0,1,0,1,0,1,0,3
883,791696,12,1,3,0,1,1,2,3,4,0,1,1,1,1,1,0,6
883,791695,14,2,5,2,5,0,0,0,0,1,3,0,1,0,2,0,4
883,797432,21,0,9,0,5,0,4,5,6,1,1,2,1,2,1,0,5
883,797434,6,0,2,0,2,0,0,1,4,2,2,0,0,0,1,0,1
883,791697,1,0,0,0,0,0,0,0,0,0,0,0,1,0,0,0,0
883,785824,7,1,1,1,1,0,0,0,0,2,0,0,0,0,0,0,2
884,786728,39,5,12,4,10,1,2,10,15,3,6,3,3,3,5,0,21
884,780892,31,1,6,0,1,1,5,5,6,1,1,2,4,0,1,0,8
884,785904,10,1,7,0,3,1,4,0,0,1,1,0,4,0,1,0,3
884,786091,35,5,9,4,6,1,3,3,5,2,3,1,1,1,0,1,14
884,775738,30,2,9,1,5,1,4,3,4,1,5,0,5,0,1,0,8
884,797666,9,1,1,0,0,1,1,0,0,1,1,0,0,0,0,0,3
884,786096,33,1,4,1,2,0,2,5,10,2,6,0,0,2,0,0,7
884,786350,3,0,0,0,0,0,0,0,0,0,0,1,0,0,0,0,0
884,786788,10,0,1,0,1,0,0,0,0,0,0,0,2,0,1,0,0
885,786195,17,6,9,6,9,0,0,0,0,0,1,1,5,1,2,0,12
885,775442,21,1,4,1,3,0,1,0,1,0,2,3,2,1,2,0,2
885,797280,21,2,5,1,4,1,1,1,4,0,0,1,3,1,2,0,6
885,797281,15,1,3,1,1,0,2,0,0,0,5,0,3,0,3,0,2
885,791647,30,1,3,1,2,0,1,2,2,0,3,3,4,0,0,0,4
885,791648,30,4,5,4,5,0,0,2,3,0,8,0,3,2,1,0,10
885,791649,27,5,10,1,4,4,6,0,0,0,3,2,3,0,1,0,14
885,785697,2,0,1,0,1,0,0,0,0,1,1,0,0,0,0,0,0
885,786640,23,2,7,1,2,1,5,3,4,0,1,4,0,0,1,0,8
885,785694,14,2,2,2,2,0,0,1,3,3,3,0,5,0,1,2,5
886,786566,31,8,14,8,11,0,3,2,2,1,6,2,0,3,2,2,18
886,781204,30,5,8,5,6,0,2,3,4,5,6,4,3,3,1,0,13
886,791993,26,4,5,4,4,0,1,0,0,2,5,3,1,0,4,1,8
886,781189,22,3,6,3,5,0,1,5,5,1,4,4,2,2,3,1,11
886,781188,33,10,16,4,6,6,10,0,0,0,2,9,1,0,1,1,26
886,791995,15,3,8,3,4,0,4,2,2,1,3,1,2,0,0,0,8
886,786565,5,2,4,1,2,1,2,0,0,2,1,0,0,0,0,1,5
886,786562,19,0,2,0,0,0,2,0,0,0,3,1,3,1,2,0,0
886,786563,14,1,4,1,2,0,2,3,3,1,4,2,4,0,2,1,5
886,781186,2,0,2,0,1,0,1,0,0,0,0,0,1,0,1,0,0
886,786567,3,0,0,0,0,0,0,0,0,0,0,0,0,0,0,0,0
888,785532,28,3,6,3,6,0,0,3,4,1,4,1,1,0,1,0,9
888,780063,34,3,5,3,3,0,2,2,4,2,5,2,3,0,1,1,8
888,785530,36,7,21,6,12,1,9,5,6,4,4,2,4,2,6,0,20
888,775573,22,3,8,0,2,3,6,0,0,0,2,3,3,0,2,0,9
888,775926,34,4,10,2,3,2,7,0,0,1,4,1,0,1,5,0,10
888,791055,29,1,4,0,2,1,2,0,2,1,4,1,5,1,3,0,3
888,791057,7,0,0,0,0,0,0,0,0,0,0,0,0,0,1,0,0
888,791058,8,1,1,1,1,0,0,1,1,0,1,0,1,0,0,0,3
888,791059,2,0,0,0,0,0,0,0,0,0,0,0,0,0,0,0,0
889,796344,29,2,9,1,2,1,7,0,0,1,6,1,2,0,1,0,5
889,790781,22,2,4,2,4,0,0,0,0,0,2,1,4,0,1,2,4
889,785239,20,1,4,0,1,1,3,0,0,0,0,1,4,0,0,0,3
889,796340,28,6,12,6,9,0,3,2,3,0,3,0,4,1,4,0,14
889,780037,37,8,11,8,8,0,3,6,7,1,3,5,0,2,4,0,22
889,780040,9,2,4,2,4,0,0,2,4,0,2,0,0,0,1,0,6
889,796343,14,1,2,1,2,0,0,0,0,0,2,1,2,0,0,1,2
889,781232,26,3,4,0,0,3,4,0,0,1,2,2,1,0,3,0,9
889,796339,15,1,2,0,1,1,1,2,2,0,1,0,2,0,0,0,5
896,791839,21,8,11,8,10,0,1,0,0,5,6,4,0,0,3,0,16
896,786736,22,1,2,1,1,0,1,2,2,0,1,2,0,0,2,0,4
896,792381,27,5,8,3,4,2,4,1,4,0,3,2,3,3,0,0,13
896,786616,23,6,11,5,8,1,3,0,0,1,4,2,1,0,2,0,13
896,776341,19,6,9,5,7,1,2,1,2,1,3,3,2,1,0,0,14
896,797444,17,1,3,0,0,1,3,0,0,1,4,1,0,0,1,1,3
896,785322,18,3,10,1,3,2,7,1,2,0,6,2,1,2,2,0,9
896,797442,14,1,6,1,3,0,3,3,4,0,0,0,1,0,0,0,5
896,791842,23,5,9,2,6,3,3,2,2,2,4,0,1,0,1,0,15
896,786613,14,1,5,1,3,0,2,0,1,2,1,3,0,0,4,0,2
896,791840,2,0,0,0,0,0,0,0,0,0,0,0,0,0,0,0,0
898,791493,34,3,6,3,6,0,0,4,4,1,11,2,3,1,0,1,10
898,789036,37,9,13,9,13,0,0,2,2,2,9,1,1,0,3,0,20
898,791495,20,0,4,0,0,0,4,0,0,0,0,1,2,1,2,0,0
898,786324,39,8,20,3,6,5,14,4,4,0,3,10,3,0,7,0,25
898,776494,19,2,3,1,2,1,1,0,0,1,1,2,0,1,0,0,5
898,781307,4,1,1,1,1,0,0,0,0,0,2,0,0,0,0,0,2
898,797191,8,0,0,0,0,0,0,0,0,0,1,1,2,0,1,0,0
898,791492,28,5,10,4,6,1,4,0,0,1,2,1,3,0,3,0,11
898,791494,8,1,1,1,1,0,0,0,0,0,0,1,2,0,1,0,2
898,797192,3,0,0,0,0,0,0,0,0,0,0,0,0,0,0,0,0
899,785459,17,9,10,9,10,0,0,1,1,0,2,0,4,0,0,1,19
899,789102,33,4,10,4,9,0,1,3,4,0,1,8,1,2,1,0,11
899,789101,30,3,5,3,4,0,1,1,2,2,3,0,1,0,1,0,7
899,781371,28,0,2,0,0,0,2,0,1,1,2,5,1,1,0,1,0
899,781367,17,4,10,4,5,0,5,4,5,1,3,0,0,1,1,0,12
899,797731,18,2,6,2,6,0,0,0,0,1,3,1,2,0,1,0,4
899,797730,10,2,4,1,1,1,3,0,0,0,1,0,0,0,0,0,5
899,792064,16,3,6,1,1,2,5,0,0,0,0,0,2,0,1,0,8
899,792061,15,2,3,1,1,1,2,0,0,1,0,0,1,1,0,0,5
899,788037,16,4,9,3,6,1,3,0,0,0,6,2,0,1,3,0,9
900,786519,27,5,10,5,10,0,0,0,0,6,8,1,3,0,1,0,10
900,791911,15,0,3,0,0,0,3,0,0,0,0,0,2,1,0,0,0
900,797556,21,2,6,1,2,1,4,2,2,1,1,0,0,1,1,0,7
900,791913,38,5,13,4,7,1,6,4,4,0,3,3,4,1,3,0,15
900,786520,36,4,13,3,7,1,6,5,8,4,3,5,1,6,3,0,14
900,797558,24,4,8,3,5,1,3,3,6,4,0,1,4,1,0,0,12
900,791912,13,1,2,1,2,0,0,0,0,1,2,0,3,0,0,0,2
900,797557,4,0,2,0,0,0,2,0,0,0,0,0,1,0,0,0,0
900,797555,22,4,7,2,4,2,3,4,7,1,3,0,1,0,0,0,14
901,797830,34,3,8,2,4,1,4,4,8,0,7,3,3,0,0,0,11
901,797824,30,5,7,4,4,1,3,1,1,3,7,1,4,1,2,0,12
901,775116,23,0,3,0,0,0,3,0,3,2,1,2,1,0,3,0,0
901,792190,20,3,5,2,3,1,2,0,0,0,4,2,5,0,6,0,7
901,781266,9,2,2,1,1,1,1,0,0,0,1,0,0,0,1,0,5
901,797828,2,1,2,0,0,1,2,0,0,0,0,0,0,0,0,0,3
901,792192,14,2,3,2,3,0,0,1,3,3,4,0,3,0,2,0,5
901,797825,11,4,5,4,5,0,0,0,0,1,0,1,3,0,1,1,8
901,797827,4,0,0,0,0,0,0,0,0,0,0,1,1,0,0,0,0
901,792191,31,0,1,0,1,0,0,4,6,1,2,2,4,1,3,0,4
901,786664,22,3,12,0,4,3,8,1,2,0,2,3,0,2,2,0,10
902,792351,23,5,6,5,6,0,0,0,0,5,3,2,2,2,1,0,10
902,786723,32,6,14,6,12,0,2,2,4,0,8,4,1,0,1,0,14
902,792349,24,3,8,3,7,0,1,3,6,1,4,0,2,0,1,3,9
902,792355,30,8,17,4,6,4,11,1,2,0,0,0,0,4,0,0,21
902,792352,32,2,3,0,0,2,3,0,0,0,3,5,3,0,3,0,6
902,786724,19,1,5,0,3,1,2,3,5,0,5,2,1,0,0,0,6
902,798060,17,2,4,2,3,0,1,4,4,1,0,7,4,1,2,0,8
902,786726,6,0,1,0,1,0,0,0,0,1,1,0,1,0,0,0,0
902,798061,6,0,1,0,0,0,1,0,0,0,0,0,0,0,2,1,0
902,798059,4,1,4,1,4,0,0,0,0,0,1,0,2,0,1,0,2
902,792348,3,0,0,0,0,0,0,0,0,0,2,0,0,0,0,0,0
902,792357,4,0,1,0,0,0,1,0,0,0,1,1,0,0,0,0,0
903,786772,27,4,5,4,5,0,0,4,7,4,9,1,1,0,1,1,12
903,781484,32,3,10,2,5,1,5,0,0,4,6,0,2,1,2,2,7
903,786769,23,1,6,1,6,0,0,0,0,0,1,1,2,0,0,0,2
903,786024,20,3,12,2,7,1,5,0,0,2,1,1,3,1,2,1,7
903,780002,30,8,18,5,8,3,10,2,2,1,3,4,1,0,5,0,21
903,786773,16,4,7,4,7,0,0,0,0,5,1,0,1,1,0,2,8
903,791970,21,1,8,0,0,1,8,0,0,1,1,0,3,0,2,0,3
903,791967,6,0,2,0,1,0,1,0,0,0,1,0,0,0,0,0,0
903,785441,3,0,0,0,0,0,0,0,0,0,0,0,1,0,1,0,0
903,790823,17,1,3,1,2,0,1,0,0,0,0,0,4,3,0,0,2
903,797840,5,0,0,0,0,0,0,0,0,0,1,0,0,0,0,0,0
904,776253,16,9,12,2,4,7,8,1,1,1,4,0,2,2,1,0,26
904,775651,15,3,4,3,4,0,0,1,2,4,1,1,2,0,0,2,7
904,791070,12,2,2,2,2,0,0,2,2,0,3,3,2,1,1,0,6
904,791627,17,5,8,1,3,4,5,0,0,0,1,4,1,3,0,0,14
904,776178,17,4,8,4,7,0,1,1,2,3,1,4,1,3,1,0,9
904,791076,3,0,0,0,0,0,0,0,0,0,0,0,0,0,0,1,0
904,796505,15,3,3,3,3,0,0,1,2,0,4,1,3,0,2,0,7
904,791071,10,2,3,2,3,0,0,0,0,2,3,1,1,0,1,1,4
904,785660,13,1,3,1,2,0,1,0,0,3,2,0,2,0,1,3,2
904,796504,16,8,15,3,3,5,12,0,0,1,6,3,3,0,4,0,21
904,796502,17,3,7,2,2,1,5,0,0,2,4,4,2,2,2,2,7
904,796501,21,2,4,1,3,1,1,0,0,1,1,6,1,1,2,0,5
904,791073,8,1,3,0,1,1,2,0,0,0,1,1,0,0,3,0,3
904,785665,20,6,12,1,1,5,11,0,0,1,2,3,1,2,0,0,17
906,792253,13,2,3,2,3,0,0,1,1,1,3,0,2,0,2,1,5
906,781430,38,7,13,7,9,0,4,6,7,0,11,3,4,0,3,0,20
906,792248,34,5,10,0,1,5,9,5,6,6,3,5,3,1,1,0,20
906,781445,37,5,18,1,2,4,16,0,0,0,1,1,2,0,2,0,14
906,768845,30,6,12,4,6,2,6,1,2,0,5,5,3,3,2,1,15
906,797957,2,0,1,0,1,0,0,0,0,0,0,0,0,0,0,0,0
906,792249,24,2,3,2,3,0,0,0,2,0,1,2,0,0,0,5,4
906,797941,5,0,2,0,1,0,1,0,2,1,1,0,1,0,0,0,0
906,792250,10,0,2,0,1,0,1,0,0,0,1,1,1,0,2,0,0
906,792251,7,0,1,0,1,0,0,0,0,1,0,0,1,1,0,0,0
907,775541,16,5,9,5,7,0,2,1,3,0,2,0,2,0,1,0,11
907,783269,31,5,10,3,4,2,6,0,0,0,7,1,2,1,1,0,12
907,787524,23,2,4,2,3,0,1,2,2,0,3,2,4,0,3,1,6
907,781019,30,2,4,2,4,0,0,6,7,1,9,7,1,2,3,0,10
907,780328,19,6,9,6,9,0,0,0,0,1,1,1,4,0,1,0,12
907,797611,7,1,3,1,3,0,0,0,0,1,1,1,1,0,0,0,2
907,787522,9,0,2,0,2,0,0,0,0,0,2,0,2,0,1,0,0
907,791774,12,1,3,1,3,0,0,0,0,2,2,1,2,0,1,0,2
907,797610,9,1,3,1,1,0,2,0,0,0,0,0,2,0,0,0,2
907,791772,23,0,5,0,3,0,2,0,1,0,2,2,2,1,3,0,0
907,791722,21,4,7,2,4,2,3,3,4,0,3,0,1,0,2,0,13
908,792140,32,6,8,6,8,0,0,6,8,2,7,2,2,1,4,5,18
908,797786,32,5,9,4,7,1,2,3,4,0,2,4,0,0,0,0,14
908,792144,29,3,5,0,2,3,3,0,0,0,5,2,3,0,4,2,9
908,792148,36,9,13,6,7,3,6,5,5,1,4,6,2,0,3,0,26
908,781429,38,4,7,0,1,4,6,0,0,0,3,1,1,1,3,0,12
908,792146,8,2,2,2,2,0,0,0,0,0,2,0,0,0,1,0,4
908,797789,11,1,2,1,1,0,1,1,2,0,1,0,0,1,1,0,3
908,785975,2,0,1,0,0,0,1,0,0,0,0,0,0,0,0,0,0
908,781431,12,0,1,0,0,0,1,5,6,0,4,3,0,0,0,0,5
910,785970,14,1,2,1,2,0,0,2,3,2,3,0,3,0,2,1,4
910,775394,25,4,7,3,5,1,2,3,4,4,7,0,1,0,1,1,12
910,791526,32,5,9,2,4,3,5,1,1,0,2,3,2,3,1,0,14
910,780272,26,5,10,4,7,1,3,0,0,0,4,2,1,1,3,0,11
910,775592,31,5,10,3,4,2,6,3,3,0,6,3,2,0,4,0,15
910,791524,15,2,5,0,2,2,3,2,2,4,2,0,1,0,0,0,8
910,797139,21,5,8,5,8,0,0,0,6,4,6,0,2,0,4,0,10
910,786354,3,0,0,0,0,0,0,0,0,0,0,0,2,0,1,0,0
910,797141,3,0,0,0,0,0,0,0,0,0,0,0,0,0,0,0,0
910,797136,2,0,0,0,0,0,0,0,0,0,0,0,0,0,0,0,0
910,791523,6,0,2,0,0,0,2,0,0,1,0,0,0,0,0,0,0
910,791525,1,0,0,0,0,0,0,0,0,0,0,0,0,0,0,0,0
910,797137,2,0,0,0,0,0,0,0,0,0,1,0,0,0,0,1,0
910,780273,19,2,7,2,3,0,4,0,0,0,1,2,0,2,1,0,4
911,791511,13,3,4,3,4,0,0,0,0,0,2,0,2,1,0,1,6
911,778442,36,6,14,3,6,3,8,0,0,0,7,3,3,5,5,0,15
911,797150,28,4,9,4,7,0,2,2,2,0,1,4,1,0,1,1,10
911,791514,18,1,3,0,1,1,2,0,0,0,0,1,2,0,0,0,3
911,786637,30,3,11,2,8,1,3,2,2,0,2,2,1,1,1,0,9
911,797151,17,2,6,2,4,0,2,0,0,2,1,1,3,0,0,1,4
911,791515,10,1,3,0,0,1,3,0,0,0,0,0,0,1,0,0,3
911,797154,3,0,1,0,0,0,1,0,0,0,0,0,0,0,0,0,0
911,797152,4,0,1,0,1,0,0,0,2,1,1,0,0,0,0,0,0
911,797149,13,0,1,0,0,0,1,2,4,1,0,0,4,0,2,1,2
911,780946,14,0,1,0,0,0,1,0,0,0,0,2,0,2,1,0,0
911,791513,14,4,7,2,4,2,3,0,0,0,2,0,1,0,0,0,10
912,785474,29,6,8,3,3,3,5,1,2,0,3,1,3,1,3,0,16
912,780283,12,4,5,4,5,0,0,0,0,0,3,1,3,0,3,0,8
912,790925,28,3,3,2,2,1,1,2,3,0,3,2,1,1,0,0,9
912,780285,26,2,7,2,5,0,2,2,4,3,8,2,0,0,4,1,6
912,785476,27,4,9,3,5,1,4,8,8,0,2,6,2,2,2,0,17
912,780292,25,4,6,4,6,0,0,3,7,2,8,3,2,0,1,3,11
912,785480,24,0,3,0,3,0,0,0,0,1,4,1,3,2,1,0,0
912,790926,15,3,7,2,3,1,4,0,0,0,1,0,1,0,0,0,7
912,796470,11,2,2,2,2,0,0,0,0,0,3,0,1,0,1,0,4
912,790343,1,0,0,0,0,0,0,0,0,0,0,0,0,0,0,0,0
912,785478,2,0,1,0,1,0,0,0,0,1,0,0,1,0,0,0,0
913,786233,11,2,5,2,2,0,3,0,0,0,0,0,2,1,2,0,4
913,786236,35,5,12,3,7,2,5,0,1,2,2,1,4,1,2,0,12
913,797325,11,3,4,3,4,0,0,0,2,0,4,0,4,0,2,0,6
913,797329,27,1,3,1,3,0,0,0,1,0,3,0,3,1,0,1,2
913,780759,29,5,10,4,5,1,5,0,0,0,0,2,3,1,1,0,11
913,797323,35,3,14,3,10,0,4,2,3,0,2,4,2,4,2,0,8
913,781002,18,1,2,1,2,0,0,0,1,3,3,1,3,1,1,1,2
913,797322,10,0,0,0,0,0,0,0,0,0,0,0,2,1,2,0,0
913,797327,9,1,5,1,1,0,4,1,1,0,1,0,0,0,2,1,3
913,776478,6,1,2,1,1,0,1,0,0,1,1,0,0,0,0,0,2
913,786246,5,1,2,1,1,0,1,0,0,0,0,0,0,0,0,0,2
913,797324,4,0,0,0,0,0,0,0,0,0,0,0,0,0,0,0,0
914,781342,28,5,11,5,7,0,4,7,13,4,8,0,2,2,1,1,17
914,781593,29,5,9,5,8,0,1,0,0,4,5,6,4,0,3,1,10
914,790901,27,2,10,2,3,0,7,0,1,0,2,0,0,0,0,0,4
914,785452,34,3,10,2,7,1,3,6,7,4,2,1,1,1,2,0,13
914,781620,28,3,9,2,4,1,5,4,4,0,4,3,2,0,1,0,11
914,774835,10,1,1,1,1,0,0,0,0,0,3,0,0,0,0,0,2
914,790902,18,1,5,0,2,1,3,0,0,0,2,0,2,0,1,0,3
914,796450,8,0,1,0,1,0,0,1,2,2,3,0,1,0,0,0,1
914,796449,4,0,0,0,0,0,0,0,0,0,0,0,0,0,1,0,0
914,790903,14,1,4,0,0,1,4,0,0,0,1,1,1,0,1,0,3
915,786765,35,4,10,2,6,2,4,1,2,3,2,3,3,2,3,3,11
915,792379,17,0,1,0,0,0,1,0,0,0,1,0,5,0,1,0,0
915,792380,38,2,6,0,1,2,5,2,2,0,1,2,1,1,0,0,8
915,781672,17,5,13,5,13,0,0,3,4,2,10,2,2,0,1,2,13
915,781669,38,5,16,4,9,1,7,1,2,0,2,2,4,0,2,0,12
915,786764,16,0,3,0,0,0,3,0,0,0,1,0,1,0,0,0,0
915,797854,18,1,2,0,0,1,2,0,0,0,2,0,4,0,1,0,3
915,797852,21,4,6,3,4,1,2,1,2,0,0,0,0,1,0,0,10
915,781671,0,0,0,0,0,0,0,0,0,0,0,0,0,0,0,0,0
916,780027,25,13,21,11,17,2,4,7,10,3,7,1,2,1,2,2,35
916,786176,23,2,6,0,2,2,4,5,6,1,4,0,2,0,1,0,11
916,786173,23,1,2,0,1,1,1,3,4,0,1,4,0,0,1,0,6
916,780028,23,1,3,1,1,0,2,0,0,1,5,6,2,1,1,0,2
916,774828,19,0,3,0,1,0,2,0,0,0,6,5,0,0,2,0,0
916,780029,19,8,11,6,7,2,4,0,0,2,3,0,3,1,0,1,18
916,797175,15,1,4,1,3,0,1,3,4,0,6,1,1,0,0,3,5
916,791379,15,3,9,2,5,1,4,3,4,1,5,3,2,0,0,0,10
916,791380,14,2,5,2,5,0,0,2,3,0,1,2,2,1,2,1,6
916,797179,9,0,0,0,0,0,0,2,2,1,0,2,0,0,2,0,2
916,797176,2,0,1,0,1,0,0,0,0,0,2,0,1,0,0,0,0
916,797178,6,0,0,0,0,0,0,0,0,0,1,0,1,0,0,0,0
916,780026,4,1,3,1,2,0,1,0,0,0,1,1,1,0,0,0,2
916,797177,2,1,2,1,2,0,0,0,0,2,0,0,0,0,0,0,2
916,786170,1,0,0,0,0,0,0,0,0,0,0,0,0,0,0,0,0
917,797779,23,4,11,2,5,2,6,0,0,3,2,2,3,3,0,3,10
917,797769,32,4,12,3,7,1,5,2,2,3,7,2,3,0,1,1,11
917,786256,26,6,13,6,12,0,1,0,2,2,4,2,3,0,2,0,12
917,797768,14,3,9,2,5,1,4,0,0,0,0,1,0,0,2,0,7
917,775106,18,0,4,0,1,0,3,0,0,1,2,1,3,0,1,0,0
917,785568,22,2,5,1,3,1,2,1,3,4,5,0,3,0,2,0,6
917,797776,30,2,12,2,9,0,3,1,2,0,4,4,2,2,4,0,5
917,797774,14,1,6,1,2,0,4,0,1,0,0,5,2,0,1,1,2
917,797780,8,0,1,0,0,0,1,0,0,0,0,0,2,0,1,0,0
917,797778,8,2,7,1,5,1,2,0,0,1,1,0,2,1,0,0,5
917,797775,5,0,0,0,0,0,0,0,0,0,0,0,0,0,0,0,0
918,792181,26,9,10,8,9,1,1,4,5,4,9,0,1,1,0,1,23
918,780986,31,2,4,2,3,0,1,3,4,2,8,3,0,2,3,0,7
918,797796,35,6,10,6,8,0,2,4,4,1,6,6,0,4,3,3,16
918,785902,30,3,13,1,7,2,6,2,2,0,4,4,1,0,2,1,10
918,792179,35,3,11,2,5,1,6,1,2,1,2,2,1,2,4,0,8
918,797794,14,3,5,2,3,1,2,2,4,1,4,0,2,2,2,2,9
918,792177,1,0,0,0,0,0,0,0,0,0,1,0,0,0,0,0,0
918,786661,15,1,7,1,2,0,5,0,0,1,2,0,2,0,3,0,2
918,792176,9,0,0,0,0,0,0,0,0,0,1,0,3,0,0,0,0
918,797788,4,0,0,0,0,0,0,0,0,0,0,0,0,0,0,0,0
919,790232,26,1,5,1,3,0,2,0,0,0,4,4,0,1,2,1,2
919,780093,25,4,6,4,6,0,0,0,0,2,0,1,2,0,0,0,8
919,789066,31,3,13,1,4,2,9,0,0,4,6,3,2,3,4,0,8
919,786463,15,1,8,0,4,1,4,0,0,0,0,1,2,1,2,1,3
919,776278,23,1,10,0,2,1,8,0,0,0,3,1,2,1,3,0,3
919,785806,24,1,4,1,1,0,3,2,2,0,2,2,1,0,1,0,4
919,792411,23,3,11,1,1,2,10,0,0,0,1,1,3,0,1,0,8
919,797593,13,2,2,2,2,0,0,1,2,1,0,0,1,0,0,0,5
919,780614,14,2,6,2,6,0,0,0,2,2,2,0,2,1,3,0,4
919,792412,2,0,0,0,0,0,0,0,0,0,1,1,1,0,1,0,0
919,797592,4,0,0,0,0,0,0,0,0,0,0,0,0,0,0,0,0
920,791822,29,2,7,0,0,2,7,0,0,0,0,0,1,1,1,0,6
920,786635,36,5,13,5,12,0,1,6,8,0,8,2,2,1,4,0,16
920,780642,31,6,12,5,10,1,2,2,2,3,1,5,2,1,2,0,15
920,791823,6,0,0,0,0,0,0,0,0,1,2,0,4,0,0,0,0
920,776449,30,6,8,5,6,1,2,2,3,1,6,4,4,1,2,0,15
920,797383,18,3,6,3,5,0,1,3,3,4,4,0,0,1,1,0,9
920,797384,4,1,2,1,2,0,0,1,1,0,0,1,0,0,0,0,3
920,781388,29,5,6,4,5,1,1,0,1,0,3,1,4,3,2,0,11
920,786632,2,0,1,0,0,0,1,0,0,0,0,0,0,0,0,0,0
920,798157,15,1,2,1,2,0,0,0,0,1,3,0,1,3,0,2,2
921,777865,22,2,3,1,2,1,1,0,0,0,1,1,3,0,6,0,5
921,776079,25,2,7,0,2,2,5,0,0,0,1,0,4,2,1,0,6
921,791432,37,5,12,3,9,2,3,2,2,0,0,4,1,0,2,0,14
921,780180,7,0,0,0,0,0,0,1,2,1,2,0,3,0,1,0,1
921,781650,26,5,9,5,9,0,0,2,4,4,0,1,3,0,2,1,12
921,791429,15,1,4,1,3,0,1,0,2,0,4,0,0,0,3,0,2
921,797068,25,1,6,1,4,0,2,2,2,0,1,3,1,1,1,0,4
921,797070,29,4,7,3,5,1,2,0,0,1,4,3,2,0,1,0,9
921,797066,14,1,2,1,2,0,0,0,0,0,4,0,1,0,0,0,2
922,790771,23,3,7,2,4,1,3,4,6,1,0,1,3,1,0,1,11
922,780271,34,2,5,1,1,1,4,3,6,1,3,2,2,4,1,0,8
922,790772,34,1,5,1,3,0,2,3,4,0,3,3,2,0,4,0,5
922,785230,22,5,9,3,6,2,3,0,0,0,3,0,3,0,2,0,12
922,780022,25,2,8,2,5,0,3,4,7,2,3,2,3,3,4,0,8
922,780375,22,4,8,1,4,3,4,2,4,0,2,1,1,0,2,0,13
922,780218,19,3,6,2,3,1,3,0,0,2,4,0,2,2,2,1,7
922,796328,19,2,4,2,3,0,1,2,2,0,2,2,1,0,1,0,6
922,790774,1,0,1,0,0,0,1,0,0,0,0,0,0,0,0,0,0
922,796329,1,0,0,0,0,0,0,0,0,0,0,0,0,0,0,0,0
923,785368,22,1,3,1,3,0,0,1,1,1,1,1,3,1,1,2,3
923,785247,27,10,13,8,10,2,3,2,2,0,12,1,2,1,4,0,24
923,790793,29,6,9,4,7,2,2,3,3,0,2,6,4,0,1,0,17
923,790792,32,4,6,3,5,1,1,5,8,0,5,0,1,2,3,2,14
923,785246,25,5,12,3,5,2,7,0,0,0,3,1,1,0,0,0,12
923,790794,17,5,6,5,6,0,0,0,0,1,0,1,3,1,2,1,10
923,780886,20,2,5,2,4,0,1,2,2,0,0,3,4,2,5,0,6
923,780281,13,1,6,1,4,0,2,0,0,0,2,0,3,1,0,0,2
923,796353,7,1,1,1,1,0,0,0,0,2,0,0,1,0,0,1,2
923,796350,4,0,1,0,0,0,1,0,0,0,0,0,0,0,0,0,0
923,790790,1,0,0,0,0,0,0,0,0,0,1,0,1,0,0,0,0
923,790789,3,0,0,0,0,0,0,0,0,0,0,0,0,0,0,0,0
924,786257,36,6,7,6,7,0,0,2,2,1,4,4,1,0,2,2,14
924,786263,13,1,1,0,0,1,1,2,3,1,1,0,0,0,2,0,5
924,797724,9,1,6,0,2,1,4,0,0,0,0,2,1,0,1,0,3
924,792122,25,1,7,1,2,0,5,0,0,4,1,0,3,1,1,0,2
924,775825,39,6,12,4,7,2,5,1,3,0,3,13,3,3,1,0,15
924,797721,2,1,1,0,0,1,1,0,0,0,0,0,0,0,1,0,3
924,792121,27,1,3,0,0,1,3,0,0,1,4,0,1,0,0,0,3
924,797725,2,1,1,1,1,0,0,0,0,0,0,0,3,0,0,2,2
924,792356,2,0,0,0,0,0,0,0,0,0,0,0,2,0,0,0,0
924,797722,15,7,9,1,2,6,7,0,0,2,2,0,0,1,2,1,20
924,786249,30,5,9,1,1,4,8,1,1,0,4,3,2,0,1,0,15
925,799000,33,6,8,6,8,0,0,0,2,0,6,0,2,0,2,0,12
925,785471,38,3,11,2,7,1,4,1,1,2,2,0,1,0,2,1,8
925,780263,34,5,10,5,9,0,1,3,3,1,4,1,2,1,3,0,13
925,775198,34,1,4,1,3,0,1,2,2,0,1,1,1,1,1,0,4
925,775628,33,8,12,7,11,1,1,6,8,1,0,3,4,4,3,2,23
925,775547,8,1,3,0,2,1,1,2,2,1,1,0,0,0,0,0,5
925,792397,1,0,0,0,0,0,0,2,2,0,0,0,0,0,0,0,2
925,792400,4,0,0,0,0,0,0,0,0,0,0,0,0,0,0,0,0
925,786697,8,0,0,0,0,0,0,0,0,0,1,0,0,0,0,0,0
925,780571,7,1,1,0,0,1,1,0,0,0,0,0,3,0,0,0,3
928,785228,27,4,7,2,3,2,4,5,6,2,6,0,3,0,0,0,15
928,780062,11,1,4,1,4,0,0,2,2,3,1,1,2,0,1,1,4
928,791581,28,11,13,6,6,5,7,5,7,1,2,1,1,4,0,0,32
928,786395,25,3,9,3,4,0,5,6,7,0,3,1,1,3,2,0,12
928,780404,19,0,4,0,3,0,1,0,0,0,0,2,3,0,5,1,0
928,791585,26,4,4,3,3,1,1,5,8,3,9,4,2,0,1,1,14
928,786394,23,0,2,0,0,0,2,5,9,1,3,6,1,0,2,1,5
928,797041,14,1,2,0,0,1,2,0,2,0,3,1,2,0,2,1,3
928,780403,8,0,1,0,0,0,1,1,2,1,1,2,1,0,0,0,1
928,791582,12,1,3,1,3,0,0,0,2,1,2,0,3,0,2,2,2
928,797037,5,1,1,1,1,0,0,0,0,0,0,0,0,1,0,0,2
928,797042,2,0,0,0,0,0,0,0,0,1,1,1,0,0,1,0,0
929,792128,24,3,10,2,8,1,2,2,3,5,1,1,3,1,1,0,9
929,786838,25,4,8,4,6,0,2,1,6,0,3,1,5,3,1,2,9
929,792132,11,1,3,0,2,1,1,0,0,0,0,0,0,0,3,0,3
929,792127,30,4,10,2,4,2,6,1,1,0,2,1,4,1,1,0,11
929,786267,22,2,6,1,4,1,2,1,2,0,3,3,4,0,2,0,6
929,797739,17,2,6,1,5,1,1,0,0,1,3,2,4,2,0,0,5
929,792126,11,1,7,0,0,1,7,0,0,1,1,0,4,0,0,0,3
929,792131,20,0,3,0,1,0,2,3,4,1,4,0,3,1,6,1,3
929,797736,17,1,5,0,1,1,4,0,0,0,0,1,2,0,2,0,3
929,791668,13,1,2,1,2,0,0,1,2,0,0,1,1,1,1,0,3
929,799273,10,1,2,1,2,0,0,0,1,2,2,0,3,0,0,1,2
930,785374,11,1,3,1,3,0,0,0,0,0,2,0,0,0,0,0,2
930,785373,30,6,9,2,3,4,6,0,0,0,0,0,1,0,1,2,16
930,785372,29,4,11,4,10,0,1,4,4,4,6,6,4,3,3,1,12
930,786384,19,3,6,2,2,1,4,3,4,1,4,2,1,0,2,0,10
930,790825,30,8,14,7,10,1,4,6,6,0,4,4,3,0,3,0,23
930,785371,19,0,3,0,1,0,2,2,2,0,1,1,2,0,1,0,2
930,785375,11,0,0,0,0,0,0,0,0,0,0,0,1,0,1,4,0
930,796385,19,1,3,1,3,0,0,2,3,0,4,2,1,1,4,0,4
930,790827,17,2,4,2,3,0,1,1,1,2,3,1,1,1,1,0,5
930,790828,12,4,7,4,7,0,0,1,3,3,2,0,2,0,1,0,9
930,796387,3,0,0,0,0,0,0,0,0,0,0,0,0,0,0,0,0
931,786795,31,3,7,2,2,1,5,0,0,1,5,5,5,2,0,0,7
931,789020,26,5,16,5,14,0,2,2,2,2,2,0,5,0,2,0,12
931,792091,34,7,14,3,8,4,6,2,2,2,3,3,2,1,2,1,20
931,786787,38,10,26,10,17,0,9,4,4,0,0,4,3,3,2,0,24
931,774954,39,4,8,4,8,0,0,3,3,5,7,2,3,2,3,0,11
931,781456,23,1,1,1,1,0,0,0,0,2,3,0,2,1,3,1,2
931,774815,8,0,1,0,0,0,1,0,0,0,1,0,0,0,0,0,0
931,775874,1,0,0,0,0,0,0,0,0,0,0,0,0,0,0,0,0
932,774806,18,2,3,2,3,0,0,3,4,2,8,3,5,0,5,1,7
932,775823,15,0,1,0,1,0,0,0,0,0,4,2,5,0,2,0,0
932,791041,37,3,12,2,4,1,8,0,2,2,4,1,2,0,2,0,7
932,791038,37,9,14,5,6,4,8,5,5,2,5,0,2,0,4,0,27
932,789023,28,6,12,3,6,3,6,5,6,0,2,4,5,1,2,0,20
932,796716,5,0,0,0,0,0,0,0,0,0,0,0,2,0,0,0,0
932,796714,11,2,5,2,5,0,0,4,6,3,2,1,5,0,1,0,8
932,786689,0,0,0,0,0,0,0,0,0,0,0,0,1,0,0,0,0
932,796712,2,0,1,0,0,0,1,0,0,0,1,0,0,0,0,0,0
932,791346,2,0,0,0,0,0,0,0,0,0,0,0,1,0,0,0,0
932,785922,19,1,3,1,3,0,0,4,5,3,5,3,2,1,0,0,6
932,775205,26,3,8,1,1,2,7,0,0,1,3,1,3,0,3,1,8
933,791512,16,0,2,0,2,0,0,3,4,2,2,3,4,2,1,0,3
933,786338,30,3,12,3,8,0,4,4,5,2,5,1,2,0,2,0,10
933,792050,25,2,10,2,6,0,4,1,2,2,2,3,3,2,2,1,5
933,785347,23,4,7,3,4,1,3,3,6,0,0,0,4,0,2,1,12
933,775601,31,3,9,1,6,2,3,8,10,1,2,0,5,1,3,0,16
933,786825,10,1,2,1,2,0,0,3,9,2,3,0,1,1,3,0,5
933,797648,9,2,4,2,3,0,1,0,0,1,2,0,2,1,0,0,4
933,797647,6,0,1,0,0,0,1,0,0,0,1,0,0,0,0,0,0
933,792052,19,1,3,1,1,0,2,2,2,0,1,0,3,0,1,0,4
933,792047,18,3,11,3,7,0,4,1,2,5,2,1,1,1,0,0,7
933,792051,2,0,0,0,0,0,0,0,0,1,1,0,0,0,0,0,0
933,780862,6,0,1,0,1,0,0,0,0,0,1,0,0,0,0,0,0
933,775476,2,0,0,0,0,0,0,0,0,0,0,0,1,0,0,0,0
933,792045,3,0,0,0,0,0,0,0,0,0,0,0,0,0,0,0,0
934,792294,11,0,1,0,1,0,0,0,0,0,2,1,2,0,1,0,0
934,775510,41,7,14,4,7,3,7,1,2,2,5,4,1,0,2,1,18
934,774976,37,5,9,4,7,1,2,7,8,0,11,1,0,0,1,2,18
934,792291,31,2,6,1,2,1,4,0,0,0,1,2,4,2,3,0,5
934,797865,31,2,4,2,2,0,2,0,0,0,3,0,2,2,2,0,4
934,786759,38,2,4,1,3,1,1,9,12,0,1,3,1,0,1,0,14
934,786614,19,2,4,1,2,1,2,3,4,2,2,2,1,2,0,1,8
934,792292,6,0,0,0,0,0,0,0,2,0,0,0,1,0,1,0,0
934,792293,11,1,2,1,2,0,0,2,2,0,0,1,1,0,0,0,4
935,780993,38,6,11,6,10,0,1,0,0,3,2,2,5,0,1,0,12
935,775248,37,5,16,2,6,3,10,0,0,1,4,2,5,0,4,0,13
935,797225,30,2,6,2,5,0,1,3,4,2,3,3,5,4,2,0,7
935,791452,38,3,7,1,3,2,4,0,0,0,5,0,5,0,1,0,8
935,797224,44,8,18,4,5,4,13,0,0,1,5,2,2,2,1,0,20
935,791449,19,0,2,0,1,0,1,0,0,0,0,2,1,1,1,0,0
935,797230,11,0,0,0,0,0,0,0,0,1,0,0,2,1,1,0,0
935,797231,4,1,2,1,1,0,1,0,0,1,1,0,0,0,0,0,2
935,791446,4,0,1,0,0,0,1,2,2,0,0,1,0,0,0,0,2
936,796870,21,4,9,4,9,0,0,2,2,1,1,0,0,0,1,0,10
936,786861,29,2,8,2,4,0,4,1,3,2,5,3,3,0,1,0,5
936,792415,33,5,13,2,5,3,8,3,5,1,5,2,1,3,2,1,16
936,767033,29,5,9,4,6,1,3,0,0,0,3,4,0,5,3,0,11
936,796869,1,0,0,0,0,0,0,0,0,0,0,0,0,0,0,0,0
936,785801,3,0,3,0,1,0,2,0,0,1,1,0,0,0,0,0,0
936,796867,1,0,1,0,0,0,1,0,0,0,0,0,0,1,1,0,0
936,796868,1,0,0,0,0,0,0,0,0,0,0,0,0,0,0,0,0
936,792416,28,2,6,0,3,2,3,2,2,0,2,3,1,0,1,0,8
936,786867,24,5,6,1,1,4,5,1,1,0,0,0,2,1,1,0,15
936,786866,7,0,1,0,0,0,1,0,0,0,1,0,1,0,0,0,0
936,786865,1,0,1,0,1,0,0,0,0,1,0,0,0,0,0,0,0
936,780387,22,6,7,4,5,2,2,1,2,1,9,1,3,1,1,0,15
937,791089,15,1,4,1,3,0,1,1,1,1,5,1,1,0,1,1,3
937,791097,28,3,5,2,4,1,1,0,0,0,3,0,3,1,3,1,7
937,796753,30,7,11,5,6,2,5,3,4,0,2,1,0,1,0,1,19
937,796752,28,4,6,2,2,2,4,4,5,0,3,4,3,1,4,0,14
937,791090,24,2,8,2,4,0,4,0,0,0,3,0,1,0,1,0,4
937,785577,17,1,5,1,5,0,0,0,0,0,3,1,1,0,1,0,2
937,791094,14,0,2,0,0,0,2,0,0,0,1,1,2,0,0,0,0
937,791091,12,1,2,1,1,0,1,0,0,0,1,1,2,0,1,0,2
937,791093,15,4,9,4,8,0,1,1,1,2,4,1,4,1,3,0,9
937,785569,17,2,5,1,1,1,4,0,0,0,0,1,1,0,3,0,5
938,798092,13,1,3,1,2,0,1,2,2,0,2,0,0,0,1,0,4
938,792299,25,5,8,5,7,0,1,6,7,1,5,0,3,1,0,3,16
938,792301,32,5,12,3,8,2,4,4,4,0,1,1,2,1,1,0,16
938,786275,27,5,8,3,4,2,4,4,4,0,4,3,4,1,0,0,16
938,792304,24,5,8,4,7,1,1,3,3,1,2,2,1,1,4,0,14
938,786286,21,1,3,1,1,0,2,1,1,0,5,3,1,0,0,0,3
938,786278,17,5,5,4,4,1,1,2,2,0,2,1,2,0,2,0,13
938,792302,15,1,2,1,2,0,0,0,0,3,1,2,2,2,1,0,2
938,792295,10,0,1,0,1,0,0,0,0,0,0,0,4,3,2,0,0
938,786280,11,4,5,4,5,0,0,1,1,0,1,0,2,0,0,1,9
938,798093,3,0,0,0,0,0,0,0,0,0,0,0,0,1,0,0,0
938,798090,2,1,2,1,2,0,0,0,1,0,1,0,0,0,0,0,2
940,791302,29,8,13,8,11,0,2,3,4,5,2,4,4,3,3,1,19
940,781622,27,4,9,2,3,2,6,2,2,3,3,0,2,1,0,0,12
940,791309,32,8,18,7,14,1,4,4,4,1,3,10,0,2,5,0,21
940,785835,23,5,9,5,8,0,1,0,0,1,2,1,2,0,0,1,10
940,776334,32,4,8,2,3,2,5,1,2,0,6,7,2,4,4,0,11
940,791301,15,6,10,4,6,2,4,0,0,2,2,0,2,1,1,1,14
940,775862,9,0,2,0,2,0,0,2,4,1,2,0,4,0,1,0,2
940,796604,9,0,0,0,0,0,0,0,0,0,1,2,4,2,1,0,0
940,796602,10,1,1,1,1,0,0,2,2,1,3,0,3,0,1,0,4
940,796603,6,2,2,1,1,1,1,0,0,1,2,0,0,2,0,0,5
940,796605,6,0,2,0,2,0,0,0,0,0,5,0,1,0,0,0,0
940,791304,2,0,0,0,0,0,0,0,0,0,0,0,0,0,0,0,0
941,786080,33,4,12,3,5,1,7,2,3,0,5,2,3,0,5,0,11
941,786216,23,3,3,3,3,0,0,1,4,2,2,1,5,0,2,0,7
941,791348,30,5,11,4,5,1,6,2,5,1,6,1,2,3,4,0,13
941,786218,33,5,12,4,6,1,6,2,3,2,2,1,1,3,3,1,13
941,780150,10,0,2,0,0,0,2,0,0,0,0,0,0,0,1,0,0
941,791350,22,1,3,0,1,1,2,0,0,0,4,2,1,0,2,0,3
941,785256,28,7,14,7,14,0,0,4,6,4,0,1,4,0,3,0,18
941,797257,9,0,0,0,0,0,0,0,1,0,3,0,2,0,0,0,0
941,781645,9,0,2,0,2,0,0,0,2,0,0,0,0,1,2,0,0
941,797258,1,0,0,0,0,0,0,0,0,0,0,0,0,0,0,1,0
941,786221,1,0,0,0,0,0,0,0,0,0,0,0,0,0,0,0,0
941,797256,1,0,0,0,0,0,0,0,0,0,0,0,0,0,0,0,0
942,785388,28,7,15,7,14,0,1,3,9,4,7,2,4,0,3,0,17
942,780370,28,1,5,1,3,0,2,0,0,2,3,3,1,1,0,0,2
942,790840,24,0,5,0,3,0,2,2,2,0,3,2,4,1,0,0,2
942,790841,36,2,6,1,3,1,3,9,12,1,2,2,1,0,0,0,14
942,780373,34,4,9,0,0,4,9,7,9,1,2,3,2,0,2,0,19
942,796393,12,2,6,2,6,0,0,2,3,0,1,0,4,0,2,1,6
942,796396,23,2,5,1,1,1,4,0,0,1,1,0,4,0,1,0,5
942,790839,15,1,3,1,1,0,2,1,2,0,1,1,1,2,1,0,3
943,792373,24,3,7,3,4,0,3,0,0,1,3,1,2,0,1,1,6
943,781598,10,0,2,0,0,0,2,0,0,0,1,0,5,0,5,0,0
943,792370,25,3,9,1,5,2,4,2,2,0,6,1,5,0,3,1,10
943,786739,30,0,3,0,1,0,2,4,4,0,3,5,2,0,2,0,4
943,775303,26,1,4,1,2,0,2,1,2,0,3,1,3,0,0,1,3
943,775809,26,5,10,4,6,1,4,4,5,2,4,2,3,2,2,0,15
943,797958,14,4,5,0,0,4,5,0,0,0,1,0,4,0,1,0,12
943,797960,7,1,2,1,1,0,1,0,0,0,2,0,2,0,1,0,2
943,790499,27,2,4,1,1,1,3,4,6,1,2,1,4,1,1,0,9
943,781597,10,0,0,0,0,0,0,0,0,0,1,2,2,0,0,0,0
943,797951,1,0,0,0,0,0,0,0,0,0,1,0,0,0,0,0,0
944,785977,29,4,10,2,2,2,8,0,0,1,9,0,2,2,1,0,10
944,791265,26,2,10,0,3,2,7,0,0,1,0,4,4,0,2,0,6
944,791271,19,1,3,1,3,0,0,0,0,1,4,1,3,0,0,1,2
944,785685,33,10,17,10,16,0,1,8,11,0,4,5,1,3,2,0,28
944,781294,21,0,2,0,0,0,2,0,0,0,1,1,3,0,1,0,0
944,791266,19,3,3,3,3,0,0,1,1,4,4,0,4,2,1,3,7
944,788872,2,0,1,0,1,0,0,0,0,1,0,0,2,1,1,0,0
944,796523,14,2,4,0,0,2,4,0,0,0,4,0,2,0,1,0,6
944,796522,17,3,7,1,1,2,6,0,0,0,0,2,1,1,1,0,8
944,796525,11,1,4,0,0,1,4,4,4,0,0,1,1,3,0,0,7
944,791270,1,0,0,0,0,0,0,0,0,0,0,0,0,0,0,0,0
944,781313,8,0,1,0,0,0,1,0,0,0,0,1,0,0,0,0,0
945,791352,31,2,6,2,4,0,2,1,3,3,3,1,4,1,2,1,5
945,785837,4,0,0,0,0,0,0,0,0,0,1,0,0,0,0,0,0
945,780455,17,2,6,2,6,0,0,1,2,1,2,0,1,0,2,0,5
945,797247,34,6,11,5,9,1,2,3,6,1,1,5,2,4,3,0,16
945,776297,34,7,15,3,7,4,8,2,2,0,5,0,2,2,2,0,20
945,797250,1,0,0,0,0,0,0,0,0,0,0,0,0,0,1,0,0
945,791355,4,0,0,0,0,0,0,0,0,0,0,0,0,0,0,0,0
945,791354,21,2,6,2,5,0,1,4,6,0,5,1,3,0,2,0,8
945,786227,1,0,0,0,0,0,0,0,0,0,0,0,0,0,0,0,0
945,797251,23,3,4,3,4,0,0,0,1,2,3,1,2,0,2,0,6
945,797248,30,3,7,1,1,2,6,2,3,1,3,1,2,0,0,0,10
946,776209,38,8,12,6,7,2,5,3,4,3,3,2,4,3,4,2,21
946,774875,6,0,0,0,0,0,0,0,0,0,0,1,2,0,0,0,0
946,796938,29,4,10,2,6,2,4,5,5,0,1,3,2,1,0,0,15
946,791237,31,4,14,2,5,2,9,0,2,2,5,2,4,1,4,1,10
946,791351,26,3,12,1,2,2,10,0,0,2,3,1,0,0,0,0,8
946,791239,2,0,0,0,0,0,0,0,0,0,0,0,1,0,0,0,0
946,788124,3,1,1,1,1,0,0,0,0,2,1,0,0,0,1,0,2
946,781227,13,1,1,1,1,0,0,0,0,1,2,1,5,1,0,0,2
946,791235,23,4,8,3,6,1,2,2,2,1,3,1,1,1,3,0,11
946,791236,13,1,3,1,2,0,1,1,2,1,2,0,1,0,1,0,3
946,791240,16,1,3,1,3,0,0,0,0,1,0,2,2,0,1,0,2
947,797967,33,8,8,8,8,0,0,1,6,3,2,4,3,0,4,0,17
947,797962,18,1,2,1,2,0,0,3,4,2,4,0,0,0,0,1,5
947,797970,27,3,8,2,5,1,3,6,6,1,5,3,4,1,1,0,13
947,781453,38,6,15,3,5,3,10,5,5,0,1,5,1,0,0,0,20
947,774869,36,4,11,0,1,4,10,2,2,1,1,2,4,1,0,0,14
947,792254,14,4,6,3,5,1,1,0,0,1,5,3,0,0,1,0,9
947,792256,7,0,1,0,1,0,0,0,0,0,0,0,0,0,0,0,0
947,797961,3,0,1,0,0,0,1,0,0,0,0,0,0,0,0,0,0
947,786098,24,5,9,3,3,2,6,1,2,4,3,2,2,2,4,0,13
948,792158,25,4,8,4,8,0,0,1,1,2,2,4,4,1,2,2,9
948,780138,25,7,10,7,10,0,0,9,12,3,2,1,3,2,0,0,23
948,792154,32,7,12,5,9,2,3,4,7,0,4,0,3,0,2,0,20
948,792152,37,2,6,2,4,0,2,2,3,0,3,2,1,3,3,0,6
948,780581,21,3,5,3,5,0,0,5,6,0,1,4,2,1,3,0,11
948,797755,9,1,1,1,1,0,0,0,0,0,0,0,1,1,0,0,2
948,792162,1,0,0,0,0,0,0,0,0,0,0,0,0,0,0,0,0
948,792157,19,5,7,5,7,0,0,0,0,2,2,0,3,0,1,1,10
948,797756,12,1,4,1,4,0,0,0,0,0,1,1,1,0,3,0,2
948,786014,19,1,2,1,1,0,1,1,3,0,2,4,4,0,2,0,3
949,796996,15,1,2,1,2,0,0,0,0,0,2,0,4,0,0,1,2
949,780471,28,5,5,5,5,0,0,4,4,2,4,2,4,1,5,2,14
949,791608,29,5,9,0,1,5,8,1,3,0,0,0,5,2,2,0,16
949,780417,5,1,2,1,2,0,0,0,0,0,0,1,1,0,1,0,2
949,776011,25,1,5,1,4,0,1,3,4,2,5,3,3,1,8,1,5
949,791610,30,6,6,6,6,0,0,8,9,0,4,6,4,2,1,1,20
949,786413,2,0,0,0,0,0,0,0,0,0,0,0,2,0,0,0,0
949,796994,25,3,4,1,1,2,3,2,2,0,0,2,2,1,4,0,10
949,791613,23,2,8,1,5,1,3,2,5,1,1,1,1,1,2,0,7
949,786353,6,0,1,0,1,0,0,0,0,0,2,0,2,1,3,0,0
949,785680,12,0,3,0,0,0,3,0,0,0,1,0,1,0,0,0,0
950,790833,24,6,12,5,9,1,3,2,2,1,3,4,5,3,2,0,15
950,796390,21,0,4,0,4,0,0,2,4,1,9,1,1,1,2,3,2
950,790832,22,4,8,2,2,2,6,0,0,0,1,1,0,1,0,0,10
950,790830,21,1,2,1,1,0,1,2,3,1,1,5,2,4,4,2,4
950,790834,31,4,9,2,3,2,6,4,4,1,2,2,2,2,2,1,14
950,785377,20,1,4,1,3,0,1,2,3,0,3,3,3,1,4,0,4
950,785451,28,6,17,2,7,4,10,7,7,2,2,1,1,4,4,0,23
950,785379,16,4,6,4,4,0,2,0,0,0,0,0,2,0,0,0,8
950,780297,2,0,0,0,0,0,0,0,0,0,1,0,0,0,0,1,0
950,790831,15,2,5,2,5,0,0,1,2,2,4,0,1,1,2,0,5
951,781208,29,2,9,2,8,0,1,4,4,3,7,2,3,0,3,0,8
951,785563,29,3,5,3,5,0,0,0,1,1,3,6,1,2,3,0,6
951,785560,29,3,10,0,2,3,8,2,2,0,4,0,1,0,2,0,11
951,780313,35,8,14,4,9,4,5,2,4,0,4,2,4,5,3,1,22
951,780766,25,2,7,0,4,2,3,2,2,0,1,1,5,1,7,0,8
951,785561,24,3,6,3,5,0,1,3,4,2,4,2,4,0,6,0,9
951,775489,13,0,3,0,2,0,1,0,0,0,0,0,1,0,0,0,0
951,780758,8,2,4,2,4,0,0,0,0,1,2,0,2,0,2,0,4
951,791088,5,0,1,0,1,0,0,0,0,0,0,0,0,0,3,0,0
951,796751,1,0,0,0,0,0,0,0,0,0,0,0,1,0,1,0,0
951,791087,2,0,0,0,0,0,0,0,0,0,0,0,1,0,0,0,0
952,791639,29,5,9,4,7,1,2,4,6,1,4,2,2,1,1,0,15
952,785389,34,6,18,6,15,0,3,4,6,0,3,0,0,1,0,0,16
952,796398,24,0,1,0,0,0,1,0,0,1,1,3,2,0,2,0,0
952,775654,27,3,6,3,6,0,0,0,0,4,5,0,4,2,1,5,6
952,785999,31,5,8,5,8,0,0,2,3,2,6,0,4,0,2,1,12
952,775171,16,2,4,2,2,0,2,6,7,0,2,0,2,0,1,0,10
952,785255,15,1,2,1,1,0,1,0,0,1,2,1,3,0,1,1,2
952,796399,17,2,3,2,3,0,0,0,0,1,2,0,2,0,2,0,4
952,791640,7,2,3,2,2,0,1,0,0,1,1,0,2,0,0,0,4
953,780695,32,3,13,2,6,1,7,1,1,2,2,0,2,1,0,0,8
953,797594,18,2,6,1,3,1,3,0,0,0,1,0,1,0,0,0,5
953,791884,30,3,10,3,8,0,2,4,4,0,0,5,3,0,3,0,10
953,791883,29,3,9,3,5,0,4,5,7,3,1,2,3,0,2,0,11
953,781066,29,3,5,2,4,1,1,4,6,4,8,4,2,0,1,0,11
953,791885,6,0,2,0,2,0,0,0,0,0,0,0,0,0,0,0,0
953,797596,30,5,8,1,3,4,5,0,0,3,1,0,3,0,2,0,14
953,797598,9,1,2,1,2,0,0,2,2,1,1,0,3,0,0,0,4
953,797600,13,0,1,0,0,0,1,0,0,0,3,0,1,1,0,0,0
953,786496,4,0,0,0,0,0,0,0,0,0,1,0,0,0,0,0,0
954,796381,27,5,7,4,5,1,2,0,0,1,2,0,1,1,2,0,11
954,775585,23,4,7,4,7,0,0,0,0,4,4,0,2,1,1,1,8
954,790822,31,6,15,4,9,2,6,3,4,4,8,3,0,0,1,1,17
954,780443,23,5,9,2,4,3,5,7,7,0,4,5,2,1,2,0,20
954,774980,31,5,13,4,9,1,4,0,0,0,2,3,1,1,0,0,11
954,790821,20,2,5,1,2,1,3,1,2,0,4,1,1,0,0,0,6
954,790820,24,0,5,0,3,0,2,5,6,0,8,6,3,0,3,0,5
954,775634,11,0,0,0,0,0,0,2,4,0,0,0,1,2,0,1,2
954,780445,10,1,3,1,2,0,1,0,0,1,3,0,1,0,0,0,2
955,792167,25,6,8,6,8,0,0,2,6,1,5,0,4,1,0,0,14
955,792170,25,3,5,1,2,2,3,0,0,0,5,0,2,0,2,1,8
955,792163,13,0,0,0,0,0,0,0,0,0,1,1,2,2,3,0,0
955,792164,26,0,8,0,4,0,4,1,2,1,1,0,3,0,5,0,1
955,780974,23,3,7,2,5,1,2,0,0,1,2,0,0,1,1,0,7
955,797767,25,1,4,1,3,0,1,0,0,0,3,8,3,0,0,0,2
955,791372,26,7,13,2,3,5,10,0,0,1,2,4,1,1,1,0,19
955,797777,7,0,2,0,2,0,0,0,0,0,0,1,0,0,0,0,0
955,797766,15,2,6,0,0,2,6,0,0,0,3,0,0,0,1,0,6
955,797772,10,0,4,0,1,0,3,0,0,0,0,1,2,0,1,0,0
955,797764,5,1,2,0,0,1,2,0,0,0,2,1,0,0,0,0,3
956,790979,23,5,8,1,2,4,6,0,0,1,1,3,4,0,3,1,14
956,796700,31,7,9,0,0,7,9,5,6,0,4,9,2,0,1,0,26
956,790978,23,4,11,0,0,4,11,0,2,1,1,2,1,2,2,0,12
956,796699,27,3,6,1,2,2,4,2,2,1,3,4,1,1,1,0,10
956,790983,31,5,8,3,5,2,3,1,4,0,4,4,4,1,2,1,13
956,788820,21,3,6,1,1,2,5,0,0,2,2,0,1,1,1,0,8
956,796698,13,2,4,1,2,1,2,0,0,2,3,0,1,1,3,1,5
956,790981,9,0,1,0,0,0,1,0,0,0,1,1,0,0,2,0,0
956,796701,11,0,0,0,0,0,0,0,0,1,5,1,0,0,2,0,0
956,790976,11,1,1,1,1,0,0,0,0,0,0,0,1,0,0,1,2
957,790909,33,6,7,4,5,2,2,5,5,1,3,2,4,4,1,0,19
957,781393,39,11,20,9,13,2,7,5,7,0,4,3,3,3,2,0,29
957,775351,20,2,5,2,5,0,0,0,0,1,1,0,5,3,3,0,4
957,787175,37,3,9,0,0,3,9,0,0,0,4,1,2,1,2,0,9
957,796455,27,1,2,1,2,0,0,0,0,1,1,1,2,1,2,1,2
957,782126,8,0,3,0,1,0,2,0,0,0,0,1,0,0,1,0,0
957,796453,28,7,12,7,9,0,3,4,6,0,1,0,2,0,0,0,18
957,790907,8,0,0,0,0,0,0,0,0,1,2,1,0,0,0,0,0
957,796454,0,0,0,0,0,0,0,0,0,0,0,0,0,0,0,0,0
958,780323,22,1,1,1,1,0,0,1,4,3,4,0,2,1,2,0,3
958,792233,23,4,9,4,8,0,1,5,6,0,5,1,1,2,1,0,13
958,797894,24,3,4,3,4,0,0,2,4,1,0,5,1,0,2,0,8
958,785954,25,4,6,0,1,4,5,2,2,0,0,4,1,0,0,0,14
958,785811,24,8,13,4,5,4,8,0,0,0,2,5,1,0,2,1,20
958,797892,19,3,7,2,5,1,2,0,0,0,4,0,3,2,5,3,7
958,792234,12,3,4,2,3,1,1,0,2,2,2,0,2,0,0,3,7
958,786016,22,0,1,0,1,0,0,1,2,1,1,2,2,3,0,0,1
958,792230,8,0,2,0,2,0,0,0,0,0,0,1,5,0,1,0,0
958,781356,7,1,1,0,0,1,1,0,0,0,0,1,1,0,0,1,3
958,797891,8,0,1,0,0,0,1,0,0,1,0,1,0,0,0,0,0
958,797893,6,1,2,1,2,0,0,2,2,0,3,0,2,0,0,0,4
959,792265,25,3,6,3,5,0,1,0,2,4,4,1,1,3,3,1,6
959,797998,24,2,8,1,4,1,4,0,0,1,2,0,2,0,1,0,5
959,786152,13,3,3,3,3,0,0,1,1,3,0,0,4,0,1,0,7
959,798009,35,5,13,4,8,1,5,2,2,2,3,1,1,0,3,0,13
959,798006,17,0,5,0,2,0,3,2,2,0,1,3,2,1,3,0,2
959,798005,9,1,1,1,1,0,0,0,0,1,3,0,5,0,1,0,2
959,792267,12,0,4,0,1,0,3,0,0,0,2,0,1,0,4,0,0
959,792266,14,0,5,0,2,0,3,0,1,0,0,0,0,0,1,1,0
959,798003,20,2,5,2,4,0,1,0,0,0,0,1,1,1,3,0,4
959,798007,14,1,2,1,2,0,0,1,1,1,0,0,2,0,2,0,3
959,798002,17,1,1,1,1,0,0,2,5,1,3,2,3,0,0,0,4
960,785512,13,1,5,1,5,0,0,4,4,0,1,0,2,1,1,0,6
960,774834,22,2,5,2,4,0,1,3,5,2,5,1,0,1,0,1,7
960,796718,21,1,2,0,0,1,2,0,0,0,1,4,3,1,0,0,3
960,776374,20,1,2,1,1,0,1,0,0,1,2,2,4,3,4,0,2
960,775412,29,2,8,2,4,0,4,0,2,1,1,1,1,4,1,2,4
960,796723,19,3,6,1,2,2,4,0,0,0,1,1,5,0,2,0,8
960,796719,14,0,3,0,3,0,0,3,6,4,2,0,0,0,2,0,3
960,791042,20,6,13,6,10,0,3,2,2,1,5,0,1,1,1,0,14
960,766998,8,0,2,0,2,0,0,0,0,1,1,1,1,0,0,1,0
960,796717,22,4,8,4,7,0,1,0,0,0,1,1,1,0,5,0,8
960,796720,12,2,5,2,4,0,1,1,2,0,1,0,1,2,0,0,5
961,791750,18,1,1,1,1,0,0,0,0,0,3,2,4,1,1,1,2
961,786177,23,5,8,0,1,5,7,0,0,1,9,1,1,1,1,1,15
961,780244,21,3,5,2,3,1,2,1,3,0,2,1,2,2,2,0,8
961,786179,24,4,8,3,4,1,4,2,2,0,3,4,2,3,1,0,11
961,780238,23,7,10,5,7,2,3,2,3,1,0,5,0,1,1,0,18
961,791752,14,3,5,3,5,0,0,1,1,1,2,0,1,0,1,2,7
961,785909,11,0,2,0,2,0,0,0,0,0,1,0,1,0,0,2,0
961,790773,17,3,5,2,3,1,2,5,7,1,4,1,1,2,1,0,12
961,781500,13,1,2,1,1,0,1,0,0,0,0,3,1,1,6,0,2
961,797347,7,0,1,0,0,0,1,0,0,0,0,0,1,0,1,0,0
961,791749,8,1,2,1,1,0,1,0,0,0,1,0,2,0,2,0,2
961,791748,7,1,2,1,1,0,1,0,1,0,0,1,1,0,0,0,2
961,786171,7,1,1,1,1,0,0,3,4,0,0,0,1,0,0,0,5
961,797346,7,2,3,2,2,0,1,0,1,1,3,0,1,0,2,0,4
964,792171,23,3,9,3,9,0,0,2,4,0,7,2,4,0,1,5,8
964,785674,41,3,5,2,2,1,3,2,2,0,5,1,2,1,2,0,9
964,780049,32,4,10,4,10,0,0,4,9,1,1,3,3,1,4,2,12
964,797784,40,7,19,4,12,3,7,4,7,0,5,5,1,1,2,0,21
964,789059,42,7,13,7,10,0,3,0,3,4,8,0,2,2,1,0,14
964,797782,13,0,3,0,2,0,1,0,0,0,1,3,3,0,1,0,0
964,792174,6,0,0,0,0,0,0,0,0,0,0,1,0,0,0,0,0
964,780527,23,2,4,2,3,0,1,4,8,2,3,2,2,2,1,0,8
964,780980,5,0,0,0,0,0,0,0,0,0,0,0,0,0,0,0,0
965,796955,29,2,5,2,5,0,0,5,9,3,8,1,3,0,3,0,9
965,791257,13,1,3,0,1,1,2,0,0,0,3,1,5,0,1,0,3
965,781606,43,4,13,3,9,1,4,0,0,0,2,4,4,1,2,0,9
965,781263,36,8,17,8,15,0,2,2,4,4,2,1,2,1,3,0,18
965,781257,37,3,11,3,9,0,2,4,4,1,5,0,4,0,3,0,10
965,791255,13,0,1,0,1,0,0,0,0,0,2,1,4,0,0,1,0
965,780900,29,3,8,2,7,1,1,0,0,3,6,1,1,3,2,1,7
965,796954,24,5,7,3,4,2,3,1,1,0,3,0,1,1,2,0,13
965,785508,1,0,0,0,0,0,0,0,0,0,1,0,0,0,0,0,0
966,785714,15,4,4,4,4,0,0,3,3,0,4,0,2,1,0,1,11
966,775894,24,6,9,5,7,1,2,0,0,0,3,2,4,1,3,0,13
966,785711,26,5,11,3,7,2,4,2,2,0,4,4,1,2,2,0,14
966,780985,26,4,8,2,2,2,6,0,0,0,2,0,1,0,0,0,10
966,775266,31,1,7,1,2,0,5,2,2,1,2,3,1,2,0,0,4
966,785710,6,0,0,0,0,0,0,0,0,0,0,0,0,0,0,0,0
966,796829,15,7,8,7,8,0,0,0,0,2,4,0,0,1,0,2,14
966,785378,19,1,4,1,3,0,1,7,8,1,6,2,1,0,0,1,9
966,791167,18,4,4,3,3,1,1,2,2,0,1,3,0,2,1,0,11
966,780988,10,1,3,1,2,0,1,2,4,1,3,1,2,0,1,0,4
966,791169,4,1,1,0,0,1,1,0,0,0,1,0,1,0,0,0,3
966,796827,3,0,2,0,1,0,1,0,0,0,1,0,0,0,0,0,0
966,796828,3,0,0,0,0,0,0,0,0,0,0,0,0,0,0,0,0
967,797235,27,6,14,6,12,0,2,2,4,2,3,2,1,0,1,0,14
967,797232,31,5,13,2,4,3,9,0,0,0,3,2,4,0,1,0,13
967,791367,26,1,5,1,4,0,1,2,2,0,0,2,0,0,4,0,4
967,797234,24,2,4,1,2,1,2,2,3,0,1,1,5,0,1,0,7
967,797239,38,5,13,5,8,0,5,0,0,0,6,5,2,0,3,1,10
967,797233,5,0,0,0,0,0,0,0,0,0,0,0,0,0,1,0,0
967,785446,8,0,2,0,1,0,1,0,0,0,2,1,1,0,2,0,0
967,791368,8,0,1,0,1,0,0,0,0,0,1,0,1,0,0,0,0
967,797237,15,1,4,0,1,1,3,0,0,1,1,0,4,1,1,0,3
967,786251,12,1,3,1,3,0,0,0,0,3,1,0,0,0,0,1,2
967,797238,6,2,4,2,4,0,0,1,1,0,2,0,1,0,0,0,5
968,792277,12,2,4,2,4,0,0,2,3,0,1,0,2,0,1,0,6
968,781464,28,3,8,1,2,2,6,0,0,1,0,5,2,2,0,1,8
968,785282,19,3,5,2,2,1,3,1,2,0,0,1,4,1,0,0,8
968,781502,26,6,7,4,4,2,3,0,1,0,7,2,1,0,2,0,14
968,780259,28,8,13,6,10,2,3,1,1,2,0,2,2,1,1,0,19
968,785913,22,3,5,3,5,0,0,1,2,3,5,1,2,0,1,0,7
968,781501,23,5,7,5,6,0,1,0,0,4,5,5,0,2,1,0,10
968,786516,12,2,6,1,1,1,5,0,0,1,2,0,0,0,1,0,5
968,798058,13,0,5,0,5,0,0,2,2,0,2,2,0,1,2,0,2
968,798056,7,0,2,0,1,0,1,0,0,0,1,0,1,0,0,0,0
968,798051,4,0,1,0,1,0,0,0,0,1,1,0,1,0,2,1,0
968,792275,2,0,0,0,0,0,0,0,0,0,1,0,0,1,1,0,0
968,798038,3,0,1,0,0,0,1,0,0,0,0,0,0,0,1,0,0
968,798048,1,0,0,0,0,0,0,0,0,0,0,0,0,0,0,0,0
969,797895,13,3,4,3,4,0,0,1,3,1,2,0,2,1,2,0,7
969,789058,26,1,4,0,0,1,4,0,0,0,2,2,2,0,1,0,3
969,797898,14,1,2,0,0,1,2,0,0,0,1,3,1,0,4,0,3
969,792236,23,2,5,2,3,0,2,2,2,1,2,0,5,1,3,0,6
969,781374,28,4,12,2,8,2,4,1,2,0,4,1,0,2,2,0,11
969,792237,17,4,8,2,3,2,5,3,4,0,2,2,1,1,0,0,13
969,776337,12,1,1,1,1,0,0,0,0,1,3,1,1,0,1,0,2
969,785286,20,2,7,2,5,0,2,1,4,0,1,1,1,1,2,0,5
969,785818,11,2,4,0,1,2,3,0,0,0,0,0,0,0,0,0,6
969,792359,11,1,1,0,0,1,1,0,0,0,2,0,0,0,1,0,3
969,792238,3,0,0,0,0,0,0,0,0,0,0,0,1,0,0,0,0
969,797897,10,1,4,0,1,1,3,0,2,0,0,0,0,1,0,0,3
969,792240,8,1,2,1,2,0,0,0,0,2,2,2,0,0,0,0,2
969,785986,4,0,0,0,0,0,0,0,0,0,0,0,0,0,0,0,0
970,780824,24,2,6,2,6,0,0,0,0,2,1,0,2,1,2,3,4
970,791117,38,3,9,1,4,2,5,2,6,2,5,0,4,1,0,3,10
970,791118,38,6,14,4,8,2,6,6,8,1,6,3,2,0,4,0,20
970,785676,22,3,3,3,3,0,0,2,2,1,5,0,4,0,2,0,8
970,774974,36,3,14,1,7,2,7,7,9,0,3,5,4,0,3,2,15
970,796771,3,0,1,0,0,0,1,0,0,0,2,0,1,0,0,0,0
970,791115,12,1,1,1,1,0,0,2,2,1,1,1,3,0,0,0,4
970,796769,18,1,1,1,1,0,0,0,0,0,1,0,0,0,1,0,2
970,791116,9,1,2,1,2,0,0,0,0,1,2,0,1,0,1,0,2
971,780870,30,2,6,2,6,0,0,1,5,6,6,4,2,0,1,1,5
971,785380,16,3,5,2,3,1,2,0,0,3,1,1,2,1,1,0,7
971,781079,25,1,7,0,2,1,5,0,0,0,0,3,2,1,0,0,3
971,781443,29,5,12,1,7,4,5,7,9,0,4,3,3,2,3,1,21
971,775822,30,5,12,1,3,4,9,0,0,0,6,1,2,0,0,0,14
971,796626,9,1,2,1,2,0,0,0,0,1,1,1,1,0,0,0,2
971,796625,14,1,6,1,1,0,5,3,4,0,6,1,2,1,0,1,5
971,796621,23,1,5,0,2,1,3,0,0,1,0,1,3,3,1,1,3
971,785831,24,5,5,5,5,0,0,6,6,2,3,4,3,3,2,1,16
972,796592,22,6,8,5,7,1,1,0,2,1,4,1,3,4,0,2,13
972,791306,18,6,6,6,6,0,0,2,2,1,7,1,2,2,0,0,14
972,780210,27,5,7,5,6,0,1,0,0,3,7,3,1,1,2,1,10
972,792427,11,1,4,1,2,0,2,0,0,0,1,1,1,2,2,0,2
972,786422,23,4,8,4,7,0,1,0,1,0,0,7,1,1,3,0,8
972,796595,6,0,1,0,1,0,0,0,0,2,0,0,5,0,0,0,0
972,790880,14,3,6,3,6,0,0,1,2,3,4,1,0,0,1,2,7
972,795353,4,0,1,0,0,0,1,0,0,0,0,0,0,1,0,0,0
972,796594,16,3,9,3,6,0,3,0,0,1,2,5,2,0,1,0,6
972,792989,2,0,1,0,1,0,0,0,0,1,0,0,0,0,0,0,0
972,792432,22,4,8,4,6,0,2,2,2,1,1,4,0,0,3,0,10
972,792433,19,3,7,0,0,3,7,3,4,2,1,1,3,2,1,1,12
972,775005,16,7,10,2,3,5,7,1,2,0,4,0,2,0,0,0,20
974,791905,25,6,11,5,7,1,4,4,4,2,2,1,1,1,1,0,17
974,781103,15,3,6,3,5,0,1,0,1,0,5,1,2,1,0,0,6
974,797568,25,7,19,6,11,1,8,1,1,2,2,2,1,0,0,0,16
974,781191,25,7,9,3,3,4,6,1,2,2,4,5,2,1,3,0,19
974,781102,23,2,3,2,3,0,0,1,1,0,6,1,0,1,1,0,5
974,797570,5,1,2,0,1,1,1,0,0,0,0,0,0,0,0,0,3
974,791909,5,0,3,0,3,0,0,0,1,1,2,1,0,0,0,1,0
974,791907,10,1,2,1,2,0,0,1,2,2,0,1,2,2,1,0,3
974,791904,12,6,9,4,6,2,3,0,0,0,0,1,1,0,0,0,14
974,797566,30,3,4,2,2,1,2,4,4,2,7,3,2,3,3,1,11
974,791906,25,2,5,2,3,0,2,0,0,0,2,0,0,3,0,0,4
976,780615,12,0,0,0,0,0,0,0,0,0,4,2,0,0,0,0,0
976,781624,17,2,5,2,3,0,2,0,0,4,2,1,1,1,1,0,4
976,791701,25,6,7,4,4,2,3,0,0,0,6,3,2,1,3,1,14
976,781420,24,7,14,4,4,3,10,2,2,1,1,2,1,0,2,0,19
976,781405,24,8,15,6,9,2,6,0,0,0,2,4,2,3,0,1,18
976,797924,10,2,2,2,2,0,0,0,0,1,3,0,5,0,2,0,4
976,792244,12,2,7,1,2,1,5,0,0,2,5,0,1,0,1,0,5
976,781417,12,2,3,2,2,0,1,0,0,0,2,0,1,0,1,0,4
976,792246,15,2,4,2,4,0,0,5,6,2,2,1,1,0,1,0,9
976,797920,2,0,0,0,0,0,0,0,0,0,1,0,0,0,0,0,0
976,797930,2,0,1,0,0,0,1,0,0,0,0,0,0,0,1,0,0
976,797925,16,2,9,2,5,0,4,0,0,1,1,2,1,1,0,0,4
976,797933,3,0,0,0,0,0,0,0,0,0,0,0,0,0,0,0,0
976,792245,26,4,5,2,3,2,2,0,0,0,5,4,2,1,0,0,10
978,786843,15,1,1,1,1,0,0,0,2,0,3,0,1,1,1,2,2
978,792220,25,8,15,5,7,3,8,2,2,4,5,6,3,0,2,0,21
978,786691,28,3,5,2,3,1,2,2,2,0,8,2,4,0,7,2,9
978,786693,25,5,12,5,10,0,2,0,4,0,4,6,4,0,4,0,10
978,781455,29,2,5,1,2,1,3,1,3,0,2,5,1,1,0,0,6
978,797876,25,2,3,2,2,0,1,5,6,9,8,2,4,1,2,0,9
978,792222,13,1,3,0,2,1,1,1,2,3,0,1,4,0,1,0,4
978,781319,14,6,9,6,9,0,0,5,6,2,5,2,2,1,3,4,17
978,781408,21,5,14,5,10,0,4,2,5,3,3,1,0,2,2,1,12
978,792447,2,0,1,0,1,0,0,0,0,0,0,0,0,0,0,0,0
978,776059,3,0,0,0,0,0,0,1,4,0,0,0,0,1,0,0,1
980,796318,15,4,6,3,3,1,3,0,0,0,3,0,3,1,4,0,9
980,790761,20,1,7,1,6,0,1,0,1,1,1,1,1,2,1,0,2
980,790764,32,9,12,3,4,6,8,0,0,0,6,2,3,1,1,1,24
980,796322,15,2,3,2,3,0,0,1,1,4,3,3,2,0,1,4,5
980,779993,32,2,4,1,2,1,2,2,2,1,4,6,0,3,2,0,7
980,796321,16,4,6,0,2,4,4,0,0,3,3,0,2,0,0,0,12
980,796319,31,2,7,2,4,0,3,0,1,0,4,6,1,2,4,1,4
980,796320,15,1,4,1,1,0,3,2,2,0,0,2,1,1,2,0,4
980,785219,11,1,3,0,1,1,2,0,0,0,0,0,2,0,1,0,3
980,775668,5,1,1,1,1,0,0,0,1,0,1,0,2,0,1,2,2
980,796323,8,2,3,2,3,0,0,0,0,0,2,0,0,2,1,0,4
981,796617,25,7,9,7,9,0,0,0,2,1,1,1,1,0,1,0,14
981,775131,25,5,7,4,6,1,1,2,3,1,1,2,3,0,2,0,13
981,796612,37,3,10,3,8,0,2,0,0,3,0,4,1,0,8,0,6
981,796606,30,1,3,0,1,1,2,0,0,0,4,1,2,2,1,0,3
981,785562,34,3,15,3,13,0,2,2,3,1,6,2,2,1,2,0,8
981,792429,13,1,4,0,3,1,1,0,0,0,2,0,1,1,0,0,3
981,796607,18,2,3,2,3,0,0,1,4,0,4,1,2,0,4,0,5
981,796614,18,1,2,1,1,0,1,0,0,0,1,2,0,0,0,0,2
982,797050,29,3,10,2,8,1,2,0,0,2,6,0,1,1,1,0,7
982,780394,31,2,5,1,2,1,3,5,6,2,1,3,3,0,1,0,10
982,780391,24,2,4,2,4,0,0,0,4,0,2,0,4,0,1,0,4
982,790871,32,4,13,3,8,1,5,3,4,0,4,4,3,3,2,0,12
982,776473,27,3,5,3,4,0,1,2,2,0,6,1,3,0,2,0,8
982,797048,27,6,10,4,7,2,3,4,6,3,5,0,2,0,2,2,18
982,791570,5,0,1,0,1,0,0,2,2,1,0,0,0,0,0,0,2
982,791573,10,0,0,0,0,0,0,0,0,0,0,2,0,0,0,0,0
982,780392,15,1,1,1,1,0,0,4,4,0,1,0,1,3,0,0,6
983,776004,22,3,6,2,4,1,2,2,2,0,5,0,2,0,3,0,9
983,780358,25,4,10,3,6,1,4,2,2,0,3,1,4,0,1,2,11
983,775011,28,3,10,1,3,2,7,1,2,2,3,2,2,1,0,1,9
983,780357,18,0,4,0,1,0,3,4,5,0,1,3,5,1,1,0,4
983,775018,31,6,14,3,9,3,5,2,2,0,6,2,1,1,3,0,17
983,796484,10,0,1,0,1,0,0,0,0,1,0,0,2,0,0,0,0
983,790930,25,1,3,1,2,0,1,1,2,1,1,1,3,1,1,1,3
983,796480,30,4,7,4,6,0,1,4,4,4,2,0,2,1,0,0,12
983,776270,11,0,1,0,0,0,1,0,0,2,0,2,1,0,1,0,0
984,797367,21,5,8,5,8,0,0,3,4,5,4,3,3,2,2,1,13
984,797364,16,3,4,3,4,0,0,0,0,1,4,0,0,2,2,0,6
984,797366,17,2,3,2,2,0,1,2,4,0,3,6,1,3,0,0,6
984,791807,17,6,11,1,2,5,9,0,2,1,1,1,1,2,0,0,17
984,786130,22,6,10,6,8,0,2,8,14,1,7,4,1,0,3,0,20
984,797371,7,2,3,2,3,0,0,1,2,1,3,3,0,0,0,0,5
984,797368,12,3,4,3,4,0,0,2,5,2,1,1,1,0,0,0,8
984,786127,7,2,4,2,4,0,0,0,0,1,0,0,2,0,0,0,4
984,797370,4,0,0,0,0,0,0,0,2,1,0,0,1,0,0,0,0
984,797369,16,4,5,1,1,3,4,4,4,0,1,2,1,3,1,0,15
984,797365,10,4,8,3,4,1,4,1,1,0,1,2,0,1,0,0,10
984,797363,19,3,6,1,2,2,4,1,2,0,1,6,4,1,3,0,9
984,791805,4,0,0,0,0,0,0,0,0,0,0,0,0,1,1,0,0
984,791804,16,1,3,1,2,0,1,0,0,1,0,3,1,6,2,0,2
984,791808,12,1,5,1,4,0,1,0,0,2,1,0,0,2,0,0,2
986,785335,14,1,2,1,2,0,0,0,0,3,1,0,3,1,1,0,2
986,780303,28,7,14,4,10,3,4,1,2,1,7,1,5,1,0,1,18
986,791594,33,5,12,2,6,3,6,2,2,1,1,6,1,4,1,0,15
986,786349,16,1,4,1,4,0,0,0,0,0,0,3,3,0,3,0,2
986,781385,31,4,13,4,7,0,6,9,10,2,5,6,3,1,1,1,17
986,791011,17,4,4,3,3,1,1,0,0,1,1,1,1,0,1,2,9
986,796671,4,0,2,0,2,0,0,0,0,1,0,0,0,0,0,0,0
986,785337,17,6,7,6,6,0,1,4,5,1,5,0,1,0,1,0,16
986,791012,23,1,6,1,1,0,5,0,0,0,4,3,1,1,1,0,2
986,781221,17,1,5,0,3,1,2,0,0,0,2,1,0,1,0,0,3
987,792035,32,5,13,5,13,0,0,3,4,3,3,5,4,1,5,1,13
987,780833,14,3,5,3,5,0,0,0,0,1,0,1,4,0,0,0,6
987,792034,38,5,8,1,3,4,5,0,0,3,9,2,1,1,2,0,14
987,785381,19,1,4,0,0,1,4,2,2,0,0,0,0,0,0,0,5
987,780830,28,3,4,0,0,3,4,5,6,0,4,2,3,0,5,0,14
987,797645,2,0,1,0,1,0,0,0,0,0,0,0,0,0,0,0,0
987,791688,16,2,6,0,2,2,4,0,0,0,3,1,2,1,0,0,6
987,792033,31,8,14,3,8,5,6,3,5,0,6,1,3,1,1,1,24
987,785980,20,2,4,0,1,2,3,0,0,0,2,3,0,0,0,0,6
988,796568,21,9,11,9,11,0,0,2,2,0,4,1,0,1,1,0,20
988,796566,19,8,9,8,9,0,0,5,8,4,9,1,0,1,0,3,21
988,790968,14,3,4,3,3,0,1,0,0,0,0,1,1,2,1,0,6
988,780166,21,2,4,0,2,2,2,0,0,0,3,6,2,1,0,0,6
988,775107,16,1,3,0,1,1,2,0,0,0,4,3,1,1,1,0,3
988,796567,6,1,4,0,2,1,2,0,0,0,1,0,1,0,0,1,3
988,796564,12,7,8,6,7,1,1,2,2,5,0,0,2,1,1,0,17
988,790971,10,2,2,2,2,0,0,0,0,1,0,4,1,1,0,0,4
988,796569,16,1,6,1,5,0,1,0,0,1,1,2,3,0,2,0,2
988,796565,14,1,5,1,1,0,4,0,0,1,1,3,1,1,0,0,2
988,796563,13,3,3,2,2,1,1,2,2,0,5,2,2,3,0,1,9
988,790969,23,5,5,4,4,1,1,2,2,0,6,5,1,0,1,0,13
988,790967,15,3,8,0,0,3,8,0,0,0,0,0,1,1,0,0,9
990,776462,27,5,8,4,7,1,1,4,7,2,1,1,2,3,2,2,15
990,785635,27,4,11,4,10,0,1,1,2,2,5,0,2,0,1,5,9
990,786440,30,1,6,0,1,1,5,5,5,1,1,3,3,0,2,0,8
990,786720,33,8,12,6,9,2,3,3,4,0,9,3,2,0,3,0,21
990,781199,35,8,17,7,14,1,3,0,0,0,1,9,2,3,3,0,17
990,791629,13,1,2,1,1,0,1,0,0,0,1,1,0,1,1,0,2
990,775642,17,1,2,1,1,0,1,2,4,2,2,1,1,0,0,1,4
990,796974,8,0,2,0,1,0,1,0,0,0,0,0,0,0,0,0,0
990,786439,8,0,0,0,0,0,0,0,0,0,2,0,3,1,1,0,0
990,791628,2,0,0,0,0,0,0,0,0,0,0,0,0,0,0,0,0
991,797628,30,3,10,2,6,1,4,2,2,4,2,3,2,0,3,1,9
991,786481,36,10,19,8,16,2,3,1,2,1,5,0,2,1,1,1,23
991,797626,31,5,11,5,11,0,0,0,0,2,1,3,3,3,3,1,10
991,797624,18,1,2,0,0,1,2,0,0,0,4,0,4,0,1,0,3
991,785965,31,5,10,2,6,3,4,3,3,0,3,2,2,0,4,0,16
991,791793,4,0,1,0,0,0,1,0,0,0,0,0,3,0,2,0,0
991,791791,31,0,3,0,1,0,2,0,0,1,1,4,1,0,0,0,0
991,781032,15,1,3,0,1,1,2,1,2,1,2,1,0,0,0,0,4
991,797627,4,0,1,0,0,0,1,2,2,0,0,0,1,1,0,0,2
992,786358,33,5,12,1,1,4,11,2,2,4,6,3,2,0,5,0,16
992,775418,19,3,5,3,5,0,0,2,2,1,1,0,3,1,1,3,8
992,786357,33,6,15,4,8,2,7,1,2,2,7,5,4,1,3,2,15
992,780306,26,2,5,2,3,0,2,2,2,1,10,6,3,0,3,0,6
992,780312,37,6,11,0,0,6,11,2,2,0,4,4,3,2,2,2,20
992,791535,4,0,0,0,0,0,0,0,0,0,1,0,0,0,1,0,0
992,791537,21,4,7,3,4,1,3,0,1,2,3,1,4,0,2,0,9
992,775565,27,4,8,2,4,2,4,1,2,0,0,4,3,1,1,0,11
993,774812,25,2,6,2,4,0,2,1,1,1,3,0,4,1,1,0,5
993,791500,34,2,7,2,7,0,0,1,2,3,6,3,1,1,1,1,5
993,791497,23,5,13,3,8,2,5,1,2,0,1,0,5,1,1,0,13
993,781486,34,4,13,2,8,2,5,9,10,1,1,0,1,1,2,0,19
993,780461,34,5,10,5,7,0,3,7,8,0,3,3,0,2,4,0,17
993,791498,15,1,3,1,3,0,0,0,0,0,5,0,0,0,0,2,2
993,797180,6,0,1,0,1,0,0,0,0,0,0,0,0,0,1,0,0
993,791503,13,0,4,0,4,0,0,0,0,2,3,1,1,0,2,0,0
993,791502,3,0,1,0,1,0,0,0,0,0,0,0,0,0,1,0,0
993,791499,11,0,1,0,1,0,0,0,0,0,0,0,0,0,0,0,0
993,790517,2,0,0,0,0,0,0,0,0,0,0,0,0,0,0,0,0
994,780765,35,3,7,2,4,1,3,3,3,0,6,4,1,2,2,1,10
994,781301,17,0,1,0,1,0,0,0,2,0,3,0,1,0,0,3,0
994,786255,32,3,7,2,5,1,2,3,4,0,2,3,2,1,2,0,10
994,780762,31,4,10,1,4,3,6,0,0,0,1,1,1,2,3,0,11
994,780768,38,6,10,2,5,4,5,1,2,1,1,8,3,2,4,0,17
994,791729,25,4,8,2,5,2,3,1,1,2,3,1,2,1,3,0,11
994,780755,21,3,8,1,4,2,4,0,0,1,2,1,4,1,1,0,8
994,797320,1,1,1,0,0,1,1,0,0,0,0,0,0,0,0,0,3
995,780094,33,3,8,2,4,1,4,8,10,2,4,2,2,0,1,0,15
995,775142,35,10,17,8,13,2,4,0,2,1,3,2,3,1,2,1,22
995,790842,20,3,4,3,4,0,0,0,2,4,2,0,3,1,1,2,6
995,790843,34,5,9,3,5,2,4,2,2,0,5,6,2,3,4,0,14
995,781563,22,4,5,3,3,1,2,0,0,0,1,3,1,1,3,0,9
995,790844,12,1,5,1,3,0,2,0,2,1,4,0,0,0,1,0,2
995,796914,18,3,7,0,2,3,5,0,0,0,1,2,1,0,0,0,9
995,786212,26,2,3,2,3,0,0,2,2,3,6,2,1,4,1,1,6
1008,791482,22,2,7,1,3,1,4,2,2,4,2,0,0,2,0,0,7
1008,797198,15,3,3,3,3,0,0,0,0,0,0,2,0,0,0,0,6
1008,784268,26,3,8,1,2,2,6,0,0,0,2,6,1,0,3,0,8
1008,786318,22,8,14,3,3,5,11,0,0,0,5,2,1,0,1,0,21
1008,780223,25,4,7,0,0,4,7,0,0,0,2,2,2,1,1,0,12
1008,797199,19,2,4,1,2,1,2,2,3,0,3,1,1,0,0,0,7
1008,780225,26,3,9,1,1,2,8,0,0,0,5,7,1,0,0,0,8
1008,786319,10,3,3,3,3,0,0,0,0,3,3,1,0,1,1,0,6
1008,791481,18,2,6,2,4,0,2,0,0,2,1,1,0,0,0,0,4
1008,786320,10,3,5,2,2,1,3,0,0,0,0,1,0,0,0,0,7
1008,786317,3,0,1,0,1,0,0,0,0,0,1,0,1,0,0,0,0
1008,791480,2,0,0,0,0,0,0,0,0,0,0,0,0,0,0,0,0
1008,796079,2,0,1,0,1,0,0,0,0,0,1,0,0,0,0,0,0
1010,780642,30,7,12,6,10,1,2,2,2,0,2,2,1,3,3,0,17
1010,776449,27,6,8,3,4,3,4,0,0,0,1,1,4,4,2,0,15
1010,786635,28,5,10,4,7,1,3,3,4,4,7,0,1,0,3,0,14
1010,791822,27,5,12,2,4,3,8,0,0,0,1,2,1,0,0,0,13
1010,791823,13,0,0,0,0,0,0,0,0,0,2,1,2,1,0,0,0
1010,781388,29,3,11,3,10,0,1,4,5,0,3,6,4,2,0,0,10
1010,798157,18,1,4,1,4,0,0,0,0,4,2,0,2,0,1,1,2
1010,797383,17,1,2,1,1,0,1,0,0,3,3,1,4,0,1,2,2
1010,797384,8,0,0,0,0,0,0,0,0,0,2,0,0,0,1,0,0
1010,791821,1,0,0,0,0,0,0,0,0,0,0,0,0,0,0,0,0
1010,786632,1,0,1,0,0,0,1,0,0,0,0,0,0,0,0,0,0
1010,797385,1,0,0,0,0,0,0,0,0,0,1,0,1,0,0,0,0
1011,781650,24,6,11,6,11,0,0,0,0,1,1,1,2,0,2,0,12
1011,791432,31,3,9,3,8,0,1,0,0,0,2,3,1,0,2,0,6
1011,776079,26,2,5,1,1,1,4,0,0,1,4,4,0,0,2,0,5
1011,777865,21,2,3,2,3,0,0,1,2,0,2,1,2,3,4,0,5
1011,780180,15,1,1,1,1,0,0,0,0,2,1,3,1,2,1,1,2
1011,797070,23,3,7,1,2,2,5,2,2,0,5,0,1,0,2,0,10
1011,797068,19,1,2,1,2,0,0,7,7,0,4,3,2,1,1,0,9
1011,797067,12,1,3,0,0,1,3,1,2,0,0,0,0,0,1,0,4
1011,791429,10,1,3,1,3,0,0,1,2,1,0,1,0,0,1,1,3
1011,785401,6,0,0,0,0,0,0,1,2,0,0,0,0,0,0,0,1
1011,797066,13,0,2,0,2,0,0,0,2,1,2,0,3,0,0,1,0
1012,785589,34,7,15,7,15,0,0,6,6,3,5,0,3,1,3,0,20
1012,791216,19,2,4,2,3,0,1,3,4,1,4,2,1,1,1,2,7
1012,791209,27,2,5,2,5,0,0,0,0,3,5,2,3,0,1,1,4
1012,791215,20,3,6,1,1,2,5,0,0,0,1,1,1,0,0,0,8
1012,791214,27,1,4,1,4,0,0,0,0,0,1,1,1,2,0,1,2
1012,791213,14,0,4,0,1,0,3,0,0,1,1,2,3,0,2,0,0
1012,776313,15,2,6,1,3,1,3,0,0,1,2,0,1,0,0,0,5
1012,776364,22,2,4,1,1,1,3,1,2,0,2,2,3,0,0,0,6
1012,796917,18,4,6,3,4,1,2,2,2,1,0,1,1,0,2,0,11
1012,791207,4,0,1,0,0,0,1,0,0,0,1,0,0,0,0,0,0
1013,781058,27,2,4,2,4,0,0,0,0,1,4,1,0,1,0,0,4
1013,780327,23,2,3,2,3,0,0,1,2,1,3,0,3,0,0,1,5
1013,797451,26,2,8,2,6,0,2,5,7,2,1,1,2,2,4,0,9
1013,791849,30,3,6,0,0,3,6,0,0,0,5,1,1,1,1,0,9
1013,786607,22,2,8,1,3,1,5,0,0,0,1,3,2,0,1,0,5
1013,791848,7,0,2,0,0,0,2,0,0,0,0,0,3,0,0,0,0
1013,797455,18,3,3,3,3,0,0,3,4,1,3,0,2,0,1,1,9
1013,785622,9,0,4,0,2,0,2,0,0,1,1,0,1,1,1,0,0
1013,797458,16,2,5,2,3,0,2,1,1,0,3,1,2,0,2,0,5
1013,797452,11,1,2,1,1,0,1,0,0,0,0,0,3,0,2,0,2
1013,797453,9,1,1,1,1,0,0,0,0,0,0,1,0,1,1,0,2
1013,797456,2,0,2,0,0,0,2,0,0,0,0,0,0,0,0,0,0
1014,767245,30,8,13,8,12,0,1,9,10,1,2,3,2,1,2,2,25
1014,780212,34,5,14,4,9,1,5,11,12,0,6,4,2,0,2,0,22
1014,775087,20,4,6,4,6,0,0,4,6,4,3,1,2,2,2,0,12
1014,790984,27,2,7,1,2,1,5,0,2,0,2,0,1,1,0,0,5
1014,780406,26,0,5,0,3,0,2,1,2,2,6,1,2,0,2,0,1
1014,791168,15,1,3,1,1,0,2,0,0,0,0,0,0,1,0,0,2
1014,790985,9,0,0,0,0,0,0,1,2,1,1,0,1,0,0,0,1
1014,780214,12,0,1,0,0,0,1,0,0,0,2,0,1,0,0,0,0
1014,785297,11,0,2,0,0,0,2,0,0,0,4,0,4,0,2,0,0
1014,780215,9,0,1,0,1,0,0,0,0,0,0,0,2,0,0,0,0
1014,796596,7,0,0,0,0,0,0,0,0,0,1,0,0,0,0,0,0
1015,780105,30,6,9,5,7,1,2,0,1,1,4,0,5,0,1,1,13
1015,791408,18,5,5,5,5,0,0,3,4,0,3,0,5,1,3,0,13
1015,785894,36,2,7,1,3,1,4,6,7,0,4,1,4,0,1,0,11
1015,781131,26,3,12,3,11,0,1,5,8,1,7,6,3,1,7,0,11
1015,791409,7,0,0,0,0,0,0,0,0,0,0,0,1,0,0,0,0
1015,786183,35,5,10,3,7,2,3,0,0,2,3,1,4,0,0,0,12
1015,785637,19,1,7,1,3,0,4,1,1,0,1,1,2,0,0,0,3
1015,785915,17,1,3,0,0,1,3,0,0,0,1,0,0,0,0,1,3
1015,780106,7,0,0,0,0,0,0,0,0,1,1,0,2,0,1,0,0
1015,785914,5,0,1,0,0,0,1,0,0,0,3,0,1,0,0,0,0
1016,780107,36,5,9,4,7,1,2,3,4,0,3,1,2,1,2,0,14
1016,775833,29,3,6,3,5,0,1,2,5,5,7,2,4,3,4,1,8
1016,781036,36,3,8,3,5,0,3,4,4,1,2,7,4,1,5,0,10
1016,775571,30,2,6,1,2,1,4,2,2,0,3,1,4,0,2,2,7
1016,774894,40,9,14,6,8,3,6,2,2,1,5,0,1,1,2,0,23
1016,796847,8,0,0,0,0,0,0,0,0,0,0,0,2,0,1,0,0
1016,791178,11,0,3,0,3,0,0,2,2,1,3,0,0,0,0,0,2
1016,789925,8,0,0,0,0,0,0,0,0,0,1,0,1,0,0,0,0
1016,796846,2,0,0,0,0,0,0,0,0,0,0,0,0,0,0,0,0
1017,786041,30,2,5,2,5,0,0,4,4,2,1,0,2,3,1,1,8
1017,780881,26,6,14,4,9,2,5,0,0,1,3,1,4,0,3,0,14
1017,780275,22,0,3,0,3,0,0,0,0,3,2,1,3,0,4,1,0
1017,792075,37,6,12,5,7,1,5,6,10,1,2,1,3,0,1,0,19
1017,786686,35,7,17,4,11,3,6,4,4,0,6,3,3,2,1,0,21
1017,786051,5,0,0,0,0,0,0,0,0,0,1,0,1,0,2,1,0
1017,780882,8,0,2,0,1,0,1,0,0,1,1,1,1,0,1,0,0
1017,780052,32,1,5,1,2,0,3,2,2,1,2,1,2,0,1,0,4
1017,792074,5,0,0,0,0,0,0,0,0,0,0,0,0,0,0,0,0
1018,775820,12,0,3,0,2,0,1,0,0,0,1,1,0,0,0,1,0
1018,775538,27,4,6,4,6,0,0,1,3,2,3,0,0,0,0,0,9
1018,785603,29,5,12,3,6,2,6,0,0,2,3,1,1,0,1,0,12
1018,775534,26,2,9,1,3,1,6,0,0,1,2,3,2,0,4,0,5
1018,776425,34,3,8,2,5,1,3,0,0,1,4,3,1,0,2,1,7
1018,796763,2,0,0,0,0,0,0,1,2,1,1,0,0,0,0,0,1
1018,791107,21,4,9,3,7,1,2,2,4,3,3,1,2,2,1,0,11
1018,791106,19,3,9,3,5,0,4,2,4,1,1,0,3,2,2,0,8
1018,791110,17,0,4,0,4,0,0,0,0,3,1,1,1,2,3,0,0
1018,786494,13,2,3,2,2,0,1,0,1,2,2,0,1,0,1,0,4
1019,785775,34,5,6,4,4,1,2,5,6,2,8,9,2,1,4,3,16
1019,781335,29,7,12,3,4,4,8,0,0,1,0,2,1,2,0,3,18
1019,776351,29,3,11,1,4,2,7,0,0,0,1,2,2,2,1,0,8
1019,785770,32,10,14,4,6,6,8,0,0,1,3,3,1,0,1,0,26
1019,781341,31,3,7,1,1,2,6,0,0,0,4,2,0,0,2,0,8
1019,796542,12,0,1,0,1,0,0,0,0,0,1,1,5,0,0,0,0
1019,791282,1,0,1,0,1,0,0,0,0,1,0,0,0,0,0,0,0
1019,791285,2,1,2,0,0,1,2,0,0,0,0,0,0,0,0,0,3
1019,796538,10,0,0,0,0,0,0,0,0,0,1,1,2,0,1,0,0
1019,791286,1,0,0,0,0,0,0,0,0,0,0,0,0,0,0,0,0
1019,791284,1,0,0,0,0,0,0,0,0,0,0,0,0,0,1,0,0
1019,791283,13,1,2,1,2,0,0,0,0,0,5,0,3,0,0,0,2
1019,785773,1,0,0,0,0,0,0,0,0,0,0,0,0,0,0,0,0
1019,785767,4,0,2,0,1,0,1,0,0,0,1,0,2,1,1,0,0
1020,775574,37,8,14,4,7,4,7,5,6,2,3,1,1,2,0,0,25
1020,780890,30,8,11,8,10,0,1,1,1,1,1,7,5,1,3,0,17
1020,775757,18,5,8,5,8,0,0,4,4,2,2,0,1,0,4,0,14
1020,786066,32,3,10,3,8,0,2,0,1,0,8,4,2,1,2,0,6
1020,785636,37,1,5,1,1,0,4,0,2,0,4,2,3,0,1,1,2
1020,785969,12,5,6,5,6,0,0,0,1,2,0,1,4,2,2,0,10
1020,791119,12,1,4,1,4,0,0,1,2,2,3,0,0,0,0,0,3
1020,791123,22,1,4,1,4,0,0,0,0,0,0,0,3,0,1,0,2
1021,786520,33,6,12,6,11,0,1,1,3,1,3,4,3,1,7,0,13
1021,797556,21,6,12,5,8,1,4,0,0,1,4,1,0,0,1,0,13
1021,786519,22,6,7,6,7,0,0,0,0,3,8,0,3,1,1,1,12
1021,791913,36,3,7,1,5,2,2,2,5,0,0,4,1,2,5,0,10
1021,791911,15,2,4,0,0,2,4,2,2,0,2,0,1,0,1,0,8
1021,797558,17,2,5,1,3,1,2,2,2,1,2,0,4,2,2,1,7
1021,797557,16,1,2,0,1,1,1,0,0,1,0,1,1,0,0,0,3
1021,797555,26,1,6,1,4,0,2,0,2,0,3,2,1,1,1,0,2
1021,791912,9,1,2,1,2,0,0,0,0,2,1,0,3,0,2,0,2
1021,797560,4,1,1,1,1,0,0,0,0,1,0,0,1,0,0,0,2
1021,781105,1,0,0,0,0,0,0,0,0,0,1,0,0,0,0,0,0
1022,790998,38,1,9,1,4,0,5,1,3,5,3,2,2,0,1,0,3
1022,766874,26,5,12,5,11,0,1,4,10,2,8,1,4,0,5,2,14
1022,790997,31,0,4,0,2,0,2,0,0,1,5,0,2,2,0,0,0
1022,790996,38,8,18,5,12,3,6,1,3,2,3,3,0,2,1,0,20
1022,785621,25,2,7,0,2,2,5,0,0,0,5,1,0,1,2,0,6
1022,796631,15,2,6,2,3,0,3,0,0,1,1,0,2,1,0,0,4
1022,796633,14,1,3,1,2,0,1,0,0,1,2,0,2,0,3,0,2
1022,790992,2,1,1,1,1,0,0,1,1,0,0,0,1,0,0,0,3
1022,796632,4,0,1,0,0,0,1,0,0,0,0,0,0,0,0,0,0
1022,790995,28,4,6,1,2,3,4,0,0,0,2,5,2,0,1,0,11
1022,781520,4,0,0,0,0,0,0,2,2,1,0,1,1,0,1,0,2
1023,791564,33,6,14,4,11,2,3,2,2,2,6,1,0,0,1,0,16
1023,775549,19,1,5,1,5,0,0,0,0,1,3,1,5,0,1,1,2
1023,797056,36,4,7,2,3,2,4,2,2,2,3,0,4,1,3,0,12
1023,797054,29,2,6,2,3,0,3,4,6,1,2,2,4,1,4,0,8
1023,786380,38,7,12,5,9,2,3,2,2,1,3,1,1,1,2,0,18
1023,791566,5,0,0,0,0,0,0,0,0,0,2,0,1,0,0,0,0
1023,780425,26,2,4,2,4,0,0,3,4,0,11,0,3,2,2,1,7
1023,791568,21,1,5,1,3,0,2,1,2,0,2,1,2,1,1,0,3
1023,797055,16,0,4,0,3,0,1,2,2,0,1,2,0,0,1,0,2
1023,797058,2,0,0,0,0,0,0,0,0,0,0,0,0,0,0,0,0
1024,791023,5,1,2,1,2,0,0,2,2,1,3,0,0,0,1,3,4
1024,791027,19,7,9,7,9,0,0,2,2,2,3,3,0,1,0,0,16
1024,791024,22,3,11,1,5,2,6,6,6,2,1,7,0,4,1,1,14
1024,781507,18,2,2,1,1,1,1,1,2,0,3,2,3,0,1,0,6
1024,777572,28,6,9,5,7,1,2,7,10,0,4,4,3,6,1,0,20
1024,796686,12,6,8,6,8,0,0,1,2,0,3,1,1,1,1,0,13
1024,791021,5,3,4,3,3,0,1,3,3,2,1,1,0,0,0,0,9
1024,791028,17,0,2,0,1,0,1,2,4,1,4,3,3,0,0,0,2
1024,791727,17,5,7,3,5,2,2,0,0,2,6,1,1,0,0,4,12
1024,796685,23,7,12,4,5,3,7,0,0,0,0,2,0,2,0,0,17
1024,796684,9,6,9,5,8,1,1,1,2,2,2,1,1,1,0,0,14
1024,796683,20,3,8,2,5,1,3,2,2,0,0,4,1,1,3,1,9
1024,791025,5,1,1,1,1,0,0,0,0,0,2,1,0,0,0,0,2
1026,796656,21,2,7,2,7,0,0,0,0,0,4,1,3,1,3,0,4
1026,796651,18,4,5,2,2,2,3,0,0,0,3,0,1,0,0,0,10
1026,791320,39,8,15,7,12,1,3,3,4,0,3,2,3,0,1,1,20
1026,785912,32,6,14,2,5,4,9,0,0,2,1,1,4,0,1,0,16
1026,781511,48,6,14,2,7,4,7,2,2,1,3,5,2,1,4,0,18
1026,796657,27,3,3,2,2,1,1,1,2,0,4,1,1,0,0,0,8
1026,796653,3,0,0,0,0,0,0,0,0,0,0,1,0,0,0,0,0
1026,796652,3,0,0,0,0,0,0,0,0,0,0,0,1,0,0,0,0
1026,791323,29,2,4,2,2,0,2,0,0,0,3,4,2,2,4,1,4
1026,791321,30,4,7,4,7,0,0,3,4,1,3,2,5,2,0,2,11
1027,791225,17,3,3,3,3,0,0,2,2,0,0,0,0,1,2,0,8
1027,791223,36,4,6,4,6,0,0,0,0,4,8,2,3,4,1,1,8
1027,791224,39,5,11,4,9,1,2,0,0,0,5,4,3,1,5,1,11
1027,781181,38,3,8,2,3,1,5,2,5,0,1,2,1,0,2,0,9
1027,785571,36,9,16,9,16,0,0,9,11,0,5,2,1,1,1,1,27
1027,796927,14,1,4,1,1,0,3,1,2,0,1,0,2,1,0,0,3
1027,775324,29,5,12,5,12,0,0,4,8,8,4,0,3,0,0,0,14
1027,796929,16,4,7,1,1,3,6,0,0,0,1,1,1,1,1,0,11
1027,785564,14,1,3,1,2,0,1,0,0,0,1,0,0,0,0,0,2
1027,786436,11,0,1,0,1,0,0,0,0,0,0,1,1,0,0,0,0
1028,780956,30,3,9,1,4,2,5,0,0,0,4,1,1,0,4,2,8
1028,791723,18,3,5,3,5,0,0,2,4,1,4,0,3,2,0,0,8
1028,781617,33,5,13,4,9,1,4,2,3,2,8,0,4,0,2,0,13
1028,797310,32,4,8,4,7,0,1,4,4,0,0,3,3,2,2,0,12
1028,791724,33,3,8,1,4,2,4,0,0,1,1,0,4,0,1,1,8
1028,797308,14,1,1,0,0,1,1,0,2,1,1,0,1,2,0,0,3
1028,786285,27,2,9,1,4,1,5,4,4,0,2,1,2,0,0,0,9
1028,780706,13,0,3,0,0,0,3,2,2,1,1,2,3,0,0,0,2
1029,780569,32,5,8,5,8,0,0,3,6,1,9,2,1,0,4,1,13
1029,780570,17,3,6,3,6,0,0,0,0,1,2,0,5,0,4,0,6
1029,797438,26,0,5,0,1,0,4,0,0,0,4,1,1,0,0,0,0
1029,780565,29,5,10,3,7,2,3,4,4,0,6,2,4,1,3,0,16
1029,781556,26,2,4,1,2,1,2,2,2,0,4,4,1,1,2,0,7
1029,791695,24,2,6,2,6,0,0,3,5,4,2,0,4,0,1,0,7
1029,785824,5,0,0,0,0,0,0,0,1,0,0,0,1,0,0,0,0
1029,791696,10,2,3,0,0,2,3,2,2,0,1,0,2,0,3,0,8
1029,797432,29,3,7,2,3,1,4,0,0,1,1,1,3,1,1,0,7
1029,797434,2,0,0,0,0,0,0,1,2,0,0,0,0,0,0,0,1
1030,796882,24,2,7,1,4,1,3,2,3,1,3,5,0,1,1,0,7
1030,790447,29,3,8,2,6,1,2,0,0,0,2,4,0,0,0,3,7
1030,796884,28,2,7,0,2,2,5,0,1,2,3,3,1,1,2,0,6
1030,796886,18,6,8,5,7,1,1,1,1,3,6,2,2,2,3,0,14
1030,796892,16,6,8,6,8,0,0,0,0,6,3,0,1,0,1,0,12
1030,796881,6,2,2,0,0,2,2,0,0,0,0,1,2,0,0,0,6
1030,776336,6,1,3,0,0,1,3,0,0,0,0,0,0,0,0,0,3
1030,796887,15,2,6,1,2,1,4,0,0,0,4,3,1,0,0,0,5
1030,796888,12,0,1,0,0,0,1,0,2,0,1,1,2,0,3,0,0
1030,796889,6,2,3,0,0,2,3,0,0,0,0,0,0,1,0,0,6
1030,796890,7,1,3,1,2,0,1,2,2,0,1,0,1,0,0,1,4
1030,785324,15,3,6,2,3,1,3,0,0,1,3,0,2,0,2,0,7
1030,796891,13,4,8,4,7,0,1,1,1,0,5,1,3,1,0,0,9
1030,796894,5,0,1,0,1,0,0,0,0,0,1,2,1,0,0,0,0
1032,781332,33,2,8,1,4,1,4,4,5,1,5,3,0,3,1,0,9
1032,791960,34,6,13,2,5,4,8,0,0,0,5,3,2,1,0,0,16
1032,776174,26,5,9,5,9,0,0,1,1,3,4,2,3,1,5,1,11
1032,791958,27,2,6,2,4,0,2,0,0,0,7,1,3,0,2,1,4
1032,785861,34,6,10,5,7,1,3,0,0,4,7,6,2,2,3,0,13
1032,786059,17,6,10,5,8,1,2,1,3,1,5,1,1,0,2,3,14
1032,797704,18,1,3,1,1,0,2,0,0,1,1,1,1,2,0,0,2
1032,791959,9,1,3,1,2,0,1,0,0,0,1,1,2,0,1,0,2
1032,781334,2,0,0,0,0,0,0,0,0,0,1,1,0,0,0,0,0
1033,781125,26,4,12,4,12,0,0,0,2,1,5,0,1,1,2,1,8
1033,780440,29,3,8,1,5,2,3,0,1,3,4,1,2,0,2,0,8
1033,786431,22,0,7,0,5,0,2,2,2,1,2,1,1,0,4,0,2
1033,791621,30,1,12,0,9,1,3,0,0,0,3,2,2,1,1,0,3
1033,775620,20,4,5,4,5,0,0,0,1,3,1,0,2,1,2,2,8
1033,791620,17,2,8,0,2,2,6,3,3,2,3,0,1,0,0,0,9
1033,791619,8,0,0,0,0,0,0,0,0,0,1,0,0,0,0,0,0
1033,786432,7,0,1,0,0,0,1,0,0,0,0,1,0,0,0,0,0
1033,786434,10,1,4,1,4,0,0,0,0,1,1,0,1,0,2,1,2
1033,781088,25,3,8,2,4,1,4,0,0,2,3,2,3,1,1,0,7
1033,775622,4,0,1,0,0,0,1,0,0,0,0,0,0,0,0,0,0
1033,796976,2,0,0,0,0,0,0,0,0,0,0,0,1,0,0,0,0
1034,790837,29,4,6,4,4,0,2,1,1,1,6,5,4,3,1,0,9
1034,780025,34,6,8,6,8,0,0,8,8,2,3,1,3,1,3,1,20
1034,786228,29,1,4,1,1,0,3,1,1,0,3,0,1,2,2,1,3
1034,785385,12,0,5,0,0,0,5,2,4,0,3,1,0,1,1,0,2
1034,785383,38,9,14,9,11,0,3,10,12,0,8,1,0,2,2,0,28
1034,785384,13,1,2,1,2,0,0,0,0,0,2,0,4,0,1,3,2
1034,781046,15,1,5,1,5,0,0,0,0,1,1,1,3,0,0,0,2
1034,796391,15,3,4,3,4,0,0,2,3,0,1,0,1,0,0,1,8
1034,792180,6,1,1,0,0,1,1,0,0,0,1,0,0,1,3,0,3
1034,785382,6,0,1,0,0,0,1,0,0,0,0,0,1,0,0,0,0
1034,786297,3,1,2,1,2,0,0,0,0,2,0,0,0,0,0,0,2
1035,796959,36,4,7,3,6,1,1,1,1,0,0,0,4,0,2,1,10
1035,781272,33,6,10,5,8,1,2,2,5,1,7,3,4,1,5,0,15
1035,791261,30,4,11,3,7,1,4,3,4,0,2,0,1,1,2,0,12
1035,791258,36,2,7,2,5,0,2,1,2,1,2,0,3,4,1,0,5
1035,781270,39,5,16,4,9,1,7,2,2,0,4,4,2,3,2,0,13
1035,796960,9,0,1,0,1,0,0,4,4,3,1,0,2,0,1,1,4
1035,791260,2,0,1,0,0,0,1,0,0,0,0,0,2,0,0,0,0
1035,796958,15,3,4,2,2,1,2,1,2,0,2,0,2,1,1,0,8
1036,791917,25,6,8,3,4,3,4,4,4,0,5,2,3,1,0,0,19
1036,786526,27,6,10,6,10,0,0,0,1,0,8,3,2,2,0,0,12
1036,786525,26,4,5,1,2,3,3,5,6,2,0,1,0,0,0,0,16
1036,791914,22,3,5,2,3,1,2,2,2,0,2,7,2,1,2,0,9
1036,786030,20,5,17,4,10,1,7,9,10,3,5,4,2,1,1,0,20
1036,786856,10,2,5,2,5,0,0,4,6,4,2,2,2,0,1,0,8
1036,781109,23,2,3,2,3,0,0,2,3,2,10,2,3,0,1,1,6
1036,786524,17,1,3,0,2,1,1,0,0,0,2,4,0,1,1,0,3
1036,797550,21,6,12,4,5,2,7,0,3,1,3,2,0,0,0,0,14
1036,797551,3,1,1,1,1,0,0,0,0,0,1,0,1,0,1,0,2
1036,797552,3,0,0,0,0,0,0,2,2,1,0,1,0,0,0,0,2
1036,791918,1,0,0,0,0,0,0,0,0,0,1,0,0,0,2,0,0
1036,791919,1,0,1,0,1,0,0,0,0,0,1,0,0,0,0,0,0
1036,791920,1,0,0,0,0,0,0,0,0,0,0,0,0,0,0,0,0
1037,796774,14,2,3,2,3,0,0,0,0,0,4,0,3,1,0,0,4
1037,796776,22,1,6,1,4,0,2,2,2,0,2,0,3,0,0,0,4
1037,792698,33,6,13,3,4,3,9,0,0,0,2,6,2,1,5,0,15
1037,792699,19,0,4,0,1,0,3,2,4,1,2,1,4,0,2,0,2
1037,792701,31,4,11,1,5,3,6,0,0,0,2,5,3,2,0,0,11
1037,796772,32,6,17,4,10,2,7,4,6,0,4,3,2,1,0,0,18
1037,792702,20,3,9,2,3,1,6,0,0,0,1,0,4,0,1,0,7
1037,792695,9,1,1,1,1,0,0,0,0,0,3,1,2,0,4,0,2
1037,792704,20,1,2,1,1,0,1,1,1,1,1,0,1,1,1,0,3
1038,781666,35,3,12,1,5,2,7,0,0,2,5,1,4,0,4,0,8
1038,786575,31,6,6,6,6,0,0,5,5,7,4,1,1,0,2,2,17
1038,792338,37,6,17,6,14,0,3,2,3,2,8,7,3,0,4,2,14
1038,792334,29,8,11,7,8,1,3,0,2,3,8,2,2,0,2,0,17
1038,798094,29,5,10,3,3,2,7,2,2,0,3,2,3,1,3,0,14
1038,791636,14,3,7,3,5,0,2,0,0,0,2,0,0,2,0,0,6
1038,798100,9,1,2,1,2,0,0,1,2,0,3,1,0,1,1,0,3
1038,785531,11,1,5,0,1,1,4,2,2,1,0,0,0,0,1,1,5
1038,798095,3,0,0,0,0,0,0,0,0,0,0,0,1,0,0,0,0
1038,798097,2,0,0,0,0,0,0,0,0,0,1,0,1,0,0,0,0
1040,780625,23,0,5,0,1,0,4,0,0,0,1,5,0,0,0,0,0
1040,797394,21,2,8,2,7,0,1,0,2,1,3,0,1,0,2,2,4
1040,780631,26,3,6,1,3,2,3,0,0,0,4,0,1,0,0,0,8
1040,786625,27,5,8,3,4,2,4,0,0,0,1,3,0,1,0,0,12
1040,791827,24,8,15,8,14,0,1,2,2,2,5,1,1,1,0,0,18
1040,797391,12,1,3,0,0,1,3,0,1,0,0,1,0,0,1,1,3
1040,797395,20,3,13,3,11,0,2,0,0,0,0,6,0,5,1,0,6
1040,786630,21,3,4,3,3,0,1,1,1,3,2,1,3,1,1,0,7
1040,791830,18,4,5,4,5,0,0,5,6,3,5,0,2,1,2,3,13
1040,797397,8,2,2,2,2,0,0,0,0,1,1,0,5,0,3,1,4
1042,776286,39,2,5,2,4,0,1,1,3,3,2,2,4,4,1,2,5
1042,775557,14,2,4,2,4,0,0,0,0,2,3,0,5,2,0,1,4
1042,797010,35,4,12,3,4,1,8,9,12,0,4,1,1,2,0,1,18
1042,785357,39,4,12,3,8,1,4,14,15,3,4,3,3,2,2,0,23
1042,775560,25,4,9,3,7,1,2,2,2,3,5,3,5,0,2,1,11
1042,785287,6,0,2,0,2,0,0,0,0,0,0,0,2,0,1,0,0
1042,791444,14,2,3,2,3,0,0,3,4,1,3,0,3,0,0,2,7
1042,797012,25,3,7,2,4,1,3,2,2,0,1,1,2,1,3,1,9
1042,785895,3,0,1,0,0,0,1,0,0,0,0,0,0,0,0,0,0
1043,785458,16,5,7,5,6,0,1,0,0,1,1,0,4,0,1,0,10
1043,785457,12,1,2,1,2,0,0,0,0,0,1,0,2,0,1,0,2
1043,780798,27,4,6,1,3,3,3,2,2,0,3,0,4,0,0,0,13
1043,785455,25,3,9,2,5,1,4,3,7,0,1,3,3,2,5,0,10
1043,785453,29,2,10,2,5,0,5,1,3,1,3,3,0,0,1,0,5
1043,790914,25,1,4,1,4,0,0,3,6,2,3,1,3,0,3,0,5
1043,790915,17,3,5,3,4,0,1,2,4,1,3,0,1,0,1,1,8
1043,790913,17,1,1,1,1,0,0,4,4,3,4,3,3,0,4,0,6
1043,785454,20,2,3,0,1,2,2,2,2,0,1,2,4,0,2,0,8
1043,774940,10,0,3,0,2,0,1,0,1,0,2,1,2,0,1,1,0
1043,790911,2,0,0,0,0,0,0,0,0,0,0,0,0,0,0,0,0
1044,792181,30,4,7,3,5,1,2,2,3,1,6,3,1,1,1,0,11
1044,780986,24,2,4,2,4,0,0,0,0,1,4,3,3,0,2,3,4
1044,797796,31,2,5,1,2,1,3,2,3,1,6,6,3,3,3,1,7
1044,785902,30,8,11,4,5,4,6,3,3,0,4,5,3,2,1,0,23
1044,792179,32,6,13,0,1,6,12,3,4,0,2,5,0,0,5,1,21
1044,797794,22,3,5,0,1,3,4,0,0,1,7,1,1,0,2,0,9
1044,792176,7,1,1,1,1,0,0,0,0,0,0,1,0,0,1,0,2
1044,792177,6,0,0,0,0,0,0,0,0,0,1,0,1,0,0,0,0
1044,786661,9,1,4,1,1,0,3,2,2,0,2,0,2,0,0,0,4
1044,797788,9,1,1,1,1,0,0,4,5,1,1,0,2,1,1,1,6
1045,785920,38,7,19,4,13,3,6,3,4,1,5,6,2,3,4,0,20
1045,786623,27,1,4,1,4,0,0,3,4,3,5,1,3,0,4,0,5
1045,786624,15,0,1,0,1,0,0,0,0,0,2,0,2,1,2,0,0
1045,791833,26,3,8,2,5,1,3,2,2,1,2,2,3,0,1,0,9
1045,785698,25,3,10,1,3,2,7,0,0,0,2,1,1,2,1,0,8
1045,797413,17,0,1,0,0,0,1,0,0,0,1,0,5,0,1,0,0
1045,791834,26,3,9,2,3,1,6,1,1,0,0,1,3,2,1,0,8
1045,784077,15,0,3,0,2,0,1,0,0,1,0,2,1,0,0,0,0
1045,797404,10,0,3,0,0,0,3,2,4,1,0,0,0,0,0,0,2
1045,797410,1,0,0,0,0,0,0,0,0,0,0,0,0,0,0,0,0
1046,785436,33,7,8,7,8,0,0,2,3,3,4,3,1,0,2,0,16
1046,796436,35,6,13,3,8,3,5,3,3,0,4,8,2,2,3,1,18
1046,790885,19,3,6,1,3,2,3,0,0,2,3,2,1,0,1,0,8
1046,790884,22,5,5,5,5,0,0,3,6,3,4,2,1,4,5,0,13
1046,781262,20,5,10,3,3,2,7,0,0,0,2,1,1,1,0,0,12
1046,796439,14,2,3,2,3,0,0,0,0,2,1,0,2,0,1,1,4
1046,796438,23,1,5,0,1,1,4,0,0,1,4,2,0,1,3,1,3
1046,791635,21,3,8,1,2,2,6,2,2,0,1,2,0,0,1,1,10
1046,796437,8,0,3,0,2,0,1,0,0,0,0,0,3,1,0,0,0
1046,796442,5,0,0,0,0,0,0,0,0,1,1,2,1,0,1,0,0
1047,785688,37,10,22,0,2,10,20,2,5,1,2,2,1,2,1,0,32
1047,797529,30,3,5,3,4,0,1,2,2,2,3,0,2,1,3,0,8
1047,797527,14,0,2,0,2,0,0,0,2,1,1,1,4,2,1,0,0
1047,797532,37,4,16,1,10,3,6,2,2,0,4,8,1,2,4,0,13
1047,791936,34,3,5,3,5,0,0,0,2,4,4,2,2,1,7,0,6
1047,785988,22,2,7,0,1,2,6,0,0,1,1,0,1,1,0,0,6
1047,791933,19,1,3,0,0,1,3,0,0,1,1,1,1,1,1,0,3
1047,791932,5,1,1,0,0,1,1,0,0,0,0,1,1,0,0,0,3
1047,797530,2,0,1,0,1,0,0,0,0,0,0,0,0,0,0,0,0
1048,791440,26,4,4,4,4,0,0,4,6,2,4,0,4,1,6,0,12
1048,797019,14,1,4,1,2,0,2,0,0,0,1,1,0,0,1,0,2
1048,781378,12,2,3,2,2,0,1,0,0,0,3,0,0,1,3,0,4
1048,774959,16,1,6,1,3,0,3,2,2,0,3,1,1,0,0,0,4
1048,775267,16,1,2,0,1,1,1,0,0,0,1,1,1,0,2,0,3
1048,791443,31,2,5,2,3,0,2,0,0,1,5,0,3,0,1,1,4
1048,781629,18,4,6,3,5,1,1,1,4,0,3,2,1,1,0,2,10
1048,775739,12,0,0,0,0,0,0,0,0,0,2,0,2,0,3,0,0
1048,797015,3,0,1,0,0,0,1,0,0,0,1,0,0,0,1,0,0
1048,797013,24,7,13,6,8,1,5,0,0,0,1,2,2,1,3,0,15
1048,797016,13,3,7,1,3,2,4,0,0,0,1,3,1,1,0,0,8
1048,791441,15,1,1,1,1,0,0,0,1,1,4,3,4,0,2,0,2
1049,791839,24,5,8,5,7,0,1,0,1,1,3,3,4,2,2,0,10
1049,786736,26,5,6,4,4,1,2,0,0,0,3,5,0,3,1,0,11
1049,792381,29,4,11,2,2,2,9,0,1,0,1,7,2,1,1,0,10
1049,786616,27,2,10,1,7,1,3,4,4,0,2,0,2,1,1,0,9
1049,776341,23,1,4,1,3,0,1,0,0,4,2,3,2,0,1,2,2
1049,791840,1,0,0,0,0,0,0,0,0,0,0,0,1,0,0,0,0
1049,797444,6,1,1,1,1,0,0,2,3,0,2,0,0,1,0,0,4
1049,785322,15,1,5,0,0,1,5,0,0,1,0,0,2,0,0,0,3
1049,797442,6,0,2,0,0,0,2,0,0,0,2,0,0,0,1,0,0
1049,791842,27,9,14,2,2,7,12,2,3,0,2,1,1,1,1,0,27
1049,786613,16,3,4,1,1,2,3,2,2,1,4,2,1,0,1,0,10
1050,780095,18,0,2,0,2,0,0,0,0,4,3,2,1,4,2,0,0
1050,776321,35,13,19,13,18,0,1,0,0,3,10,1,2,1,3,2,26
1050,797918,28,0,2,0,2,0,0,0,0,0,0,1,1,0,1,0,0
1050,786081,36,4,10,3,8,1,2,0,0,0,3,3,1,0,2,0,9
1050,780232,39,8,15,3,7,5,8,13,13,1,4,11,1,4,2,1,34
1050,797917,1,2,2,2,2,0,0,0,0,0,0,0,0,0,0,0,4
1050,786020,9,1,2,1,2,0,0,0,0,0,5,0,1,0,2,0,2
1050,785356,16,2,7,0,0,2,7,0,0,0,0,1,0,0,0,0,6
1050,781328,1,0,0,0,0,0,0,0,0,0,0,0,0,0,0,1,0
1050,789019,16,1,6,0,1,1,5,0,0,1,2,3,0,0,0,0,3
1050,797911,1,0,0,0,0,0,0,0,0,0,0,1,0,0,0,0,0
1052,781579,33,1,5,1,4,0,1,4,4,6,7,0,2,2,1,1,6
1052,786731,39,7,18,7,17,0,1,4,9,3,5,4,4,4,1,0,18
1052,798023,37,4,14,4,11,0,3,7,8,1,4,5,3,0,2,1,15
1052,781584,21,1,4,0,1,1,3,0,0,0,3,0,2,0,2,0,3
1052,780347,36,6,12,6,10,0,2,5,8,1,6,0,4,1,3,0,17
1052,792358,18,1,5,1,3,0,2,0,0,0,0,0,3,1,1,0,2
1052,775696,7,0,0,0,0,0,0,0,0,0,1,1,1,0,0,0,0
1052,776481,1,0,0,0,0,0,0,0,0,0,0,0,1,0,1,0,0
1052,798008,8,1,1,0,0,1,1,0,0,0,1,0,1,0,2,0,3
1053,779857,30,3,11,2,5,1,6,1,2,1,1,2,3,0,3,4,8
1053,796674,26,3,8,0,4,3,4,2,2,0,6,1,4,1,1,0,11
1053,785339,33,3,10,2,5,1,5,0,0,1,2,2,4,0,2,0,7
1053,779976,34,6,8,4,5,2,3,9,11,0,5,2,1,2,1,0,23
1053,774990,28,3,8,3,6,0,2,0,0,0,5,2,1,0,3,0,6
1053,791014,8,0,0,0,0,0,0,0,0,0,0,0,2,0,0,0,0
1053,796673,13,0,5,0,4,0,1,0,0,0,5,0,3,0,1,0,0
1053,785126,2,1,1,1,1,0,0,2,2,1,0,0,0,0,1,0,4
1053,785961,18,3,4,2,3,1,1,0,0,1,1,1,2,0,2,0,7
1053,781586,8,0,0,0,0,0,0,1,2,1,2,2,4,0,0,0,1
1064,776418,16,9,9,9,9,0,0,1,5,3,3,0,1,0,1,3,19
1064,785505,27,6,10,5,8,1,2,3,5,0,0,8,2,3,2,0,16
1064,780797,26,2,6,1,2,1,4,4,4,3,10,5,1,2,0,0,9
1064,775604,26,3,9,1,3,2,6,0,0,0,1,2,1,1,2,0,8
1064,780555,24,3,5,1,2,2,3,0,0,0,3,1,0,1,0,0,8
1064,796981,16,7,10,7,9,0,1,2,2,0,2,2,0,2,1,0,16
1064,796984,16,2,2,1,1,1,1,0,0,0,4,1,3,1,2,0,5
1064,791616,16,1,2,0,1,1,1,1,2,0,0,0,1,1,2,0,4
1064,786429,4,1,1,0,0,1,1,0,0,0,1,0,0,0,0,0,3
1064,796986,10,0,3,0,1,0,2,0,0,0,2,0,0,0,0,0,0
1064,796983,5,0,0,0,0,0,0,0,0,0,0,0,1,0,1,0,0
1064,780432,4,0,0,0,0,0,0,0,0,0,0,1,0,1,0,0,0
1064,791617,4,0,1,0,1,0,0,0,0,0,0,0,0,0,0,0,0
1064,796982,2,0,1,0,1,0,0,0,0,0,0,0,0,0,0,0,0
1064,786430,2,0,1,0,1,0,0,0,0,0,0,0,0,0,0,0,0
1064,796985,2,0,1,0,1,0,0,0,0,0,0,1,0,0,0,1,0
1066,792250,24,5,11,3,6,2,5,1,2,2,1,6,3,2,0,0,13
1066,781445,24,4,8,0,0,4,8,0,0,0,3,0,3,2,2,0,12
1066,792248,23,4,8,1,2,3,6,0,0,0,4,4,1,0,1,0,11
1066,792253,10,3,5,3,5,0,0,2,3,1,6,1,2,0,1,1,8
1066,781430,5,1,3,0,1,1,2,0,0,0,0,1,1,1,1,0,3
1066,792251,19,5,7,3,3,2,4,0,0,0,4,1,1,3,1,0,12
1066,797941,19,4,8,3,5,1,3,2,3,1,2,2,2,5,0,0,11
1066,792249,22,1,3,0,2,1,1,4,6,1,7,3,1,1,4,2,7
1066,797957,11,3,7,3,7,0,0,1,2,1,1,0,3,0,0,2,7
1066,786076,20,2,3,2,3,0,0,2,2,1,1,5,2,3,0,0,6
1066,797944,9,2,4,0,0,2,4,0,0,0,3,0,1,0,0,0,6
1066,781448,7,2,2,2,2,0,0,0,0,0,2,1,1,0,0,0,4
1066,786072,7,0,2,0,0,0,2,0,0,0,0,2,1,0,1,0,0
1068,786091,29,5,11,3,6,2,5,4,4,4,5,0,3,2,2,1,16
1068,775738,28,4,8,4,4,0,4,0,0,0,5,0,2,1,2,2,8
1068,786728,33,2,5,2,4,0,1,0,0,2,4,4,3,1,2,0,4
1068,785904,37,6,16,4,6,2,10,5,6,1,0,3,0,0,2,0,19
1068,780892,37,6,12,2,4,4,8,3,4,1,7,2,2,3,1,0,19
1068,797666,11,1,2,0,0,1,2,1,2,1,2,2,0,2,1,0,4
1068,786788,2,0,0,0,0,0,0,0,0,0,0,0,0,0,0,0,0
1068,786096,23,2,6,1,3,1,3,0,0,1,0,2,3,0,1,1,5
1069,797281,23,3,7,2,4,1,3,0,0,0,3,2,2,1,2,0,7
1069,791648,35,9,14,7,11,2,3,1,2,1,3,2,2,1,3,0,21
1069,786195,30,6,13,6,13,0,0,1,2,0,7,1,3,0,1,1,13
1069,791649,30,2,5,0,1,2,4,0,0,0,2,2,3,2,2,0,6
1069,797280,34,0,0,0,0,0,0,6,6,0,2,3,3,0,1,0,6
1069,785694,10,0,2,0,2,0,0,2,2,0,1,0,2,0,0,0,2
1069,786640,27,7,9,4,6,3,3,2,3,0,3,6,0,0,4,0,19
1069,785697,11,0,3,0,2,0,1,0,0,1,1,1,1,0,0,0,0
1070,786746,26,2,4,0,1,2,3,0,0,0,3,3,1,1,0,1,6
1070,775075,24,2,5,2,5,0,0,1,1,3,2,1,1,2,1,3,5
1070,780178,14,4,6,4,6,0,0,0,0,0,1,1,3,2,0,1,8
1070,797883,25,1,5,1,4,0,1,0,0,1,4,5,0,2,1,0,2
1070,792376,28,5,12,1,4,4,8,0,0,0,3,3,2,2,4,0,14
1070,797885,12,1,5,1,3,0,2,0,0,2,2,0,1,0,1,0,2
1070,797890,17,2,3,1,1,1,2,0,0,0,0,0,0,1,0,0,5
1070,792374,18,1,4,1,3,0,1,4,4,0,0,2,0,4,2,0,6
1070,792378,18,3,7,3,7,0,0,0,0,1,4,1,2,2,1,2,6
1070,797888,13,3,6,3,5,0,1,0,0,0,2,0,1,1,2,1,6
1070,785744,3,0,0,0,0,0,0,0,0,0,0,0,2,0,0,0,0
1070,792375,2,0,1,0,1,0,0,0,0,0,0,0,0,0,0,0,0
1071,785809,28,2,7,1,4,1,3,1,2,0,4,1,1,1,1,1,6
1071,780530,30,3,10,3,9,0,1,1,2,2,4,1,2,2,1,1,7
1071,785740,23,1,2,1,2,0,0,1,2,0,0,0,0,0,3,1,3
1071,785738,30,2,7,2,6,0,1,2,2,0,2,2,0,2,4,0,6
1071,797402,30,1,5,1,2,0,3,0,0,1,4,1,2,1,1,0,2
1071,797396,8,1,2,1,1,0,1,0,0,0,1,0,0,1,1,0,2
1071,797399,28,5,7,2,2,3,5,1,2,1,1,1,1,0,6,2,14
1071,785739,16,1,3,1,3,0,0,0,0,1,5,0,0,0,2,0,2
1071,791664,4,0,1,0,1,0,0,0,0,0,0,0,0,0,1,0,0
1071,797400,2,0,0,0,0,0,0,0,0,0,0,1,0,0,0,0,0
1071,780526,1,0,0,0,0,0,0,0,0,0,0,0,0,0,0,0,0
1072,791337,24,4,9,4,9,0,0,7,10,5,2,0,0,4,1,2,15
1072,797877,31,10,15,10,15,0,0,1,2,1,5,1,1,0,0,2,21
1072,797872,30,0,4,0,3,0,1,3,4,0,1,5,0,2,0,0,3
1072,797874,24,1,3,0,0,1,3,0,0,0,2,3,3,1,1,0,3
1072,791339,30,8,18,7,14,1,4,6,8,3,3,3,3,0,1,0,23
1072,797873,4,1,3,1,3,0,0,0,0,0,0,0,0,0,0,0,2
1072,791335,9,0,2,0,2,0,0,4,6,1,2,0,2,0,0,0,4
1072,781599,12,2,2,2,2,0,0,0,1,1,2,0,3,0,0,1,4
1072,797875,13,3,6,2,4,1,2,1,2,0,1,2,0,1,1,0,8
1072,791338,17,1,1,1,1,0,0,0,0,0,3,4,0,0,0,0,2
1072,781595,5,0,1,0,0,0,1,0,0,0,0,0,0,0,1,0,0
1072,785882,1,0,1,0,0,0,1,0,0,0,0,0,0,0,0,0,0
1073,797616,18,3,5,3,5,0,0,1,2,1,4,1,4,0,4,0,7
1073,791882,33,7,12,6,11,1,1,3,4,4,8,2,3,0,2,1,18
1073,786491,32,3,7,3,5,0,2,4,4,2,4,4,3,1,0,3,10
1073,791881,32,5,7,3,4,2,3,0,1,0,2,5,1,0,1,1,12
1073,786420,30,5,14,3,6,2,8,0,0,1,0,4,3,0,2,0,12
1073,797618,12,2,3,2,3,0,0,2,3,1,1,1,2,0,1,1,6
1073,797617,2,0,0,0,0,0,0,0,0,0,0,0,0,0,0,0,0
1073,797614,2,0,0,0,0,0,0,0,0,0,0,1,0,0,0,0,0
1073,797613,13,2,8,0,1,2,7,0,0,0,2,0,2,0,1,0,6
1073,781258,9,0,0,0,0,0,0,0,0,1,1,1,1,0,3,0,0
1073,781052,17,1,4,0,0,1,4,0,0,0,4,0,1,0,2,0,3
1074,791299,28,5,9,5,9,0,0,5,6,5,11,1,3,0,2,0,15
1074,791296,38,4,10,4,5,0,5,6,6,0,13,2,2,1,0,1,14
1074,775871,31,8,10,8,10,0,0,3,3,1,10,0,1,0,4,0,19
1074,791298,32,3,11,2,9,1,2,2,3,1,1,2,0,6,4,1,9
1074,791519,34,9,15,9,13,0,2,2,6,1,7,9,3,1,7,0,20
1074,786276,8,2,4,0,1,2,3,0,0,0,1,0,0,0,0,0,6
1074,796593,12,0,2,0,2,0,0,0,0,1,2,1,3,0,3,0,0
1074,780529,1,0,0,0,0,0,0,0,0,0,0,0,0,0,0,0,0
1074,781390,16,1,2,1,1,0,1,0,0,0,1,0,0,0,0,0,2
1075,791161,35,4,11,2,5,2,6,0,0,1,4,3,5,0,2,3,10
1075,780629,16,3,9,3,8,0,1,0,0,1,1,1,2,0,1,0,6
1075,796816,13,0,2,0,1,0,1,1,2,0,3,0,2,1,3,0,1
1075,774845,38,4,14,2,6,2,8,0,2,1,7,3,4,4,4,0,10
1075,775888,34,8,17,7,15,1,2,5,6,4,4,1,0,2,1,0,22
1075,796817,26,4,10,0,2,4,8,2,2,0,3,1,3,1,0,0,14
1075,796815,5,0,2,0,1,0,1,0,0,0,0,1,0,1,1,0,0
1075,792111,4,0,2,0,0,0,2,0,0,0,0,0,1,0,0,0,0
1075,785346,29,2,11,0,0,2,11,0,0,1,1,3,2,0,1,0,6
1076,786289,35,4,10,3,7,1,3,0,1,0,3,2,0,0,0,0,9
1076,796332,24,1,4,1,3,0,1,3,4,3,3,5,3,2,1,1,5
1076,785813,34,6,16,3,9,3,7,0,0,0,1,3,1,2,2,0,15
1076,785827,18,3,5,3,5,0,0,0,0,1,2,0,5,0,5,1,6
1076,790776,9,1,2,1,2,0,0,0,0,3,2,0,3,1,2,0,2
1076,796330,13,2,5,1,2,1,3,1,2,0,4,1,0,0,0,0,6
1076,796334,23,5,12,5,11,0,1,3,6,4,5,0,1,2,2,0,13
1076,779975,20,2,5,2,5,0,0,3,3,4,4,0,4,0,3,2,7
1076,796337,24,3,6,3,6,0,0,1,2,0,6,3,2,1,1,0,7
1077,785529,37,5,11,2,4,3,7,0,0,0,0,4,1,0,5,0,13
1077,776205,27,3,11,3,6,0,5,0,1,0,2,3,2,1,4,1,6
1077,781237,32,1,3,0,0,1,3,2,2,0,2,4,2,0,1,0,5
1077,781243,31,1,8,0,1,1,7,3,3,0,5,0,5,3,2,2,6
1077,781244,18,4,7,3,4,1,3,4,4,0,5,0,5,0,4,0,13
1077,791241,30,4,10,2,6,2,4,0,0,0,2,0,3,1,0,0,10
1077,791245,23,5,7,3,4,2,3,2,2,1,4,2,2,0,2,0,14
1077,785537,2,0,0,0,0,0,0,0,0,0,0,0,0,0,0,0,0
1078,780552,32,8,14,2,4,6,10,2,3,1,5,1,1,2,1,1,24
1078,775606,25,7,8,7,8,0,0,1,3,1,4,1,1,0,3,3,15
1078,791674,32,2,7,1,3,1,4,4,6,0,2,6,2,3,5,0,9
1078,791672,24,4,6,4,6,0,0,1,1,2,4,1,3,0,2,1,9
1078,780550,18,1,2,1,2,0,0,0,0,2,3,1,3,0,4,1,2
1078,797424,13,2,4,2,4,0,0,2,7,1,3,0,2,0,0,0,6
1078,780538,22,2,7,1,3,1,4,0,0,1,2,5,4,3,1,0,5
1078,785791,3,1,2,0,0,1,2,0,0,0,0,0,0,0,0,0,3
1078,785793,19,1,3,1,2,0,1,0,0,2,0,2,0,1,0,1,2
1078,797423,9,1,2,1,2,0,0,0,0,1,2,0,2,0,2,0,2
1078,785790,3,0,1,0,0,0,1,0,0,0,1,0,0,0,0,0,0
1079,798968,27,6,10,4,6,2,4,1,4,1,0,3,2,0,1,0,15
1079,798963,31,5,8,5,8,0,0,2,2,0,2,6,3,3,6,1,12
1079,798965,17,3,5,2,3,1,2,0,0,0,7,0,3,0,1,1,7
1079,787996,18,3,7,3,6,0,1,0,0,1,1,1,2,2,2,0,6
1079,791718,18,0,9,0,5,0,4,0,0,0,3,2,2,0,1,0,0
1079,791719,21,2,8,2,5,0,3,2,2,3,1,0,1,0,1,0,6
1079,791717,24,1,2,1,1,0,1,1,2,1,4,1,4,1,1,0,3
1079,798966,12,1,2,1,2,0,0,0,0,2,0,0,1,0,1,1,2
1079,791720,5,1,2,1,2,0,0,0,0,1,2,0,1,0,0,0,2
1079,798964,5,1,2,1,2,0,0,0,0,0,0,0,1,0,0,0,2
1079,768880,18,0,4,0,1,0,3,1,2,0,1,1,1,0,2,0,1
1079,798967,4,0,3,0,1,0,2,0,0,0,1,0,0,0,1,0,0
1080,785670,26,4,8,3,4,1,4,1,1,0,2,5,2,1,1,1,10
1080,774969,28,3,6,3,6,0,0,1,2,2,9,4,2,0,3,1,7
1080,791181,23,1,3,0,0,1,3,0,0,1,2,4,1,0,1,0,3
1080,781054,36,3,10,0,3,3,7,3,5,0,1,2,1,0,1,1,12
1080,781053,37,7,11,2,3,5,8,2,2,0,10,1,1,0,8,1,21
1080,796850,22,3,7,3,7,0,0,0,1,1,1,5,0,1,1,1,6
1080,796848,5,0,1,0,0,0,1,0,0,0,0,2,0,1,2,0,0
1080,791179,23,7,10,1,2,6,8,0,0,0,6,0,2,1,0,0,20
1082,775897,23,2,5,2,4,0,1,0,0,3,6,2,2,0,1,0,4
1082,780324,21,4,6,4,6,0,0,0,0,0,3,0,0,0,1,3,8
1082,786530,27,3,3,2,2,1,1,2,2,0,3,5,1,0,0,0,9
1082,784246,22,6,10,3,4,3,6,2,6,0,2,2,0,1,1,0,17
1082,780317,21,3,4,1,1,2,3,2,2,0,3,2,2,1,3,0,10
1082,791546,15,3,5,2,2,1,3,0,0,1,2,0,1,0,2,0,7
1082,786362,4,0,1,0,0,0,1,0,0,0,1,0,0,0,0,0,0
1082,791543,13,0,1,0,0,0,1,1,2,1,2,4,1,0,2,0,1
1082,797091,20,2,7,2,4,0,3,4,7,0,1,0,2,0,1,0,8
1082,791547,10,0,1,0,0,0,1,1,2,0,0,0,4,0,1,1,1
1082,791545,10,1,3,1,3,0,0,0,0,0,2,2,1,1,0,0,2
1082,786360,14,3,5,0,0,3,5,0,0,0,6,1,0,0,0,0,9
1084,792473,29,0,2,0,1,0,1,0,2,0,1,0,3,1,4,2,0
1084,780043,35,5,7,2,3,3,4,2,2,1,4,5,0,2,4,1,15
1084,799276,39,2,5,0,0,2,5,2,2,0,7,3,2,1,2,0,8
1084,785249,25,2,7,2,4,0,3,0,0,0,3,2,4,1,1,0,4
1084,780035,35,8,12,5,7,3,5,4,5,0,5,3,3,2,2,1,23
1084,785251,5,0,1,0,0,0,1,0,0,0,1,0,1,0,0,0,0
1084,792477,8,1,1,1,1,0,0,0,0,0,1,1,0,0,1,0,2
1084,780036,24,3,6,2,4,1,2,0,0,0,5,2,3,2,1,0,7
1085,780201,39,1,7,1,7,0,0,8,10,3,6,0,1,2,1,0,10
1085,791469,38,0,2,0,2,0,0,1,2,1,3,0,3,0,0,3,1
1085,797208,24,5,10,5,10,0,0,0,0,0,3,0,3,3,3,0,10
1085,791467,21,4,13,4,11,0,2,0,0,0,1,0,2,0,3,0,8
1085,775516,38,2,6,1,3,1,3,0,1,0,6,1,2,2,2,0,5
1085,798344,14,2,5,2,5,0,0,1,2,1,2,0,1,1,1,0,5
1085,797210,23,2,6,2,6,0,0,1,1,0,0,2,3,1,2,0,5
1085,791471,3,0,1,0,0,0,1,0,0,0,0,0,0,0,0,0,0
1086,792227,29,3,6,2,2,1,4,1,4,1,9,1,1,0,0,4,8
1086,781352,22,3,7,3,7,0,0,2,2,1,1,0,1,0,1,1,8
1086,785935,35,4,8,4,8,0,0,2,2,0,2,5,2,0,5,1,10
1086,781340,33,6,10,4,7,2,3,1,2,2,3,1,2,1,1,0,15
1086,776128,32,4,10,2,5,2,5,2,2,0,3,7,2,2,0,0,12
1086,797881,15,5,7,5,7,0,0,0,0,2,2,0,1,1,0,0,10
1086,797889,3,1,3,1,3,0,0,0,0,0,1,0,1,0,1,0,2
1086,781351,11,0,2,0,2,0,0,2,2,1,3,1,2,0,1,0,2
1086,792223,15,2,4,1,2,1,2,0,0,0,0,1,0,0,0,1,5
1086,792228,5,0,1,0,0,0,1,0,2,1,0,0,0,0,0,0,0
1087,791403,31,6,7,6,6,0,1,2,2,0,10,2,2,0,2,2,14
1087,791404,32,3,8,1,2,2,6,0,0,1,3,3,4,0,2,0,8
1087,791407,37,6,20,3,11,3,9,1,2,4,2,2,1,1,2,0,16
1087,785928,29,1,5,0,3,1,2,2,3,1,2,3,5,0,1,0,5
1087,785923,25,4,6,3,5,1,1,2,3,0,1,1,2,1,0,0,11
1087,797111,8,0,0,0,0,0,0,0,0,0,2,0,0,0,0,0,0
1087,797109,12,1,2,0,0,1,2,0,0,0,0,0,3,0,1,0,3
1087,797114,26,3,8,2,5,1,3,0,0,0,2,2,3,1,4,0,7
1088,790810,33,5,15,4,10,1,5,3,3,4,11,1,2,0,1,0,14
1088,785362,13,3,8,3,8,0,0,1,2,1,1,0,3,0,0,1,7
1088,790808,27,2,6,1,4,1,2,4,4,2,4,0,3,0,3,1,9
1088,785361,35,5,11,3,4,2,7,1,4,1,2,3,1,2,1,1,13
1088,779997,37,2,9,2,9,0,0,2,2,1,4,4,2,1,1,0,6
1088,796370,15,1,2,1,2,0,0,0,0,0,0,0,2,0,1,0,2
1088,774854,3,2,2,2,2,0,0,0,0,2,1,0,1,0,1,0,4
1088,790809,10,0,2,0,2,0,0,0,0,1,0,0,1,1,1,0,0
1088,790811,5,1,1,1,1,0,0,0,0,0,0,0,0,0,1,0,2
1088,796368,22,3,6,3,5,0,1,2,4,4,4,0,1,2,1,2,8
1089,781044,24,3,10,2,7,1,3,4,4,1,2,2,5,2,1,1,11
1089,791795,26,1,2,0,0,1,2,2,2,1,3,1,2,0,2,0,5
1089,786489,29,3,10,2,5,1,5,0,0,1,4,0,3,0,3,0,7
1089,786488,32,3,9,2,7,1,2,0,2,0,6,1,0,0,5,0,7
1089,781038,31,4,7,3,6,1,1,5,5,2,4,0,2,1,1,0,14
1089,791796,2,0,1,0,1,0,0,0,0,0,0,0,0,1,0,0,0
1089,797621,8,1,1,1,1,0,0,0,0,0,0,0,1,1,0,0,2
1089,797619,18,2,5,2,4,0,1,2,4,1,2,0,2,1,0,0,6
1089,786487,14,2,4,1,1,1,3,0,0,0,4,0,2,0,0,0,5
1089,797620,16,2,4,2,3,0,1,0,0,0,0,1,2,0,0,3,4
1090,775746,35,6,13,3,5,3,8,13,17,0,4,0,4,1,2,0,28
1090,791343,32,1,7,1,5,0,2,3,6,1,2,7,2,2,1,0,5
1090,797000,10,0,2,0,0,0,2,0,0,0,2,0,0,0,2,0,0
1090,781602,38,5,11,2,4,3,7,2,3,1,3,2,1,0,0,0,15
1090,781425,31,5,9,5,9,0,0,7,7,0,8,0,2,0,0,0,17
1090,786611,19,0,4,0,0,0,4,0,0,0,1,0,0,1,5,0,0
1090,796999,8,0,1,0,1,0,0,0,0,0,1,0,2,1,0,0,0
1090,781601,8,0,0,0,0,0,0,0,0,1,1,0,1,0,0,0,0
1090,791344,19,4,4,4,4,0,0,1,6,3,3,0,4,1,2,0,9
1091,786450,35,4,7,2,2,2,5,0,0,1,7,0,5,4,1,2,10
1091,797165,29,1,8,1,3,0,5,4,4,1,3,1,3,0,2,0,6
1091,780599,8,0,1,0,1,0,0,0,0,0,1,1,4,0,2,0,0
1091,797164,19,0,5,0,4,0,1,0,0,2,5,3,5,0,2,1,0
1091,776396,38,10,17,4,5,6,12,7,7,1,6,3,1,0,3,0,33
1091,797161,18,1,6,0,1,1,5,2,3,1,0,2,2,0,0,0,5
1091,797163,30,6,12,6,12,0,0,2,3,5,5,4,5,1,0,4,14
1091,791385,23,6,9,5,7,1,2,1,2,2,3,3,4,0,3,0,14
1091,791386,0,0,0,0,0,0,0,0,0,0,0,0,0,0,0,0,0
1092,785059,37,5,11,1,2,4,9,3,4,1,4,1,4,2,4,0,17
1092,789219,36,8,18,3,6,5,12,3,4,0,0,4,3,1,0,0,24
1092,782133,15,1,4,1,1,0,3,0,0,3,2,0,2,0,1,0,2
1092,796623,33,2,8,2,2,0,6,13,15,0,2,3,4,1,2,0,17
1092,785123,28,5,11,5,10,0,1,9,11,2,2,0,2,0,1,0,19
1092,796622,4,0,0,0,0,0,0,0,0,0,1,0,0,0,0,0,0
1092,785303,4,0,2,0,0,0,2,0,0,0,0,1,1,0,0,0,0
1092,790989,2,0,0,0,0,0,0,0,1,0,1,0,0,0,0,0,0
1092,790988,3,0,0,0,0,0,0,0,0,0,1,0,1,0,0,0,0
1092,785122,20,1,7,0,1,1,6,0,0,0,2,0,2,3,0,0,3
1092,785305,7,0,2,0,1,0,1,1,4,0,1,0,0,0,0,0,1
1092,790990,11,0,1,0,0,0,1,0,0,1,2,2,4,0,2,0,0
1093,797358,25,5,8,2,3,3,5,2,2,0,6,1,5,0,1,0,15
1093,797359,3,0,0,0,0,0,0,0,0,0,0,0,0,0,0,0,0
1093,785669,25,1,4,1,3,0,1,2,2,0,3,4,1,1,4,0,4
1093,785416,18,4,5,3,3,1,2,4,4,2,7,0,3,1,4,0,13
1093,786140,4,0,0,0,0,0,0,0,0,0,0,0,5,0,0,0,0
1093,775195,17,3,6,1,1,2,5,1,4,0,1,2,3,0,1,0,9
1093,781145,5,0,0,0,0,0,0,0,0,0,1,0,1,0,0,0,0
1093,797357,4,0,0,0,0,0,0,0,0,0,0,2,0,0,1,0,0
1093,786138,34,7,13,5,9,2,4,7,9,2,8,3,3,0,3,0,23
1093,776236,24,1,7,0,4,1,3,2,2,2,2,2,1,0,2,0,5
1093,786136,14,4,9,3,4,1,5,2,2,2,4,1,4,0,1,0,11
1093,786578,27,6,7,2,2,4,5,0,0,2,5,1,4,0,0,1,16
1094,785536,15,2,8,0,0,2,8,0,0,0,9,1,0,1,0,4,6
1094,780119,18,3,5,3,4,0,1,3,4,1,5,0,1,0,2,1,9
1094,776097,13,3,4,3,4,0,0,0,0,1,3,3,3,0,2,1,6
1094,796559,24,7,8,5,5,2,3,2,3,3,5,3,2,1,1,0,18
1094,785280,13,2,4,1,2,1,2,1,2,0,4,2,0,0,0,0,6
1094,796560,18,2,5,1,2,1,3,1,1,1,6,1,4,0,2,0,6
1094,775679,23,3,9,1,2,2,7,2,2,0,3,1,0,0,1,0,10
1094,796561,21,2,6,1,3,1,3,0,0,0,2,4,3,1,0,0,5
1094,780149,22,5,12,3,5,2,7,0,0,1,3,1,5,0,3,0,12
1094,796558,15,2,2,2,2,0,0,0,0,2,1,1,2,1,1,0,4
1094,785285,14,2,3,2,3,0,0,0,0,1,3,0,1,0,0,1,4
1094,781908,3,0,0,0,0,0,0,0,0,0,0,0,0,0,0,0,0
1094,792636,1,0,0,0,0,0,0,0,0,0,0,0,0,0,0,0,0
1095,780229,24,4,11,4,11,0,0,2,4,3,3,2,2,0,1,0,10
1095,795572,18,0,5,0,5,0,0,2,4,0,1,1,0,2,2,0,2
1095,791488,24,2,8,1,4,1,4,0,2,0,3,2,1,1,0,0,5
1095,786322,19,1,7,0,5,1,2,2,3,0,2,0,3,1,3,0,5
1095,780228,24,1,6,0,1,1,5,1,2,0,1,1,1,0,0,0,4
1095,781592,27,1,5,1,3,0,2,4,6,3,7,1,2,1,0,0,6
1095,797194,10,0,3,0,0,0,3,0,0,0,1,0,0,1,0,0,0
1095,791485,21,3,6,3,4,0,2,0,0,0,2,0,0,0,1,0,6
1095,791484,14,2,5,1,3,1,2,3,4,2,3,1,2,1,0,0,8
1095,786323,16,1,3,0,2,1,1,0,0,0,0,1,0,0,0,0,3
1095,791487,3,0,0,0,0,0,0,1,2,0,0,0,0,0,0,0,1
1096,791669,27,6,7,6,7,0,0,0,0,2,6,3,3,0,3,1,12
1096,780531,38,8,16,5,10,3,6,3,5,0,9,6,1,2,1,1,22
1096,797409,31,4,9,0,2,4,7,3,4,0,0,6,1,0,3,0,15
1096,780535,10,0,1,0,0,0,1,0,0,0,4,0,2,0,1,0,0
1096,785762,31,7,13,7,12,0,1,1,2,3,8,1,4,2,3,0,15
1096,785760,25,1,4,0,0,1,4,0,0,0,0,1,5,1,0,0,3
1096,791666,16,2,5,1,3,1,2,2,2,0,1,3,0,0,2,0,7
1096,791670,5,0,1,0,1,0,0,0,0,2,1,0,0,0,0,0,0
1096,780534,11,1,2,1,2,0,0,0,0,0,3,0,4,0,1,0,2
1096,797414,6,0,0,0,0,0,0,0,0,0,2,0,1,0,1,0,0
1097,791411,36,5,15,4,9,1,6,0,0,2,2,2,3,0,1,1,11
1097,785776,34,2,10,2,6,0,4,0,0,0,1,5,0,1,2,0,4
1097,785911,15,1,2,1,1,0,1,0,0,1,2,0,2,0,1,0,2
1097,791413,32,6,13,4,6,2,7,2,3,0,1,1,1,1,1,1,16
1097,791414,23,1,5,0,3,1,2,2,4,0,4,0,4,0,2,2,5
1097,797100,15,2,4,2,3,0,1,3,5,0,5,0,3,0,3,0,7
1097,797105,14,1,2,0,0,1,2,0,0,0,0,1,0,0,0,0,3
1097,797099,3,0,1,0,1,0,0,0,1,0,0,0,1,0,1,0,0
1097,797103,21,6,8,6,8,0,0,3,8,5,4,2,3,0,0,0,15
1097,786403,7,1,2,1,2,0,0,0,0,0,1,0,0,0,0,0,2
1098,785938,26,4,9,1,4,3,5,0,0,0,0,5,2,2,3,0,11
1098,785939,31,3,12,2,9,1,3,4,8,0,1,1,3,1,1,0,11
1098,785946,7,0,0,0,0,0,0,0,0,1,0,0,3,0,0,0,0
1098,785948,20,3,5,3,5,0,0,1,1,3,4,1,4,0,1,0,7
1098,785941,37,4,7,2,3,2,4,3,5,0,4,0,2,2,1,0,13
1098,792020,28,3,8,1,4,2,4,1,3,0,2,9,2,2,8,0,9
1098,792026,11,0,0,0,0,0,0,0,0,0,4,0,1,1,0,2,0
1098,792022,21,3,6,1,3,2,3,0,0,1,4,2,4,1,1,1,8
1098,792025,19,5,5,5,5,0,0,0,0,1,5,0,1,0,1,2,10
1099,786685,24,9,14,9,12,0,2,5,9,3,2,2,3,3,2,0,23
1099,792232,28,2,5,2,3,0,2,0,0,2,6,0,1,1,0,3,4
1099,785841,33,4,9,4,7,0,2,4,6,0,1,4,3,2,1,0,12
1099,785664,18,1,2,1,2,0,0,2,6,3,4,0,2,0,1,0,4
1099,796609,34,5,14,4,9,1,5,2,3,3,5,3,2,1,5,1,13
1099,796613,16,1,5,1,3,0,2,1,2,0,0,1,1,3,5,0,3
1099,791312,3,2,2,2,2,0,0,0,0,2,0,0,2,0,0,0,4
1099,766623,22,0,1,0,1,0,0,0,1,0,4,0,3,1,1,0,0
1099,796611,22,4,8,3,4,1,4,0,0,2,1,0,1,1,1,0,9
1100,785294,30,4,6,4,6,0,0,2,3,1,9,3,0,1,4,0,10
1100,791081,16,2,2,2,2,0,0,2,2,1,6,0,2,1,2,1,6
1100,791085,31,9,15,9,11,0,4,2,2,1,0,6,2,1,4,0,20
1100,786446,16,3,8,3,5,0,3,2,2,0,1,2,4,2,1,0,8
1100,785675,27,8,13,3,3,5,10,2,3,4,4,3,1,1,1,1,23
1100,796511,13,0,2,0,2,0,0,1,2,1,2,0,2,1,2,0,1
1100,791083,14,1,2,1,2,0,0,2,4,2,1,1,2,0,1,0,4
1100,796512,16,2,9,0,1,2,8,0,0,1,0,1,1,1,1,0,6
1100,796514,9,0,1,0,0,0,1,0,0,0,0,2,1,2,3,0,0
1100,791077,1,0,0,0,0,0,0,0,0,0,0,0,0,0,0,0,0
1100,791080,20,5,10,4,7,1,3,2,2,3,8,2,1,0,2,0,13
1100,796515,7,0,4,0,0,0,4,0,0,0,2,0,1,0,0,0,0
1102,785667,25,5,12,0,2,5,10,0,0,1,1,4,0,0,1,1,15
1102,786570,26,4,8,2,3,2,5,5,7,0,3,7,1,2,0,0,15
1102,786572,28,4,8,2,3,2,5,5,7,1,2,5,2,1,4,0,15
1102,791876,27,8,13,4,7,4,6,2,4,3,7,3,0,2,0,0,22
1102,791877,15,2,2,2,2,0,0,0,0,2,1,1,4,1,1,1,4
1102,797490,14,3,6,3,6,0,0,0,0,2,3,0,3,0,0,0,6
1102,781205,6,0,2,0,2,0,0,0,0,3,0,0,2,0,0,0,0
1102,797486,14,1,4,1,3,0,1,1,2,0,2,1,1,1,0,0,3
1102,797487,10,0,0,0,0,0,0,0,3,0,2,2,1,1,0,2,0
1102,797491,14,0,0,0,0,0,0,1,2,0,0,1,0,1,0,0,1
1102,797492,4,1,1,1,1,0,0,0,0,0,0,0,2,0,0,0,2
1102,791880,2,0,0,0,0,0,0,0,0,0,2,0,1,0,0,0,0
1102,790396,4,1,1,0,0,1,1,0,0,0,0,1,0,0,0,0,3
1102,786573,3,0,1,0,1,0,0,1,2,0,0,0,0,0,0,0,1
1102,797489,3,0,1,0,0,0,1,0,0,0,1,0,1,0,1,0,0
1102,791878,5,1,1,1,1,0,0,0,0,0,0,1,1,0,0,0,2
1103,786512,34,7,13,3,5,4,8,0,0,0,4,3,4,0,5,0,18
1103,797574,21,2,3,2,2,0,1,0,0,1,0,2,1,0,2,1,4
1103,797575,23,3,6,3,6,0,0,3,4,3,2,2,3,0,1,2,9
1103,786032,20,4,8,1,5,3,3,0,0,1,1,1,5,0,4,1,11
1103,786435,31,2,11,2,9,0,2,1,3,2,7,0,1,0,0,0,5
1103,797573,23,1,4,1,4,0,0,6,7,0,2,0,2,0,1,2,8
1103,791900,11,0,4,0,2,0,2,0,0,0,2,0,1,0,0,0,0
1103,780189,11,0,0,0,0,0,0,0,0,1,1,0,1,0,0,0,0
1103,797571,22,1,4,1,2,0,2,2,2,0,2,5,2,0,5,0,4
1103,791901,4,0,0,0,0,0,0,0,0,0,0,1,0,1,0,0,0
1104,780176,32,5,13,3,8,2,5,5,6,0,3,1,2,2,2,0,17
1104,786013,18,1,2,1,2,0,0,0,0,1,2,0,3,0,3,0,2
1104,790814,29,2,9,2,5,0,4,0,0,5,4,1,1,1,3,0,4
1104,796379,36,4,11,3,7,1,4,0,0,2,3,7,1,0,0,0,9
1104,790815,34,3,9,1,5,2,4,1,2,1,1,2,1,0,1,1,9
1104,796375,1,0,0,0,0,0,0,0,0,0,0,0,1,0,0,0,0
1104,796372,13,2,3,2,3,0,0,1,1,1,1,0,2,0,0,0,5
1104,796378,16,3,7,2,5,1,2,0,0,1,4,2,0,1,1,0,7
1104,796377,21,2,7,1,2,1,5,0,0,1,0,0,2,0,2,0,5
1105,785482,35,8,15,6,10,2,5,0,0,1,7,6,0,0,4,0,18
1105,791375,29,5,8,3,3,2,5,0,0,0,4,2,3,2,0,0,12
1105,785487,35,1,4,1,3,0,1,0,0,1,4,4,2,1,2,0,2
1105,781560,13,1,2,1,2,0,0,4,6,2,3,0,5,0,2,0,6
1105,780837,30,9,17,2,4,7,13,0,0,0,2,0,1,0,4,0,25
1105,786164,24,0,1,0,0,0,1,0,0,0,2,1,0,2,1,2,0
1105,796479,12,0,0,0,0,0,0,0,0,0,0,0,1,1,1,0,0
1105,796477,14,2,3,1,1,1,2,0,0,0,0,2,0,1,0,0,5
1105,796473,8,0,0,0,0,0,0,0,0,2,1,0,0,0,1,0,0
1106,790934,20,3,6,3,5,0,1,3,4,1,2,1,2,2,1,0,9
1106,774936,15,2,3,1,2,1,1,3,4,1,3,0,3,0,3,0,8
1106,790932,33,2,7,1,3,1,4,3,5,0,1,1,1,1,2,1,8
1106,781345,30,2,5,0,0,2,5,2,2,1,2,5,2,4,2,0,8
1106,786803,24,4,11,1,4,3,7,0,0,2,0,4,1,1,2,0,11
1106,796490,1,0,1,0,1,0,0,0,0,1,0,0,0,0,0,0,0
1106,796488,4,0,2,0,1,0,1,0,2,0,0,0,2,0,0,0,0
1106,786804,21,2,5,1,2,1,3,0,0,0,6,1,2,1,1,0,5
1106,786805,18,3,7,3,6,0,1,1,3,2,2,1,3,0,2,1,7
1106,796489,1,0,0,0,0,0,0,0,0,0,0,0,0,0,0,0,0
1106,796487,6,0,1,0,0,0,1,0,0,0,0,0,0,0,0,0,0
1106,790931,13,3,4,3,3,0,1,2,2,2,3,0,4,0,1,0,8
1106,790933,11,2,4,1,2,1,2,0,0,0,0,1,1,1,0,0,5
1106,780033,2,0,0,0,0,0,0,0,0,0,0,1,0,0,0,0,0
1106,780030,1,0,0,0,0,0,0,0,0,0,0,0,0,0,0,0,0
1107,791868,30,2,6,2,5,0,1,8,14,0,1,1,3,2,7,1,12
1107,797802,32,2,3,2,2,0,1,2,4,1,2,0,1,2,5,2,6
1107,797809,12,1,4,1,3,0,1,3,4,0,1,1,5,0,1,0,5
1107,797807,40,5,9,5,6,0,3,0,0,0,6,1,2,1,4,0,10
1107,786058,31,3,4,3,4,0,0,0,2,1,7,1,4,5,4,0,6
1107,797812,4,0,1,0,1,0,0,0,0,0,0,0,3,0,0,1,0
1107,795730,25,1,5,0,3,1,2,0,0,1,3,0,4,0,4,0,3
1107,797810,4,0,1,0,1,0,0,0,0,0,0,0,0,0,1,0,0
1107,792264,22,1,2,1,2,0,0,4,5,2,5,1,3,0,2,0,6
1108,780651,21,7,8,7,8,0,0,1,2,2,2,6,0,0,1,2,15
1108,791815,23,6,10,3,5,3,5,0,0,0,5,1,1,2,0,0,15
1108,791810,23,3,5,3,5,0,0,0,1,0,2,8,3,3,0,1,6
1108,791814,20,5,7,3,3,2,4,0,0,0,2,1,0,0,0,0,12
1108,780650,21,6,9,3,6,3,3,0,1,2,5,4,1,3,0,0,15
1108,791809,11,2,2,2,2,0,0,4,6,1,2,0,3,1,2,2,8
1108,797374,7,0,1,0,0,0,1,0,0,0,1,0,2,0,0,0,0
1108,791812,10,2,3,1,2,1,1,2,2,1,0,1,2,0,1,0,7
1108,781596,9,3,4,3,4,0,0,2,2,0,1,1,1,0,2,0,8
1108,797373,9,1,3,1,2,0,1,0,0,0,0,3,2,0,1,0,2
1108,797372,15,2,2,2,2,0,0,1,2,0,2,0,4,4,1,0,5
1108,791813,4,1,2,1,2,0,0,1,2,1,0,0,0,0,0,0,3
1108,786645,15,0,3,0,3,0,0,2,2,1,2,1,4,1,1,0,2
1108,786644,10,2,2,0,0,2,2,3,4,0,2,0,0,0,0,0,9
1108,789086,2,0,0,0,0,0,0,0,0,0,1,0,0,0,0,0,0
1109,792418,22,0,6,0,4,0,2,1,2,1,1,0,4,0,3,2,1
1109,796693,27,2,5,1,3,1,2,0,2,1,1,2,3,0,6,0,5
1109,796691,15,1,5,0,2,1,3,0,0,1,1,0,2,0,1,0,3
1109,792422,10,2,2,2,2,0,0,0,0,0,2,0,1,0,1,0,4
1109,789484,39,7,21,3,11,4,10,5,7,1,4,2,1,1,5,0,23
1109,796692,11,0,1,0,0,0,1,2,3,1,0,0,0,0,0,0,2
1109,792424,25,0,1,0,1,0,0,2,4,0,1,0,3,1,1,0,2
1109,792419,11,0,0,0,0,0,0,0,0,0,1,0,1,0,0,0,0
1109,792421,18,2,3,0,0,2,3,6,6,0,1,1,1,2,1,0,12
1109,796694,11,0,1,0,0,0,1,0,2,2,0,1,2,0,1,0,0
1109,792423,11,0,3,0,3,0,0,2,2,1,0,1,0,0,2,0,2
1110,797482,34,5,11,5,10,0,1,4,5,0,4,2,1,1,0,0,14
1110,797485,21,1,3,1,1,0,2,0,0,1,4,1,3,0,0,1,2
1110,797481,31,6,11,4,8,2,3,1,2,2,8,0,4,0,3,0,15
1110,797480,22,4,8,4,7,0,1,1,3,0,5,3,4,2,1,0,9
1110,785944,33,6,14,5,7,1,7,15,18,0,5,4,4,2,5,0,28
1110,797484,13,0,1,0,1,0,0,0,0,1,2,2,2,0,0,1,0
1110,797483,5,1,1,1,1,0,0,0,0,0,0,0,1,0,0,0,2
1110,797478,16,1,5,1,4,0,1,3,3,0,1,1,0,1,2,0,5
1110,791873,25,4,7,4,6,0,1,3,4,1,2,3,2,1,2,0,11
1111,790784,24,4,9,1,1,3,8,2,2,2,4,1,5,0,3,2,13
1111,786548,12,3,5,3,4,0,1,0,0,1,1,0,5,1,1,0,6
1111,786770,24,4,9,3,5,1,4,7,8,0,4,4,1,2,2,0,16
1111,786719,24,3,9,3,6,0,3,0,0,1,2,1,5,1,2,0,6
1111,775229,33,7,15,5,8,2,7,5,11,3,1,3,3,1,2,0,21
1111,786583,2,0,0,0,0,0,0,0,0,0,0,0,1,0,0,0,0
1111,776219,27,1,6,1,3,0,3,0,0,1,4,0,4,0,5,1,2
1111,797475,9,0,2,0,1,0,1,0,0,1,1,0,2,1,3,0,0
1111,791871,8,0,0,0,0,0,0,0,2,0,0,1,0,0,0,0,0
1111,786581,14,2,5,2,3,0,2,2,2,0,1,1,0,0,2,0,6
1111,786229,23,0,3,0,0,0,3,3,4,1,9,2,2,1,0,0,3
1118,796469,23,3,6,2,4,1,2,0,0,2,4,0,3,0,3,2,7
1118,779981,23,3,6,3,6,0,0,1,2,2,4,1,3,0,1,0,7
1118,785463,37,7,12,5,7,2,5,1,1,0,2,2,5,2,4,0,17
1118,779978,37,7,15,5,10,2,5,1,1,1,2,3,1,0,2,0,17
1118,776003,23,2,10,1,4,1,6,0,0,0,5,1,1,2,1,0,5
1118,779980,11,2,4,2,4,0,0,0,1,2,3,0,1,1,0,0,4
1118,785466,24,0,2,0,0,0,2,0,0,0,2,2,0,0,0,0,0
1118,790923,20,3,5,2,2,1,3,0,1,0,2,0,4,1,1,0,7
1118,785462,2,0,0,0,0,0,0,0,0,0,0,0,0,0,0,0,0
1119,791981,36,9,14,9,12,0,2,1,2,3,5,2,2,0,2,1,19
1119,780342,32,2,7,2,5,0,2,4,6,4,8,3,2,1,1,0,8
1119,791982,35,6,9,4,5,2,4,5,6,0,3,0,1,0,2,0,19
1119,780333,33,3,10,1,6,2,4,4,5,1,3,3,3,2,0,0,12
1119,781493,18,1,3,1,1,0,2,0,0,0,0,1,3,0,4,0,2
1119,791984,7,0,3,0,3,0,0,0,0,0,0,0,0,0,0,0,0
1119,786756,20,3,9,1,4,2,5,0,0,0,1,0,1,0,0,0,8
1119,786755,19,0,1,0,1,0,0,0,0,0,2,0,2,0,0,1,0
1120,791201,22,5,9,5,9,0,0,0,0,2,6,2,4,0,1,0,10
1120,791202,32,5,11,1,2,4,9,0,0,1,3,1,3,1,2,0,14
1120,775767,23,4,8,3,7,1,1,3,6,2,7,1,3,0,3,0,12
1120,785628,37,6,12,4,8,2,4,1,2,0,4,6,0,3,2,0,15
1120,785627,34,3,9,2,4,1,5,3,4,0,7,2,2,0,4,0,10
1120,796904,11,0,2,0,1,0,1,3,4,0,3,3,0,1,0,0,3
1120,781138,1,0,0,0,0,0,0,0,0,0,0,0,1,0,0,0,0
1120,781135,5,0,0,0,0,0,0,0,0,0,0,1,1,0,0,0,0
1120,796902,3,1,1,1,1,0,0,0,0,0,0,1,0,0,1,0,2
1120,796901,18,0,2,0,1,0,1,0,0,1,2,1,1,0,1,0,0
1120,788869,1,0,0,0,0,0,0,0,0,0,0,0,0,0,0,0,0
1120,789974,1,0,0,0,0,0,0,0,0,0,0,0,0,0,0,0,0
1120,785629,12,1,2,0,0,1,2,0,0,0,1,0,0,0,1,0,3
1121,796817,25,2,4,0,0,2,4,0,0,0,1,0,2,0,1,1,6
1121,791161,16,1,6,1,2,0,4,1,2,0,0,1,2,1,2,0,3
1121,780629,25,7,14,7,11,0,3,1,4,3,4,0,4,1,2,0,15
1121,774845,36,3,11,3,9,0,2,3,3,0,4,5,0,4,3,0,9
1121,775888,34,4,10,4,8,0,2,3,5,1,7,0,2,1,2,0,11
1121,796816,22,0,1,0,0,0,1,0,0,0,6,1,4,2,2,0,0
1121,796815,3,0,1,0,0,0,1,0,0,0,0,0,0,0,0,0,0
1121,796819,3,0,0,0,0,0,0,0,0,0,0,0,0,0,0,0,0
1121,791159,8,0,2,0,1,0,1,2,3,0,2,0,1,0,0,0,2
1121,785346,28,3,7,1,2,2,5,0,0,0,4,1,1,1,1,0,8
1122,792373,15,5,9,5,7,0,2,0,0,0,1,0,1,2,2,0,10
1122,781598,11,1,3,1,1,0,2,0,0,0,2,0,1,0,0,0,2
1122,792370,16,2,6,2,3,0,3,0,0,2,3,2,2,3,3,2,4
1122,786739,15,1,2,0,0,1,2,0,0,0,1,2,0,0,1,0,3
1122,775303,20,2,3,1,1,1,2,0,0,0,5,3,1,2,0,0,5
1122,797958,27,7,11,5,7,2,4,4,5,3,3,0,0,2,1,0,20
1122,792369,8,0,1,0,0,0,1,0,0,0,4,0,0,0,0,0,0
1122,797951,20,5,12,5,8,0,4,0,0,0,4,1,2,1,1,0,10
1122,797949,4,0,0,0,0,0,0,2,2,1,0,0,1,1,0,0,2
1122,797960,17,5,9,0,2,5,7,2,2,3,3,1,2,0,0,0,17
1122,790499,3,0,1,0,0,0,1,0,0,0,0,1,1,0,1,0,0
1122,781597,24,1,5,1,2,0,3,1,2,1,0,5,1,1,1,0,3
1122,775809,20,2,4,1,3,1,1,4,6,1,1,3,1,2,1,1,9
1124,786029,22,2,7,2,6,0,1,0,0,1,2,0,5,2,1,1,4
1124,781398,26,1,5,1,2,0,3,0,0,0,2,0,1,0,0,0,2
1124,792114,33,3,12,1,4,2,8,6,6,1,1,2,0,0,2,1,14
1124,786018,31,3,11,0,6,3,5,0,0,3,4,0,1,1,0,2,9
1124,775678,32,5,16,3,11,2,5,1,2,1,4,6,3,1,2,0,13
1124,797746,21,6,10,6,8,0,2,2,4,4,3,0,0,0,3,1,14
1124,797744,11,1,2,1,1,0,1,1,2,0,0,0,0,0,0,0,3
1124,786022,12,0,1,0,1,0,0,0,0,2,0,0,4,0,1,0,0
1124,797740,11,1,2,1,2,0,0,1,4,0,4,0,0,0,0,0,3
1124,780352,1,0,0,0,0,0,0,0,0,0,0,0,0,0,0,0,0
1125,790863,17,4,7,4,7,0,0,6,6,2,5,0,5,0,1,0,14
1125,780021,18,3,4,3,4,0,0,1,5,1,4,1,3,0,1,0,7
1125,785412,29,1,13,1,6,0,7,1,2,1,4,6,1,1,3,0,3
1125,780099,34,6,11,4,6,2,5,5,5,1,5,1,1,1,1,0,19
1125,776214,36,5,7,3,5,2,2,2,2,0,3,4,4,2,1,1,14
1125,775686,25,2,3,1,1,1,2,0,0,1,4,2,0,0,2,1,5
1125,785417,13,3,4,2,2,1,2,1,2,1,2,1,0,0,1,0,8
1125,785413,17,1,2,1,1,0,1,0,0,1,3,0,3,0,1,0,2
1125,776221,8,0,1,0,0,0,1,0,0,0,1,0,0,0,0,0,0
1125,785411,3,0,0,0,0,0,0,0,0,0,0,0,0,0,0,0,0
1126,780797,29,5,8,3,4,2,4,4,4,1,8,4,3,0,0,0,16
1126,776418,17,6,7,6,7,0,0,8,10,1,5,0,1,0,1,4,20
1126,785505,28,2,6,1,4,1,2,0,0,0,3,7,2,1,6,0,5
1126,780555,30,4,7,0,0,4,7,0,0,1,3,5,0,0,1,0,12
1126,775604,29,9,15,3,4,6,11,0,0,3,2,2,0,1,1,0,24
1126,791616,15,0,2,0,2,0,0,0,0,0,4,0,2,0,1,1,0
1126,796983,4,1,3,1,3,0,0,2,5,4,0,0,1,0,1,0,4
1126,796986,10,0,3,0,0,0,3,0,0,0,1,1,1,0,0,0,0
1126,796984,13,2,4,2,3,0,1,0,0,0,0,1,3,1,0,1,4
1126,796981,17,5,8,5,8,0,0,1,1,0,6,3,2,1,0,1,11
1126,791617,4,0,1,0,0,0,1,0,0,0,0,0,0,0,0,0,0
1126,780432,4,0,0,0,0,0,0,0,0,0,0,0,1,0,0,0,0
1128,785608,18,5,8,5,8,0,0,2,4,0,7,3,2,3,1,1,12
1128,792104,28,5,11,2,5,3,6,3,4,1,2,4,0,3,3,1,16
1128,797709,18,2,5,2,3,0,2,0,0,1,3,0,0,2,5,0,4
1128,797708,28,1,2,1,1,0,1,4,6,1,0,4,3,4,3,0,6
1128,786198,34,8,11,5,6,3,5,2,2,1,3,3,0,6,1,0,21
1128,776327,10,2,3,2,3,0,0,3,3,2,1,0,3,2,2,0,7
1128,786204,12,1,4,0,2,1,2,1,2,1,1,0,1,0,0,0,4
1128,797707,19,3,4,3,3,0,1,0,0,0,1,4,3,0,2,0,6
1128,786180,11,3,3,3,3,0,0,0,0,1,1,0,2,0,0,0,6
1128,792106,14,2,5,1,3,1,2,0,0,0,3,4,2,0,1,0,5
1128,781631,7,1,1,1,1,0,0,0,1,0,0,1,0,0,0,0,2
1128,799162,1,0,1,0,0,0,1,0,0,1,0,0,0,0,0,0,0
1129,792171,31,7,11,7,9,0,2,1,2,1,5,1,3,1,4,0,15
1129,785674,29,5,16,2,5,3,11,1,3,4,6,0,4,1,2,1,14
1129,780049,27,5,7,5,7,0,0,0,0,4,4,0,3,0,2,0,10
1129,797784,31,4,8,3,4,1,4,2,2,0,0,4,0,3,6,0,11
1129,789059,22,2,7,0,3,2,4,1,2,1,2,1,2,0,2,0,7
1129,780527,16,2,3,2,2,0,1,0,1,0,1,1,1,2,1,0,4
1129,792174,11,1,2,1,2,0,0,0,0,0,0,0,1,0,3,0,2
1129,780980,7,0,0,0,0,0,0,0,0,0,0,0,1,1,2,0,0
1129,797782,12,0,0,0,0,0,0,0,0,0,1,0,0,0,6,1,0
1129,792173,8,1,2,0,1,1,1,0,0,1,0,1,1,0,1,0,3
1129,786658,2,0,0,0,0,0,0,0,0,0,0,0,0,0,0,0,0
1129,797785,2,0,0,0,0,0,0,0,0,0,0,0,0,0,0,0,0
1129,792175,2,0,0,0,0,0,0,0,0,0,0,0,0,0,0,0,0
1130,776100,26,1,3,1,2,0,1,1,2,2,5,3,3,0,2,0,3
1130,785991,20,6,6,6,6,0,0,1,4,2,9,0,2,0,2,4,13
1130,781406,23,5,7,4,5,1,2,5,8,0,2,3,0,0,1,0,16
1130,781401,21,2,6,2,4,0,2,5,6,1,1,1,2,4,0,1,9
1130,775317,16,2,2,1,1,1,1,0,0,0,0,3,0,1,1,0,5
1130,797763,1,0,0,0,0,0,0,0,0,0,0,0,0,1,0,0,0
1130,797760,14,5,8,3,5,2,3,3,3,5,2,0,1,0,2,0,15
1130,792129,4,2,4,2,4,0,0,0,0,1,1,0,1,0,0,0,4
1130,797758,4,1,2,0,1,1,1,0,0,0,0,0,0,0,0,0,3
1130,792130,3,1,1,0,0,1,1,2,2,0,0,0,0,0,0,0,5
1130,792133,25,5,14,4,8,1,6,1,2,2,3,3,1,0,3,0,12
1130,797762,22,1,3,1,2,0,1,4,4,4,5,7,2,2,2,1,6
1130,781029,20,2,12,1,4,1,8,0,0,2,2,1,3,1,1,0,5
1130,785997,1,0,0,0,0,0,0,0,0,0,0,0,0,0,0,0,0
1131,799136,10,0,0,0,0,0,0,0,0,0,0,1,4,1,1,0,0
1131,799132,40,6,12,2,3,4,9,5,6,0,3,3,4,1,0,0,21
1131,799130,35,8,19,5,9,3,10,4,4,0,3,2,3,0,4,0,23
1131,799134,19,0,1,0,0,0,1,2,2,0,3,1,5,0,3,1,2
1131,792634,39,6,18,3,7,3,11,0,0,0,2,3,1,3,4,0,15
1131,799135,8,1,1,1,1,0,0,0,0,1,1,1,0,0,0,0,2
1131,799131,11,0,1,0,1,0,0,0,0,1,1,0,0,0,0,0,0
1131,799128,13,0,0,0,0,0,0,0,0,0,2,0,1,1,1,0,0
1131,799133,25,2,4,0,0,2,4,0,0,0,2,2,4,1,2,0,6
1132,791923,24,3,10,3,8,0,2,2,4,3,2,1,4,0,4,0,8
1132,781122,16,1,3,1,3,0,0,1,2,1,2,1,2,1,1,0,3
1132,791926,36,6,14,0,2,6,12,4,5,0,1,0,4,1,2,1,22
1132,786527,31,4,9,2,3,2,6,0,0,1,3,0,5,1,2,0,10
1132,781112,17,1,4,0,2,1,2,0,0,1,1,2,2,0,1,0,3
1132,791922,19,2,3,1,2,1,1,0,0,2,4,1,2,1,2,1,5
1132,797541,27,7,14,7,14,0,0,4,5,6,9,1,3,0,0,0,18
1132,797542,21,2,10,1,5,1,5,0,0,1,2,0,3,0,0,0,5
1132,786858,22,3,6,3,5,0,1,3,4,0,1,4,2,0,2,0,9
1132,778952,12,0,3,0,3,0,0,0,0,0,2,4,1,0,0,0,0
1133,797151,22,2,4,2,3,0,1,8,9,1,3,1,5,0,1,0,12
1133,778442,28,3,15,2,7,1,8,4,4,2,3,1,5,0,0,1,11
1133,797150,28,5,12,5,11,0,1,3,4,0,6,2,1,1,1,1,13
1133,791514,15,1,2,1,2,0,0,0,0,0,2,1,0,0,2,0,2
1133,786637,39,4,10,3,6,1,4,7,11,1,8,5,2,1,1,0,16
1133,791515,22,4,8,1,2,3,6,0,0,1,3,0,2,1,1,0,11
1133,797152,19,3,5,2,3,1,2,2,2,2,5,0,2,0,2,0,9
1133,797149,5,0,0,0,0,0,0,1,2,0,0,0,0,0,0,0,1
1133,780946,25,2,3,1,2,1,1,4,4,0,1,4,1,1,1,0,9
1133,791513,22,3,5,2,3,1,2,1,2,2,3,0,0,0,0,0,8
1134,789036,36,7,15,7,15,0,0,4,7,3,4,1,4,1,1,1,18
1134,791493,32,4,9,4,9,0,0,4,9,6,7,0,2,1,2,3,12
1134,776494,31,5,7,2,2,3,5,1,2,2,2,1,4,1,2,0,14
1134,786324,36,4,13,2,7,2,6,9,10,1,4,13,3,2,7,0,19
1134,791495,15,2,2,1,1,1,1,0,0,0,0,0,1,0,0,0,5
1134,781307,13,0,1,0,1,0,0,0,0,0,2,1,4,0,2,0,0
1134,791494,16,4,5,4,4,0,1,1,1,0,3,0,5,1,1,0,9
1134,797191,4,1,3,0,2,1,1,0,0,0,0,0,0,0,0,0,3
1134,791492,17,1,7,0,3,1,4,3,4,0,0,4,2,0,0,1,6
1135,785563,32,3,10,2,5,1,5,3,4,2,5,4,4,0,2,1,10
1135,781208,30,4,7,4,6,0,1,0,2,1,1,0,4,1,2,0,8
1135,780313,37,4,9,4,6,0,3,6,8,0,8,3,2,1,3,0,14
1135,785560,14,0,3,0,1,0,2,0,0,0,1,1,3,0,1,0,0
1135,780766,31,6,10,2,3,4,7,7,7,1,1,4,3,1,3,0,23
1135,785561,24,3,7,3,6,0,1,5,8,4,3,1,3,0,3,0,11
1135,775489,21,3,4,3,4,0,0,5,6,1,3,0,3,0,1,1,11
1135,780758,9,2,5,2,5,0,0,0,0,1,3,0,1,0,0,0,4
1135,791088,2,1,1,1,1,0,0,0,0,0,0,0,1,0,1,0,2
1136,786256,33,10,15,10,15,0,0,2,5,0,9,1,0,1,1,2,22
1136,797769,34,6,13,5,9,1,4,2,2,2,1,3,2,0,3,1,15
1136,797774,31,3,10,0,0,3,10,4,5,1,3,3,4,0,0,0,13
1136,797779,31,3,8,0,3,3,5,2,2,1,4,2,3,2,2,0,11
1136,797776,30,1,6,1,6,0,0,2,7,1,3,5,4,3,2,0,4
1136,775106,20,2,3,2,3,0,0,2,4,3,2,5,1,1,4,0,6
1136,785568,12,1,4,1,3,0,1,0,1,2,1,0,2,0,1,1,2
1136,797768,8,0,0,0,0,0,0,0,0,0,0,0,1,0,2,0,0
1136,797780,1,0,0,0,0,0,0,0,0,0,0,0,1,0,1,0,0
1137,796759,18,9,11,8,10,1,1,0,0,1,5,0,4,0,0,0,19
1137,791105,34,5,13,4,10,1,3,3,6,1,6,6,2,4,3,1,14
1137,796758,33,6,9,6,9,0,0,0,0,2,6,0,3,3,0,0,12
1137,791101,30,4,6,3,5,1,1,2,2,0,2,4,4,0,3,0,11
1137,780794,19,0,4,0,2,0,2,0,0,0,3,2,2,0,2,1,0
1137,796757,31,6,11,5,8,1,3,2,2,0,1,3,4,1,3,0,15
1137,780109,21,2,5,0,1,2,4,2,2,0,4,2,2,0,2,1,8
1137,775124,8,0,3,0,3,0,0,0,0,2,0,0,0,0,0,0,0
1137,785597,6,0,1,0,1,0,0,0,0,0,1,0,3,0,1,0,0
1138,797054,33,6,17,6,13,0,4,1,1,0,4,1,2,1,3,0,13
1138,775549,29,5,7,5,7,0,0,2,2,1,5,0,2,1,3,3,12
1138,797056,23,5,9,4,6,1,3,0,0,0,3,0,4,1,1,0,11
1138,786380,22,3,8,3,8,0,0,3,4,0,4,0,3,2,0,0,9
1138,791564,30,3,8,2,4,1,4,0,2,1,5,1,0,0,0,1,7
1138,797055,24,3,9,3,7,0,2,0,0,2,1,3,1,2,0,0,6
1138,791568,14,1,2,1,1,0,1,1,2,0,0,0,2,1,1,0,3
1138,797058,12,1,1,0,0,1,1,0,0,0,2,0,0,0,0,0,3
1138,780425,11,0,1,0,1,0,0,0,0,0,1,0,3,0,1,0,0
1138,791566,2,0,0,0,0,0,0,0,0,0,0,0,0,0,0,0,0
1139,790996,36,7,11,5,8,2,3,3,5,0,7,2,0,0,5,0,19
1139,766874,27,5,10,5,9,0,1,2,4,0,2,1,5,1,2,4,12
1139,790998,36,3,10,1,4,2,6,1,2,2,6,8,0,1,2,0,9
1139,785621,18,2,7,1,2,1,5,0,0,1,1,0,0,0,0,0,5
1139,790997,29,2,4,2,3,0,1,0,0,1,10,2,0,0,1,0,4
1139,781520,22,2,3,0,0,2,3,2,2,0,3,2,2,0,3,0,8
1139,790995,16,1,4,0,1,1,3,0,0,0,0,0,2,0,1,1,3
1139,796631,12,0,2,0,0,0,2,0,0,1,0,1,2,0,1,0,0
1139,790999,4,0,0,0,0,0,0,0,0,0,0,0,2,0,1,0,0
1139,796633,0,0,0,0,0,0,0,0,0,0,0,0,0,0,0,0,0
1140,796404,25,1,8,1,5,0,3,0,0,5,7,1,3,0,5,1,2
1140,785434,25,2,7,1,4,1,3,2,3,0,1,0,4,0,0,1,7
1140,790853,4,0,0,0,0,0,0,0,0,0,0,0,0,0,0,0,0
1140,781164,20,1,6,1,5,0,1,0,0,3,2,3,2,0,3,0,2
1140,781163,35,4,13,2,10,2,3,10,13,2,2,2,3,1,3,0,20
1140,790854,21,4,4,4,4,0,0,8,8,3,3,0,3,1,0,3,16
1140,796405,11,1,3,1,2,0,1,1,2,0,1,0,2,0,1,0,3
1140,790849,14,3,4,1,1,2,3,2,3,0,3,4,1,2,1,0,10
1140,781223,4,0,0,0,0,0,0,0,0,0,0,1,0,0,0,0,0
1140,796406,15,2,4,2,4,0,0,0,0,2,3,1,0,0,0,1,4
1140,790848,11,1,2,0,0,1,2,0,0,0,0,1,3,0,0,0,3
1140,790850,15,1,5,0,2,1,3,3,4,0,1,2,0,2,0,0,6
1141,797698,24,7,10,6,7,1,3,0,2,1,3,1,3,1,1,0,15
1141,780844,26,2,5,1,2,1,3,1,2,2,3,0,3,0,1,3,6
1141,797699,20,5,11,5,10,0,1,1,1,2,3,5,3,1,1,1,11
1141,797694,8,0,1,0,0,0,1,0,0,0,0,0,1,0,0,0,0
1141,780846,40,3,10,3,8,0,2,1,5,0,5,5,3,3,3,0,7
1141,791956,29,6,10,3,5,3,5,4,7,1,4,1,3,0,0,0,19
1141,797696,13,0,1,0,1,0,0,0,0,2,3,0,0,0,1,0,0
1141,791954,13,1,4,1,3,0,1,2,2,0,1,1,1,0,2,0,4
1141,797692,27,4,6,1,2,3,4,3,3,0,2,0,5,1,1,0,14
1142,780270,23,2,6,0,1,2,5,1,2,0,4,7,5,0,1,0,7
1142,798134,14,2,6,1,3,1,3,1,2,0,0,0,4,0,2,0,6
1142,798132,22,1,2,0,0,1,2,0,0,0,2,0,1,1,2,0,3
1142,792561,35,8,11,7,9,1,2,1,2,2,2,5,0,2,0,1,18
1142,776333,19,1,3,1,3,0,0,4,6,1,8,0,4,2,0,1,6
1142,780266,8,1,2,0,0,1,2,5,6,0,1,0,4,0,0,0,8
1142,798135,11,0,1,0,0,0,1,1,2,0,1,0,2,0,1,0,1
1142,792563,23,3,5,1,2,2,3,0,2,0,3,0,2,1,5,0,8
1142,792565,28,7,8,7,8,0,0,7,9,4,6,1,1,3,5,0,21
1142,792560,11,1,3,1,3,0,0,1,2,2,3,1,1,0,0,0,3
1142,798133,6,0,1,0,0,0,1,0,0,0,1,0,0,0,0,0,0
1143,792220,24,2,12,0,5,2,7,3,6,1,4,2,3,0,1,0,9
1143,781329,25,1,2,1,2,0,0,2,2,2,0,4,1,2,1,0,4
1143,786693,21,1,5,1,3,0,2,0,0,1,1,2,1,0,1,0,2
1143,786691,31,7,16,3,7,4,9,3,4,1,5,1,4,1,1,0,21
1143,792219,22,2,2,2,2,0,0,2,2,1,3,0,4,0,3,2,6
1143,781408,15,3,7,2,4,1,3,3,7,4,0,1,3,0,2,0,10
1143,781455,17,1,1,1,1,0,0,3,3,0,1,2,3,1,2,0,5
1143,797876,16,1,2,1,2,0,0,0,0,0,1,0,3,2,1,1,2
1143,792222,10,1,4,1,1,0,3,1,2,0,0,1,0,0,0,0,3
1143,792046,17,2,8,0,2,2,6,0,2,1,1,2,2,2,1,0,6
1143,786843,2,0,1,0,1,0,0,0,0,0,0,0,1,0,0,0,0
1144,796585,19,1,1,1,1,0,0,0,3,1,4,1,1,0,1,0,2
1144,780192,32,3,7,2,3,1,4,0,0,0,3,2,4,0,5,0,7
1144,786818,28,3,6,3,6,0,0,1,1,1,5,4,1,1,2,0,7
1144,798139,21,3,8,2,5,1,3,3,3,0,0,1,3,3,2,0,10
1144,780182,30,4,11,2,3,2,8,2,2,0,4,1,0,0,1,0,12
1144,780186,21,2,3,2,3,0,0,0,0,1,3,2,1,0,1,0,4
1144,786820,19,4,7,2,4,2,3,2,3,0,2,2,0,0,0,0,12
1144,780184,17,3,7,2,2,1,5,0,0,0,0,0,1,0,0,0,7
1144,798138,10,1,3,1,2,0,1,0,0,0,4,0,0,0,1,1,2
1144,780188,3,0,0,0,0,0,0,0,0,0,1,0,0,0,0,0,0
1145,780122,20,3,4,2,3,1,1,0,0,1,0,0,2,0,0,2,7
1145,780792,29,2,10,1,5,1,5,2,2,0,5,2,4,0,2,0,7
1145,791461,27,2,4,1,2,1,2,1,2,1,2,1,1,1,1,2,6
1145,786295,29,5,10,1,2,4,8,4,4,0,9,1,2,1,4,1,18
1145,797215,28,5,7,4,5,1,2,0,2,0,1,2,1,3,1,0,11
1145,775598,19,3,8,2,4,1,4,0,0,0,0,0,1,0,2,0,7
1145,791462,2,0,0,0,0,0,0,0,0,0,0,0,0,0,0,0,0
1145,786299,20,0,2,0,2,0,0,0,0,2,4,1,3,1,0,0,0
1145,791459,19,1,7,1,7,0,0,0,0,1,0,3,2,3,0,0,2
1145,797214,7,0,2,0,2,0,0,1,2,1,2,1,1,1,1,0,1
1146,780677,31,6,12,5,6,1,6,4,5,1,4,0,0,1,2,0,17
1146,780676,31,4,10,4,8,0,2,5,6,2,3,0,3,1,4,1,13
1146,786150,26,3,7,2,4,1,3,1,2,3,1,3,3,2,1,0,8
1146,786157,21,2,4,2,4,0,0,2,2,2,4,0,2,1,1,1,6
1146,791756,28,0,3,0,2,0,1,2,3,0,3,3,1,1,3,0,2
1146,775533,14,5,6,5,5,0,1,0,0,1,4,0,4,3,1,0,10
1146,780673,20,0,1,0,0,0,1,6,8,0,4,2,3,2,1,0,6
1146,780992,22,1,7,1,2,0,5,0,0,0,3,3,1,0,0,0,2
1146,791754,5,0,0,0,0,0,0,1,5,0,0,0,0,0,0,0,1
1146,797348,2,0,0,0,0,0,0,0,0,0,0,0,1,0,1,1,0
1147,786566,38,8,18,3,9,5,9,1,1,0,5,1,1,2,2,2,22
1147,781189,26,6,9,6,8,0,1,0,1,0,0,2,5,0,3,0,12
1147,781204,35,4,6,2,2,2,4,1,2,1,5,2,3,2,2,0,11
1147,781188,40,3,10,3,5,0,5,4,4,1,3,7,4,2,7,0,10
1147,791993,31,1,5,1,4,0,1,1,2,0,4,2,4,0,1,1,3
1147,786563,10,1,3,1,2,0,1,0,0,0,1,0,2,0,0,0,2
1147,786562,14,0,2,0,2,0,0,0,0,1,1,0,4,0,1,0,0
1147,791995,6,0,1,0,1,0,0,0,0,0,0,0,0,0,0,0,0
1148,781673,36,7,10,4,4,3,6,0,0,0,2,5,2,1,0,0,17
1148,781462,33,9,14,9,14,0,0,3,3,3,4,2,4,2,1,3,21
1148,785353,31,0,6,0,3,0,3,0,0,0,3,5,0,3,1,0,0
1148,780876,25,5,10,3,7,2,3,0,0,0,2,3,5,3,1,1,12
1148,781457,39,4,9,3,4,1,5,1,2,1,2,1,2,2,2,1,10
1148,785355,15,1,5,0,3,1,2,1,2,0,0,1,1,3,0,0,4
1148,790895,21,5,6,4,4,1,2,4,4,0,2,3,0,1,1,0,15
1149,797222,32,4,8,4,8,0,0,1,1,3,9,4,3,1,3,1,9
1149,781526,30,1,4,1,4,0,0,4,4,0,3,2,4,0,2,0,6
1149,797219,38,9,14,6,10,3,4,1,2,1,2,3,1,0,4,0,22
1149,797217,27,1,2,0,1,1,1,0,0,0,1,1,1,1,2,0,3
1149,797218,27,4,11,1,4,3,7,0,0,1,3,0,2,1,3,0,11
1149,775697,28,2,8,1,1,1,7,2,2,0,3,6,1,1,2,0,7
1149,797223,2,0,0,0,0,0,0,2,2,1,0,0,0,0,1,0,2
1149,791846,11,1,1,1,1,0,0,0,0,0,1,0,0,0,0,0,2
1149,791453,4,0,1,0,0,0,1,0,0,0,0,0,1,0,3,0,0
1149,797221,1,0,0,0,0,0,0,0,0,0,0,0,0,0,0,0,0
1150,792068,25,7,12,5,7,2,5,2,3,1,8,3,1,0,0,2,18
1150,784640,14,3,8,3,7,0,1,3,4,4,4,2,3,0,0,0,9
1150,792072,19,4,7,0,0,4,7,0,0,0,1,0,1,0,1,0,12
1150,792069,24,3,7,2,4,1,3,4,4,1,1,1,2,2,2,0,11
1150,785572,19,7,10,7,10,0,0,2,3,0,5,2,2,0,0,0,16
1150,786025,8,2,2,2,2,0,0,0,0,0,2,0,0,0,0,0,4
1150,797655,19,2,4,2,4,0,0,0,0,2,4,3,1,2,1,0,4
1150,797654,3,1,2,0,1,1,1,0,0,0,0,0,0,0,0,0,3
1150,797657,25,6,8,4,5,2,3,0,0,0,2,3,2,1,1,0,14
1150,797652,24,3,7,3,5,0,2,1,2,0,4,4,1,0,1,0,7
1150,797653,10,1,3,1,2,0,1,0,0,1,0,3,1,1,0,0,2
1150,774844,10,1,2,1,2,0,0,0,0,0,3,2,0,1,0,0,2
1152,797367,15,7,9,7,9,0,0,0,0,2,2,1,0,3,0,1,14
1152,797364,14,2,2,2,2,0,0,0,2,1,4,3,1,1,0,1,4
1152,797366,14,0,1,0,1,0,0,0,0,0,3,8,1,2,0,0,0
1152,791807,14,7,12,2,3,5,9,1,2,2,0,0,0,2,2,1,20
1152,786130,14,8,13,6,9,2,4,2,3,0,5,3,2,3,1,1,20
1152,797371,14,2,3,2,3,0,0,0,0,4,4,1,3,2,0,0,4
1152,797368,10,1,3,1,3,0,0,0,0,1,2,0,1,0,0,2,2
1152,786127,10,0,2,0,2,0,0,0,0,0,2,0,2,0,0,1,0
1152,797370,6,1,2,1,2,0,0,0,0,1,0,0,0,0,0,0,2
1152,797369,21,4,5,0,0,4,5,0,0,0,1,1,1,0,2,0,12
1152,797365,12,5,10,0,0,5,10,0,0,0,0,1,1,0,1,0,15
1152,797363,13,4,6,4,4,0,2,2,3,0,3,2,1,1,1,0,10
1152,791805,8,0,2,0,0,0,2,0,0,0,2,2,0,0,0,0,0
1152,791804,19,1,7,0,0,1,7,4,5,0,1,6,1,0,2,0,7
1152,791808,16,3,5,3,4,0,1,1,1,2,7,3,2,0,0,0,7
1154,797142,17,0,0,0,0,0,0,0,0,1,0,1,3,2,0,1,0
1154,791522,28,4,7,4,6,0,1,10,12,0,8,0,1,1,2,0,18
1154,786351,20,4,5,1,1,3,4,1,2,1,7,0,4,0,3,1,12
1154,797146,29,5,11,5,8,0,3,6,8,0,4,1,0,0,2,0,16
1154,797143,30,6,9,2,3,4,6,0,0,0,6,2,0,0,2,1,16
1154,797147,15,1,4,1,2,0,2,0,0,1,1,0,2,1,2,0,2
1154,791520,14,1,3,1,1,0,2,0,0,0,4,1,1,0,1,0,2
1154,785479,19,1,4,1,3,0,1,2,4,0,4,0,2,0,0,1,4
1154,797144,13,3,4,2,3,1,1,3,4,0,1,2,2,3,0,0,10
1154,786348,6,1,1,1,1,0,0,2,2,1,1,0,0,0,0,0,4
1154,797148,3,0,0,0,0,0,0,2,2,0,2,0,1,0,1,0,2
1154,786771,4,0,0,0,0,0,0,0,0,0,0,0,1,0,1,0,0
1154,786826,2,0,0,0,0,0,0,0,0,0,1,0,0,0,0,0,0
1155,785970,10,0,5,0,5,0,0,3,4,3,1,0,3,0,0,0,3
1155,775394,27,1,7,1,4,0,3,0,2,1,6,2,3,0,1,0,2
1155,791526,24,2,6,1,3,1,3,0,1,0,1,1,4,1,3,0,5
1155,780272,25,2,8,0,1,2,7,0,0,1,1,1,2,0,2,0,6
1155,775592,22,2,12,2,9,0,3,0,0,0,1,1,1,0,2,0,4
1155,797139,25,6,8,6,8,0,0,5,10,6,6,0,2,1,1,0,17
1155,780273,26,1,5,0,2,1,3,1,2,1,0,0,1,1,1,0,4
1155,791524,12,1,3,1,2,0,1,0,0,1,0,0,5,0,1,0,2
1155,797136,15,3,7,2,2,1,5,2,2,0,1,1,1,2,0,0,9
1155,791523,5,0,2,0,0,0,2,0,0,0,0,0,0,0,1,0,0
1155,786354,3,0,0,0,0,0,0,1,2,1,0,0,0,1,0,0,1
1155,797141,3,0,2,0,0,0,2,0,2,0,0,0,0,1,0,0,0
1155,797137,3,1,1,1,1,0,0,0,0,0,0,0,1,0,0,0,2
1156,774905,23,2,5,1,2,1,3,1,1,1,1,5,0,1,2,1,6
1156,790825,25,4,9,2,5,2,4,0,0,0,1,6,2,0,0,0,10
1156,785374,11,3,3,3,3,0,0,0,0,0,1,1,3,0,0,1,6
1156,786384,27,8,14,2,4,6,10,2,2,1,9,4,0,2,0,1,24
1156,785373,15,3,4,2,3,1,1,0,0,1,2,1,0,0,4,0,7
1156,790827,21,1,2,1,1,0,1,0,0,1,3,1,1,1,1,0,2
1156,785375,12,4,6,4,6,0,0,0,0,0,1,0,1,0,1,2,8
1156,785372,31,5,13,5,9,0,4,2,4,2,2,5,1,0,1,1,12
1156,785371,16,0,2,0,1,0,1,0,0,0,1,2,1,0,0,0,0
1156,790828,7,0,0,0,0,0,0,0,0,0,2,1,2,0,1,0,0
1156,796385,6,0,2,0,1,0,1,0,0,0,2,1,2,0,0,0,0
1156,796387,3,2,2,2,2,0,0,0,0,0,2,0,1,0,0,0,4
1156,790826,1,0,0,0,0,0,0,0,0,0,0,1,0,0,1,0,0
1156,780007,2,0,1,0,0,0,1,0,0,0,0,0,0,0,0,0,0
1157,792123,35,5,11,2,5,3,6,6,6,0,6,3,1,1,2,0,19
1157,792120,20,4,10,3,8,1,2,0,0,0,0,2,4,0,2,0,9
1157,797749,27,3,6,2,4,1,2,0,0,1,0,2,1,0,0,0,7
1157,775455,24,2,9,2,9,0,0,2,2,0,6,4,1,0,0,0,6
1157,792124,32,7,11,7,10,0,1,2,2,5,5,1,2,0,0,1,16
1157,786005,13,0,4,0,3,0,1,0,0,0,0,1,0,0,2,0,0
1157,792119,21,0,0,0,0,0,0,0,0,0,2,0,1,1,2,0,0
1157,797752,15,2,4,2,4,0,0,0,0,1,1,1,1,0,1,0,4
1157,797747,10,0,4,0,3,0,1,0,0,0,1,0,1,1,1,0,0
1157,786008,3,0,0,0,0,0,0,0,1,0,0,0,1,1,1,0,0
1158,792005,38,9,16,7,9,2,7,3,4,0,7,1,1,0,4,1,23
1158,781175,27,4,5,4,5,0,0,3,3,4,4,1,5,1,1,0,11
1158,786553,28,5,17,2,7,3,10,4,4,1,1,2,3,1,2,0,17
1158,780895,20,3,7,2,3,1,4,3,4,1,2,3,5,0,1,0,10
1158,781172,33,1,5,0,2,1,3,1,2,1,0,4,3,0,0,0,4
1158,781177,12,1,1,0,0,1,1,0,0,0,3,1,3,0,1,0,3
1158,785312,29,4,10,3,7,1,3,1,2,0,1,6,5,0,3,0,10
1158,786555,34,5,8,1,2,4,6,0,0,0,6,1,3,3,2,0,14
1158,797503,4,0,1,0,1,0,0,0,0,0,1,1,1,0,0,1,0
1159,780765,41,10,19,8,14,2,5,8,10,1,4,4,4,1,3,1,30
1159,781301,18,5,7,5,7,0,0,0,3,3,1,0,2,0,1,1,10
1159,786255,44,6,13,5,7,1,6,2,3,0,8,3,1,2,1,1,15
1159,780762,31,5,8,3,4,2,4,4,5,1,1,2,4,2,0,1,16
1159,780768,37,3,7,2,4,1,3,3,4,2,3,7,3,3,4,0,10
1159,791729,19,2,5,2,2,0,3,1,2,2,1,1,2,1,1,0,5
1159,780755,32,3,5,2,3,1,2,5,8,1,5,2,3,1,2,0,12
1159,797320,3,0,0,0,0,0,0,0,0,0,0,0,0,0,0,0,0
1164,792140,20,6,10,6,10,0,0,2,3,1,1,2,5,0,3,3,14
1164,792144,39,3,9,3,8,0,1,0,0,2,8,0,0,1,4,0,6
1164,792148,37,4,14,1,3,3,11,1,2,0,3,1,0,2,2,0,12
1164,776092,41,7,13,3,7,4,6,5,7,5,4,6,2,1,5,0,23
1164,792146,25,3,6,3,6,0,0,3,7,1,5,0,1,0,2,0,9
1164,797786,14,0,2,0,1,0,1,3,3,0,0,1,0,0,0,0,3
1164,797789,6,0,1,0,0,0,1,0,0,0,1,1,1,0,0,0,0
1164,781429,43,3,12,0,1,3,11,0,0,0,4,2,2,1,1,0,9
1165,797830,22,2,4,2,2,0,2,1,1,2,6,1,2,0,3,0,5
1165,797824,22,2,6,1,3,1,3,0,0,0,4,0,5,2,4,0,5
1165,775116,22,1,7,0,2,1,5,0,2,1,6,3,3,0,2,0,3
1165,792190,37,6,11,4,6,2,5,4,4,1,2,1,1,1,0,0,18
1165,786664,35,8,16,5,9,3,7,1,3,0,2,4,0,4,4,1,20
1165,797828,5,0,5,0,1,0,4,0,0,1,1,0,0,0,0,0,0
1165,792192,18,3,5,3,5,0,0,0,1,1,4,0,3,1,1,0,6
1165,797827,2,1,1,1,1,0,0,0,0,0,0,0,1,0,0,0,2
1165,792193,20,2,5,2,5,0,0,2,2,2,4,1,4,1,1,0,6
1165,792191,19,1,2,1,2,0,0,0,0,1,1,2,3,0,2,0,2
1165,791928,23,3,3,3,3,0,0,2,2,1,0,1,2,0,1,1,8
1166,785368,12,3,4,3,4,0,0,1,2,0,1,0,2,0,0,1,7
1166,785247,22,7,13,7,13,0,0,5,5,2,1,2,0,1,2,0,19
1166,790793,26,3,8,1,4,2,4,2,2,0,2,2,2,0,2,0,10
1166,790792,24,2,5,2,3,0,2,6,6,4,6,6,1,1,1,1,10
1166,785246,16,5,7,0,1,5,6,0,0,0,1,0,3,1,0,0,15
1166,790794,20,2,4,2,4,0,0,0,0,2,3,2,2,0,3,3,4
1166,796350,13,2,6,1,2,1,4,0,0,1,1,0,0,1,1,1,5
1166,780281,5,1,2,1,1,0,1,0,0,1,2,0,5,0,0,0,2
1166,790789,14,1,4,0,2,1,2,2,2,0,1,2,3,0,0,0,5
1166,780886,20,0,2,0,0,0,2,2,3,0,2,2,1,4,1,0,2
1166,796351,9,0,1,0,1,0,0,1,2,2,3,0,2,0,0,0,1
1166,796353,10,2,5,2,4,0,1,2,2,0,1,1,2,0,0,0,6
1166,790791,4,0,1,0,0,0,1,0,0,0,0,0,0,0,0,0,0
1166,790790,4,0,0,0,0,0,0,0,0,0,2,0,0,0,1,0,0
1166,796352,1,0,0,0,0,0,0,0,0,0,1,0,1,0,0,0,0
1167,792167,23,0,5,0,5,0,0,1,2,3,2,0,2,1,4,0,1
1167,792170,11,0,2,0,1,0,1,1,2,1,1,0,1,0,5,1,1
1167,791372,33,3,11,1,4,2,7,2,3,0,2,0,2,2,3,0,10
1167,792164,28,3,14,2,8,1,6,6,7,0,2,1,4,0,3,0,13
1167,780974,6,1,2,1,1,0,1,0,0,0,1,0,0,0,1,0,2
1167,797766,18,0,3,0,2,0,1,1,2,0,2,0,2,0,0,0,1
1167,797767,24,0,5,0,3,0,2,0,0,0,2,3,2,2,2,0,0
1167,792163,11,1,2,0,1,1,1,0,0,2,1,0,4,0,1,0,3
1167,797772,21,1,3,1,1,0,2,4,4,0,0,1,3,0,1,0,6
1167,797764,19,1,4,1,2,0,2,0,2,5,5,1,0,0,2,0,2
1167,797765,2,0,0,0,0,0,0,1,2,0,0,0,1,0,0,0,1
1167,797777,2,0,0,0,0,0,0,0,0,0,0,0,0,0,0,0,0
1167,792169,2,0,0,0,0,0,0,0,0,0,0,0,0,0,0,0,0
1168,780323,23,4,10,4,10,0,0,0,0,3,3,0,2,1,2,1,8
1168,792233,22,5,7,5,7,0,0,2,3,1,1,0,1,1,0,0,12
1168,797894,24,0,3,0,3,0,0,0,0,1,1,1,1,1,3,0,0
1168,785954,26,4,8,2,3,2,5,3,3,2,9,5,0,2,2,2,13
1168,785811,21,2,7,0,3,2,4,6,6,0,1,3,2,1,3,0,12
1168,786016,22,4,8,2,5,2,3,0,0,1,1,3,2,0,1,1,10
1168,792234,12,1,4,1,4,0,0,0,0,0,0,0,1,0,1,1,2
1168,797892,15,2,3,1,1,1,2,7,7,1,2,3,2,6,0,0,12
1168,797893,9,2,7,2,7,0,0,2,2,1,3,1,0,0,0,1,6
1168,781356,7,0,1,0,0,0,1,0,2,1,0,0,1,0,0,0,0
1168,797891,11,1,2,1,1,0,1,1,2,2,1,0,2,1,0,1,3
1168,792230,8,1,2,0,0,1,2,0,2,0,0,0,1,0,0,0,3
1169,781289,16,0,0,0,0,0,0,0,0,0,3,0,2,1,1,2,0
1169,796645,14,0,2,0,1,0,1,0,1,0,1,0,3,2,3,0,0
1169,792626,24,2,5,2,2,0,3,3,7,1,3,1,2,1,5,0,7
1169,781491,28,1,3,1,2,0,1,0,0,0,3,1,3,0,4,0,2
1169,780250,28,4,8,2,3,2,5,1,1,1,5,0,2,1,3,0,11
1169,792627,7,0,0,0,0,0,0,0,0,0,0,1,2,0,2,0,0
1169,796634,23,1,3,1,3,0,0,3,4,0,1,0,4,0,2,2,5
1169,792632,17,0,1,0,1,0,0,1,2,0,3,0,3,0,1,0,1
1169,796642,18,3,11,3,8,0,3,3,4,1,3,0,1,0,2,0,9
1169,792631,7,0,0,0,0,0,0,0,0,0,0,0,1,1,3,0,0
1169,796637,9,1,2,1,2,0,0,1,1,0,0,0,0,0,3,0,3
1169,796638,9,1,2,1,1,0,1,0,0,0,1,0,0,0,1,0,2
1170,792197,3,1,1,1,1,0,0,0,0,1,0,0,1,0,0,0,2
1170,781132,26,3,8,2,2,1,6,3,4,0,7,4,2,3,0,2,10
1170,797517,19,7,10,7,10,0,0,4,7,7,7,2,1,1,1,1,18
1170,791940,25,7,10,4,5,3,5,3,4,1,1,1,1,1,1,0,20
1170,786534,24,5,6,5,6,0,0,2,3,0,7,8,0,0,2,0,12
1170,797521,9,1,1,0,0,1,1,7,8,1,0,0,2,0,0,1,10
1170,797519,18,2,4,1,1,1,3,1,3,1,3,0,2,1,1,0,6
1170,797522,8,3,3,3,3,0,0,0,0,0,2,0,3,0,1,0,6
1170,786539,10,0,0,0,0,0,0,0,0,3,3,2,1,0,0,0,0
1170,791939,4,0,0,0,0,0,0,0,0,0,0,0,0,0,0,0,0
1170,797520,8,0,4,0,2,0,2,0,0,0,1,1,2,1,0,0,0
1170,797518,16,3,6,3,5,0,1,3,4,0,2,4,1,0,6,0,9
1170,791938,22,3,5,2,2,1,3,0,2,0,0,1,0,2,1,0,7
1170,797516,4,0,1,0,1,0,0,1,2,0,0,0,2,0,0,0,1
1170,789070,4,0,0,0,0,0,0,0,0,0,0,0,0,0,1,0,0
1171,785681,24,2,4,2,4,0,0,3,5,3,3,1,3,2,3,1,7
1171,796789,27,1,10,1,6,0,4,4,4,1,2,1,3,1,3,0,6
1171,796782,18,1,5,0,2,1,3,1,1,0,1,0,0,0,2,0,4
1171,791126,8,1,2,0,1,1,1,1,2,0,0,0,3,0,1,0,4
1171,791124,15,0,3,0,2,0,1,0,0,0,0,1,0,0,0,0,0
1171,784479,8,0,2,0,0,0,2,4,4,0,1,0,2,2,2,0,4
1171,796786,20,2,9,1,2,1,7,2,2,0,1,0,0,0,1,0,7
1171,796788,17,1,5,1,5,0,0,1,1,2,0,0,2,1,1,1,3
1171,796784,18,2,6,2,4,0,2,0,0,1,0,0,3,0,2,0,4
1171,796783,9,0,0,0,0,0,0,0,0,0,0,2,1,1,0,0,0
1171,791125,9,0,2,0,1,0,1,1,2,0,1,0,3,0,1,0,1
1171,796785,11,0,1,0,0,0,1,0,0,0,2,0,2,0,2,0,0
1171,780050,16,3,8,3,7,0,1,0,0,1,2,1,5,0,2,0,6
1172,791851,32,5,5,2,2,3,3,4,4,0,4,4,3,1,6,1,17
1172,780377,34,3,11,1,2,2,9,2,2,0,10,2,1,0,1,0,10
1172,791852,19,1,2,1,2,0,0,0,0,2,3,0,2,0,1,5,2
1172,797460,34,6,11,3,6,3,5,1,2,1,5,0,1,1,1,3,16
1172,786600,24,2,5,2,5,0,0,0,0,1,5,4,1,0,5,0,4
1172,797462,19,1,4,1,4,0,0,3,3,0,5,1,3,0,0,0,5
1172,791853,2,0,0,0,0,0,0,0,0,0,0,0,2,0,0,0,0
1172,797459,16,0,4,0,2,0,2,1,3,0,1,2,2,0,2,0,1
1172,786602,8,0,5,0,2,0,3,0,0,0,3,0,1,0,2,1,0
1172,786599,12,4,6,3,4,1,2,0,0,0,0,0,4,1,1,0,9
1173,785836,37,7,15,5,9,2,6,1,3,5,7,1,1,0,0,2,17
1173,775872,21,0,4,0,2,0,2,3,5,3,4,1,2,0,0,0,3
1173,797533,17,1,4,1,3,0,1,0,0,0,1,0,1,0,3,0,2
1173,785838,34,5,19,5,13,0,6,1,3,2,2,1,4,3,1,0,11
1173,780577,30,3,9,0,4,3,5,0,0,0,4,2,4,0,2,0,9
1173,791705,9,0,2,0,0,0,2,0,0,0,0,0,0,2,1,0,0
1173,791707,28,4,11,4,9,0,2,3,4,1,5,2,4,1,4,0,11
1173,791704,24,1,3,1,2,0,1,3,4,0,6,2,3,3,1,0,5
1174,783269,17,1,5,0,2,1,3,0,1,0,1,0,0,1,0,1,3
1174,775541,14,0,2,0,2,0,0,0,0,1,2,0,1,0,0,2,0
1174,781019,34,4,8,4,7,0,1,0,0,1,7,5,0,4,4,0,8
1174,787524,24,1,8,1,3,0,5,1,2,0,5,2,2,3,2,0,3
1174,780328,22,4,8,4,8,0,0,0,0,0,2,0,0,1,1,0,8
1174,797611,10,1,8,1,6,0,2,1,1,2,2,0,0,0,1,0,3
1174,791772,16,0,6,0,4,0,2,0,0,1,1,0,1,0,1,0,0
1174,780017,21,1,7,1,4,0,3,1,2,2,2,1,2,0,4,0,3
1174,791774,13,4,5,3,4,1,1,1,1,1,0,0,3,0,1,1,10
1174,791722,19,3,7,1,2,2,5,0,0,0,0,0,1,0,1,0,8
1174,797608,2,0,0,0,0,0,0,0,0,0,0,0,1,0,0,0,0
1174,787522,2,0,0,0,0,0,0,0,0,0,1,0,0,0,0,0,0
1174,776790,3,0,1,0,0,0,1,0,0,0,0,0,0,0,0,0,0
1174,797610,3,0,2,0,0,0,2,0,2,1,0,0,0,0,0,0,0
1175,780953,25,12,16,10,14,2,2,0,0,4,4,4,1,2,2,2,26
1175,792143,21,3,7,1,1,2,6,0,0,0,3,1,1,2,0,1,8
1175,797753,26,2,12,2,7,0,5,2,2,2,8,2,1,0,1,0,6
1175,780955,25,4,8,3,3,1,5,0,0,1,6,4,1,0,2,0,9
1175,786287,16,2,3,2,3,0,0,0,0,0,3,4,1,0,1,0,4
1175,797750,14,2,7,1,4,1,3,2,2,2,2,1,0,1,0,1,7
1175,797748,7,3,5,2,4,1,1,1,1,2,1,0,2,0,0,1,8
1175,792147,13,0,7,0,7,0,0,0,0,5,5,0,1,1,0,0,0
1175,797751,17,1,5,1,2,0,3,0,0,0,0,1,1,1,0,0,2
1175,797742,12,1,5,1,3,0,2,1,1,1,0,0,1,0,2,1,3
1175,792145,3,1,1,0,0,1,1,0,0,0,1,0,0,0,0,0,3
1175,786301,3,1,1,1,1,0,0,0,1,0,1,0,0,0,0,0,2
1175,786302,12,0,1,0,1,0,0,0,0,1,3,2,4,1,4,0,0
1175,786294,3,0,0,0,0,0,0,0,0,0,0,0,0,0,0,0,0
1175,796192,3,0,0,0,0,0,0,0,0,0,1,0,0,0,1,0,0
1176,791185,28,1,4,1,1,0,3,0,0,0,6,1,2,0,3,1,2
1176,791187,18,3,6,3,6,0,0,1,3,1,3,0,2,1,0,1,7
1176,796857,16,1,5,1,4,0,1,2,2,1,0,1,2,0,0,0,4
1176,785650,22,2,4,1,3,1,1,3,4,0,0,0,1,1,1,0,8
1176,785649,25,6,15,4,10,2,5,2,2,0,3,0,2,0,0,0,16
1176,796860,24,3,8,2,6,1,2,2,2,0,3,1,0,1,1,0,9
1176,791183,6,2,2,2,2,0,0,0,0,0,2,0,2,0,0,0,4
1176,775208,16,5,7,5,7,0,0,0,0,0,1,1,1,0,0,0,10
1176,796861,4,0,0,0,0,0,0,0,0,0,1,0,0,0,0,0,0
1176,796856,19,0,4,0,2,0,2,0,0,0,1,1,1,0,1,0,0
1176,791186,1,1,1,1,1,0,0,0,1,0,0,0,0,0,0,0,2
1176,791184,17,0,1,0,1,0,0,1,2,0,1,5,2,0,2,0,1
1176,796859,1,0,0,0,0,0,0,0,0,0,0,0,0,0,0,0,0
1176,796862,1,0,0,0,0,0,0,0,0,0,0,0,0,0,0,0,0
1176,793803,2,0,0,0,0,0,0,0,0,0,0,0,0,0,0,0,0
1177,776344,22,4,9,3,6,1,3,4,4,0,4,2,3,1,3,0,13
1177,775821,16,6,8,4,5,2,3,0,0,3,2,0,3,0,1,1,14
1177,792453,28,8,10,4,4,4,6,2,2,0,4,4,1,0,1,0,22
1177,785131,21,3,8,0,2,3,6,0,0,3,1,1,3,1,1,0,9
1177,781538,27,0,5,0,1,0,4,0,0,0,5,6,1,1,0,0,0
1177,798113,23,1,5,1,4,0,1,0,0,1,7,2,2,0,0,1,2
1177,798115,23,4,6,0,1,4,5,0,0,0,2,1,1,1,2,2,12
1177,792322,1,0,0,0,0,0,0,0,0,0,0,0,1,0,0,0,0
1177,792324,15,3,4,2,2,1,2,0,0,0,0,0,1,0,0,0,7
1177,792323,9,0,1,0,0,0,1,1,4,0,1,0,2,0,0,0,1
1177,776233,8,1,1,1,1,0,0,1,3,0,2,0,2,1,1,0,3
1177,786696,7,0,1,0,0,0,1,0,0,0,0,1,0,0,0,0,0
1178,792288,30,1,8,1,6,0,2,2,2,4,7,2,4,3,1,0,4
1178,785227,31,4,7,4,7,0,0,5,6,4,6,1,2,0,1,4,13
1178,786237,29,7,10,7,10,0,0,4,5,1,2,1,2,2,3,0,18
1178,780287,28,6,12,3,7,3,5,2,2,0,5,1,0,1,2,0,17
1178,776309,30,5,9,4,6,1,3,2,5,1,3,1,4,3,2,0,13
1178,798077,1,1,1,0,0,1,1,0,0,0,0,0,0,0,0,0,3
1178,798067,12,0,1,0,1,0,0,0,0,0,4,0,2,0,0,0,0
1178,798068,1,0,0,0,0,0,0,0,0,0,0,1,0,0,0,0,0
1178,792278,17,0,3,0,0,0,3,0,0,0,2,0,2,0,1,0,0
1178,786232,19,3,6,2,3,1,3,2,2,0,3,0,3,0,2,0,9
1178,798066,1,0,0,0,0,0,0,0,0,0,0,0,0,0,0,0,0
1178,798084,1,0,0,0,0,0,0,0,0,0,0,0,0,0,0,0,0
1179,792265,22,2,5,2,3,0,2,1,3,1,2,0,3,0,0,0,5
1179,797998,19,2,7,1,3,1,4,0,0,1,5,1,0,1,0,0,5
1179,798009,34,1,10,1,7,0,3,3,5,1,3,1,0,3,4,0,5
1179,798006,7,0,3,0,2,0,1,0,0,0,0,0,1,0,1,0,0
1179,798007,15,0,4,0,3,0,1,2,2,2,1,1,5,0,2,1,2
1179,798005,8,1,3,1,3,0,0,0,0,0,0,0,1,0,0,0,2
1179,792266,20,4,7,3,4,1,3,5,5,1,1,0,1,1,1,2,14
1179,798003,19,1,4,1,2,0,2,0,0,0,1,3,3,3,4,0,2
1179,786152,31,6,12,5,10,1,2,4,6,1,5,2,5,0,2,2,17
1179,792267,21,1,4,0,1,1,3,0,0,0,2,1,0,0,0,0,3
1179,798002,4,0,0,0,0,0,0,0,0,0,0,0,0,0,0,0,0
1180,785366,29,6,11,6,9,0,2,4,4,1,4,6,3,1,0,0,16
1180,780863,31,6,16,5,11,1,5,5,8,0,6,3,1,0,2,1,18
1180,791974,31,2,8,2,6,0,2,1,2,0,1,3,1,2,1,1,5
1180,776069,23,4,9,2,3,2,6,0,0,0,6,0,3,1,1,0,10
1180,781107,32,4,5,4,5,0,0,0,0,0,1,2,5,0,0,0,8
1180,780867,8,1,1,1,1,0,0,0,1,1,0,2,1,0,1,0,2
1180,791972,17,2,6,0,2,2,4,0,0,1,0,0,3,0,1,0,6
1180,796777,10,1,3,1,2,0,1,0,0,0,0,1,0,0,0,0,2
1180,796778,15,1,5,1,4,0,1,0,0,3,5,2,2,1,1,0,2
1180,791971,4,0,0,0,0,0,0,0,0,0,0,0,0,0,0,0,0
1181,780747,31,6,10,6,8,0,2,8,8,0,5,5,2,0,2,1,20
1181,776363,26,3,5,1,3,2,2,2,2,0,3,2,1,2,0,0,10
1181,797691,20,0,1,0,1,0,0,6,8,0,2,2,3,0,2,0,6
1181,776014,32,2,5,1,2,1,3,1,2,0,2,2,2,0,0,1,6
1181,791949,34,7,15,5,10,2,5,0,1,0,9,0,3,0,4,0,16
1181,797690,17,2,2,2,2,0,0,1,2,0,4,3,1,1,1,0,5
1181,784336,11,2,2,2,2,0,0,2,2,0,5,0,2,0,0,1,6
1181,791946,11,1,3,1,2,0,1,0,0,0,0,0,2,0,1,0,2
1181,785304,15,2,5,0,1,2,4,0,0,0,0,0,0,1,1,0,6
1181,797689,3,0,1,0,0,0,1,0,0,0,0,0,1,0,1,0,0
1182,785631,19,3,3,2,2,1,1,0,0,1,5,2,1,1,2,0,7
1182,786248,14,0,4,0,4,0,0,0,0,3,2,1,2,0,2,0,0
1182,785630,16,3,5,0,0,3,5,0,0,0,1,5,0,1,0,0,9
1182,780777,19,4,7,4,5,0,2,1,1,1,1,6,0,2,0,0,9
1182,785863,18,5,12,5,11,0,1,0,0,0,4,0,2,2,2,0,10
1182,796899,8,2,2,1,1,1,1,0,0,0,1,0,1,1,0,2,5
1182,791199,7,0,1,0,1,0,0,2,2,2,2,0,0,0,0,2,2
1182,791197,12,0,1,0,1,0,0,0,0,0,4,1,1,0,1,0,0
1182,796900,2,1,1,1,1,0,0,0,0,0,0,0,0,0,0,0,2
1182,796898,12,4,10,3,7,1,3,2,2,1,1,0,1,2,2,0,11
1182,791198,18,4,8,0,0,4,8,0,0,0,1,1,1,0,0,0,12
1182,791196,11,3,7,1,1,2,6,4,5,0,2,0,0,1,1,0,12
1182,791195,8,1,1,1,1,0,0,0,0,0,1,2,2,1,1,0,2
1182,791200,16,4,5,2,2,2,3,0,1,0,2,1,2,2,0,0,10
1182,785632,14,3,4,3,4,0,0,0,0,1,1,2,0,1,0,0,6
1182,781129,6,0,0,0,0,0,0,0,0,0,2,1,0,0,0,0,0
1184,785540,29,2,3,2,3,0,0,1,2,2,3,2,3,1,1,0,5
1184,789046,27,7,12,2,4,5,8,3,3,2,3,2,3,1,0,1,22
1184,797631,19,3,6,3,4,0,2,0,0,1,3,2,2,1,1,1,6
1184,797629,24,4,9,4,7,0,2,4,5,2,3,1,1,1,2,0,12
1184,789041,25,6,13,3,4,3,9,0,0,1,4,3,0,1,1,1,15
1184,791787,22,8,10,6,8,2,2,7,10,3,5,3,1,3,1,0,25
1184,797632,11,0,0,0,0,0,0,0,0,1,2,0,0,0,1,0,0
1184,797633,5,0,0,0,0,0,0,0,0,0,0,0,0,0,0,0,0
1184,797630,26,4,10,1,3,3,7,1,2,0,3,5,4,3,2,1,12
1184,789044,12,4,5,2,2,2,3,0,0,0,3,0,1,0,1,0,10
1186,796556,26,5,9,1,2,4,7,4,5,0,3,0,1,0,1,0,18
1186,790961,24,4,9,4,8,0,1,6,8,2,2,1,2,2,2,1,14
1186,785278,24,4,6,2,3,2,3,0,0,0,1,4,3,1,2,1,10
1186,775860,33,1,5,0,2,1,3,0,2,1,7,4,2,3,1,0,3
1186,780832,10,1,2,1,2,0,0,0,0,0,0,0,1,0,0,0,2
1186,790962,25,5,10,4,7,1,3,6,6,4,2,1,1,3,0,1,17
1186,796555,13,3,6,2,3,1,3,0,0,0,2,0,2,0,0,0,7
1186,780146,21,1,3,1,2,0,1,3,3,0,3,5,2,0,2,0,5
1186,790965,6,1,3,1,1,0,2,0,0,0,0,0,0,0,0,0,2
1186,796557,1,0,0,0,0,0,0,2,2,1,0,0,0,0,0,0,2
1186,796554,9,0,1,0,0,0,1,1,2,0,4,0,1,1,1,1,1
1186,796553,2,0,0,0,0,0,0,0,0,0,0,0,0,0,0,0,0
1186,790963,2,0,0,0,0,0,0,0,0,0,0,0,0,0,0,0,0
1186,790960,2,0,0,0,0,0,0,0,0,0,0,0,0,0,0,0,0
1186,780363,2,0,1,0,1,0,0,0,0,0,1,0,0,0,0,0,0
1188,780012,27,2,9,1,3,1,6,0,0,3,4,1,0,0,1,1,5
1188,774895,12,2,2,2,2,0,0,0,0,2,2,0,1,0,0,0,4
1188,790824,16,4,6,4,5,0,1,0,0,2,3,3,3,0,1,1,8
1188,780011,30,4,9,2,3,2,6,0,0,0,0,5,1,1,4,0,10
1188,775667,27,1,6,1,3,0,3,2,2,0,1,4,0,1,2,0,4
1188,781524,20,7,12,3,6,4,6,0,0,0,4,2,0,0,0,0,18
1188,796383,14,3,6,2,4,1,2,3,3,0,6,0,0,0,0,0,10
1188,785370,15,2,3,1,1,1,2,0,0,1,1,2,4,1,1,1,5
1188,796309,24,6,6,6,6,0,0,2,2,2,5,1,2,0,0,1,14
1188,785367,4,1,3,1,2,0,1,0,0,1,0,0,1,0,0,0,2
1188,796384,4,0,0,0,0,0,0,0,0,0,1,0,0,0,1,0,0
1188,796382,4,0,3,0,3,0,0,0,1,0,0,0,0,0,0,0,0
1188,780941,3,0,0,0,0,0,0,0,0,1,1,0,2,0,0,0,0
1189,790846,13,0,3,0,3,0,0,2,2,0,2,1,5,0,0,1,2
1189,796755,12,2,4,2,4,0,0,0,0,2,0,1,1,0,1,0,4
1189,791099,34,3,11,2,5,1,6,2,2,0,1,1,1,1,0,1,9
1189,785470,37,7,13,5,10,2,3,5,5,0,5,1,0,1,1,0,21
1189,785586,32,2,8,2,7,0,1,0,0,0,3,3,1,0,3,1,4
1189,780315,27,1,5,0,1,1,4,2,2,2,2,1,2,1,1,0,5
1189,796754,26,5,12,4,10,1,2,0,0,0,3,0,2,2,1,0,11
1189,780795,13,1,3,1,3,0,0,0,0,0,3,1,1,0,0,0,2
1189,780814,6,0,1,0,1,0,0,0,0,1,0,0,1,0,1,0,0
1190,785638,16,0,4,0,2,0,2,0,0,1,1,1,0,0,1,0,0
1190,781326,30,2,5,2,5,0,0,0,0,6,5,1,2,1,0,3,4
1190,792209,19,2,6,0,0,2,6,0,0,0,2,0,2,0,0,0,6
1190,792210,25,6,8,4,4,2,4,1,1,0,2,0,4,0,0,0,15
1190,781323,26,5,15,3,8,2,7,6,8,0,1,5,2,2,1,0,18
1190,792213,20,2,4,2,2,0,2,1,2,3,3,1,3,1,0,2,5
1190,785430,10,1,3,1,3,0,0,0,0,1,3,2,2,0,0,0,2
1190,797870,33,8,15,5,10,3,5,2,2,0,2,3,1,0,2,0,21
1190,792214,4,0,1,0,0,0,1,0,0,0,0,1,0,0,0,0,0
1190,792215,17,2,3,1,2,1,1,2,2,1,1,1,2,0,2,0,7
1191,785432,27,4,5,4,5,0,0,0,0,3,3,0,1,0,2,1,8
1191,779985,33,6,13,5,9,1,4,1,2,1,5,0,2,0,2,2,14
1191,790882,18,2,3,1,2,1,1,1,2,2,3,4,3,0,0,0,6
1191,781062,21,1,4,1,1,0,3,0,0,0,1,1,2,2,1,0,2
1191,774987,36,7,16,5,12,2,4,16,18,1,5,9,0,0,1,0,32
1191,790876,30,6,9,5,6,1,3,0,0,0,1,2,2,1,2,0,13
1191,790877,19,1,2,1,1,0,1,2,2,0,4,0,3,1,0,0,4
1191,796434,16,1,2,0,0,1,2,0,0,0,1,1,0,0,0,0,3
1192,797174,33,0,7,0,2,0,5,2,4,3,6,2,1,0,1,3,2
1192,791510,30,5,7,1,1,4,6,1,2,1,3,1,1,0,3,0,15
1192,791507,19,3,3,3,3,0,0,3,4,0,1,0,5,0,1,2,9
1192,797168,29,6,12,5,8,1,4,1,3,0,7,4,2,2,3,0,14
1192,775357,35,4,10,2,4,2,6,0,0,0,3,5,3,1,3,0,10
1192,791509,2,1,1,1,1,0,0,0,0,0,1,0,0,0,0,0,2
1192,791506,20,2,4,0,0,2,4,0,0,0,0,0,0,0,0,0,6
1192,786699,19,2,5,2,5,0,0,2,3,4,0,1,2,0,1,1,6
1192,791508,7,0,1,0,0,0,1,0,0,0,1,0,0,0,1,0,0
1192,791505,6,0,3,0,2,0,1,0,0,0,0,0,2,0,1,0,0
1194,781403,30,4,9,1,2,3,7,0,0,1,7,0,4,0,2,0,11
1194,792654,23,3,7,3,7,0,0,3,4,3,6,0,4,0,0,3,9
1194,780524,35,3,6,2,2,1,4,2,2,0,1,1,3,0,4,0,9
1194,781400,38,7,16,2,4,5,12,0,0,0,3,0,0,0,1,0,19
1194,775893,30,2,6,1,4,1,2,3,4,1,4,8,3,1,4,0,8
1194,792653,17,2,4,2,4,0,0,1,1,1,6,0,5,0,1,2,5
1194,786857,17,4,10,3,6,1,4,1,4,2,4,0,3,1,3,2,10
1194,797301,10,0,4,0,3,0,1,0,0,1,1,2,2,0,0,0,0
1195,791975,21,3,6,3,6,0,0,3,5,4,2,1,3,0,1,1,9
1195,785972,35,5,11,4,7,1,4,2,4,2,2,2,1,2,1,0,13
1195,785967,18,5,12,5,12,0,0,4,5,3,6,1,3,0,0,1,14
1195,791977,27,1,6,1,3,0,3,5,7,0,2,0,0,0,0,0,7
1195,791978,34,5,9,3,6,2,3,5,7,0,7,7,1,4,2,0,17
1195,780160,20,0,2,0,2,0,0,0,0,0,2,1,4,2,1,0,0
1195,797799,9,0,4,0,2,0,2,0,0,0,4,1,2,1,0,0,0
1195,791976,23,4,9,3,8,1,1,3,4,1,0,0,0,0,0,0,12
1195,785973,9,2,3,1,1,1,2,0,0,1,3,1,2,0,0,0,5
1195,791980,3,1,2,0,0,1,2,0,1,0,1,0,0,0,0,0,3
1195,797800,1,0,0,0,0,0,0,0,0,0,0,0,0,0,0,0,0
1196,774812,27,6,11,6,9,0,2,4,7,1,4,1,4,1,3,1,16
1196,791500,28,3,6,3,6,0,0,0,0,4,6,1,4,0,1,0,6
1196,791497,36,5,12,2,6,3,6,1,2,1,12,3,2,1,2,1,14
1196,781486,34,4,6,4,5,0,1,9,10,0,2,2,4,2,4,0,17
1196,780461,37,9,18,7,14,2,4,4,5,2,6,7,3,0,0,0,24
1196,791498,6,1,2,1,2,0,0,0,0,0,1,0,0,0,0,0,2
1196,797180,5,0,1,0,0,0,1,0,0,0,1,0,0,0,1,0,0
1196,791499,9,0,2,0,0,0,2,0,0,0,1,1,2,0,1,0,0
1196,791503,18,0,1,0,1,0,0,1,2,0,1,0,3,0,2,0,1
1197,797325,24,2,2,2,2,0,0,0,0,4,4,1,3,0,1,0,4
1197,797329,31,2,8,1,3,1,5,2,2,4,6,0,3,2,1,0,7
1197,797323,40,10,24,5,14,5,10,7,8,2,5,7,2,2,3,1,32
1197,786236,35,8,15,2,8,6,7,2,4,0,2,2,1,0,0,0,24
1197,780759,29,1,5,0,1,1,4,0,1,0,0,2,3,0,1,0,3
1197,786246,4,0,3,0,0,0,3,0,0,0,0,0,0,0,1,0,0
1197,781002,13,0,1,0,1,0,0,2,6,0,2,0,2,0,1,1,2
1197,776478,6,0,1,0,0,0,1,1,2,0,2,0,2,0,0,0,1
1197,797327,8,0,1,0,1,0,0,0,0,1,1,0,4,0,2,0,0
1197,797322,4,1,3,1,1,0,2,0,0,0,0,0,1,0,1,0,2
1197,786233,6,0,1,0,0,0,1,0,0,0,2,0,1,0,0,0,0
1198,792158,26,4,6,4,6,0,0,6,6,6,7,3,3,0,1,0,14
1198,780138,22,1,1,1,1,0,0,4,6,3,0,2,3,0,3,0,6
1198,792154,33,12,19,8,14,4,5,1,4,1,4,1,2,3,1,0,29
1198,792152,33,6,14,6,11,0,3,0,0,0,3,7,2,2,1,0,12
1198,780581,23,3,7,2,4,1,3,1,2,0,1,2,2,1,4,0,8
1198,797755,17,2,5,2,5,0,0,0,0,2,2,1,1,0,1,0,4
1198,792162,1,0,0,0,0,0,0,0,0,0,0,0,0,0,0,0,0
1198,792157,14,3,4,3,4,0,0,0,0,2,1,4,2,1,1,1,6
1198,797756,4,0,0,0,0,0,0,0,0,0,1,1,2,0,1,0,0
1198,792159,2,0,1,0,1,0,0,0,0,0,0,0,2,0,1,0,0
1198,786014,23,5,12,3,5,2,7,6,8,1,3,0,2,0,0,0,18
1198,785358,2,0,1,0,0,0,1,0,0,0,0,0,0,0,0,0,0
1200,780291,28,2,6,1,5,1,1,3,4,3,7,1,4,0,1,0,8
1200,785607,16,3,4,3,4,0,0,2,2,0,2,0,3,0,1,0,8
1200,796665,21,4,7,3,5,1,2,2,3,1,0,0,2,0,0,0,11
1200,785333,38,3,6,2,4,1,2,2,4,0,1,3,1,2,1,1,9
1200,775305,37,7,18,3,11,4,7,15,15,1,3,3,4,1,2,0,33
1200,796663,8,0,1,0,1,0,0,0,2,0,1,0,2,0,0,0,0
1200,791004,26,3,9,1,1,2,8,2,2,0,4,0,2,3,1,0,10
1200,791006,2,0,0,0,0,0,0,0,0,0,1,0,0,0,1,0,0
1200,796666,10,1,3,1,1,0,2,4,4,1,1,0,2,0,1,0,6
1200,796664,8,0,2,0,1,0,1,0,0,0,4,0,3,0,1,0,0
1200,791005,2,0,0,0,0,0,0,0,2,0,0,0,0,0,0,0,0
1200,791007,4,0,1,0,1,0,0,1,2,0,0,0,2,0,1,0,1
1201,785490,20,1,2,1,1,0,1,2,2,2,6,1,2,0,1,1,4
1201,785495,33,7,16,6,14,1,2,4,6,1,5,1,3,1,5,0,19
1201,775377,19,0,1,0,1,0,0,3,4,3,3,0,4,1,0,3,3
1201,785494,39,8,13,7,10,1,3,5,6,3,2,1,0,0,1,0,22
1201,780698,38,9,19,7,11,2,8,3,9,0,4,0,4,2,4,0,23
1201,785659,16,2,4,2,4,0,0,1,2,0,3,1,5,0,1,0,5
1201,796702,10,0,1,0,1,0,0,0,0,0,0,0,3,0,1,0,0
1201,785486,2,0,1,0,1,0,0,0,0,1,0,0,0,0,0,0,0
1201,780427,23,1,4,1,4,0,0,0,0,0,4,1,5,0,0,0,2
1202,791438,35,8,21,5,12,3,9,4,5,2,1,2,4,0,1,0,23
1202,797060,22,3,6,0,0,3,6,2,2,0,1,3,4,1,2,0,11
1202,791439,26,4,5,4,5,0,0,2,4,1,4,3,2,0,1,2,10
1202,791437,33,1,5,0,2,1,3,0,0,1,3,3,0,2,1,0,3
1202,781641,32,4,11,0,1,4,10,4,5,0,2,1,4,3,2,1,16
1202,797038,16,0,1,0,0,0,1,0,0,0,4,5,0,0,2,0,0
1202,776137,22,0,2,0,0,0,2,0,0,0,1,2,2,0,1,0,0
1202,791436,1,0,0,0,0,0,0,0,2,0,0,0,1,0,1,0,0
1202,797043,4,0,1,0,1,0,0,0,0,0,0,0,1,0,0,0,0
1202,797053,6,0,0,0,0,0,0,0,2,0,0,0,2,0,1,0,0
1202,797059,1,0,0,0,0,0,0,0,0,0,0,0,0,0,0,0,0
1202,786305,2,0,0,0,0,0,0,0,0,0,0,0,0,0,0,0,0
1203,796617,20,1,5,1,5,0,0,2,4,0,4,0,1,0,0,0,4
1203,775131,32,2,7,0,1,2,6,6,6,1,1,3,4,0,3,1,12
1203,796612,36,10,15,8,10,2,5,0,0,0,3,5,1,2,5,0,22
1203,796606,36,2,3,0,0,2,3,0,0,0,1,3,3,2,1,0,6
1203,785562,26,5,9,2,5,3,4,2,2,5,4,5,3,1,2,0,15
1203,796615,1,0,0,0,0,0,0,0,0,0,0,0,0,0,0,0,0
1203,792429,9,3,3,3,3,0,0,2,2,0,1,0,1,0,0,0,8
1203,796619,1,0,2,0,2,0,0,0,0,0,0,0,0,0,0,0,0
1203,796614,15,1,3,1,2,0,1,1,2,0,1,3,1,0,1,0,3
1203,796608,1,0,0,0,0,0,0,0,0,0,0,0,0,0,0,0,0
1203,796607,22,5,8,4,6,1,2,3,7,2,12,1,4,0,0,0,14
1203,799543,1,0,0,0,0,0,0,0,0,0,0,0,1,0,0,0,0
1204,785423,36,6,11,3,7,3,4,1,2,3,8,0,3,1,2,0,16
1204,775676,30,5,10,5,10,0,0,2,2,2,7,3,4,0,1,4,12
1204,786298,38,4,12,2,7,2,5,2,2,0,5,6,0,1,0,1,12
1204,785425,39,7,13,6,10,1,3,0,0,2,8,2,1,0,1,0,15
1204,785422,40,6,16,2,6,4,10,2,3,0,3,8,1,1,3,0,18
1204,796431,2,0,1,0,1,0,0,0,0,1,2,0,1,0,0,0,0
1204,796429,15,2,2,1,1,1,1,0,0,0,0,0,2,0,1,0,5
1205,786795,30,1,4,1,1,0,3,0,0,3,7,3,2,0,0,2,2
1205,789020,40,7,17,4,11,3,6,1,1,2,4,1,2,1,2,0,18
1205,792091,30,5,13,3,8,2,5,3,3,0,5,1,2,0,1,0,15
1205,786787,40,5,19,3,9,2,10,2,2,0,3,3,2,1,1,0,14
1205,774954,37,5,12,5,9,0,3,2,3,1,6,2,5,2,3,0,12
1205,781456,21,3,5,3,5,0,0,0,1,3,3,3,1,1,0,0,6
1205,774815,1,0,0,0,0,0,0,0,0,0,0,0,0,0,0,0,0
1205,796876,1,1,1,0,0,1,1,0,0,0,0,0,0,0,0,0,3
1206,780283,20,2,4,2,4,0,0,0,0,0,2,2,1,1,1,0,4
1206,790925,32,5,9,3,5,2,4,0,3,0,6,2,0,1,3,0,12
1206,785476,29,5,7,5,7,0,0,1,2,1,3,12,0,0,1,0,11
1206,785474,30,1,5,1,3,0,2,1,2,2,3,2,3,0,1,0,3
1206,780285,31,7,12,4,8,3,4,4,5,1,3,1,2,2,4,0,21
1206,780292,21,4,6,4,6,0,0,2,3,2,5,2,2,1,0,0,10
1206,790926,16,2,3,2,2,0,1,0,0,0,2,1,1,0,0,0,4
1206,785480,16,4,4,1,1,3,3,0,0,0,1,1,0,1,0,0,11
1206,796470,5,0,0,0,0,0,0,0,0,0,0,0,1,0,1,0,0
1207,785532,23,1,2,1,2,0,0,0,0,2,3,1,2,0,0,0,2
1207,780063,29,3,8,1,3,2,5,0,0,0,2,0,3,0,2,0,8
1207,791055,31,1,2,1,1,0,1,0,1,0,1,5,2,2,2,0,2
1207,785530,23,5,12,4,9,1,3,1,2,0,3,0,1,0,1,0,12
1207,775926,35,5,11,3,3,2,8,0,0,0,4,0,2,0,5,0,12
1207,791058,10,1,1,1,1,0,0,0,0,0,1,0,1,1,0,0,2
1207,791059,7,0,0,0,0,0,0,0,0,0,2,1,0,0,0,0,0
1207,791056,11,1,2,1,1,0,1,2,2,1,2,1,4,0,1,0,4
1207,775573,24,5,10,1,3,4,7,0,0,0,1,3,1,0,1,0,14
1207,791057,5,0,1,0,0,0,1,0,0,0,0,0,2,0,1,0,0
1207,796734,2,0,0,0,0,0,0,0,0,0,0,0,0,0,0,0,0
1210,781158,10,3,4,3,4,0,0,0,1,1,1,0,3,0,0,1,6
1210,781652,35,8,10,7,8,1,2,0,0,2,4,6,3,0,5,0,17
1210,786034,32,7,12,4,6,3,6,3,4,0,2,2,2,1,1,0,20
1210,786419,30,6,7,2,3,4,4,2,2,0,6,4,3,0,5,0,18
1210,781283,25,2,7,1,2,1,5,2,2,0,0,5,2,2,4,0,7
1210,791614,8,0,2,0,2,0,0,0,0,0,1,1,0,0,0,0,0
1210,781653,27,7,8,7,8,0,0,5,8,4,5,1,3,1,1,3,19
1210,796993,11,1,3,0,0,1,3,0,0,0,0,0,0,0,1,0,3
1210,791615,22,1,3,1,2,0,1,0,0,0,4,1,2,0,3,1,2
1211,791299,29,4,8,4,7,0,1,0,1,1,4,0,2,1,1,1,8
1211,791296,34,6,13,2,5,4,8,3,4,1,3,0,3,2,4,0,19
1211,775871,26,3,8,2,7,1,1,3,4,5,2,1,0,1,2,0,10
1211,791298,34,0,7,0,5,0,2,4,6,1,0,3,5,1,2,0,4
1211,791519,32,7,18,3,11,4,7,2,2,1,2,6,2,2,2,0,20
1211,786276,6,0,1,0,0,0,1,0,0,0,1,0,0,0,0,0,0
1211,780525,3,0,0,0,0,0,0,1,2,1,0,0,0,0,0,0,1
1211,796593,3,1,3,1,3,0,0,0,0,3,1,0,1,0,2,0,2
1211,781390,33,7,7,6,6,1,1,2,2,2,1,1,3,3,1,0,17
1211,796591,0,0,1,0,1,0,0,0,0,0,0,0,0,0,0,0,0
1212,785589,29,6,16,6,16,0,0,4,4,6,5,0,3,1,1,1,16
1212,791216,26,2,5,1,4,1,1,2,2,0,3,4,4,3,2,0,7
1212,791215,20,2,5,0,1,2,4,0,0,0,2,4,1,1,4,0,6
1212,791214,34,3,8,1,4,2,4,2,2,0,3,8,1,0,2,1,10
1212,776313,39,7,13,5,9,2,4,1,2,1,5,1,0,2,0,1,17
1212,791213,34,8,11,2,4,6,7,0,0,0,4,3,0,0,4,0,22
1212,776364,10,0,4,0,2,0,2,0,0,0,1,3,2,1,2,0,0
1212,791209,10,1,2,1,2,0,0,2,2,2,0,0,3,0,0,2,4
1212,796917,11,1,3,1,2,0,1,0,0,0,1,0,1,0,3,0,2
1212,791207,6,0,0,0,0,0,0,1,2,0,2,0,2,0,0,1,1
1212,791210,6,1,1,0,0,1,1,0,0,1,0,1,1,0,0,1,3
1213,797431,23,6,10,4,5,2,5,0,0,0,4,2,5,1,0,0,14
1213,791356,41,4,8,4,7,0,1,3,5,4,3,1,1,2,4,0,11
1213,791680,15,0,3,0,3,0,0,2,2,0,0,0,0,0,0,0,2
1213,785815,43,7,18,4,9,3,9,11,15,2,5,2,2,1,4,0,28
1213,780104,40,4,11,3,7,1,4,3,3,0,4,4,4,3,6,0,12
1213,791681,28,2,4,2,4,0,0,2,3,3,5,1,2,0,2,6,6
1213,791682,3,0,1,0,1,0,0,0,0,0,1,0,0,0,0,0,0
1213,791684,32,2,4,1,1,1,3,0,0,0,3,0,2,2,3,0,5
1214,786090,33,5,13,4,8,1,5,8,9,3,6,2,1,2,1,0,19
1214,774921,27,7,11,5,8,2,3,0,0,1,2,2,5,0,4,0,16
1214,786088,36,3,7,3,6,0,1,4,4,0,4,7,3,1,4,0,10
1214,791135,20,3,8,3,8,0,0,1,4,2,4,1,5,0,2,1,7
1214,791131,26,1,4,0,2,1,2,0,0,3,3,0,3,0,4,0,3
1214,796790,26,3,6,0,2,3,4,7,7,0,2,2,1,0,3,0,16
1214,791521,16,2,2,2,2,0,0,0,0,0,0,0,3,0,1,3,4
1214,786097,1,1,1,1,1,0,0,0,0,0,0,0,0,0,0,0,2
1214,791132,15,0,0,0,0,0,0,1,2,0,4,0,0,0,2,0,1
1215,774985,35,8,14,7,10,1,4,2,3,0,1,0,5,0,3,0,19
1215,782157,32,4,7,4,6,0,1,2,4,2,2,6,2,2,1,0,10
1215,789025,33,2,7,2,4,0,3,5,8,1,3,1,5,1,1,0,9
1215,780193,20,2,10,2,9,0,1,0,0,0,1,0,4,1,1,0,4
1215,798153,15,2,3,2,3,0,0,0,0,2,2,0,2,0,3,0,4
1215,792670,21,3,7,1,2,2,5,2,4,0,6,0,3,1,2,0,10
1215,792669,8,0,1,0,1,0,0,2,2,0,0,2,0,0,2,0,2
1215,775276,10,0,2,0,0,0,2,0,0,0,0,1,2,1,0,0,0
1215,792666,2,0,0,0,0,0,0,0,0,1,0,0,0,0,0,0,0
1215,798152,1,0,0,0,0,0,0,0,0,0,0,0,1,0,0,0,0
1215,786163,23,3,7,1,3,2,4,5,5,1,3,0,4,0,2,0,13
1216,792253,5,1,1,1,1,0,0,0,0,0,1,0,0,0,1,0,2
1216,781430,33,13,21,9,15,4,6,1,2,5,16,7,0,1,1,0,31
1216,792250,21,1,7,0,5,1,2,0,0,1,3,3,1,1,0,1,3
1216,792248,21,4,9,0,1,4,8,3,3,1,3,3,2,0,1,1,15
1216,781445,24,4,9,1,3,3,6,0,0,2,1,2,0,0,1,0,11
1216,797957,11,0,2,0,2,0,0,0,0,0,1,0,0,0,0,0,0
1216,792249,20,4,6,4,5,0,1,0,2,4,3,2,1,2,2,1,8
1216,781448,11,0,2,0,2,0,0,0,0,2,1,3,0,0,0,0,0
1216,797944,7,1,1,0,0,1,1,0,1,0,0,0,0,2,0,0,3
1216,797941,19,4,4,2,2,2,2,1,2,1,1,0,2,0,0,0,11
1216,792251,8,2,5,0,1,2,4,2,2,0,0,0,1,0,0,1,8
1216,786076,20,1,4,0,2,1,2,1,2,2,0,5,0,0,1,0,4
1218,776200,25,8,10,8,10,0,0,0,0,0,5,1,3,3,4,0,16
1218,781034,33,4,12,3,8,1,4,2,2,1,2,3,3,1,2,0,11
1218,780925,28,4,5,1,1,3,4,0,0,0,5,4,1,1,2,0,11
1218,780446,14,1,3,1,1,0,2,0,0,0,2,0,1,1,1,0,2
1218,796980,13,1,2,1,2,0,0,0,1,1,0,0,1,0,0,0,2
1218,796979,23,6,9,4,6,2,3,0,0,1,6,1,4,0,1,1,14
1218,785620,34,4,12,2,7,2,5,0,3,0,0,5,2,0,3,0,10
1218,791625,8,1,3,1,3,0,0,0,0,4,1,0,1,0,2,0,2
1218,791624,6,0,1,0,1,0,0,2,3,0,1,1,1,0,0,1,2
1218,791622,11,0,0,0,0,0,0,0,0,0,0,1,2,0,1,0,0
1218,786437,5,0,1,0,1,0,0,0,0,0,0,0,2,0,0,0,0
1219,775574,35,6,19,4,10,2,9,6,6,0,2,1,0,1,5,0,20
1219,786066,37,5,9,4,7,1,2,7,7,2,11,4,1,0,3,0,18
1219,780890,36,6,12,4,7,2,5,3,5,3,2,2,3,0,2,0,17
1219,775757,11,3,5,3,4,0,1,1,2,1,0,0,4,0,1,0,7
1219,785636,33,2,7,1,3,1,4,0,2,0,6,5,2,5,1,0,5
1219,785969,15,3,3,3,3,0,0,2,2,1,0,1,2,0,2,0,8
1219,791123,19,1,1,0,0,1,1,0,0,0,1,0,1,0,1,0,3
1219,791119,14,0,0,0,0,0,0,2,2,1,2,2,0,0,1,0,2
1220,775455,20,3,7,3,6,0,1,0,0,0,3,2,0,1,3,0,6
1220,792124,22,7,11,7,11,0,0,3,8,2,5,1,2,1,2,0,17
1220,797749,20,2,5,2,4,0,1,0,1,2,2,0,3,0,1,0,4
1220,792120,26,4,6,4,6,0,0,0,1,1,7,2,0,1,2,0,8
1220,792123,22,2,7,1,4,1,3,2,2,0,3,3,0,1,1,0,7
1220,792119,23,1,3,1,2,0,1,0,0,0,5,0,2,0,5,0,2
1220,797752,21,1,3,1,3,0,0,3,7,1,3,3,2,4,0,3,5
1220,797747,12,1,2,1,1,0,1,0,2,0,1,0,2,0,3,0,2
1220,786008,13,1,3,1,3,0,0,0,0,0,1,0,0,0,0,0,2
1220,786005,21,3,4,2,3,1,1,2,3,0,3,0,1,2,0,0,9
1222,791230,35,10,16,4,4,6,12,3,3,1,4,1,3,1,0,0,29
1222,785557,27,6,9,6,7,0,2,1,2,3,6,2,4,7,0,0,13
1222,796932,31,4,16,3,10,1,6,0,0,2,1,6,1,4,4,0,9
1222,785624,32,2,8,1,2,1,6,0,0,0,1,2,2,2,2,0,5
1222,791228,24,2,6,1,2,1,4,0,0,1,1,4,2,2,1,0,5
1222,791227,19,2,4,1,1,1,3,0,0,0,0,1,0,1,0,0,5
1222,785556,19,1,5,1,4,0,1,2,2,0,1,0,1,0,3,0,4
1222,791226,13,0,1,0,1,0,0,1,4,1,1,0,1,0,1,0,1
1223,797292,28,6,8,6,8,0,0,1,4,1,6,2,4,0,3,1,13
1223,780509,27,5,6,4,4,1,2,0,2,0,1,1,2,0,3,2,11
1223,797290,30,4,7,3,3,1,4,1,2,0,7,2,0,1,4,0,10
1223,791660,34,2,4,2,2,0,2,0,0,0,2,5,1,0,5,0,4
1223,791661,12,0,2,0,2,0,0,0,0,1,1,0,1,0,3,0,0
1223,797291,26,5,5,4,4,1,1,2,3,0,5,7,0,1,1,0,13
1223,786064,26,4,7,1,3,3,4,0,0,0,3,1,4,1,5,0,11
1223,791658,11,2,3,2,3,0,0,0,0,1,0,1,1,0,1,1,4
1223,797293,6,1,1,1,1,0,0,0,0,0,1,2,0,0,0,0,2
1224,785335,17,2,3,2,3,0,0,0,0,1,10,0,0,1,0,3,4
1224,780303,29,7,12,7,12,0,0,3,4,2,4,0,2,0,0,1,17
1224,791594,27,2,3,1,2,1,1,2,2,0,4,5,3,0,1,0,7
1224,791012,24,5,11,1,3,4,8,0,0,0,2,1,2,2,2,0,14
1224,781385,21,4,7,2,3,2,4,0,0,1,3,4,4,1,1,0,10
1224,791011,16,1,1,0,0,1,1,0,0,1,4,1,1,0,0,0,3
1224,785337,18,5,6,5,5,0,1,9,13,3,2,1,0,2,2,0,19
1224,786349,12,3,5,1,3,2,2,0,0,0,2,1,1,0,0,0,8
1224,781221,22,2,7,1,1,1,6,0,0,0,1,3,2,0,3,0,5
1224,796670,2,0,0,0,0,0,0,0,0,0,1,0,0,0,0,0,0
1224,796668,3,2,3,2,2,0,1,2,2,0,0,0,1,0,1,0,6
1224,791013,5,1,2,1,2,0,0,0,0,0,0,0,1,1,0,0,2
1224,796671,3,0,0,0,0,0,0,0,0,2,0,2,0,0,0,0,0
1224,796669,1,0,0,0,0,0,0,0,0,0,0,0,0,0,0,0,0
1226,786289,29,12,16,5,7,7,9,2,2,0,3,2,1,3,1,0,33
1226,796332,26,2,5,2,2,0,3,1,6,0,3,6,3,1,2,3,5
1226,785813,22,3,6,2,4,1,2,2,4,0,3,3,3,1,2,0,9
1226,785827,23,6,6,6,6,0,0,5,5,3,8,0,2,0,1,0,17
1226,790776,19,0,0,0,0,0,0,1,2,1,3,0,2,0,1,4,1
1226,796337,21,0,2,0,2,0,0,1,2,0,1,5,0,0,0,0,1
1226,796330,21,3,5,1,2,2,3,3,4,1,4,4,2,0,2,0,11
1226,796334,11,1,1,1,1,0,0,1,2,1,0,0,5,0,0,0,3
1226,779975,13,2,2,2,2,0,0,2,2,1,2,0,4,0,2,2,6
1226,779973,3,0,0,0,0,0,0,0,0,0,1,1,0,0,0,0,0
1226,796333,6,2,3,0,0,2,3,0,0,0,2,0,0,0,1,0,6
1226,796335,2,0,0,0,0,0,0,1,2,0,0,0,0,0,0,0,1
1226,796213,2,1,2,0,0,1,2,0,0,0,0,0,0,0,0,1,3
1226,796338,2,0,0,0,0,0,0,0,0,0,1,0,0,0,0,0,0
1227,781561,20,2,5,2,4,0,1,1,2,0,4,3,5,1,2,0,5
1227,791895,17,0,2,0,1,0,1,2,2,1,0,0,3,1,0,0,2
1227,781078,19,1,5,1,3,0,2,2,4,0,0,0,2,0,1,0,4
1227,786502,33,5,15,4,11,1,4,4,6,1,4,2,0,1,4,0,15
1227,781080,32,6,12,3,4,3,8,1,1,0,2,0,2,0,1,0,16
1227,797587,16,1,6,1,6,0,0,1,1,2,1,1,3,0,1,0,3
1227,791891,15,1,2,1,2,0,0,1,4,1,1,0,1,1,0,0,3
1227,786501,15,2,8,1,4,1,4,0,0,0,1,0,2,0,1,0,5
1227,797584,19,0,2,0,2,0,0,0,0,1,0,2,2,0,1,0,0
1227,797586,11,0,2,0,2,0,0,0,0,1,0,0,5,0,0,0,0
1227,791894,3,0,0,0,0,0,0,0,0,0,0,0,0,0,0,0,0
1228,791837,28,4,8,3,6,1,2,3,5,0,7,0,2,0,1,0,12
1228,780613,25,3,5,3,5,0,0,5,8,1,5,1,3,0,0,0,11
1228,775097,23,6,10,5,9,1,1,2,3,3,1,2,3,0,3,0,15
1228,780609,38,6,14,2,7,4,7,2,3,0,5,6,1,5,1,0,18
1228,776395,36,3,12,2,7,1,5,1,1,0,0,1,2,1,2,0,8
1228,786621,15,0,2,0,1,0,1,0,0,1,3,3,1,0,0,1,0
1228,786619,11,2,2,1,1,1,1,0,0,0,2,0,0,0,0,1,5
1228,786622,23,4,5,4,4,0,1,0,0,1,1,0,1,1,2,1,8
1228,797437,1,0,0,0,0,0,0,0,0,0,0,0,0,0,0,0,0
1229,792041,26,3,7,1,1,2,6,0,0,0,8,2,5,1,2,1,8
1229,786054,31,9,12,8,10,1,2,1,3,3,7,2,4,3,7,0,20
1229,791964,37,2,9,0,4,2,5,0,0,1,4,0,2,0,0,0,6
1229,781339,40,5,13,2,3,3,10,2,4,0,4,5,1,0,0,0,15
1229,781337,39,7,15,3,5,4,10,3,4,1,1,4,1,1,2,0,21
1229,797713,7,1,2,1,1,0,1,0,0,0,1,0,1,1,1,0,2
1229,797712,20,0,3,0,3,0,0,0,0,7,2,1,5,0,2,0,0
1230,796870,19,1,2,1,2,0,0,0,0,1,3,0,1,0,2,0,2
1230,786861,35,5,11,5,8,0,3,0,2,5,6,2,1,0,1,3,10
1230,792415,25,6,12,5,8,1,4,0,0,2,5,0,4,2,1,0,13
1230,780387,37,2,8,2,6,0,2,4,5,1,3,1,3,2,1,0,8
1230,767033,33,5,9,4,6,1,3,4,7,0,2,6,3,4,1,1,15
1230,792416,5,0,0,0,0,0,0,2,2,0,0,2,0,0,0,0,2
1230,786867,22,3,8,2,3,1,5,0,1,0,1,1,1,0,0,0,7
1230,786866,20,3,8,1,1,2,7,0,0,1,3,1,1,1,0,0,8
1230,796869,1,0,0,0,0,0,0,0,0,0,0,0,1,0,0,0,0
1230,796868,1,1,1,1,1,0,0,0,0,0,0,0,0,0,0,0,2
1230,786865,1,0,0,0,0,0,0,0,0,0,0,0,0,0,0,0,0
1230,796867,1,0,0,0,0,0,0,0,0,0,0,0,0,0,0,0,0
1230,785801,0,0,0,0,0,0,0,0,0,0,0,0,0,0,0,0,0
1231,796955,18,1,1,1,1,0,0,0,0,0,2,0,0,1,2,1,2
1231,780900,21,3,6,2,4,1,2,0,0,2,5,2,4,0,0,0,7
1231,781606,33,2,12,2,7,0,5,0,0,0,1,2,5,0,5,0,4
1231,781263,30,7,11,6,7,1,4,1,2,0,2,0,2,0,3,0,16
1231,781257,37,6,12,6,9,0,3,0,0,1,5,0,0,2,0,0,12
1231,791255,10,0,0,0,0,0,0,0,0,0,0,0,1,0,0,0,0
1231,791257,26,1,4,1,3,0,1,2,4,1,7,2,1,1,0,3,4
1231,796954,22,2,7,1,2,1,5,1,2,0,3,1,1,0,1,0,6
1231,785508,2,1,2,0,0,1,2,0,0,0,0,0,0,0,0,0,3
1231,796029,1,0,0,0,0,0,0,0,0,0,0,0,1,0,0,0,0
1232,791117,27,6,10,5,8,1,2,1,2,2,5,2,2,1,1,0,14
1232,791118,33,4,9,1,4,3,5,1,2,1,5,4,2,1,4,1,12
1232,774974,33,5,8,5,5,0,3,0,0,0,6,4,1,2,1,0,10
1232,785676,33,4,12,2,6,2,6,0,0,0,2,4,0,0,0,0,10
1232,780824,20,4,5,4,5,0,0,0,0,4,5,1,2,0,0,0,8
1232,796769,12,3,5,0,1,3,4,2,2,0,0,1,1,0,0,0,11
1232,791116,22,1,5,1,2,0,3,4,6,0,3,3,1,0,2,1,6
1232,796771,10,3,4,3,4,0,0,0,0,2,3,1,2,0,1,0,6
1232,791115,7,0,0,0,0,0,0,1,2,0,3,1,4,0,1,4,1
1232,794654,3,0,0,0,0,0,0,0,0,0,1,0,0,0,0,0,0
1233,768880,19,3,9,0,1,3,8,0,0,0,2,0,2,0,2,0,9
1233,798968,26,2,8,1,3,1,5,0,0,0,5,2,1,0,2,1,5
1233,791718,31,1,8,0,5,1,3,0,0,1,4,2,0,0,1,0,3
1233,787996,17,0,3,0,3,0,0,3,4,2,4,0,0,1,0,1,3
1233,798965,13,0,2,0,2,0,0,0,0,0,0,0,3,1,1,0,0
1233,791720,16,2,5,2,3,0,2,2,3,0,3,0,1,0,1,0,6
1233,798963,19,2,6,1,3,1,3,0,0,0,2,1,0,0,2,0,5
1233,791719,16,2,7,1,3,1,4,0,0,0,1,1,0,0,1,0,5
1233,798966,19,1,3,1,3,0,0,0,0,1,2,0,2,1,2,0,2
1233,791717,7,0,1,0,0,0,1,2,2,0,0,0,0,1,0,0,2
1233,798967,9,0,0,0,0,0,0,0,0,0,0,0,0,0,0,0,0
1233,798964,7,0,1,0,1,0,0,0,0,1,0,0,1,0,0,0,0
1233,798969,1,0,0,0,0,0,0,0,0,0,0,0,0,0,0,0,0
1234,797616,19,3,7,3,4,0,3,1,1,1,2,2,3,0,2,0,7
1234,791882,33,4,7,3,5,1,2,1,2,0,6,2,3,0,2,1,10
1234,786491,30,5,8,3,6,2,2,2,2,1,5,1,3,0,2,0,14
1234,791881,36,5,8,0,1,5,7,0,0,0,1,8,2,0,3,1,15
1234,786420,29,8,13,4,4,4,9,0,0,0,3,4,3,1,2,1,20
1234,797618,8,1,4,1,3,0,1,0,1,0,1,0,1,0,0,0,2
1234,797613,9,0,3,0,1,0,2,0,0,0,3,0,0,0,3,0,0
1234,781258,12,1,1,0,0,1,1,0,0,0,0,0,2,0,1,0,3
1234,781052,24,2,6,0,0,2,6,0,0,0,4,0,1,0,0,0,6
1235,776253,33,5,14,4,13,1,1,2,3,1,9,5,0,1,0,0,13
1235,775651,22,8,10,8,10,0,0,3,5,1,1,0,4,0,2,0,19
1235,791070,29,4,8,2,5,2,3,0,0,2,3,2,0,2,2,0,10
1235,791627,34,5,11,4,9,1,2,0,0,4,1,2,1,1,0,0,11
1235,776178,19,1,4,1,4,0,0,2,5,0,2,1,2,0,0,0,4
1235,796505,10,1,4,1,4,0,0,1,2,1,1,0,1,1,1,0,3
1235,791071,3,0,0,0,0,0,0,0,0,1,0,0,0,0,0,0,0
1235,785660,6,0,1,0,1,0,0,0,0,0,0,0,0,0,2,0,0
1235,796504,4,0,0,0,0,0,0,1,2,0,2,0,1,0,0,0,1
1235,796502,12,2,2,2,2,0,0,0,0,4,1,2,2,1,1,0,4
1235,796501,6,1,3,1,2,0,1,0,0,0,0,0,1,0,0,0,2
1235,785665,22,4,8,2,2,2,6,2,4,0,1,2,1,2,2,0,12
1236,791777,34,11,13,11,13,0,0,7,10,1,8,8,2,1,3,1,29
1236,786476,21,4,8,4,8,0,0,0,2,0,2,0,1,0,1,1,8
1236,781025,19,2,4,1,3,1,1,3,4,1,2,0,2,2,2,0,8
1236,791780,28,1,7,0,4,1,3,1,2,2,3,2,1,0,3,0,4
1236,791783,15,1,3,1,3,0,0,0,0,2,2,0,1,0,0,0,2
1236,791776,35,4,5,1,1,3,4,1,2,0,7,0,1,1,2,0,12
1236,776285,17,4,5,4,5,0,0,1,4,2,2,0,4,0,3,1,9
1236,775503,19,1,6,1,2,0,4,0,0,0,3,0,2,0,0,1,2
1236,797612,9,1,1,1,1,0,0,0,0,0,0,2,0,0,0,0,2
1236,791781,2,0,0,0,0,0,0,0,0,0,0,0,1,1,0,0,0
1236,791778,1,0,0,0,0,0,0,0,0,0,0,0,0,1,0,0,0
1237,792492,34,8,17,7,13,1,4,4,5,6,5,0,1,1,2,0,21
1237,792493,28,5,13,0,0,5,13,1,2,0,0,0,1,0,1,1,16
1237,792495,34,3,15,2,9,1,6,3,4,1,3,2,2,2,2,1,10
1237,792491,37,0,3,0,3,0,0,3,4,2,4,10,3,0,4,1,3
1237,788128,6,1,3,1,1,0,2,0,0,0,0,0,0,0,0,0,2
1237,781144,26,3,8,3,4,0,4,0,0,0,2,0,1,0,0,0,6
1237,792490,19,1,4,0,0,1,4,0,0,1,0,0,2,1,0,0,3
1237,780023,16,1,1,1,1,0,0,1,2,0,3,0,5,1,1,3,3
1238,791051,10,2,2,2,2,0,0,2,5,1,4,1,1,0,1,0,6
1238,780739,20,4,7,4,7,0,0,1,2,3,3,1,0,2,1,2,9
1238,786310,20,2,7,2,5,0,2,0,0,0,2,3,0,1,1,0,4
1238,785524,16,6,8,6,7,0,1,0,0,1,0,1,1,1,1,0,12
1238,781115,25,1,5,1,5,0,0,3,4,0,1,6,2,3,1,0,5
1238,796731,15,1,3,1,2,0,1,3,4,2,2,0,2,1,1,0,5
1238,796730,13,7,14,0,4,7,10,0,0,1,5,0,0,2,0,1,21
1238,791053,17,2,2,2,2,0,0,5,5,2,1,1,4,0,2,0,9
1238,785784,10,0,1,0,1,0,0,0,0,3,0,1,2,0,1,0,0
1238,791052,9,1,3,1,3,0,0,2,4,2,3,0,2,0,0,1,4
1238,775094,31,4,8,3,6,1,2,4,5,0,11,1,0,1,3,1,13
1238,775456,14,2,2,2,2,0,0,2,2,1,1,4,1,0,2,0,6
1240,780094,30,6,10,3,5,3,5,2,2,2,8,1,3,0,2,1,17
1240,775142,31,8,18,7,15,1,3,1,3,1,3,2,2,0,4,1,18
1240,790842,16,1,4,1,4,0,0,1,2,0,5,0,1,2,2,0,3
1240,790843,34,1,5,1,3,0,2,1,1,2,6,3,1,0,2,2,3
1240,781563,26,0,3,0,2,0,1,0,0,0,1,5,0,1,2,1,0
1240,790844,13,4,8,4,8,0,0,0,0,0,1,0,2,1,0,0,8
1240,796914,19,3,6,1,2,2,4,0,0,0,4,0,2,1,0,0,8
1240,786212,31,5,9,3,3,2,6,0,0,2,8,3,5,0,2,0,12
1241,781244,27,1,5,1,4,0,1,2,6,1,12,0,4,0,0,2,4
1241,785529,32,4,11,2,5,2,6,0,0,0,3,2,1,1,3,0,10
1241,781243,22,0,3,0,0,0,3,0,0,1,3,0,3,1,1,0,0
1241,781237,15,0,0,0,0,0,0,0,1,0,2,2,0,0,0,0,0
1241,776205,32,5,16,5,10,0,6,5,6,0,3,3,0,0,2,1,15
1241,791243,8,0,0,0,0,0,0,0,0,0,0,2,1,0,2,0,0
1241,791241,24,3,9,3,7,0,2,0,0,0,2,0,0,2,1,1,6
1241,791245,32,4,10,3,4,1,6,2,2,0,2,0,0,0,2,0,11
1241,791246,8,2,3,0,1,2,2,0,0,0,0,0,1,1,0,0,6
1242,775913,28,5,9,5,9,0,0,6,8,5,3,5,3,1,0,1,16
1242,791737,29,4,10,3,6,1,4,3,4,1,2,5,4,3,2,0,12
1242,783524,30,7,13,4,6,3,7,2,2,0,0,3,0,1,2,0,19
1242,786223,20,1,5,1,2,0,3,1,2,1,2,0,0,0,1,0,3
1242,780561,29,3,10,0,4,3,6,0,0,3,4,0,1,0,1,0,9
1242,797332,12,1,1,1,1,0,0,0,0,1,3,0,1,0,1,0,2
1242,797333,8,0,1,0,0,0,1,0,0,0,0,1,1,0,0,0,0
1242,797331,23,8,10,5,6,3,4,0,0,0,2,1,2,1,0,0,19
1242,786220,21,1,3,1,2,0,1,0,0,0,2,4,0,0,0,0,2
1243,780229,31,6,8,6,8,0,0,4,6,1,6,10,2,0,6,2,16
1243,795572,30,4,10,4,7,0,3,2,2,1,4,3,3,0,2,0,10
1243,791488,22,1,6,0,3,1,3,0,0,1,1,5,4,0,0,0,3
1243,786322,29,7,10,3,5,4,5,4,5,0,2,3,1,1,3,0,22
1243,780228,35,7,13,3,4,4,9,0,0,0,1,0,1,0,0,0,18
1243,791484,3,1,2,0,0,1,2,0,0,0,0,0,1,0,1,0,3
1243,781592,23,2,2,2,2,0,0,1,1,0,5,0,3,0,1,0,5
1243,786323,18,0,0,0,0,0,0,0,0,1,0,1,1,0,0,0,0
1243,791485,9,0,0,0,0,0,0,0,0,0,0,0,0,0,0,0,0
1244,775955,37,5,13,2,6,3,7,6,6,0,4,5,1,1,2,0,19
1244,786704,19,4,8,4,5,0,3,4,4,0,1,0,5,0,3,0,12
1244,775840,31,2,6,2,6,0,0,2,4,1,2,1,1,2,1,0,6
1244,785395,33,4,5,2,3,2,2,0,0,1,5,4,3,2,1,4,10
1244,775811,20,2,4,1,2,1,2,0,0,1,1,0,4,0,0,0,5
1244,790921,11,2,4,2,4,0,0,0,0,0,0,2,3,0,1,0,4
1244,786551,22,4,8,3,5,1,3,2,2,0,1,2,0,1,0,0,11
1244,792327,0,0,0,0,0,0,0,0,0,0,1,0,0,0,1,0,0
1244,775287,7,1,2,1,2,0,0,0,2,2,0,0,4,0,0,0,2
1244,786706,20,0,0,0,0,0,0,0,0,0,5,2,4,0,1,2,0
1245,780306,38,10,23,10,22,0,1,11,13,8,4,0,2,0,2,0,31
1245,786357,31,1,5,1,4,0,1,2,2,0,7,1,1,0,3,1,4
1245,780312,33,0,6,0,1,0,5,3,5,1,1,1,5,1,0,0,3
1245,797116,28,2,8,2,6,0,2,0,2,0,1,4,3,0,3,0,4
1245,775418,16,1,3,1,3,0,0,0,2,3,0,0,1,0,1,0,2
1245,775565,16,0,5,0,3,0,2,0,0,1,0,0,0,2,1,0,0
1245,791537,24,4,8,3,6,1,2,5,7,5,6,0,3,0,3,0,14
1245,786358,14,0,1,0,0,0,1,0,0,1,2,1,1,0,1,0,0
1252,791768,27,6,9,6,9,0,0,0,3,0,7,0,3,1,1,1,12
1252,786460,25,3,4,3,4,0,0,1,2,1,5,7,1,1,4,2,7
1252,780604,34,7,14,7,11,0,3,4,4,1,11,1,2,2,2,0,18
1252,780603,33,1,4,1,2,0,2,1,2,1,5,5,3,0,3,0,3
1252,780602,37,10,11,10,11,0,0,2,2,1,5,2,1,0,3,1,22
1252,786462,9,0,5,0,2,0,3,0,0,0,0,0,0,1,2,0,0
1252,791766,18,2,8,2,5,0,3,2,2,1,1,1,0,0,1,0,6
1252,791767,7,3,3,3,3,0,0,0,0,1,1,0,3,0,1,0,6
1252,786230,10,0,3,0,1,0,2,0,0,0,3,0,0,0,2,0,0
1254,781158,20,6,9,6,9,0,0,0,0,1,3,1,4,1,2,0,12
1254,781652,10,0,1,0,0,0,1,0,0,0,1,0,0,0,1,1,0
1254,786034,35,2,6,0,2,2,4,2,2,0,1,0,2,0,0,0,8
1254,786419,30,4,8,3,6,1,2,3,5,0,4,3,2,0,5,0,12
1254,781283,31,4,9,0,3,4,6,4,4,1,7,2,2,1,2,0,16
1254,791614,10,0,1,0,1,0,0,4,4,2,1,0,0,0,1,0,4
1254,785419,5,0,0,0,0,0,0,0,0,1,1,0,1,0,0,0,0
1254,781653,22,8,9,8,9,0,0,0,6,1,4,0,2,0,0,1,16
1254,796993,5,0,1,0,0,0,1,0,0,0,0,0,0,0,0,0,0
1254,796992,1,0,1,0,1,0,0,0,0,0,0,0,0,0,0,0,0
1254,791615,29,2,4,2,3,0,1,4,4,0,4,6,4,0,2,0,8
1254,796991,1,0,0,0,0,0,0,0,0,0,0,0,0,0,0,0,0
1254,796990,1,0,0,0,0,0,0,0,0,0,0,0,0,0,0,0,0
1255,785670,22,1,2,0,0,1,2,0,0,0,5,0,2,0,2,0,3
1255,774969,23,3,7,3,7,0,0,2,2,3,4,0,3,0,3,0,8
1255,791181,23,0,1,0,0,0,1,0,0,0,3,1,5,0,1,1,0
1255,781054,35,5,15,5,8,0,7,5,6,0,0,4,2,0,0,0,15
1255,781053,39,7,18,5,12,2,6,2,4,0,2,1,3,3,1,0,18
1255,796850,18,2,5,1,2,1,3,6,6,1,1,2,4,0,1,1,11
1255,780981,6,0,1,0,1,0,0,0,0,1,2,0,1,0,0,0,0
1255,796848,8,0,0,0,0,0,0,0,0,0,0,0,0,0,0,0,0
1255,791179,26,2,5,0,1,2,4,0,0,0,3,0,1,0,0,1,6
1256,791391,26,8,12,8,12,0,0,0,0,3,2,0,2,0,2,3,16
1256,797156,25,3,7,3,7,0,0,2,2,0,5,4,0,5,1,1,8
1256,791390,28,5,13,5,12,0,1,3,3,0,5,1,2,1,2,3,13
1256,780133,24,3,7,1,1,2,6,2,2,0,1,3,3,1,0,0,10
1256,780130,31,2,6,2,3,0,3,0,0,0,7,3,0,1,2,1,4
1256,797158,9,1,2,1,2,0,0,0,2,1,2,1,1,1,0,0,2
1256,791389,14,1,2,0,0,1,2,2,5,0,2,0,1,0,1,0,5
1256,775743,22,7,11,5,5,2,6,3,3,1,2,1,1,2,2,0,19
1256,776446,20,1,7,1,4,0,3,1,2,2,0,3,1,2,1,0,3
1256,797157,1,0,0,0,0,0,0,0,0,0,0,0,0,0,0,0,0
1258,780765,19,3,7,3,5,0,2,0,0,1,4,1,1,0,2,1,6
1258,781301,29,4,4,4,4,0,0,12,15,1,2,0,2,0,5,8,20
1258,786255,34,6,9,4,6,2,3,8,10,2,9,0,2,0,3,3,22
1258,780762,26,1,6,0,3,1,3,0,0,1,3,1,1,0,1,0,3
1258,780768,26,1,3,0,2,1,1,6,6,1,3,5,2,1,1,0,9
1258,791729,12,3,6,3,3,0,3,0,1,1,5,0,5,0,0,0,6
1258,797320,18,0,1,0,0,0,1,0,0,0,2,3,0,0,1,0,0
1258,780755,25,2,5,2,4,0,1,5,5,0,1,2,3,1,1,0,9
1258,797319,8,1,2,0,0,1,2,0,0,0,1,0,1,1,1,0,3
1258,798260,3,0,0,0,0,0,0,0,0,0,0,0,0,0,0,0,0
1259,792388,14,0,1,0,1,0,0,1,4,0,0,0,4,0,0,1,1
1259,797845,36,5,16,3,6,2,10,1,2,3,2,0,2,2,1,0,13
1259,797851,35,3,13,2,10,1,3,0,0,1,2,2,3,1,2,0,7
1259,792391,31,5,13,5,13,0,0,3,3,2,1,0,3,1,2,0,13
1259,792395,26,3,14,3,9,0,5,1,3,3,5,1,5,1,4,0,7
1259,792396,8,0,0,0,0,0,0,0,0,1,3,0,3,0,0,0,0
1259,781533,11,0,2,0,1,0,1,0,0,0,0,1,3,0,1,0,0
1259,781541,11,0,0,0,0,0,0,0,0,0,0,1,1,0,1,0,0
1259,780840,16,0,2,0,1,0,1,0,0,1,2,0,2,1,0,1,0
1259,792394,12,1,1,1,1,0,0,2,2,0,1,0,3,1,0,0,4
1260,796381,31,3,6,3,3,0,3,1,2,2,3,2,3,0,2,0,7
1260,775585,30,3,6,3,5,0,1,0,0,1,2,0,3,1,1,1,6
1260,790822,34,2,8,2,4,0,4,7,11,0,3,1,2,2,2,1,11
1260,790820,35,4,9,4,6,0,3,1,3,1,8,6,2,4,4,2,9
1260,774980,30,5,10,4,7,1,3,7,10,1,4,2,0,0,1,0,18
1260,790821,18,2,5,2,3,0,2,0,2,1,1,0,1,0,3,0,4
1260,780445,17,1,3,1,2,0,1,1,1,0,5,1,0,0,0,1,3
1260,775634,5,0,0,0,0,0,0,0,0,0,0,0,3,0,0,0,0
1261,785388,23,4,10,4,10,0,0,0,0,3,4,0,5,2,2,0,8
1261,780370,20,0,6,0,2,0,4,0,0,2,2,2,0,1,1,2,0
1261,790840,25,3,7,2,4,1,3,0,0,1,4,2,5,2,1,0,7
1261,790841,25,0,3,0,0,0,3,0,0,0,2,2,1,1,2,0,0
1261,780373,32,1,5,0,1,1,4,1,2,0,5,1,3,0,1,0,4
1261,796393,14,5,5,5,5,0,0,5,6,0,2,1,5,1,4,0,15
1261,790839,22,4,10,3,6,1,4,0,0,3,3,3,3,0,2,0,9
1261,785386,27,4,10,3,5,1,5,2,2,1,1,0,1,1,0,0,11
1261,796396,12,0,4,0,2,0,2,0,0,1,2,0,0,0,0,0,0
1262,786723,32,3,9,2,7,1,2,4,6,0,4,3,1,0,3,0,11
1262,792351,30,4,7,2,4,2,3,0,0,0,4,2,4,0,0,0,10
1262,792349,21,6,11,5,9,1,2,0,0,0,2,2,0,1,1,0,13
1262,792352,29,5,8,3,5,2,3,0,0,0,1,5,3,5,1,0,12
1262,792355,25,5,10,3,5,2,5,1,2,2,3,0,1,1,1,0,13
1262,798060,24,5,6,4,5,1,1,3,4,0,1,3,0,1,1,2,14
1262,786724,21,0,1,0,0,0,1,2,2,1,4,4,1,1,0,0,2
1262,798061,12,0,3,0,2,0,1,0,0,0,0,1,1,1,0,1,0
1262,786726,1,0,0,0,0,0,0,0,0,0,0,0,2,0,0,0,0
1262,792348,5,0,0,0,0,0,0,0,0,0,0,1,2,0,0,0,0
1263,791425,25,2,4,2,4,0,0,0,0,1,1,0,0,1,3,0,4
1263,791424,27,2,10,1,7,1,3,2,2,1,6,0,2,1,3,0,7
1263,791421,32,7,12,5,7,2,5,2,2,0,4,3,3,1,3,0,18
1263,797085,32,4,13,2,7,2,6,0,0,2,8,4,3,1,4,3,10
1263,785899,37,1,8,1,3,0,5,4,5,3,1,2,2,1,5,0,6
1263,785509,15,1,1,1,1,0,0,0,0,1,0,0,1,0,0,2,2
1263,797086,5,0,1,0,0,0,1,0,0,0,1,0,1,0,0,0,0
1263,797087,13,2,5,2,3,0,2,2,3,3,0,0,1,0,1,0,6
1263,797079,13,2,3,2,3,0,0,2,2,1,2,1,2,0,0,0,6
1263,797088,1,0,0,0,0,0,0,0,0,1,0,0,0,0,0,0,0
1264,775954,23,4,10,4,9,0,1,3,4,1,2,0,3,1,2,0,11
1264,781006,33,1,9,1,7,0,2,0,0,4,6,0,2,1,1,0,2
1264,796194,33,3,5,0,1,3,4,2,2,0,2,5,2,2,3,0,11
1264,790917,30,2,6,2,3,0,3,4,4,2,4,3,0,3,1,0,8
1264,781157,35,3,7,1,1,2,6,0,0,0,3,2,2,3,0,0,8
1264,780648,14,1,6,1,6,0,0,2,4,4,0,1,2,0,0,1,4
1264,796464,13,2,3,2,2,0,1,0,0,0,0,1,2,1,5,0,4
1264,796459,9,2,3,0,1,2,2,0,1,0,2,0,1,1,2,0,6
1264,790918,9,1,3,1,3,0,0,0,0,0,0,0,1,0,1,0,2
1264,785238,1,0,1,0,1,0,0,0,0,0,0,0,0,0,0,0,0
1265,775640,18,1,1,1,1,0,0,2,2,2,1,0,1,1,3,0,4
1265,780919,26,2,6,2,5,0,1,0,0,1,1,0,3,0,3,0,4
1265,791142,21,1,3,0,0,1,3,0,0,0,4,0,2,0,1,0,3
1265,791141,27,3,12,2,7,1,5,0,0,0,1,2,0,1,2,0,7
1265,780920,40,3,8,3,6,0,2,2,4,1,6,4,3,1,5,0,8
1265,780914,24,0,5,0,2,0,3,0,0,1,2,3,3,1,1,0,0
1265,775816,24,4,8,1,2,3,6,4,4,2,9,1,3,0,4,0,15
1265,796797,10,1,3,1,2,0,1,2,2,0,2,0,1,0,2,0,4
1265,796801,3,1,1,1,1,0,0,0,0,0,0,0,0,0,0,0,2
1265,796799,7,0,1,0,0,0,1,0,0,1,0,0,1,1,1,0,0
1266,796766,23,3,5,2,3,1,2,4,6,2,3,0,3,1,1,1,11
1266,780809,14,2,3,2,2,0,1,0,0,0,1,1,1,1,1,0,4
1266,796767,30,5,14,2,9,3,5,1,2,3,4,4,2,1,2,0,14
1266,791111,30,6,10,6,8,0,2,3,4,0,1,2,0,0,2,0,15
1266,780812,14,6,9,5,5,1,4,2,2,0,3,2,1,2,0,0,15
1266,785614,21,2,5,2,5,0,0,4,4,2,2,1,3,0,3,0,8
1266,796765,26,0,2,0,2,0,0,1,2,2,1,4,1,2,2,0,1
1266,785618,24,6,9,2,3,4,6,0,0,1,1,1,2,2,1,1,16
1266,780813,18,5,6,5,6,0,0,0,0,2,0,3,2,4,1,0,10
1268,797574,30,2,5,2,3,0,2,1,3,2,2,0,2,0,2,1,5
1268,797575,17,2,2,2,2,0,0,2,2,1,1,1,5,0,1,0,6
1268,786512,44,7,20,3,9,4,11,0,0,0,5,3,2,0,0,0,18
1268,786435,18,1,3,1,3,0,0,0,2,1,1,0,5,1,2,0,2
1268,786032,42,7,17,7,14,0,3,4,4,3,2,2,4,1,4,0,18
1268,797573,20,3,5,3,5,0,0,3,4,2,3,1,5,0,1,0,9
1268,791900,9,0,1,0,1,0,0,0,0,0,0,0,1,0,0,0,0
1268,780189,13,0,1,0,1,0,0,3,4,1,3,0,1,0,0,0,3
1268,797571,32,3,6,2,3,1,3,2,2,2,4,3,3,1,3,0,9
1269,780406,28,3,5,0,1,3,4,4,8,1,4,1,4,0,1,0,13
1269,775087,23,1,1,1,1,0,0,7,8,2,6,0,3,0,1,1,9
1269,790984,27,1,4,0,1,1,3,0,2,1,1,3,1,0,1,0,3
1269,780212,40,7,20,4,10,3,10,1,2,1,4,4,2,2,2,0,18
1269,767245,33,5,9,5,9,0,0,8,10,0,2,1,4,0,1,0,18
1269,780214,9,1,2,0,0,1,2,1,2,0,2,2,4,0,0,0,4
1269,790985,7,0,0,0,0,0,0,1,2,1,1,0,0,1,0,0,1
1269,780215,11,0,0,0,0,0,0,1,2,2,0,0,2,0,1,0,1
1269,796596,8,1,2,0,0,1,2,0,0,0,0,0,1,0,0,0,3
1269,791168,17,2,7,1,1,1,6,1,1,0,0,0,0,0,1,0,6
1269,785297,22,1,4,1,2,0,2,1,2,2,2,2,1,1,1,0,3
1270,785740,17,4,6,4,6,0,0,0,1,4,1,0,4,0,3,1,8
1270,785809,35,7,12,7,9,0,3,5,5,1,7,2,4,1,0,1,19
1270,780530,34,3,6,3,4,0,2,0,0,2,2,0,3,0,1,5,6
1270,785738,36,7,13,4,5,3,8,0,0,0,4,8,0,1,0,0,17
1270,781121,35,5,9,3,4,2,5,1,2,0,8,1,1,1,1,0,13
1270,797396,11,1,3,1,3,0,0,2,2,1,0,1,2,0,0,0,4
1270,797402,18,3,7,1,1,2,6,0,0,0,0,1,2,0,0,0,8
1270,797399,13,0,4,0,1,0,3,0,0,0,2,0,1,0,1,0,0
1270,785739,1,0,0,0,0,0,0,0,0,0,0,0,0,0,0,0,0
1271,786131,27,3,10,2,5,1,5,2,2,0,1,1,0,0,1,0,9
1271,780904,26,3,6,3,5,0,1,7,7,4,10,1,2,0,0,0,13
1271,797686,26,0,5,0,4,0,1,0,0,0,0,2,2,0,2,0,0
1271,797688,33,2,4,1,3,1,1,2,2,0,4,2,3,0,1,0,7
1271,786145,29,4,10,3,5,1,5,0,0,0,3,0,1,1,0,0,9
1271,792100,9,0,2,0,2,0,0,0,0,0,1,0,0,0,2,0,0
1271,797685,20,4,8,4,7,0,1,1,2,0,2,1,3,0,1,0,9
1271,792096,6,1,1,0,0,1,1,0,0,0,0,0,0,0,0,0,3
1271,775251,21,3,7,2,6,1,1,0,0,1,2,0,5,0,2,1,7
1271,797684,3,0,0,0,0,0,0,0,0,0,0,0,0,0,0,0,0
1272,797701,18,4,9,4,8,0,1,0,0,2,2,0,1,0,1,1,8
1272,780922,5,0,1,0,1,0,0,1,2,3,0,0,2,0,1,1,1
1272,792101,33,5,17,5,12,0,5,1,2,1,2,5,3,0,2,0,11
1272,780923,26,2,8,2,5,0,3,0,0,1,3,6,2,3,3,1,4
1272,775564,29,7,17,3,9,4,8,0,0,2,3,3,3,1,2,0,18
1272,797700,18,3,4,3,4,0,0,1,3,3,3,0,3,0,2,1,7
1272,797697,13,2,3,2,3,0,0,0,0,0,2,0,2,0,1,3,4
1272,792102,7,1,4,0,2,1,2,0,0,0,1,0,0,0,0,1,3
1272,786156,4,0,1,0,1,0,0,0,0,0,0,1,0,0,0,0,0
1272,786160,20,2,4,0,1,2,3,1,2,1,2,2,5,1,2,1,7
1272,776386,27,8,15,7,10,1,5,2,2,1,7,2,4,2,2,0,19
1272,797703,0,0,0,0,0,0,0,0,0,0,0,0,0,0,0,0,0
1272,792103,0,0,0,0,0,0,0,0,0,0,0,0,0,0,0,0,0
1273,791023,22,4,8,4,8,0,0,2,4,1,5,0,2,0,1,2,10
1273,791027,28,6,13,5,10,1,3,3,5,7,10,2,3,0,5,0,16
1273,791024,29,4,14,3,12,1,2,8,8,3,3,5,3,0,3,0,17
1273,781507,26,1,4,0,3,1,1,2,2,0,4,7,3,0,0,0,5
1273,777572,29,7,15,4,10,3,5,2,2,2,4,3,1,3,3,1,19
1273,791021,2,0,0,0,0,0,0,0,0,0,1,0,0,0,0,0,0
1273,791028,15,3,3,2,2,1,1,2,3,1,3,0,3,1,1,0,9
1273,796685,28,6,10,1,2,5,8,0,0,0,1,3,0,1,2,0,17
1273,796684,14,3,8,3,6,0,2,2,2,1,2,0,0,1,2,0,8
1273,796683,3,0,0,0,0,0,0,0,0,0,0,0,1,0,0,0,0
1273,791025,2,0,0,0,0,0,0,0,2,0,0,0,0,0,0,0,0
1273,791727,2,0,0,0,0,0,0,0,0,0,0,0,0,0,0,0,0
1274,781403,35,8,11,6,8,2,3,1,1,4,14,2,2,1,3,1,19
1274,792654,23,2,3,2,3,0,0,3,5,0,4,0,4,0,4,2,7
1274,780524,28,2,8,2,4,0,4,0,0,1,7,3,4,0,1,0,4
1274,781400,33,6,10,2,2,4,8,6,7,0,5,4,1,1,6,0,22
1274,775893,24,1,4,1,2,0,2,0,0,1,5,3,1,0,6,0,2
1274,797301,16,2,3,1,2,1,1,0,0,0,1,3,0,1,2,0,5
1274,786857,21,5,9,3,6,2,3,1,2,2,6,2,1,1,2,1,13
1274,797305,1,1,1,1,1,0,0,0,0,0,0,0,0,0,0,0,2
1274,797302,8,0,2,0,1,0,1,0,0,0,0,0,1,1,1,0,0
1274,797304,5,0,0,0,0,0,0,1,2,0,0,0,1,1,1,0,1
1274,797303,4,2,2,1,1,1,1,0,0,0,0,0,1,0,0,0,5
1274,797306,2,0,0,0,0,0,0,0,0,0,0,0,0,0,0,0,0
1275,796817,15,0,3,0,1,0,2,0,1,0,0,2,3,0,1,0,0
1275,780629,25,5,17,4,13,1,4,1,2,4,6,0,2,0,3,0,12
1275,796816,29,2,5,2,3,0,2,3,6,0,6,0,3,2,3,0,7
1275,785346,27,2,8,0,0,2,8,0,0,1,2,2,2,0,0,0,6
1275,775888,32,4,10,4,7,0,3,0,1,2,3,1,1,5,2,1,8
1275,792111,25,4,13,0,2,4,11,0,2,0,1,1,4,1,0,0,12
1275,796815,24,0,5,0,2,0,3,0,0,0,1,6,0,0,2,0,0
1275,791159,14,1,4,0,0,1,4,0,0,1,0,0,5,2,1,0,3
1275,796819,9,0,1,0,0,0,1,0,0,0,0,0,0,1,0,0,0
1276,787175,28,1,5,0,1,1,4,2,2,0,4,1,2,0,1,2,5
1276,782126,33,6,13,2,4,4,9,3,4,2,2,1,2,1,2,2,19
1276,796453,33,5,12,5,8,0,4,4,6,3,2,0,2,1,2,0,14
1276,790909,37,3,8,2,2,1,6,6,6,0,5,7,1,2,1,0,13
1276,781393,38,8,12,5,7,3,5,7,8,0,4,3,2,3,4,0,26
1276,796455,11,0,0,0,0,0,0,0,0,0,4,0,1,1,1,2,0
1276,790907,7,1,1,1,1,0,0,0,0,0,2,0,1,0,1,0,2
1276,775351,13,0,1,0,1,0,0,1,2,0,1,0,4,0,2,0,1
1278,776462,20,1,4,1,1,0,3,3,5,1,4,0,0,0,0,0,5
1278,785635,37,5,10,5,9,0,1,4,8,3,5,0,3,0,3,1,14
1278,786440,30,2,5,2,2,0,3,0,0,0,0,1,3,2,2,0,4
1278,786720,37,5,11,3,6,2,5,4,4,0,9,3,2,0,1,0,16
1278,781199,40,7,20,6,14,1,6,7,8,0,5,6,2,0,4,0,22
1278,791628,24,2,3,0,0,2,3,0,2,1,3,2,0,1,0,0,6
1278,775642,6,0,1,0,1,0,0,2,2,1,1,0,1,0,1,0,2
1278,791629,15,2,3,1,1,1,2,1,2,1,1,2,3,1,1,0,6
1278,796974,13,4,7,4,5,0,2,2,2,2,1,3,0,1,0,0,10
1278,786439,3,0,0,0,0,0,0,0,0,0,0,0,2,0,0,0,0
1279,790771,29,4,7,3,3,1,4,0,0,2,9,2,5,1,3,1,9
1279,780271,21,2,6,2,4,0,2,1,1,0,2,1,5,0,2,1,5
1279,790772,37,5,14,1,4,4,10,2,2,0,5,2,2,2,3,0,16
1279,785230,40,8,17,4,6,4,11,4,5,0,4,3,2,0,2,0,24
1279,780022,37,3,11,3,9,0,2,0,0,1,3,6,4,2,1,0,6
1279,780218,24,3,5,2,3,1,2,0,1,2,5,1,4,0,1,1,7
1279,796328,15,1,4,1,4,0,0,1,1,2,2,0,1,0,1,0,3
1279,780375,18,4,7,2,3,2,4,0,0,0,0,1,1,0,1,0,10
1279,796329,4,0,0,0,0,0,0,0,0,0,0,0,0,0,0,0,0
1280,780027,35,6,20,6,19,0,1,4,8,7,7,2,4,1,1,4,16
1280,786176,32,7,12,2,5,5,7,0,0,2,7,5,3,1,3,0,19
1280,786173,34,8,11,3,4,5,7,0,0,0,0,0,1,2,1,0,21
1280,780028,17,0,0,0,0,0,0,0,0,0,2,2,4,2,0,0,0
1280,774828,31,8,17,1,1,7,16,1,2,0,0,6,0,0,4,0,24
1280,791380,12,2,3,2,2,0,1,2,3,0,1,3,2,0,1,0,6
1280,791379,11,0,3,0,0,0,3,0,0,1,3,2,0,1,0,0,0
1280,780029,22,2,9,2,4,0,5,0,0,2,1,2,3,0,0,0,4
1280,797175,6,1,1,1,1,0,0,1,1,1,0,0,0,1,0,1,3
1281,790856,22,2,4,2,4,0,0,0,0,3,8,0,5,0,2,1,4
1281,780452,33,7,11,7,11,0,0,3,3,4,4,2,4,0,2,0,17
1281,796409,33,4,8,2,3,2,5,2,4,0,2,8,1,0,3,0,12
1281,796408,32,4,13,3,9,1,4,2,3,2,2,6,1,1,4,0,11
1281,796407,28,4,10,3,9,1,1,0,0,1,8,2,2,2,1,0,9
1281,796410,14,5,6,5,6,0,0,3,6,2,4,1,4,2,3,0,13
1281,796413,12,0,2,0,0,0,2,0,0,0,2,3,0,2,1,0,0
1281,780450,16,3,7,1,4,2,3,2,2,0,1,0,0,0,2,0,10
1281,796411,6,1,3,1,3,0,0,0,2,1,0,0,1,0,0,1,2
1281,796412,4,1,1,1,1,0,0,0,0,0,0,0,0,0,0,0,2
1282,790884,17,4,9,4,9,0,0,3,4,1,2,0,2,0,2,1,11
1282,796436,33,9,18,7,14,2,4,9,10,0,4,3,2,0,5,1,29
1282,790885,23,2,5,2,4,0,1,2,2,3,9,2,1,1,0,2,6
1282,785436,33,2,4,2,4,0,0,3,4,4,4,2,3,1,0,1,7
1282,781262,20,1,7,1,4,0,3,2,2,0,0,0,1,0,0,0,4
1282,791635,25,2,7,1,4,1,3,0,0,0,3,1,2,4,4,0,5
1282,796439,19,6,9,6,9,0,0,3,7,4,1,1,0,0,0,0,15
1282,796438,24,1,3,0,1,1,2,1,2,0,2,0,0,2,1,0,4
1282,796442,2,1,1,1,1,0,0,0,0,1,0,0,1,0,0,0,2
1282,796437,2,0,1,0,0,0,1,0,0,1,1,0,0,0,0,0,0
1282,790520,2,0,0,0,0,0,0,0,0,0,0,0,0,0,0,0,0
1283,786547,19,1,6,0,2,1,4,0,0,0,3,2,3,1,0,3,3
1283,786544,35,5,9,2,5,3,4,3,5,2,10,1,3,0,3,1,16
1283,797507,31,4,11,0,4,4,7,0,0,1,1,0,2,0,3,0,12
1283,792012,39,10,19,4,7,6,12,7,7,1,5,7,3,2,4,0,33
1283,775084,32,3,7,3,5,0,2,0,0,1,0,4,3,0,3,0,6
1283,786860,21,3,6,1,1,2,5,0,0,1,3,2,3,1,1,0,8
1283,786546,18,0,1,0,1,0,0,0,0,0,3,0,4,0,1,0,0
1283,797509,5,0,1,0,1,0,0,0,0,1,0,0,1,0,2,1,0
1283,797512,0,0,0,0,0,0,0,0,0,0,0,0,0,0,0,0,0
1283,792013,0,0,0,0,0,0,0,0,0,0,0,0,1,0,0,0,0
1284,790833,32,8,14,7,12,1,2,4,6,3,6,2,1,3,2,2,21
1284,796390,24,7,10,7,10,0,0,0,4,4,9,1,4,0,3,4,14
1284,785451,9,1,4,0,0,1,4,0,0,0,2,0,0,0,0,0,3
1284,790834,30,5,9,4,5,1,4,3,5,5,6,7,1,1,2,1,14
1284,785379,20,3,7,2,3,1,4,1,2,0,0,1,0,1,1,0,8
1284,780297,12,1,5,1,2,0,3,2,2,3,4,1,1,0,0,2,4
1284,790832,24,6,12,4,5,2,7,4,4,0,2,2,1,1,0,1,18
1284,785377,27,1,4,1,3,0,1,0,0,2,1,11,4,3,1,0,2
1284,790831,15,5,10,5,10,0,0,0,1,3,1,0,2,1,1,1,10
1284,796389,4,0,2,0,1,0,1,0,0,0,0,0,0,0,0,0,0
1284,796388,3,0,0,0,0,0,0,0,0,1,1,0,0,1,1,0,0
1285,799136,12,0,0,0,0,0,0,0,0,0,0,0,5,0,0,0,0
1285,799132,29,3,11,1,5,2,6,1,2,1,2,1,3,2,5,0,9
1285,799130,32,3,11,0,5,3,6,0,2,1,6,1,2,0,7,0,9
1285,799134,35,7,15,4,6,3,9,2,4,0,2,4,1,1,2,0,19
1285,792634,28,6,14,3,6,3,8,0,0,0,3,3,1,0,3,0,15
1285,799135,14,0,1,0,1,0,0,0,0,0,3,0,1,0,0,0,0
1285,799133,26,2,8,1,5,1,3,0,1,1,3,1,2,0,0,0,5
1285,799128,12,0,0,0,0,0,0,0,0,0,1,2,0,0,0,0,0
1285,799131,12,0,0,0,0,0,0,0,1,0,1,0,2,0,0,0,0
1286,791669,17,2,2,2,2,0,0,0,0,2,4,0,3,1,1,0,4
1286,785762,29,6,6,6,6,0,0,4,5,4,3,0,2,0,2,0,16
1286,797409,17,1,6,1,5,0,1,1,2,0,1,1,2,0,1,0,3
1286,780535,24,4,7,4,4,0,3,2,2,1,2,1,0,0,0,1,10
1286,780531,33,7,16,2,6,5,10,0,0,0,4,1,1,2,3,1,19
1286,797414,5,0,0,0,0,0,0,0,0,0,0,0,1,0,0,0,0
1286,797411,2,0,0,0,0,0,0,0,0,0,1,0,1,0,0,1,0
1286,791670,4,0,0,0,0,0,0,1,2,0,1,0,2,0,1,0,1
1286,780534,22,2,2,2,2,0,0,3,4,3,3,3,4,0,0,1,7
1286,797407,2,2,2,2,2,0,0,0,0,0,0,0,1,0,0,0,4
1286,791671,2,0,0,0,0,0,0,0,0,0,0,0,1,0,0,0,0
1286,791666,21,7,10,4,6,3,4,0,0,0,2,3,1,1,2,0,17
1286,797415,2,1,1,1,1,0,0,0,0,0,0,0,0,0,0,0,2
1286,785760,20,2,5,2,3,0,2,0,0,0,2,2,0,3,0,0,4
1287,796592,20,1,5,1,4,0,1,0,0,1,0,0,0,0,2,0,2
1287,791306,25,2,4,2,2,0,2,2,3,2,2,0,2,0,1,0,6
1287,780210,35,8,14,8,12,0,2,0,0,4,7,1,1,0,0,0,16
1287,792427,29,2,9,1,7,1,2,0,0,1,1,1,0,0,3,0,5
1287,786422,15,1,2,1,2,0,0,0,0,1,0,0,2,0,2,0,2
1287,790880,3,0,1,0,0,0,1,0,0,0,0,0,0,0,0,0,0
1287,796594,11,3,6,0,1,3,5,3,4,0,0,0,0,0,3,0,12
1287,792432,30,3,6,1,3,2,3,3,4,0,2,1,0,0,3,0,11
1287,792433,12,0,1,0,0,0,1,0,0,0,0,0,5,2,1,0,0
1287,775005,17,1,5,1,3,0,2,1,2,1,0,1,2,0,1,0,3
1287,796595,2,0,0,0,0,0,0,0,0,0,0,0,0,0,0,0,0
1287,795353,1,0,0,0,0,0,0,0,0,0,0,0,0,0,0,0,0
1288,781342,24,4,11,4,10,0,1,0,1,7,5,1,0,0,3,0,8
1288,781593,14,0,1,0,1,0,0,0,0,1,2,0,0,0,3,1,0
1288,790901,22,3,8,2,4,1,4,3,4,0,0,0,3,0,1,0,10
1288,785452,33,1,6,1,3,0,3,2,4,1,4,3,3,1,1,1,4
1288,781620,29,3,6,2,3,1,3,0,0,0,0,1,2,0,2,0,7
1288,796450,11,2,2,2,2,0,0,1,2,2,2,1,0,0,0,0,5
1288,774835,21,1,3,1,3,0,0,0,1,0,5,1,1,0,0,0,2
1288,790903,20,4,12,1,4,3,8,0,0,1,1,1,0,0,0,0,11
1288,774864,19,2,4,1,2,1,2,2,4,1,2,0,3,0,4,1,7
1288,790902,1,0,0,0,0,0,0,0,0,0,1,0,0,0,0,0,0
1288,796449,3,0,1,0,0,0,1,1,2,0,1,0,0,0,0,0,1
1288,796452,3,0,0,0,0,0,0,0,0,0,0,0,0,0,0,0,0
1289,792005,19,0,4,0,3,0,1,0,0,0,1,1,2,1,1,1,0
1289,781175,20,3,5,3,5,0,0,1,2,3,3,0,2,0,0,0,7
1289,786553,30,5,12,1,5,4,7,0,0,0,3,3,0,1,0,0,14
1289,780895,29,10,14,8,11,2,3,2,4,2,6,1,0,1,0,1,24
1289,781172,26,2,2,1,1,1,1,0,0,0,2,6,3,1,0,0,5
1289,781177,14,2,3,2,3,0,0,0,0,0,3,2,2,1,0,0,4
1289,786555,21,4,9,1,3,3,6,0,0,2,1,0,3,0,1,1,11
1289,785312,24,4,7,2,4,2,3,0,2,0,1,2,3,1,2,2,10
1289,797503,5,0,1,0,1,0,0,0,0,0,3,0,1,0,0,1,0
1289,797500,3,0,0,0,0,0,0,0,0,1,0,0,0,0,0,0,0
1289,797502,3,0,2,0,1,0,1,0,0,0,1,0,0,0,0,0,0
1289,797501,2,0,1,0,0,0,1,0,0,0,1,0,1,0,0,0,0
1289,792004,2,0,0,0,0,0,0,0,0,0,0,0,0,0,0,0,0
1289,781173,1,0,0,0,0,0,0,0,0,0,0,0,0,0,0,0,0
1289,786557,1,0,0,0,0,0,0,0,0,0,0,0,0,0,0,0,0
1290,781579,22,6,7,6,7,0,0,9,9,3,4,0,1,3,0,0,21
1290,786731,19,4,6,4,6,0,0,0,0,2,6,3,1,1,2,0,8
1290,798023,27,3,8,2,6,1,2,4,4,2,2,1,1,3,3,0,11
1290,792358,33,4,9,2,5,2,4,1,1,0,3,4,0,3,2,0,11
1290,781584,13,1,7,1,6,0,1,0,0,0,1,0,1,0,0,0,2
1290,798021,2,0,0,0,0,0,0,0,0,0,0,0,1,0,1,0,0
1290,792361,6,1,2,1,1,0,1,0,0,1,1,0,0,0,0,0,2
1290,775696,23,3,6,3,5,0,1,3,3,2,3,2,2,0,2,0,9
1290,798026,7,0,1,0,1,0,0,2,2,0,1,1,2,0,1,1,2
1290,776481,16,4,5,4,5,0,0,1,2,1,3,0,0,0,0,2,9
1290,798008,32,4,7,3,4,1,3,6,9,1,2,7,4,2,2,0,15
1292,797389,15,0,0,0,0,0,0,0,0,1,5,0,3,1,0,2,0
1292,791826,31,2,4,1,2,1,2,0,0,0,2,2,3,0,4,0,5
1292,786785,38,9,13,4,5,5,8,3,5,0,7,2,1,0,1,0,26
1292,786784,31,6,14,4,8,2,6,5,6,3,4,3,2,0,1,0,19
1292,776009,39,6,13,5,10,1,3,5,6,1,2,10,2,5,5,0,18
1292,780634,28,5,9,5,9,0,0,1,1,5,7,0,4,0,2,0,11
1292,797387,10,0,4,0,0,0,4,0,0,2,1,2,1,0,1,0,0
1292,797388,6,0,1,0,0,0,1,0,0,0,0,0,1,0,2,0,0
1292,797390,2,0,0,0,0,0,0,0,0,0,0,0,0,0,1,0,0
1293,792181,36,6,9,3,4,3,5,3,5,0,5,0,4,1,0,1,18
1293,780986,37,6,11,6,11,0,0,2,3,1,3,1,3,2,2,0,14
1293,797796,37,1,5,1,3,0,2,4,6,1,2,7,3,5,2,0,6
1293,785902,37,7,18,5,9,2,9,4,4,4,4,1,4,1,6,0,20
1293,792179,34,1,8,0,2,1,6,0,0,0,2,6,1,0,2,0,3
1293,797794,9,2,5,1,1,1,4,1,2,0,1,0,1,1,0,0,6
1293,792176,7,0,1,0,1,0,0,0,0,1,0,1,0,0,0,0,0
1293,786661,3,1,1,1,1,0,0,0,0,0,0,0,0,0,0,0,2
1294,786257,28,5,10,5,10,0,0,4,5,2,3,1,2,0,1,0,14
1294,786263,17,4,7,3,5,1,2,0,1,0,4,0,1,0,0,2,9
1294,797724,22,1,2,1,2,0,0,0,0,0,3,1,1,1,2,0,2
1294,792122,35,2,6,0,2,2,4,5,6,0,3,0,2,0,1,0,11
1294,775825,38,10,18,10,16,0,2,4,4,2,3,5,1,2,3,0,24
1294,792121,23,0,0,0,0,0,0,2,2,1,6,1,3,0,1,1,2
1294,797725,12,1,1,1,1,0,0,1,3,1,0,0,2,0,1,1,3
1294,797722,5,0,0,0,0,0,0,0,0,0,0,0,0,0,2,1,0
1294,786249,18,3,4,1,1,2,3,0,0,0,5,0,1,2,0,0,8
1294,797721,2,0,0,0,0,0,0,0,0,0,0,0,0,0,0,0,0
1295,780095,17,3,3,3,3,0,0,0,0,0,1,0,4,1,2,0,6
1295,776321,28,7,14,5,11,2,3,1,2,2,6,0,2,0,1,0,17
1295,786081,40,2,11,2,8,0,3,2,2,4,0,1,3,1,1,0,6
1295,785431,31,1,10,1,7,0,3,0,0,0,1,4,1,3,0,1,2
1295,780232,40,7,16,4,11,3,5,4,4,0,3,1,2,2,3,0,21
1295,786020,15,2,6,2,6,0,0,0,0,1,3,0,2,0,1,0,4
1295,785356,20,2,4,1,1,1,3,0,0,0,2,0,2,0,0,0,5
1295,797918,9,0,0,0,0,0,0,0,0,0,0,0,0,0,0,0,0
1296,790784,21,2,9,1,3,1,6,0,0,4,2,4,0,1,1,0,5
1296,786548,15,4,8,4,8,0,0,3,4,1,5,1,4,1,1,2,11
1296,791871,18,2,3,1,1,1,2,0,0,0,1,4,1,2,1,0,5
1296,786719,23,4,13,2,7,2,6,1,2,3,4,0,1,0,5,0,11
1296,775229,19,3,9,3,6,0,3,2,2,7,5,4,1,1,1,0,8
1296,786583,10,1,5,1,3,0,2,0,0,2,1,1,0,0,0,0,2
1296,776219,14,2,4,0,0,2,4,1,2,1,2,0,1,0,1,0,7
1296,786235,15,2,3,2,3,0,0,0,0,2,2,0,3,1,1,1,4
1296,797477,5,1,2,1,1,0,1,0,0,0,2,0,1,0,0,0,2
1296,797476,4,0,3,0,3,0,0,0,0,0,1,0,0,0,0,0,0
1296,797475,16,4,6,3,4,1,2,2,2,1,2,2,0,1,0,0,11
1296,786581,15,2,4,2,3,0,1,5,5,2,2,1,2,0,0,0,9
1296,786770,6,1,3,1,2,0,1,0,0,2,0,3,0,0,0,0,2
1296,786229,12,4,5,4,4,0,1,0,0,0,2,0,1,1,0,0,8
1296,781518,7,1,1,0,0,1,1,0,0,0,0,1,3,0,0,0,3
1304,797164,9,2,3,2,3,0,0,0,0,0,3,0,4,0,1,2,4
1304,780599,8,0,0,0,0,0,0,0,0,0,1,0,2,0,2,2,0
1304,797165,20,4,5,2,3,2,2,0,0,0,0,2,3,0,2,0,10
1304,786450,26,7,9,7,7,0,2,1,3,3,8,1,5,4,2,0,15
1304,776396,35,5,12,5,7,0,5,2,3,2,1,1,2,0,3,0,12
1304,797163,32,2,4,2,4,0,0,2,2,3,2,0,1,2,3,1,6
1304,791385,31,3,7,3,5,0,2,2,2,1,3,5,1,0,2,0,8
1304,797166,4,0,0,0,0,0,0,0,0,0,0,0,1,0,0,0,0
1304,797161,29,4,16,0,2,4,14,5,5,0,0,5,0,0,1,0,17
1304,776199,6,0,2,0,2,0,0,0,0,0,0,1,2,0,1,0,0
1304,791386,0,0,0,0,0,0,0,0,0,0,0,0,0,0,0,0,0
1305,788113,29,8,9,3,3,5,6,1,2,1,1,2,5,0,4,0,22
1305,776497,34,7,17,2,9,5,8,6,7,3,4,1,2,0,2,0,25
1305,785731,21,2,2,2,2,0,0,7,8,1,5,2,3,2,3,0,11
1305,785729,36,1,5,1,5,0,0,2,2,0,3,7,1,2,0,1,4
1305,780864,26,2,5,2,3,0,2,1,2,1,1,5,3,2,1,0,5
1305,762035,10,1,2,0,0,1,2,0,0,0,1,0,1,0,0,0,3
1305,792402,5,0,0,0,0,0,0,0,0,0,1,1,0,0,0,0,0
1305,796211,4,0,0,0,0,0,0,2,2,0,1,1,1,0,1,0,2
1305,786231,21,3,10,3,9,0,1,3,3,2,1,1,2,1,1,0,9
1305,785725,2,0,0,0,0,0,0,0,0,0,0,0,1,0,0,0,0
1305,785443,12,1,2,1,2,0,0,0,0,0,2,0,0,0,2,0,2
1306,780122,18,4,5,4,5,0,0,2,2,1,4,2,1,0,1,4,10
1306,797215,30,1,2,1,1,0,1,2,2,1,2,8,2,2,3,0,4
1306,791461,15,1,4,1,3,0,1,0,0,0,4,3,2,1,0,0,2
1306,786295,25,5,11,3,6,2,5,3,3,2,7,0,1,1,6,0,15
1306,780792,26,3,9,0,2,3,7,0,0,0,1,0,2,1,2,2,9
1306,797216,11,3,4,3,4,0,0,0,0,2,3,2,2,0,0,0,6
1306,791462,8,0,0,0,0,0,0,3,4,0,0,0,1,0,0,1,3
1306,786299,3,0,1,0,1,0,0,0,0,0,0,0,0,0,0,0,0
1306,797214,25,4,9,3,8,1,1,1,1,0,5,3,4,2,1,0,10
1306,797213,3,0,4,0,2,0,2,0,0,1,1,1,1,1,0,0,0
1306,791463,1,0,1,0,0,0,1,0,0,0,0,0,1,0,0,0,0
1306,791460,16,2,3,0,0,2,3,2,2,0,1,1,1,0,0,0,8
1306,789034,1,0,0,0,0,0,0,0,0,0,0,0,0,0,0,0,0
1306,775598,18,5,9,2,4,3,5,0,0,0,0,0,1,1,1,0,13
1308,786765,15,3,5,0,1,3,4,0,0,1,2,2,0,1,2,1,9
1308,792379,20,4,5,2,2,2,3,2,2,0,5,2,1,0,0,0,12
1308,792380,22,5,7,1,1,4,6,0,0,0,2,1,0,0,0,0,14
1308,781672,23,6,8,5,7,1,1,4,4,3,7,4,0,1,3,0,17
1308,781669,16,3,5,2,3,1,2,2,2,0,2,5,0,0,2,0,9
1308,792384,4,0,1,0,0,0,1,0,0,0,0,0,0,0,0,0,0
1308,786764,16,2,4,0,0,2,4,0,0,0,3,2,2,0,0,0,6
1308,781668,10,1,1,1,1,0,0,0,0,0,3,0,1,0,0,1,2
1308,797860,13,3,3,3,3,0,0,0,0,1,1,1,1,0,1,0,6
1308,797854,14,1,3,1,1,0,2,6,8,1,5,2,3,0,1,0,8
1308,797853,13,1,6,1,2,0,4,2,2,0,1,0,1,1,2,0,4
1308,797852,16,3,8,1,4,2,4,3,3,3,1,3,1,1,0,0,11
1308,781671,18,1,4,1,1,0,3,0,0,0,2,4,3,1,1,0,2
1310,785996,23,1,5,1,4,0,1,3,4,2,4,0,4,3,4,0,5
1310,780858,26,5,7,3,4,2,3,1,3,3,5,0,3,0,1,1,13
1310,797646,27,3,8,3,6,0,2,6,10,0,4,6,1,0,1,0,12
1310,780849,30,5,8,2,4,3,4,1,2,2,2,2,0,0,2,0,14
1310,780853,25,8,10,6,8,2,2,0,2,2,7,4,0,1,3,0,18
1310,792235,11,0,2,0,2,0,0,0,0,1,1,0,3,1,1,0,0
1310,792039,18,3,7,2,5,1,2,2,3,1,3,1,4,0,0,0,9
1310,785990,16,1,4,1,2,0,2,0,0,0,0,4,1,0,1,0,2
1310,780776,11,0,1,0,1,0,0,0,0,1,1,0,1,1,0,0,0
1310,785998,12,0,3,0,1,0,2,0,0,0,2,0,0,0,0,0,0
1310,786001,1,0,0,0,0,0,0,0,0,0,0,0,0,0,0,0,0
1311,792167,20,3,5,3,5,0,0,4,4,0,3,0,4,0,1,2,10
1311,792170,22,3,6,3,4,0,2,0,0,0,3,1,4,0,1,0,6
1311,797767,18,0,1,0,1,0,0,0,0,0,0,0,1,1,1,0,0
1311,791372,31,3,10,0,1,3,9,4,5,1,6,0,2,2,4,0,13
1311,792164,30,4,12,1,4,3,8,4,4,0,1,3,1,0,1,0,15
1311,797772,20,1,1,0,0,1,1,0,1,1,2,5,1,0,1,0,3
1311,797766,17,2,8,2,5,0,3,2,3,1,1,1,0,0,1,1,6
1311,780974,15,3,5,3,4,0,1,0,1,0,0,0,1,0,1,0,6
1311,797777,14,0,0,0,0,0,0,0,0,1,0,1,0,0,1,0,0
1311,797764,7,0,1,0,0,0,1,0,0,0,1,1,2,0,0,0,0
1311,792163,6,1,3,0,0,1,3,0,0,0,1,1,1,0,0,0,3
1312,790810,32,8,12,4,6,4,6,3,5,4,6,1,3,0,2,0,23
1312,785362,28,5,12,5,12,0,0,3,4,3,4,1,2,1,3,0,13
1312,790808,37,5,13,1,4,4,9,0,1,0,4,6,3,3,0,0,14
1312,785361,24,0,6,0,6,0,0,0,0,1,4,4,0,2,3,1,0
1312,779997,35,3,10,2,6,1,4,2,3,0,3,4,0,2,1,0,9
1312,796370,17,3,6,2,4,1,2,1,2,1,1,2,2,1,2,0,8
1312,796368,4,0,2,0,2,0,0,0,0,0,0,0,0,0,0,2,0
1312,790811,9,1,1,1,1,0,0,0,0,0,2,0,1,1,0,0,2
1312,790809,8,1,2,1,1,0,1,0,0,0,0,0,1,0,1,0,2
1312,774854,6,0,2,0,2,0,0,2,2,2,1,0,1,0,0,0,2
1313,785714,29,5,6,4,5,1,1,2,4,1,8,1,2,1,4,3,13
1313,775894,35,6,8,6,8,0,0,1,4,1,5,0,2,1,1,0,13
1313,785711,35,5,14,2,6,3,8,3,6,1,5,4,2,1,5,0,16
1313,780985,38,2,8,0,0,2,8,0,0,0,3,5,2,2,1,0,6
1313,775266,34,7,14,4,6,3,8,2,2,0,5,2,3,3,1,0,19
1313,796829,9,0,1,0,0,0,1,1,2,0,1,0,1,0,0,0,1
1313,791167,10,0,1,0,0,0,1,0,0,0,0,1,2,1,1,0,0
1313,785378,10,2,4,2,4,0,0,0,0,0,1,0,2,0,1,2,4
1314,797174,31,3,6,2,3,1,3,0,0,1,4,2,4,0,1,0,7
1314,791507,15,3,5,3,5,0,0,0,0,2,1,0,3,0,3,1,6
1314,797168,33,3,9,3,6,0,3,3,4,1,7,11,1,0,3,0,9
1314,775357,36,5,12,2,4,3,8,0,0,0,5,3,2,3,5,0,13
1314,791509,2,0,0,0,0,0,0,0,0,0,1,0,0,0,0,0,0
1314,791506,7,1,2,0,0,1,2,0,0,0,0,0,3,0,0,1,3
1314,786699,23,4,5,4,5,0,0,0,0,2,4,0,3,2,3,0,8
1314,791510,26,5,9,3,5,2,4,3,4,1,2,1,1,0,2,0,15
1314,798345,3,0,1,0,1,0,0,0,0,0,0,0,0,0,0,0,0
1314,791508,9,1,2,0,0,1,2,0,0,0,0,0,0,1,1,0,3
1314,791505,15,5,6,2,2,3,4,0,0,0,3,1,0,1,0,0,13
1315,787524,26,2,6,0,2,2,4,0,0,0,1,0,1,1,2,1,6
1315,791774,8,0,3,0,2,0,1,0,0,0,1,0,1,0,0,1,0
1315,791722,27,2,6,2,3,0,3,0,1,0,4,1,3,0,0,0,4
1315,781019,36,6,7,6,7,0,0,4,6,1,0,4,3,2,3,0,16
1315,780017,29,6,14,4,10,2,4,2,2,0,4,3,1,3,4,0,16
1315,775541,8,1,2,1,2,0,0,0,0,1,0,0,2,1,0,0,2
1315,797611,21,1,7,1,4,0,3,2,2,1,4,0,0,1,0,0,4
1315,787522,13,1,1,1,1,0,0,0,0,0,1,0,1,0,1,1,2
1315,783269,2,0,2,0,0,0,2,0,0,0,0,0,2,0,1,0,0
1315,791772,23,3,7,0,0,3,7,0,0,0,0,1,0,1,2,0,9
1315,780328,6,0,1,0,1,0,0,1,2,1,0,1,0,0,0,0,1
1315,776790,1,0,0,0,0,0,0,0,0,0,0,0,0,0,0,0,0
1316,780107,34,8,11,8,10,0,1,0,0,3,7,0,1,0,2,0,16
1316,775833,22,2,3,2,3,0,0,0,0,3,5,0,4,0,5,0,4
1316,781036,39,6,16,4,9,2,7,3,4,1,5,8,1,0,2,0,17
1316,775571,30,2,4,2,4,0,0,0,0,0,3,5,4,3,3,0,4
1316,774894,38,5,10,3,7,2,3,7,8,0,3,2,3,2,7,0,19
1316,796846,21,3,6,3,4,0,2,0,0,1,1,1,2,1,0,1,6
1316,796847,5,0,0,0,0,0,0,0,0,0,0,0,3,0,0,0,0
1316,791178,7,0,0,0,0,0,0,0,0,0,1,0,1,0,1,1,0
1316,789925,4,0,0,0,0,0,0,0,0,0,0,0,2,0,0,0,0
1317,786519,26,2,3,2,3,0,0,0,0,2,2,0,2,0,1,0,4
1317,791911,17,1,2,0,0,1,2,0,0,1,3,1,0,1,0,0,3
1317,791913,37,4,10,3,4,1,6,2,4,3,2,4,0,2,3,0,11
1317,786520,31,4,16,2,7,2,9,5,10,5,0,2,4,2,3,0,15
1317,781105,4,0,0,0,0,0,0,0,0,0,2,0,0,0,0,0,0
1317,797558,24,3,7,3,4,0,3,2,2,0,0,0,5,1,3,0,8
1317,791912,9,0,2,0,2,0,0,0,0,1,0,1,3,0,1,0,0
1317,797556,19,2,4,1,2,1,2,1,2,0,2,0,1,0,1,0,6
1317,797555,33,5,12,5,10,0,2,3,5,1,4,1,2,2,1,0,13
1318,785608,20,3,5,3,5,0,0,0,0,2,1,1,3,0,2,0,6
1318,792104,33,7,17,7,13,0,4,4,4,4,6,0,0,3,1,2,18
1318,797709,31,9,15,6,10,3,5,5,7,2,5,1,1,1,1,1,26
1318,797708,32,2,6,2,6,0,0,0,0,1,2,8,2,1,3,0,4
1318,786198,19,2,5,1,3,1,2,0,2,0,0,3,4,2,0,0,5
1318,797707,22,2,8,2,5,0,3,0,0,1,1,5,1,0,1,0,4
1318,776327,4,0,1,0,1,0,0,1,2,1,2,0,2,0,0,0,1
1318,786204,22,7,8,6,6,1,2,1,3,2,3,1,0,2,1,1,16
1318,786180,5,1,2,1,2,0,0,0,0,3,1,1,0,0,0,0,2
1318,781631,4,0,2,0,1,0,1,0,0,0,1,0,0,0,0,0,0
1318,792106,8,0,1,0,0,0,1,0,0,0,0,0,1,0,0,0,0
1319,786623,12,0,0,0,0,0,0,0,0,0,1,1,3,0,1,0,0
1319,797405,31,3,9,3,7,0,2,0,0,2,3,4,3,0,2,2,6
1319,791834,37,6,9,3,3,3,6,2,2,0,3,2,4,0,1,0,17
1319,785920,38,7,15,6,12,1,3,4,6,2,4,7,2,1,4,0,19
1319,785698,36,6,12,0,3,6,9,2,3,0,5,0,2,2,1,0,20
1319,786624,28,3,5,3,5,0,0,4,6,3,5,0,1,2,2,2,10
1319,797413,8,0,2,0,1,0,1,0,0,0,1,1,2,0,0,0,0
1319,784077,10,3,5,2,2,1,3,0,0,0,0,1,0,0,2,0,7
1320,791302,34,7,13,7,11,0,2,1,2,8,9,1,2,3,1,1,15
1320,781622,21,4,6,2,3,2,3,0,0,3,2,2,3,1,2,0,10
1320,791309,29,4,14,3,8,1,6,0,0,0,6,5,4,1,4,0,9
1320,785835,25,1,4,1,2,0,2,0,0,1,1,1,0,0,0,0,2
1320,776334,35,5,11,3,6,2,5,0,0,1,5,0,0,1,6,0,12
1320,775862,22,5,8,5,8,0,0,3,7,2,3,1,2,1,4,2,13
1320,791301,8,1,5,1,3,0,2,0,0,0,2,0,0,1,0,0,2
1320,796602,5,0,0,0,0,0,0,0,0,0,1,0,0,1,0,0,0
1320,796604,13,0,3,0,3,0,0,0,0,0,0,1,3,1,1,0,0
1320,796603,8,0,4,0,1,0,3,0,0,2,2,0,0,0,0,0,0
1321,797281,19,0,2,0,2,0,0,0,0,0,3,0,1,0,4,1,0
1321,791648,37,6,14,6,13,0,1,5,5,2,4,0,1,1,0,0,17
1321,786195,32,2,4,2,4,0,0,0,0,0,8,0,2,0,3,3,4
1321,791649,16,1,5,1,3,0,2,0,0,0,0,1,4,1,0,0,2
1321,797280,38,4,12,3,8,1,4,1,1,0,4,2,2,2,6,0,10
1321,786640,29,2,7,1,5,1,2,1,2,0,3,5,2,0,5,0,6
1321,785697,25,3,6,0,1,3,5,2,2,0,1,2,1,0,2,0,11
1321,797278,3,0,1,0,0,0,1,0,0,0,1,0,2,0,0,0,0
1321,785694,1,0,0,0,0,0,0,0,0,0,0,0,1,0,0,0,0
1322,796959,19,1,2,1,2,0,0,0,0,0,0,2,1,1,1,0,2
1322,781272,32,9,15,9,10,0,5,6,6,1,8,4,3,1,2,0,24
1322,791261,29,3,9,3,6,0,3,0,0,2,5,2,3,1,2,1,6
1322,791258,35,2,8,1,2,1,6,4,6,2,0,1,2,1,2,0,9
1322,781270,38,6,15,3,8,3,7,9,10,0,3,3,1,4,1,0,24
1322,791260,7,1,2,1,2,0,0,0,1,1,0,1,1,0,1,0,2
1322,785503,5,2,3,2,3,0,0,0,0,0,1,0,1,0,1,0,4
1322,785502,4,0,0,0,0,0,0,0,0,1,0,0,2,0,0,0,0
1322,796958,31,5,9,1,4,4,5,2,2,2,2,1,5,3,0,0,16
1323,791097,24,5,9,5,8,0,1,1,3,2,1,0,3,1,1,0,11
1323,796752,19,3,5,3,5,0,0,2,4,0,2,6,4,1,2,0,8
1323,791094,31,3,3,1,1,2,2,0,1,0,3,2,2,0,2,0,8
1323,791093,31,9,15,8,14,1,1,2,3,3,7,3,2,0,4,0,21
1323,785569,31,7,9,4,4,3,5,0,0,0,2,3,3,0,2,0,17
1323,791089,5,0,0,0,0,0,0,0,0,0,0,0,0,0,1,0,0
1323,785577,15,3,6,2,5,1,1,0,0,2,5,2,2,1,3,1,7
1323,796753,19,4,4,4,4,0,0,2,4,0,2,2,2,0,1,0,10
1323,791091,9,0,1,0,1,0,0,3,3,0,2,2,2,0,0,0,3
1323,791090,16,3,6,0,1,3,5,0,0,0,0,1,0,0,2,0,9
1324,786575,22,1,3,1,3,0,0,0,1,4,8,0,3,0,0,4,2
1324,792334,28,7,15,6,11,1,4,0,4,7,10,3,3,0,4,0,15
1324,798094,20,0,5,0,2,0,3,0,0,0,2,2,2,0,4,0,0
1324,792338,29,7,16,6,12,1,4,0,0,6,1,6,1,1,2,1,15
1324,781666,30,7,19,4,12,3,7,2,2,0,5,2,1,0,0,0,19
1324,798097,15,4,7,4,7,0,0,2,2,4,6,0,0,0,1,1,10
1324,792336,6,0,2,0,2,0,0,0,0,1,0,0,1,0,0,1,0
1324,785531,9,3,7,3,5,0,2,2,3,0,2,1,2,0,1,0,8
1324,798095,9,1,3,0,0,1,3,0,0,0,0,0,0,0,0,0,3
1324,798100,12,0,0,0,0,0,0,0,0,1,2,5,3,1,5,0,0
1324,791636,20,7,12,3,5,4,7,0,0,3,1,4,1,0,1,1,18
1326,786080,33,8,15,5,9,3,6,4,4,1,1,0,0,0,2,1,23
1326,786216,23,5,7,5,7,0,0,1,5,3,6,1,1,0,2,0,11
1326,791348,37,7,11,6,9,1,2,2,2,2,5,2,0,1,4,0,17
1326,786218,33,3,7,2,3,1,4,6,6,3,5,2,5,1,3,0,13
1326,780150,26,2,5,0,0,2,5,0,0,0,1,4,1,2,0,0,6
1326,791350,19,1,3,0,0,1,3,2,3,1,3,1,5,0,1,0,5
1326,785256,17,0,6,0,5,0,1,3,5,1,3,1,5,0,1,0,3
1326,780156,12,0,1,0,1,0,0,0,0,1,0,1,0,0,1,0,0
1327,791062,35,11,16,8,11,3,5,1,2,0,5,1,3,0,4,2,26
1327,791063,25,6,10,5,8,1,2,2,2,0,5,1,2,1,0,2,15
1327,785542,36,1,4,1,4,0,0,2,4,0,0,3,1,3,1,0,4
1327,780743,37,7,11,5,8,2,3,1,2,0,0,3,3,2,3,0,17
1327,780055,15,1,3,0,0,1,3,0,0,0,2,1,1,0,0,0,3
1327,791060,17,2,5,2,3,0,2,0,0,1,4,5,5,0,0,0,4
1327,796735,25,3,6,3,3,0,3,5,8,2,4,2,3,1,0,0,11
1327,791064,10,0,2,0,1,0,1,0,0,0,0,1,2,1,0,0,0
1328,786787,40,7,21,5,12,2,9,5,5,1,4,4,1,0,5,0,21
1328,786795,39,3,5,0,1,3,4,6,6,3,4,3,2,0,3,1,15
1328,792091,33,2,8,1,6,1,2,0,0,1,6,0,4,5,1,0,5
1328,774954,33,2,10,2,8,0,2,1,2,1,1,1,2,0,1,0,5
1328,789020,18,1,8,0,5,1,3,1,1,0,0,1,5,0,0,0,4
1328,781456,25,5,9,4,7,1,2,4,4,0,4,2,0,1,2,0,15
1328,774815,11,0,0,0,0,0,0,1,2,0,2,0,0,0,0,0,1
1328,775874,1,0,0,0,0,0,0,0,0,0,0,0,0,0,0,0,0
1329,775248,26,8,17,4,8,4,9,3,4,1,6,3,3,0,3,2,23
1329,797224,33,5,10,2,3,3,7,2,3,1,5,4,2,1,3,0,15
1329,780993,33,5,10,5,10,0,0,0,0,4,9,1,2,1,1,0,10
1329,791452,37,3,6,1,3,2,3,0,0,0,2,3,3,1,5,0,8
1329,797225,25,1,4,1,4,0,0,1,2,1,5,3,4,1,0,0,3
1329,797230,16,4,5,4,5,0,0,4,4,1,3,0,3,0,2,1,12
1329,797231,22,3,7,0,0,3,7,0,0,0,1,2,1,0,1,1,9
1329,791446,5,0,1,0,1,0,0,0,0,0,1,0,0,0,0,0,0
1329,791449,3,0,0,0,0,0,0,0,0,0,0,0,2,0,2,1,0
1330,785423,39,5,7,3,4,2,3,5,7,2,7,1,1,2,1,0,17
1330,775676,22,3,8,3,8,0,0,1,1,6,3,1,5,0,2,0,7
1330,786298,39,5,8,3,3,2,5,3,4,0,3,4,3,0,1,0,15
1330,785425,40,7,14,5,9,2,5,0,1,1,2,2,2,2,2,0,16
1330,785422,37,8,17,3,8,5,9,5,5,2,4,6,2,2,3,1,26
1330,796429,15,1,3,1,1,0,2,0,0,0,0,0,4,0,3,0,2
1330,796431,8,1,2,1,2,0,0,0,0,3,0,1,2,0,0,1,2
1331,790873,31,7,15,7,13,0,2,5,5,6,6,1,4,3,0,3,19
1331,780054,31,6,10,5,8,1,2,3,4,1,1,4,1,1,2,0,16
1331,781140,24,1,5,1,3,0,2,1,2,2,2,1,3,1,0,0,3
1331,786851,31,4,9,1,4,3,5,2,2,0,3,4,3,1,2,0,13
1331,776357,30,3,10,1,6,2,4,8,8,1,2,2,3,0,3,0,16
1331,785429,20,4,6,0,0,4,6,0,0,0,1,0,0,1,0,1,12
1331,796433,2,0,1,0,1,0,0,0,0,0,1,0,0,0,0,0,0
1331,781139,22,3,5,3,4,0,1,1,1,0,2,0,3,1,0,0,7
1331,796432,5,0,0,0,0,0,0,1,2,1,0,0,0,0,0,0,1
1331,780343,4,1,1,0,0,1,1,0,0,0,0,0,0,0,1,0,3
1332,782133,14,1,4,1,1,0,3,1,2,0,3,2,4,0,2,0,3
1332,785123,27,3,10,3,10,0,0,16,21,5,6,0,0,0,0,2,22
1332,790990,26,2,4,1,1,1,3,2,4,1,2,2,4,0,4,1,7
1332,789219,33,8,15,1,5,7,10,0,0,0,4,1,2,3,0,0,23
1332,785059,34,5,7,5,6,0,1,0,0,1,8,3,3,2,0,0,10
1332,790989,6,0,0,0,0,0,0,1,2,0,0,0,1,0,1,0,1
1332,785305,5,0,0,0,0,0,0,1,4,1,2,0,0,0,2,0,1
1332,796622,6,0,1,0,1,0,0,0,0,0,0,0,3,0,2,1,0
1332,796623,18,3,7,1,4,2,3,2,2,0,2,2,0,1,3,0,10
1332,790988,5,0,1,0,1,0,0,2,2,0,2,0,0,1,0,0,2
1332,785303,9,0,1,0,0,0,1,0,0,0,1,0,1,0,1,1,0
1332,785122,13,0,2,0,0,0,2,0,0,0,3,2,1,1,0,0,0
1332,796624,4,0,0,0,0,0,0,0,0,0,0,0,0,0,0,0,0
1333,792186,19,1,5,1,5,0,0,0,4,2,4,0,5,0,1,0,2
1333,781447,25,3,5,3,5,0,0,1,2,0,5,0,4,1,3,0,7
1333,781490,24,3,8,2,5,1,3,0,0,1,3,4,3,2,2,0,7
1333,792183,29,10,16,8,10,2,6,4,4,0,3,2,4,0,5,0,26
1333,786675,23,1,6,1,2,0,4,4,4,0,4,1,3,0,0,0,6
1333,797821,12,1,5,1,2,0,3,2,4,3,3,0,5,1,2,0,4
1333,797820,8,0,1,0,1,0,0,0,0,0,2,0,0,0,0,1,0
1333,780433,8,0,4,0,4,0,0,0,2,0,0,0,5,0,0,1,0
1333,797816,17,1,6,1,3,0,3,0,0,2,1,2,2,0,1,0,2
1333,792188,11,2,4,2,4,0,0,1,2,1,1,0,1,1,0,0,5
1333,792187,1,0,0,0,0,0,0,0,0,0,0,0,1,0,0,0,0
1333,792185,14,2,2,1,1,1,1,0,2,0,3,0,0,0,0,0,5
1333,781466,9,0,1,0,0,0,1,0,0,0,0,0,0,0,0,0,0
1334,780651,24,3,9,3,9,0,0,0,0,3,5,0,2,0,0,1,6
1334,791815,21,5,9,5,8,0,1,0,0,2,1,4,4,0,2,1,10
1334,791810,31,4,8,2,4,2,4,2,2,1,2,9,0,3,0,0,12
1334,791814,27,8,16,5,6,3,10,2,2,1,0,1,1,2,1,0,21
1334,780650,30,7,17,7,15,0,2,1,2,4,7,2,0,6,4,0,15
1334,791809,8,0,1,0,1,0,0,0,0,1,0,1,1,0,0,0,0
1334,791812,11,2,3,0,1,2,2,0,0,1,1,0,1,1,2,0,6
1334,781596,13,1,2,1,2,0,0,1,2,1,1,1,3,0,1,1,3
1334,797372,3,0,0,0,0,0,0,0,0,0,0,2,0,1,1,0,0
1334,786645,14,2,3,2,2,0,1,2,2,0,2,1,1,0,1,1,6
1334,786644,18,3,4,2,3,1,1,2,2,0,2,0,2,3,0,1,9
1335,781208,20,0,5,0,4,0,1,0,0,1,4,0,3,0,3,0,0
1335,775489,23,5,9,4,7,1,2,2,2,1,4,0,0,0,1,0,13
1335,785563,19,2,6,2,4,0,2,3,4,0,3,1,1,0,1,0,7
1335,780313,35,5,7,3,4,2,3,4,6,0,4,4,1,1,4,0,16
1335,780766,34,4,10,2,6,2,4,0,0,0,2,8,2,1,7,1,10
1335,780758,11,1,1,1,1,0,0,0,0,0,3,0,1,1,1,1,2
1335,796751,10,2,5,2,5,0,0,0,1,1,1,0,2,0,1,0,4
1335,791088,8,0,0,0,0,0,0,0,0,1,0,0,0,0,1,0,0
1335,785560,20,4,5,2,2,2,3,0,0,2,2,0,1,1,2,0,10
1335,785561,20,0,4,0,3,0,1,3,6,1,1,0,4,1,6,0,3
1336,796372,16,2,3,2,3,0,0,0,0,1,1,0,0,1,0,0,4
1336,790814,18,0,1,0,0,0,1,0,0,0,3,0,0,1,1,0,0
1336,796379,34,3,12,3,7,0,5,0,1,1,4,5,2,2,3,0,6
1336,790815,31,3,11,3,6,0,5,5,8,1,5,2,4,2,5,0,11
1336,780176,36,7,9,3,3,4,6,4,5,1,1,0,2,2,1,0,22
1336,796377,23,2,5,2,3,0,2,6,8,2,0,1,3,2,2,0,10
1336,796376,8,2,3,2,2,0,1,0,1,1,1,0,0,0,0,0,4
1336,796375,13,0,1,0,1,0,0,3,5,0,1,0,3,0,1,0,3
1336,796378,21,3,5,3,4,0,1,2,2,1,1,1,1,1,3,0,8
1338,797050,29,7,13,5,10,2,3,2,2,1,6,0,2,0,1,1,18
1338,780394,22,3,7,1,4,2,3,0,0,2,3,0,2,1,1,0,8
1338,780391,33,4,6,4,6,0,0,0,0,3,9,2,2,1,2,3,8
1338,790871,26,3,7,2,4,1,3,2,2,0,2,3,3,1,1,0,9
1338,776473,37,10,16,5,7,5,9,3,3,0,3,4,2,0,0,0,28
1338,797048,18,1,5,1,4,0,1,0,0,2,0,2,2,0,2,1,2
1338,791570,3,0,1,0,0,0,1,2,2,1,1,0,1,0,0,0,2
1338,791573,19,1,4,1,1,0,3,3,3,0,3,2,0,0,2,0,5
1338,780392,13,1,3,1,3,0,0,0,0,0,1,2,1,0,0,0,2
1339,796656,22,2,3,2,3,0,0,0,0,0,1,0,2,0,0,0,4
1339,791321,25,4,9,4,9,0,0,3,7,4,1,1,3,0,0,1,11
1339,791320,33,2,9,2,8,0,1,3,4,1,3,1,3,1,2,1,7
1339,785912,36,6,20,3,9,3,11,2,3,2,3,6,1,2,1,1,17
1339,781511,36,8,15,4,5,4,10,2,2,0,7,1,1,0,0,1,22
1339,796657,18,1,2,1,1,0,1,0,0,0,2,0,1,0,0,1,2
1339,796653,13,1,3,1,1,0,2,0,0,1,0,0,1,0,0,0,2
1339,791323,15,1,2,0,0,1,2,0,0,0,2,4,1,1,1,0,3
1339,796651,2,0,0,0,0,0,0,0,0,0,0,0,0,0,0,0,0
1340,785999,25,8,12,8,12,0,0,3,5,5,7,1,2,0,1,0,19
1340,775654,21,1,3,1,3,0,0,2,2,3,5,2,3,0,1,1,4
1340,796398,21,1,4,1,4,0,0,0,2,2,2,2,0,1,2,1,2
1340,791639,29,8,12,3,5,5,7,0,0,0,5,4,2,1,2,0,21
1340,785389,27,3,8,2,6,1,2,4,4,0,0,2,2,0,1,0,11
1340,785255,19,1,2,0,0,1,2,8,14,4,1,1,4,1,2,0,11
1340,775171,12,1,4,0,2,1,2,0,0,0,2,0,0,0,0,1,3
1340,796399,17,1,8,1,6,0,2,3,4,0,5,2,0,2,2,0,5
1340,791640,11,0,3,0,2,0,1,0,0,2,0,0,1,0,0,0,0
1340,796401,3,1,2,1,1,0,1,0,0,1,0,0,0,0,0,0,2
1340,785391,3,1,1,1,1,0,0,0,0,0,0,0,1,0,1,0,2
1340,796402,3,0,0,0,0,0,0,0,0,0,0,0,0,0,1,0,0
1340,796400,5,1,2,1,1,0,1,0,2,1,1,0,0,1,1,1,2
1340,796403,4,0,0,0,0,0,0,0,0,0,1,1,0,0,0,0,0
1341,797262,25,2,5,0,1,2,4,1,2,0,2,0,5,0,1,0,7
1341,775758,23,4,6,4,6,0,0,2,2,0,3,1,4,1,1,1,10
1341,791340,27,2,5,1,2,1,3,4,4,0,6,3,2,1,3,0,9
1341,780181,33,6,15,3,9,3,6,2,2,0,2,3,1,0,3,0,17
1341,776089,21,0,4,0,1,0,3,0,0,1,0,1,2,1,3,0,0
1341,792337,22,3,7,1,4,2,3,0,0,2,1,1,2,2,3,1,8
1341,791336,15,1,5,0,3,1,2,1,2,0,3,1,2,0,1,0,4
1341,789178,21,1,2,0,0,1,2,0,0,0,2,1,4,0,0,0,3
1341,797261,8,0,2,0,2,0,0,0,0,0,0,1,5,0,2,1,0
1341,797260,3,0,0,0,0,0,0,1,2,0,0,0,0,0,0,0,1
1341,797266,1,0,0,0,0,0,0,0,0,0,0,0,0,1,0,0,0
1341,797265,1,0,1,0,0,0,1,0,0,0,0,0,0,0,0,0,0
1342,783072,30,7,8,5,5,2,3,0,0,0,1,1,3,1,2,0,16
1342,781463,29,2,7,1,4,1,3,2,2,1,6,0,3,0,2,5,7
1342,791540,28,1,6,0,2,1,4,2,3,0,2,4,0,1,3,0,5
1342,787782,25,4,11,2,6,2,5,3,3,1,2,2,2,0,2,1,13
1342,776068,33,9,16,6,9,3,7,8,11,0,4,5,4,4,0,0,29
1342,797817,13,1,2,1,1,0,1,4,5,0,5,3,2,2,3,0,6
1342,785647,9,1,2,1,2,0,0,0,0,0,1,0,0,0,1,0,2
1342,792153,21,1,3,1,1,0,2,0,0,0,2,2,2,1,0,0,2
1342,781202,12,2,2,1,1,1,1,0,0,0,1,0,2,0,0,1,5
1344,796318,23,3,10,2,7,1,3,0,2,2,5,1,3,2,1,2,7
1344,790764,30,8,15,8,9,0,6,3,5,3,4,0,4,1,0,1,19
1344,796322,7,1,2,1,2,0,0,0,0,0,1,0,2,0,1,0,2
1344,796319,28,5,9,2,4,3,5,0,0,0,2,2,3,1,5,0,13
1344,779993,36,2,9,2,6,0,3,1,2,1,1,4,5,4,2,0,5
1344,796320,31,5,11,5,10,0,1,3,4,2,2,7,0,0,0,0,13
1344,790761,7,0,3,0,3,0,0,0,0,0,1,0,1,0,1,0,0
1344,796321,18,2,5,1,2,1,3,0,0,0,5,0,1,0,0,1,5
1344,785219,16,1,3,1,2,0,1,2,3,2,0,0,0,0,2,1,4
1344,775668,2,0,0,0,0,0,0,0,0,0,0,0,0,0,0,0,0
1344,796323,2,0,0,0,0,0,0,0,0,0,0,0,0,0,0,0,0
1345,791416,27,4,9,4,9,0,0,5,10,0,8,0,3,0,2,2,13
1345,797096,29,3,5,0,2,3,3,0,0,0,2,1,1,2,1,0,9
1345,785906,36,6,11,6,9,0,2,6,6,0,12,5,4,1,3,1,18
1345,780100,20,4,4,2,2,2,2,0,0,0,3,1,4,2,0,0,10
1345,780096,35,3,5,1,2,2,3,2,2,0,3,3,2,1,5,0,10
1345,781614,1,0,0,0,0,0,0,0,0,0,0,0,2,0,0,0,0
1345,797094,9,0,1,0,1,0,0,0,0,0,0,0,1,0,1,0,0
1345,785907,22,4,6,4,6,0,0,3,4,2,3,1,1,0,1,1,11
1345,797093,21,5,9,5,8,0,1,2,2,1,1,2,2,1,5,1,12
1346,790893,26,4,11,3,8,1,3,0,2,2,4,4,1,1,1,0,9
1346,796444,31,8,13,6,9,2,4,4,6,3,8,3,3,1,2,5,22
1346,790889,26,2,5,1,1,1,4,1,2,0,4,4,0,0,1,1,6
1346,786615,25,3,5,3,5,0,0,1,2,1,2,3,1,1,3,0,7
1346,780702,26,5,9,1,2,4,7,4,5,0,1,3,1,0,0,1,18
1346,775536,18,3,6,3,6,0,0,1,3,2,4,1,4,1,0,1,7
1346,775260,22,4,9,1,5,3,4,1,1,0,1,3,1,1,2,0,12
1346,786732,20,2,3,1,1,1,2,3,7,1,4,2,0,3,0,1,8
1346,796445,4,1,1,1,1,0,0,0,0,0,1,0,1,1,2,1,2
1346,796132,1,0,0,0,0,0,0,0,0,0,0,0,0,0,0,0,0
1346,792678,1,0,0,0,0,0,0,0,0,0,0,0,0,0,0,0,0
1347,786296,13,1,2,1,2,0,0,0,0,0,2,2,1,2,2,0,2
1347,781530,23,3,14,3,11,0,3,0,0,0,0,1,2,0,0,0,6
1347,776423,13,4,8,4,8,0,0,0,0,1,5,0,4,0,0,1,8
1347,792307,25,0,8,0,4,0,4,0,0,0,3,0,4,2,4,0,0
1347,792319,13,1,1,1,1,0,0,0,0,0,0,1,0,0,2,0,2
1347,792314,21,3,5,3,5,0,0,4,5,4,3,1,4,0,1,0,10
1347,798096,24,6,9,3,5,3,4,2,4,1,2,0,1,1,0,1,17
1347,792320,15,0,5,0,4,0,1,0,3,3,4,1,1,0,0,0,0
1347,798106,19,1,4,1,4,0,0,0,0,0,1,5,3,1,1,0,2
1347,798104,24,4,11,3,4,1,7,0,0,1,1,1,2,0,1,0,9
1347,798109,3,0,0,0,0,0,0,0,0,0,0,0,0,1,0,0,0
1347,798102,3,0,0,0,0,0,0,0,0,0,0,0,1,0,1,0,0
1347,792321,4,0,1,0,1,0,0,0,0,0,0,0,0,0,0,0,0
1354,781058,23,2,2,2,2,0,0,0,0,3,8,2,0,5,1,0,4
1354,780327,16,8,10,8,10,0,0,0,1,1,2,0,0,0,0,2,16
1354,797451,28,4,6,3,4,1,2,0,0,0,3,9,2,3,2,0,9
1354,791849,12,3,3,1,1,2,2,0,0,0,2,2,4,0,0,0,8
1354,786607,22,5,9,5,6,0,3,1,2,2,2,4,1,1,0,0,11
1354,791848,8,1,3,0,1,1,2,0,0,0,1,0,0,0,0,0,3
1354,797457,6,1,2,1,2,0,0,0,0,4,0,2,0,0,0,1,2
1354,797455,14,5,9,5,9,0,0,4,4,3,1,0,1,0,0,1,14
1354,785622,9,0,4,0,2,0,2,0,0,0,0,1,2,0,0,0,0
1354,797458,22,3,8,2,4,1,4,3,4,0,6,1,1,0,2,0,10
1354,797456,8,2,3,1,2,1,1,0,0,0,1,0,0,0,0,0,5
1354,797453,17,4,6,2,4,2,2,0,0,0,4,4,0,1,2,1,10
1354,797452,11,2,7,2,6,0,1,2,4,3,0,0,0,0,0,0,6
1354,791850,4,0,0,0,0,0,0,0,2,1,0,0,1,0,0,0,0
1356,775897,16,2,3,2,2,0,1,0,0,1,2,0,0,2,0,0,4
1356,780324,24,10,13,10,13,0,0,2,4,2,7,2,2,0,0,2,22
1356,784246,22,6,9,4,5,2,4,1,2,1,3,3,1,2,1,0,15
1356,786530,24,2,5,0,0,2,5,0,0,0,1,2,1,0,3,0,6
1356,780317,19,2,5,1,3,1,2,0,0,0,5,5,0,0,1,0,5
1356,791546,13,1,2,1,1,0,1,1,1,0,0,0,3,0,0,0,3
1356,786362,4,0,0,0,0,0,0,0,0,0,1,1,1,0,1,0,0
1356,791543,20,2,3,2,2,0,1,0,0,0,0,0,1,0,0,0,4
1356,797091,15,2,7,1,4,1,3,3,4,0,2,1,0,0,0,0,8
1356,791547,8,3,4,3,3,0,1,1,1,0,1,2,1,0,1,0,7
1356,791545,22,4,5,4,5,0,0,0,0,1,4,6,2,1,1,0,8
1356,786360,9,1,3,0,0,1,3,0,0,0,2,0,0,0,1,0,3
1356,775437,4,1,2,0,1,1,1,0,0,0,1,0,0,0,0,0,3
1357,792699,32,2,8,2,6,0,2,0,0,1,4,1,2,2,1,0,4
1357,796772,36,5,12,5,11,0,1,2,4,0,2,2,1,1,0,0,12
1357,792698,24,2,9,2,4,0,5,0,0,0,2,3,4,0,2,0,4
1357,792702,22,3,7,2,4,1,3,0,0,1,3,0,3,1,1,1,7
1357,796776,26,3,6,3,4,0,2,0,0,2,2,1,1,0,0,2,6
1357,792701,17,0,4,0,1,0,3,1,1,0,1,1,3,0,1,0,1
1357,792695,23,3,6,3,5,0,1,4,5,1,5,1,5,0,6,0,10
1357,792704,20,1,1,0,0,1,1,4,4,0,2,1,1,0,3,1,7
1358,796960,19,5,7,5,7,0,0,1,2,4,1,0,5,0,1,0,11
1358,781272,34,5,10,5,9,0,1,3,6,0,10,2,2,0,5,2,13
1358,791261,26,4,7,1,2,3,5,1,2,1,3,4,2,0,0,0,12
1358,791258,26,2,4,1,2,1,2,0,0,0,2,1,1,1,1,0,5
1358,781270,40,3,7,2,5,1,2,4,6,0,4,9,1,1,2,0,11
1358,796959,13,2,2,2,2,0,0,2,4,3,0,0,2,0,3,0,6
1358,796958,20,3,8,1,4,2,4,2,2,1,1,0,4,1,2,0,10
1358,785501,22,3,7,2,3,1,4,4,7,1,6,2,4,1,2,0,11
1359,791097,29,5,9,5,8,0,1,6,8,1,6,3,3,2,2,1,16
1359,796752,32,3,9,3,8,0,1,6,8,1,1,6,2,1,0,0,12
1359,791094,24,0,2,0,0,0,2,0,3,0,3,2,2,0,1,0,0
1359,791093,30,3,9,3,7,0,2,1,4,4,2,3,4,1,2,0,7
1359,785569,18,3,6,0,0,3,6,0,0,0,0,1,3,0,0,0,9
1359,791089,4,0,0,0,0,0,0,0,0,0,1,0,0,0,2,0,0
1359,785577,12,1,4,1,3,0,1,0,0,0,2,0,3,0,1,1,2
1359,796753,23,6,11,3,5,3,6,0,1,2,1,0,3,1,1,0,15
1359,791091,8,0,2,0,2,0,0,0,0,0,0,0,1,1,0,0,0
1359,791090,20,3,6,2,3,1,3,3,3,0,2,1,1,1,1,0,10
1360,796778,24,4,7,4,6,0,1,0,0,0,2,2,2,1,1,2,8
1360,781107,19,4,4,4,4,0,0,0,1,1,4,4,5,0,1,1,8
1360,791974,27,1,3,0,2,1,1,4,4,0,1,1,4,0,0,0,7
1360,785366,30,1,5,1,2,0,3,5,6,0,9,5,2,0,3,0,7
1360,780863,35,10,17,9,14,1,3,6,12,2,3,1,1,2,2,2,27
1360,776069,20,3,4,3,3,0,1,1,2,0,4,2,4,0,3,0,7
1360,780867,8,1,1,1,1,0,0,2,2,0,2,1,1,0,0,0,4
1360,796777,10,0,2,0,1,0,1,2,2,0,2,0,0,0,1,0,2
1360,791972,16,3,4,1,1,2,3,0,0,1,0,2,2,1,2,0,8
1360,791971,11,0,1,0,1,0,0,0,0,0,0,0,0,0,1,0,0
1361,785775,29,3,7,3,4,0,3,3,5,0,3,0,4,1,2,2,9
1361,781335,30,5,12,3,6,2,6,8,10,3,5,2,4,0,1,1,20
1361,776351,36,8,17,4,6,4,11,3,3,2,2,1,4,1,2,0,23
1361,785770,38,4,11,3,7,1,4,5,6,2,4,6,1,2,1,0,14
1361,781341,32,2,9,2,5,0,4,1,1,0,1,5,4,0,1,0,5
1361,796542,14,0,0,0,0,0,0,0,2,0,0,1,2,0,1,0,0
1361,791283,8,1,1,1,1,0,0,0,0,0,0,0,2,0,0,0,2
1361,796538,13,0,1,0,1,0,0,0,0,0,0,0,2,2,0,0,0
1362,792213,17,1,2,1,1,0,1,0,0,0,1,0,3,0,0,0,2
1362,785430,19,0,2,0,1,0,1,2,2,0,1,1,2,0,1,1,2
1362,781326,25,5,6,5,6,0,0,0,2,2,4,0,2,2,0,3,10
1362,797870,36,7,14,5,9,2,5,4,4,0,1,2,2,1,6,0,20
1362,781323,38,11,17,8,12,3,5,0,1,1,6,7,1,1,6,0,25
1362,785638,27,3,4,2,2,1,2,1,1,0,2,2,2,1,1,0,8
1362,792215,18,0,0,0,0,0,0,0,0,0,0,3,4,2,0,1,0
1362,780874,18,0,0,0,0,0,0,3,4,0,1,2,2,1,2,0,3
1362,786688,2,0,0,0,0,0,0,0,0,0,0,1,0,0,2,0,0
1363,781046,14,0,4,0,4,0,0,1,2,5,3,0,1,0,2,0,1
1363,780025,29,8,13,8,13,0,0,2,5,7,1,0,2,0,1,0,18
1363,786228,24,1,6,1,3,0,3,0,0,0,1,8,3,1,1,0,2
1363,785385,25,3,7,2,4,1,3,0,0,1,3,2,0,3,1,0,7
1363,785383,39,11,19,6,11,5,8,1,4,0,1,7,2,2,3,0,28
1363,790837,30,2,5,1,3,1,2,2,2,0,2,3,1,3,1,0,7
1363,786297,11,4,5,4,5,0,0,0,0,0,1,0,2,0,0,1,8
1363,796391,13,0,0,0,0,0,0,0,0,0,0,1,1,0,0,0,0
1363,785384,15,4,4,4,4,0,0,0,0,1,2,1,3,1,1,1,8
1364,780012,30,5,7,2,3,3,4,3,4,2,4,1,0,2,1,1,16
1364,774895,12,5,6,5,6,0,0,2,2,2,1,0,4,1,1,0,12
1364,790824,27,4,8,2,6,2,2,4,4,0,5,4,1,1,1,1,14
1364,780011,29,5,12,3,8,2,4,0,1,1,2,3,0,0,0,1,12
1364,775667,28,2,6,1,3,1,3,2,2,0,2,7,2,0,0,0,7
1364,796309,23,8,11,8,11,0,0,2,3,2,5,1,1,1,2,4,18
1364,781524,20,4,4,3,3,1,1,0,0,0,1,3,0,1,0,1,9
1364,785370,10,1,1,1,1,0,0,1,2,1,2,0,1,1,1,1,3
1364,796383,10,0,2,0,0,0,2,0,0,0,2,1,2,0,2,0,0
1364,796382,4,0,2,0,2,0,0,0,0,0,0,0,0,0,0,0,0
1364,796384,3,0,0,0,0,0,0,0,0,0,0,0,2,0,0,0,0
1364,785367,4,0,0,0,0,0,0,0,0,0,0,0,0,0,0,0,0
1365,797967,30,7,13,7,11,0,2,0,0,2,4,2,2,0,1,0,14
1365,797962,22,0,2,0,2,0,0,4,4,4,2,1,3,0,1,0,4
1365,797970,30,3,13,3,9,0,4,0,0,1,3,4,2,1,3,0,6
1365,781453,31,4,16,2,10,2,6,2,2,1,3,3,2,2,4,0,12
1365,774869,29,5,8,1,2,4,6,0,0,0,0,0,0,1,0,0,14
1365,786098,19,2,5,0,1,2,4,3,4,0,3,0,3,0,2,0,9
1365,797961,9,1,2,1,2,0,0,0,0,0,1,0,2,0,0,0,2
1365,792256,8,1,1,1,1,0,0,0,0,0,0,2,2,0,0,0,2
1365,792254,20,3,4,2,2,1,2,1,2,1,1,0,3,0,2,1,8
1365,786106,2,0,0,0,0,0,0,0,0,0,0,0,0,0,0,0,0
1366,791837,37,7,9,4,4,3,5,4,4,3,10,0,3,1,1,1,21
1366,780613,29,3,6,3,6,0,0,0,1,1,3,0,3,1,2,0,6
1366,775097,23,8,18,7,16,1,2,0,0,0,11,4,2,0,3,0,17
1366,780609,39,3,8,2,4,1,4,5,5,0,3,11,1,4,1,0,12
1366,776395,37,6,13,3,6,3,7,1,2,1,0,1,2,1,3,0,16
1366,786621,7,0,2,0,0,0,2,0,0,0,1,1,1,0,0,1,0
1366,786622,12,1,2,1,1,0,1,1,2,0,1,1,2,2,1,0,3
1366,797437,5,0,0,0,0,0,0,0,0,0,1,0,1,0,0,0,0
1366,786619,11,1,1,1,1,0,0,1,1,1,2,0,1,0,2,1,3
1367,791905,19,1,3,1,1,0,2,1,1,0,3,0,2,0,1,1,3
1367,781103,23,6,11,6,10,0,1,3,5,2,6,2,1,0,3,0,15
1367,797568,36,2,11,2,6,0,5,0,0,0,4,1,4,2,0,0,4
1367,797566,36,2,5,1,2,1,3,1,2,0,2,2,1,0,2,1,6
1367,781191,36,5,13,4,7,1,6,2,3,1,5,3,5,0,1,0,13
1367,791904,12,4,7,3,5,1,2,0,0,1,0,2,1,0,0,0,9
1367,781102,28,6,10,6,10,0,0,4,7,3,5,0,0,2,2,0,16
1367,791907,7,1,1,1,1,0,0,0,0,0,1,0,1,1,1,0,2
1367,791906,3,0,0,0,0,0,0,0,0,0,0,0,1,0,0,0,0
1368,781425,30,5,10,5,10,0,0,5,6,1,7,0,2,0,1,1,15
1368,797000,15,2,6,1,2,1,4,0,0,0,2,1,3,0,0,0,5
1368,791343,35,4,6,2,3,2,3,2,2,0,3,6,1,1,0,0,12
1368,781602,35,4,12,4,7,0,5,2,2,0,3,5,1,3,1,1,10
1368,775746,34,7,11,2,2,5,9,0,0,3,5,3,4,1,1,0,19
1368,791344,25,2,6,2,4,0,2,1,4,0,5,0,4,0,2,0,5
1368,781601,10,1,1,1,1,0,0,0,0,1,2,0,1,0,0,1,2
1368,797001,5,1,2,1,1,0,1,0,0,0,0,0,0,0,1,0,2
1368,786611,11,0,5,0,2,0,3,2,2,0,1,0,2,0,0,0,2
1369,792171,29,4,15,4,13,0,2,4,4,2,8,3,1,0,2,2,12
1369,785674,30,4,10,1,2,3,8,5,5,4,2,2,2,0,2,0,16
1369,780049,21,4,7,3,6,1,1,1,2,0,5,0,2,0,0,0,10
1369,797784,33,0,9,0,4,0,5,0,0,2,3,3,2,1,3,0,0
1369,789059,32,4,9,2,3,2,6,2,2,1,6,2,1,0,1,0,12
1369,797782,14,2,5,2,5,0,0,1,2,1,3,1,2,0,1,1,5
1369,797783,10,1,1,1,1,0,0,0,0,1,1,2,3,0,0,0,2
1369,792174,14,1,3,1,1,0,2,3,3,0,0,0,3,0,0,0,5
1369,792173,5,0,0,0,0,0,0,0,0,0,0,0,0,0,0,0,0
1369,780527,10,1,2,1,1,0,1,3,4,1,0,1,0,0,0,0,5
1369,780980,2,0,0,0,0,0,0,0,0,0,0,1,0,0,0,0,0
1370,791356,29,5,9,4,5,1,4,2,4,2,9,4,3,2,3,1,13
1370,780104,17,5,7,3,3,2,4,0,0,0,2,3,0,2,0,0,12
1370,791684,24,2,5,2,3,0,2,4,6,0,3,6,1,1,2,1,8
1370,797431,17,3,5,1,1,2,4,0,0,0,0,3,2,3,1,0,8
1370,791681,17,3,6,3,6,0,0,0,0,2,2,1,0,2,0,0,6
1370,791680,26,9,12,6,7,3,5,4,5,2,3,0,1,1,1,1,25
1370,785812,25,8,15,4,5,4,10,2,3,1,3,6,1,3,0,0,22
1370,791682,15,6,6,6,6,0,0,1,2,2,0,0,0,2,0,0,13
1370,785410,16,3,6,3,6,0,0,3,4,1,2,0,3,0,1,1,9
1370,790530,14,0,2,0,1,0,1,0,0,2,2,3,5,0,0,1,0
1372,796617,19,0,0,0,0,0,0,4,6,0,1,0,3,0,0,0,4
1372,775131,38,2,8,1,5,1,3,4,4,0,5,3,3,1,3,1,9
1372,796612,38,8,18,8,18,0,0,3,3,0,2,6,0,0,3,0,19
1372,796606,31,0,3,0,2,0,1,0,0,0,0,3,3,3,1,0,0
1372,785562,35,10,14,8,11,2,3,0,0,1,5,3,2,0,2,0,22
1372,792429,15,4,6,4,4,0,2,0,0,0,0,1,2,0,1,0,8
1372,796614,6,0,2,0,2,0,0,0,0,1,0,0,0,0,0,0,0
1372,796607,18,2,5,2,3,0,2,2,2,2,5,0,0,2,0,0,6
1373,780890,38,3,9,2,3,1,6,0,1,1,2,3,2,1,1,0,7
1373,775757,14,1,2,1,2,0,0,2,2,2,1,0,3,0,0,0,4
1373,786066,39,6,12,4,5,2,7,4,4,1,10,6,4,1,6,0,18
1373,785636,37,5,9,0,1,5,8,0,0,0,8,2,1,1,3,0,15
1373,775574,32,5,10,1,3,4,7,0,0,0,3,5,5,2,4,0,14
1373,791119,5,0,0,0,0,0,0,0,0,0,0,0,0,0,0,0,0
1373,791123,27,5,8,0,0,5,8,0,0,0,2,3,0,1,0,0,15
1373,785969,8,0,2,0,2,0,0,4,4,0,0,0,2,0,1,0,4
1374,792373,11,2,3,2,3,0,0,5,7,0,3,1,4,1,1,0,9
1374,797960,20,3,8,0,1,3,7,0,0,0,1,0,3,1,0,0,9
1374,792370,23,3,8,3,5,0,3,0,0,3,1,2,4,2,4,2,6
1374,786739,20,3,7,3,5,0,2,1,2,0,1,8,3,4,2,0,7
1374,775303,21,4,6,3,3,1,3,1,1,0,2,0,1,2,3,0,10
1374,797958,19,1,8,1,6,0,2,1,2,3,2,0,0,1,0,0,3
1374,792369,1,0,0,0,0,0,0,0,0,0,0,0,1,0,0,0,0
1374,781598,2,0,0,0,0,0,0,0,0,0,0,0,0,0,0,0,0
1374,797951,22,7,9,4,5,3,4,3,3,1,7,1,0,0,1,0,20
1374,797949,2,0,0,0,0,0,0,0,0,0,1,0,0,0,0,0,0
1374,792368,3,0,1,0,0,0,1,0,0,0,0,0,1,0,1,0,0
1374,790499,13,4,5,4,5,0,0,2,2,1,3,0,1,2,1,0,10
1374,781597,19,0,0,0,0,0,0,0,0,0,0,1,0,0,1,0,0
1374,775809,24,2,6,2,3,0,3,2,2,2,2,3,3,3,2,1,6
1375,791723,31,4,7,4,7,0,0,0,0,1,1,1,4,1,4,0,8
1375,797310,28,1,6,1,4,0,2,0,0,1,5,3,2,2,5,0,2
1375,791724,29,3,10,2,5,1,5,0,1,2,4,4,5,0,4,1,7
1375,781617,22,5,7,5,6,0,1,1,2,0,4,0,3,2,3,1,11
1375,797312,1,0,0,0,0,0,0,0,0,0,0,0,0,0,0,0,0
1375,785580,21,3,6,3,4,0,2,1,4,1,1,1,4,0,2,0,7
1375,797308,17,1,4,1,2,0,2,2,4,1,1,1,0,2,1,1,4
1375,790085,1,0,0,0,0,0,0,0,0,0,0,0,0,0,0,0,0
1375,780706,15,1,2,0,1,1,1,0,0,0,1,0,2,1,1,0,3
1375,780956,35,7,15,7,11,0,4,2,2,1,3,1,0,0,4,3,16
1376,775534,33,9,22,3,6,6,16,3,4,0,5,4,0,3,1,1,27
1376,785603,35,6,14,4,7,2,7,2,2,0,2,2,3,0,0,0,16
1376,776425,38,4,9,1,4,3,5,1,2,0,4,4,0,1,1,0,12
1376,775538,31,1,3,1,3,0,0,4,5,4,6,1,2,1,0,2,6
1376,791107,16,1,5,1,5,0,0,0,0,1,0,1,1,0,2,0,2
1376,775820,14,1,2,0,1,1,1,2,2,0,2,1,2,0,1,1,5
1376,791110,10,0,0,0,0,0,0,2,2,0,1,0,2,1,1,0,2
1376,796763,3,1,2,1,1,0,1,0,0,0,0,0,2,0,0,0,2
1376,791106,19,0,2,0,1,0,1,0,0,0,1,0,2,0,2,0,0
1376,786494,1,0,1,0,1,0,0,0,0,0,0,0,1,0,0,0,0
1377,780399,35,7,10,3,6,4,4,1,1,0,3,5,1,1,4,0,19
1377,775515,29,6,11,2,3,4,8,3,4,0,4,0,3,1,0,2,19
1377,786387,40,6,11,6,11,0,0,1,3,0,2,9,1,0,2,1,13
1377,797047,14,2,4,2,3,0,1,2,3,0,2,1,2,0,0,1,6
1377,791579,33,2,6,2,4,0,2,1,1,1,3,1,2,1,1,0,5
1377,780400,22,4,7,3,4,1,3,2,4,1,7,0,3,0,2,0,11
1377,791575,10,2,2,1,1,1,1,0,0,1,3,0,2,1,0,2,5
1377,791577,6,1,1,0,0,1,1,0,0,0,1,0,1,0,0,0,3
1377,786846,5,1,2,0,1,1,1,0,0,0,1,1,2,1,1,0,3
1377,797046,6,0,2,0,2,0,0,0,0,0,2,0,0,0,1,0,0
1378,797683,18,2,8,1,1,1,7,0,0,0,1,1,1,2,1,1,5
1378,780683,21,4,12,2,7,2,5,3,5,3,5,0,0,0,0,1,13
1378,797681,25,5,9,2,4,3,5,4,7,1,1,5,2,3,0,0,17
1378,780688,26,4,14,4,11,0,3,3,6,7,3,4,1,3,1,0,11
1378,780772,13,0,0,0,0,0,0,0,0,0,1,0,0,1,0,0,0
1378,797682,11,0,2,0,2,0,0,2,2,1,1,0,3,0,1,0,2
1378,797680,11,2,5,1,3,1,2,0,0,0,2,0,0,1,0,0,5
1378,797679,20,4,12,4,9,0,3,1,2,3,2,0,1,1,1,1,9
1378,797678,3,0,0,0,0,0,0,0,0,0,0,0,1,0,0,0,0
1378,791942,12,0,1,0,1,0,0,0,0,1,0,3,1,0,1,0,0
1378,791941,16,1,4,0,2,1,2,0,0,0,1,1,2,0,1,0,3
1378,780689,24,2,4,2,3,0,1,3,4,2,2,0,1,3,1,0,7
1380,797257,6,2,2,2,2,0,0,0,0,0,1,0,2,0,1,0,4
1380,791348,35,2,5,2,5,0,0,0,0,1,6,3,2,1,3,0,4
1380,786218,19,3,6,1,2,2,4,0,2,2,2,1,3,0,1,0,8
1380,785256,32,8,13,8,12,0,1,2,3,1,11,4,2,1,6,0,18
1380,780150,20,0,4,0,0,0,4,0,0,0,3,1,0,2,2,0,0
1380,786080,27,8,12,4,4,4,8,3,5,1,5,2,1,0,4,2,23
1380,786216,18,3,7,3,7,0,0,3,4,4,2,2,1,1,1,0,9
1380,791350,29,3,6,2,2,1,4,0,0,1,3,4,1,0,1,0,7
1380,780156,14,2,4,1,2,1,2,0,0,0,1,1,0,0,1,1,5
1382,781300,31,5,10,4,8,1,2,1,4,1,8,4,4,1,0,1,12
1382,790803,21,6,12,6,12,0,0,0,1,3,5,0,5,0,1,0,12
1382,796360,30,3,10,2,8,1,2,2,4,2,2,5,3,4,2,0,9
1382,781304,41,6,15,4,9,2,6,5,6,1,0,1,3,0,5,0,19
1382,781302,33,3,8,1,2,2,6,1,4,4,4,0,3,0,0,1,9
1382,796362,1,0,0,0,0,0,0,0,0,0,0,0,1,0,0,0,0
1382,790801,13,0,4,0,4,0,0,0,0,0,0,1,0,1,0,0,0
1382,796363,14,1,4,0,2,1,2,0,0,0,1,0,0,0,0,0,3
1382,780598,31,1,3,0,2,1,1,2,2,4,5,1,3,2,0,1,5
1382,781305,7,0,3,0,2,0,1,0,0,1,0,1,0,0,1,1,0
1382,796364,2,0,0,0,0,0,0,0,0,0,0,0,0,0,0,0,0
1382,781306,1,0,0,0,0,0,0,0,0,0,0,0,0,0,0,0,0
1383,791401,40,8,15,8,15,0,0,9,12,7,10,0,2,0,3,2,25
1383,780125,34,3,5,3,5,0,0,3,4,2,4,1,3,1,2,1,9
1383,791400,30,3,9,3,7,0,2,3,4,3,5,1,4,1,3,0,9
1383,785931,40,2,10,1,5,1,5,4,6,0,0,2,2,1,1,0,9
1383,780118,38,3,10,2,6,1,4,2,2,0,5,4,1,1,2,0,9
1383,786837,16,2,4,0,1,2,3,0,0,1,2,0,2,0,1,0,6
1383,797125,20,0,3,0,2,0,1,0,0,0,1,2,2,0,1,0,0
1383,797130,7,0,1,0,1,0,0,0,0,0,0,0,1,0,1,0,0
1384,797139,19,2,4,2,4,0,0,3,5,0,2,2,4,0,5,1,7
1384,775394,32,2,6,1,4,1,2,4,6,2,5,2,2,2,1,0,9
1384,791526,29,1,6,1,4,0,2,0,0,0,1,6,1,3,0,0,2
1384,780272,30,5,11,2,6,3,5,3,4,1,2,1,1,2,0,1,16
1384,775592,31,9,15,5,8,4,7,2,2,0,6,1,2,0,0,0,24
1384,791524,16,5,7,5,6,0,1,0,0,3,1,1,3,0,3,0,10
1384,786354,3,0,0,0,0,0,0,0,0,0,0,0,1,0,0,0,0
1384,785970,10,1,3,1,3,0,0,0,1,1,1,0,1,1,0,0,2
1384,797136,11,2,2,0,0,2,2,0,0,0,2,1,0,0,0,0,6
1384,780273,19,1,4,1,3,0,1,0,0,0,2,3,2,1,0,0,2
1385,791512,15,4,4,4,4,0,0,0,0,0,1,0,3,0,1,0,8
1385,786338,35,5,12,1,5,4,7,0,0,0,5,2,1,1,3,1,14
1385,792050,30,3,6,2,3,1,3,0,0,0,1,5,1,1,0,1,7
1385,785347,12,1,3,1,2,0,1,0,0,0,2,2,0,1,2,0,2
1385,775601,33,4,7,4,6,0,1,1,2,1,5,3,3,1,7,0,9
1385,786825,20,6,8,6,8,0,0,3,10,4,4,1,3,0,1,1,15
1385,792045,1,0,0,0,0,0,0,0,2,0,0,0,1,0,1,0,0
1385,797648,15,2,3,0,0,2,3,0,0,0,1,0,3,0,0,0,6
1385,792052,21,2,3,1,2,1,1,1,3,1,0,0,3,0,1,1,6
1385,792047,9,1,2,1,1,0,1,0,0,1,2,0,4,0,0,1,2
1385,775476,9,0,1,0,1,0,0,0,0,0,1,2,0,0,1,0,0
1386,780229,17,3,5,3,5,0,0,1,2,0,5,2,5,0,2,1,7
1386,795572,39,6,7,6,7,0,0,0,2,1,5,1,4,2,3,2,12
1386,791488,15,0,4,0,3,0,1,0,0,0,1,1,1,1,2,0,0
1386,786322,39,6,11,4,8,2,3,12,14,0,2,4,1,0,0,0,26
1386,780228,39,6,13,3,5,3,8,2,2,0,0,1,4,0,0,0,17
1386,791484,8,0,2,0,1,0,1,0,0,0,1,0,0,0,0,0,0
1386,781592,12,0,3,0,3,0,0,0,0,0,1,0,5,1,0,0,0
1386,797195,7,0,1,0,1,0,0,2,2,0,0,1,2,0,0,0,2
1386,797193,0,0,1,0,1,0,0,0,0,0,0,0,0,0,0,0,0
1386,791485,16,3,5,0,0,3,5,2,2,0,1,0,1,1,1,0,11
1386,786323,30,2,3,1,1,1,2,0,0,0,4,5,1,2,1,0,5
1386,797194,3,0,0,0,0,0,0,0,0,0,0,0,0,0,0,0,0
1387,775913,20,3,6,3,6,0,0,2,2,1,3,0,1,1,2,1,8
1387,791737,37,5,12,4,9,1,3,6,7,1,4,1,2,1,6,1,17
1387,783524,35,7,17,3,9,4,8,3,8,0,2,0,2,0,4,0,21
1387,786223,29,3,4,3,3,0,1,3,5,4,4,1,5,2,2,0,9
1387,780561,22,1,3,1,1,0,2,0,0,1,3,2,2,1,2,1,2
1387,797332,10,1,3,1,3,0,0,0,0,3,2,1,1,0,0,0,2
1387,797333,13,1,1,1,1,0,0,0,0,0,0,1,3,0,2,0,2
1387,797331,30,2,3,1,1,1,2,0,0,1,2,0,4,0,2,0,5
1387,786220,29,2,6,2,5,0,1,4,6,1,4,2,2,2,1,0,8
1388,791949,34,12,14,8,8,4,6,0,0,1,4,3,2,2,2,1,28
1388,776014,22,1,3,0,0,1,3,0,0,1,3,2,1,1,0,0,3
1388,797691,14,2,3,2,3,0,0,1,1,0,1,5,1,0,0,0,5
1388,780747,28,6,11,2,6,4,5,4,4,1,3,8,3,3,3,0,20
1388,776363,27,9,13,2,4,7,9,0,0,2,4,1,2,1,0,0,25
1388,784336,13,2,6,2,6,0,0,1,3,3,2,1,0,0,1,1,5
1388,791946,11,2,5,0,1,2,4,0,0,0,1,0,0,0,2,0,6
1388,797690,21,1,3,0,1,1,2,0,0,1,2,4,1,1,3,1,3
1388,785304,19,0,3,0,1,0,2,0,0,0,0,3,1,0,0,0,0
1388,797689,7,0,1,0,0,0,1,2,2,1,0,0,1,1,0,0,2
1388,791948,4,1,1,1,1,0,0,0,0,0,1,1,2,0,0,0,2
1389,785432,25,4,5,4,5,0,0,0,0,2,2,0,1,1,0,0,8
1389,779985,34,6,11,3,5,3,6,2,2,1,3,1,3,1,1,0,17
1389,790882,26,4,8,4,7,0,1,2,2,1,1,4,4,0,1,0,10
1389,790876,26,3,7,3,6,0,1,5,6,1,0,3,3,3,1,0,11
1389,774987,31,4,8,3,5,1,3,4,4,0,3,4,1,0,6,0,13
1389,781062,15,0,3,0,0,0,3,0,0,0,1,1,0,0,0,0,0
1389,790877,14,1,4,1,4,0,0,0,0,2,3,2,0,0,0,1,2
1389,796434,14,2,5,0,0,2,5,0,0,0,2,0,0,1,1,0,6
1389,790879,9,5,8,5,8,0,0,0,2,2,2,0,0,1,0,0,10
1389,790875,2,0,1,0,0,0,1,0,0,0,0,0,0,0,0,0,0
1389,790878,4,0,0,0,0,0,0,0,0,0,1,0,0,0,0,0,0
1390,786424,30,8,15,8,15,0,0,4,7,2,13,1,2,0,1,4,20
1390,797979,33,3,7,2,4,1,3,0,0,0,0,2,5,0,0,0,7
1390,791015,35,0,2,0,1,0,1,2,2,0,4,4,1,2,1,0,2
1390,792279,33,7,12,6,10,1,2,3,5,1,3,5,3,2,1,0,18
1390,785483,33,5,11,3,7,2,4,3,5,0,6,5,5,1,4,0,15
1390,797991,0,0,0,0,0,0,0,0,0,0,0,0,0,0,0,0,0
1390,785959,8,0,0,0,0,0,0,0,0,0,0,0,2,0,1,0,0
1390,781454,14,2,6,2,4,0,2,2,2,1,1,1,5,0,1,0,6
1390,797988,2,0,2,0,0,0,2,0,0,0,0,0,0,0,0,0,0
1390,775335,12,1,4,0,0,1,4,0,0,0,0,2,2,0,1,0,3
1391,775738,18,1,6,1,5,0,1,2,2,2,6,2,4,0,0,1,4
1391,786091,27,6,8,5,6,1,2,6,7,1,4,1,3,0,0,2,19
1391,786728,37,2,4,2,4,0,0,0,4,2,5,6,2,2,2,0,4
1391,785904,39,10,23,5,11,5,12,8,10,1,4,1,1,0,4,0,33
1391,780892,22,2,6,1,2,1,4,1,2,1,5,5,4,0,2,0,6
1391,786350,4,1,1,1,1,0,0,0,1,0,0,1,0,0,1,1,2
1391,797669,4,0,0,0,0,0,0,0,0,1,0,2,1,0,0,1,0
1391,797666,20,0,1,0,0,0,1,2,4,0,5,1,1,0,0,0,2
1391,786788,10,0,2,0,1,0,1,1,2,1,0,1,2,0,1,0,1
1391,786096,19,5,5,5,5,0,0,0,1,0,4,1,4,0,1,0,10
1392,785298,11,1,1,1,1,0,0,2,2,1,0,0,4,0,1,0,4
1392,775224,22,2,6,2,5,0,1,0,0,1,5,0,4,3,4,0,4
1392,778046,24,3,7,1,4,2,3,4,4,0,2,7,0,1,3,0,12
1392,782121,31,4,6,3,4,1,2,2,2,1,2,7,1,4,3,1,11
1392,775793,25,2,6,2,3,0,3,5,5,1,1,1,1,0,2,0,9
1392,785485,21,5,6,5,6,0,0,3,4,1,5,0,3,0,0,1,13
1392,786594,23,4,7,1,2,3,5,3,4,0,2,1,1,3,3,0,14
1392,796598,18,1,3,0,0,1,3,3,4,1,1,3,2,1,1,0,6
1392,785302,16,3,6,1,3,2,3,2,2,0,0,1,3,2,2,2,10
1392,796599,3,0,0,0,0,0,0,0,0,0,1,0,1,0,0,0,0
1392,790987,4,0,1,0,1,0,0,0,0,0,0,0,1,0,1,0,0
1392,785301,1,0,2,0,2,0,0,0,0,0,0,0,0,0,0,0,0
1392,778469,1,0,0,0,0,0,0,0,0,0,0,0,1,0,0,0,0
1393,792158,28,2,3,2,3,0,0,0,5,2,5,0,4,2,3,0,4
1393,780138,23,5,7,5,7,0,0,0,3,4,2,1,3,0,2,1,10
1393,792154,32,4,7,4,6,0,1,3,5,1,3,2,3,3,5,0,11
1393,792152,30,1,6,1,6,0,0,2,2,0,4,0,2,1,7,0,4
1393,780581,25,3,9,2,4,1,5,3,4,0,0,1,2,1,6,0,10
1393,797755,14,0,4,0,2,0,2,0,0,1,2,0,1,1,1,2,0
1393,792157,13,1,1,1,1,0,0,0,0,2,1,0,3,1,3,0,2
1393,786014,17,0,2,0,2,0,0,2,2,0,2,0,3,1,3,0,2
1393,797756,9,1,3,1,3,0,0,3,4,0,1,0,1,0,2,0,5
1393,792162,2,0,1,0,0,0,1,0,0,1,0,0,2,0,2,0,0
1393,785358,4,0,0,0,0,0,0,2,2,0,1,0,1,0,1,0,2
1393,792159,2,1,1,1,1,0,0,0,0,0,0,0,1,0,0,1,2
1393,797759,1,0,0,0,0,0,0,0,0,0,0,0,0,0,0,0,0
1394,797344,3,0,0,0,0,0,0,0,0,0,1,0,0,0,0,0,0
1394,797342,19,1,3,1,3,0,0,0,0,3,1,0,3,1,2,1,2
1394,791747,34,12,21,7,10,5,11,9,10,3,9,2,3,0,2,0,38
1394,791746,32,7,11,7,9,0,2,1,1,0,11,5,2,0,4,2,15
1394,786188,32,3,10,2,5,1,5,1,2,1,6,4,0,0,1,0,8
1394,797345,8,2,3,2,3,0,0,0,1,1,1,0,2,0,2,0,4
1394,797343,2,0,0,0,0,0,0,0,0,0,0,0,1,0,0,0,0
1394,791743,24,3,10,3,10,0,0,0,0,0,4,3,1,1,2,0,6
1394,797341,6,0,0,0,0,0,0,0,2,0,0,0,2,0,1,2,0
1394,786193,27,2,5,0,0,2,5,2,4,1,1,2,0,0,0,0,8
1394,786184,9,1,2,0,0,1,2,0,0,0,0,1,2,1,0,0,3
1394,780711,4,1,1,0,0,1,1,0,0,0,2,0,0,0,1,0,3
1396,786509,28,7,8,7,7,0,1,0,0,5,4,1,1,0,0,1,14
1396,786508,30,8,17,6,10,2,7,2,4,4,6,2,1,1,1,1,20
1396,786507,22,6,11,6,9,0,2,1,3,2,7,2,2,1,2,0,13
1396,785796,25,6,13,5,9,1,4,0,0,1,1,4,1,2,1,0,13
1396,797576,29,3,7,2,3,1,4,3,5,0,3,1,1,0,1,0,10
1396,797579,6,0,1,0,0,0,1,0,0,0,1,0,1,0,0,0,0
1396,786511,6,2,2,0,0,2,2,0,0,0,0,0,1,0,0,0,6
1396,797582,6,0,0,0,0,0,0,0,2,0,2,1,1,0,0,0,0
1396,791896,8,0,1,0,1,0,0,0,0,0,1,0,0,0,0,0,0
1396,791897,15,2,4,2,3,0,1,1,2,0,4,1,1,0,0,0,5
1396,786505,16,1,3,0,1,1,2,1,2,0,0,1,3,0,1,0,4
1396,781325,9,1,4,1,2,0,2,0,0,0,3,1,0,1,0,0,2
1398,785474,19,1,3,1,3,0,0,0,0,3,1,2,2,0,2,0,2
1398,780283,21,4,10,4,10,0,0,3,4,3,7,2,1,0,2,0,11
1398,790925,29,6,9,3,5,3,4,2,2,1,3,1,3,1,2,4,17
1398,780285,21,3,5,2,3,1,2,5,6,2,6,2,4,2,1,1,12
1398,785476,28,5,12,4,11,1,1,1,2,1,4,5,2,1,0,0,12
1398,791456,20,4,6,3,4,1,2,1,2,1,2,0,0,1,0,0,10
1398,785480,20,1,5,1,2,0,3,0,0,0,1,1,1,1,0,0,2
1398,780292,18,2,8,2,8,0,0,3,4,3,7,0,1,0,2,1,7
1398,790926,17,2,4,2,3,0,1,0,0,1,1,1,0,1,1,0,4
1398,796470,4,2,3,2,3,0,0,2,2,0,0,0,1,0,0,0,6
1398,790343,1,0,0,0,0,0,0,0,0,0,0,1,0,0,0,0,0
1398,785478,1,0,0,0,0,0,0,0,0,0,1,0,0,0,0,0,0
1398,796471,1,0,0,0,0,0,0,0,0,0,0,0,0,0,0,0,0
1399,780667,30,6,11,2,6,4,5,2,2,0,1,3,1,0,2,0,18
1399,775680,26,3,10,2,7,1,3,3,5,0,2,1,2,2,1,0,10
1399,776037,18,2,6,2,6,0,0,2,4,0,3,1,5,0,2,0,6
1399,786147,29,2,7,0,3,2,4,0,0,0,0,3,2,1,1,0,6
1399,782643,24,3,8,3,8,0,0,3,4,4,10,0,1,2,5,2,9
1399,791759,18,0,3,0,2,0,1,0,0,0,1,3,1,0,1,0,0
1399,792562,17,2,5,1,3,1,2,0,0,0,3,0,1,0,0,0,5
1399,780588,16,0,4,0,4,0,0,0,0,2,0,0,2,0,0,0,0
1399,785229,7,1,2,1,2,0,0,0,0,0,0,0,2,0,0,0,2
1399,785987,15,0,5,0,1,0,4,0,0,0,0,1,1,0,0,0,0
1400,796674,25,0,4,0,1,0,3,2,2,0,6,0,4,0,2,0,2
1400,779857,25,7,10,7,9,0,1,4,6,1,3,0,1,0,2,1,18
1400,785339,21,1,3,1,1,0,2,1,2,0,2,2,1,0,0,0,3
1400,779976,34,7,11,3,5,4,6,4,6,1,2,3,2,1,4,0,22
1400,774990,28,2,7,2,4,0,3,0,0,0,6,4,2,0,2,0,4
1400,791014,10,0,3,0,2,0,1,0,0,0,1,2,2,0,1,0,0
1400,785126,3,0,1,0,1,0,0,0,0,0,1,0,0,0,0,0,0
1400,796673,3,0,0,0,0,0,0,0,0,0,0,0,0,1,0,0,0
1400,786737,12,1,3,0,0,1,3,0,0,0,3,0,2,0,1,0,3
1400,785961,25,4,5,2,3,2,2,0,0,0,2,2,3,0,0,0,10
1400,781586,12,4,5,4,5,0,0,0,2,2,0,1,3,0,0,0,8
1400,796672,2,0,0,0,0,0,0,0,0,0,0,0,0,0,0,0,0
1401,781174,15,0,2,0,2,0,0,1,2,0,3,0,5,0,1,0,1
1401,781159,31,5,11,3,7,2,4,2,4,3,2,2,4,4,1,0,14
1401,791001,37,8,12,8,12,0,0,3,4,0,3,5,2,0,1,0,19
1401,779972,30,4,12,2,9,2,3,3,4,1,5,0,4,0,3,0,13
1401,775255,35,5,12,5,12,0,0,2,3,1,3,2,2,0,4,0,12
1401,796644,14,2,3,2,3,0,0,2,2,0,0,0,5,0,0,0,6
1401,785320,25,3,6,1,3,2,3,1,2,0,4,3,1,2,1,0,9
1401,796643,13,0,0,0,0,0,0,0,0,1,2,0,0,1,0,0,0
1402,797699,35,13,20,10,13,3,7,1,2,1,1,5,2,3,4,0,30
1402,791956,28,6,9,3,4,3,5,0,0,1,0,0,3,0,0,0,15
1402,780846,37,5,14,4,9,1,5,3,4,2,7,6,1,0,2,0,14
1402,797698,19,2,6,2,3,0,3,1,2,2,3,0,1,2,2,3,5
1402,780844,18,1,3,1,1,0,2,1,1,0,2,1,5,1,1,0,3
1402,797692,21,3,9,1,3,2,6,0,0,1,2,1,3,1,1,0,8
1402,797694,15,2,3,1,1,1,2,0,0,2,1,0,1,1,0,0,5
1402,791954,5,1,2,1,2,0,0,1,2,1,1,1,2,0,1,0,3
1402,797696,12,0,1,0,1,0,0,0,0,1,1,0,2,1,1,0,0
1402,782128,10,0,0,0,0,0,0,0,0,0,1,1,3,0,0,0,0
1403,785649,27,2,10,2,9,0,1,6,6,1,3,1,4,1,2,0,10
1403,785650,23,2,4,0,1,2,3,0,0,0,1,4,0,1,2,0,6
1403,791185,34,1,3,1,2,0,1,3,4,2,6,0,0,1,2,0,5
1403,791187,10,2,5,2,5,0,0,0,0,2,0,0,5,0,4,0,4
1403,796857,15,0,1,0,0,0,1,1,2,1,2,1,0,1,3,0,1
1403,775208,14,5,7,5,7,0,0,2,4,2,2,0,2,0,2,0,12
1403,796860,24,4,7,4,6,0,1,2,3,1,4,0,2,0,6,0,10
1403,796856,14,2,3,0,1,2,2,3,4,0,0,0,2,0,2,0,9
1403,791184,15,1,3,1,1,0,2,0,0,0,4,5,2,2,2,0,2
1403,791183,13,0,3,0,3,0,0,2,2,2,2,0,1,0,1,1,2
1403,796861,7,0,1,0,1,0,0,0,0,0,0,0,1,1,0,0,0
1403,791186,4,0,1,0,0,0,1,0,0,0,0,0,0,0,1,0,0
1404,786772,21,5,7,5,7,0,0,0,1,5,3,1,3,0,4,0,10
1404,781484,26,2,4,1,2,1,2,2,2,1,4,0,1,0,1,2,7
1404,797840,31,4,10,3,8,1,2,4,4,0,5,4,1,2,2,1,13
1404,786769,25,4,6,3,5,1,1,0,0,0,3,3,2,0,1,0,9
1404,786024,26,1,5,0,4,1,1,0,0,0,4,0,2,2,2,0,3
1404,786773,10,0,1,0,1,0,0,0,0,1,4,2,1,0,1,1,0
1404,780002,18,6,7,2,3,4,4,2,2,0,2,1,0,2,1,0,18
1404,790823,16,1,5,1,3,0,2,0,0,0,6,0,0,0,1,1,2
1404,791970,10,1,5,1,3,0,2,1,2,0,2,0,2,1,0,0,3
1404,785441,6,1,3,1,3,0,0,0,0,0,0,0,1,0,1,0,2
1404,791967,7,0,1,0,1,0,0,4,4,2,0,0,1,0,1,0,4
1404,776046,1,0,1,0,0,0,1,0,0,0,0,0,0,0,0,0,0
1404,789094,1,1,1,1,1,0,0,0,0,0,0,0,0,0,0,0,2
1404,797837,1,0,0,0,0,0,0,0,0,0,0,0,0,0,1,0,0
1404,789093,1,0,0,0,0,0,0,0,0,0,0,0,0,0,0,0,0
1405,797325,35,6,7,6,7,0,0,0,3,1,5,1,3,0,2,0,12
1405,797329,27,1,5,0,3,1,2,1,2,2,5,2,2,0,2,0,4
1405,797323,32,4,12,3,10,1,2,0,0,2,2,1,1,3,3,0,9
1405,786236,39,3,15,3,12,0,3,0,0,3,2,1,2,0,1,0,6
1405,780759,27,1,10,1,2,0,8,0,0,0,1,4,3,1,0,0,2
1405,797322,9,1,2,0,1,1,1,0,0,0,2,1,0,1,1,0,3
1405,781002,7,0,1,0,1,0,0,0,0,0,0,0,1,0,2,0,0
1405,786233,2,0,1,0,0,0,1,0,0,0,0,0,0,0,0,0,0
1405,776478,5,0,3,0,0,0,3,2,2,0,1,0,0,0,0,0,2
1405,786239,2,0,1,0,0,0,1,0,0,0,0,0,1,0,1,0,0
1405,786246,6,1,2,0,0,1,2,0,0,0,0,0,1,1,0,1,3
1405,797324,6,0,0,0,0,0,0,0,0,0,0,0,1,0,1,0,0
1405,797327,3,0,0,0,0,0,0,0,0,0,0,0,0,0,0,0,0
1412,791768,8,1,4,1,3,0,1,0,0,1,0,0,2,0,4,0,2
1412,786460,26,0,2,0,2,0,0,0,0,1,3,1,1,0,2,0,0
1412,780604,40,12,18,11,16,1,2,9,11,1,3,3,5,1,1,0,34
1412,780603,20,1,3,1,1,0,2,0,0,0,1,2,4,0,2,0,2
1412,780602,30,3,8,3,6,0,2,2,2,0,5,2,4,0,2,0,8
1412,786071,21,3,3,3,3,0,0,2,3,2,4,0,3,0,1,0,8
1412,791766,18,2,5,1,2,1,3,1,1,1,0,0,4,0,2,0,6
1412,791767,6,0,0,0,0,0,0,0,0,0,1,1,1,0,1,0,0
1412,786230,30,4,14,2,5,2,9,0,0,2,1,3,4,2,2,0,10
1412,797564,1,0,0,0,0,0,0,0,0,0,0,0,0,0,0,0,0
1413,791062,27,4,8,4,7,0,1,1,3,0,3,0,3,0,1,1,9
1413,791063,27,2,5,2,4,0,1,2,4,1,4,3,4,0,4,1,6
1413,785542,31,3,4,2,3,1,1,7,10,1,3,1,1,1,2,0,14
1413,780743,36,8,10,5,7,3,3,7,7,0,6,2,0,4,1,0,26
1413,780055,20,3,4,2,2,1,2,0,0,0,2,1,3,0,0,0,7
1413,791060,20,3,4,3,3,0,1,4,4,0,0,2,4,1,4,0,10
1413,796735,21,2,4,2,2,0,2,0,1,1,1,1,3,1,2,0,4
1413,791064,18,1,4,1,3,0,1,1,2,0,1,0,0,0,0,0,3
1414,797701,22,3,4,3,4,0,0,2,2,2,3,0,1,0,0,0,8
1414,792101,32,8,16,5,8,3,8,5,7,0,3,4,2,3,1,0,24
1414,780923,16,4,6,4,6,0,0,3,4,0,2,4,4,1,1,0,11
1414,775564,35,6,12,6,10,0,2,3,3,3,6,3,4,0,3,1,15
1414,776386,38,7,12,6,9,1,3,3,5,3,8,5,2,1,3,0,18
1414,797700,19,2,4,2,4,0,0,1,2,1,5,0,2,0,1,0,5
1414,797697,0,0,0,0,0,0,0,0,0,0,0,0,1,0,1,0,0
1414,792102,8,0,2,0,0,0,2,2,2,0,1,0,0,0,0,0,2
1414,786156,10,1,2,1,2,0,0,0,0,0,1,1,0,1,1,0,2
1414,786160,18,2,6,1,3,1,3,3,4,0,1,2,4,1,0,0,8
1414,786165,2,0,0,0,0,0,0,0,0,0,0,0,0,0,0,0,0
1415,791023,16,3,5,3,5,0,0,0,0,0,3,0,3,1,1,2,6
1415,791027,34,4,7,4,5,0,2,3,4,3,3,4,2,1,2,0,11
1415,791024,35,3,14,2,8,1,6,4,5,1,1,6,1,0,1,2,11
1415,781507,24,5,8,5,8,0,0,3,5,2,3,2,2,0,2,0,13
1415,777572,32,6,10,3,6,3,4,6,6,1,5,2,2,0,5,0,21
1415,791028,24,3,5,1,1,2,4,0,0,0,4,1,5,1,1,0,8
1415,791727,2,0,2,0,2,0,0,0,0,1,1,0,0,0,0,0,0
1415,796685,29,6,11,1,2,5,9,2,5,0,1,0,3,0,1,0,19
1415,796684,4,0,2,0,2,0,0,2,2,0,1,0,2,1,0,0,2
1416,776004,28,4,10,3,6,1,4,4,6,2,5,2,3,0,2,0,13
1416,780358,19,2,8,2,7,0,1,1,2,2,3,0,4,0,2,3,5
1416,775011,25,4,8,2,2,2,6,1,2,1,0,0,4,0,1,0,11
1416,780357,32,4,9,1,4,3,5,12,12,0,3,0,1,2,1,0,23
1416,775018,36,2,8,1,4,1,4,3,6,0,4,4,3,1,2,0,8
1416,790930,29,1,3,1,2,0,1,2,4,1,5,1,4,1,0,0,4
1416,776270,11,1,1,1,1,0,0,1,2,0,1,1,0,1,1,0,3
1416,796480,17,2,5,2,4,0,1,2,2,1,2,1,1,0,0,2,6
1416,796484,3,0,0,0,0,0,0,0,0,0,0,0,2,0,0,0,0
1417,781407,28,2,6,2,4,0,2,0,0,2,8,1,5,0,4,3,4
1417,791583,26,2,3,2,3,0,0,4,9,2,6,0,3,0,0,0,8
1417,785623,21,3,4,3,3,0,1,0,0,0,2,0,3,1,1,0,6
1417,780580,33,3,14,3,10,0,4,2,4,0,5,1,1,1,3,0,8
1417,776150,29,5,8,2,4,3,4,0,0,0,0,1,1,2,4,1,13
1417,791584,17,2,4,2,4,0,0,4,6,0,1,1,5,0,0,1,8
1417,786659,24,4,7,4,7,0,0,1,2,0,5,0,2,0,2,0,9
1417,797448,11,0,2,0,0,0,2,0,0,0,1,0,4,1,0,0,0
1417,797445,11,1,3,1,3,0,0,4,4,0,0,0,2,0,0,0,6
1418,780879,31,7,13,5,10,2,3,0,2,5,2,1,3,2,3,1,16
1418,775785,20,1,5,1,4,0,1,0,0,0,3,2,2,0,0,0,2
1418,790768,23,4,8,2,4,2,4,2,2,0,1,1,1,1,0,0,12
1418,785226,24,6,13,6,10,0,3,0,0,2,1,1,3,1,1,0,12
1418,780875,25,0,1,0,0,0,1,0,0,1,6,2,1,1,2,1,0
1418,785743,28,4,8,2,5,2,3,0,0,0,1,0,1,3,0,0,10
1418,785224,16,1,2,0,1,1,1,0,0,0,4,0,1,0,1,0,3
1418,796326,8,0,2,0,1,0,1,2,2,0,3,0,0,0,0,0,2
1418,790769,10,0,2,0,2,0,0,0,0,0,1,1,1,0,0,0,0
1418,790767,9,2,3,0,0,2,3,2,2,0,0,0,0,0,1,0,8
1418,796324,2,1,1,1,1,0,0,0,0,1,1,0,0,0,0,0,2
1418,785225,1,0,0,0,0,0,0,0,0,0,0,0,0,0,1,0,0
1418,796041,1,0,0,0,0,0,0,0,0,0,0,0,0,0,0,0,0
1418,796325,1,0,0,0,0,0,0,0,0,0,0,0,0,0,0,0,0
1418,792437,1,0,0,0,0,0,0,0,0,0,0,0,0,0,0,0,0
1419,791585,30,4,7,1,3,3,4,0,0,0,6,0,1,1,1,3,11
1419,780062,19,3,3,3,3,0,0,2,2,0,2,0,1,0,1,0,8
1419,786395,29,3,7,3,6,0,1,0,0,0,2,3,0,1,0,0,6
1419,786394,31,2,10,0,5,2,5,0,0,1,2,2,1,0,4,0,6
1419,780404,22,2,10,2,8,0,2,0,2,2,4,2,2,2,2,1,4
1419,785228,22,2,6,2,2,0,4,0,0,1,0,0,1,0,1,0,4
1419,797041,9,0,0,0,0,0,0,3,6,1,1,1,2,0,2,1,3
1419,791581,24,4,7,3,5,1,2,0,1,1,1,0,3,1,2,0,9
1419,780403,8,0,0,0,0,0,0,0,0,0,0,4,2,0,0,0,0
1419,791582,5,0,0,0,0,0,0,0,0,0,1,0,0,0,1,0,0
1419,797037,1,0,0,0,0,0,0,0,0,0,0,0,0,0,0,0,0
1420,780440,30,6,9,4,5,2,4,5,6,2,14,1,3,1,1,3,19
1420,786431,26,3,4,1,1,2,3,4,4,0,0,1,0,0,2,0,12
1420,781125,25,3,8,3,7,0,1,1,2,3,3,0,1,0,2,2,7
1420,775620,18,2,6,2,5,0,1,0,0,2,2,0,1,0,0,2,4
1420,791621,30,1,10,1,4,0,6,1,2,0,1,4,3,4,1,1,3
1420,781088,22,4,8,3,5,1,3,5,7,2,4,4,2,0,0,0,14
1420,786432,20,2,6,1,2,1,4,0,0,0,5,0,1,0,1,0,5
1420,791619,9,1,3,0,0,1,3,0,0,0,1,0,1,0,0,0,3
1420,791620,12,0,2,0,0,0,2,0,0,1,1,0,2,0,0,0,0
1420,786434,6,0,3,0,3,0,0,0,0,0,0,0,1,0,1,0,0
1420,775622,2,0,1,0,1,0,0,0,0,0,0,0,2,0,1,0,0
1421,797779,24,6,12,3,7,3,5,0,1,3,4,1,4,1,1,0,15
1421,786256,29,6,11,6,10,0,1,0,2,5,5,2,3,0,2,1,12
1421,797776,31,4,14,3,11,1,3,1,5,1,1,4,2,1,3,0,10
1421,797769,31,2,7,1,3,1,4,0,0,1,8,1,3,0,0,1,5
1421,797774,32,1,8,0,2,1,6,0,0,0,2,0,4,0,0,0,3
1421,797778,13,4,7,3,5,1,2,0,0,0,0,0,1,1,0,0,9
1421,797768,10,1,3,1,1,0,2,0,0,0,3,0,1,0,2,0,2
1421,785568,10,0,1,0,0,0,1,1,2,3,0,0,1,0,0,1,1
1421,775106,20,0,5,0,4,0,1,0,0,0,5,3,1,0,0,0,0
1422,797290,21,3,9,1,2,2,7,2,2,0,5,2,3,0,1,2,10
1422,791660,25,3,7,1,1,2,6,0,0,0,0,5,3,1,2,1,8
1422,780509,13,1,2,1,2,0,0,3,4,1,4,2,2,0,2,1,5
1422,797291,23,1,3,0,1,1,2,0,0,1,2,5,0,0,1,1,3
1422,797292,18,1,6,1,6,0,0,1,4,3,4,0,1,1,0,1,3
1422,791661,15,6,10,2,2,4,8,0,0,2,3,0,1,0,2,0,16
1422,797293,19,2,7,2,3,0,4,5,6,1,4,2,4,3,1,0,9
1422,786064,25,3,6,1,2,2,4,0,0,2,8,1,1,0,1,1,8
1422,791658,17,4,5,4,5,0,0,0,0,1,2,0,0,0,0,0,8
1422,791663,11,2,2,2,2,0,0,0,0,1,0,0,0,0,0,0,4
1422,797295,5,1,1,0,0,1,1,0,0,0,0,1,0,0,0,0,3
1422,785658,6,0,2,0,2,0,0,0,0,0,1,1,2,0,2,1,0
1422,797294,2,0,0,0,0,0,0,0,0,1,1,0,0,0,0,0,0
1424,796568,3,0,0,0,0,0,0,0,0,0,0,1,0,0,3,0,0
1424,796566,28,8,12,8,12,0,0,5,9,8,11,3,4,3,3,0,21
1424,790969,35,5,11,4,9,1,2,0,1,0,5,4,3,1,1,1,11
1424,780166,36,4,14,3,10,1,4,2,2,0,2,2,1,0,2,1,11
1424,775107,37,5,7,2,3,3,4,3,3,2,5,0,2,0,3,2,16
1424,781380,6,0,2,0,2,0,0,0,0,0,0,0,1,0,0,0,0
1424,796564,16,2,7,2,7,0,0,0,1,2,1,1,3,0,2,0,4
1424,790971,27,2,6,2,6,0,0,7,12,7,1,0,1,1,1,0,11
1424,796565,3,0,0,0,0,0,0,0,0,0,0,0,0,0,0,0,0
1424,790968,5,0,1,0,0,0,1,0,0,0,0,1,0,1,1,0,0
1424,790967,4,0,1,0,0,0,1,0,0,0,0,0,0,0,1,0,0
1425,792424,13,0,0,0,0,0,0,0,0,1,1,0,4,0,0,1,0
1425,792418,21,3,8,3,7,0,1,0,0,1,2,0,4,1,1,0,6
1425,796693,34,4,12,2,7,2,5,6,8,1,2,3,0,2,3,0,16
1425,796691,27,2,4,1,1,1,3,2,2,0,0,2,1,4,3,0,7
1425,789484,34,7,17,4,13,3,4,3,3,0,5,3,3,0,2,3,20
1425,796692,5,0,1,0,1,0,0,0,0,0,0,0,0,0,0,0,0
1425,792419,8,2,3,1,1,1,2,0,0,0,1,0,0,1,0,0,5
1425,782654,27,2,3,2,3,0,0,4,4,1,2,1,4,1,2,2,8
1425,792421,24,4,9,1,4,3,5,0,0,2,3,1,2,4,1,0,11
1425,792423,7,1,2,1,2,0,0,0,0,1,1,0,1,0,0,0,2
1426,786746,20,1,2,0,0,1,2,4,4,0,8,4,3,0,2,0,7
1426,780178,14,3,6,3,6,0,0,3,4,1,0,0,1,0,0,0,9
1426,775075,15,4,5,4,5,0,0,0,0,2,0,0,4,0,1,0,8
1426,792376,23,11,16,4,4,7,12,1,2,0,3,1,2,1,2,0,30
1426,797883,23,4,6,3,4,1,2,1,1,2,1,5,4,4,3,1,10
1426,797890,20,3,6,2,2,1,4,2,2,1,4,1,1,0,5,1,9
1426,792378,21,3,4,3,4,0,0,0,0,0,5,2,1,3,1,4,6
1426,797888,17,1,2,1,2,0,0,2,3,1,5,2,2,0,2,1,4
1426,785744,5,0,1,0,1,0,0,0,0,0,3,0,1,0,0,1,0
1426,792375,2,0,0,0,0,0,0,0,0,0,1,0,0,0,0,0,0
1426,792374,22,3,5,3,3,0,2,0,0,0,3,4,5,2,3,1,6
1426,797885,18,2,3,1,1,1,2,1,2,0,1,1,0,0,0,0,6
1427,787524,20,4,9,3,5,1,4,4,5,2,1,0,2,1,2,0,13
1427,791774,13,2,6,2,6,0,0,0,0,0,5,0,2,0,2,0,4
1427,791722,20,0,4,0,0,0,4,0,0,1,1,1,2,2,0,0,0
1427,781019,34,2,5,2,4,0,1,7,9,2,2,3,2,2,3,0,11
1427,780017,23,2,9,1,6,1,3,7,7,0,2,1,3,2,5,0,12
1427,775541,14,1,4,1,4,0,0,0,0,1,1,0,1,0,0,0,2
1427,797611,16,2,6,1,2,1,4,2,4,2,0,0,0,0,1,0,7
1427,787522,3,1,1,1,1,0,0,0,0,0,0,0,0,0,0,0,2
1427,783269,24,1,4,1,4,0,0,0,0,2,1,0,2,2,0,1,2
1427,797610,4,1,3,0,1,1,2,0,1,0,1,1,1,0,0,0,3
1427,791772,26,0,6,0,4,0,2,1,3,0,1,2,1,0,1,0,1
1427,776790,3,1,1,1,1,0,0,0,0,0,1,0,0,0,0,0,2
1428,792253,12,3,5,3,5,0,0,3,4,2,2,0,3,1,0,0,9
1428,792249,27,6,8,6,8,0,0,0,1,4,10,3,3,1,4,0,12
1428,792250,19,0,4,0,3,0,1,2,2,1,2,3,3,2,1,0,2
1428,792248,23,5,12,2,2,3,10,2,2,0,5,5,2,0,1,0,15
1428,781445,24,8,13,3,3,5,10,2,2,1,1,2,0,0,1,0,23
1428,797957,22,2,5,2,5,0,0,0,0,2,3,1,2,0,1,0,4
1428,797944,11,0,6,0,1,0,5,0,0,1,6,1,0,2,2,0,0
1428,797941,17,5,5,1,1,4,4,1,4,1,6,0,2,2,1,1,15
1428,792251,20,2,6,2,3,0,3,1,2,3,1,3,2,0,1,0,5
1428,786076,21,5,8,3,5,2,3,2,2,0,4,3,2,2,0,0,14
1428,786072,4,1,3,0,1,1,2,0,0,0,0,1,1,0,0,0,3
1430,778442,36,8,14,6,8,2,6,4,4,1,8,3,2,1,3,0,22
1430,797150,25,2,9,1,4,1,5,1,2,0,3,0,0,0,1,0,6
1430,786637,33,2,7,1,5,1,2,0,7,1,6,1,3,0,4,0,5
1430,791514,20,1,6,1,5,0,1,0,0,0,2,1,2,1,1,1,2
1430,791511,14,1,1,1,1,0,0,0,0,1,2,0,4,0,3,1,2
1430,791513,18,5,9,4,6,1,3,0,0,1,2,2,0,1,0,0,11
1430,797151,19,3,5,3,4,0,1,0,0,2,3,0,0,1,0,0,6
1430,780946,20,1,3,1,3,0,0,0,1,0,2,5,2,3,2,0,2
1430,791515,7,1,1,1,1,0,0,0,0,0,0,1,2,0,1,0,2
1430,797149,4,1,2,1,1,0,1,0,0,0,1,0,0,0,0,0,2
1430,797152,4,0,0,0,0,0,0,0,0,0,0,0,0,0,0,0,0
1431,797208,35,8,14,7,12,1,2,0,3,2,9,0,3,2,1,0,17
1431,780201,33,5,11,5,11,0,0,5,6,4,4,0,5,2,0,1,15
1431,797210,25,4,8,4,8,0,0,0,0,2,1,4,1,2,3,0,8
1431,791467,29,2,11,2,8,0,3,0,0,1,6,3,3,0,2,0,4
1431,775516,29,1,4,1,4,0,0,1,2,0,3,5,1,1,1,0,3
1431,786311,30,5,14,1,6,4,8,2,2,0,4,0,1,1,2,0,16
1431,791469,13,0,1,0,1,0,0,0,0,1,3,0,3,0,1,3,0
1431,798344,5,0,0,0,0,0,0,0,0,0,1,0,0,0,2,0,0
1431,791470,1,0,0,0,0,0,0,0,0,0,0,0,0,0,0,0,0
1432,785811,37,1,11,1,7,0,4,6,7,0,3,2,2,1,1,0,8
1432,786016,33,2,4,2,2,0,2,0,1,2,2,3,3,2,6,0,4
1432,797894,22,1,6,1,6,0,0,0,2,1,0,0,3,0,2,1,2
1432,785954,40,4,12,2,5,2,7,9,10,2,5,1,0,2,2,1,19
1432,780323,25,3,5,3,5,0,0,2,4,2,4,1,4,1,2,4,8
1432,797892,30,1,3,1,2,0,1,8,10,2,2,0,2,3,3,0,10
1432,792234,4,0,0,0,0,0,0,0,0,1,0,0,1,0,0,0,0
1432,781356,4,0,1,0,1,0,0,0,1,1,1,0,0,0,0,0,0
1432,797891,3,0,1,0,0,0,1,0,2,0,0,0,0,0,0,0,0
1432,797893,1,0,0,0,0,0,0,0,0,0,0,0,1,0,0,0,0
1432,792230,1,0,0,0,0,0,0,0,0,0,0,0,0,0,0,0,0
1433,790934,14,0,4,0,3,0,1,0,0,0,2,1,3,0,0,0,0
1433,786803,25,2,6,1,4,1,2,1,2,0,2,1,3,3,4,0,6
1433,781345,31,3,6,2,3,1,3,1,1,1,2,1,3,2,6,0,8
1433,790932,32,5,8,4,5,1,3,3,4,1,2,0,3,0,2,0,14
1433,774936,23,0,3,0,3,0,0,1,2,0,4,1,2,1,1,2,1
1433,790933,9,1,3,1,1,0,2,0,0,0,0,0,2,0,0,0,2
1433,786804,16,0,4,0,2,0,2,0,0,1,2,1,3,0,2,1,0
1433,786805,18,1,4,1,4,0,0,0,0,0,2,0,5,1,4,0,2
1433,790931,17,2,3,1,2,1,1,0,0,0,4,0,3,1,0,0,5
1433,796487,14,2,4,0,0,2,4,0,0,0,0,1,3,0,1,0,6
1433,796488,1,0,0,0,0,0,0,0,0,0,0,0,1,0,0,0,0
1434,785514,36,4,11,4,9,0,2,11,13,1,5,3,2,0,3,0,19
1434,781249,33,6,11,3,5,3,6,0,0,0,7,3,0,0,2,1,15
1434,781253,37,4,9,2,4,2,5,1,2,0,2,0,1,0,0,1,11
1434,785515,34,5,8,4,5,1,3,0,0,1,5,4,1,2,2,0,11
1434,775165,27,4,5,1,2,3,3,0,0,0,3,0,5,1,1,0,11
1434,791252,11,0,1,0,1,0,0,1,2,0,0,2,1,0,0,0,1
1434,796951,13,0,0,0,0,0,0,0,0,0,0,1,2,0,0,0,0
1434,796953,8,0,2,0,1,0,1,0,0,0,2,0,0,0,0,0,0
1434,791251,1,0,0,0,0,0,0,0,0,0,0,0,0,0,0,0,0
1435,785571,29,6,13,3,10,3,3,2,2,0,2,2,0,0,2,0,17
1435,791224,25,7,12,6,11,1,1,2,3,1,4,1,5,2,4,0,17
1435,781181,32,4,7,0,2,4,5,0,0,0,3,4,2,0,1,0,12
1435,775324,13,1,1,1,1,0,0,0,0,0,1,0,1,0,0,0,2
1435,791223,23,0,3,0,3,0,0,0,2,1,1,3,0,3,1,0,0
1435,785564,25,3,7,0,1,3,6,0,0,0,2,0,2,0,0,0,9
1435,791225,22,1,4,1,3,0,1,2,4,0,3,1,3,0,1,1,4
1435,796927,16,2,5,2,3,0,2,0,0,1,3,0,1,0,0,0,4
1435,786436,11,0,0,0,0,0,0,0,0,0,1,0,4,0,1,0,0
1435,791811,4,0,0,0,0,0,0,0,0,0,1,1,1,0,0,0,0
1436,796938,27,7,11,5,7,2,4,9,11,1,2,4,0,6,3,0,25
1436,791236,25,5,5,3,3,2,2,7,10,0,3,0,1,2,1,2,19
1436,776209,29,5,11,5,10,0,1,5,5,1,5,2,0,3,2,4,15
1436,791237,32,4,10,2,6,2,4,1,2,0,12,1,1,6,0,0,11
1436,788124,19,0,0,0,0,0,0,0,0,2,3,0,4,0,2,2,0
1436,791235,25,5,15,4,11,1,4,2,2,6,7,0,2,1,4,0,13
1436,791240,28,4,6,4,5,0,1,2,4,0,3,3,1,2,3,0,10
1436,796939,15,1,4,1,2,0,2,0,0,0,3,0,0,1,1,0,2
1438,796337,23,5,10,1,2,4,8,2,2,1,3,6,2,1,0,0,16
1438,790776,20,3,4,3,4,0,0,0,0,3,3,0,3,0,1,4,6
1438,796332,24,4,5,2,2,2,3,0,0,1,3,3,3,2,1,0,10
1438,785813,30,4,12,4,8,0,4,0,0,0,3,7,1,3,2,0,8
1438,786289,26,5,9,2,2,3,7,2,2,0,3,2,2,0,3,0,15
1438,785827,16,1,3,1,3,0,0,1,2,0,0,0,3,0,0,2,3
1438,796334,18,1,1,0,0,1,1,9,10,1,2,0,2,1,2,1,12
1438,796330,23,4,9,2,6,2,3,5,5,3,3,2,0,1,0,0,15
1438,779975,11,0,0,0,0,0,0,0,0,0,2,1,0,0,1,0,0
1438,796333,3,0,1,0,0,0,1,0,0,0,0,0,2,0,0,0,0
1438,796335,2,0,1,0,0,0,1,0,0,0,1,0,1,0,0,0,0
1438,779973,1,0,0,0,0,0,0,0,0,0,0,0,0,1,0,0,0
1438,796213,2,0,1,0,1,0,0,0,0,1,0,0,0,0,0,0,0
1438,796338,1,0,0,0,0,0,0,0,0,0,0,0,0,0,0,0,0
1439,791051,22,2,4,2,4,0,0,0,2,3,6,1,1,1,2,0,4
1439,780739,26,3,7,3,7,0,0,3,4,0,0,0,2,0,1,1,9
1439,785524,26,3,6,2,3,1,3,2,2,2,1,2,1,0,3,0,9
1439,781115,37,2,6,2,5,0,1,0,0,0,1,4,0,0,3,0,4
1439,775094,20,2,6,1,3,1,3,5,5,0,3,2,2,1,1,0,10
1439,796730,20,1,6,0,1,1,5,1,2,0,3,1,1,0,0,0,4
1439,791053,8,2,3,2,3,0,0,0,0,0,0,0,5,0,1,0,4
1439,785784,4,0,0,0,0,0,0,0,0,0,0,1,0,0,0,0,0
1439,786310,16,1,6,0,2,1,4,0,0,0,1,0,3,1,0,0,3
1439,791052,9,0,1,0,1,0,0,2,4,0,1,0,2,0,0,0,2
1439,796731,12,5,7,5,6,0,1,1,2,2,3,0,1,1,1,0,11
1440,781439,27,4,16,4,11,0,5,2,2,3,0,1,1,1,2,1,10
1440,781322,26,2,5,1,2,1,3,2,2,1,3,0,4,0,2,0,7
1440,786571,31,2,9,2,6,0,3,2,6,1,8,1,5,0,3,0,6
1440,780563,26,1,4,1,3,0,1,0,0,4,3,5,1,1,1,0,2
1440,785989,36,6,15,5,11,1,4,4,5,2,7,6,3,1,5,0,17
1440,781419,28,7,9,1,2,6,7,0,0,0,2,1,4,0,2,0,20
1440,781207,15,1,2,1,2,0,0,0,0,1,2,0,1,0,1,0,2
1440,791690,11,0,1,0,1,0,0,0,0,1,0,0,0,0,0,0,0
1441,785353,23,4,9,2,3,2,6,2,2,0,3,0,2,1,4,0,12
1441,781457,27,7,12,4,7,3,5,7,8,0,1,3,4,0,2,0,24
1441,781673,38,1,9,0,1,1,8,4,5,1,3,2,4,3,0,0,7
1441,780876,16,3,7,3,6,0,1,0,0,0,3,3,2,1,0,0,6
1441,781462,33,5,8,4,7,1,1,2,3,4,4,4,3,1,0,2,13
1441,785355,33,5,7,4,5,1,2,0,0,3,5,0,0,2,0,0,11
1441,790895,30,1,6,1,4,0,2,0,2,0,5,1,4,0,2,0,2
1444,785863,24,11,13,10,12,1,1,0,0,0,6,3,1,1,0,1,23
1444,785631,21,2,7,2,6,0,1,2,2,0,8,2,0,0,4,3,6
1444,786248,15,5,5,5,5,0,0,0,0,2,1,1,0,2,1,0,10
1444,785630,19,1,2,1,1,0,1,2,2,1,0,1,1,0,2,0,4
1444,780777,25,6,10,5,9,1,1,0,0,0,4,5,0,2,2,0,13
1444,796899,5,1,2,1,2,0,0,0,0,1,1,0,1,0,0,0,2
1444,791199,13,1,2,1,2,0,0,0,1,1,1,1,1,0,1,2,2
1444,791197,11,2,2,2,2,0,0,0,1,0,1,0,2,0,0,0,4
1444,796900,1,1,1,1,1,0,0,0,0,0,0,0,0,0,0,0,2
1444,796898,5,1,4,1,2,0,2,0,0,3,0,0,1,0,1,1,2
1444,791198,13,1,2,0,0,1,2,0,0,1,1,1,1,0,0,0,3
1444,791196,7,1,3,0,1,1,2,0,0,0,2,2,2,1,1,0,3
1444,791200,21,3,8,3,4,0,4,1,2,0,1,3,2,1,2,0,7
1444,785632,17,4,4,4,4,0,0,1,1,1,2,0,1,1,0,0,9
1444,781129,1,0,0,0,0,0,0,0,0,0,1,0,0,0,0,0,0
1444,791195,2,0,0,0,0,0,0,0,0,0,0,0,0,0,0,0,0
1446,796469,22,7,14,4,7,3,7,1,1,0,2,0,2,0,1,3,18
1446,779981,20,2,5,2,5,0,0,4,4,5,4,1,2,0,1,1,8
1446,785463,30,3,7,2,5,1,2,4,5,2,3,6,2,1,3,0,11
1446,779978,34,2,6,1,4,1,2,0,0,0,1,6,2,2,2,0,5
1446,776003,28,3,8,2,2,1,6,4,6,0,6,2,1,1,1,0,11
1446,790923,23,3,5,3,5,0,0,2,2,0,4,1,2,1,2,2,8
1446,779980,14,2,3,2,3,0,0,0,0,1,2,0,1,0,0,1,4
1446,785466,5,0,0,0,0,0,0,0,0,1,0,0,2,0,1,0,0
1446,785462,12,1,4,1,3,0,1,0,0,1,1,0,0,0,1,0,2
1446,790924,7,1,2,1,1,0,1,2,2,0,0,0,0,0,0,0,4
1446,785467,4,1,2,0,0,1,2,0,0,0,1,0,0,0,1,0,3
1446,789977,1,0,1,0,0,0,1,0,0,1,0,0,0,0,1,0,0
1447,792227,26,4,8,4,7,0,1,0,0,2,4,1,0,1,1,2,8
1447,781352,18,3,7,3,7,0,0,0,0,1,1,0,3,1,5,0,6
1447,785935,37,5,14,3,10,2,4,2,2,0,4,0,3,1,5,0,14
1447,781340,34,4,7,4,6,0,1,0,1,1,3,2,3,3,1,0,8
1447,776128,16,0,1,0,1,0,0,0,0,1,0,2,1,2,0,0,0
1447,792223,8,1,5,1,3,0,2,0,0,1,1,3,2,1,1,0,2
1447,797881,14,2,5,2,5,0,0,1,3,0,2,0,0,0,0,1,5
1447,781351,11,1,3,1,2,0,1,2,2,1,1,0,0,0,0,1,4
1447,786453,18,1,5,1,4,0,1,0,0,0,1,0,1,0,0,1,2
1447,792228,6,0,1,0,1,0,0,2,2,0,0,0,0,0,0,1,2
1447,797889,8,0,1,0,1,0,0,0,0,0,0,0,2,0,0,0,0
1447,797886,2,1,3,1,3,0,0,0,0,3,0,0,0,1,0,0,2
1447,797882,2,0,1,0,0,0,1,0,0,0,0,0,0,0,0,0,0
1448,791686,22,1,5,1,3,0,2,3,3,0,3,1,1,1,0,2,5
1448,798028,25,1,6,1,5,0,1,0,0,0,5,3,1,3,2,1,2
1448,792270,32,5,9,5,8,0,1,5,5,3,8,1,2,3,2,1,15
1448,790940,33,4,11,4,6,0,5,0,0,0,3,1,2,2,2,0,8
1448,780770,28,5,7,2,3,3,4,2,2,0,0,6,4,0,3,0,15
1448,792271,11,1,3,1,2,0,1,0,0,1,3,0,1,0,2,0,2
1448,786060,14,1,3,1,1,0,2,0,0,0,2,0,0,0,0,0,2
1448,792269,16,0,1,0,0,0,1,2,2,1,2,0,1,1,1,1,2
1448,798022,16,3,6,2,2,1,4,0,0,0,5,2,0,0,1,1,7
1448,792305,2,0,0,0,0,0,0,0,0,0,1,0,0,0,0,0,0
1448,798020,1,0,1,0,0,0,1,0,0,0,0,0,0,0,0,0,0
1449,792082,17,1,6,1,4,0,2,0,0,1,3,1,3,0,2,0,2
1449,786067,29,1,7,1,7,0,0,2,3,4,5,1,0,1,2,0,4
1449,792083,24,0,4,0,2,0,2,3,4,0,2,3,2,1,3,0,3
1449,785591,23,1,10,1,9,0,1,0,0,0,0,1,2,2,2,0,2
1449,780258,27,4,11,3,4,1,7,1,2,1,1,2,0,1,2,0,10
1449,792078,17,1,2,1,2,0,0,0,0,1,4,0,4,0,1,1,2
1449,797661,21,4,8,1,3,3,5,0,2,0,6,0,1,0,4,0,11
1449,797660,24,0,2,0,1,0,1,1,2,0,2,1,0,0,1,0,1
1449,797659,10,1,3,0,1,1,2,0,0,0,0,1,1,0,0,0,3
1449,791952,5,0,0,0,0,0,0,0,0,0,0,0,1,0,0,0,0
1449,792079,2,0,0,0,0,0,0,0,0,0,0,0,0,0,0,0,0
1449,797664,1,0,0,0,0,0,0,0,0,0,0,0,0,0,0,0,0
1450,785536,20,1,4,0,1,1,3,0,0,0,9,0,1,3,0,3,3
1450,780119,27,4,9,4,8,0,1,3,6,3,1,2,1,0,2,1,11
1450,776097,25,5,9,4,5,1,4,1,2,0,4,2,1,2,2,0,12
1450,796559,26,5,10,3,6,2,4,0,0,3,2,2,1,0,2,1,12
1450,785280,21,4,7,1,2,3,5,0,1,0,3,5,0,1,0,1,11
1450,780149,15,5,11,3,3,2,8,0,1,0,2,0,1,1,0,0,12
1450,796560,13,0,1,0,0,0,1,0,2,0,2,0,1,0,1,2,0
1450,775679,14,1,4,0,0,1,4,0,0,2,0,2,2,0,1,0,3
1450,796561,14,0,4,0,2,0,2,1,2,0,2,1,1,1,2,0,1
1450,796558,16,5,8,4,7,1,1,3,3,3,4,2,1,0,1,0,14
1450,785285,5,0,0,0,0,0,0,0,0,1,1,0,0,0,0,0,0
1450,792636,2,0,0,0,0,0,0,0,0,0,0,0,0,0,1,0,0
1450,781908,1,0,0,0,0,0,0,0,0,0,0,0,0,0,0,0,0
1450,796562,1,0,0,0,0,0,0,0,0,0,0,0,0,0,0,0,0
1451,792055,21,4,11,4,10,0,1,0,0,2,3,0,1,0,1,0,8
1451,792062,12,0,4,0,4,0,0,0,0,2,2,0,0,0,1,0,0
1451,792059,27,4,9,4,5,0,4,0,0,1,2,0,1,1,2,0,8
1451,789028,31,4,8,3,7,1,1,0,0,1,5,1,2,1,4,0,9
1451,775323,29,0,9,0,4,0,5,0,0,1,3,0,1,2,1,0,0
1451,786836,5,0,2,0,2,0,0,0,0,0,0,1,1,0,0,0,0
1451,790779,12,3,5,3,5,0,0,1,2,1,2,0,4,1,1,0,7
1451,797651,9,0,2,0,0,0,2,0,0,0,1,2,5,0,2,0,0
1451,776426,2,0,1,0,1,0,0,0,0,0,0,0,2,0,0,0,0
1451,775523,4,0,1,0,1,0,0,0,0,0,1,0,1,0,0,0,0
1451,789029,4,0,0,0,0,0,0,0,0,0,0,1,0,0,1,0,0
1451,797649,13,0,3,0,3,0,0,0,0,0,4,0,0,0,0,0,0
1451,797650,9,1,3,1,3,0,0,2,4,0,0,0,2,0,0,0,4
1451,792058,13,2,5,2,5,0,0,4,4,0,2,0,0,1,0,0,8
1451,792067,7,0,0,0,0,0,0,0,0,0,1,0,0,0,0,0,0
1451,792056,2,0,0,0,0,0,0,0,0,0,1,0,1,0,1,0,0
1452,785412,24,5,11,5,8,0,3,2,2,1,6,3,3,2,6,0,12
1452,776214,34,4,11,3,8,1,3,5,5,1,1,1,4,0,1,2,14
1452,780099,36,5,12,1,4,4,8,3,4,0,4,0,0,1,3,0,17
1452,780021,22,3,3,3,3,0,0,2,6,4,5,2,2,0,1,0,8
1452,790863,15,1,3,1,1,0,2,0,0,0,2,1,3,0,1,0,2
1452,776221,24,0,0,0,0,0,0,0,2,0,2,5,3,0,1,0,0
1452,775686,24,2,3,2,3,0,0,2,2,1,6,0,4,0,1,0,6
1452,785413,14,4,5,4,5,0,0,0,0,1,2,0,0,0,0,0,8
1452,785417,5,1,1,1,1,0,0,0,0,0,0,0,0,0,0,0,2
1452,785411,2,0,0,0,0,0,0,0,0,0,0,0,0,0,0,0,0
1453,784268,37,2,8,1,4,1,4,0,0,0,1,5,3,2,3,0,5
1453,786318,32,1,9,0,1,1,8,6,6,2,3,1,3,0,0,0,9
1453,780223,24,3,7,1,3,2,4,2,3,0,2,0,3,0,1,0,10
1453,791482,28,3,5,1,3,2,2,2,2,0,2,1,2,0,0,1,10
1453,797198,7,1,4,1,2,0,2,0,0,0,0,1,2,1,0,0,2
1453,780225,28,1,3,0,0,1,3,0,0,0,2,1,1,1,0,0,3
1453,786319,15,4,7,4,7,0,0,4,8,3,2,0,4,0,2,0,12
1453,791481,20,2,4,2,2,0,2,1,1,0,4,1,4,1,1,0,5
1453,797199,8,1,3,1,3,0,0,2,2,0,1,0,0,0,0,0,4
1453,797201,1,0,0,0,0,0,0,0,0,0,0,0,0,0,0,0,0
1454,796719,21,1,3,0,1,1,2,0,0,1,5,0,3,0,0,0,3
1454,785512,28,0,5,0,5,0,0,1,2,1,4,0,1,0,0,0,1
1454,776374,22,2,8,2,6,0,2,6,6,3,2,4,0,1,1,1,10
1454,796718,32,6,10,3,6,3,4,1,2,1,2,1,2,0,1,2,16
1454,775412,32,1,7,0,0,1,7,2,2,0,3,1,4,0,1,0,5
1454,796717,16,5,6,5,6,0,0,5,6,0,2,3,2,0,0,1,15
1454,791042,25,6,13,5,10,1,3,3,4,1,5,0,3,0,3,1,16
1454,796723,22,1,7,0,2,1,5,0,0,0,3,4,1,1,0,0,3
1454,766998,2,0,0,0,0,0,0,0,0,0,0,0,2,0,1,0,0
1455,776328,28,2,5,2,3,0,2,0,0,0,7,1,0,1,0,1,4
1455,780717,33,7,18,7,17,0,1,3,5,2,12,1,3,2,0,0,17
1455,786203,38,5,13,4,9,1,4,3,4,2,5,3,3,0,3,0,14
1455,791738,22,3,5,3,5,0,0,1,4,3,3,0,1,0,1,3,7
1455,791740,34,4,7,2,3,2,4,5,5,0,2,2,2,0,0,0,15
1455,797334,6,2,2,0,0,2,2,0,0,0,0,1,4,0,1,1,6
1455,786315,9,0,0,0,0,0,0,0,0,0,0,2,2,0,2,0,0
1455,791741,10,3,5,3,4,0,1,1,2,0,1,1,0,0,0,0,7
1455,774859,2,0,0,0,0,0,0,0,0,1,0,0,0,0,0,0,0
1455,786197,18,3,6,3,5,0,1,0,0,0,1,1,1,0,1,1,6
1456,797823,21,2,6,2,6,0,0,2,4,2,5,0,0,2,1,1,6
1456,780505,32,6,15,5,12,1,3,4,9,0,8,2,2,2,4,0,17
1456,792283,26,2,7,2,5,0,2,1,1,0,5,1,2,1,1,0,5
1456,797831,24,4,6,1,2,3,4,0,0,1,3,1,2,0,5,0,11
1456,792280,36,5,7,4,6,1,1,8,8,2,2,4,1,1,4,2,19
1456,799468,8,0,1,0,1,0,0,0,0,0,1,2,1,1,0,0,0
1456,797826,8,0,0,0,0,0,0,0,2,0,1,0,2,1,0,0,0
1456,792286,18,1,2,1,2,0,0,1,2,2,2,1,2,0,0,3,3
1456,792284,25,0,3,0,2,0,1,0,0,0,2,1,2,0,1,0,0
1456,797829,2,0,0,0,0,0,0,0,0,0,1,0,0,0,1,0,0
1457,776079,27,1,4,0,2,1,2,0,0,1,2,3,2,3,3,1,3
1457,797070,32,5,8,3,5,2,3,2,2,0,8,2,1,1,1,0,14
1457,777865,17,3,8,1,4,2,4,0,0,0,4,1,1,0,0,0,8
1457,791432,35,3,11,1,5,2,6,0,0,0,1,1,4,1,2,0,8
1457,781650,23,6,11,6,11,0,0,0,0,0,0,0,2,1,4,0,12
1457,780180,8,0,1,0,0,0,1,0,0,0,0,1,2,0,0,0,0
1457,797066,7,0,0,0,0,0,0,0,0,2,3,0,1,0,1,0,0
1457,797068,22,5,14,5,9,0,5,3,3,0,0,1,4,2,1,0,13
1457,797067,6,0,1,0,1,0,0,0,0,0,0,0,0,0,1,0,0
1457,785401,10,0,1,0,1,0,0,0,2,0,2,1,4,0,1,0,0
1457,791429,13,0,2,0,1,0,1,0,2,0,2,2,1,0,0,0,0
1458,786566,32,9,13,5,7,4,6,4,4,1,7,0,4,1,4,2,26
1458,781204,23,2,4,1,1,1,3,0,0,1,5,0,4,3,0,0,5
1458,791993,31,3,9,3,6,0,3,0,0,0,2,5,1,0,1,1,6
1458,781189,29,1,4,1,3,0,1,0,0,0,0,4,3,2,2,0,2
1458,781188,37,4,12,3,7,1,5,0,1,0,2,11,3,2,4,0,9
1458,791997,20,5,7,1,2,4,5,0,0,0,3,0,2,0,1,0,14
1458,786563,28,5,8,3,5,2,3,0,0,2,2,1,2,1,0,0,12
1459,785532,17,2,2,2,2,0,0,0,0,1,2,0,3,0,1,0,4
1459,780063,39,8,14,6,9,2,5,3,4,5,3,0,0,0,1,0,21
1459,791055,29,0,2,0,2,0,0,1,2,1,3,4,5,4,2,0,1
1459,785530,35,9,19,7,12,2,7,7,9,1,4,2,4,0,3,0,27
1459,775926,34,1,7,1,2,0,5,2,2,0,6,3,0,1,2,1,4
1459,775573,29,1,6,0,0,1,6,1,2,0,3,0,1,1,2,0,4
1459,791058,6,0,1,0,1,0,0,0,0,0,2,1,2,0,2,0,0
1459,791059,2,0,0,0,0,0,0,0,0,1,0,0,1,0,1,0,0
1459,791057,3,0,1,0,0,0,1,1,2,0,1,0,0,0,0,0,1
1459,796733,6,0,1,0,1,0,0,0,0,2,0,0,0,0,1,0,0
1460,791917,17,2,6,1,2,1,4,2,2,0,3,0,4,1,0,2,7
1460,786526,31,2,6,1,2,1,4,0,0,0,7,3,4,0,2,2,5
1460,786525,32,3,9,3,6,0,3,2,4,0,6,0,0,2,1,0,8
1460,791914,34,2,9,0,3,2,6,8,11,0,4,6,2,0,3,0,14
1460,786030,33,5,15,3,7,2,8,0,2,0,3,2,2,0,2,0,12
1460,786856,23,3,5,3,5,0,0,7,7,3,4,3,1,1,2,1,13
1460,797550,10,1,3,0,1,1,2,0,0,0,1,1,1,0,0,0,3
1460,781109,10,1,2,1,2,0,0,0,0,1,1,0,5,1,1,0,2
1460,786524,10,2,2,1,1,1,1,1,1,0,1,0,1,0,0,0,6
1461,791876,40,9,19,8,13,1,6,1,5,5,15,0,0,0,1,1,20
1461,791877,21,0,2,0,2,0,0,2,2,0,4,0,5,1,1,1,2
1461,785667,14,0,5,0,2,0,3,0,0,2,2,1,3,0,1,0,0
1461,786572,33,6,13,5,11,1,2,5,6,5,3,1,2,0,2,0,18
1461,786570,34,6,16,1,7,5,9,4,7,1,6,4,4,1,4,0,21
1461,797490,10,1,3,1,3,0,0,1,1,2,1,1,2,0,2,0,3
1461,797491,33,3,11,2,8,1,3,0,0,2,2,2,2,1,0,0,7
1461,797486,7,0,1,0,1,0,0,0,0,0,0,3,3,1,1,0,0
1461,781205,1,0,1,0,1,0,0,0,0,0,0,0,0,0,0,0,0
1461,797487,7,0,0,0,0,0,0,0,0,0,0,0,3,0,1,0,0
1462,775142,23,6,14,5,9,1,5,0,0,0,1,3,2,0,2,0,13
1462,780094,29,5,9,4,5,1,4,0,0,3,3,3,1,2,3,2,11
1462,790843,32,10,14,7,7,3,7,0,0,1,0,2,1,3,2,1,23
1462,781563,21,2,2,2,2,0,0,0,2,0,5,3,1,0,2,0,4
1462,790842,18,10,10,10,10,0,0,2,2,2,3,0,5,2,1,0,22
1462,790844,20,2,3,1,1,1,2,3,4,1,3,2,0,1,1,2,8
1462,796914,22,1,6,1,2,0,4,0,0,0,3,5,3,1,2,0,2
1462,786212,25,1,3,1,2,0,1,0,1,1,3,2,2,1,0,0,2
1462,790847,6,1,2,1,2,0,0,0,0,0,1,0,1,0,2,1,2
1462,781161,2,0,0,0,0,0,0,0,0,0,1,0,0,0,0,0,0
1462,796915,1,0,0,0,0,0,0,0,0,0,0,0,0,0,0,0,0
1462,785396,1,0,0,0,0,0,0,0,0,0,0,0,0,0,0,0,0
1463,781656,19,2,4,2,4,0,0,0,0,2,4,1,1,0,5,0,4
1463,781658,26,4,9,4,9,0,0,0,0,1,3,2,4,2,1,0,8
1463,780129,33,2,8,2,5,0,3,2,3,1,2,3,2,1,6,0,6
1463,786798,35,3,9,3,8,0,1,3,4,3,2,7,1,1,3,0,9
1463,796962,22,2,8,1,4,1,4,3,4,0,1,1,1,1,2,0,8
1463,798206,19,5,8,4,4,1,4,0,0,1,2,0,1,1,0,0,11
1463,796964,3,0,2,0,1,0,1,0,0,0,0,0,1,0,1,0,0
1463,791263,15,5,7,5,7,0,0,2,3,3,3,0,0,0,0,0,12
1463,791264,15,1,3,1,2,0,1,3,4,1,1,0,2,1,1,0,5
1463,796967,7,1,1,0,0,1,1,0,0,0,0,0,1,0,0,0,3
1463,796961,2,0,1,0,1,0,0,0,0,0,0,0,0,0,0,0,0
1463,790256,2,0,0,0,0,0,0,0,0,0,0,0,0,0,0,0,0
1463,796966,2,0,0,0,0,0,0,0,0,0,0,0,0,0,0,0,0
1470,786534,34,10,15,8,11,2,4,0,0,0,3,11,2,5,3,0,22
1470,797517,27,8,13,8,13,0,0,1,2,6,7,1,1,1,1,0,17
1470,791940,33,4,8,3,4,1,4,5,6,2,2,2,1,0,1,0,14
1470,781132,32,4,12,3,5,1,7,4,6,0,7,6,2,1,2,2,13
1470,797521,11,3,8,2,4,1,4,0,1,2,2,0,2,0,0,1,7
1470,797522,2,1,1,1,1,0,0,1,2,0,1,0,1,0,0,0,3
1470,797518,6,1,2,1,1,0,1,0,0,0,0,1,0,0,0,0,2
1470,786539,8,0,0,0,0,0,0,1,2,0,0,0,0,0,0,0,1
1470,797520,4,0,0,0,0,0,0,0,0,0,0,0,0,0,0,0,0
1470,797519,15,1,3,1,2,0,1,0,1,2,2,2,1,0,0,1,2
1470,791938,28,4,6,3,4,1,2,2,3,0,0,1,2,3,2,1,11
1472,785490,22,4,6,4,5,0,1,0,0,0,4,1,0,0,0,1,8
1472,785495,30,7,14,6,11,1,3,2,2,1,11,4,0,2,3,0,17
1472,785659,21,3,3,3,3,0,0,1,2,1,1,1,2,1,0,0,7
1472,785494,34,5,10,3,7,2,3,0,0,0,2,5,0,1,3,0,12
1472,780698,33,5,11,4,8,1,3,2,2,3,8,9,3,2,5,1,13
1472,791034,13,2,4,2,3,0,1,0,0,1,4,0,1,0,1,0,4
1472,791130,15,4,10,2,3,2,7,1,2,0,0,2,3,0,2,0,11
1472,791033,6,0,1,0,0,0,1,0,0,0,0,0,2,0,0,0,0
1472,785486,8,0,0,0,0,0,0,2,2,0,1,0,2,1,0,0,2
1472,780427,18,3,5,3,4,0,1,1,1,3,0,2,1,2,0,0,7
1474,785589,26,7,19,7,18,0,1,6,9,4,8,1,4,0,3,0,20
1474,791216,29,4,9,4,6,0,3,2,3,2,3,5,2,1,2,0,10
1474,791209,28,3,6,3,6,0,0,0,1,0,3,0,3,0,0,1,6
1474,791215,12,1,1,0,0,1,1,0,0,0,0,3,1,0,0,0,3
1474,791214,30,0,4,0,3,0,1,6,6,2,3,8,1,2,2,0,6
1474,791213,28,6,11,3,8,3,3,1,1,0,2,1,2,0,2,1,16
1474,776313,20,0,4,0,2,0,2,1,2,4,4,0,1,1,2,2,1
1474,776364,5,0,1,0,1,0,0,0,0,0,0,0,2,0,0,0,0
1474,796917,16,4,6,3,5,1,1,0,0,0,3,3,0,1,0,0,9
1474,791207,6,0,1,0,1,0,0,2,2,0,1,0,0,0,0,1,2
1475,797616,29,4,9,4,7,0,2,1,3,2,7,2,1,1,2,1,9
1475,791882,9,2,2,2,2,0,0,2,2,1,3,0,1,0,1,0,6
1475,786491,28,2,7,2,4,0,3,5,6,0,3,1,4,0,1,0,9
1475,791881,35,2,7,1,4,1,3,6,6,2,4,4,4,3,4,0,11
1475,786420,36,2,10,1,3,1,7,0,0,1,1,4,4,1,0,0,5
1475,797618,13,2,4,2,4,0,0,0,0,1,2,1,4,0,0,1,4
1475,781052,30,5,11,0,0,5,11,0,0,1,4,1,2,0,1,0,15
1475,797613,13,2,7,1,3,1,4,3,3,1,1,0,0,0,1,0,8
1475,781258,7,0,1,0,0,0,1,0,0,0,0,1,0,0,1,0,0
1476,785822,14,2,4,2,4,0,0,0,0,0,5,0,5,0,0,0,4
1476,761149,27,6,11,4,6,2,5,1,1,2,0,1,3,1,1,0,15
1476,792032,33,2,9,2,7,0,2,1,2,0,1,8,2,0,0,1,5
1476,792031,24,1,3,0,0,1,3,1,2,1,3,3,1,0,2,0,4
1476,780828,36,12,25,7,16,5,9,1,2,0,5,1,2,0,1,0,30
1476,797641,7,0,0,0,0,0,0,0,1,1,0,1,0,0,1,0,0
1476,792029,19,2,4,2,4,0,0,1,2,1,4,0,5,0,2,1,5
1476,797637,9,1,2,1,1,0,1,0,0,0,0,0,0,1,0,0,2
1476,797636,11,0,0,0,0,0,0,0,0,0,0,2,1,0,1,0,0
1476,792030,4,0,0,0,0,0,0,0,0,0,1,0,1,0,0,0,0
1476,792027,16,2,4,2,3,0,1,2,3,0,3,2,0,1,0,0,6
1477,797628,27,2,6,2,4,0,2,7,9,2,4,1,1,0,0,0,11
1477,786481,33,10,15,9,13,1,2,5,6,1,5,1,1,1,3,0,26
1477,797626,36,5,8,4,5,1,3,1,3,1,8,3,4,0,3,0,12
1477,797624,31,2,7,1,2,1,5,3,4,2,2,0,2,0,0,0,8
1477,785965,22,4,9,4,7,0,2,2,2,0,2,1,4,0,1,0,10
1477,791793,7,0,1,0,1,0,0,0,0,0,1,1,0,0,0,0,0
1477,791791,14,1,3,0,0,1,3,0,0,1,0,1,1,0,0,0,3
1477,797627,5,0,1,0,1,0,0,0,0,0,1,0,1,0,0,0,0
1477,781032,25,2,4,1,2,1,2,0,1,0,4,0,3,0,3,1,5
1478,796817,9,0,0,0,0,0,0,0,0,0,1,0,1,0,0,0,0
1478,780629,28,2,8,1,5,1,3,2,4,0,7,2,3,1,3,0,7
1478,775888,39,11,13,9,10,2,3,10,15,1,9,8,0,4,7,4,34
1478,796815,30,1,6,1,4,0,2,1,2,0,3,4,0,0,1,0,3
1478,796816,33,7,9,6,6,1,3,5,9,0,4,0,3,1,2,1,20
1478,791159,10,1,6,1,3,0,3,0,0,0,3,0,4,0,1,0,2
1478,792111,23,3,6,0,0,3,6,2,2,0,3,2,5,0,2,1,11
1478,785346,28,3,5,0,0,3,5,0,0,0,2,0,4,0,1,0,9
1479,785800,20,1,7,1,2,0,5,2,2,1,2,0,3,0,2,0,4
1479,785799,9,2,4,2,4,0,0,0,0,2,2,0,3,0,2,0,4
1479,780760,19,0,8,0,1,0,7,0,0,3,3,0,3,0,0,0,0
1479,780554,26,3,8,3,6,0,2,2,3,4,1,1,2,2,0,0,8
1479,780553,36,11,25,11,23,0,2,2,3,1,8,5,1,1,5,0,24
1479,797426,3,0,3,0,0,0,3,0,0,1,0,0,1,1,0,0,0
1479,791678,17,2,3,2,2,0,1,3,4,2,4,0,3,0,1,2,7
1479,791679,6,1,2,1,2,0,0,0,0,0,1,1,1,1,2,0,2
1479,785807,24,7,11,5,5,2,6,2,3,4,4,1,2,0,0,1,18
1479,797427,16,2,6,0,0,2,6,0,0,0,3,0,0,0,1,0,6
1479,791677,2,0,0,0,0,0,0,0,0,0,0,1,2,1,1,0,0
1479,791676,22,2,5,1,1,1,4,2,2,0,2,1,2,2,2,0,7
1480,796404,32,4,10,4,10,0,0,1,2,2,9,0,1,1,0,5,9
1480,785434,34,7,12,5,8,2,4,2,2,1,4,1,3,0,0,0,18
1480,790849,32,2,5,1,2,1,3,0,0,0,1,6,2,3,3,0,5
1480,781164,28,2,8,2,4,0,4,1,1,0,3,7,2,1,1,0,5
1480,781163,34,9,17,6,11,3,6,10,12,1,0,1,4,0,2,0,31
1480,790854,8,0,1,0,1,0,0,0,0,1,0,0,1,0,0,1,0
1480,790850,21,4,12,1,5,3,7,3,3,2,1,0,2,0,0,0,14
1480,796405,4,0,0,0,0,0,0,0,0,0,1,0,1,1,1,0,0
1480,781223,11,0,3,0,2,0,1,0,0,0,1,2,2,0,0,0,0
1480,796406,6,0,1,0,1,0,0,0,0,2,3,0,1,0,1,0,0
1480,790848,8,0,0,0,0,0,0,0,0,1,1,2,1,0,0,0,0
1480,790853,7,2,4,2,4,0,0,0,0,1,1,0,1,0,0,0,4
1481,797482,41,9,17,9,16,0,1,4,4,3,6,1,2,1,2,0,22
1481,797485,35,2,7,0,3,2,4,2,4,1,7,2,3,0,1,0,8
1481,797481,37,2,8,2,6,0,2,3,4,3,4,1,3,0,3,0,7
1481,797480,32,6,11,5,8,1,3,5,7,0,3,3,2,0,1,0,18
1481,785944,39,8,15,4,7,4,8,6,7,0,6,4,1,1,2,0,26
1481,797483,10,0,2,0,2,0,0,0,0,2,2,1,0,0,1,1,0
1481,797478,15,3,4,3,4,0,0,0,0,0,3,0,3,2,0,0,6
1481,781217,9,0,1,0,0,0,1,0,0,0,0,0,2,0,1,0,0
1481,791873,6,0,0,0,0,0,0,0,0,0,0,0,0,0,1,0,0
1481,797479,1,0,0,0,0,0,0,0,0,0,0,0,0,0,0,0,0
1482,786502,31,2,9,2,7,0,2,9,13,1,2,3,4,3,4,0,13
1482,781080,35,4,8,2,5,2,3,2,2,0,1,1,0,1,1,0,12
1482,781561,26,3,8,3,5,0,3,3,3,0,2,1,2,0,5,0,9
1482,781078,26,3,8,1,4,2,4,0,0,1,2,0,3,0,0,0,8
1482,791895,21,1,3,1,3,0,0,2,2,1,3,1,1,0,2,0,4
1482,797584,12,1,1,1,1,0,0,0,0,0,0,0,0,1,0,0,2
1482,786501,14,0,5,0,1,0,4,1,2,0,1,0,0,0,0,0,1
1482,791891,13,0,4,0,2,0,2,1,2,0,0,0,0,0,0,0,1
1482,797587,18,0,1,0,1,0,0,0,0,3,2,2,2,0,0,1,0
1482,797583,1,0,1,0,0,0,1,0,0,0,0,0,0,0,0,0,0
1482,791892,1,0,1,0,0,0,1,0,0,0,0,0,0,0,0,0,0
1482,791894,1,0,0,0,0,0,0,0,0,0,0,0,0,0,0,0,0
1482,797586,1,0,1,0,1,0,0,0,0,0,2,0,0,0,0,0,0
1483,776344,17,6,8,3,5,3,3,2,2,1,0,1,4,0,3,0,17
1483,781538,25,4,5,1,2,3,3,0,0,0,3,1,2,0,1,0,11
1483,792453,20,4,6,3,4,1,2,0,0,0,6,2,4,0,2,0,9
1483,785131,25,2,6,0,2,2,4,0,0,0,4,5,3,0,4,0,6
1483,775821,26,2,4,2,3,0,1,0,0,2,2,3,3,1,1,0,4
1483,798115,22,3,6,0,1,3,5,0,0,1,2,2,1,0,0,0,9
1483,776233,18,4,7,3,4,1,3,0,0,1,3,0,1,1,1,0,9
1483,798113,15,4,5,4,5,0,0,1,2,2,5,1,2,0,0,2,9
1483,792324,17,0,4,0,1,0,3,0,0,1,1,0,1,0,2,0,0
1483,792323,8,0,2,0,0,0,2,0,0,0,1,0,1,0,2,0,0
1483,786696,6,0,2,0,0,0,2,0,0,0,0,0,0,0,0,0,0
1483,792322,1,0,0,0,0,0,0,0,0,0,0,0,0,0,0,0,0
1484,785991,34,13,19,13,18,0,1,3,5,3,11,0,1,0,0,3,29
1484,781401,20,5,8,3,6,2,2,4,4,0,4,0,1,1,0,1,16
1484,781406,31,3,13,3,11,0,2,3,5,0,1,3,3,2,1,0,9
1484,775317,21,1,5,1,3,0,2,2,2,0,2,7,3,1,0,0,4
1484,776100,27,0,8,0,7,0,1,0,1,4,1,0,1,0,1,0,0
1484,781029,24,5,5,0,0,5,5,0,0,0,3,4,2,0,1,0,15
1484,792133,19,2,5,1,3,1,2,2,2,1,0,3,1,1,1,0,7
1484,797762,19,2,7,2,5,0,2,0,0,0,1,2,0,1,0,0,4
1484,797760,5,1,3,1,2,0,1,0,0,0,2,1,0,1,0,0,2
1485,796571,31,7,11,6,9,1,2,4,5,0,4,2,0,0,1,0,19
1485,781346,33,4,12,2,6,2,6,5,6,1,5,6,1,1,2,0,15
1485,791291,27,5,6,0,0,5,6,0,2,0,4,1,4,0,2,0,15
1485,791289,27,5,9,5,9,0,0,1,2,1,5,0,4,0,3,4,11
1485,785786,23,1,4,1,4,0,0,0,0,1,4,1,1,0,1,4,2
1485,796574,11,3,4,2,3,1,1,0,0,0,0,2,1,0,2,0,7
1485,791290,16,2,7,0,4,2,3,0,0,0,1,1,3,0,1,2,6
1485,796576,12,2,2,1,1,1,1,0,0,0,1,4,3,0,0,0,5
1485,796572,14,2,3,2,3,0,0,0,0,1,2,0,2,0,2,0,4
1485,791288,6,0,0,0,0,0,0,0,0,0,1,0,0,0,0,0,0
1486,792033,35,7,17,4,9,3,8,0,0,2,4,2,3,2,1,2,17
1486,780830,35,5,12,5,6,0,6,6,7,0,4,4,2,2,1,0,16
1486,792034,35,5,9,2,4,3,5,1,1,0,11,2,1,1,2,1,14
1486,785381,20,3,5,2,3,1,2,2,2,2,2,0,3,0,0,0,9
1486,780833,29,4,7,4,7,0,0,0,0,0,0,1,3,0,1,3,8
1486,797645,11,4,6,4,5,0,1,3,5,1,0,0,3,1,1,0,11
1486,791688,17,0,2,0,1,0,1,2,4,0,3,2,0,0,0,0,2
1486,785980,18,0,2,0,1,0,1,0,0,0,0,0,2,0,0,0,0
1487,786488,34,6,9,3,6,3,3,5,6,1,7,7,2,0,2,0,20
1487,791795,31,5,8,2,3,3,5,5,5,0,7,0,2,1,3,0,18
1487,781044,35,6,14,3,5,3,9,2,3,1,4,1,3,0,2,1,17
1487,781038,37,3,8,3,7,0,1,1,2,1,2,2,1,1,1,2,7
1487,786489,21,1,4,0,2,1,2,4,4,1,3,1,2,0,1,0,7
1487,797619,7,2,2,2,2,0,0,0,0,0,0,0,1,0,2,0,4
1487,797620,12,1,2,1,1,0,1,0,0,0,0,0,3,0,0,0,2
1487,797621,13,0,2,0,2,0,0,0,0,0,0,0,0,1,0,0,0
1487,786487,8,0,2,0,1,0,1,0,0,0,2,0,1,0,0,0,0
1487,791796,2,0,1,0,1,0,0,0,0,0,0,0,2,0,0,0,0
1492,785542,29,4,8,4,8,0,0,2,5,1,1,2,1,0,0,0,10
1492,780743,30,8,13,4,5,4,8,0,1,0,1,5,2,0,1,0,20
1492,780055,29,9,13,2,2,7,11,1,1,1,5,0,0,2,1,0,26
1492,791063,17,3,3,3,3,0,0,2,4,1,3,4,1,0,0,0,8
1492,791062,19,9,11,8,9,1,2,0,0,2,0,2,2,0,1,0,19
1492,796735,18,2,3,2,2,0,1,2,2,0,2,2,2,1,1,0,6
1492,791060,20,5,8,5,7,0,1,0,0,3,5,5,2,1,2,1,10
1492,796736,8,1,1,0,0,1,1,2,2,0,2,2,0,0,0,0,5
1492,796741,5,1,3,1,3,0,0,3,4,0,2,2,1,0,2,0,5
1492,796737,5,0,0,0,0,0,0,0,0,0,1,0,2,0,2,0,0
1492,791064,12,4,6,2,2,2,4,0,0,0,2,1,3,1,2,0,10
1492,796739,2,0,0,0,0,0,0,0,0,0,0,0,0,0,0,0,0
1492,796740,2,0,0,0,0,0,0,0,0,0,1,0,0,0,0,0,0
1492,791061,2,1,1,0,0,1,1,0,0,0,0,0,0,0,0,0,3
1492,796742,2,0,0,0,0,0,0,0,0,0,0,0,0,0,0,0,0
1494,797769,28,4,6,2,4,2,2,0,0,1,2,3,2,1,1,0,10
1494,786256,25,7,15,7,15,0,0,0,0,9,7,3,2,0,5,2,14
1494,797774,13,1,4,1,1,0,3,1,2,0,1,0,0,1,0,0,3
1494,797776,26,3,7,3,3,0,4,0,0,0,1,3,1,2,0,0,6
1494,797779,29,2,6,2,4,0,2,3,6,3,3,1,3,0,3,2,7
1494,775106,23,4,8,3,6,1,2,6,6,3,3,1,3,1,3,0,15
1494,785568,20,4,4,4,4,0,0,0,1,2,4,1,3,2,2,3,8
1494,797775,4,0,1,0,0,0,1,0,0,0,1,0,0,0,1,0,0
1494,797778,16,2,4,2,3,0,1,0,0,1,2,1,4,1,1,0,4
1494,797768,14,5,10,2,3,3,7,0,0,0,1,0,1,0,2,0,13
1494,797780,2,0,0,0,0,0,0,0,0,0,0,0,0,0,0,0,0
1496,786080,36,9,19,6,12,3,7,4,4,1,4,2,3,1,2,0,25
1496,786216,36,6,8,6,8,0,0,7,10,4,5,2,2,1,2,1,19
1496,791348,38,2,9,2,8,0,1,0,0,0,5,4,3,0,3,0,4
1496,786218,27,3,5,2,4,1,1,6,6,0,1,2,4,2,4,0,13
1496,780150,7,0,2,0,1,0,1,0,0,0,0,0,0,1,0,0,0
1496,791350,33,4,6,1,1,3,5,0,1,0,3,1,2,1,1,0,11
1496,785256,15,2,5,2,4,0,1,1,2,0,1,0,0,0,0,1,5
1496,780156,8,0,2,0,1,0,1,0,2,1,2,0,0,0,0,0,0
1497,791768,22,5,5,5,5,0,0,0,0,2,4,2,2,1,2,1,10
1497,786460,16,1,4,1,4,0,0,1,2,1,2,1,4,0,0,1,3
1497,786230,34,2,7,1,1,1,6,0,0,1,3,2,2,1,4,0,5
1497,780604,37,8,11,7,10,1,1,7,9,0,8,3,4,2,4,0,24
1497,780602,38,11,16,11,16,0,0,1,2,0,5,1,3,1,2,0,23
1497,786071,13,1,5,1,5,0,0,1,2,2,2,0,2,0,0,0,3
1497,791766,24,1,4,1,2,0,2,0,0,1,0,1,0,0,1,0,2
1497,791767,6,0,3,0,2,0,1,0,0,1,0,1,3,0,1,1,0
1497,780603,10,0,2,0,1,0,1,0,0,0,2,1,0,0,1,0,0
1498,797292,21,9,10,9,10,0,0,3,4,3,7,0,4,1,1,3,21
1498,791661,18,1,4,1,2,0,2,0,0,0,2,0,1,0,0,0,2
1498,797290,21,4,9,1,3,3,6,0,0,0,2,1,3,0,1,0,11
1498,791660,23,4,7,2,5,2,2,0,0,0,2,5,0,0,2,0,10
1498,786064,23,4,10,2,5,2,5,2,4,3,1,0,1,1,0,0,12
1498,791658,12,0,2,0,2,0,0,0,0,1,1,0,1,0,2,1,0
1498,791663,7,2,2,2,2,0,0,2,3,1,0,1,0,0,0,0,6
1498,785658,8,0,2,0,1,0,1,0,0,0,2,1,0,0,1,1,0
1498,780509,13,3,5,3,4,0,1,0,1,2,0,1,0,0,1,0,6
1498,797295,9,2,4,2,4,0,0,0,0,1,2,1,0,1,1,0,4
1498,797294,3,0,1,0,0,0,1,0,0,0,0,0,0,0,0,0,0
1498,797293,27,0,1,0,1,0,0,0,0,0,6,3,1,0,1,0,0
1498,797291,15,3,5,2,3,1,2,2,2,0,1,2,2,0,2,0,9
1500,791787,18,4,6,3,3,1,3,2,2,0,4,1,5,1,3,0,11
1500,789048,34,3,6,3,6,0,0,0,2,3,4,3,2,0,1,0,6
1500,789046,35,3,9,2,4,1,5,2,4,2,6,1,3,0,1,3,9
1500,797631,7,0,2,0,1,0,1,0,0,0,0,0,1,0,1,0,0
1500,789041,32,4,15,3,5,1,10,2,3,2,3,1,0,1,1,0,11
1500,785540,26,3,5,3,4,0,1,0,0,2,2,0,2,2,1,0,6
1500,797630,29,1,7,0,2,1,5,2,2,0,3,0,3,1,0,0,5
1500,797629,16,2,3,2,3,0,0,0,0,0,0,3,2,0,1,0,4
1500,789044,3,1,2,0,0,1,2,2,2,0,1,0,1,0,0,0,5
1501,792266,29,4,8,2,5,2,3,10,10,3,3,0,2,2,0,0,20
1501,798003,24,1,5,1,2,0,3,2,2,0,3,1,4,0,5,0,4
1501,798006,17,1,4,0,2,1,2,0,0,0,0,2,1,0,0,0,3
1501,798007,13,0,1,0,0,0,1,1,2,1,2,0,2,0,0,0,1
1501,798009,22,4,9,2,5,2,4,0,2,1,0,1,1,0,1,0,10
1501,786152,38,6,11,6,10,0,1,1,2,3,10,2,2,0,3,2,13
1501,792267,29,1,8,0,1,1,7,0,0,1,1,2,3,0,2,0,3
1501,792265,27,4,11,4,7,0,4,0,0,3,7,0,2,1,1,0,8
1501,798002,1,0,0,0,0,0,0,0,0,0,0,0,0,0,0,0,0
1502,776018,21,8,10,8,10,0,0,0,2,2,5,0,4,2,4,0,16
1502,781314,25,3,7,2,2,1,5,3,3,1,2,4,4,1,0,0,10
1502,792208,34,2,9,2,9,0,0,4,5,2,7,2,3,0,5,0,8
1502,797855,33,1,6,1,4,0,2,6,7,1,3,1,2,1,4,0,8
1502,797859,23,3,5,2,3,1,2,0,0,1,2,3,2,0,3,1,7
1502,792204,22,3,9,3,6,0,3,1,2,0,5,1,0,0,2,0,7
1502,786983,8,0,0,0,0,0,0,4,4,2,3,0,2,0,3,0,4
1502,786262,16,0,1,0,0,0,1,2,2,0,0,0,1,2,1,0,2
1502,797856,15,1,1,1,1,0,0,0,1,0,1,0,3,2,2,1,2
1502,781317,2,0,0,0,0,0,0,0,0,0,1,1,0,0,0,0,0
1502,797862,1,0,0,0,0,0,0,0,0,0,0,0,0,0,0,1,0
1503,786691,35,8,17,7,11,1,6,3,5,3,4,1,1,2,2,0,20
1503,781319,17,2,9,2,9,0,0,3,3,2,3,0,4,0,2,0,7
1503,781455,30,1,6,1,5,0,1,4,4,0,1,3,2,3,0,0,6
1503,792220,32,2,10,1,5,1,5,0,0,3,1,1,1,2,0,1,5
1503,786693,21,1,6,0,3,1,3,2,2,0,3,1,3,3,3,0,5
1503,792046,21,6,10,3,4,3,6,2,2,1,1,1,3,1,3,1,17
1503,792219,11,2,4,2,4,0,0,1,1,2,0,0,3,0,2,0,5
1503,792222,11,1,2,1,2,0,0,0,0,0,0,0,1,1,0,0,2
1503,781408,10,0,1,0,1,0,0,1,2,1,1,2,3,0,3,0,1
1503,797876,12,0,1,0,1,0,0,0,0,1,4,0,3,1,2,0,0
1504,791628,28,2,7,2,3,0,4,0,0,3,8,1,2,0,0,2,4
1504,785635,26,7,11,6,9,1,2,12,14,1,8,2,3,0,2,5,27
1504,786440,27,2,7,0,2,2,5,4,7,2,0,1,2,1,1,0,10
1504,786720,24,4,5,2,2,2,3,4,4,1,4,3,2,1,1,0,14
1504,781199,31,3,7,1,3,2,4,7,8,0,0,7,1,0,2,0,15
1504,775642,12,2,2,2,2,0,0,1,4,2,1,1,0,1,0,0,5
1504,791629,10,1,4,1,2,0,2,0,1,0,2,0,1,0,1,0,2
1504,796974,19,1,3,1,3,0,0,4,4,0,0,3,1,0,0,0,6
1504,786439,5,0,0,0,0,0,0,0,0,0,0,0,3,1,0,1,0
1504,796972,6,0,2,0,0,0,2,2,2,0,1,0,4,0,0,0,2
1504,791626,5,0,0,0,0,0,0,0,0,0,3,0,0,0,0,1,0
1504,780459,3,0,0,0,0,0,0,0,0,0,1,0,0,0,0,0,0
1504,796973,4,2,4,1,2,1,2,0,0,0,1,0,0,0,0,0,5
1505,792340,21,2,9,1,6,1,3,1,2,4,3,0,2,0,2,1,6
1505,792345,25,4,10,4,9,0,1,2,4,2,2,1,4,1,3,0,10
1505,792342,30,3,5,0,2,3,3,0,0,0,0,4,3,1,3,0,9
1505,792346,17,2,4,2,3,0,1,0,0,1,1,1,5,0,0,1,4
1505,781552,28,5,10,5,9,0,1,0,1,0,7,5,4,0,4,0,10
1505,792341,16,1,4,1,3,0,1,4,8,1,1,0,4,0,1,0,6
1505,790887,15,2,6,1,2,1,4,1,4,0,5,0,5,0,1,0,6
1505,798086,19,1,4,1,4,0,0,0,0,1,0,1,2,0,0,0,2
1505,798080,17,2,3,0,0,2,3,0,0,0,2,1,3,2,0,0,6
1505,792344,7,1,1,1,1,0,0,0,0,0,0,1,0,0,0,0,2
1505,798088,5,0,0,0,0,0,0,0,0,0,1,0,0,0,0,0,0
1506,786447,14,3,4,2,3,1,1,0,0,3,2,3,3,0,2,0,7
1506,776365,13,5,6,4,4,1,2,0,0,0,2,1,0,1,2,0,11
1506,786448,23,2,7,2,5,0,2,0,0,1,2,4,4,2,0,0,4
1506,780731,23,2,5,2,3,0,2,2,2,0,1,2,2,1,0,0,6
1506,780462,23,9,10,4,5,5,5,0,0,1,0,2,0,3,1,0,23
1506,775074,20,2,4,2,4,0,0,4,5,1,5,0,3,0,2,2,8
1506,791631,16,2,3,2,2,0,1,0,0,0,1,1,3,1,1,0,4
1506,786132,14,2,4,1,3,1,1,0,0,0,0,3,0,0,0,2,5
1506,796971,18,0,7,0,5,0,2,4,4,0,0,1,0,0,1,0,4
1506,775121,14,1,3,1,2,0,1,2,2,0,3,2,0,0,2,0,4
1506,791632,9,1,3,1,1,0,2,1,4,1,1,0,1,0,1,1,3
1506,791630,8,0,2,0,1,0,1,0,0,2,2,2,0,1,0,0,0
1506,791634,3,0,2,0,1,0,1,0,0,0,0,0,1,0,0,0,0
1506,786449,2,0,1,0,1,0,0,1,2,1,0,0,0,0,0,0,1
1507,797262,16,0,3,0,1,0,2,4,4,0,0,1,3,0,1,0,4
1507,789177,38,6,11,6,11,0,0,0,0,4,8,0,2,1,4,3,12
1507,791340,30,1,5,1,5,0,0,2,2,0,1,3,1,0,2,0,4
1507,780181,31,5,11,4,8,1,3,2,2,3,5,0,4,2,6,0,13
1507,776089,10,0,4,0,3,0,1,0,0,0,2,0,2,0,3,0,0
1507,789178,16,0,1,0,0,0,1,0,0,0,1,0,1,1,1,0,0
1507,792189,14,1,4,1,4,0,0,0,0,3,2,0,2,1,2,0,2
1507,792337,17,2,7,1,4,1,3,2,4,0,1,0,1,0,2,0,7
1507,791336,17,0,2,0,2,0,0,1,4,2,3,0,2,2,4,0,1
1507,797261,5,0,1,0,1,0,0,0,0,0,0,0,0,0,0,0,0
1507,797264,4,0,1,0,1,0,0,2,2,1,0,0,1,1,0,0,2
1507,797260,2,0,0,0,0,0,0,0,0,0,0,0,0,0,0,0,0
1508,780238,21,7,10,3,6,4,4,0,0,0,3,3,2,2,3,0,18
1508,786179,26,2,12,0,3,2,9,0,0,0,2,2,0,3,1,0,6
1508,786177,22,2,5,0,0,2,5,0,0,1,8,1,0,2,3,2,6
1508,791750,21,1,1,0,0,1,1,2,4,2,1,4,4,0,0,0,5
1508,780244,25,2,3,2,2,0,1,0,0,1,3,0,2,0,2,2,4
1508,781500,23,7,10,3,4,4,6,6,6,0,1,6,2,1,0,0,24
1508,790773,17,6,8,3,3,3,5,0,0,1,6,1,4,2,3,0,15
1508,791752,14,4,5,4,5,0,0,1,1,2,3,2,1,0,0,0,9
1508,797346,4,3,3,1,1,2,2,0,0,1,1,1,0,0,0,1,8
1508,785909,9,3,5,3,5,0,0,0,0,0,3,0,3,0,0,1,6
1508,791749,6,2,4,2,3,0,1,0,0,0,3,2,0,0,1,1,4
1508,797347,3,1,1,1,1,0,0,0,0,0,0,0,1,0,0,0,2
1508,791748,4,0,1,0,1,0,0,0,0,0,4,0,2,0,0,0,0
1508,786171,4,0,1,0,0,0,1,0,0,0,0,2,0,0,0,0,0
1508,791751,1,0,1,0,1,0,0,0,0,0,1,0,0,0,0,0,0
1509,774812,21,3,12,3,11,0,1,3,4,1,1,0,3,3,3,0,9
1509,791497,25,2,10,2,8,0,2,4,4,3,5,1,3,0,1,0,8
1509,781486,32,2,8,1,5,1,3,2,3,0,2,0,2,1,2,0,7
1509,780461,32,3,11,3,8,0,3,1,3,0,3,2,0,0,2,0,7
1509,791500,24,1,5,1,5,0,0,1,2,0,2,0,1,1,2,0,3
1509,797180,15,3,6,1,4,2,2,0,2,1,1,0,1,0,0,0,8
1509,791498,14,4,5,4,5,0,0,0,0,1,2,0,3,1,1,0,8
1509,791502,6,1,5,0,3,1,2,3,4,0,2,0,0,0,0,0,6
1509,791499,11,0,0,0,0,0,0,4,4,0,0,0,1,1,1,0,4
1509,790517,7,0,1,0,1,0,0,2,2,0,0,0,0,0,0,0,2
1509,791503,13,0,2,0,2,0,0,0,0,0,1,0,0,0,0,0,0
1510,790781,32,4,8,4,8,0,0,2,4,1,3,0,3,0,2,2,10
1510,785239,12,1,3,0,0,1,3,0,0,1,1,0,4,0,0,2,3
1510,790785,30,8,20,1,6,7,14,2,2,0,5,4,3,1,3,0,25
1510,796340,25,2,8,1,3,1,5,8,8,1,4,1,5,1,1,1,13
1510,780037,34,2,8,0,2,2,6,3,4,0,5,3,1,2,3,0,9
1510,781232,23,0,3,0,0,0,3,0,2,0,2,3,1,0,1,0,0
1510,796343,14,1,3,1,3,0,0,0,2,3,4,1,2,0,0,0,2
1510,780040,15,1,2,0,1,1,1,0,0,0,0,1,4,0,1,0,3
1510,796339,13,1,3,0,1,1,2,0,0,0,1,1,0,1,0,0,3
1510,796345,1,0,0,0,0,0,0,0,0,0,1,0,0,0,1,0,0
1510,790780,1,0,0,0,0,0,0,0,0,0,0,0,0,0,0,0,0
1511,786157,28,7,12,7,10,0,2,3,4,4,11,1,3,1,1,3,17
1511,786150,18,2,4,2,4,0,0,0,3,2,1,2,3,0,4,0,4
1511,780676,26,1,7,1,3,0,4,12,15,0,5,2,3,2,3,0,14
1511,791756,29,3,8,2,6,1,2,0,0,0,1,2,4,1,1,0,7
1511,780677,32,9,15,4,6,5,9,2,2,2,4,0,1,2,1,0,25
1511,775533,9,1,4,1,2,0,2,1,1,2,0,0,4,1,0,0,3
1511,780992,25,2,5,0,1,2,4,0,0,0,0,4,2,0,1,0,6
1511,797348,12,1,4,1,3,0,1,0,0,0,3,2,0,1,1,0,2
1511,780673,21,1,2,1,1,0,1,0,0,1,2,1,0,0,0,0,2
1522,791597,15,0,1,0,1,0,0,2,4,2,1,1,2,0,0,0,2
1522,792116,17,1,3,0,0,1,3,2,2,0,1,5,4,1,0,0,5
1522,780410,28,5,15,3,8,2,7,2,2,1,2,1,4,1,1,0,14
1522,797028,26,2,4,2,3,0,1,0,2,3,1,1,5,0,1,0,4
1522,791598,35,13,18,11,16,2,2,3,6,3,8,2,2,1,2,1,31
1522,797025,33,9,13,7,10,2,3,3,5,0,2,4,2,3,2,0,23
1522,797026,13,1,2,0,0,1,2,1,2,0,1,1,1,0,1,1,4
1522,797027,2,0,0,0,0,0,0,0,0,0,0,0,0,0,1,0,0
1522,775047,5,0,1,0,1,0,0,0,0,0,0,1,0,0,0,0,0
1522,791600,25,3,11,2,6,1,5,4,4,0,2,0,2,0,1,0,11
1522,797029,1,0,0,0,0,0,0,0,0,0,0,0,0,0,0,0,0
1523,781071,22,5,7,4,6,1,1,0,0,1,3,0,2,0,3,0,11
1523,791890,36,7,9,5,7,2,2,13,14,1,2,4,3,5,4,0,29
1523,780098,17,1,1,1,1,0,0,2,2,1,3,0,3,0,0,0,4
1523,797591,27,0,8,0,3,0,5,1,2,0,2,2,2,0,1,0,1
1523,780719,15,2,3,2,3,0,0,0,0,0,6,2,5,0,4,0,4
1523,791888,16,1,5,1,4,0,1,3,4,1,1,1,2,1,3,0,5
1523,797588,10,2,4,2,2,0,2,0,0,0,2,0,2,0,0,0,4
1523,797589,28,4,6,2,4,2,2,3,6,0,2,1,2,0,1,0,13
1523,791889,9,0,1,0,1,0,0,0,0,0,0,0,0,0,0,0,0
1523,785424,20,4,5,4,5,0,0,0,0,1,4,2,4,0,1,1,8
1524,780765,39,12,18,9,13,3,5,5,8,1,8,3,0,1,1,0,32
1524,781301,22,3,4,3,4,0,0,0,0,1,1,0,3,0,4,1,6
1524,786255,28,1,5,1,3,0,2,3,4,1,8,1,4,1,3,0,5
1524,780762,33,4,12,3,7,1,5,1,2,1,2,1,2,0,2,0,10
1524,780768,35,2,4,2,2,0,2,2,2,1,2,5,2,1,3,0,6
1524,780755,23,2,6,1,4,1,2,9,12,2,3,2,1,1,1,0,14
1524,791729,12,2,5,2,5,0,0,0,0,2,2,1,1,0,0,0,4
1524,797320,8,0,1,0,0,0,1,0,0,0,0,0,0,0,1,0,0
1525,786180,4,0,0,0,0,0,0,0,0,0,2,0,1,0,0,2,0
1525,792104,34,10,19,9,15,1,4,3,4,1,5,0,2,1,2,3,24
1525,797709,30,5,11,4,8,1,3,0,0,0,2,1,0,1,0,0,11
1525,797708,27,3,5,3,4,0,1,0,0,2,2,0,3,1,3,0,6
1525,786198,27,4,10,2,4,2,6,2,2,0,1,3,4,1,3,1,12
1525,785608,9,1,3,1,2,0,1,0,0,0,0,0,3,0,0,1,2
1525,797707,24,1,5,1,1,0,4,0,0,3,2,6,5,1,1,0,2
1525,786204,13,0,3,0,3,0,0,1,2,1,3,0,2,0,0,0,1
1525,775779,16,5,10,5,8,0,2,0,2,0,0,1,1,3,1,1,10
1525,776327,13,0,0,0,0,0,0,0,0,1,2,1,2,0,0,0,0
1525,792106,3,0,0,0,0,0,0,0,0,0,1,0,0,0,0,0,0
1526,776205,22,5,7,2,2,3,5,2,4,0,2,3,1,1,0,2,15
1526,791245,22,5,10,3,6,2,4,0,2,2,4,5,3,1,0,1,12
1526,781243,22,4,10,2,3,2,7,1,2,1,7,1,1,3,1,0,11
1526,781244,25,4,11,4,8,0,3,2,4,3,9,1,3,0,2,3,10
1526,785529,23,1,6,1,2,0,4,3,4,0,2,3,1,1,1,0,5
1526,791241,21,7,12,6,9,1,3,0,1,1,4,0,3,0,0,0,15
1526,785537,13,2,6,1,3,1,3,2,2,0,1,1,1,0,0,0,7
1526,791243,15,1,2,0,1,1,1,0,0,0,1,0,0,0,0,0,3
1526,796943,6,1,1,1,1,0,0,0,0,0,1,0,1,0,1,0,2
1526,781237,16,0,3,0,1,0,2,0,0,0,0,3,1,0,0,0,0
1526,791246,13,0,4,0,1,0,3,0,0,0,2,1,0,0,0,0,0
1526,785528,1,0,0,0,0,0,0,0,0,0,0,0,0,0,0,0,0
1526,796940,1,0,0,0,0,0,0,0,0,0,0,0,0,0,0,0,0
1528,785471,20,15,18,15,18,0,0,5,6,3,4,3,0,1,0,0,35
1528,792399,16,5,8,5,8,0,0,0,1,1,4,0,1,0,3,0,10
1528,775628,13,1,5,0,3,1,2,1,2,0,3,4,1,1,3,1,4
1528,775198,16,1,3,0,0,1,3,0,0,0,4,1,1,0,0,0,3
1528,786697,16,1,2,0,0,1,2,0,0,0,2,5,1,2,0,0,3
1528,799000,20,7,13,7,13,0,0,0,1,6,4,2,1,1,1,1,14
1528,786695,18,3,7,2,2,1,5,2,3,0,2,0,0,1,1,0,9
1528,780571,14,3,8,2,3,1,5,2,2,0,1,3,0,0,1,0,9
1528,792397,20,3,4,3,3,0,1,0,0,0,2,1,0,2,0,0,6
1528,780263,13,3,5,3,3,0,2,0,3,3,3,3,0,0,4,0,6
1528,775547,14,1,5,1,4,0,1,1,2,2,4,2,0,0,3,2,3
1528,792400,17,0,0,0,0,0,0,1,2,0,0,3,2,2,2,0,1
1528,798999,3,0,1,0,0,0,1,0,0,0,1,1,0,0,0,0,0
1530,786481,31,7,14,6,11,1,3,3,3,3,4,0,2,0,4,0,18
1530,785965,35,5,13,4,7,1,6,2,2,0,3,2,1,0,1,0,13
1530,797626,31,3,12,1,7,2,5,0,2,2,6,4,2,3,2,0,8
1530,797628,15,2,4,2,4,0,0,2,3,2,2,2,3,1,0,0,6
1530,797624,32,2,5,1,1,1,4,0,0,0,1,1,2,0,2,0,5
1530,791793,9,2,5,2,4,0,1,0,0,1,1,0,3,2,0,0,4
1530,781032,19,1,5,0,1,1,4,0,0,0,1,0,2,0,0,0,3
1530,791791,16,1,3,0,0,1,3,0,0,0,2,0,0,0,1,0,3
1530,797627,12,1,4,1,2,0,2,0,0,0,1,0,1,0,1,0,2
1531,780833,28,7,10,6,9,1,1,6,6,4,3,3,1,1,3,1,21
1531,792033,37,5,14,3,6,2,8,3,3,0,5,3,2,1,0,1,15
1531,780830,37,3,4,0,0,3,4,2,2,0,7,1,2,2,0,0,11
1531,792034,34,5,12,4,6,1,6,0,0,2,8,6,2,2,3,0,11
1531,785381,22,3,7,3,3,0,4,2,4,0,4,1,1,0,5,0,8
1531,797645,12,3,5,3,5,0,0,0,1,1,2,0,2,0,1,0,6
1531,791688,17,1,3,1,3,0,0,0,0,0,2,0,1,0,0,0,2
1531,785980,10,0,1,0,0,0,1,0,0,0,2,0,1,0,0,0,0
1531,797643,1,0,0,0,0,0,0,0,0,0,0,0,0,0,0,0,0
1531,797644,1,0,0,0,0,0,0,0,0,0,0,0,0,0,1,0,0
1531,785982,1,0,0,0,0,0,0,0,0,0,0,0,0,0,0,0,0
1532,781403,36,7,11,5,7,2,4,0,0,1,9,1,5,0,3,0,16
1532,792654,28,5,12,5,12,0,0,2,2,3,2,0,2,0,1,1,12
1532,780524,29,2,6,0,0,2,6,0,0,1,3,2,1,0,0,0,6
1532,781400,37,5,11,4,6,1,5,0,0,0,3,3,0,0,0,0,11
1532,775893,27,1,5,1,4,0,1,0,0,0,3,2,2,0,4,0,2
1532,797302,4,0,2,0,2,0,0,0,0,1,0,0,0,0,0,0,0
1532,786857,17,2,6,1,2,1,4,0,0,1,4,1,5,0,1,0,5
1532,792653,9,0,1,0,1,0,0,2,2,2,1,0,2,0,0,1,2
1532,797301,13,4,7,3,4,1,3,0,0,0,1,1,0,0,3,0,9
1532,797303,0,0,0,0,0,0,0,0,0,0,0,0,0,0,0,0,0
1533,791981,36,3,9,1,5,2,4,1,2,0,4,0,1,0,1,0,9
1533,780342,26,3,10,3,5,0,5,1,1,3,3,2,1,0,2,0,7
1533,791982,32,2,7,1,2,1,5,0,0,0,8,6,2,1,0,0,5
1533,780333,35,5,10,0,3,5,7,3,4,1,3,6,1,2,2,0,18
1533,781493,25,6,11,1,2,5,9,1,2,0,2,1,2,0,1,0,18
1533,791984,8,0,2,0,0,0,2,5,8,0,1,0,2,0,0,0,5
1533,786756,21,4,8,2,2,2,6,0,0,1,2,1,2,0,1,0,10
1533,786755,17,2,3,2,2,0,1,0,0,3,2,1,2,0,0,0,4
1534,779997,20,1,5,0,2,1,3,2,2,0,5,8,2,2,0,0,5
1534,790808,18,2,6,1,1,1,5,0,0,0,0,1,0,1,0,0,5
1534,790810,16,3,5,2,2,1,3,2,2,2,5,1,0,0,0,0,9
1534,785361,22,7,10,3,4,4,6,0,0,3,2,2,0,1,0,0,18
1534,785362,14,4,9,4,9,0,0,3,3,4,7,0,1,0,1,1,11
1534,796368,20,5,10,5,7,0,3,3,4,3,4,1,3,2,0,2,13
1534,790809,20,1,1,1,1,0,0,0,0,0,0,2,2,1,2,0,2
1534,790811,20,2,7,1,3,1,4,0,0,1,1,0,3,0,4,0,5
1534,796370,21,1,8,0,4,1,4,0,0,0,2,2,2,0,1,0,3
1534,774854,14,4,5,3,4,1,1,5,6,4,3,0,3,0,2,3,14
1534,796371,8,1,2,1,2,0,0,0,1,2,2,0,1,0,1,1,2
1534,796369,5,2,2,1,1,1,1,0,0,0,0,1,0,1,0,0,5
1534,779999,2,1,1,0,0,1,1,0,0,1,1,0,0,0,0,0,3
1535,797438,24,2,9,0,4,2,5,0,0,2,2,0,2,0,0,0,6
1535,780565,28,2,8,2,6,0,2,2,2,0,2,1,2,0,2,0,6
1535,780570,28,6,10,6,9,0,1,2,2,2,3,0,2,0,1,0,14
1535,781556,13,0,6,0,3,0,3,0,0,0,3,0,2,0,1,0,0
1535,780569,22,2,7,2,7,0,0,2,2,2,3,0,4,0,3,0,6
1535,791695,18,1,5,1,5,0,0,3,4,4,2,1,0,3,2,0,5
1535,791696,18,0,4,0,1,0,3,2,2,0,0,1,1,0,2,0,2
1535,797432,30,4,8,2,3,2,5,1,1,0,1,1,3,1,3,0,11
1535,785824,6,0,0,0,0,0,0,0,2,1,1,0,0,0,0,0,0
1535,797434,4,0,2,0,2,0,0,0,0,0,0,0,1,1,0,1,0
1535,797433,3,0,0,0,0,0,0,0,0,0,0,0,1,0,0,0,0
1535,791694,3,0,2,0,1,0,1,0,0,0,0,0,0,0,0,0,0
1535,791693,3,0,1,0,1,0,0,0,0,0,1,0,0,0,0,0,0
1536,774969,29,6,12,6,11,0,1,2,3,5,7,1,1,0,3,0,14
1536,781053,38,5,9,3,6,2,3,1,1,1,2,5,3,2,4,1,13
1536,781054,38,4,15,2,5,2,10,2,3,0,2,2,1,0,3,0,12
1536,785670,26,3,5,1,1,2,4,1,1,1,1,1,1,1,0,0,9
1536,791181,24,1,5,1,2,0,3,0,0,1,2,2,1,0,2,0,2
1536,791179,16,3,5,1,1,2,4,2,2,1,3,1,0,0,1,0,10
1536,780981,11,1,1,0,0,1,1,2,2,1,3,0,2,1,0,1,5
1536,796850,15,1,6,0,4,1,2,0,0,2,0,2,3,0,1,0,3
1536,796848,3,0,1,0,1,0,0,0,0,0,0,0,1,0,1,0,0
1537,791519,32,5,15,3,10,2,5,2,2,0,1,5,1,1,5,0,14
1537,791296,30,4,14,2,9,2,5,4,4,1,5,1,1,3,5,0,14
1537,791299,26,4,7,4,6,0,1,2,3,4,2,0,5,0,2,1,10
1537,791298,23,3,4,3,4,0,0,0,0,1,2,1,2,0,2,0,6
1537,775871,36,1,2,1,2,0,0,2,2,2,10,2,1,0,2,1,4
1537,781390,17,3,5,0,0,3,5,0,0,0,1,0,2,0,0,0,9
1537,796591,17,2,4,1,3,1,1,0,0,0,3,1,2,0,0,0,5
1537,786276,6,1,1,0,0,1,1,0,0,0,0,0,0,0,0,0,3
1537,780525,7,0,0,0,0,0,0,0,0,0,0,1,3,1,2,1,0
1537,796593,6,0,0,0,0,0,0,0,0,0,0,0,0,0,1,0,0
1538,796347,22,3,4,2,2,1,2,0,0,0,4,1,2,0,1,1,7
1538,785243,24,3,5,2,4,1,1,0,0,2,6,5,2,3,1,1,7
1538,790788,29,7,10,3,4,4,6,0,0,2,2,5,1,0,1,0,18
1538,781028,31,7,15,4,7,3,8,0,2,1,3,2,2,1,2,0,17
1538,781026,28,8,10,1,2,7,8,0,0,0,3,4,0,0,0,0,23
1538,790787,5,0,0,0,0,0,0,0,0,0,0,1,2,0,2,0,0
1538,785242,14,0,2,0,1,0,1,0,0,1,2,1,1,0,2,0,0
1538,781027,10,0,1,0,1,0,0,0,0,0,2,2,4,0,1,0,0
1538,797899,1,0,0,0,0,0,0,0,0,0,0,0,0,0,0,0,0
1538,790786,1,0,0,0,0,0,0,0,0,0,0,0,0,0,0,0,0
1538,796346,4,0,0,0,0,0,0,0,1,0,1,0,1,0,0,0,0
1538,796348,15,1,2,0,1,1,1,2,2,0,1,0,3,1,1,0,5
1538,785244,5,0,3,0,0,0,3,0,0,0,0,0,0,0,0,0,0
1538,796349,11,0,3,0,0,0,3,0,0,0,0,1,1,1,0,0,0
1539,785664,16,2,3,2,3,0,0,0,1,2,2,0,2,1,0,0,4
1539,785841,27,1,2,1,2,0,0,1,3,0,1,1,1,0,2,0,3
1539,796611,20,0,4,0,1,0,3,0,0,0,2,0,0,0,1,0,0
1539,786685,10,0,2,0,1,0,1,0,0,0,4,1,3,0,2,0,0
1539,781504,33,5,12,5,10,0,2,6,6,0,0,2,0,2,1,1,16
1539,796613,13,1,3,0,1,1,2,0,0,0,3,1,0,0,1,0,3
1539,792232,13,0,2,0,1,0,1,0,0,0,0,0,1,0,1,0,0
1539,791312,7,1,1,1,1,0,0,1,2,1,0,0,2,1,3,0,3
1539,785840,7,2,4,1,1,1,3,0,0,1,1,0,0,0,0,0,5
1539,780728,5,0,0,0,0,0,0,0,0,0,2,0,1,0,0,0,0
1539,796620,1,0,0,0,0,0,0,0,0,0,1,0,0,0,0,0,0
1539,796609,25,3,6,3,5,0,1,0,0,0,0,1,1,1,1,1,6
1539,791313,1,0,0,0,0,0,0,0,0,0,0,0,0,0,0,0,0
1539,785848,1,0,0,0,0,0,0,1,2,0,0,0,0,0,0,0,1
1539,796203,2,0,0,0,0,0,0,0,0,0,1,0,1,0,1,0,0
1539,766623,19,2,4,2,4,0,0,0,0,0,1,0,5,1,1,0,4
1540,792068,37,4,13,4,8,0,5,5,6,1,4,3,1,0,2,1,13
1540,784640,23,4,6,2,3,2,3,3,4,0,4,0,3,2,3,1,13
1540,792072,28,2,4,0,0,2,4,0,0,0,1,4,1,1,0,0,6
1540,792069,26,2,6,0,4,2,2,4,4,0,3,4,0,0,4,0,10
1540,785572,26,3,6,3,5,0,1,6,8,0,6,2,1,1,2,0,12
1540,797655,18,0,0,0,0,0,0,1,2,0,5,1,3,1,3,0,1
1540,797657,17,2,5,1,3,1,2,0,0,0,0,0,0,0,1,0,5
1540,797652,23,3,3,1,1,2,2,2,2,0,1,0,1,0,2,0,10
1540,774844,2,0,0,0,0,0,0,0,0,0,0,0,1,0,1,0,0
1541,791669,22,2,3,2,3,0,0,0,0,2,3,2,1,2,3,0,4
1541,785762,22,7,11,4,6,3,5,0,0,2,5,0,4,0,4,1,17
1541,797409,24,1,8,1,5,0,3,0,0,1,1,7,2,1,3,0,2
1541,780535,22,5,10,2,4,3,6,2,2,1,3,0,5,1,5,0,15
1541,780531,34,1,7,0,3,1,4,0,0,1,6,0,4,1,1,1,3
1541,797414,2,0,0,0,0,0,0,0,0,0,0,0,0,0,0,0,0
1541,780534,34,4,10,4,9,0,1,1,2,3,6,4,1,2,0,0,9
1541,791666,23,4,7,4,6,0,1,2,2,0,0,2,4,0,1,0,10
1541,785760,17,2,5,1,2,1,3,1,1,0,1,2,0,1,1,0,6
1542,792128,27,4,7,4,6,0,1,1,2,2,12,0,3,0,3,0,9
1542,786838,29,6,12,6,11,0,1,0,0,1,4,1,0,2,4,4,12
1542,792132,26,4,6,1,3,3,3,0,0,0,3,9,2,1,2,0,11
1542,792127,32,7,14,4,8,3,6,2,2,1,3,2,1,1,2,1,19
1542,786267,20,0,1,0,1,0,0,0,0,0,1,2,3,0,1,0,0
1542,799273,9,1,2,1,2,0,0,0,2,1,0,0,2,0,0,1,2
1542,792131,14,2,6,2,5,0,1,3,5,2,1,0,3,3,0,0,7
1542,797736,14,0,2,0,0,0,2,0,0,1,2,1,0,0,0,0,0
1542,797739,6,0,0,0,0,0,0,0,0,0,0,1,2,0,0,0,0
1542,792126,14,2,6,0,2,2,4,3,3,0,5,1,3,0,3,0,9
1542,791668,9,0,1,0,1,0,0,1,2,0,0,0,0,1,0,0,1
1543,790232,38,6,13,5,10,1,3,1,3,3,4,2,4,1,2,1,14
1543,780093,29,2,7,2,7,0,0,2,4,4,1,1,0,0,1,0,6
1543,789066,33,2,13,2,12,0,1,3,4,0,4,4,2,0,6,0,7
1543,785806,23,1,5,1,4,0,1,0,0,0,1,2,2,3,3,0,2
1543,776278,26,4,6,1,1,3,5,2,2,0,5,0,1,1,1,0,13
1543,797593,1,0,1,0,1,0,0,0,0,0,0,0,0,0,0,0,0
1543,780614,23,5,10,5,9,0,1,2,2,0,6,1,0,1,1,2,12
1543,797592,9,0,1,0,1,0,0,0,0,1,0,0,0,2,1,0,0
1543,792411,18,0,1,0,0,0,1,0,1,0,3,0,4,0,1,0,0
1544,786509,17,3,4,3,4,0,0,1,2,0,6,0,3,1,0,0,7
1544,786508,25,9,11,5,6,4,5,3,3,1,9,3,0,0,4,2,25
1544,786507,21,2,6,1,3,1,3,1,2,1,3,1,2,0,1,0,6
1544,785796,25,7,11,5,5,2,6,1,1,0,5,2,0,0,2,1,17
1544,797576,26,5,8,3,4,2,4,1,1,0,1,6,1,0,3,0,13
1544,797579,4,1,1,1,1,0,0,0,0,0,1,0,0,0,1,0,2
1544,797577,4,0,0,0,0,0,0,0,0,0,2,0,2,0,0,0,0
1544,786511,9,0,1,0,0,0,1,0,0,0,2,0,0,0,0,0,0
1544,797582,9,0,2,0,1,0,1,1,2,2,1,1,2,0,2,0,1
1544,797581,3,0,0,0,0,0,0,0,0,0,0,0,0,0,0,0,0
1544,797580,10,0,1,0,0,0,1,0,0,1,3,0,2,0,2,0,0
1544,797578,4,1,1,1,1,0,0,0,0,0,0,0,1,0,0,0,2
1544,791896,8,0,0,0,0,0,0,0,0,0,0,1,2,0,1,0,0
1544,791897,14,2,3,1,1,1,2,0,0,1,4,1,1,0,2,0,5
1544,786505,15,1,3,0,2,1,1,0,2,0,1,1,1,0,0,0,3
1544,781325,6,1,2,1,2,0,0,0,0,0,0,1,0,0,0,0,2
1546,781038,35,4,5,3,3,1,2,8,8,0,5,0,2,0,2,0,17
1546,786488,35,5,11,4,6,1,5,5,6,0,3,0,3,1,3,0,16
1546,781044,28,7,10,6,6,1,4,1,1,2,6,3,3,1,0,1,16
1546,791795,30,4,8,3,5,1,3,2,2,1,4,0,2,0,3,0,11
1546,786489,31,2,6,1,1,1,5,2,2,0,4,3,1,1,0,0,7
1546,797621,18,1,2,1,1,0,1,1,2,1,1,1,1,0,1,0,3
1546,797620,9,1,3,1,2,0,1,0,0,0,0,0,1,0,1,0,2
1546,797619,8,1,4,1,2,0,2,0,0,0,1,0,0,0,0,0,2
1546,786487,6,0,1,0,0,0,1,0,0,0,0,0,1,0,0,0,0
1547,792032,37,6,10,6,7,0,3,2,4,1,4,5,2,0,3,0,14
1547,780828,32,5,14,3,9,2,5,2,2,0,5,3,1,1,0,0,14
1547,792029,21,4,8,3,6,1,2,3,3,1,2,0,3,0,1,0,12
1547,761149,34,3,9,3,9,0,0,2,2,1,5,0,3,0,3,1,8
1547,792031,17,1,3,1,2,0,1,0,0,0,3,1,1,1,0,0,2
1547,797637,18,5,7,0,0,5,7,2,2,0,0,0,3,1,0,1,17
1547,785822,19,0,1,0,1,0,0,0,2,0,0,1,1,0,0,0,0
1547,792027,12,0,0,0,0,0,0,0,0,0,0,2,1,0,0,0,0
1547,792030,8,0,1,0,1,0,0,0,0,0,0,1,0,1,0,0,0
1547,797636,2,0,0,0,0,0,0,0,0,0,0,0,1,0,1,0,0
1548,791317,37,7,14,4,9,3,5,5,6,1,2,4,1,0,1,0,22
1548,781505,32,4,7,2,4,2,3,9,11,1,2,2,3,2,2,0,19
1548,776279,27,5,7,3,5,2,2,0,0,1,8,1,4,1,4,2,12
1548,777573,25,5,8,4,4,1,4,0,1,2,3,0,1,0,2,0,11
1548,780353,29,2,5,2,5,0,0,3,4,1,1,1,0,1,3,3,7
1548,786222,12,3,3,3,3,0,0,1,1,0,4,0,4,0,1,0,7
1548,796648,12,2,4,1,1,1,3,0,0,0,0,1,0,0,0,0,5
1548,790851,16,1,2,1,1,0,1,0,0,0,4,2,2,0,0,0,2
1548,785966,7,1,1,1,1,0,0,0,0,0,0,2,0,0,0,0,2
1548,796649,3,0,1,0,0,0,1,0,0,0,0,1,0,0,0,0,0
1549,782593,36,7,15,1,2,6,13,4,4,0,4,1,3,1,2,0,24
1549,792118,34,6,12,4,8,2,4,2,3,0,2,5,1,2,3,0,16
1549,785402,29,4,7,4,6,0,1,2,2,1,3,0,4,0,0,0,10
1549,791699,20,2,5,2,3,0,2,3,4,3,1,2,3,0,2,0,7
1549,797523,27,0,6,0,4,0,2,0,0,1,1,0,1,2,1,0,0
1549,785828,13,4,7,4,6,0,1,1,2,1,1,0,3,0,0,0,9
1549,791700,17,2,4,1,2,1,2,2,2,0,3,0,1,0,1,0,7
1549,797525,3,2,2,2,2,0,0,0,0,0,0,0,0,0,0,0,4
1549,791702,15,0,0,0,0,0,0,0,0,0,0,1,4,0,0,0,0
1549,797526,6,0,1,0,1,0,0,0,0,0,2,0,0,0,0,0,0
1550,786263,20,6,9,5,6,1,3,2,2,1,9,1,0,1,0,0,15
1550,786257,19,6,7,6,7,0,0,1,2,0,0,4,0,0,1,0,13
1550,775825,18,4,6,3,5,1,1,0,0,0,2,1,2,1,1,0,9
1550,792122,20,3,7,2,4,1,3,0,1,2,4,1,3,0,2,0,7
1550,797724,18,0,1,0,1,0,0,2,2,0,2,0,1,1,0,0,2
1550,785661,18,4,7,4,6,0,1,7,7,0,5,0,1,0,0,0,15
1550,797722,20,4,10,2,4,2,6,1,1,0,2,0,3,0,0,0,11
1550,792121,18,4,7,4,7,0,0,1,2,0,4,0,1,1,0,0,9
1550,797725,14,3,3,3,3,0,0,0,1,3,3,0,1,0,2,0,6
1550,792356,9,1,3,1,3,0,0,4,4,3,1,0,2,0,0,3,6
1550,786249,14,1,2,0,0,1,2,0,0,0,1,3,0,0,0,0,3
1550,797721,12,0,3,0,2,0,1,0,0,0,2,0,2,2,0,0,0
1551,791746,33,8,12,6,9,2,3,0,0,1,4,3,2,1,1,2,18
1551,791747,34,4,15,1,6,3,9,6,7,0,3,2,1,0,0,0,17
1551,797342,24,3,5,3,5,0,0,0,0,1,5,0,3,0,3,1,6
1551,786193,18,1,7,1,3,0,4,1,2,0,2,3,0,0,0,0,3
1551,791743,15,1,3,1,3,0,0,0,0,1,1,1,3,1,1,0,2
1551,797341,18,2,5,0,2,2,3,1,2,0,0,0,3,0,2,0,7
1551,780711,15,2,3,0,1,2,2,0,0,1,1,0,4,0,1,0,6
1551,797345,20,0,5,0,5,0,0,2,2,2,1,0,3,0,1,1,2
1551,797343,16,0,5,0,3,0,2,0,0,1,1,0,0,0,1,0,0
1551,786184,6,0,1,0,0,0,1,0,0,0,0,0,0,0,1,0,0
1551,791744,1,0,0,0,0,0,0,0,0,0,0,0,0,0,0,0,0
1562,791975,13,0,5,0,5,0,0,0,0,5,2,1,2,0,2,0,0
1562,785972,28,2,7,2,6,0,1,2,2,3,3,0,0,0,2,0,6
1562,785967,20,4,13,4,13,0,0,2,3,3,7,3,0,1,2,1,10
1562,791977,29,5,9,3,6,2,3,3,3,0,2,0,0,1,2,0,15
1562,791978,36,2,7,2,5,0,2,2,3,2,5,5,1,2,1,0,6
1562,780160,24,1,3,1,3,0,0,2,4,4,5,2,4,1,4,0,4
1562,797799,7,3,4,3,4,0,0,0,0,1,1,0,3,0,0,0,6
1562,791976,25,5,12,4,6,1,6,2,2,0,2,1,1,0,1,1,13
1562,791980,7,1,1,1,1,0,0,0,0,1,0,0,1,0,0,0,2
1562,785973,6,0,0,0,0,0,0,0,0,1,0,0,0,0,1,0,0
1562,797800,4,0,0,0,0,0,0,0,0,0,0,1,0,0,0,0,0
1562,797801,0,0,0,0,0,0,0,0,0,0,0,0,0,0,0,0,0
1562,797803,1,0,0,0,0,0,0,0,0,0,0,0,0,0,0,0,0
1563,791883,32,4,9,2,3,2,6,2,2,2,2,0,4,0,2,0,12
1563,797594,9,0,0,0,0,0,0,0,0,1,0,0,2,0,2,0,0
1563,781066,26,1,5,1,4,0,1,0,0,1,6,1,3,1,2,1,2
1563,791884,37,6,16,6,16,0,0,3,3,1,2,3,1,2,2,0,15
1563,780695,22,0,6,0,1,0,5,0,0,0,3,2,2,0,2,0,0
1563,797598,12,3,3,3,3,0,0,0,2,1,1,0,3,1,1,0,6
1563,786496,22,1,4,1,2,0,2,0,0,0,2,0,3,3,0,0,2
1563,797600,10,2,4,2,4,0,0,0,0,1,1,0,2,0,2,0,4
1563,797596,30,2,8,0,3,2,5,3,6,3,3,1,2,2,1,0,9
1564,791118,38,8,13,4,7,4,6,4,4,0,6,3,1,0,1,1,24
1564,780824,24,3,4,3,4,0,0,5,6,1,6,0,4,0,2,0,11
1564,774974,34,2,8,1,3,1,5,2,4,0,2,3,2,1,4,0,7
1564,785676,37,1,9,1,4,0,5,0,0,0,8,5,2,2,1,1,2
1564,791117,11,0,0,0,0,0,0,0,0,1,0,1,4,0,0,0,0
1564,796769,32,3,8,0,2,3,6,0,0,1,1,0,2,1,1,0,9
1564,791115,16,2,4,2,4,0,0,0,0,0,1,0,2,0,1,1,4
1564,791116,8,0,3,0,2,0,1,0,0,0,1,0,0,0,0,0,0
1565,785278,39,7,13,6,8,1,5,6,6,0,5,5,0,1,0,2,21
1565,790962,34,4,7,3,4,1,3,6,8,2,5,1,1,1,4,1,15
1565,790961,21,3,4,1,2,2,2,2,4,1,2,2,3,0,1,1,10
1565,775860,40,3,8,2,4,1,4,0,0,0,3,2,2,0,1,0,7
1565,780832,25,2,5,2,5,0,0,2,3,2,1,0,2,0,2,3,6
1565,790965,11,1,2,1,1,0,1,0,0,0,0,0,2,0,1,0,2
1565,796556,16,0,3,0,0,0,3,0,0,1,3,1,0,0,1,3,0
1565,780146,9,0,4,0,3,0,1,0,0,0,1,1,1,2,0,0,0
1565,796554,4,0,1,0,0,0,1,0,0,0,1,0,0,0,0,0,0
1565,796555,1,0,2,0,1,0,1,0,0,0,0,0,0,0,0,0,0
1566,786431,29,8,13,5,7,3,6,2,2,1,1,1,0,1,0,0,21
1566,791621,29,5,9,4,6,1,3,0,0,0,2,4,1,1,0,0,11
1566,781125,25,3,5,3,5,0,0,0,0,4,6,1,3,0,3,0,6
1566,780440,24,1,4,0,1,1,3,3,4,1,4,1,2,0,0,1,6
1566,775620,13,0,1,0,1,0,0,1,2,1,3,0,3,0,0,1,1
1566,781088,28,6,12,3,5,3,7,4,4,0,2,2,2,0,0,0,19
1566,786432,14,2,7,0,1,2,6,0,0,0,0,1,2,0,0,0,6
1566,791620,15,1,3,0,1,1,2,0,0,1,1,0,0,0,0,0,3
1566,786434,11,1,1,1,1,0,0,1,2,0,1,2,0,0,0,0,3
1566,791619,10,1,3,0,0,1,3,0,0,0,2,1,0,0,0,0,3
1566,775622,2,0,0,0,0,0,0,0,0,0,0,0,1,0,1,0,0
1568,786253,25,7,9,4,6,3,3,2,2,0,1,2,3,0,4,0,19
1568,786374,25,2,11,2,8,0,3,5,6,4,3,1,4,0,0,2,9
1568,780378,25,3,7,3,7,0,0,0,1,1,2,0,1,2,3,1,6
1568,786378,25,1,10,0,1,1,9,0,0,1,2,2,1,0,0,0,3
1568,786404,14,0,4,0,2,0,2,0,1,0,0,1,4,1,0,0,0
1568,785798,32,5,12,3,8,2,4,2,2,0,2,2,0,1,2,1,14
1568,797061,20,3,4,1,2,2,2,2,2,1,1,0,1,0,0,0,10
1568,791562,12,1,2,0,0,1,2,0,1,0,0,2,0,0,0,0,3
1568,797065,18,0,3,0,1,0,2,0,0,1,5,3,3,1,2,0,0
1568,780121,4,0,2,0,0,0,2,0,0,1,1,0,1,0,0,0,0
1569,785920,38,7,13,5,10,2,3,4,4,2,13,7,1,2,2,0,20
1569,791833,24,4,6,4,6,0,0,6,10,2,3,1,3,3,3,0,14
1569,785698,28,4,8,1,5,3,3,2,2,2,3,2,0,0,1,0,13
1569,786623,13,4,4,4,4,0,0,0,0,2,1,2,3,1,1,1,8
1569,797405,30,2,10,2,10,0,0,3,4,1,1,1,4,0,2,0,7
1569,786624,25,5,6,5,6,0,0,1,3,2,7,0,1,0,3,3,11
1569,784077,13,2,4,1,2,1,2,0,0,0,1,2,0,0,0,0,5
1569,791834,22,1,4,1,3,0,1,0,0,0,1,3,3,1,1,0,2
1569,797413,7,1,4,1,4,0,0,0,0,1,1,1,2,0,1,0,2
1570,797895,19,4,8,4,8,0,0,7,12,6,9,4,2,0,0,1,15
1570,792237,28,5,13,3,9,2,4,2,2,1,1,3,0,1,3,0,14
1570,792236,21,5,9,3,6,2,3,0,0,0,5,4,0,3,2,1,12
1570,776337,16,4,5,4,5,0,0,3,5,3,6,2,1,0,3,1,11
1570,792240,24,4,7,3,5,1,2,0,0,4,3,2,4,0,2,0,9
1570,797897,25,3,7,1,3,2,4,4,4,0,1,1,4,0,4,1,12
1570,785286,21,3,8,2,6,1,2,2,2,3,2,1,1,1,2,0,9
1570,792238,20,2,2,2,2,0,0,2,3,1,5,1,4,0,1,0,6
1570,785986,19,1,3,0,0,1,3,0,0,0,1,1,1,1,1,1,3
1570,797896,7,0,0,0,0,0,0,0,0,0,0,0,0,0,0,0,0
1572,785642,12,3,5,3,3,0,2,0,0,0,0,3,1,0,0,0,6
1572,791067,32,3,4,2,2,1,2,1,1,0,6,5,4,0,2,1,8
1572,796744,19,1,5,0,2,1,3,1,2,0,0,1,0,0,0,1,4
1572,796743,24,1,4,0,1,1,3,0,0,0,2,2,2,0,2,0,3
1572,785551,33,6,8,4,4,2,4,1,2,1,2,4,3,1,1,0,15
1572,780512,27,8,13,6,9,2,4,0,2,0,7,1,2,2,2,1,18
1572,796745,11,1,2,1,2,0,0,1,2,2,0,0,2,0,0,0,3
1572,791066,28,7,14,5,8,2,6,0,0,1,3,2,0,0,1,0,16
1572,791068,14,2,3,2,2,0,1,4,5,0,1,0,1,0,0,2,8
1573,791564,10,2,3,2,3,0,0,0,0,0,1,1,1,0,0,0,4
1573,775549,20,2,4,2,4,0,0,2,2,3,1,1,3,0,2,0,6
1573,797056,28,1,6,0,3,1,3,3,4,1,3,3,3,1,2,0,6
1573,797054,29,7,13,6,10,1,3,0,2,1,3,3,0,1,1,0,15
1573,786380,31,5,11,4,7,1,4,4,4,0,10,0,1,1,3,0,15
1573,797058,6,1,1,0,0,1,1,0,0,0,1,0,0,0,1,0,3
1573,780425,20,1,2,1,2,0,0,2,2,1,2,1,3,0,1,0,4
1573,791568,14,0,0,0,0,0,0,0,0,0,0,0,0,0,1,0,0
1573,797055,24,7,12,5,7,2,5,1,2,1,2,2,0,1,2,0,17
1573,786381,18,1,4,1,1,0,3,0,0,0,1,0,2,0,1,0,2
1574,775534,9,3,4,0,1,3,3,4,4,0,2,1,0,1,0,0,13
1574,785603,24,2,5,1,2,1,3,7,7,0,6,5,1,1,1,0,12
1574,776425,29,4,5,2,2,2,3,1,1,1,2,3,0,0,2,0,11
1574,791107,13,3,6,3,6,0,0,4,5,0,3,0,3,0,3,2,10
1574,775538,19,1,2,1,2,0,0,1,1,1,5,0,3,0,0,1,3
1574,791110,16,5,5,3,3,2,2,4,4,0,3,2,3,1,3,0,16
1574,796763,14,4,6,4,5,0,1,0,0,2,2,0,2,1,0,0,8
1574,791106,24,2,7,1,4,1,3,2,2,0,3,2,3,0,3,1,7
1574,786494,17,2,7,2,5,0,2,0,0,0,3,1,0,1,1,0,4
1574,796762,16,0,3,0,1,0,2,2,2,1,0,2,3,0,1,0,2
1574,775820,15,1,2,1,1,0,1,0,0,0,2,0,1,1,1,1,2
1574,780801,4,1,1,1,1,0,0,0,0,0,0,0,1,0,0,0,2
1575,798968,27,6,14,5,10,1,4,3,3,1,2,2,1,2,1,1,16
1575,791718,25,3,8,2,4,1,4,2,4,0,3,1,1,0,2,0,9
1575,768880,18,1,4,0,0,1,4,0,0,0,2,0,0,0,1,0,3
1575,798966,18,0,0,0,0,0,0,3,4,2,1,2,3,0,1,0,3
1575,798965,17,1,6,1,4,0,2,0,0,1,0,1,3,2,2,0,2
1575,791719,25,3,6,0,2,3,4,2,2,0,2,0,2,0,1,0,11
1575,791717,23,4,10,3,6,1,4,2,2,1,1,1,3,0,1,0,11
1575,798964,7,0,0,0,0,0,0,4,4,0,1,0,2,0,0,3,4
1575,787996,10,1,3,1,2,0,1,0,0,0,2,0,1,0,1,0,2
1575,798967,9,1,2,1,2,0,0,0,0,0,0,1,3,0,1,0,2
1575,791720,9,0,0,0,0,0,0,0,0,0,1,0,1,0,1,0,0
1575,798969,8,0,2,0,0,0,2,0,0,0,1,0,0,0,1,0,0
1575,798963,4,0,2,0,2,0,0,0,0,0,0,0,1,0,0,0,0
1576,781257,29,6,10,4,8,2,2,2,2,0,0,0,3,1,3,0,16
1576,781606,33,4,7,2,3,2,4,0,1,0,4,3,3,2,2,0,10
1576,796955,25,2,8,2,8,0,0,2,3,3,4,1,2,1,3,1,6
1576,781263,25,0,5,0,3,0,2,3,4,1,3,1,3,1,4,0,3
1576,780900,21,0,4,0,3,0,1,0,1,1,6,0,2,0,2,0,0
1576,796954,26,0,4,0,2,0,2,3,3,0,1,1,0,0,0,1,3
1576,791257,16,1,6,1,5,0,1,0,0,0,1,0,4,0,3,0,2
1576,791254,2,1,1,1,1,0,0,0,0,2,0,0,0,0,0,0,2
1576,785508,12,0,3,0,0,0,3,0,0,0,1,0,1,0,0,0,0
1576,791255,9,0,0,0,0,0,0,0,0,0,5,0,1,0,0,0,0
1576,796029,2,0,3,0,2,0,1,0,0,1,0,0,0,0,0,0,0
1577,776396,35,12,20,9,13,3,7,3,4,0,4,1,2,2,1,0,30
1577,791385,33,6,13,4,9,2,4,0,0,4,8,2,2,0,1,1,14
1577,776199,27,5,11,4,8,1,3,2,2,0,1,5,2,2,4,0,13
1577,786450,34,2,4,1,2,1,2,0,1,1,6,1,1,1,0,1,5
1577,797163,20,2,6,2,6,0,0,0,0,2,1,2,4,0,1,0,4
1577,797165,14,1,3,1,3,0,0,0,0,0,2,2,2,0,0,0,2
1577,797166,5,0,1,0,1,0,0,2,4,1,1,0,1,0,0,0,2
1577,797164,18,0,1,0,0,0,1,0,0,0,3,0,5,1,1,0,0
1577,780599,6,0,1,0,1,0,0,0,0,1,0,1,2,0,2,0,0
1577,791386,2,0,0,0,0,0,0,0,0,0,0,0,0,0,0,0,0
1577,797161,2,0,1,0,0,0,1,0,0,0,2,0,0,0,0,0,0
1577,797162,2,0,0,0,0,0,0,0,0,0,0,0,0,0,0,0,0
1577,793778,2,0,0,0,0,0,0,0,0,0,0,0,0,0,0,0,0
1578,785714,13,5,5,5,5,0,0,0,2,1,2,1,4,3,2,0,10
1578,775894,30,5,9,4,5,1,4,0,1,1,3,5,2,1,3,1,11
1578,785711,33,6,13,1,6,5,7,5,5,0,3,5,3,4,4,0,22
1578,780985,33,2,5,0,0,2,5,0,0,0,2,4,2,4,0,1,6
1578,775266,28,7,18,3,8,4,10,2,2,1,3,4,2,1,2,0,20
1578,791169,3,0,0,0,0,0,0,0,0,0,0,0,1,0,0,0,0
1578,796829,18,6,9,6,9,0,0,1,3,5,3,0,2,0,1,3,13
1578,780988,4,0,0,0,0,0,0,0,0,0,1,0,0,0,0,0,0
1578,796828,2,0,2,0,1,0,1,0,0,0,0,0,0,0,0,0,0
1578,796827,2,0,0,0,0,0,0,0,0,0,0,0,0,1,0,0,0
1578,791167,13,3,5,2,4,1,1,0,0,0,0,2,2,1,0,0,7
1578,785710,3,1,1,1,1,0,0,0,0,0,0,1,0,0,0,0,2
1578,785378,18,3,6,2,4,1,2,0,0,0,4,2,1,1,1,0,7
1579,781322,18,0,1,0,0,0,1,2,2,0,4,1,4,0,3,0,2
1579,785989,27,3,6,1,2,2,4,4,6,1,6,1,1,2,3,0,12
1579,786571,28,5,7,2,4,3,3,2,5,0,2,0,2,1,4,0,15
1579,780563,32,3,5,1,2,2,3,0,0,0,6,3,1,0,4,0,8
1579,781439,30,10,20,7,14,3,6,3,4,5,4,2,2,2,4,0,26
1579,791692,2,0,0,0,0,0,0,0,0,0,0,0,0,0,1,0,0
1579,791690,18,1,3,1,3,0,0,2,3,2,2,2,3,0,1,2,4
1579,797300,2,0,1,0,0,0,1,0,0,0,0,0,0,0,1,0,0
1579,781419,24,2,8,1,3,1,5,0,2,0,1,2,0,0,2,1,5
1579,781207,17,1,6,1,3,0,3,0,0,1,2,1,2,0,2,0,2
1579,791691,2,0,0,0,0,0,0,0,0,0,0,0,0,0,0,0,0
1580,781629,21,5,7,5,7,0,0,4,4,1,3,1,1,1,1,1,14
1580,791440,18,3,6,3,6,0,0,1,4,2,3,2,3,0,3,1,7
1580,797013,30,8,13,2,5,6,8,1,1,0,2,3,3,2,2,0,23
1580,791441,22,2,3,0,0,2,3,2,2,0,4,5,0,1,2,1,8
1580,774959,13,0,2,0,2,0,0,0,0,0,0,3,1,0,0,0,0
1580,791443,8,0,0,0,0,0,0,0,0,0,2,1,4,0,0,1,0
1580,775739,13,3,4,3,4,0,0,0,0,0,4,1,3,0,1,0,6
1580,797017,1,0,0,0,0,0,0,0,0,1,0,0,0,0,0,0,0
1580,797018,1,0,1,0,1,0,0,0,0,0,0,0,0,0,0,0,0
1580,797015,10,0,0,0,0,0,0,0,0,0,0,1,0,1,0,0,0
1580,797019,10,3,3,2,2,1,1,0,0,0,0,1,0,0,1,0,7
1580,797016,8,2,4,2,4,0,0,0,0,0,1,0,1,0,2,0,4
1580,789009,5,1,2,0,0,1,2,0,0,0,1,0,0,1,0,0,3
1580,781378,24,7,13,5,8,2,5,2,2,0,7,2,0,3,1,1,18
1580,775267,16,1,2,0,0,1,2,0,0,0,0,2,1,0,1,0,3
1582,780176,36,4,7,2,2,2,5,1,3,0,3,8,2,1,1,1,11
1582,796377,34,7,14,5,7,2,7,1,2,0,3,1,2,0,1,1,17
1582,796372,32,6,8,6,8,0,0,6,11,2,5,0,3,0,2,2,18
1582,796379,37,5,12,3,9,2,3,0,2,1,5,5,3,0,1,0,12
1582,790815,16,1,3,1,1,0,2,0,0,0,2,1,4,0,3,0,2
1582,790814,12,0,1,0,1,0,0,0,0,0,3,2,4,0,0,1,0
1582,796376,3,0,0,0,0,0,0,0,0,0,0,0,0,0,0,0,0
1582,796378,30,6,8,2,3,4,5,0,0,1,3,3,2,0,2,0,16
1583,786039,15,1,2,1,2,0,0,1,2,2,2,0,1,0,0,0,3
1583,792043,25,2,5,1,1,1,4,2,2,1,2,0,3,0,0,0,7
1583,792040,34,3,6,2,3,1,3,3,4,0,3,2,1,1,1,0,10
1583,775028,28,2,10,1,6,1,4,6,8,1,4,9,0,1,4,0,11
1583,786266,32,5,17,3,12,2,5,3,4,1,5,3,3,0,2,2,15
1583,797718,8,2,3,0,0,2,3,0,0,0,1,1,0,1,1,0,6
1583,797719,2,0,0,0,0,0,0,0,0,0,0,0,2,0,0,0,0
1583,797723,14,1,2,0,1,1,1,0,0,0,1,0,2,0,1,0,3
1583,797726,22,2,2,1,1,1,1,1,2,1,2,0,5,1,0,0,6
1583,797728,20,4,6,3,4,1,2,5,6,3,3,0,1,0,2,0,14
1584,796568,29,3,7,3,6,0,1,3,4,2,6,2,3,1,0,0,9
1584,796566,22,6,7,6,7,0,0,4,5,2,8,3,3,1,1,0,16
1584,790969,32,6,12,5,9,1,3,2,4,0,4,0,1,0,1,0,15
1584,780166,32,4,8,3,6,1,2,5,6,1,0,2,3,2,3,1,14
1584,775107,31,3,6,2,4,1,2,1,3,1,1,2,0,0,1,0,8
1584,781380,13,4,6,4,6,0,0,1,1,1,2,2,4,0,2,0,9
1584,796564,2,0,0,0,0,0,0,0,0,0,1,0,1,0,0,0,0
1584,790971,14,2,3,2,3,0,0,1,2,1,2,3,2,1,1,0,5
1584,796569,14,0,2,0,1,0,1,0,0,0,2,1,1,0,1,1,0
1584,790968,11,1,1,0,0,1,1,2,5,0,2,1,0,0,1,0,5
1586,780027,17,13,14,7,7,6,7,2,4,3,0,1,3,0,1,0,34
1586,786176,25,6,9,6,8,0,1,4,4,0,4,0,0,0,1,0,16
1586,786173,26,4,8,3,5,1,3,0,0,0,0,2,0,0,0,0,9
1586,780028,24,1,6,1,2,0,4,5,6,1,5,2,1,0,0,0,7
1586,774828,27,1,7,0,1,1,6,0,0,0,2,5,1,2,1,0,3
1586,780029,19,7,9,6,7,1,2,2,2,6,4,1,2,0,3,2,17
1586,791379,17,1,4,0,3,1,1,3,4,2,3,0,0,2,1,1,6
1586,791380,13,2,5,2,4,0,1,0,0,0,0,7,2,0,0,0,4
1586,797175,17,0,2,0,0,0,2,0,0,1,4,1,2,2,0,0,0
1586,797179,5,0,1,0,0,0,1,2,2,0,0,1,0,0,0,0,2
1586,797176,3,0,1,0,1,0,0,0,0,0,1,0,0,0,0,0,0
1586,797178,3,1,1,1,1,0,0,2,2,1,0,0,1,0,0,0,4
1586,797177,2,0,0,0,0,0,0,0,0,0,1,0,0,0,0,0,0
1586,780026,2,1,1,0,0,1,1,0,0,0,0,0,0,0,0,0,3
1587,781480,30,8,16,6,8,2,8,2,2,1,1,2,3,0,3,0,20
1587,774846,28,2,5,2,5,0,0,2,2,5,1,0,2,0,0,1,6
1587,797182,10,0,0,0,0,0,0,0,0,0,0,0,0,0,2,0,0
1587,786558,33,7,13,5,8,2,5,2,3,1,4,5,1,3,2,0,18
1587,766611,31,6,9,1,2,5,7,0,0,2,4,1,4,0,2,0,17
1587,797272,28,2,9,0,1,2,8,2,2,0,3,2,3,1,0,0,8
1587,786185,10,0,2,0,2,0,0,0,1,0,1,1,1,0,2,0,0
1587,797183,14,3,7,1,5,2,2,0,0,2,2,0,2,0,1,1,8
1587,797181,9,0,2,0,1,0,1,0,0,0,1,0,0,0,2,1,0
1587,797273,7,0,1,0,0,0,1,0,0,0,1,0,1,0,0,0,0
1588,780283,18,1,3,1,3,0,0,1,2,0,0,0,3,0,1,0,3
1588,790925,28,7,12,6,9,1,3,3,3,2,4,1,4,1,0,0,18
1588,791456,26,3,12,2,4,1,8,2,2,0,2,1,3,0,1,0,9
1588,785476,35,2,3,2,2,0,1,0,0,0,3,9,2,1,2,0,4
1588,780285,26,0,8,0,6,0,2,4,6,3,4,0,0,2,2,1,4
1588,796470,4,0,0,0,0,0,0,0,0,0,1,0,2,0,0,0,0
1588,780292,22,2,4,2,4,0,0,3,4,1,3,1,1,0,0,3,7
1588,785480,9,2,3,0,0,2,3,0,0,0,0,0,1,0,1,0,6
1588,785474,26,5,7,4,4,1,3,4,4,2,5,1,2,2,0,0,15
1588,790926,6,1,4,0,1,1,3,0,0,0,0,0,0,0,0,0,3
1589,797050,35,3,12,3,8,0,4,6,6,2,2,0,3,1,3,0,12
1589,780394,30,3,7,3,4,0,3,0,0,2,5,0,2,2,1,1,6
1589,780391,26,0,2,0,2,0,0,0,0,2,4,2,4,0,1,1,0
1589,790871,33,7,13,5,7,2,6,2,3,0,5,4,3,0,3,0,18
1589,776473,28,4,8,3,6,1,2,0,0,0,5,3,5,0,4,0,9
1589,797048,12,3,4,3,4,0,0,1,2,3,1,0,4,0,1,0,7
1589,791570,5,0,1,0,0,0,1,0,0,0,0,0,1,0,2,0,0
1589,780392,24,2,6,1,2,1,4,3,4,0,0,0,2,0,1,0,8
1589,797049,7,0,0,0,0,0,0,0,0,0,1,0,0,0,0,1,0
1602,781300,23,2,5,2,5,0,0,1,2,2,6,2,3,1,3,2,5
1602,790803,16,3,7,3,7,0,0,0,1,0,3,0,1,0,3,1,6
1602,796360,28,7,10,6,8,1,2,2,6,0,2,5,3,1,3,0,17
1602,781304,30,2,5,1,3,1,2,12,12,0,2,3,1,3,4,0,17
1602,781302,28,4,7,1,3,3,4,3,4,2,3,2,1,1,1,1,14
1602,780598,21,1,5,1,4,0,1,0,0,1,1,0,4,1,1,0,2
1602,790801,18,1,4,1,3,0,1,3,3,0,3,2,2,0,1,0,5
1602,781305,18,2,5,1,1,1,4,0,0,0,0,2,0,0,0,0,5
1602,796364,6,2,2,2,2,0,0,2,2,0,1,0,1,0,0,0,6
1602,790802,3,1,1,0,0,1,1,0,0,0,0,0,2,0,0,0,3
1602,796363,7,1,3,0,2,1,1,0,0,0,0,1,0,1,0,0,3
1602,796362,2,0,0,0,0,0,0,0,0,0,0,0,0,0,0,0,0
1603,785368,21,3,4,3,4,0,0,1,3,4,3,0,3,2,1,1,7
1603,785247,4,2,3,2,2,0,1,1,1,0,0,0,0,0,0,0,5
1603,790793,29,7,17,5,10,2,7,1,1,0,8,7,4,1,3,0,17
1603,790792,39,6,13,2,8,4,5,3,5,2,2,3,3,2,5,3,19
1603,785246,24,2,6,0,1,2,5,2,2,0,0,1,2,0,3,0,8
1603,780886,23,2,7,0,3,2,4,0,0,0,2,1,3,1,5,0,6
1603,790789,12,2,4,2,4,0,0,0,0,0,2,1,1,0,2,0,4
1603,780281,14,0,1,0,1,0,0,1,2,0,1,1,3,0,0,0,1
1603,790794,16,1,2,1,2,0,0,0,0,1,1,0,3,0,0,3,2
1603,796353,3,0,1,0,0,0,1,0,0,0,0,0,0,0,0,0,0
1603,796351,15,0,1,0,1,0,0,2,2,1,2,0,2,0,1,1,2
1604,797967,36,6,10,4,7,2,3,3,4,3,7,3,1,1,0,0,17
1604,797962,19,0,2,0,2,0,0,0,0,2,0,1,3,0,1,1,0
1604,797970,35,4,6,3,3,1,3,5,6,0,5,1,1,1,5,0,14
1604,781453,33,3,8,1,3,2,5,8,8,0,3,3,1,1,4,0,16
1604,774869,30,2,7,1,2,1,5,0,0,0,1,0,4,0,4,0,5
1604,792254,22,0,2,0,1,0,1,0,0,3,3,2,3,0,1,1,0
1604,792256,3,0,0,0,0,0,0,0,0,0,0,0,2,0,1,0,0
1604,797961,4,0,1,0,1,0,0,2,2,0,0,0,0,1,0,0,2
1604,786098,18,2,3,1,2,1,1,5,6,1,1,2,2,1,0,0,10
1605,792340,25,6,9,5,7,1,2,0,1,0,4,2,2,2,1,0,13
1605,792345,22,2,5,2,4,0,1,4,5,1,0,0,5,0,1,0,8
1605,792342,37,2,5,0,1,2,4,0,0,0,2,1,3,3,1,0,6
1605,792346,26,3,7,3,6,0,1,1,2,2,3,4,4,0,1,0,7
1605,781552,38,8,15,5,10,3,5,2,3,1,2,1,2,1,2,0,21
1605,798080,13,0,2,0,0,0,2,0,0,1,1,2,1,0,0,0,0
1605,790887,9,1,3,1,2,0,1,0,0,0,2,1,2,0,1,0,2
1605,798086,13,0,0,0,0,0,0,0,0,0,0,0,2,0,1,0,0
1605,792341,17,0,0,0,0,0,0,0,0,0,2,0,3,0,2,0,0
1606,797140,15,2,7,1,5,1,2,0,0,1,2,1,2,0,1,0,5
1606,775110,28,1,5,1,4,0,1,5,6,3,13,1,3,0,2,3,7
1606,797135,30,3,9,2,4,1,5,0,0,0,1,0,1,0,5,1,7
1606,791392,36,3,6,2,5,1,1,3,4,2,2,8,3,2,3,0,10
1606,775458,36,6,15,4,9,2,6,4,7,0,4,2,1,2,1,1,18
1606,797134,3,1,1,1,1,0,0,0,1,1,0,0,1,0,0,1,2
1606,791394,2,0,1,0,1,0,0,0,0,1,0,0,1,0,0,0,0
1606,786062,4,0,0,0,0,0,0,2,2,0,2,0,1,0,1,1,2
1606,781353,3,0,0,0,0,0,0,0,0,0,0,0,2,0,0,0,0
1606,797138,14,3,6,3,5,0,1,3,5,0,1,0,0,1,0,0,9
1606,785264,13,2,5,0,2,2,3,1,2,1,2,2,0,1,1,0,7
1606,785936,16,1,5,1,4,0,1,0,0,1,1,0,1,0,2,0,2
1607,792186,35,8,13,8,13,0,0,1,3,5,3,2,3,0,1,0,17
1607,781447,11,3,4,3,4,0,0,1,2,1,3,1,5,0,4,0,7
1607,781490,25,2,4,2,2,0,2,0,0,1,4,2,2,1,1,0,4
1607,792183,35,5,15,5,12,0,3,4,4,1,4,3,3,3,4,0,14
1607,786675,25,1,7,1,4,0,3,0,0,1,4,3,2,1,1,0,2
1607,797821,20,4,12,3,8,1,4,2,4,1,2,0,4,1,1,2,11
1607,780433,8,1,2,1,2,0,0,0,0,0,2,0,3,0,2,0,2
1607,797816,22,3,8,1,4,2,4,0,0,1,5,2,1,2,1,1,8
1607,792188,13,0,4,0,3,0,1,1,2,0,2,0,1,0,0,0,1
1607,792185,2,0,0,0,0,0,0,0,0,0,0,1,0,0,0,0,0
1607,781466,4,0,0,0,0,0,0,0,0,0,0,0,0,0,1,0,0
1608,775954,34,4,11,4,11,0,0,7,8,4,8,1,0,0,1,0,15
1608,781006,29,4,9,4,8,0,1,0,0,2,2,0,0,0,1,2,8
1608,796194,28,2,6,1,2,1,4,2,2,0,5,3,3,0,1,1,7
1608,790917,21,1,5,1,5,0,0,6,6,2,2,3,1,3,3,0,8
1608,781157,26,3,9,2,5,1,4,0,0,0,1,0,0,0,1,0,7
1608,796464,20,2,6,2,3,0,3,3,6,1,5,1,1,0,2,1,7
1608,796459,25,3,8,3,8,0,0,5,6,1,3,1,1,1,1,0,11
1608,780648,12,0,4,0,4,0,0,2,2,3,0,0,3,0,0,0,2
1608,790918,5,0,1,0,1,0,0,0,0,0,0,0,1,0,1,0,0
1609,796778,26,3,10,2,5,1,5,0,1,2,5,0,3,0,1,0,7
1609,781107,16,2,2,2,2,0,0,0,0,0,5,1,5,0,4,1,4
1609,791974,27,3,6,2,4,1,2,1,1,0,1,1,2,1,2,0,8
1609,785366,33,5,17,4,11,1,6,0,0,1,3,7,1,3,2,0,11
1609,780863,16,2,5,1,2,1,3,1,2,1,0,0,4,1,2,0,6
1609,776069,23,0,4,0,2,0,2,2,2,2,4,0,3,0,5,0,2
1609,796777,12,1,2,1,2,0,0,0,0,0,1,0,3,1,0,0,2
1609,791971,21,1,4,1,1,0,3,0,0,0,1,2,2,0,0,0,2
1609,791972,26,5,8,1,1,4,7,0,1,0,2,0,3,1,0,0,14
1610,790771,20,1,4,1,4,0,0,0,0,0,1,2,3,1,4,1,2
1610,780271,20,0,2,0,1,0,1,0,0,0,5,0,2,0,2,0,0
1610,790772,27,2,12,1,4,1,8,0,0,1,0,2,0,2,3,0,5
1610,785230,22,4,9,1,3,3,6,0,0,0,0,3,0,2,1,0,11
1610,780022,25,1,9,1,5,0,4,3,4,0,3,0,2,3,1,0,5
1610,780375,24,3,10,0,0,3,10,0,0,0,1,6,1,1,1,0,9
1610,780218,28,8,13,8,13,0,0,4,7,7,1,0,2,0,3,0,20
1610,796328,20,2,3,2,3,0,0,2,3,2,2,1,1,1,1,0,6
1610,792438,6,2,3,1,1,1,2,0,0,0,1,1,0,0,1,0,5
1610,796329,3,0,0,0,0,0,0,0,0,0,1,0,1,0,0,0,0
1610,790774,5,0,0,0,0,0,0,0,0,0,0,0,0,0,0,0,0
1611,792181,30,5,7,5,6,0,1,4,5,2,3,2,0,1,1,0,14
1611,780986,28,2,5,2,5,0,0,6,6,2,4,7,2,0,2,0,10
1611,785902,29,8,13,2,4,6,9,0,0,2,8,4,2,1,6,0,22
1611,792179,26,6,8,1,1,5,7,0,0,0,5,5,1,1,3,0,17
1611,786662,25,7,13,4,5,3,8,0,0,0,0,2,1,2,0,0,17
1611,797796,20,4,4,3,3,1,1,0,0,0,2,3,3,4,2,0,9
1611,797794,15,4,7,3,4,1,3,0,0,0,4,0,0,0,0,0,9
1611,792176,3,0,1,0,1,0,0,0,0,1,0,0,2,0,0,0,0
1611,786661,11,0,3,0,1,0,2,0,0,0,2,0,0,0,1,0,0
1611,797788,9,0,0,0,0,0,0,0,0,1,2,0,1,0,2,0,0
1611,792177,4,1,2,1,2,0,0,1,1,0,0,0,2,0,0,0,3
1612,780323,25,5,6,5,6,0,0,2,5,3,3,2,4,0,0,3,12
1612,792233,24,5,10,5,9,0,1,5,6,5,2,2,1,2,0,0,15
1612,797894,25,6,13,6,12,0,1,0,0,4,1,2,0,2,2,0,12
1612,785954,26,3,10,1,5,2,5,1,2,1,2,3,2,0,1,0,9
1612,785811,27,2,10,2,8,0,2,1,2,0,4,6,0,3,0,0,5
1612,786016,21,2,7,2,6,0,1,0,0,3,2,0,1,1,0,0,4
1612,797892,18,0,4,0,1,0,3,5,6,1,2,1,3,0,1,0,5
1612,792234,12,1,2,1,1,0,1,3,5,3,1,1,0,0,0,0,5
1612,797891,6,0,2,0,2,0,0,0,0,0,0,0,0,0,0,0,0
1612,797893,5,0,0,0,0,0,0,2,2,0,2,1,1,0,0,0,2
1612,792230,7,2,3,0,0,2,3,0,0,0,0,0,2,0,0,0,6
1612,781356,4,1,1,1,1,0,0,0,2,1,0,1,0,0,0,1,2
1613,776018,21,1,4,1,4,0,0,0,0,3,1,0,4,0,1,3,2
1613,797859,31,4,9,2,4,2,5,0,0,0,3,0,2,1,2,0,10
1613,797855,27,1,3,1,3,0,0,0,0,0,3,4,1,0,1,0,2
1613,792208,27,3,5,3,5,0,0,0,3,1,4,0,2,0,4,0,6
1613,797862,6,2,2,2,2,0,0,0,0,0,0,0,2,1,0,0,4
1613,792204,15,1,4,0,1,1,3,0,0,0,1,3,0,0,3,0,3
1613,797863,11,1,2,1,2,0,0,0,0,1,2,1,2,0,1,1,2
1613,797856,14,2,4,2,2,0,2,1,1,0,1,1,3,0,2,0,5
1613,786262,18,3,7,0,3,3,4,3,3,0,1,0,3,0,1,0,12
1613,786983,12,1,2,1,2,0,0,4,7,3,3,0,1,1,2,0,6
1613,781314,15,2,6,1,3,1,3,0,0,0,3,0,3,0,1,0,5
1613,781317,3,0,0,0,0,0,0,0,0,0,0,2,0,0,0,0,0
1614,780890,30,7,14,5,9,2,5,7,7,2,3,1,2,1,0,1,23
1614,775757,15,0,0,0,0,0,0,0,0,1,1,1,1,0,5,0,0
1614,791123,37,2,3,2,2,0,1,2,2,0,1,1,0,1,2,0,6
1614,786066,38,8,21,7,13,1,8,2,4,2,11,2,1,1,3,0,19
1614,785636,35,6,7,3,3,3,4,0,0,0,7,1,3,2,1,0,15
1614,791121,7,2,3,2,2,0,1,0,0,1,0,0,2,0,0,0,4
1614,791119,15,1,4,1,4,0,0,1,2,1,0,0,2,0,1,0,3
1614,785969,23,3,5,2,3,1,2,4,5,0,2,4,2,3,2,0,11
1616,785775,23,3,4,2,2,1,2,1,2,1,5,1,1,1,4,2,8
1616,781335,26,7,13,6,8,1,5,2,3,1,4,1,4,2,1,2,17
1616,776351,24,9,11,7,7,2,4,1,3,5,3,1,4,0,4,0,21
1616,785770,27,2,9,1,5,1,4,0,0,0,4,3,1,1,5,0,5
1616,781341,28,3,8,1,1,2,7,2,3,0,6,5,2,3,0,0,10
1616,796542,12,0,2,0,1,0,1,2,2,0,2,2,0,0,1,0,2
1616,791285,9,0,2,0,0,0,2,2,2,0,1,0,2,0,1,0,2
1616,796538,15,1,3,1,1,0,2,0,0,0,3,2,2,3,0,0,2
1616,791284,10,0,1,0,0,0,1,0,0,0,1,1,1,0,0,0,0
1616,791283,6,0,1,0,1,0,0,0,0,0,0,1,1,1,0,0,0
1616,785767,14,5,6,0,0,5,6,0,0,0,2,1,2,0,0,0,15
1616,791282,2,0,0,0,0,0,0,2,2,0,0,0,0,1,0,0,2
1616,791286,2,0,1,0,1,0,0,0,0,0,0,0,0,0,0,0,0
1616,785773,2,1,1,1,1,0,0,0,0,0,0,0,0,0,0,0,2
1618,775606,16,3,5,3,5,0,0,0,2,2,1,0,4,1,0,1,6
1618,791672,23,3,4,3,4,0,0,1,2,2,2,2,2,0,1,2,7
1618,791674,28,3,8,2,4,1,4,0,0,0,4,6,3,1,1,1,7
1618,780552,32,6,14,3,4,3,10,0,0,1,4,2,1,0,1,0,15
1618,780550,29,6,9,3,4,3,5,2,3,1,4,4,0,2,3,0,17
1618,797424,12,2,3,2,3,0,0,0,0,1,1,0,2,0,1,0,4
1618,785791,26,6,14,2,2,4,12,0,2,1,2,0,3,1,2,0,16
1618,785793,11,2,3,0,0,2,3,0,0,3,1,0,1,0,1,1,6
1618,780538,22,1,5,1,3,0,2,0,0,0,2,5,1,4,4,0,2
1618,797423,1,0,0,0,0,0,0,0,0,0,0,0,0,0,0,0,0
1619,791337,21,4,7,4,7,0,0,4,7,2,2,0,2,1,0,1,12
1619,797877,26,8,13,8,11,0,2,2,2,4,5,1,1,0,3,0,18
1619,797872,27,3,7,3,7,0,0,0,0,0,4,1,1,4,5,0,6
1619,797874,15,1,2,0,0,1,2,0,0,0,0,2,0,1,0,0,3
1619,791339,30,7,18,6,12,1,6,1,2,1,6,6,2,1,1,0,16
1619,791335,14,0,4,0,1,0,3,0,0,0,0,2,1,0,2,2,0
1619,781599,9,0,0,0,0,0,0,0,0,0,0,0,1,0,0,0,0
1619,797875,21,3,6,3,4,0,2,2,4,0,3,0,2,1,2,0,8
1619,791338,20,1,1,1,1,0,0,2,4,1,1,1,2,0,3,0,4
1619,781595,13,0,1,0,0,0,1,0,0,0,2,0,0,0,0,0,0
1619,797873,4,0,0,0,0,0,0,0,0,0,0,0,0,0,0,0,0
1620,797235,27,2,3,2,3,0,0,1,4,2,3,1,3,2,4,0,5
1620,797232,38,8,16,4,4,4,12,4,4,1,1,4,0,3,1,0,24
1620,791367,21,2,6,2,5,0,1,0,1,0,1,1,3,0,3,0,4
1620,797234,15,2,5,2,4,0,1,2,3,2,4,0,4,0,1,0,6
1620,797239,38,8,12,4,4,4,8,1,2,0,7,3,3,2,1,0,21
1620,797233,6,0,1,0,0,0,1,1,2,0,1,0,1,0,2,0,1
1620,791368,16,3,3,3,3,0,0,0,0,1,3,0,4,0,0,0,6
1620,797238,3,0,0,0,0,0,0,0,0,1,1,0,1,0,0,0,0
1620,786251,8,0,0,0,0,0,0,0,0,0,1,0,1,0,2,0,0
1620,785446,23,1,6,0,2,1,4,2,2,0,1,3,3,0,2,0,5
1620,791369,5,0,1,0,0,0,1,0,0,0,0,0,1,0,0,0,0
1622,792078,22,2,3,2,3,0,0,0,0,0,3,0,1,0,0,0,4
1622,786067,32,4,4,4,4,0,0,2,3,3,4,1,3,0,4,0,10
1622,797661,38,9,16,3,5,6,11,1,2,2,8,3,2,2,4,1,25
1622,797660,20,1,3,1,2,0,1,0,0,0,1,3,3,0,3,0,2
1622,780258,35,7,14,2,3,5,11,0,0,0,3,6,3,0,6,0,19
1622,792082,27,4,8,0,1,4,7,0,0,0,1,0,3,0,0,1,12
1622,791952,2,0,0,0,0,0,0,0,0,0,1,0,0,0,0,0,0
1622,797659,2,0,1,0,0,0,1,0,0,1,0,0,0,0,0,0,0
1622,785591,20,0,3,0,1,0,2,3,4,0,0,8,1,2,0,0,3
1622,792083,2,0,1,0,0,0,1,0,0,0,0,0,1,0,0,0,0
1623,787175,35,6,12,0,0,6,12,0,0,0,8,0,2,1,2,0,18
1623,782126,31,2,4,2,3,0,1,1,4,0,1,1,1,2,3,0,5
1623,790909,34,6,12,3,6,3,6,3,4,1,1,6,3,2,1,0,18
1623,781393,19,3,8,2,4,1,4,0,0,0,1,1,0,0,2,0,7
1623,775351,38,4,4,4,4,0,0,0,0,0,1,1,1,0,4,0,8
1623,790907,24,4,7,4,7,0,0,8,9,1,3,0,5,1,1,0,16
1623,796455,19,1,1,1,1,0,0,2,2,1,3,1,3,1,0,0,4
1623,796454,0,0,0,0,0,0,0,0,0,0,0,0,0,0,0,0,0
1624,796860,27,4,9,3,7,1,2,2,2,3,4,1,3,1,3,0,11
1624,791185,33,2,2,2,2,0,0,0,0,0,8,1,5,0,4,1,4
1624,791187,27,5,8,5,8,0,0,3,4,0,4,0,0,2,3,1,13
1624,785650,27,3,5,2,2,1,3,3,4,0,0,1,2,0,3,0,10
1624,785649,36,6,16,5,11,1,5,8,8,0,9,4,3,1,3,0,21
1624,775208,13,0,1,0,1,0,0,4,4,0,2,0,3,0,2,1,4
1624,796857,12,1,2,0,0,1,2,0,0,0,1,0,2,1,0,0,3
1624,796856,13,1,4,1,2,0,2,0,0,0,2,0,1,0,2,0,2
1624,791184,12,1,2,1,1,0,1,0,0,1,3,2,2,0,1,0,2
1625,796892,18,1,3,1,3,0,0,0,0,0,4,1,4,0,2,2,2
1625,796886,32,2,9,1,5,1,4,2,4,1,3,0,2,3,3,0,7
1625,796884,28,3,8,1,3,2,5,2,2,1,1,5,4,4,0,0,10
1625,796882,34,7,13,2,4,5,9,4,7,0,3,3,0,1,3,0,23
1625,790447,31,1,6,1,6,0,0,0,0,0,2,1,1,2,0,0,2
1625,796891,16,6,9,5,7,1,2,1,1,2,2,0,3,1,1,0,14
1625,796890,4,0,1,0,0,0,1,2,2,0,0,0,2,1,2,0,2
1625,785324,4,2,2,1,1,1,1,0,0,0,0,0,0,0,0,0,5
1625,796888,15,0,1,0,0,0,1,0,0,0,3,2,1,0,0,0,0
1625,796887,18,3,7,3,3,0,4,2,5,0,2,1,3,0,2,0,8
1626,792025,15,2,3,2,3,0,0,2,4,0,4,0,4,0,1,1,6
1626,792020,31,7,16,7,14,0,2,0,1,0,1,5,0,3,1,0,14
1626,792022,11,2,4,2,3,0,1,2,2,0,1,0,2,0,3,0,6
1626,785946,26,2,4,1,3,1,1,1,2,2,5,1,3,0,3,1,6
1626,785939,28,5,11,1,4,4,7,4,4,1,3,4,2,0,4,0,18
1626,792026,15,1,3,1,3,0,0,0,0,0,1,0,1,1,0,1,2
1626,785948,10,0,0,0,0,0,0,2,2,2,0,0,4,1,3,0,2
1626,797634,16,3,5,2,2,1,3,1,1,1,2,2,0,0,2,0,8
1626,792024,4,0,1,0,1,0,0,0,0,0,0,3,1,0,0,0,0
1626,785941,22,4,9,1,3,3,6,1,3,1,2,0,4,1,0,0,12
1626,785938,22,1,4,0,1,1,3,0,0,0,2,2,0,0,1,0,3
1627,785459,15,4,7,4,7,0,0,0,0,0,2,1,4,1,2,0,8
1627,789102,30,5,7,5,7,0,0,2,3,0,5,11,1,0,4,0,12
1627,789101,20,0,1,0,1,0,0,0,0,0,1,0,2,0,0,1,0
1627,781371,18,1,4,0,2,1,2,0,0,1,2,4,0,3,1,0,3
1627,781367,18,5,8,3,4,2,4,0,0,1,2,1,1,0,2,0,12
1627,797731,13,4,7,4,7,0,0,2,6,5,3,0,4,0,1,0,10
1627,792066,18,2,3,2,2,0,1,0,0,4,3,1,1,0,0,0,4
1627,781362,1,0,0,0,0,0,0,1,3,0,0,0,0,0,0,0,1
1627,797730,9,2,6,2,4,0,2,0,0,1,0,0,1,2,0,0,4
1627,792064,14,6,8,1,1,5,7,0,1,0,0,1,0,1,1,0,17
1627,792063,12,2,5,0,1,2,4,0,0,1,0,1,4,0,1,0,6
1627,792061,14,2,4,1,3,1,1,0,0,2,3,0,1,0,0,0,5
1627,788037,17,4,12,2,8,2,4,3,6,3,5,2,1,1,2,0,13
1627,789982,1,0,0,0,0,0,0,0,0,0,0,0,0,0,0,0,0
1628,791220,17,1,5,1,4,0,1,1,6,1,3,3,3,0,1,0,3
1628,776217,30,4,4,4,4,0,0,2,3,3,8,1,2,2,3,3,10
1628,790818,27,2,8,1,6,1,2,3,4,1,1,4,2,0,4,0,8
1628,786396,24,1,8,1,6,0,2,3,4,0,2,1,1,0,2,0,5
1628,780730,31,7,14,3,7,4,7,0,0,1,8,1,1,0,1,3,18
1628,786824,23,1,6,1,2,0,4,5,6,3,2,2,2,0,1,0,7
1628,796923,10,0,2,0,2,0,0,0,0,1,1,1,1,1,2,0,0
1628,791219,22,2,6,1,1,1,5,0,0,0,3,1,0,0,1,0,5
1628,796921,10,1,1,1,1,0,0,0,0,0,0,0,3,0,2,0,2
1628,796920,6,1,1,0,0,1,1,0,0,0,0,0,2,0,0,0,3
1629,785227,30,2,6,2,6,0,0,2,2,3,9,0,4,1,2,3,6
1629,786237,21,2,6,2,6,0,0,3,5,2,2,2,2,0,1,0,7
1629,786232,24,1,7,0,5,1,2,0,0,0,1,3,3,0,1,1,3
1629,780287,34,8,16,7,10,1,6,2,2,2,3,0,2,1,0,0,19
1629,776309,26,1,6,1,4,0,2,1,2,1,3,1,4,4,2,1,3
1629,792288,26,0,2,0,2,0,0,3,4,0,6,1,3,1,2,1,3
1629,798067,15,4,7,4,7,0,0,0,0,2,1,1,1,0,1,0,8
1629,792278,24,4,11,0,3,4,8,4,4,0,2,0,2,1,2,0,16
1630,791876,32,10,20,10,16,0,4,4,4,7,14,5,0,1,2,2,24
1630,791877,17,3,6,3,6,0,0,0,0,4,5,1,4,0,0,2,6
1630,785667,27,1,6,1,1,0,5,0,0,0,1,2,1,2,0,0,2
1630,786572,31,2,8,2,6,0,2,5,8,1,2,0,1,1,3,0,9
1630,786570,18,4,5,3,3,1,2,3,5,1,2,4,2,0,3,0,12
1630,797486,20,0,2,0,1,0,1,4,6,0,2,1,1,2,2,1,4
1630,797490,13,1,5,1,4,0,1,0,0,0,6,0,2,0,1,0,2
1630,797491,16,0,5,0,3,0,2,0,0,1,5,0,2,2,1,0,0
1630,781205,9,1,3,1,3,0,0,2,6,5,1,0,2,0,2,2,4
1630,797487,6,1,2,1,2,0,0,1,1,0,0,0,1,0,1,0,3
1630,790396,2,0,0,0,0,0,0,0,0,0,0,0,0,0,1,0,0
1630,797489,1,0,0,0,0,0,0,0,0,0,0,0,0,0,0,0,0
1630,797492,1,0,0,0,0,0,0,0,0,0,0,0,0,0,0,0,0
1630,791880,1,0,0,0,0,0,0,0,0,0,0,0,0,0,0,0,0
1630,791878,6,0,2,0,1,0,1,1,2,1,0,0,1,0,0,0,1
1631,791289,16,1,3,1,3,0,0,1,4,1,2,0,5,1,0,0,3
1631,785786,23,0,2,0,1,0,1,0,0,1,7,1,4,2,1,1,0
1631,796571,19,1,9,1,8,0,1,0,0,0,3,0,4,0,1,0,2
1631,791291,30,4,9,2,3,2,6,0,0,2,4,1,2,2,0,0,10
1631,781346,33,5,15,4,8,1,7,2,2,1,2,4,1,0,2,0,13
1631,796572,14,1,4,1,4,0,0,0,3,3,2,1,1,0,2,0,2
1631,791288,6,0,1,0,1,0,0,0,0,0,0,0,3,1,1,0,0
1631,796576,20,1,7,1,5,0,2,2,2,2,2,1,2,1,5,0,4
1631,796574,13,2,5,1,2,1,3,2,2,0,1,2,2,0,4,0,7
1631,791290,21,4,9,3,4,1,5,0,0,0,2,0,1,0,0,1,9
1631,791287,5,0,0,0,0,0,0,0,0,0,1,0,2,1,1,1,0
1632,791230,25,1,4,1,2,0,2,2,2,3,4,3,0,1,2,0,4
1632,785557,21,3,5,3,5,0,0,2,2,2,2,3,4,0,3,1,8
1632,791228,26,4,10,3,6,1,4,2,4,1,4,1,1,1,2,0,11
1632,796932,20,4,8,3,6,1,2,3,3,1,1,2,3,1,0,0,12
1632,785624,19,0,3,0,1,0,2,0,0,1,3,1,3,1,2,0,0
1632,796935,18,6,10,2,2,4,8,0,0,0,4,0,0,2,0,0,16
1632,796933,2,1,1,1,1,0,0,0,1,0,0,0,0,1,0,0,2
1632,791226,14,1,2,1,2,0,0,2,3,0,1,0,0,0,1,3,4
1632,791229,1,0,0,0,0,0,0,0,0,0,1,0,0,0,1,0,0
1632,791227,18,1,4,1,2,0,2,0,0,0,1,2,3,1,0,0,2
1632,785556,8,5,9,4,5,1,4,2,2,0,0,0,1,5,1,0,13
1632,781211,1,0,0,0,0,0,0,0,0,0,0,0,0,0,0,0,0
1632,781201,13,2,4,1,1,1,3,0,1,0,1,0,0,2,0,1,5
1632,781198,14,1,2,1,2,0,0,2,3,0,3,1,2,2,0,0,4
1634,791131,16,2,3,2,3,0,0,2,4,2,5,1,0,0,1,0,6
1634,791135,15,6,9,6,9,0,0,0,1,5,4,0,0,1,0,0,12
1634,786090,20,10,17,5,7,5,10,0,0,2,6,4,2,3,0,0,25
1634,786088,21,2,3,1,2,1,1,2,2,0,4,5,0,2,4,0,7
1634,774921,6,1,3,0,1,1,2,0,0,0,1,2,2,0,0,1,3
1634,791133,10,5,6,5,6,0,0,0,0,3,1,1,0,0,1,1,10
1634,791134,8,0,1,0,1,0,0,0,1,2,4,3,0,0,0,2,0
1634,785541,13,3,8,2,2,1,6,0,0,1,4,0,1,0,0,0,7
1634,786097,10,1,1,1,1,0,0,0,0,1,2,1,0,1,2,0,2
1634,791521,15,3,4,3,4,0,0,1,5,5,4,1,2,2,2,4,7
1634,796792,5,0,2,0,0,0,2,0,2,0,0,0,0,0,0,0,0
1634,796791,4,1,1,1,1,0,0,0,0,0,0,0,2,0,1,0,2
1634,796790,21,2,9,1,2,1,7,2,2,0,2,4,2,0,1,0,7
1634,792585,7,3,5,0,1,3,4,0,0,0,0,0,0,1,0,0,9
1634,791132,15,2,5,2,4,0,1,0,2,3,2,1,0,2,1,0,4
1634,786092,14,1,3,1,2,0,1,0,0,0,2,4,0,1,2,0,2
1636,792227,23,4,14,3,10,1,4,2,3,5,6,1,2,0,3,1,11
1636,781340,20,1,4,1,3,0,1,0,3,2,1,2,5,2,2,0,2
1636,776128,32,1,6,1,3,0,3,0,0,0,4,3,3,1,2,0,2
1636,785935,35,5,14,4,7,1,7,2,3,2,2,5,2,3,3,0,13
1636,781352,29,5,8,5,8,0,0,2,2,4,7,0,3,1,1,2,12
1636,792223,18,3,9,3,5,0,4,0,1,1,1,1,2,1,1,0,6
1636,797889,6,1,2,1,2,0,0,0,0,0,1,0,0,0,0,0,2
1636,781351,21,3,6,1,3,2,3,1,2,4,6,0,2,0,4,0,9
1636,786453,10,0,2,0,2,0,0,0,0,0,2,1,3,0,1,0,0
1636,797881,6,0,1,0,1,0,0,1,2,1,0,1,0,0,1,0,1
1638,780306,24,2,5,2,3,0,2,5,6,0,5,2,2,3,3,1,9
1638,786357,36,9,12,7,10,2,2,3,4,0,7,1,4,0,4,0,23
1638,780312,38,6,10,1,2,5,8,5,5,0,3,2,1,1,2,0,22
1638,797116,31,3,8,2,3,1,5,0,0,0,2,4,3,0,3,0,7
1638,791537,28,2,6,2,5,0,1,0,2,2,1,4,4,1,1,0,4
1638,775846,3,0,1,0,1,0,0,0,0,0,1,0,0,0,0,0,0
1638,775565,7,2,3,1,2,1,1,0,0,0,1,0,3,0,0,0,5
1638,775418,10,0,0,0,0,0,0,0,0,0,2,1,5,0,3,0,0
1638,786358,23,4,8,2,4,2,4,1,2,2,2,0,1,0,0,0,11
1639,775955,30,6,9,3,3,3,6,6,8,0,3,4,2,1,0,0,21
1639,775840,27,2,3,1,1,1,2,0,0,0,0,3,3,1,1,0,5
1639,785395,32,3,6,2,5,1,1,1,2,0,6,1,5,3,0,1,8
1639,775811,19,0,1,0,1,0,0,0,0,0,1,0,1,0,1,0,0
1639,786704,27,3,11,2,7,1,4,2,2,2,4,1,2,0,5,1,9
1639,790921,19,0,1,0,1,0,0,2,2,0,2,3,1,2,0,0,2
1639,786551,25,6,13,3,5,3,8,3,3,0,0,3,0,0,3,0,18
1639,792327,1,0,0,0,0,0,0,0,0,0,0,0,0,0,0,0,0
1639,775287,8,2,4,0,1,2,3,0,0,2,0,1,0,0,0,0,6
1639,786706,12,3,4,3,4,0,0,1,3,0,3,1,4,0,1,1,7
1640,775074,33,7,8,7,8,0,0,6,7,1,5,2,0,1,0,2,20
1640,780462,29,7,15,5,9,2,6,2,2,0,0,6,2,3,5,0,18
1640,786447,19,2,6,2,5,0,1,2,2,2,0,1,4,1,1,1,6
1640,786448,30,6,10,4,7,2,3,0,4,4,8,4,1,1,1,2,14
1640,780731,27,2,5,2,4,0,1,2,2,2,2,2,0,0,2,0,6
1640,786132,21,1,2,1,2,0,0,0,0,0,4,1,3,1,1,0,2
1640,776365,3,1,2,1,2,0,0,0,0,0,1,0,0,0,0,0,2
1640,791631,15,2,7,2,4,0,3,2,2,0,0,0,1,0,2,0,6
1640,796971,13,1,2,1,1,0,1,0,0,0,1,0,2,0,0,0,2
1640,775121,5,1,1,1,1,0,0,0,2,1,1,0,2,1,1,0,2
1640,791632,4,0,0,0,0,0,0,0,0,0,1,0,1,0,1,0,0
1640,791630,1,0,0,0,0,0,0,0,0,0,0,1,0,0,0,0,0
1641,780104,32,6,11,3,8,3,3,0,2,1,6,4,3,3,3,0,15
1641,791680,23,1,4,1,1,0,3,0,0,0,1,2,4,0,1,1,2
1641,797431,19,2,4,2,4,0,0,0,0,1,0,2,2,0,2,0,4
1641,791356,29,4,8,4,6,0,2,0,3,1,3,1,1,0,3,0,8
1641,785815,39,3,11,0,3,3,8,4,4,0,4,2,3,4,4,0,13
1641,791681,12,0,1,0,1,0,0,0,0,1,0,0,2,1,1,0,0
1641,785812,32,5,10,2,5,3,5,3,4,0,1,2,3,0,3,0,16
1641,791684,9,0,1,0,1,0,0,0,0,0,1,0,1,0,1,0,0
1641,791682,5,0,1,0,1,0,0,0,0,0,0,0,3,0,1,0,0
1642,775324,18,7,7,7,7,0,0,2,5,1,2,0,1,1,0,0,16
1642,791223,27,1,5,1,5,0,0,0,0,3,4,1,0,1,1,1,2
1642,791224,29,4,14,3,8,1,6,2,6,2,9,6,3,2,2,3,11
1642,785571,37,7,14,6,12,1,2,7,9,2,2,4,1,2,0,1,22
1642,781181,28,5,9,2,3,3,6,0,0,1,1,2,4,0,2,1,13
1642,796927,1,0,0,0,0,0,0,0,0,0,0,0,0,0,0,0,0
1642,791225,20,3,6,3,5,0,1,4,6,0,2,1,1,1,0,3,10
1642,791811,6,1,3,1,3,0,0,0,0,0,0,0,3,0,1,0,2
1642,785564,13,4,6,1,2,3,4,0,0,0,1,1,2,1,1,0,11
1642,786436,21,1,3,0,1,1,2,2,3,0,3,2,3,1,0,1,5
1643,797779,24,2,8,1,4,1,4,2,2,5,5,0,4,0,6,1,7
1643,797769,34,4,11,4,8,0,3,1,2,1,4,0,1,1,2,0,9
1643,786256,20,1,5,1,5,0,0,1,2,2,3,0,3,0,1,0,3
1643,797776,15,0,4,0,3,0,1,0,0,0,2,2,0,0,1,0,0
1643,797774,27,2,6,1,3,1,3,4,5,2,3,1,5,1,1,0,9
1643,785568,23,0,1,0,0,0,1,0,0,0,2,1,3,0,1,1,0
1643,797778,18,6,12,3,5,3,7,4,4,2,6,0,2,3,0,0,19
1643,797768,31,13,23,8,15,5,8,6,7,2,2,4,1,0,0,0,37
1643,775106,8,1,1,1,1,0,0,2,2,0,1,0,2,0,1,0,4
1644,796980,14,1,4,1,4,0,0,2,3,3,1,1,1,0,2,0,4
1644,776200,16,0,4,0,4,0,0,3,4,2,1,1,0,1,0,0,3
1644,780925,22,2,6,2,3,0,3,0,0,0,1,1,1,1,0,0,4
1644,780446,24,1,4,0,0,1,4,2,4,0,4,5,2,1,2,0,5
1644,781034,30,9,17,5,7,4,10,0,0,1,6,0,1,5,0,1,22
1644,791625,7,0,2,0,2,0,0,0,0,2,1,0,0,0,1,0,0
1644,796978,1,0,1,0,1,0,0,0,0,0,0,0,0,0,0,1,0
1644,791622,21,1,4,1,4,0,0,0,0,2,5,0,3,1,1,0,2
1644,796979,18,3,7,3,6,0,1,2,2,3,5,1,2,0,0,0,8
1644,791624,10,2,5,0,0,2,5,1,2,0,2,2,1,0,0,0,7
1644,791637,5,0,1,0,0,0,1,0,0,0,0,0,0,0,0,0,0
1644,786437,12,1,4,1,3,0,1,3,4,1,2,0,4,2,3,0,5
1644,785620,20,3,9,2,7,1,2,9,9,3,2,2,4,0,3,0,16
1646,785827,20,3,7,3,7,0,0,2,4,3,3,0,0,0,3,1,8
1646,790776,22,3,6,3,6,0,0,3,4,2,4,1,2,0,0,1,9
1646,796332,31,1,7,1,5,0,2,0,0,3,3,0,2,1,2,0,2
1646,785813,36,2,11,2,9,0,2,14,14,0,1,3,2,2,1,0,18
1646,786289,31,5,9,5,5,0,4,1,1,0,1,2,1,0,2,0,11
1646,779975,12,2,4,2,4,0,0,0,0,3,3,0,1,0,1,0,4
1646,796330,16,5,7,5,6,0,1,3,3,3,4,0,1,0,4,0,13
1646,796337,21,0,3,0,3,0,0,2,2,2,3,2,3,2,0,1,2
1646,796334,11,1,2,1,2,0,0,0,0,1,5,0,3,1,3,2,2
1647,780095,16,4,5,4,5,0,0,0,0,3,1,1,5,0,0,0,8
1647,776321,35,4,13,2,8,2,5,0,0,0,7,2,4,1,1,0,10
1647,786081,38,4,8,4,7,0,1,0,0,1,4,1,1,4,2,0,8
1647,785431,37,1,6,1,5,0,1,4,4,1,2,4,4,2,1,0,6
1647,780232,38,4,12,2,8,2,4,6,9,0,1,1,3,2,4,0,16
1647,786020,13,2,4,2,4,0,0,2,2,0,0,0,2,1,3,0,6
1647,785356,17,2,4,1,1,1,3,0,0,0,1,0,2,0,2,0,5
1647,797918,6,1,2,1,1,0,1,0,0,0,0,0,1,0,0,0,2
1648,780378,21,4,6,4,6,0,0,2,2,1,4,1,4,0,3,2,10
1648,785798,33,2,11,0,1,2,10,5,10,0,4,1,1,0,3,0,11
1648,786253,36,8,12,5,8,3,4,8,8,1,5,4,3,1,2,1,27
1648,786374,34,8,11,8,9,0,2,4,7,3,4,2,3,2,2,2,20
1648,786404,31,4,4,4,4,0,0,1,2,3,2,0,4,2,2,0,9
1648,780381,5,0,0,0,0,0,0,2,2,0,0,0,2,0,0,0,2
1648,780121,3,0,1,0,0,0,1,0,0,0,0,0,0,0,0,0,0
1648,797061,25,0,2,0,1,0,1,2,2,0,3,4,2,0,3,1,2
1648,791562,7,1,1,0,0,1,1,0,0,0,1,1,3,0,0,0,3
1648,797065,5,1,1,0,0,1,1,0,0,0,0,1,0,0,0,0,3
1649,791833,22,5,9,5,8,0,1,5,6,1,1,4,4,1,2,0,15
1649,786623,18,2,3,2,3,0,0,0,0,1,0,1,4,1,1,1,4
1649,797405,34,3,9,3,8,0,1,2,4,1,4,1,4,1,2,0,8
1649,785698,26,3,8,2,3,1,5,0,1,1,2,0,0,0,1,0,7
1649,785920,35,6,16,6,13,0,3,1,2,0,4,4,0,0,2,0,13
1649,786624,16,2,2,2,2,0,0,3,4,0,4,0,3,0,2,0,7
1649,791834,20,3,5,2,3,1,2,2,2,0,0,2,5,2,0,0,9
1649,784077,21,3,4,0,0,3,4,0,0,0,1,1,4,1,0,0,9
1649,797413,8,1,2,0,1,1,1,2,2,1,0,0,0,0,0,0,5
1650,797628,17,0,4,0,2,0,2,0,0,1,1,0,1,0,1,0,0
1650,786481,31,9,16,7,12,2,4,1,5,2,5,0,2,0,0,1,21
1650,797626,34,1,7,1,4,0,3,0,1,0,2,6,3,2,4,2,2
1650,797624,35,2,6,1,2,1,4,0,0,1,12,3,2,2,4,1,5
1650,785965,26,1,3,1,2,0,1,1,2,1,1,3,0,0,0,0,3
1650,791793,9,4,6,4,5,0,1,0,0,2,1,0,1,0,1,0,8
1650,791791,15,1,2,0,0,1,2,0,0,0,1,1,3,0,0,0,3
1650,797627,11,1,2,0,0,1,2,0,0,0,1,0,0,0,0,0,3
1650,781032,22,3,4,2,2,1,2,0,1,0,0,1,2,0,0,0,7
1651,781044,31,3,12,2,10,1,2,2,4,2,4,2,2,0,2,1,9
1651,791795,31,3,5,1,2,2,3,0,0,2,3,1,1,1,2,0,8
1651,786489,30,2,6,2,4,0,2,1,1,0,4,0,3,0,0,0,5
1651,786488,37,6,17,6,14,0,3,2,3,1,5,2,2,0,2,0,14
1651,781038,35,6,7,5,5,1,2,0,1,0,4,1,0,2,1,0,13
1651,797620,9,0,1,0,0,0,1,0,0,0,0,1,1,0,2,0,0
1651,797621,14,0,0,0,0,0,0,0,0,0,0,0,2,0,0,0,0
1651,797619,8,1,2,1,2,0,0,0,0,0,0,0,2,0,2,0,2
1651,786487,5,1,1,1,1,0,0,0,0,0,2,0,2,0,0,0,2
1652,780406,21,1,6,0,3,1,3,2,4,2,5,2,1,1,1,0,5
1652,775087,23,5,8,5,7,0,1,4,7,3,8,1,2,2,2,0,14
1652,790984,23,3,7,2,2,1,5,0,0,0,1,0,0,0,1,0,7
1652,780212,32,6,12,2,4,4,8,4,4,0,3,3,1,1,1,0,20
1652,767245,26,4,8,4,8,0,0,2,4,1,3,3,3,4,4,1,10
1652,780214,13,2,6,1,3,1,3,1,1,0,2,1,1,0,1,0,6
1652,790985,1,0,0,0,0,0,0,0,0,0,0,0,1,0,0,0,0
1652,780215,15,3,5,3,5,0,0,0,0,2,2,1,0,1,1,0,6
1652,796596,8,0,2,0,0,0,2,0,0,0,2,2,1,0,0,0,0
1652,791168,17,3,6,3,3,0,3,0,0,0,1,1,2,0,1,0,6
1652,785297,21,3,5,1,2,2,3,0,0,0,3,2,1,1,0,0,8
1653,797103,26,7,10,7,10,0,0,0,0,5,8,0,3,0,3,1,14
1653,791414,22,2,5,2,4,0,1,0,1,1,3,2,1,0,0,1,4
1653,791413,21,3,10,2,4,1,6,0,0,0,1,1,1,1,1,0,7
1653,791411,26,2,6,0,2,2,4,0,0,0,2,2,4,0,3,0,6
1653,785776,29,6,11,4,6,2,5,0,0,0,6,4,2,2,2,0,14
1653,797102,2,0,1,0,1,0,0,0,0,1,0,0,0,0,0,0,0
1653,785911,9,2,2,1,1,1,1,0,0,1,1,0,2,0,2,0,5
1653,786403,12,0,5,0,4,0,1,0,2,0,2,1,1,0,1,1,0
1653,797105,14,0,0,0,0,0,0,0,0,0,4,0,0,0,0,0,0
1653,797100,21,0,3,0,2,0,1,1,2,0,2,1,3,2,6,0,1
1653,781209,18,6,12,3,6,3,6,0,0,0,2,0,4,1,1,0,15
1654,785835,31,6,13,6,11,0,2,3,6,3,4,3,2,1,0,1,15
1654,791309,36,5,15,4,12,1,3,4,7,1,4,6,3,1,5,0,15
1654,781622,34,4,10,3,3,1,7,1,2,3,3,0,1,1,1,2,10
1654,796602,15,1,1,1,1,0,0,0,0,1,3,0,0,1,0,0,2
1654,776334,35,6,12,2,3,4,9,2,4,1,4,3,3,1,2,0,18
1654,775862,20,3,6,3,6,0,0,5,7,1,3,0,3,3,3,0,11
1654,791301,16,1,3,1,2,0,1,4,6,3,4,0,1,0,1,0,6
1654,796603,5,0,1,0,0,0,1,0,0,0,2,1,0,0,0,0,0
1654,796604,4,0,1,0,1,0,0,0,0,0,1,0,0,0,0,0,0
1654,791304,4,1,1,1,1,0,0,0,0,0,1,0,1,0,0,0,2
1655,797359,2,0,0,0,0,0,0,0,0,0,0,0,0,0,0,0,0
1655,785669,33,5,12,4,6,1,6,1,1,1,3,5,2,0,3,0,12
1655,785416,30,7,11,7,11,0,0,0,0,2,8,0,2,0,2,0,14
1655,786578,22,2,4,1,2,1,2,0,0,0,4,1,5,0,1,1,5
1655,797358,16,0,6,0,4,0,2,0,0,3,2,0,1,0,3,0,0
1655,786138,30,9,14,5,6,4,8,7,9,1,2,3,4,1,2,0,29
1655,776236,17,1,7,1,2,0,5,0,0,1,0,2,1,0,2,0,2
1655,786140,9,0,1,0,1,0,0,0,0,0,2,1,3,1,0,0,0
1655,797357,2,0,1,0,1,0,0,0,0,0,0,0,0,0,0,0,0
1655,786136,8,1,2,1,1,0,1,0,0,0,0,0,3,0,1,1,2
1655,781145,9,1,5,1,3,0,2,0,0,1,5,1,2,0,0,0,2
1655,775195,22,3,6,0,1,3,5,0,0,1,0,1,0,0,1,0,9
1656,790839,18,2,2,1,1,1,1,0,0,0,3,2,1,0,1,0,5
1656,796393,11,4,6,4,6,0,0,2,4,1,2,0,2,0,2,2,10
1656,790840,15,0,0,0,0,0,0,0,0,1,0,4,0,1,3,0,0
1656,785386,34,4,12,3,7,1,5,4,4,0,1,5,3,1,3,0,13
1656,780373,33,3,5,0,0,3,5,3,4,0,3,4,2,0,2,0,12
1656,785388,29,13,18,13,18,0,0,4,7,6,5,2,1,1,2,1,30
1656,780370,23,4,7,3,4,1,3,1,2,2,11,1,3,0,1,4,10
1656,790841,27,0,4,0,2,0,2,0,0,1,0,1,1,0,1,0,0
1656,796396,10,0,0,0,0,0,0,0,0,0,0,3,0,0,3,1,0
1657,791391,14,4,7,4,6,0,1,1,2,0,1,0,4,0,3,0,9
1657,797156,26,0,2,0,1,0,1,2,2,1,2,4,3,3,2,0,2
1657,791390,39,4,13,4,11,0,2,2,4,2,5,4,3,3,1,2,10
1657,780133,31,7,11,3,3,4,8,4,4,0,1,4,2,1,0,0,22
1657,780130,36,8,14,6,9,2,5,0,0,0,4,3,3,0,3,0,18
1657,797158,13,0,0,0,0,0,0,0,0,1,1,0,4,0,2,0,0
1657,791388,6,1,5,1,4,0,1,0,0,1,0,0,0,0,0,0,2
1657,775743,16,0,3,0,1,0,2,0,0,0,0,0,2,0,1,0,0
1657,780407,10,1,1,1,1,0,0,0,1,1,0,0,0,0,0,0,2
1657,776446,9,1,3,0,1,1,2,0,0,0,1,0,0,0,0,0,3
1658,792128,31,4,7,4,5,0,2,6,6,4,5,0,3,1,3,0,14
1658,786838,30,4,9,4,8,0,1,7,12,2,6,0,4,0,2,3,15
1658,792132,25,1,4,1,2,0,2,0,0,0,2,1,3,1,2,0,2
1658,792127,27,3,9,2,5,1,4,0,0,1,4,0,1,1,0,0,7
1658,786267,29,3,8,2,4,1,4,0,0,1,2,1,3,0,4,0,7
1658,799273,6,1,3,1,3,0,0,0,0,0,0,0,1,1,0,0,2
1658,792131,14,3,6,3,6,0,0,0,0,2,3,1,4,1,1,0,6
1658,797736,7,0,0,0,0,0,0,0,0,0,2,0,0,0,0,0,0
1658,797739,13,0,1,0,0,0,1,0,0,0,1,3,0,1,0,0,0
1658,792126,17,0,4,0,1,0,3,0,0,0,4,0,3,0,0,0,0
1658,791668,1,0,0,0,0,0,0,0,0,0,0,0,0,0,0,0,0
1659,790232,35,4,11,1,6,3,5,0,0,0,4,3,2,1,6,0,11
1659,780614,21,1,4,0,3,1,1,1,4,4,2,1,4,1,1,0,4
1659,780093,25,2,4,2,4,0,0,4,7,1,4,0,2,0,1,0,8
1659,789066,37,5,14,2,6,3,8,2,6,0,5,0,4,3,0,0,15
1659,776278,28,1,4,0,1,1,3,4,5,0,3,1,2,0,2,0,7
1659,797593,9,2,6,2,6,0,0,0,0,3,0,1,2,0,0,0,4
1659,797592,6,0,1,0,0,0,1,0,0,0,0,1,0,0,0,0,0
1659,792411,12,0,5,0,1,0,4,0,0,0,2,1,0,0,0,0,0
1659,785806,27,0,0,0,0,0,0,0,0,0,2,1,0,0,2,0,0
1660,785536,27,4,8,3,6,1,2,0,0,1,9,0,1,0,1,2,9
1660,780119,27,6,14,6,11,0,3,0,0,1,3,1,4,0,2,2,12
1660,776097,30,6,8,3,3,3,5,2,2,0,1,11,1,1,0,1,17
1660,796559,35,6,11,3,4,3,7,0,0,0,7,3,1,2,1,1,15
1660,785280,30,7,12,6,9,1,3,2,3,2,1,4,4,3,2,1,17
1660,780149,27,8,18,4,8,4,10,2,2,0,2,6,1,3,1,1,22
1660,796561,2,0,0,0,0,0,0,0,0,0,0,0,0,0,1,0,0
1660,796558,7,0,1,0,1,0,0,0,0,0,1,0,0,0,0,0,0
1660,775679,13,3,4,3,4,0,0,0,0,0,0,1,3,1,0,0,6
1660,796560,2,0,0,0,0,0,0,2,2,2,0,0,0,0,0,0,2
1661,781208,20,3,11,3,8,0,3,0,0,1,3,1,0,0,0,0,6
1661,775489,25,5,9,5,9,0,0,0,0,2,8,0,1,0,3,0,10
1661,785561,22,1,4,1,3,0,1,2,4,1,3,0,1,1,0,0,4
1661,780313,35,4,12,3,7,1,5,4,4,0,3,4,1,0,3,0,13
1661,780766,35,4,11,1,3,3,8,2,2,0,2,7,3,3,3,0,13
1661,785560,19,3,7,1,2,2,5,0,0,1,0,0,2,1,1,0,8
1661,785563,23,3,7,2,5,1,2,0,0,0,3,1,1,0,1,0,7
1661,780758,13,4,4,3,3,1,1,2,2,3,5,0,0,0,3,1,11
1661,796751,2,0,0,0,0,0,0,0,0,0,0,0,1,0,0,0,0
1661,791087,1,0,0,0,0,0,0,0,0,0,0,0,1,0,0,0,0
1661,796750,1,1,1,0,0,1,1,0,0,0,0,0,1,0,0,0,3
1661,796748,1,0,0,0,0,0,0,0,0,0,0,1,0,0,0,0,0
1661,791088,2,0,0,0,0,0,0,0,0,0,0,0,0,0,0,0,0
1661,796749,1,0,0,0,0,0,0,0,0,0,0,0,0,0,0,0,0
1662,786772,20,3,8,3,8,0,0,0,0,3,5,1,4,0,2,0,6
1662,781484,34,3,7,1,1,2,6,0,0,1,5,1,3,0,1,1,8
1662,786769,20,2,5,2,5,0,0,0,0,0,1,1,2,0,2,0,4
1662,786024,21,2,7,2,4,0,3,0,0,0,3,0,3,1,2,1,4
1662,780002,37,10,17,9,14,1,3,5,5,1,2,4,2,1,4,0,26
1662,786773,9,0,0,0,0,0,0,0,0,0,1,0,3,0,1,2,0
1662,797840,32,1,4,1,3,0,1,2,2,1,2,3,0,2,1,0,4
1662,791970,21,6,11,2,5,4,6,3,3,1,2,0,3,1,2,1,19
1662,790823,6,0,0,0,0,0,0,0,0,0,0,0,0,0,1,0,0
1663,780094,35,4,11,2,7,2,4,3,4,3,4,3,2,3,1,0,13
1663,775142,22,3,13,3,11,0,2,8,8,4,1,3,5,0,1,0,14
1663,790842,20,4,6,4,6,0,0,4,8,3,7,1,0,1,1,1,12
1663,790843,36,4,9,2,3,2,6,4,6,3,4,2,2,2,4,1,14
1663,781563,30,2,4,2,2,0,2,0,0,0,1,3,3,0,1,0,4
1663,790844,18,4,8,4,8,0,0,0,0,2,1,0,1,0,2,0,8
1663,796914,10,0,2,0,1,0,1,0,0,0,0,1,1,3,2,0,0
1663,786212,29,4,12,4,8,0,4,1,1,2,3,0,2,0,0,0,9
1664,792029,16,1,6,1,5,0,1,0,0,2,1,1,3,0,1,0,2
1664,761149,22,3,5,1,2,2,3,4,4,0,4,2,3,0,1,1,12
1664,792032,36,5,11,2,6,3,5,4,6,0,4,6,3,0,0,0,17
1664,792031,21,0,4,0,1,0,3,0,0,0,3,4,2,1,0,0,0
1664,780828,38,17,26,14,20,3,6,4,5,1,10,1,2,0,1,0,41
1664,797641,9,1,3,1,3,0,0,0,0,0,1,0,2,0,0,0,2
1664,785822,14,1,3,1,3,0,0,0,0,0,3,0,4,0,1,1,2
1664,797637,28,1,3,0,0,1,3,2,2,0,1,4,0,2,0,0,5
1664,797636,3,0,0,0,0,0,0,0,0,0,0,0,1,1,1,0,0
1664,792030,2,1,1,0,0,1,1,0,0,0,0,0,1,0,0,0,3
1664,792027,11,2,4,0,2,2,2,1,2,1,0,0,3,0,0,0,7
1665,780833,23,0,2,0,2,0,0,2,3,1,2,1,4,1,1,2,2
1665,792034,32,3,5,1,2,2,3,7,8,0,8,1,2,0,1,0,15
1665,792033,16,3,8,2,4,1,4,6,6,0,3,0,1,0,2,0,13
1665,785381,32,4,11,2,3,2,8,1,2,1,7,2,2,0,1,2,11
1665,780830,33,4,6,2,2,2,4,8,8,0,4,2,3,0,2,0,18
1665,797645,15,3,6,3,5,0,1,2,2,0,1,0,2,0,2,1,8
1665,791688,20,1,3,0,0,1,3,0,0,0,4,1,1,0,1,0,3
1665,785980,29,3,8,1,1,2,7,0,0,0,1,0,3,0,2,0,8
1678,797222,16,0,1,0,1,0,0,1,2,2,3,1,3,0,0,1,1
1678,781526,34,11,16,11,15,0,1,0,1,2,5,2,3,0,2,3,22
1678,797219,39,6,13,4,9,2,4,0,0,2,0,3,2,1,4,0,14
1678,797218,29,5,15,3,7,2,8,2,2,1,3,2,1,3,2,0,14
1678,775697,30,3,9,3,4,0,5,1,1,1,2,4,3,2,2,0,7
1678,797223,8,0,0,0,0,0,0,0,0,0,2,0,1,0,1,0,0
1678,797221,4,0,1,0,0,0,1,0,0,0,0,0,0,0,0,0,0
1678,797217,22,1,2,0,0,1,2,0,0,0,2,1,1,0,0,0,3
1678,791846,18,1,5,1,3,0,2,0,0,1,2,1,2,0,0,0,2
1679,785423,38,6,10,4,4,2,6,7,7,1,8,0,1,0,4,1,21
1679,775676,22,2,3,2,3,0,0,0,0,1,3,1,4,0,1,2,4
1679,786298,38,2,8,1,4,1,4,1,1,2,6,4,1,1,2,0,6
1679,785425,39,3,8,2,7,1,1,2,2,0,3,2,1,1,1,1,9
1679,785422,37,8,17,6,11,2,6,0,0,0,1,1,4,2,5,0,18
1679,774957,16,1,3,0,0,1,3,0,0,0,1,1,1,0,1,0,3
1679,796431,7,1,3,1,2,0,1,1,2,2,0,0,0,0,0,0,3
1679,796429,3,0,0,0,0,0,0,0,0,0,0,0,0,0,0,0,0
1680,796381,28,1,5,1,3,0,2,0,0,2,2,1,2,0,2,0,2
1680,775585,34,4,7,4,7,0,0,5,7,6,9,1,3,0,1,2,13
1680,790822,40,9,19,7,12,2,7,0,0,1,2,1,2,3,2,1,20
1680,790820,39,4,13,4,8,0,5,1,2,0,5,4,3,2,3,0,9
1680,774980,4,1,1,0,0,1,1,0,0,0,0,1,0,1,2,0,3
1680,790821,32,5,8,5,5,0,3,2,2,0,4,0,4,1,3,3,12
1680,780445,19,1,3,1,3,0,0,1,2,1,3,0,1,0,1,2,3
1680,775634,2,0,2,0,2,0,0,0,0,1,0,0,0,0,1,0,0
1680,785365,2,0,1,0,0,0,1,0,0,0,0,0,0,0,0,0,0
1681,785294,39,5,12,4,11,1,1,0,1,4,5,3,2,0,3,0,11
1681,791081,8,0,1,0,1,0,0,0,0,0,1,0,3,0,1,0,0
1681,796514,33,0,1,0,1,0,0,5,7,1,1,8,0,3,4,0,5
1681,791080,29,3,11,1,8,2,3,4,6,2,2,2,2,0,0,1,12
1681,785675,32,7,12,3,5,4,7,0,0,0,3,1,0,1,2,0,18
1681,796511,13,0,2,0,0,0,2,0,0,0,2,0,1,1,1,0,0
1681,786446,18,1,3,0,0,1,3,2,2,0,1,1,2,3,1,0,5
1681,791083,20,5,11,0,0,5,11,0,0,0,1,0,3,0,0,2,15
1681,796512,8,0,3,0,0,0,3,0,0,0,1,0,0,0,0,0,0
1682,780853,39,6,14,5,11,1,3,0,0,1,10,3,3,1,3,1,13
1682,780858,30,4,10,3,5,1,5,2,2,1,3,1,3,1,1,2,11
1682,780849,20,3,5,2,2,1,3,2,2,0,1,2,0,0,0,0,9
1682,797646,21,2,6,2,6,0,0,0,1,0,1,2,1,1,2,1,4
1682,785996,11,0,2,0,1,0,1,0,0,0,3,1,4,2,1,1,0
1682,785990,20,3,10,2,6,1,4,0,0,0,0,2,3,1,2,0,7
1682,792039,20,4,6,4,6,0,0,0,3,3,5,0,1,2,3,1,8
1682,780776,3,0,1,0,1,0,0,0,0,0,0,0,0,0,1,0,0
1682,792235,10,2,2,2,2,0,0,0,0,1,1,0,1,0,1,0,4
1682,785998,18,0,2,0,1,0,1,0,2,2,2,0,2,0,2,0,0
1682,786010,8,1,1,1,1,0,0,0,0,2,1,1,2,0,2,0,2
1683,791964,27,0,4,0,1,0,3,1,2,1,1,0,3,0,3,0,1
1683,781339,39,8,21,4,6,4,15,1,1,0,5,3,4,1,3,1,21
1683,792041,32,3,10,1,2,2,8,1,3,1,3,0,3,0,2,0,9
1683,781337,39,6,12,3,5,3,7,2,4,2,6,6,0,1,5,0,17
1683,786056,14,1,5,0,1,1,4,0,0,0,4,2,2,1,0,1,3
1683,786054,34,2,5,2,4,0,1,1,2,2,3,1,2,2,1,0,5
1683,797712,14,0,2,0,1,0,1,0,0,1,2,0,4,0,1,1,0
1683,797713,1,0,0,0,0,0,0,0,0,0,0,0,1,0,1,0,0
1684,791023,14,2,3,2,3,0,0,0,0,1,3,0,5,0,2,3,4
1684,791027,27,6,14,5,9,1,5,3,4,2,5,8,3,2,2,0,16
1684,791024,35,7,15,4,7,3,8,7,7,1,5,1,2,0,4,0,24
1684,781507,34,5,7,4,6,1,1,1,1,1,1,2,3,1,1,0,12
1684,777572,17,0,2,0,1,0,1,0,0,1,2,1,1,0,2,0,0
1684,791028,25,1,6,0,2,1,4,0,0,0,4,1,2,2,0,1,3
1684,796685,33,4,8,1,3,3,5,3,4,0,4,1,1,0,4,0,14
1684,796684,15,3,4,1,1,2,3,0,0,1,1,1,1,1,1,0,8
1685,792171,21,4,8,4,8,0,0,3,4,0,4,1,3,1,4,5,11
1685,785674,28,3,9,1,3,2,6,1,3,1,2,0,4,1,0,0,9
1685,780049,29,5,12,5,12,0,0,3,5,2,4,0,0,0,2,0,13
1685,797784,32,8,16,5,10,3,6,0,0,2,6,2,2,1,3,0,19
1685,789059,36,4,10,4,8,0,2,2,3,3,0,1,1,1,1,0,10
1685,797782,3,0,1,0,0,0,1,0,0,0,0,0,0,0,0,0,0
1685,792174,16,0,0,0,0,0,0,0,0,0,2,2,2,0,1,0,0
1685,792173,1,0,0,0,0,0,0,0,0,0,0,1,0,0,0,0,0
1685,780527,23,4,5,4,4,0,1,2,4,0,2,2,2,1,2,0,10
1685,780980,8,0,0,0,0,0,0,0,0,0,0,1,3,0,1,0,0
1685,797783,3,0,0,0,0,0,0,0,0,0,0,0,0,0,0,0,0
1686,791201,18,2,5,2,5,0,0,1,2,2,1,0,1,0,1,0,5
1686,791202,36,2,9,0,2,2,7,0,0,1,2,4,3,2,4,0,6
1686,775767,31,4,7,4,7,0,0,1,2,1,8,2,2,0,2,1,9
1686,785628,40,5,15,5,11,0,4,5,5,1,3,1,2,2,1,0,15
1686,785627,29,4,10,3,5,1,5,1,2,2,2,2,0,2,0,0,10
1686,796904,3,0,0,0,0,0,0,0,0,0,0,0,0,0,1,0,0
1686,781135,6,1,1,1,1,0,0,0,0,1,1,0,1,0,2,0,2
1686,796902,1,0,0,0,0,0,0,0,0,0,0,0,2,0,0,0,0
1686,796901,14,0,4,0,2,0,2,0,0,0,2,0,0,0,0,0,0
1686,785629,22,0,3,0,1,0,2,1,2,0,3,0,0,1,1,0,1
1687,786299,21,2,3,2,3,0,0,0,0,0,0,0,3,0,1,3,4
1687,797215,24,3,6,1,3,2,3,0,0,0,2,4,2,3,5,0,8
1687,786295,29,3,7,2,4,1,3,0,0,2,11,0,0,1,3,0,7
1687,780792,26,4,6,3,5,1,1,2,2,0,1,3,1,0,1,0,11
1687,775598,22,1,5,0,3,1,2,0,0,1,0,2,0,0,1,0,3
1687,797216,6,0,0,0,0,0,0,0,0,0,1,0,1,0,1,0,0
1687,797214,24,6,12,6,12,0,0,3,4,2,6,1,3,0,0,0,15
1687,791461,19,2,4,2,4,0,0,0,0,2,1,2,1,0,2,1,4
1687,791459,15,2,5,2,5,0,0,0,0,0,2,0,2,1,2,0,4
1687,791460,14,1,4,1,3,0,1,0,0,0,0,0,1,0,1,1,2
1688,776333,15,1,1,1,1,0,0,1,2,1,1,1,1,1,1,0,3
1688,798134,22,3,7,1,3,2,4,1,2,0,2,3,4,3,1,0,9
1688,792561,24,1,5,1,4,0,1,2,3,1,0,2,0,1,4,0,4
1688,780270,32,2,6,2,3,0,3,0,0,2,5,3,1,2,2,1,4
1688,780266,24,3,8,1,3,2,5,4,4,0,0,0,1,0,2,0,12
1688,792565,34,3,7,3,6,0,1,4,6,3,6,1,2,2,2,0,10
1688,792563,29,4,10,4,8,0,2,3,4,1,1,1,4,1,5,0,11
1688,792560,5,0,0,0,0,0,0,0,0,0,0,0,4,0,3,0,0
1688,798132,10,1,3,1,2,0,1,0,0,0,0,0,0,0,0,0,2
1688,798135,5,0,0,0,0,0,0,0,0,0,2,0,1,0,0,0,0
1689,785638,18,2,5,0,2,2,3,0,0,2,1,0,2,1,3,0,6
1689,781326,24,4,5,4,5,0,0,0,0,3,6,2,3,2,1,2,8
1689,792215,20,1,5,1,3,0,2,1,2,0,0,1,2,1,2,0,3
1689,797870,37,5,10,2,5,3,5,2,3,0,3,5,3,0,4,0,15
1689,781323,33,6,10,4,5,2,5,2,2,0,4,9,2,3,4,0,16
1689,792210,31,4,9,2,4,2,5,3,3,0,2,4,2,1,2,0,13
1689,780874,19,2,4,1,1,1,3,3,5,0,4,0,1,1,0,0,8
1689,785430,16,2,2,2,2,0,0,0,1,3,3,1,2,0,0,0,4
1689,792213,2,0,0,0,0,0,0,0,0,0,0,0,0,0,0,0,0
1690,775455,29,6,12,5,10,1,2,0,0,5,4,1,1,0,1,1,13
1690,792124,32,6,10,6,10,0,0,2,3,7,5,1,2,0,4,1,14
1690,797749,16,1,4,0,1,1,3,0,0,1,0,0,2,0,2,0,3
1690,792120,30,1,11,0,2,1,9,2,2,0,4,1,2,0,1,0,5
1690,792123,34,4,11,3,4,1,7,2,2,1,3,3,3,1,2,0,11
1690,792119,5,0,1,0,1,0,0,0,2,1,0,0,1,0,0,0,0
1690,797752,14,1,3,1,3,0,0,0,0,0,2,2,4,1,1,1,2
1690,786002,6,1,2,1,1,0,1,0,0,0,0,0,0,0,0,0,2
1690,786005,11,2,6,1,2,1,4,0,0,0,1,0,1,0,0,0,5
1690,781397,23,1,4,1,3,0,1,0,0,0,4,0,3,1,1,0,2
1691,786795,37,3,6,1,1,2,5,0,0,2,10,1,2,1,1,0,8
1691,789020,39,3,9,3,6,0,3,6,7,3,2,2,2,2,1,1,12
1691,792091,26,3,9,0,4,3,5,2,2,1,2,0,3,1,2,1,11
1691,786787,40,6,18,6,12,0,6,2,3,0,4,2,0,2,1,0,14
1691,774954,35,3,7,3,5,0,2,6,7,0,3,2,2,1,1,0,12
1691,781456,20,4,6,2,3,2,3,0,0,1,2,1,3,0,0,0,10
1691,774815,3,0,1,0,1,0,0,0,0,0,0,0,0,0,0,0,0
1692,791686,9,1,3,1,2,0,1,2,2,0,1,1,3,0,1,0,4
1692,798028,23,1,4,1,3,0,1,1,2,1,4,3,1,3,2,1,3
1692,792270,23,1,4,1,2,0,2,5,6,0,0,0,5,0,2,1,7
1692,790940,40,4,11,2,4,2,7,6,6,2,7,1,2,0,1,0,16
1692,780770,32,7,17,7,12,0,5,1,3,0,2,3,1,4,0,0,15
1692,792305,3,0,1,0,1,0,0,0,0,0,0,0,1,0,0,0,0
1692,792271,8,1,3,1,3,0,0,2,4,0,2,0,1,1,0,0,4
1692,798022,26,3,7,1,2,2,5,0,0,0,1,1,1,2,1,0,8
1692,792269,28,4,5,4,5,0,0,0,0,3,5,3,1,0,1,0,8
1692,786060,8,1,2,1,2,0,0,0,0,0,0,1,2,0,1,0,2
1693,792418,34,4,10,4,10,0,0,4,4,3,6,1,4,0,3,2,12
1693,782654,24,1,4,1,3,0,1,2,2,3,5,1,4,1,1,1,4
1693,796693,28,3,6,0,2,3,4,3,4,0,0,3,2,2,4,0,12
1693,796691,22,2,7,2,4,0,3,2,2,0,0,1,1,2,2,0,6
1693,789484,37,3,11,3,6,0,5,1,2,1,7,1,4,0,4,0,7
1693,792421,30,5,9,2,4,3,5,2,4,0,3,1,2,2,0,0,15
1693,792419,13,0,2,0,1,0,1,0,1,0,1,1,0,0,0,1,0
1693,792424,6,0,0,0,0,0,0,0,0,0,0,0,2,0,0,0,0
1693,796692,1,0,0,0,0,0,0,0,0,0,0,0,0,0,1,0,0
1693,792423,4,0,0,0,0,0,0,0,0,0,0,0,0,0,1,0,0
1693,796694,1,0,0,0,0,0,0,0,0,0,0,0,0,0,0,0,0
1694,786805,19,6,8,5,6,1,2,3,5,4,4,1,1,0,0,0,16
1694,774936,14,4,5,4,5,0,0,0,0,1,2,1,0,0,2,0,8
1694,790932,15,4,7,3,3,1,4,3,6,0,1,3,4,2,0,0,12
1694,781345,21,1,2,1,1,0,1,0,0,1,2,2,2,0,1,0,2
1694,786803,21,3,7,1,3,2,4,2,2,0,1,3,1,2,1,0,10
1694,796490,9,1,4,1,4,0,0,0,0,2,3,0,3,0,0,0,2
1694,796488,12,1,4,1,3,0,1,2,4,2,1,1,2,1,0,0,4
1694,790934,11,0,0,0,0,0,0,0,2,0,2,2,3,2,0,1,0
1694,786804,15,2,9,1,4,1,5,2,2,2,1,1,0,1,1,1,7
1694,796489,2,0,0,0,0,0,0,0,0,0,0,0,0,0,0,0,0
1694,796487,16,4,8,2,2,2,6,0,0,1,2,1,1,3,1,0,10
1694,790931,16,2,5,2,4,0,1,1,1,0,3,1,1,0,1,0,5
1694,790933,15,2,5,1,3,1,2,0,0,0,3,2,0,2,1,0,5
1694,780033,9,1,4,1,2,0,2,0,0,1,1,2,1,0,1,0,2
1694,780030,5,0,3,0,0,0,3,0,0,1,0,0,0,1,1,0,0
1696,790856,27,6,7,6,7,0,0,7,10,5,6,0,2,1,1,1,19
1696,780452,23,1,3,1,3,0,0,3,4,3,1,1,2,0,1,0,5
1696,796409,33,2,10,2,5,0,5,2,2,0,1,3,2,0,3,0,6
1696,796408,32,4,9,4,7,0,2,4,5,0,3,4,3,3,6,1,12
1696,796407,23,1,3,1,1,0,2,1,2,1,6,1,2,1,2,1,3
1696,796411,8,1,2,1,1,0,1,3,3,0,1,0,2,0,3,1,5
1696,796410,22,4,8,4,8,0,0,4,4,1,5,2,1,1,0,2,12
1696,780450,15,4,6,2,3,2,3,1,1,0,0,1,1,1,1,0,11
1696,796413,11,0,1,0,0,0,1,0,0,0,1,1,0,0,1,0,0
1696,796412,6,0,1,0,0,0,1,0,0,0,0,0,0,0,0,0,0
1697,798153,5,0,0,0,0,0,0,0,0,0,1,0,3,0,0,0,0
1697,789025,27,4,8,3,7,1,1,2,2,2,2,1,4,2,2,1,11
1697,782157,17,0,4,0,4,0,0,0,0,0,2,4,0,2,2,0,0
1697,780193,18,4,6,2,2,2,4,0,0,0,1,0,5,0,4,0,10
1697,774985,33,9,18,8,15,1,3,0,0,0,5,2,3,3,3,0,19
1697,781149,25,4,7,2,3,2,4,3,4,0,2,4,4,1,0,0,13
1697,792669,22,2,3,2,3,0,0,2,2,1,1,3,1,2,2,0,6
1697,786163,19,1,5,1,3,0,2,0,0,0,0,0,0,0,0,0,2
1697,775276,15,0,3,0,2,0,1,0,0,0,2,0,1,0,0,0,0
1697,792666,5,1,1,0,0,1,1,0,0,0,1,0,2,0,0,0,3
1697,792670,13,1,3,0,0,1,3,0,0,0,1,0,0,0,0,0,3
1697,798152,1,0,0,0,0,0,0,0,0,0,0,0,0,0,0,0,0
1698,786029,16,3,5,3,5,0,0,4,4,0,2,0,3,0,3,0,10
1698,797744,6,0,0,0,0,0,0,0,0,0,1,2,1,0,2,0,0
1698,792114,35,6,13,3,5,3,8,4,5,1,1,2,0,1,0,0,19
1698,786018,32,3,11,2,4,1,7,0,0,0,1,0,2,3,1,0,7
1698,775678,32,4,8,4,5,0,3,6,9,0,4,2,2,1,4,0,14
1698,786022,14,0,3,0,2,0,1,0,0,0,0,1,2,0,0,0,0
1698,797746,13,1,2,1,2,0,0,0,0,0,1,0,3,1,0,1,2
1698,781398,27,3,10,2,4,1,6,2,2,1,5,1,2,0,1,2,9
1698,797740,14,0,3,0,3,0,0,1,2,1,4,0,2,0,0,0,1
1698,797737,5,0,0,0,0,0,0,0,0,0,2,2,0,0,0,0,0
1698,792112,6,1,3,1,2,0,1,0,0,3,2,0,0,1,0,0,2
1699,796442,12,0,0,0,0,0,0,0,0,0,0,0,3,0,1,0,0
1699,796436,35,4,11,2,7,2,4,0,0,0,6,3,0,1,4,1,10
1699,785436,36,5,11,5,9,0,2,4,4,5,3,3,2,0,1,0,14
1699,781262,13,1,5,1,2,0,3,0,0,0,2,1,3,0,1,0,2
1699,791635,23,2,10,1,3,1,7,1,2,1,6,1,1,2,0,0,6
1699,796439,16,2,3,2,3,0,0,4,7,2,1,1,1,1,2,0,8
1699,796438,27,5,11,3,5,2,6,1,2,0,2,1,2,1,2,1,13
1699,790883,10,3,4,2,3,1,1,0,1,0,2,0,3,1,1,0,7
1699,790885,13,1,3,0,0,1,3,0,0,1,3,0,1,0,2,0,3
1699,790884,15,2,2,2,2,0,0,0,0,2,1,1,2,0,1,1,4
1700,780107,48,6,8,5,7,1,1,2,2,1,6,3,1,0,2,0,15
1700,775833,28,2,3,2,2,0,1,2,5,1,5,0,3,2,1,1,6
1700,781036,50,8,18,5,10,3,8,4,6,0,2,4,1,0,6,0,23
1700,775571,38,6,9,6,7,0,2,3,4,0,2,4,5,2,4,0,15
1700,774894,48,5,12,2,4,3,8,8,9,0,4,5,1,0,2,2,21
1700,791178,10,1,3,1,3,0,0,0,0,1,2,0,1,0,2,0,2
1700,796846,28,1,2,0,0,1,2,0,0,0,3,2,4,1,0,1,3
1701,785999,32,5,10,5,10,0,0,3,7,4,3,0,5,0,3,0,13
1701,775654,31,1,3,1,3,0,0,0,0,2,5,0,5,1,1,0,2
1701,791639,43,10,23,10,18,0,5,0,0,1,2,7,3,2,2,1,20
1701,796398,36,2,5,2,4,0,1,1,4,2,0,1,5,2,0,1,5
1701,785389,47,13,22,10,17,3,5,3,5,0,2,2,0,0,3,0,32
1701,785255,26,1,7,1,5,0,2,0,4,4,3,0,1,1,2,0,2
1701,796399,18,0,0,0,0,0,0,2,2,0,1,3,1,1,3,0,2
1701,791640,11,2,5,0,1,2,4,0,0,1,0,0,1,1,0,0,6
1701,775171,6,0,0,0,0,0,0,0,0,0,0,0,0,0,0,0,0
1702,781454,26,5,9,5,8,0,1,2,4,1,4,0,5,0,2,0,12
1702,786424,35,8,12,8,12,0,0,11,16,10,10,3,1,0,2,2,27
1702,797979,20,0,0,0,0,0,0,0,0,0,2,3,4,1,1,0,0
1702,792279,35,8,15,6,9,2,6,1,1,1,3,5,3,0,1,1,19
1702,785483,39,8,18,6,14,2,4,5,6,1,4,8,2,1,2,0,23
1702,797991,5,0,0,0,0,0,0,0,0,1,1,0,2,0,1,0,0
1702,785959,5,1,2,1,2,0,0,0,1,1,2,0,2,0,0,1,2
1702,797988,8,1,4,1,3,0,1,0,0,0,0,0,1,1,1,1,2
1702,791015,25,1,2,0,0,1,2,0,0,0,1,4,1,0,1,0,3
1702,775335,2,0,2,0,0,0,2,0,0,0,0,0,1,0,0,0,0
1703,797698,7,1,1,1,1,0,0,0,0,0,1,0,3,0,0,0,2
1703,780844,24,2,4,0,0,2,4,0,0,0,1,0,4,1,0,0,6
1703,797699,26,3,11,1,7,2,4,4,5,0,3,4,4,1,2,0,12
1703,791956,30,1,3,0,1,1,2,5,6,1,3,2,3,0,2,0,8
1703,780846,34,12,23,11,19,1,4,5,8,3,4,8,3,2,3,0,30
1703,797696,16,3,3,3,3,0,0,0,1,1,2,0,4,0,1,0,6
1703,782128,2,0,0,0,0,0,0,0,0,0,0,0,0,0,0,0,0
1703,797694,33,6,9,0,1,6,8,3,4,0,3,0,1,2,0,1,21
1703,797692,14,1,4,0,1,1,3,0,0,0,2,0,3,0,1,0,3
1703,791954,14,1,2,1,2,0,0,3,3,0,0,3,1,1,0,0,5
1704,783269,36,11,19,8,9,3,10,2,4,2,3,0,3,0,1,0,27
1704,787524,24,1,4,1,3,0,1,5,8,3,3,2,4,2,2,0,7
1704,791774,12,3,3,2,2,1,1,0,0,0,3,0,2,0,1,3,7
1704,791722,38,1,5,1,4,0,1,0,0,3,2,1,2,0,0,0,2
1704,781019,44,7,13,7,13,0,0,6,9,4,5,16,4,0,6,0,20
1704,775541,2,0,1,0,1,0,0,0,0,0,0,0,0,0,0,0,0
1704,797611,12,3,5,1,2,2,3,0,0,1,2,0,1,0,0,0,8
1704,787522,15,3,5,3,5,0,0,3,5,1,2,0,5,0,0,1,9
1704,780017,8,0,2,0,2,0,0,0,0,0,1,1,1,0,2,0,0
1704,776790,1,0,0,0,0,0,0,0,0,0,0,0,1,0,0,0,0
1704,775961,33,6,15,1,5,5,10,1,4,0,0,0,4,1,0,0,18
1705,792140,30,10,12,10,12,0,0,2,6,7,7,4,4,0,3,3,22
1705,792144,34,7,10,5,6,2,4,3,5,0,4,4,5,1,2,0,19
1705,792148,35,5,14,4,8,1,6,0,1,0,4,4,5,2,3,0,11
1705,781429,43,7,10,0,1,7,9,2,2,0,2,0,2,0,1,0,23
1705,776092,39,6,10,5,7,1,3,7,10,2,2,6,3,2,1,0,20
1705,797791,2,0,0,0,0,0,0,0,0,0,0,0,1,0,0,0,0
1705,792146,13,1,1,1,1,0,0,0,0,0,5,0,3,0,3,0,2
1705,797786,18,0,4,0,3,0,1,0,0,0,0,0,3,0,2,0,0
1705,797789,7,1,2,1,1,0,1,0,0,0,0,0,0,0,1,0,2
1705,781431,4,2,4,2,3,0,1,1,2,2,1,0,0,0,1,0,5
1706,791053,26,4,7,4,7,0,0,3,6,1,3,2,3,1,5,0,11
1706,780739,21,3,4,3,4,0,0,0,0,0,5,0,4,2,1,1,6
1706,785524,27,3,7,3,4,0,3,2,4,4,4,2,1,2,0,0,8
1706,781115,31,5,8,5,8,0,0,4,4,1,2,2,0,1,0,0,14
1706,775094,14,4,9,3,5,1,4,2,2,2,1,0,2,0,1,0,11
1706,796731,12,2,3,2,3,0,0,2,2,3,0,1,2,1,0,0,6
1706,796730,14,2,4,2,2,0,2,2,3,1,1,0,0,1,0,0,6
1706,785784,1,0,0,0,0,0,0,0,0,0,0,0,0,0,0,0,0
1706,791051,13,2,5,2,5,0,0,1,3,3,3,0,4,1,4,2,5
1706,791052,1,0,0,0,0,0,0,1,2,0,0,0,0,0,0,0,1
1706,786310,17,0,1,0,1,0,0,2,2,0,0,1,1,1,1,0,2
1706,775456,23,3,7,3,7,0,0,0,0,0,2,3,3,2,0,0,6
1707,781650,14,2,3,2,3,0,0,4,4,0,3,0,5,0,1,0,8
1707,797070,28,4,5,0,1,4,4,1,1,0,2,1,1,0,2,0,13
1707,776079,13,1,3,0,0,1,3,0,2,0,1,2,2,0,3,0,3
1707,791432,32,4,9,1,4,3,5,0,1,0,2,2,2,1,3,0,11
1707,777865,18,0,3,0,2,0,1,0,0,1,0,3,2,0,5,0,0
1707,797066,18,1,2,1,2,0,0,2,2,1,3,0,4,0,2,0,4
1707,780180,21,1,3,0,1,1,2,0,0,2,2,1,2,0,2,0,3
1707,797067,9,1,1,1,1,0,0,3,6,0,1,1,0,0,0,0,5
1707,797068,23,2,6,1,3,1,3,1,1,0,1,3,3,1,2,0,6
1707,791429,24,5,9,2,4,3,5,0,0,0,1,2,1,1,0,0,13
1708,796759,21,3,7,3,6,0,1,0,0,2,1,0,5,0,0,1,6
1708,796758,30,5,8,5,8,0,0,0,0,3,5,1,4,0,6,0,10
1708,791101,36,3,6,2,3,1,3,14,17,3,4,4,1,0,1,0,21
1708,791105,31,7,14,2,8,5,6,8,10,1,4,4,1,1,1,0,27
1708,780794,26,2,4,1,2,1,2,0,0,0,4,3,1,2,2,0,5
1708,796761,10,1,4,1,4,0,0,0,0,0,0,0,5,0,2,1,2
1708,780109,19,2,5,1,3,1,2,0,2,0,3,0,4,0,1,0,5
1708,796757,18,3,4,2,3,1,1,1,1,0,2,1,1,1,1,0,8
1708,785597,9,0,2,0,2,0,0,0,0,0,0,1,1,1,2,0,0
1709,792373,30,4,10,4,10,0,0,4,5,4,2,2,1,1,2,3,12
1709,792370,38,8,13,7,10,1,3,3,4,2,3,3,4,1,0,1,20
1709,797960,21,3,8,1,1,2,7,6,6,2,3,0,4,2,1,0,14
1709,786739,23,3,9,3,6,0,3,2,2,0,2,3,3,0,2,0,8
1709,775303,13,2,3,0,0,2,3,0,0,0,1,0,3,1,2,0,6
1709,797958,9,2,3,1,1,1,2,3,4,1,1,0,2,0,1,0,8
1709,797951,17,2,7,2,4,0,3,0,0,2,1,0,0,0,2,0,4
1709,792368,2,0,1,0,0,0,1,0,0,0,0,0,0,0,0,0,0
1709,790499,9,0,2,0,1,0,1,2,3,1,0,1,0,1,2,0,2
1709,781597,11,0,0,0,0,0,0,0,0,0,0,0,1,0,0,0,0
1709,775809,27,2,5,1,3,1,2,0,0,0,3,2,2,1,1,0,5
1710,791881,36,4,9,3,5,1,4,4,4,1,4,3,2,0,4,1,13
1710,781052,34,1,4,0,0,1,4,2,2,0,3,2,2,3,3,0,5
1710,786420,34,8,14,6,10,2,4,0,0,0,3,5,3,0,3,0,18
1710,797616,27,6,9,5,8,1,1,4,6,2,3,0,5,1,4,3,17
1710,786491,32,7,9,6,8,1,1,4,4,2,5,2,1,1,0,2,19
1710,797613,3,0,2,0,1,0,1,0,0,1,0,0,0,0,0,0,0
1710,781258,19,0,3,0,1,0,2,0,1,1,3,0,2,1,0,0,0
1710,797618,15,3,6,3,6,0,0,2,5,4,1,0,3,0,0,1,8
1711,785977,32,3,11,2,6,1,5,4,4,3,3,1,0,2,1,0,11
1711,791265,34,9,13,4,5,5,8,0,0,0,1,3,4,3,2,0,23
1711,791271,21,2,6,2,6,0,0,0,1,2,2,1,1,1,2,0,4
1711,796525,22,4,11,2,5,2,6,4,5,1,1,1,1,0,0,0,14
1711,785685,34,5,13,5,12,0,1,2,3,1,4,7,4,1,7,0,12
1711,791266,20,4,5,4,5,0,0,2,2,4,7,0,3,2,0,3,10
1711,791270,3,0,0,0,0,0,0,0,0,0,0,0,1,0,1,0,0
1711,796523,5,0,0,0,0,0,0,0,0,0,0,1,2,0,0,0,0
1711,796522,10,1,3,0,0,1,3,0,0,0,0,1,2,1,0,0,3
1711,781313,19,0,5,0,2,0,3,0,0,1,0,1,1,1,0,0,0
1712,791923,24,4,9,4,9,0,0,1,1,4,5,1,0,1,0,0,9
1712,781122,21,6,11,6,11,0,0,0,0,3,6,1,2,3,2,0,12
1712,791926,20,3,9,0,0,3,9,0,0,0,1,2,1,1,1,0,9
1712,786527,21,2,6,2,3,0,3,0,1,3,3,1,0,0,2,0,4
1712,781112,15,0,2,0,2,0,0,0,0,1,4,6,2,2,2,0,0
1712,791922,19,4,8,2,4,2,4,3,6,3,6,2,3,0,2,1,13
1712,797541,17,2,6,2,6,0,0,0,1,1,6,0,2,0,1,1,4
1712,797543,9,2,4,0,1,2,3,0,0,0,1,0,0,0,0,0,6
1712,797542,20,6,8,3,3,3,5,3,4,0,1,1,3,1,3,0,18
1712,786858,16,1,5,1,3,0,2,0,0,0,3,1,2,0,0,0,2
1712,778952,18,0,1,0,1,0,0,0,0,0,1,6,2,0,0,0,0
1714,785432,21,7,10,7,9,0,1,0,0,2,6,1,1,0,0,3,14
1714,779985,21,4,9,2,4,2,5,0,0,0,3,0,1,0,0,0,10
1714,790882,22,4,9,4,8,0,1,2,2,2,3,2,1,2,1,0,10
1714,790876,22,3,8,1,4,2,4,2,2,1,5,1,1,1,2,0,10
1714,774987,29,4,6,3,4,1,2,3,3,0,1,8,0,0,1,0,12
1714,790877,16,2,4,2,4,0,0,2,2,1,3,2,3,1,0,0,6
1714,790875,8,1,4,1,1,0,3,0,0,0,1,0,0,0,0,0,2
1714,790879,11,1,1,1,1,0,0,3,5,0,2,0,1,1,0,0,5
1714,790878,9,0,1,0,1,0,0,2,4,3,3,0,1,0,0,1,2
1714,796434,15,1,2,0,0,1,2,2,2,0,0,0,1,1,0,1,5
1714,781062,17,3,9,0,2,3,7,0,0,0,2,1,2,1,1,0,9
1714,779987,3,0,0,0,0,0,0,0,0,0,1,0,0,0,0,0,0
1714,790874,3,0,1,0,1,0,0,0,0,0,0,0,0,0,0,0,0
1714,790881,3,0,1,0,1,0,0,0,0,0,0,1,0,1,0,0,0
1715,781656,18,3,8,3,8,0,0,0,0,1,3,1,1,0,2,2,6
1715,781658,32,2,6,2,5,0,1,3,4,5,6,0,2,0,4,0,7
1715,791264,14,0,4,0,3,0,1,0,0,2,1,0,1,0,1,0,0
1715,786798,34,6,14,6,14,0,0,3,4,0,2,3,1,0,2,0,15
1715,780129,35,0,8,0,6,0,2,2,4,0,2,2,3,1,2,0,2
1715,798206,21,6,12,2,4,4,8,0,0,3,6,1,2,1,0,0,16
1715,791263,7,1,4,1,4,0,0,0,0,0,1,0,3,0,3,0,2
1715,796967,17,2,5,0,1,2,4,0,0,0,1,1,0,1,1,0,6
1715,796961,18,0,1,0,1,0,0,0,0,0,0,0,0,1,0,0,0
1715,790256,2,0,1,0,1,0,0,0,0,0,0,0,0,0,0,0,0
1715,796966,2,0,0,0,0,0,0,0,0,0,1,0,0,0,0,0,0
1716,791511,25,1,1,1,1,0,0,1,4,0,3,0,4,0,2,1,3
1716,786637,35,9,13,5,8,4,5,6,6,0,2,1,2,2,2,0,28
1716,797150,25,1,5,0,1,1,4,0,0,0,2,0,3,2,3,0,3
1716,791513,14,0,0,0,0,0,0,3,5,0,2,1,2,1,2,0,3
1716,778442,37,3,10,0,2,3,8,2,4,0,6,3,4,0,1,0,11
1716,791514,3,0,0,0,0,0,0,0,0,0,0,0,0,0,2,0,0
1716,780946,35,6,8,3,5,3,3,1,2,0,4,7,2,2,3,0,16
1716,797149,8,0,0,0,0,0,0,0,0,0,2,0,0,0,1,0,0
1716,797151,15,0,1,0,1,0,0,0,0,0,1,0,2,1,2,0,0
1716,797152,3,0,0,0,0,0,0,2,2,1,1,0,0,0,0,0,2
1717,792152,31,4,8,3,6,1,2,3,4,0,2,1,2,2,1,0,12
1717,792154,32,4,11,4,7,0,4,3,4,1,2,4,2,2,5,0,11
1717,780581,32,4,6,0,0,4,6,2,2,0,1,0,3,2,3,0,14
1717,792158,26,2,4,1,3,1,1,3,4,1,3,1,3,1,3,0,8
1717,780138,29,0,3,0,3,0,0,2,8,2,3,2,2,2,4,0,2
1717,797756,5,1,1,1,1,0,0,0,0,0,1,0,2,0,0,0,2
1717,786014,17,0,6,0,2,0,4,0,0,0,4,2,1,0,0,0,0
1717,792157,20,2,2,2,2,0,0,0,0,1,2,0,2,0,0,0,4
1717,792159,2,1,2,1,2,0,0,0,1,0,0,0,2,0,0,0,2
1717,797755,6,0,1,0,1,0,0,0,0,0,0,1,0,0,0,0,0
1718,797883,24,4,5,4,5,0,0,1,2,0,1,2,1,1,0,0,9
1718,792376,30,4,14,1,5,3,9,4,4,0,4,2,1,6,2,0,15
1718,786746,27,3,6,2,3,1,3,4,6,2,6,2,2,2,1,0,11
1718,775075,26,3,8,3,6,0,2,0,0,2,3,0,1,0,1,2,6
1718,780178,12,1,3,1,3,0,0,0,0,1,2,0,4,0,4,0,2
1718,797890,16,2,5,1,2,1,3,1,2,0,1,0,1,0,1,0,6
1718,797888,14,3,3,2,2,1,1,3,4,1,4,0,1,0,3,1,10
1718,792374,19,3,4,2,2,1,2,0,0,0,3,1,2,1,3,0,7
1718,792378,15,1,1,1,1,0,0,5,6,2,3,1,4,0,0,3,7
1718,797885,10,1,4,1,3,0,1,2,3,1,1,0,0,0,0,0,4
1718,785744,7,0,0,0,0,0,0,0,0,0,1,1,1,0,0,0,0
1719,792015,31,2,10,2,8,0,2,6,6,1,4,4,2,0,4,0,10
1719,775995,34,1,4,1,3,0,1,0,0,0,1,1,4,0,5,0,2
1719,792019,19,0,2,0,1,0,1,0,0,0,2,0,5,0,1,0,0
1719,786542,34,5,11,3,5,2,6,0,3,0,2,0,2,1,2,0,12
1719,786540,24,5,10,5,10,0,0,2,3,1,3,0,1,2,2,2,12
1719,792016,18,1,5,1,4,0,1,0,0,0,1,1,1,1,1,0,2
1719,781147,7,0,1,0,0,0,1,0,0,0,0,0,0,1,1,0,0
1719,785364,16,6,7,6,7,0,0,0,2,3,5,1,2,1,1,0,12
1719,797515,17,1,4,0,1,1,3,1,2,0,2,0,4,1,0,0,4
1720,796699,18,3,7,2,5,1,2,0,1,0,3,0,2,0,2,0,7
1720,790983,26,3,8,3,6,0,2,0,0,1,2,8,4,0,1,2,6
1720,790978,20,2,7,2,3,0,4,0,1,1,0,0,2,0,1,0,4
1720,790979,32,5,10,4,5,1,5,5,8,1,3,1,0,1,0,0,16
1720,796700,33,9,13,5,7,4,6,4,6,1,7,2,0,1,5,0,26
1720,790980,4,1,2,1,2,0,0,0,0,2,2,0,1,0,0,0,2
1720,796698,7,1,2,1,1,0,1,0,0,1,0,0,1,0,0,0,2
1720,796701,14,1,2,1,2,0,0,0,2,4,1,0,2,0,1,0,2
1720,790976,16,1,2,1,1,0,1,2,2,1,1,0,2,2,1,1,4
1720,790981,8,1,3,1,2,0,1,2,2,0,1,0,1,0,5,0,4
1720,788820,22,0,4,0,2,0,2,1,4,0,3,1,2,0,1,0,1
1721,790833,34,7,14,5,11,2,3,0,4,2,5,2,4,3,3,1,16
1721,796390,21,4,11,4,11,0,0,1,3,10,4,1,0,0,2,0,9
1721,785451,35,3,9,0,1,3,8,0,0,0,1,5,3,1,0,0,9
1721,790830,19,2,4,2,4,0,0,3,6,0,3,3,3,3,2,0,7
1721,790834,18,1,7,1,4,0,3,0,0,3,5,2,3,1,3,0,2
1721,780297,4,1,1,1,1,0,0,0,0,0,0,0,1,0,0,0,2
1721,790831,14,1,3,1,3,0,0,0,0,3,1,0,4,1,2,0,2
1721,790832,27,3,10,2,6,1,4,3,4,0,1,0,2,1,3,0,10
1721,785379,8,2,5,2,2,0,3,0,0,2,1,0,1,0,1,0,4
1721,785377,20,3,7,3,7,0,0,4,6,3,2,1,4,2,2,0,10
1722,785126,18,3,8,2,6,1,2,0,0,1,3,0,1,0,0,0,7
1722,779857,18,3,7,3,6,0,1,1,1,1,3,1,1,0,0,2,7
1722,785339,26,6,8,5,5,1,3,4,4,1,3,2,0,0,1,0,17
1722,779976,33,2,4,1,2,1,2,0,0,0,3,8,1,1,4,0,5
1722,774990,17,2,3,1,1,1,2,0,0,0,2,5,5,2,3,0,5
1722,796673,1,0,1,0,1,0,0,0,0,0,0,0,1,0,0,0,0
1722,796674,22,2,4,1,2,1,2,3,4,1,9,0,3,0,5,0,8
1722,781586,20,7,7,7,7,0,0,1,1,3,4,1,0,0,0,0,15
1722,785961,27,6,11,2,3,4,8,0,0,1,5,2,2,0,2,0,16
1722,791014,18,0,3,0,0,0,3,2,2,0,4,2,3,0,0,0,2
1723,792351,26,3,7,1,2,2,5,1,2,2,4,0,4,2,2,0,9
1723,786723,38,4,12,4,12,0,0,3,5,1,1,5,2,3,1,0,11
1723,792349,19,2,5,2,5,0,0,0,0,3,5,1,1,1,1,0,4
1723,792355,33,7,15,3,7,4,8,1,2,3,2,2,0,1,1,0,19
1723,792352,32,2,10,1,5,1,5,2,3,0,0,2,5,3,1,0,7
1723,786724,24,5,10,3,4,2,6,0,0,1,1,1,1,1,0,0,12
1723,798061,6,0,2,0,0,0,2,0,0,0,0,0,0,0,0,0,0
1723,798060,12,0,3,0,2,0,1,0,0,0,1,0,1,0,3,0,0
1723,792348,8,1,2,1,1,0,1,0,0,0,0,0,0,0,0,0,2
1723,786726,2,0,0,0,0,0,0,0,0,0,1,0,1,0,0,0,0
1724,775823,24,7,8,7,7,0,1,8,8,0,3,2,3,1,2,0,22
1724,791041,31,5,7,2,3,3,4,5,6,1,6,4,3,0,1,0,18
1724,791038,24,1,6,1,2,0,4,2,2,1,1,2,5,0,1,1,4
1724,774806,22,5,8,5,7,0,1,2,2,1,8,0,1,2,1,0,12
1724,789023,30,6,9,3,4,3,5,4,5,1,4,8,0,1,0,0,19
1724,775205,17,4,5,0,0,4,5,0,0,0,0,3,3,0,0,0,12
1724,791346,6,3,3,1,1,2,2,2,2,1,1,1,0,0,0,0,10
1724,785922,16,0,0,0,0,0,0,0,1,1,3,0,3,1,1,0,0
1724,796711,4,0,0,0,0,0,0,0,0,0,0,1,0,0,0,0,0
1724,796712,4,0,3,0,0,0,3,0,0,0,1,0,1,0,1,0,0
1724,796714,10,1,3,1,3,0,0,1,2,0,3,0,0,0,0,0,3
1724,786689,4,1,1,1,1,0,0,0,0,0,0,0,0,0,0,0,2
1724,796716,8,3,6,2,5,1,1,1,2,4,4,1,3,1,0,0,8
1726,786575,17,1,4,1,4,0,0,4,4,2,8,0,3,0,1,0,6
1726,792334,27,2,9,2,6,0,3,0,1,4,3,1,3,2,5,0,4
1726,798094,28,1,5,0,3,1,2,0,0,0,0,0,3,1,1,0,3
1726,792338,28,5,10,5,8,0,2,1,3,0,3,2,2,3,1,1,11
1726,781666,38,8,22,4,10,4,12,5,5,0,5,1,1,0,3,0,25
1726,798097,21,4,4,4,4,0,0,1,2,2,6,0,1,0,1,0,9
1726,785531,13,0,4,0,2,0,2,0,0,1,2,1,2,0,0,1,0
1726,798095,2,0,0,0,0,0,0,0,0,0,0,0,0,0,0,0,0
1726,798100,5,0,0,0,0,0,0,0,0,0,0,0,2,0,1,0,0
1726,791636,21,1,6,0,2,1,4,0,0,1,8,2,1,0,4,0,3
1727,797139,22,3,7,3,7,0,0,7,9,1,3,2,5,0,4,0,13
1727,775394,25,0,3,0,2,0,1,1,2,0,2,2,0,1,1,2,1
1727,791526,32,1,4,1,2,0,2,0,1,0,3,3,1,0,3,0,2
1727,780272,33,3,10,1,4,2,6,4,4,0,2,2,1,3,0,0,12
1727,775592,27,4,9,1,5,3,4,0,0,0,6,1,3,1,2,0,11
1727,791524,25,5,12,4,8,1,4,0,1,2,4,0,1,1,2,0,11
1727,785970,9,2,4,2,4,0,0,0,0,0,3,0,1,0,2,0,4
1727,797136,15,1,5,1,2,0,3,0,0,0,1,0,3,0,0,0,2
1727,780273,12,0,2,0,0,0,2,0,0,0,2,0,0,0,0,0,0
1728,785642,8,0,0,0,0,0,0,0,0,0,1,0,4,1,2,0,0
1728,791067,35,2,6,2,4,0,2,3,5,1,3,4,2,0,3,0,7
1728,791066,30,8,15,4,7,4,8,1,2,1,1,0,2,5,1,0,21
1728,791068,29,2,5,1,3,1,2,4,4,0,3,1,2,0,1,1,9
1728,785551,35,1,8,0,4,1,4,1,2,1,3,2,4,1,3,0,4
1728,780512,33,3,9,3,8,0,1,5,8,5,8,1,1,0,4,0,11
1728,796745,4,0,1,0,0,0,1,0,0,0,0,0,0,0,1,0,0
1728,796744,11,0,4,0,1,0,3,0,0,0,0,0,1,1,2,0,0
1728,796743,15,0,6,0,2,0,4,0,0,1,1,2,3,1,0,0,0
1729,791564,30,3,7,2,4,1,3,0,0,3,3,0,3,1,1,1,7
1729,775549,23,5,11,5,11,0,0,0,0,2,5,1,5,1,1,1,10
1729,797056,28,1,5,1,2,0,3,5,6,0,2,0,2,0,4,1,7
1729,797054,21,1,6,1,4,0,2,4,4,0,2,3,1,1,5,0,6
1729,786380,8,1,3,1,3,0,0,0,2,1,2,1,0,2,0,0,2
1729,797058,9,0,1,0,0,0,1,0,0,0,1,0,0,0,1,0,0
1729,780425,17,1,1,1,1,0,0,0,0,3,1,0,3,1,2,0,2
1729,791568,13,2,3,1,1,1,2,0,0,0,4,0,2,2,2,1,5
1729,797055,27,4,9,3,6,1,3,1,2,0,1,1,0,1,4,0,10
1729,786381,24,1,3,1,1,0,2,5,6,2,5,1,3,0,0,0,7
1730,796955,19,4,7,4,7,0,0,1,1,4,0,0,2,0,2,2,9
1730,796954,37,3,9,2,5,1,4,3,6,2,5,2,2,3,3,0,10
1730,781606,35,3,5,2,2,1,3,7,10,0,3,3,2,0,1,0,14
1730,781263,33,3,14,2,8,1,6,0,0,0,5,1,1,3,2,1,7
1730,781257,38,2,5,0,1,2,4,4,4,0,5,2,0,1,1,0,10
1730,791255,10,0,1,0,1,0,0,0,0,0,1,2,1,0,0,1,0
1730,791257,21,5,8,5,8,0,0,1,2,4,6,1,5,0,2,1,11
1730,780900,7,3,5,3,4,0,1,0,0,1,0,1,3,0,2,0,6
1731,797163,22,4,8,4,8,0,0,1,3,5,3,0,5,0,1,0,9
1731,791385,19,3,6,2,4,1,2,0,0,1,4,1,5,0,0,0,7
1731,786450,25,1,3,1,3,0,0,0,0,1,3,3,3,3,3,0,2
1731,776396,36,2,9,1,5,1,4,4,6,0,2,2,1,1,3,0,9
1731,776199,24,2,11,2,10,0,1,2,2,0,1,1,4,0,3,0,6
1731,797162,9,0,1,0,1,0,0,2,2,0,2,1,1,0,1,0,2
1731,797164,30,0,2,0,1,0,1,1,2,1,4,0,0,1,3,1,1
1731,797161,9,0,4,0,1,0,3,0,0,1,1,0,1,1,2,0,0
1731,797165,23,5,10,4,7,1,3,3,3,0,0,0,1,0,1,0,14
1731,791386,3,1,1,1,1,0,0,0,0,0,0,0,0,0,0,0,2
1732,796996,8,2,3,2,3,0,0,0,0,0,0,0,3,0,0,0,4
1732,791610,23,4,8,4,8,0,0,2,2,2,3,2,4,1,1,0,10
1732,796994,29,2,7,1,2,1,5,1,2,0,1,8,2,3,4,0,6
1732,791608,30,6,15,1,2,5,13,0,0,0,5,5,2,2,1,0,17
1732,776011,21,2,5,2,5,0,0,0,0,0,7,4,3,1,4,0,4
1732,786413,11,1,2,1,2,0,0,1,1,1,2,0,2,0,0,0,3
1732,780471,24,5,5,5,5,0,0,5,9,4,9,1,4,0,3,0,15
1732,791613,19,8,9,8,8,0,1,2,4,0,3,1,2,1,1,0,18
1732,791611,6,2,3,2,3,0,0,1,2,0,0,0,0,3,1,0,5
1732,786353,17,4,5,2,3,2,2,0,0,1,1,0,2,1,0,0,10
1732,785680,10,2,5,2,4,0,1,0,0,0,0,1,2,2,0,0,4
1732,780417,2,0,0,0,0,0,0,0,0,0,1,0,1,0,2,0,0
1734,790863,22,5,8,3,3,2,5,0,2,1,7,0,3,0,3,0,12
1734,780021,18,0,2,0,2,0,0,3,4,0,2,0,5,1,4,0,3
1734,785412,31,6,13,5,9,1,4,4,5,0,2,5,1,0,1,0,17
1734,780099,22,1,6,0,2,1,4,2,2,0,2,0,5,0,3,0,5
1734,776214,39,5,11,4,6,1,5,7,8,1,2,3,3,2,4,0,18
1734,785413,24,6,8,6,8,0,0,2,2,1,4,0,1,0,0,0,14
1734,796420,3,0,0,0,0,0,0,0,0,0,0,0,1,0,1,0,0
1734,775686,25,1,2,1,1,0,1,6,6,2,5,0,4,1,1,2,8
1734,785411,1,0,0,0,0,0,0,0,0,0,0,0,1,0,0,0,0
1734,785417,6,0,0,0,0,0,0,2,2,2,0,0,1,0,1,0,2
1734,776221,9,1,3,1,1,0,2,0,0,0,0,1,2,0,0,0,2
1735,791416,31,8,10,8,10,0,0,3,6,2,4,0,4,1,2,1,19
1735,797096,23,1,6,1,3,0,3,0,0,0,1,1,4,2,1,0,2
1735,785906,38,13,20,12,17,1,3,9,12,0,5,1,4,1,6,1,36
1735,780100,27,1,3,0,0,1,3,0,0,0,2,2,1,1,0,0,3
1735,780096,32,1,3,0,1,1,2,1,2,0,1,1,4,1,0,0,4
1735,797093,27,5,10,5,9,0,1,4,8,0,4,4,4,3,2,0,14
1735,785907,13,0,1,0,1,0,0,0,0,0,1,0,4,0,2,0,0
1735,797094,4,0,0,0,0,0,0,0,0,0,0,1,0,0,0,0,0
1735,781614,5,0,2,0,1,0,1,0,0,0,0,0,0,0,0,0,0
1736,776110,23,1,4,0,1,1,3,0,0,0,2,1,1,5,0,1,3
1736,780059,30,3,9,3,7,0,2,11,12,0,4,2,3,3,2,0,17
1736,790944,27,2,8,2,5,0,3,1,2,1,0,1,2,2,3,0,5
1736,786754,27,3,10,2,6,1,4,0,0,2,1,2,2,2,3,0,7
1736,780061,32,2,10,1,5,1,5,5,5,0,4,1,4,2,1,0,10
1736,780058,12,2,7,2,4,0,3,1,2,0,5,0,2,1,2,0,5
1736,790941,3,0,0,0,0,0,0,0,0,0,0,0,1,0,0,0,0
1736,796494,23,3,4,3,3,0,1,0,0,0,2,0,1,0,1,0,6
1736,796496,6,0,1,0,1,0,0,0,0,0,1,0,0,1,1,0,0
1736,790943,13,1,3,1,2,0,1,1,1,1,1,1,1,1,2,0,3
1736,796497,4,0,0,0,0,0,0,0,0,0,0,0,0,0,0,0,0
1737,780879,22,3,4,3,4,0,0,0,0,0,5,3,3,0,6,0,6
1737,775785,19,4,9,4,7,0,2,0,0,2,6,1,2,0,1,2,8
1737,790768,31,4,9,3,4,1,5,1,3,2,2,3,1,1,1,1,10
1737,785226,27,2,5,1,2,1,3,0,0,0,5,0,3,1,5,1,5
1737,780875,23,2,5,2,3,0,2,0,2,1,4,2,1,1,3,0,4
1737,796324,18,2,4,1,2,1,2,0,1,2,3,1,2,1,1,2,5
1737,785224,6,3,3,2,2,1,1,2,3,0,1,0,0,0,0,0,9
1737,796326,14,2,4,2,4,0,0,0,0,1,1,0,1,2,1,0,4
1737,790769,16,1,6,1,6,0,0,2,2,0,1,0,0,1,1,1,4
1737,785743,20,4,8,3,4,1,4,0,0,1,0,3,3,1,1,0,9
1737,790767,4,0,0,0,0,0,0,0,0,0,1,0,1,0,0,0,0
1738,780229,34,13,24,13,24,0,0,3,8,6,5,3,2,0,3,1,29
1738,795572,32,4,12,3,9,1,3,1,1,1,4,1,2,1,2,1,10
1738,786323,12,0,1,0,1,0,0,0,0,1,1,1,0,0,1,0,0
1738,786322,29,1,4,1,2,0,2,0,0,1,1,2,3,0,1,0,2
1738,780228,6,0,0,0,0,0,0,0,0,0,0,1,0,0,1,0,0
1738,781592,27,3,6,1,3,2,3,1,2,1,7,1,2,3,1,0,9
1738,797195,3,0,1,0,1,0,0,0,0,0,0,0,0,0,1,0,0
1738,791483,31,7,13,6,11,1,2,1,2,1,4,3,3,3,2,0,16
1738,791485,24,1,3,0,0,1,3,2,2,0,0,1,3,0,0,0,5
1738,797194,2,0,0,0,0,0,0,0,0,0,0,0,0,0,0,0,0
1739,782133,20,6,8,3,4,3,4,0,0,1,6,2,4,0,3,0,15
1739,785123,30,7,11,7,11,0,0,0,0,1,7,1,2,0,2,1,14
1739,796623,35,5,13,4,9,1,4,0,0,0,4,8,3,1,0,0,11
1739,790990,34,3,8,3,5,0,3,4,6,1,3,3,1,0,3,0,10
1739,789219,33,6,13,1,2,5,11,2,2,1,2,4,2,5,1,0,19
1739,785305,4,0,1,0,1,0,0,0,0,0,0,0,0,0,0,0,0
1739,796622,5,1,1,1,1,0,0,0,0,0,1,0,1,0,0,0,2
1739,785303,21,3,6,2,3,1,3,0,1,1,2,0,1,1,1,0,7
1739,785122,16,1,2,0,1,1,1,0,0,1,1,1,0,1,0,0,3
1739,790988,2,0,0,0,0,0,0,0,0,0,0,0,0,0,0,0,0
1740,786566,37,7,15,5,10,2,5,5,6,3,6,2,4,0,3,1,21
1740,781204,14,2,5,2,3,0,2,0,0,2,2,0,2,0,1,0,4
1740,791993,30,2,3,2,3,0,0,2,2,2,5,0,2,0,1,0,6
1740,781189,27,3,6,2,4,1,2,2,2,0,4,2,5,1,4,0,9
1740,781188,37,7,15,5,8,2,7,13,16,1,4,9,3,1,3,1,29
1740,791997,29,5,7,2,2,3,5,2,2,0,3,1,2,0,2,0,15
1740,786562,3,0,1,0,1,0,0,0,0,0,2,1,0,0,0,0,0
1740,786563,23,0,1,0,1,0,0,0,0,0,2,1,1,0,2,0,0
1741,796837,37,6,11,6,9,0,2,1,2,2,5,2,2,1,1,0,13
1741,791171,30,5,9,5,9,0,0,2,2,3,2,1,4,1,3,0,12
1741,791170,32,8,17,6,8,2,9,0,0,2,4,0,0,0,0,0,18
1741,785700,34,6,11,5,7,1,4,1,1,0,4,4,5,3,1,0,14
1741,780269,32,8,15,5,9,3,6,5,9,1,1,5,4,1,2,0,24
1741,796838,4,1,1,1,1,0,0,0,0,1,1,1,0,0,0,0,2
1741,796834,12,0,3,0,2,0,1,1,2,0,1,1,2,1,0,0,1
1741,796833,9,0,1,0,0,0,1,0,0,0,0,0,1,0,0,0,0
1741,785706,10,2,3,1,1,1,2,0,0,1,0,1,3,0,2,0,5
1746,797591,20,2,6,1,2,1,4,0,0,0,1,0,1,0,1,0,5
1746,781071,34,6,14,3,7,3,7,1,1,1,4,2,3,1,2,0,16
1746,780098,23,3,8,3,8,0,0,4,4,2,4,1,4,1,3,1,10
1746,780719,37,5,9,3,5,2,4,0,4,0,9,3,3,3,5,0,12
1746,791890,31,4,8,4,5,0,3,12,15,0,4,6,2,2,2,0,20
1746,785424,17,1,1,1,1,0,0,2,2,2,3,2,4,0,0,0,4
1746,797589,27,3,7,2,5,1,2,4,4,0,3,5,1,0,1,0,11
1746,797588,1,0,0,0,0,0,0,0,0,0,0,0,0,0,0,0,0
1746,791888,10,0,1,0,0,0,1,0,0,0,0,0,1,0,0,0,0
1747,797028,32,4,5,3,4,1,1,3,3,1,4,1,2,0,1,0,12
1747,797025,35,6,11,4,9,2,2,4,6,0,4,3,3,3,4,0,18
1747,792116,28,6,11,4,4,2,7,1,1,1,4,1,4,1,4,0,15
1747,780410,29,2,7,2,7,0,0,2,3,0,1,1,4,0,0,0,6
1747,797026,8,0,3,0,0,0,3,0,0,1,1,0,1,0,1,0,0
1747,785687,3,0,2,0,1,0,1,0,0,1,0,0,0,0,1,0,0
1747,775047,6,0,2,0,1,0,1,0,0,0,0,1,0,0,0,0,0
1747,791600,18,5,10,3,6,2,4,2,3,1,5,0,3,2,0,1,14
1747,791598,32,3,10,3,9,0,1,4,5,0,8,1,4,2,3,1,10
1747,791597,9,0,1,0,1,0,0,0,0,0,1,0,1,1,0,0,0
1748,791401,28,4,8,4,8,0,0,7,11,2,5,2,3,1,2,3,15
1748,780125,17,2,2,2,2,0,0,4,7,0,5,0,2,0,2,2,8
1748,791400,23,7,12,2,5,5,7,0,0,0,4,5,3,3,2,1,19
1748,785931,15,2,6,0,0,2,6,2,4,0,5,1,1,2,1,1,8
1748,780118,23,1,5,0,0,1,5,0,0,0,2,2,1,0,3,0,3
1748,786837,22,2,7,1,1,1,6,0,0,1,6,0,4,0,2,0,5
1748,797125,21,5,6,4,4,1,2,0,1,0,2,0,0,1,1,0,11
1748,797132,14,1,2,0,0,1,2,1,2,2,1,3,1,1,0,0,4
1748,797130,17,2,5,0,1,2,4,4,4,0,4,3,2,0,3,0,10
1748,797126,16,2,2,2,2,0,0,0,2,0,4,1,3,1,1,0,4
1748,791399,2,0,0,0,0,0,0,0,0,0,1,0,0,1,0,0,0
1748,792671,1,0,1,0,0,0,1,0,0,0,0,0,0,0,0,0,0
1748,791398,1,0,0,0,0,0,0,0,0,0,0,0,0,0,0,0,0
1749,791787,31,4,14,4,10,0,4,1,2,0,3,0,4,0,3,0,9
1749,789048,25,3,7,3,7,0,0,0,1,1,3,1,3,1,3,0,6
1749,789046,26,2,7,1,3,1,4,2,3,0,5,0,1,0,1,1,7
1749,797629,33,7,9,7,9,0,0,2,4,1,3,2,3,1,4,0,16
1749,789041,18,0,4,0,2,0,2,0,0,0,0,0,3,0,3,0,0
1749,785540,26,1,4,1,2,0,2,1,3,0,9,0,3,1,1,1,3
1749,797630,29,3,13,1,6,2,7,0,1,1,3,5,2,3,1,0,8
1749,789044,10,1,5,0,1,1,4,0,0,0,0,0,2,0,0,0,3
1749,797632,1,0,0,0,0,0,0,0,0,1,0,0,0,0,1,0,0
1749,797633,1,0,0,0,0,0,0,0,0,0,0,0,0,0,0,0,0
1750,780291,26,5,11,2,6,3,5,1,3,1,4,1,5,2,1,0,14
1750,785607,12,1,4,1,4,0,0,1,2,0,2,0,0,0,0,0,3
1750,796665,29,5,14,3,8,2,6,3,4,1,0,0,1,1,0,0,15
1750,785333,27,3,7,2,3,1,4,0,2,0,1,2,1,0,3,0,7
1750,775305,35,4,13,4,10,0,3,5,5,1,2,6,2,1,1,0,13
1750,796663,12,2,2,2,2,0,0,0,0,1,0,1,2,2,0,0,4
1750,791004,10,0,3,0,1,0,2,0,0,0,0,0,2,0,1,0,0
1750,791006,1,0,1,0,1,0,0,0,0,1,0,0,0,0,0,0,0
1750,796666,19,2,5,1,4,1,1,0,0,1,2,1,3,6,2,1,5
1750,796664,16,2,7,2,6,0,1,0,0,1,3,0,0,2,1,0,4
1750,791007,13,0,2,0,1,0,1,2,4,0,1,3,3,1,0,0,2
1751,776174,27,8,12,8,12,0,0,0,2,3,13,2,3,1,4,4,16
1751,791958,34,8,13,8,9,0,4,3,3,0,5,4,1,2,1,0,19
1751,791960,25,2,7,1,1,1,6,0,0,1,0,2,2,0,1,0,5
1751,785861,34,4,9,2,2,2,7,0,0,2,4,0,2,1,2,1,10
1751,781332,35,5,9,2,2,3,7,4,4,0,3,5,0,0,4,0,17
1751,786059,29,4,5,4,5,0,0,4,7,3,6,1,3,1,2,2,12
1751,786063,1,0,0,0,0,0,0,0,0,0,1,0,0,0,0,0,0
1751,781334,2,0,0,0,0,0,0,0,0,0,1,0,0,0,1,0,0
1751,797706,1,0,0,0,0,0,0,2,2,0,0,0,1,0,0,0,2
1751,797704,9,0,1,0,0,0,1,0,0,0,1,0,1,0,0,0,0
1751,791959,3,1,2,1,2,0,0,2,2,0,1,0,0,0,2,0,4
1752,790998,38,5,9,3,4,2,5,0,0,3,5,2,0,0,1,0,12
1752,766874,20,1,4,1,4,0,0,1,2,2,4,1,4,1,2,1,3
1752,790997,24,2,7,2,3,0,4,1,2,0,4,1,3,0,2,0,5
1752,790996,30,5,11,2,3,3,8,2,2,1,2,3,1,1,3,0,15
1752,790995,34,4,5,3,3,1,2,0,0,2,1,4,2,2,4,0,9
1752,796631,19,2,7,0,2,2,5,2,2,1,2,0,2,0,3,0,8
1752,796633,17,4,4,4,4,0,0,2,4,2,4,0,3,0,0,1,10
1752,785621,12,1,4,0,0,1,4,0,0,0,0,0,0,0,1,0,3
1752,781520,6,0,1,0,1,0,0,0,0,0,2,0,3,1,2,0,0
1753,780686,32,10,18,9,17,1,1,2,6,1,5,0,2,0,2,0,23
1753,780683,33,6,6,5,5,1,1,1,4,5,6,2,1,0,1,1,14
1753,797681,29,3,10,2,4,1,6,0,0,2,1,3,2,2,1,0,7
1753,786112,34,5,12,2,2,3,10,4,4,0,3,1,1,2,5,1,17
1753,780688,29,4,6,3,4,1,2,2,2,2,2,2,2,1,0,0,11
1753,797683,7,0,2,0,0,0,2,0,0,0,1,0,1,0,0,0,0
1753,797682,1,0,0,0,0,0,0,0,0,0,0,0,0,0,0,0,0
1753,797679,10,0,2,0,1,0,1,0,0,1,1,1,2,0,1,0,0
1753,797678,1,0,0,0,0,0,0,0,0,0,0,0,0,0,0,0,0
1753,797677,1,0,0,0,0,0,0,0,0,0,0,0,0,0,0,0,0
1753,791942,1,1,1,1,1,0,0,0,0,0,0,0,0,0,0,0,2
1753,791941,9,1,2,0,1,1,1,0,0,1,0,0,0,0,0,0,3
1753,780772,6,1,2,1,2,0,0,0,0,0,0,1,1,0,0,0,2
1753,780689,7,0,1,0,0,0,1,0,0,0,0,1,3,0,0,0,0
1754,791975,24,6,8,6,8,0,0,0,0,1,4,3,1,1,1,0,12
1754,785972,23,3,6,3,5,0,1,0,0,0,6,2,0,1,2,0,6
1754,785967,30,3,8,3,8,0,0,4,5,1,10,2,2,1,2,1,10
1754,791977,23,5,8,3,6,2,2,0,0,0,3,4,2,0,0,0,12
1754,791978,28,9,11,7,9,2,2,0,0,0,1,5,1,3,1,0,20
1754,780160,19,0,2,0,1,0,1,0,0,1,2,2,1,1,0,0,0
1754,785973,11,2,3,0,1,2,2,0,0,0,1,0,0,1,3,0,6
1754,791976,19,5,7,3,4,2,3,3,4,0,0,1,2,2,1,0,15
1754,797799,5,1,3,1,2,0,1,0,0,0,0,1,4,0,0,0,2
1754,791980,8,1,3,1,2,0,1,0,2,1,1,1,1,0,0,0,2
1754,797800,4,0,0,0,0,0,0,0,0,0,0,0,1,0,0,0,0
1754,797801,2,0,1,0,1,0,0,0,0,0,0,1,1,0,1,0,0
1754,797803,2,1,1,1,1,0,0,0,0,0,1,0,1,0,1,0,2
1754,791979,1,0,1,0,0,0,1,0,0,0,0,0,0,0,0,0,0
1754,799649,1,0,0,0,0,0,0,0,2,1,0,0,1,0,0,0,0
1755,791837,34,5,15,3,9,2,6,2,2,3,7,0,3,0,2,0,14
1755,780613,30,5,8,5,8,0,0,4,6,3,3,1,3,1,1,0,14
1755,775097,30,3,4,2,3,1,1,2,2,2,6,1,1,1,6,0,9
1755,780609,39,3,7,2,3,1,4,0,0,0,0,6,0,4,2,0,7
1755,776395,33,5,17,4,7,1,10,1,5,1,1,0,2,2,3,0,12
1755,786622,15,0,3,0,0,0,3,1,2,0,2,2,1,0,1,0,1
1755,786619,12,1,2,1,1,0,1,5,8,0,2,1,4,0,1,0,7
1755,786621,3,0,0,0,0,0,0,0,0,0,0,1,1,0,0,0,0
1755,786169,1,1,1,0,0,1,1,2,2,0,2,0,0,0,0,0,5
1755,797437,2,0,0,0,0,0,0,2,2,0,0,1,0,1,0,0,2
1755,797439,1,0,0,0,0,0,0,0,0,0,0,0,0,1,0,0,0
1756,792025,29,2,3,2,3,0,0,2,3,1,6,1,2,1,0,2,6
1756,792020,34,8,17,5,8,3,9,4,4,0,4,6,1,1,5,0,23
1756,785946,15,0,1,0,1,0,0,2,2,1,0,1,5,0,0,0,2
1756,785941,28,6,12,1,3,5,9,3,3,1,3,0,2,0,1,0,20
1756,785939,20,1,10,0,3,1,7,3,4,1,1,1,2,0,3,0,6
1756,792026,22,1,2,1,2,0,0,1,1,0,2,0,0,0,0,0,3
1756,785948,14,1,1,1,1,0,0,2,2,0,0,0,4,0,2,1,4
1756,797634,13,1,3,0,0,1,3,2,2,0,0,0,2,0,5,0,5
1756,785938,24,3,6,1,2,2,4,0,0,0,3,5,2,0,1,0,8
1756,792024,1,0,0,0,0,0,0,0,0,0,0,0,0,0,0,0,0
1757,785459,16,8,9,8,9,0,0,0,1,4,1,1,1,0,0,0,16
1757,789102,26,5,9,2,4,3,5,0,0,1,10,14,1,1,1,0,13
1757,789101,9,1,2,1,2,0,0,0,0,1,0,0,5,0,1,0,2
1757,781371,19,2,7,2,3,0,4,0,1,1,0,1,1,0,0,0,4
1757,781367,17,4,9,1,1,3,8,2,3,0,3,0,0,0,1,0,13
1757,797731,17,3,5,3,5,0,0,3,6,4,1,1,2,0,1,0,9
1757,792066,15,2,2,2,2,0,0,0,0,0,4,0,2,2,0,0,4
1757,781362,5,1,2,0,1,1,1,0,0,0,0,0,0,0,0,0,3
1757,797730,1,0,1,0,1,0,0,0,0,0,0,0,1,0,0,0,0
1757,792064,20,4,9,1,1,3,8,4,4,0,1,1,0,2,2,0,15
1757,792063,18,1,4,1,1,0,3,0,2,1,0,2,3,1,1,0,2
1757,792061,14,3,5,0,1,3,4,0,0,0,4,1,1,1,0,0,9
1757,788037,20,5,10,2,5,3,5,4,6,1,4,2,0,3,1,0,17
1757,789982,3,0,1,0,0,0,1,0,0,0,0,0,1,0,0,0,0
1758,780027,20,8,10,6,7,2,3,5,7,2,6,2,0,0,0,1,23
1758,786176,19,9,13,8,9,1,4,1,3,2,2,0,1,2,1,0,20
1758,786173,18,2,3,2,3,0,0,0,0,0,1,2,0,1,0,0,4
1758,780028,20,2,4,1,1,1,3,0,2,1,3,7,1,0,1,0,5
1758,774828,17,2,5,0,0,2,5,0,0,0,0,6,1,2,0,0,6
1758,780029,14,2,6,2,4,0,2,0,0,3,5,2,2,0,0,1,4
1758,791380,18,2,4,2,4,0,0,2,2,0,2,2,1,0,2,0,6
1758,791379,21,4,9,2,4,2,5,4,4,1,3,2,2,0,0,1,14
1758,797175,15,4,5,2,2,2,3,0,0,2,3,2,0,2,1,3,10
1758,797179,14,2,4,2,3,0,1,0,0,0,0,2,0,0,2,0,4
1758,797178,10,2,6,2,5,0,1,0,0,4,3,2,0,2,0,0,4
1758,797176,4,0,0,0,0,0,0,0,0,0,0,0,0,1,1,0,0
1758,797177,4,0,0,0,0,0,0,0,0,0,0,0,1,0,0,0,0
1758,780026,4,2,3,0,1,2,2,0,0,0,0,0,0,1,0,0,6
1758,786170,1,0,0,0,0,0,0,0,0,0,1,0,0,0,0,1,0
1758,786178,1,0,1,0,0,0,1,0,0,0,0,0,0,1,0,0,0
1759,797574,24,3,7,3,4,0,3,1,1,2,3,1,1,0,2,0,7
1759,797575,27,7,10,7,10,0,0,0,0,4,0,0,4,0,0,0,14
1759,786512,27,3,9,1,2,2,7,0,0,2,5,2,3,1,8,0,8
1759,786435,34,5,12,5,11,0,1,0,2,1,4,2,1,1,2,1,10
1759,786032,28,2,11,2,9,0,2,1,4,4,2,1,3,1,2,0,5
1759,797571,29,3,11,3,10,0,1,0,0,0,2,3,0,1,2,0,6
1759,797573,14,0,2,0,2,0,0,0,0,3,0,1,3,1,0,0,0
1759,791900,12,1,5,1,4,0,1,1,2,2,1,0,2,0,1,0,3
1759,780189,4,0,2,0,2,0,0,0,0,1,1,0,0,0,0,0,0
1759,791901,1,0,1,0,1,0,0,0,0,0,0,0,0,0,0,0,0
1760,785799,21,3,3,3,3,0,0,3,4,1,5,1,4,1,1,0,9
1760,780760,28,2,3,2,2,0,1,0,0,1,3,0,3,0,0,4,4
1760,791676,22,1,7,1,2,0,5,1,2,0,2,3,3,2,4,0,3
1760,780554,30,5,12,3,6,2,6,4,4,4,6,2,0,2,0,0,16
1760,780553,33,6,19,5,16,1,3,4,5,1,5,5,1,2,4,1,17
1760,797426,3,0,2,0,0,0,2,0,0,0,0,0,0,0,0,0,0
1760,791678,10,0,0,0,0,0,0,0,0,1,0,0,1,0,1,0,0
1760,791679,8,0,4,0,4,0,0,0,2,1,2,0,0,0,1,0,0
1760,785807,15,4,5,3,3,1,2,3,4,4,2,0,4,0,0,0,12
1760,785800,23,1,3,1,1,0,2,0,0,1,1,0,2,0,1,0,2
1760,797427,4,0,3,0,1,0,2,0,1,0,0,0,0,0,0,0,0
1760,791677,3,0,0,0,0,0,0,1,3,0,0,1,1,0,1,0,1
1761,786476,12,1,3,1,3,0,0,0,0,1,0,0,1,0,0,1,2
1761,791783,9,0,0,0,0,0,0,0,0,0,2,0,2,0,0,0,0
1761,791780,15,1,4,0,1,1,3,0,0,1,0,1,4,0,2,0,3
1761,791777,36,6,16,6,15,0,1,2,7,1,11,1,2,2,1,0,14
1761,780488,39,2,9,2,6,0,3,2,2,0,2,0,2,3,5,0,6
1761,791781,3,0,0,0,0,0,0,0,0,0,1,0,0,0,0,0,0
1761,791778,7,0,1,0,1,0,0,1,2,1,0,0,2,0,0,1,1
1761,776285,27,3,7,3,7,0,0,8,10,0,2,0,4,1,1,0,14
1761,797612,5,0,0,0,0,0,0,0,0,0,1,1,2,0,1,0,0
1761,791776,34,2,4,1,2,1,2,0,0,0,3,1,0,1,1,0,5
1761,775503,13,1,3,1,1,0,2,0,1,0,1,0,4,0,2,0,2
1762,798965,32,3,4,3,4,0,0,0,0,1,6,0,2,0,2,0,6
1762,768880,15,1,5,1,3,0,2,0,0,1,4,1,3,0,0,0,2
1762,791718,31,10,20,5,11,5,9,2,2,0,5,3,1,0,3,0,27
1762,791720,17,0,1,0,1,0,0,0,0,0,1,0,1,0,0,0,0
1762,791719,5,1,6,1,4,0,2,0,1,2,1,1,2,0,2,1,2
1762,787996,16,0,0,0,0,0,0,0,0,0,0,0,3,0,2,0,0
1762,798967,8,2,3,1,1,1,2,0,0,0,1,0,0,0,0,0,5
1762,798968,17,3,5,1,3,2,2,1,2,2,3,1,2,0,2,0,9
1762,798966,26,0,4,0,3,0,1,0,0,1,1,1,3,0,0,1,0
1762,791717,33,3,5,2,4,1,1,0,0,1,1,0,0,0,0,0,7
1763,786080,33,4,12,2,2,2,10,3,4,2,3,0,0,0,3,0,13
1763,780150,22,1,7,0,0,1,7,0,0,2,1,2,0,0,0,0,3
1763,786216,16,3,7,3,7,0,0,3,4,3,3,0,5,0,3,0,9
1763,791348,35,4,8,4,8,0,0,2,3,1,3,3,0,0,2,0,10
1763,786218,38,4,12,4,6,0,6,3,3,2,3,1,3,1,3,1,11
1763,781645,4,0,0,0,0,0,0,0,0,0,0,0,0,0,1,0,0
1763,791350,32,5,9,4,5,1,4,0,0,1,4,1,1,0,0,0,11
1763,780156,17,0,1,0,0,0,1,3,4,0,2,0,0,0,0,0,3
1763,797257,3,0,1,0,1,0,0,0,0,0,1,0,0,0,0,0,0
1764,785863,30,3,5,3,5,0,0,1,2,1,9,2,2,2,5,1,7
1764,785631,15,3,8,2,5,1,3,0,0,1,2,1,2,0,1,1,7
1764,786248,22,3,4,3,4,0,0,0,1,4,5,0,3,0,1,0,6
1764,785630,33,7,11,1,1,6,10,3,3,0,3,1,3,0,2,0,23
1764,780777,23,5,9,4,6,1,3,0,0,1,2,8,1,1,2,0,11
1764,791199,5,0,0,0,0,0,0,0,0,0,1,1,2,1,0,0,0
1764,791197,17,1,1,1,1,0,0,1,4,1,1,0,2,0,0,0,3
1764,791198,6,1,2,0,0,1,2,0,0,0,0,0,0,1,0,0,3
1764,791196,3,0,1,0,0,0,1,0,0,0,2,0,0,0,1,0,0
1764,791200,23,4,7,3,4,1,3,2,2,0,0,3,3,1,0,0,11
1764,785632,22,4,7,4,5,0,2,2,2,2,2,0,1,1,1,0,10
1764,796898,1,0,0,0,0,0,0,0,0,0,0,0,0,0,0,0,0
1765,792473,16,1,3,1,2,0,1,1,2,0,2,0,4,0,2,0,3
1765,780043,40,2,4,1,3,1,1,1,2,0,4,0,0,4,0,0,6
1765,799276,26,1,7,1,3,0,4,0,0,0,4,0,2,3,4,0,2
1765,785249,34,4,15,4,12,0,3,6,6,0,3,3,2,3,0,0,14
1765,780035,36,4,9,2,3,2,6,3,4,1,0,1,0,0,3,0,13
1765,792471,2,0,0,0,0,0,0,0,0,0,1,0,1,0,0,0,0
1765,785251,18,5,7,4,5,1,2,4,6,2,0,1,0,0,1,0,15
1765,792477,9,0,2,0,1,0,1,0,0,0,0,0,0,0,1,0,0
1765,785253,2,0,0,0,0,0,0,0,0,0,1,0,0,0,0,0,0
1765,780036,13,0,2,0,2,0,0,0,0,0,0,0,3,0,1,0,0
1765,799650,4,0,0,0,0,0,0,0,0,0,0,0,0,0,0,0,0
1766,780063,36,7,12,6,11,1,1,3,3,0,7,3,1,0,2,0,18
1766,791055,31,2,4,1,3,1,1,0,2,0,4,2,2,1,0,1,5
1766,785530,29,7,14,5,11,2,3,1,1,1,2,5,4,0,2,0,17
1766,775573,27,1,7,0,1,1,6,0,0,0,0,2,3,2,0,0,3
1766,775926,39,1,6,0,2,1,4,4,4,0,3,4,2,2,0,0,7
1766,785532,30,7,10,7,10,0,0,8,13,2,5,0,3,1,2,1,22
1766,796733,7,0,0,0,0,0,0,0,0,0,0,1,0,0,0,0,0
1766,791057,1,0,0,0,0,0,0,0,0,0,1,0,0,0,0,0,0
1767,791750,26,0,2,0,2,0,0,2,2,0,2,1,3,1,3,0,2
1767,786177,32,2,5,1,2,1,3,0,0,0,6,0,4,1,1,0,5
1767,780244,14,1,2,1,1,0,1,0,0,1,2,5,5,0,0,0,2
1767,786179,31,6,12,2,7,4,5,5,6,1,3,3,1,0,3,0,21
1767,780238,37,10,17,7,10,3,7,1,3,1,3,3,1,0,2,0,24
1767,790773,25,2,6,0,1,2,5,5,6,0,6,0,4,1,0,0,11
1767,791752,12,0,0,0,0,0,0,0,0,0,2,0,3,0,1,0,0
1767,781500,13,1,4,1,2,0,2,1,1,1,1,2,0,1,0,0,3
1767,785909,10,1,1,1,1,0,0,0,0,0,1,0,1,0,1,2,2
1768,791161,25,0,5,0,1,0,4,0,0,0,5,1,5,0,3,2,0
1768,780629,24,5,15,5,12,0,3,4,6,1,5,1,4,3,3,0,14
1768,796816,33,0,3,0,0,0,3,0,0,1,5,2,1,3,3,0,0
1768,796815,21,3,4,3,4,0,0,0,1,0,3,2,0,1,3,0,6
1768,775888,38,2,13,1,7,1,6,2,2,1,6,2,1,1,0,1,7
1768,796817,5,1,2,0,0,1,2,0,0,0,0,1,1,0,1,0,3
1768,791159,5,0,1,0,1,0,0,0,0,0,0,0,0,0,0,0,0
1768,792111,19,2,7,0,1,2,6,0,0,0,0,0,3,0,3,0,6
1768,785346,30,5,9,2,2,3,7,0,0,1,1,2,5,1,2,0,13
1769,781653,26,3,5,3,5,0,0,2,4,4,6,0,2,0,2,0,8
1769,781652,36,7,13,6,11,1,2,3,5,4,10,4,3,3,3,1,18
1769,786034,33,4,12,3,5,1,7,3,4,1,3,0,2,3,1,0,12
1769,786419,30,3,8,3,7,0,1,2,3,1,4,1,3,1,4,0,8
1769,781283,33,1,6,0,2,1,4,3,4,1,4,3,4,1,2,0,6
1769,781158,11,1,3,1,3,0,0,0,0,0,2,0,0,0,1,0,2
1769,796993,1,0,0,0,0,0,0,0,0,0,0,0,0,1,1,0,0
1769,791615,29,4,12,4,7,0,5,4,4,2,7,3,2,1,5,0,12
1769,791614,1,0,0,0,0,0,0,0,0,0,0,0,0,0,0,0,0
1770,776279,15,0,1,0,0,0,1,0,0,0,1,0,4,0,2,0,0
1770,781505,34,7,10,5,7,2,3,2,2,1,3,1,3,0,4,0,18
1770,780353,28,6,8,6,8,0,0,2,3,1,8,0,3,0,2,0,14
1770,791317,39,7,13,5,10,2,3,5,5,0,2,5,0,4,4,0,21
1770,777573,25,1,6,1,4,0,2,6,7,0,2,2,1,0,2,0,8
1770,786222,18,0,5,0,3,0,2,1,2,1,5,1,2,0,0,0,1
1770,790851,25,1,2,1,1,0,1,1,2,1,5,3,1,3,3,0,3
1770,796648,15,1,3,0,0,1,3,2,2,0,1,0,1,0,1,0,5
1770,796649,1,0,0,0,0,0,0,0,0,0,0,0,1,0,0,0,0
1771,790781,24,1,2,1,2,0,0,0,2,0,3,0,2,0,1,1,2
1771,780040,17,2,4,2,4,0,0,0,0,2,4,0,2,2,3,0,4
1771,790785,26,4,9,3,7,1,2,0,0,0,2,2,3,3,2,0,9
1771,796340,29,3,9,2,7,1,2,4,4,0,4,3,1,3,3,0,11
1771,780037,34,12,21,9,15,3,6,4,5,2,0,4,3,2,3,0,31
1771,796343,14,2,2,2,2,0,0,0,0,0,0,0,4,0,0,1,4
1771,785239,22,0,4,0,0,0,4,0,0,0,2,0,2,1,0,0,0
1771,781232,21,3,6,1,1,2,5,2,2,0,4,0,1,1,0,0,10
1771,796339,11,0,0,0,0,0,0,0,0,0,3,1,1,0,0,0,0
1771,796345,2,0,0,0,0,0,0,0,0,0,0,0,0,0,0,0,0
1771,796342,0,0,0,0,0,0,0,0,0,0,0,0,0,0,0,0,0
1772,797283,31,4,9,2,3,2,6,2,3,0,2,2,4,3,1,1,12
1772,797285,28,3,4,0,0,3,4,2,2,0,5,2,1,1,1,0,11
1772,791652,18,5,5,5,5,0,0,10,12,2,1,1,3,0,2,1,20
1772,791653,4,0,0,0,0,0,0,0,0,0,2,2,2,0,1,0,0
1772,797289,33,6,10,4,7,2,3,2,3,0,6,6,3,3,2,0,16
1772,786495,19,6,12,6,9,0,3,2,2,3,8,2,4,0,4,0,14
1772,791654,12,2,6,2,6,0,0,2,2,2,3,1,1,0,1,0,6
1772,791651,13,2,3,1,1,1,2,0,0,0,1,1,0,0,1,0,5
1772,797286,28,4,10,1,3,3,7,10,11,2,10,3,4,0,5,0,21
1772,775705,14,3,5,3,5,0,0,3,3,4,1,1,0,0,0,0,9
1774,785429,23,2,3,0,0,2,3,0,0,1,2,0,0,0,1,0,6
1774,780054,26,2,8,2,6,0,2,5,8,0,3,0,4,0,2,0,9
1774,781140,17,0,2,0,2,0,0,0,0,1,1,2,2,1,0,1,0
1774,786851,30,5,14,3,7,2,7,5,6,0,1,0,0,0,2,0,17
1774,776357,36,5,12,4,8,1,4,5,5,0,4,3,1,0,2,0,16
1774,796433,21,4,5,4,5,0,0,4,6,4,6,2,2,1,2,3,12
1774,796432,7,0,1,0,0,0,1,0,0,0,0,0,0,0,0,0,0
1774,781139,25,2,5,2,3,0,2,0,0,2,4,2,2,0,0,0,4
1774,780343,14,1,2,0,0,1,2,0,1,0,1,1,1,1,1,0,3
1774,796102,1,0,0,0,0,0,0,0,0,0,0,0,0,0,0,1,0
1775,796788,15,2,4,2,4,0,0,0,0,2,1,0,3,0,3,0,4
1775,785681,20,0,1,0,1,0,0,4,6,0,5,1,4,0,4,0,4
1775,791126,11,2,5,2,4,0,1,0,0,0,0,2,3,0,0,0,4
1775,791124,33,1,6,1,6,0,0,0,0,0,1,4,1,1,0,0,2
1775,780050,30,4,11,4,10,0,1,0,2,2,12,2,3,0,3,0,8
1775,796789,33,6,14,4,8,2,6,0,0,0,4,0,4,1,0,1,14
1775,796782,26,1,4,1,3,0,1,2,2,0,1,1,3,0,0,0,4
1775,796784,9,0,0,0,0,0,0,1,2,0,0,1,1,0,1,0,1
1775,792711,3,1,2,1,2,0,0,0,0,0,0,0,0,0,0,0,2
1775,784479,9,5,7,3,3,2,4,0,0,1,1,0,4,0,2,0,12
1775,796786,8,2,2,0,0,2,2,0,1,0,0,0,1,0,0,0,6
1775,796783,3,0,0,0,0,0,0,0,0,0,0,0,0,0,0,0,0
1776,797822,31,9,16,7,9,2,7,1,2,0,4,2,3,2,0,1,21
1776,792190,31,2,5,1,2,1,3,2,2,0,1,6,2,1,1,0,7
1776,786664,32,6,12,3,6,3,6,5,6,1,1,10,4,1,6,0,20
1776,797824,10,0,1,0,0,0,1,0,0,1,0,0,0,0,2,0,0
1776,775116,23,2,3,2,2,0,1,0,0,2,2,1,1,1,1,0,4
1776,791928,4,0,0,0,0,0,0,0,0,0,0,1,0,0,0,0,0
1776,792191,20,1,1,1,1,0,0,0,1,0,1,0,1,1,1,1,2
1776,792192,15,3,6,3,6,0,0,2,2,3,3,0,2,1,1,0,8
1776,797830,15,1,5,1,4,0,1,1,2,1,1,0,1,0,0,1,3
1776,797828,1,0,0,0,0,0,0,0,0,0,0,0,0,0,0,0,0
1776,792193,18,1,7,1,7,0,0,0,0,1,5,0,4,1,1,0,2
1777,797247,38,1,4,1,3,0,1,5,6,0,4,7,1,2,4,0,7
1777,791352,28,3,7,2,3,1,4,4,4,2,4,4,2,1,1,2,11
1777,797251,19,0,2,0,0,0,2,2,2,0,3,2,2,0,0,1,2
1777,776297,37,6,13,2,4,4,9,2,5,2,2,6,2,0,4,0,18
1777,780455,17,7,9,7,9,0,0,2,2,2,3,0,1,0,0,1,16
1777,797248,22,1,5,0,0,1,5,0,0,0,2,1,2,0,1,0,3
1777,785837,18,2,4,2,4,0,0,2,4,0,3,0,4,0,1,1,6
1777,791354,11,3,3,3,3,0,0,1,1,1,1,0,0,1,1,0,7
1777,791355,9,1,3,0,0,1,3,0,0,1,0,0,1,0,0,0,3
1777,797252,1,0,0,0,0,0,0,0,0,0,0,0,0,0,0,0,0
1778,785829,16,6,8,6,8,0,0,0,0,2,4,1,2,0,1,0,12
1778,796724,20,5,8,3,4,2,4,1,2,1,2,1,1,0,0,0,13
1778,786531,21,2,6,2,3,0,3,0,0,0,2,3,0,2,0,0,4
1778,785519,24,7,9,2,3,5,6,0,0,0,4,4,1,1,3,2,19
1778,791048,24,5,8,4,6,1,2,2,2,0,2,5,3,2,1,1,13
1778,796725,9,2,4,2,4,0,0,0,0,0,0,0,2,0,1,0,4
1778,796726,11,1,2,0,0,1,2,1,2,0,0,3,1,0,0,0,4
1778,796727,15,2,4,0,0,2,4,0,0,1,1,1,0,0,1,1,6
1778,796728,13,3,5,3,3,0,2,0,0,0,3,1,0,0,0,0,6
1778,791044,7,1,2,1,2,0,0,2,2,1,1,0,1,1,2,0,4
1778,796729,19,2,8,2,6,0,2,3,3,0,2,2,0,1,1,0,7
1778,780723,18,1,3,1,3,0,0,0,0,2,4,1,0,0,1,0,2
1778,791045,3,0,0,0,0,0,0,0,0,0,0,0,0,0,1,0,0
1780,786239,6,1,2,1,1,0,1,2,2,0,1,0,1,0,2,0,4
1780,786236,32,11,16,9,12,2,4,3,5,1,4,0,1,1,2,1,27
1780,797323,34,6,11,6,8,0,3,3,3,0,4,6,2,1,1,0,15
1780,797325,19,4,6,4,6,0,0,0,0,2,4,3,2,1,0,0,8
1780,797329,32,1,2,0,0,1,2,0,0,0,4,1,3,1,2,2,3
1780,786233,12,1,3,0,1,1,2,0,0,1,1,0,1,0,0,0,3
1780,797322,13,1,2,1,1,0,1,1,2,0,0,2,0,1,1,0,3
1780,786246,8,0,2,0,0,0,2,0,0,0,1,0,0,0,0,1,0
1780,797324,9,2,3,2,2,0,1,3,3,0,0,0,1,1,0,0,7
1780,776478,14,2,6,1,1,1,5,2,2,1,5,0,2,0,0,0,7
1780,781002,21,5,6,5,6,0,0,2,3,1,3,1,0,0,1,3,12
1786,776100,15,1,2,1,2,0,0,1,4,3,1,0,2,1,1,0,3
1786,785991,27,4,10,4,9,0,1,5,6,3,6,2,5,0,0,5,13
1786,781406,31,5,11,5,10,0,1,4,4,3,4,3,3,4,3,0,14
1786,781401,31,4,5,2,3,2,2,5,6,0,5,1,1,1,2,0,15
1786,775317,13,0,2,0,2,0,0,0,0,0,0,0,1,1,2,0,0
1786,797760,9,0,3,0,2,0,1,0,0,1,2,0,1,1,0,0,0
1786,792129,9,1,1,1,1,0,0,0,0,1,3,0,0,0,0,1,2
1786,792133,23,3,8,3,6,0,2,5,5,0,1,2,0,1,1,0,11
1786,797762,24,3,5,3,5,0,0,1,1,0,2,2,1,0,4,0,7
1786,781029,18,1,5,0,0,1,5,0,0,0,0,1,1,1,3,0,3
1787,781407,25,3,6,2,4,1,2,1,2,4,2,0,2,0,0,0,8
1787,791583,21,3,8,3,8,0,0,0,0,1,3,0,3,1,1,3,6
1787,785623,9,0,4,0,3,0,1,0,0,0,1,0,1,1,2,1,0
1787,780580,32,3,8,3,5,0,3,8,9,0,4,4,3,3,1,0,14
1787,776150,27,1,5,0,1,1,4,0,0,0,1,3,1,1,5,0,3
1787,797448,24,6,7,2,2,4,5,0,0,0,2,0,1,1,1,0,16
1787,786608,13,2,6,2,5,0,1,0,0,1,3,0,5,1,2,0,4
1787,791584,5,0,1,0,1,0,0,0,0,0,1,0,1,0,0,0,0
1787,797445,16,3,4,3,3,0,1,1,2,2,0,3,0,2,0,0,7
1787,786659,28,3,8,3,7,0,1,1,2,0,1,1,3,1,3,0,7
1788,785374,11,0,1,0,1,0,0,0,0,1,2,1,3,0,1,0,0
1788,785372,28,6,13,4,6,2,7,1,1,3,2,5,2,3,6,2,15
1788,786384,25,4,6,2,3,2,3,0,0,2,8,4,4,0,3,0,10
1788,790825,22,4,11,3,4,1,7,0,0,1,2,6,4,0,2,0,9
1788,774905,22,5,10,3,3,2,7,1,1,3,2,4,1,0,2,0,13
1788,785375,10,1,3,1,3,0,0,1,2,1,1,0,2,0,2,0,3
1788,785373,18,7,9,3,3,4,6,2,2,0,1,1,2,1,0,0,20
1788,785371,18,2,5,0,2,2,3,4,4,0,0,7,0,0,0,0,10
1788,790827,16,4,6,3,5,1,1,1,1,3,3,1,1,0,0,0,10
1788,796385,7,3,3,2,2,1,1,3,3,0,3,1,0,0,0,1,10
1788,790828,6,2,3,2,3,0,0,1,1,1,0,1,1,0,0,0,5
1788,796387,8,0,1,0,1,0,0,2,2,1,5,0,0,0,0,0,2
1788,780007,5,1,3,1,2,0,1,0,0,0,1,1,0,0,0,0,2
1788,796386,2,0,1,0,1,0,0,0,0,0,0,0,0,0,0,0,0
1788,790826,2,0,1,0,0,0,1,0,0,0,0,0,0,0,0,0,0
1789,797529,23,2,2,2,2,0,0,1,3,0,2,3,3,0,0,2,5
1789,797527,26,3,4,3,3,0,1,0,2,2,1,2,4,2,0,0,6
1789,791936,19,1,1,1,1,0,0,0,0,0,0,1,4,0,0,0,2
1789,797532,32,8,15,3,8,5,7,5,8,0,2,5,3,2,7,0,26
1789,785688,35,12,28,4,11,8,17,4,5,0,0,0,2,4,2,0,36
1789,785988,8,0,2,0,1,0,1,0,0,0,0,0,2,0,1,0,0
1789,791933,21,1,2,0,0,1,2,0,0,0,5,1,0,1,1,0,3
1789,791932,9,3,3,0,0,3,3,0,0,0,1,2,1,0,0,0,9
1789,797531,8,1,1,0,0,1,1,0,0,0,0,0,0,2,0,0,3
1789,797530,6,0,0,0,0,0,0,0,0,0,1,1,2,0,0,1,0
1789,791931,7,0,2,0,1,0,1,1,2,0,2,0,1,0,0,0,1
1789,791935,4,0,2,0,1,0,1,0,0,0,2,1,0,0,0,0,0
1789,797528,2,0,0,0,0,0,0,0,0,0,0,0,0,0,0,0,0
1790,775606,28,4,5,4,5,0,0,2,4,2,6,2,5,1,3,2,10
1790,791672,34,2,4,2,4,0,0,0,0,1,1,1,4,0,4,0,4
1790,791674,40,2,5,1,1,1,4,4,4,0,5,6,2,2,1,0,9
1790,780552,35,6,13,2,3,4,10,3,4,0,3,2,0,3,0,1,19
1790,780550,34,6,10,3,5,3,5,3,6,2,4,6,3,0,2,0,18
1790,797424,7,2,3,2,3,0,0,1,3,0,0,0,0,0,1,0,5
1790,785791,12,3,5,0,0,3,5,5,5,0,0,0,4,2,3,0,14
1790,785793,5,0,0,0,0,0,0,0,0,0,0,0,2,0,1,1,0
1790,797423,2,0,0,0,0,0,0,0,0,0,0,0,0,0,0,0,0
1790,780538,28,5,10,4,6,1,4,0,0,0,3,3,3,3,1,0,11
1791,791337,23,3,8,3,8,0,0,2,5,1,2,0,1,0,2,0,8
1791,797877,19,6,8,6,8,0,0,1,3,3,0,1,3,1,1,0,13
1791,797872,40,3,11,2,8,1,3,4,4,2,4,5,3,0,3,0,11
1791,797874,11,0,2,0,0,0,2,0,0,0,1,0,1,1,0,0,0
1791,791339,40,7,15,4,10,3,5,5,6,2,3,5,4,4,5,0,22
1791,797873,4,1,3,1,2,0,1,0,0,0,0,0,0,0,0,0,2
1791,791335,30,2,3,2,2,0,1,2,2,1,6,3,4,0,1,1,6
1791,781599,15,4,5,4,5,0,0,1,2,2,3,0,3,0,0,0,9
1791,797875,30,5,11,4,7,1,4,0,0,0,1,0,1,1,1,0,11
1791,791338,13,0,2,0,2,0,0,2,2,1,0,0,0,1,1,0,2
1792,786765,35,4,12,3,7,1,5,2,2,1,11,4,2,2,3,4,11
1792,792379,31,3,7,1,2,2,5,0,0,1,7,1,0,0,1,0,8
1792,792380,36,6,10,1,2,5,8,0,1,0,2,2,1,1,0,0,17
1792,781672,33,7,13,7,13,0,0,0,0,4,7,2,1,3,6,0,14
1792,781669,28,5,10,3,6,2,4,3,3,2,2,4,2,0,3,0,15
1792,786764,3,1,3,1,2,0,1,0,0,0,0,0,1,0,1,0,2
1792,797860,2,0,0,0,0,0,0,0,0,0,0,0,0,0,0,0,0
1792,797854,16,0,3,0,0,0,3,0,0,0,1,2,1,0,0,0,0
1792,797852,16,4,7,4,5,0,2,4,4,1,4,0,1,2,0,0,12
1793,792492,29,1,4,1,4,0,0,0,2,1,3,1,4,2,1,0,2
1793,780023,26,5,7,5,7,0,0,0,1,1,1,1,1,1,3,3,10
1793,792493,21,3,5,0,0,3,5,0,0,0,0,0,0,1,0,0,9
1793,792495,36,7,19,5,13,2,6,4,4,3,4,2,4,2,2,1,20
1793,792491,32,2,9,2,8,0,1,2,3,0,3,5,3,0,4,0,6
1793,798960,5,0,1,0,1,0,0,0,0,1,2,0,2,0,1,1,0
1793,798959,5,0,2,0,0,0,2,0,0,0,2,0,0,0,1,0,0
1793,793441,3,0,0,0,0,0,0,0,0,0,2,0,0,0,0,0,0
1793,792490,8,1,2,1,1,0,1,0,0,1,0,0,0,0,0,1,2
1793,781144,32,5,12,0,4,5,8,0,0,0,5,2,1,0,2,0,15
1793,786832,3,0,2,0,0,0,2,0,0,0,0,0,0,0,0,1,0
1794,797047,25,3,5,1,2,2,3,0,2,0,6,0,3,1,1,0,8
1794,775515,22,2,7,2,3,0,4,2,2,2,1,0,4,0,1,2,6
1794,791579,34,3,6,3,5,0,1,0,0,3,7,5,2,3,1,2,6
1794,786387,38,10,13,9,11,1,2,7,8,3,3,0,1,0,4,0,28
1794,780399,38,5,10,4,6,1,4,3,5,0,0,6,1,3,4,0,14
1794,786846,14,4,6,3,3,1,3,4,5,0,1,0,2,1,3,0,13
1794,780400,11,0,2,0,1,0,1,0,0,1,1,1,2,0,1,0,0
1794,791575,8,2,3,2,2,0,1,0,0,1,2,0,1,0,0,2,4
1794,797046,3,1,3,1,1,0,2,0,0,0,0,0,1,0,0,0,2
1794,791577,7,0,0,0,0,0,0,0,0,0,0,0,1,1,0,0,0
1795,797519,16,0,1,0,0,0,1,1,2,1,0,0,3,1,0,0,1
1795,781132,32,2,6,1,1,1,5,4,6,1,3,3,4,1,5,1,9
1795,797517,34,10,17,10,16,0,1,4,5,5,7,2,2,2,3,0,24
1795,791940,38,2,10,2,8,0,2,0,0,1,0,0,2,2,0,0,4
1795,786534,40,6,14,2,6,4,8,3,3,3,2,5,3,0,6,1,19
1795,797521,5,0,2,0,2,0,0,0,0,0,2,0,4,2,2,0,0
1795,786539,4,1,1,0,0,1,1,0,0,0,1,0,0,0,1,0,3
1795,791938,31,1,4,0,2,1,2,4,4,0,3,3,1,2,0,0,7
1796,780993,29,11,13,11,13,0,0,0,0,2,4,1,2,2,1,1,22
1796,775248,33,7,14,4,8,3,6,2,2,0,7,6,2,1,7,0,19
1796,797225,34,6,12,5,10,1,2,0,0,1,3,7,3,4,3,0,13
1796,791452,36,3,7,0,3,3,4,0,0,1,2,7,1,2,4,1,9
1796,797224,34,6,13,2,3,4,10,3,4,0,3,2,2,0,0,0,19
1796,797230,17,4,5,4,5,0,0,2,2,5,4,1,1,0,0,1,10
1796,791446,1,0,0,0,0,0,0,0,0,0,0,0,0,0,0,0,0
1796,797226,0,0,0,0,0,0,0,0,0,0,1,0,0,0,0,0,0
1796,797231,10,0,2,0,0,0,2,0,0,0,0,1,0,1,0,0,0
1796,797227,0,0,0,0,0,0,0,0,0,0,0,0,0,0,0,0,0
1796,791449,6,0,1,0,1,0,0,0,0,0,0,0,2,1,0,0,0
1797,797558,28,7,15,4,8,3,7,2,4,1,0,0,0,1,3,0,19
1797,786519,32,4,8,4,8,0,0,0,0,6,8,2,4,4,3,1,8
1797,797555,16,0,3,0,3,0,0,0,0,2,1,2,1,2,1,0,0
1797,791913,24,1,7,1,3,0,4,0,0,0,1,5,0,1,2,0,2
1797,786520,40,10,20,9,14,1,6,7,8,2,2,3,1,2,1,0,28
1797,791912,4,0,0,0,0,0,0,0,0,0,0,0,0,0,0,0,0
1797,791911,16,1,4,0,0,1,4,0,0,1,2,0,0,0,1,0,3
1797,797556,25,3,8,1,3,2,5,3,3,0,2,0,0,1,1,0,11
1797,781076,15,1,7,1,3,0,4,0,0,1,1,1,1,1,2,0,2
1798,780012,35,1,7,1,4,0,3,8,8,1,5,2,1,0,2,0,10
1798,796309,27,9,14,9,13,0,1,2,2,1,6,1,4,0,2,3,20
1798,790824,36,2,5,2,3,0,2,2,2,0,7,3,2,0,1,2,6
1798,780011,35,3,7,1,4,2,3,4,4,0,4,2,1,0,2,1,12
1798,775667,31,3,6,1,3,2,3,0,0,1,3,3,2,0,3,0,8
1798,785370,14,2,4,1,3,1,1,1,2,1,1,1,2,0,4,1,6
1798,781524,20,0,2,0,1,0,1,0,0,0,4,1,3,0,1,0,0
1798,796383,2,0,0,0,0,0,0,0,2,0,1,0,1,0,0,1,0
1799,792005,28,2,10,1,5,1,5,0,0,1,2,0,3,0,0,0,5
1799,781175,20,3,6,3,6,0,0,3,6,1,3,1,2,0,2,0,9
1799,786553,25,3,11,1,7,2,4,2,2,1,1,2,0,1,0,0,10
1799,780895,31,5,14,3,11,2,3,2,3,0,6,0,1,0,1,0,14
1799,781172,28,0,3,0,2,0,1,0,0,1,2,4,1,3,1,0,0
1799,781177,13,0,2,0,0,0,2,0,0,3,4,0,3,0,0,0,0
1799,786555,22,1,2,0,1,1,1,3,3,0,2,0,1,2,2,1,6
1799,785312,27,4,15,3,12,1,3,1,1,1,0,3,3,1,1,0,10
1799,797503,6,2,2,2,2,0,0,0,0,2,0,0,3,0,1,1,4
1800,791408,24,2,5,2,5,0,0,1,2,0,5,2,3,0,3,0,5
1800,786183,38,3,5,1,1,2,4,2,3,0,4,2,3,0,1,1,10
1800,780105,35,7,10,5,8,2,2,0,1,1,8,3,2,0,0,2,16
1800,785637,32,2,9,1,3,1,6,0,0,0,2,3,2,0,0,0,5
1800,785894,24,1,7,1,2,0,5,0,0,0,1,0,2,0,1,0,2
1800,785916,11,3,4,0,1,3,3,2,2,3,0,1,4,0,1,1,11
1800,785915,12,0,2,0,0,0,2,0,0,0,1,0,0,0,0,0,0
1800,781131,24,8,13,8,12,0,1,1,2,0,1,5,3,0,6,0,17
1801,775897,30,2,7,2,5,0,2,3,4,2,5,5,3,2,2,0,7
1801,780324,32,8,14,8,14,0,0,6,8,3,1,2,3,1,2,1,22
1801,786530,32,4,7,1,2,3,5,0,0,0,3,2,1,0,2,0,11
1801,784246,24,0,3,0,2,0,1,1,4,0,3,0,1,0,2,0,1
1801,780317,31,4,7,2,4,2,3,0,0,1,7,2,3,1,1,0,10
1801,791546,8,2,2,1,1,1,1,0,0,1,3,0,2,0,0,0,5
1801,791543,6,1,3,1,3,0,0,0,0,0,0,0,0,0,1,0,2
1801,797091,2,0,0,0,0,0,0,0,0,0,0,0,0,0,1,0,0
1801,791545,21,5,6,4,5,1,1,5,6,1,1,2,1,2,0,0,16
1801,786360,14,1,3,0,0,1,3,0,1,0,2,3,2,0,0,0,3
1802,775455,31,6,14,3,8,3,6,3,6,2,6,1,4,0,3,0,18
1802,792124,27,1,5,1,5,0,0,1,3,2,4,0,2,0,1,0,3
1802,792123,27,5,8,1,1,4,7,3,6,0,0,4,4,1,1,1,17
1802,786002,6,0,0,0,0,0,0,0,0,0,0,0,2,0,1,0,0
1802,781397,33,6,9,5,7,1,2,3,4,1,3,1,1,0,3,0,16
1802,792119,5,0,0,0,0,0,0,0,0,0,0,0,1,0,1,0,0
1802,797752,8,0,1,0,1,0,0,0,0,1,1,0,1,0,1,1,0
1802,797749,14,0,3,0,1,0,2,1,2,0,2,1,3,0,1,0,1
1802,792120,32,3,9,2,5,1,4,1,2,1,5,1,2,1,1,0,8
1802,786005,17,0,2,0,2,0,0,0,0,0,0,1,1,1,1,0,0
1803,786039,17,2,3,2,3,0,0,4,5,3,6,0,2,0,0,0,8
1803,792043,25,2,4,0,0,2,4,1,2,2,4,0,2,0,0,1,7
1803,786266,23,5,10,3,5,2,5,1,2,0,6,0,2,4,4,1,13
1803,792040,34,3,8,2,5,1,3,0,0,0,5,0,1,1,1,0,7
1803,775028,29,5,16,5,13,0,3,6,8,0,4,4,3,2,4,0,16
1803,797728,15,1,3,1,1,0,2,0,0,1,1,1,4,0,1,1,2
1803,797726,5,1,1,1,1,0,0,0,0,0,0,0,3,1,0,0,2
1803,792036,18,4,5,4,5,0,0,3,3,4,2,0,2,0,1,0,11
1803,797723,3,0,0,0,0,0,0,0,0,0,0,0,2,0,0,0,0
1803,797719,15,1,5,0,1,1,4,0,0,1,0,0,1,1,0,0,3
1803,797718,16,1,5,1,3,0,2,0,1,0,1,2,1,1,0,0,2
1804,792306,23,6,10,1,1,5,9,0,0,1,12,3,1,1,0,1,17
1804,786618,23,5,7,5,7,0,0,2,4,4,4,1,0,0,1,1,12
1804,797904,25,6,8,6,6,0,2,2,2,2,2,4,0,1,2,0,14
1804,792303,26,4,7,3,3,1,4,2,2,0,2,6,1,1,2,0,11
1804,781603,19,1,5,1,2,0,3,0,0,0,1,2,0,0,1,0,2
1804,797914,22,2,7,1,1,1,6,0,0,0,3,0,1,2,1,0,5
1804,790813,14,2,5,0,0,2,5,4,4,0,1,1,3,1,1,0,10
1804,781605,11,1,7,1,5,0,2,2,2,2,7,0,0,0,0,0,4
1804,796155,13,1,5,0,1,1,4,2,2,1,2,1,0,1,0,0,5
1804,797907,12,1,2,1,2,0,0,0,0,2,2,1,1,0,1,0,2
1804,792687,7,1,3,1,1,0,2,0,0,0,2,1,1,0,0,0,2
1804,781607,4,0,0,0,0,0,0,0,0,0,0,0,0,0,0,0,0
1804,797902,1,0,0,0,0,0,0,0,0,0,0,0,0,0,0,0,0
1805,799136,27,0,0,0,0,0,0,0,0,1,3,0,4,0,1,0,0
1805,799132,34,4,15,1,8,3,7,2,2,3,4,2,2,0,0,0,13
1805,799130,27,4,11,3,7,1,4,0,0,0,1,1,1,2,2,2,9
1805,799134,30,3,10,0,3,3,7,0,0,0,1,0,2,0,4,0,9
1805,792634,32,2,15,2,10,0,5,0,0,0,2,4,2,0,4,0,4
1805,799133,22,0,6,0,4,0,2,0,0,1,4,1,1,0,0,0,0
1805,799128,16,2,3,0,0,2,3,0,0,0,1,1,1,1,1,0,6
1805,799131,10,0,0,0,0,0,0,0,0,1,2,0,1,0,0,0,0
1805,799135,2,0,0,0,0,0,0,0,0,0,0,0,0,0,0,0,0
1806,792265,22,4,6,4,5,0,1,0,0,1,2,0,2,2,1,1,8
1806,797998,16,2,5,2,3,0,2,3,4,0,3,1,1,1,1,0,7
1806,786152,27,3,4,2,3,1,1,6,10,1,5,2,3,1,2,3,13
1806,798003,15,2,6,2,4,0,2,0,0,0,3,1,4,1,3,0,4
1806,798006,21,2,3,2,3,0,0,3,4,0,2,1,2,0,2,1,7
1806,798007,12,0,2,0,1,0,1,2,2,0,2,0,1,1,0,0,2
1806,798002,14,0,1,0,1,0,0,0,4,3,7,2,1,2,2,1,0
1806,798005,4,0,0,0,0,0,0,2,2,0,2,0,2,0,0,1,2
1806,792266,19,0,2,0,1,0,1,5,5,1,0,0,1,0,4,0,5
1806,797999,3,0,1,0,0,0,1,0,0,0,0,0,1,1,0,0,0
1806,798009,24,4,10,3,6,1,4,1,2,2,1,1,1,1,2,0,10
1806,797997,5,0,2,0,2,0,0,0,0,0,0,0,1,0,0,0,0
1806,792267,18,1,5,0,1,1,4,0,0,0,0,0,3,0,3,0,3
1808,791839,29,1,5,1,4,0,1,0,0,2,4,2,1,0,3,0,2
1808,776341,26,0,1,0,0,0,1,1,2,0,4,0,3,2,2,0,1
1808,792381,34,5,13,2,3,3,10,2,2,0,1,1,2,2,2,0,15
1808,786616,23,0,5,0,2,0,3,3,4,2,0,3,5,0,3,0,3
1808,786736,19,1,6,1,5,0,1,1,2,0,1,3,1,1,1,0,3
1808,791842,31,7,14,1,4,6,10,1,2,1,3,0,0,0,0,0,21
1808,785322,21,3,8,0,2,3,6,0,0,2,2,0,1,0,0,0,9
1808,786613,15,2,4,1,1,1,3,2,4,2,1,2,2,0,3,0,7
1808,797444,2,0,0,0,0,0,0,0,0,0,0,0,0,0,0,0,0
1809,780351,25,5,9,5,9,0,0,1,1,4,3,3,3,0,2,0,11
1809,790857,30,2,8,2,4,0,4,1,2,0,2,2,2,3,0,0,5
1809,780586,29,8,14,6,12,2,2,5,6,6,6,1,1,0,2,0,23
1809,797549,24,1,3,1,3,0,0,2,2,1,4,4,2,0,1,1,4
1809,791715,20,3,6,2,2,1,4,1,2,1,6,0,4,0,2,0,8
1809,797546,22,5,9,5,9,0,0,0,0,3,2,2,1,1,4,1,10
1809,785855,15,0,3,0,1,0,2,0,0,1,2,0,0,0,1,1,0
1809,797544,13,4,11,3,8,1,3,0,0,3,3,0,2,1,2,0,9
1809,797540,9,1,3,1,1,0,2,0,0,0,0,0,1,1,0,0,2
1809,791716,11,0,0,0,0,0,0,0,0,0,0,0,0,0,1,0,0
1809,789065,2,0,0,0,0,0,0,0,0,0,0,0,0,0,0,0,0
1810,791001,31,4,9,2,3,2,6,2,2,0,2,4,1,4,3,0,12
1810,779972,34,3,12,2,6,1,6,0,0,2,6,6,2,2,0,1,7
1810,775255,30,7,14,2,7,5,7,4,5,0,5,0,3,0,4,0,23
1810,781159,30,5,10,3,6,2,4,3,4,1,3,1,4,1,4,0,15
1810,781174,29,1,7,1,7,0,0,0,1,4,6,2,3,1,1,0,2
1810,785320,27,3,6,2,3,1,3,0,1,0,2,2,1,0,0,0,7
1810,796643,15,1,2,1,2,0,0,0,0,2,4,1,2,1,0,0,2
1810,796644,4,1,1,1,1,0,0,0,0,0,1,0,2,0,0,0,2
1811,787782,23,2,8,2,4,0,4,3,3,0,2,3,4,2,2,0,7
1811,791540,38,2,11,1,4,1,7,0,1,0,2,5,3,0,3,0,5
1811,781463,31,3,7,2,3,1,4,0,0,3,8,1,3,0,3,3,7
1811,776068,33,4,11,2,5,2,6,8,8,0,3,2,4,1,5,0,18
1811,783072,28,6,7,4,5,2,2,3,5,1,3,0,2,2,1,0,17
1811,797817,15,1,2,1,1,0,1,1,1,0,3,0,0,3,0,0,3
1811,792153,11,1,2,1,1,0,1,0,0,1,0,0,0,0,0,0,2
1811,781202,9,0,1,0,1,0,0,0,0,0,1,0,1,0,2,0,0
1811,774879,12,0,3,0,3,0,0,0,0,0,1,0,0,0,0,0,0
1812,776374,30,5,12,5,12,0,0,3,4,0,4,5,1,2,1,0,13
1812,796718,25,3,4,1,1,2,3,0,0,0,3,1,5,0,4,1,8
1812,796719,21,1,1,1,1,0,0,4,4,4,4,1,1,0,0,0,6
1812,775412,33,2,5,0,0,2,5,2,2,0,2,0,2,1,4,1,8
1812,785512,7,0,3,0,3,0,0,0,0,0,2,0,2,0,1,0,0
1812,796717,21,1,7,1,7,0,0,0,0,0,2,2,4,1,1,0,2
1812,796720,2,0,0,0,0,0,0,0,0,0,0,0,1,0,1,0,0
1812,791042,25,4,10,4,8,0,2,9,10,1,6,0,4,0,4,3,17
1812,796723,29,7,12,7,9,0,3,3,6,2,6,2,1,1,1,1,17
1812,766998,7,1,2,1,2,0,0,0,0,0,2,0,2,0,0,0,2
1813,797342,10,1,1,1,1,0,0,0,0,0,1,0,3,1,1,1,2
1813,791746,30,1,6,1,4,0,2,2,4,1,4,1,1,1,2,2,4
1813,791747,34,9,21,6,11,3,10,3,4,1,3,1,3,0,2,0,24
1813,786188,32,5,13,4,11,1,2,7,11,1,6,2,4,3,4,0,18
1813,791743,31,4,9,4,9,0,0,5,9,2,6,0,4,0,2,0,13
1813,780711,5,0,0,0,0,0,0,0,0,0,1,0,1,0,0,0,0
1813,797341,7,0,3,0,2,0,1,0,0,1,0,0,0,0,1,0,0
1813,786184,22,0,3,0,1,0,2,4,4,0,1,1,4,1,0,0,4
1813,797345,5,0,1,0,1,0,0,0,0,0,0,0,0,0,0,0,0
1813,786193,24,2,5,0,1,2,4,0,1,2,2,2,1,1,1,0,6
1814,797831,34,4,12,1,3,3,9,1,2,0,7,1,1,1,5,1,12
1814,792283,6,0,1,0,0,0,1,0,0,0,1,1,0,0,1,0,0
1814,797823,22,1,3,1,3,0,0,0,0,0,6,1,3,0,0,1,2
1814,792280,32,8,12,7,9,1,3,1,2,2,3,2,2,1,1,0,18
1814,780505,25,5,13,3,8,2,5,4,7,1,4,3,5,1,2,1,16
1814,799468,15,0,0,0,0,0,0,0,2,0,0,1,1,1,0,0,0
1814,792284,30,0,3,0,2,0,1,0,0,0,3,5,2,0,2,0,0
1814,792286,18,3,3,3,3,0,0,0,0,1,3,0,3,0,1,2,6
1814,797826,18,3,4,2,2,1,2,8,11,0,2,0,1,1,1,0,15
1815,790784,24,2,7,1,4,1,3,3,3,3,1,1,2,3,2,0,8
1815,786548,25,4,11,4,11,0,0,4,4,3,8,0,5,2,0,2,12
1815,791871,10,0,2,0,0,0,2,0,0,0,0,2,1,0,4,0,0
1815,786719,27,3,14,3,12,0,2,2,2,3,1,0,3,1,1,0,8
1815,775229,20,1,10,0,5,1,5,2,2,0,2,0,0,0,2,0,5
1815,786235,9,2,3,2,3,0,0,0,0,0,2,0,4,0,1,0,4
1815,786229,16,0,2,0,1,0,1,0,0,0,3,0,1,0,0,0,0
1815,776219,21,1,2,1,1,0,1,1,2,2,2,0,1,0,0,1,3
1815,797475,23,6,10,4,7,2,3,4,5,1,2,2,3,2,1,0,18
1815,786581,17,1,4,1,2,0,2,0,0,1,1,0,1,0,0,0,2
1815,786770,8,0,1,0,1,0,0,0,0,0,0,0,1,0,1,0,0
1816,785841,27,5,14,5,12,0,2,0,0,2,2,0,2,0,4,0,10
1816,781504,31,8,17,6,12,2,5,6,6,0,5,1,3,3,2,0,24
1816,796609,27,3,14,3,13,0,1,0,2,2,3,6,1,6,0,0,6
1816,791312,21,2,8,2,8,0,0,3,4,4,1,0,3,0,3,2,7
1816,785664,23,6,8,6,8,0,0,1,2,6,3,0,4,1,0,0,13
1816,785840,5,0,0,0,0,0,0,0,0,0,0,0,0,0,0,0,0
1816,796611,23,2,5,2,2,0,3,1,1,0,2,0,1,2,1,0,5
1816,796613,17,2,4,2,2,0,2,0,0,0,5,0,3,0,1,0,4
1816,780728,1,0,0,0,0,0,0,0,0,0,0,0,0,0,0,0,0
1816,766623,24,1,1,1,1,0,0,4,4,1,1,1,2,4,2,0,6
1816,796620,1,0,0,0,0,0,0,0,0,0,0,0,0,0,0,0,0
1817,785505,29,3,12,3,8,0,4,2,2,3,5,8,1,1,5,1,8
1817,780555,37,3,9,1,1,2,8,0,0,0,2,6,2,1,2,0,8
1817,775604,37,6,11,2,3,4,8,6,9,0,1,0,2,2,3,0,22
1817,780797,34,5,7,2,3,3,4,0,3,4,12,2,1,1,6,0,13
1817,776418,15,1,4,1,4,0,0,1,2,2,1,0,2,0,1,4,3
1817,796981,18,4,6,2,2,2,4,0,2,0,0,0,4,2,4,0,10
1817,796984,8,0,0,0,0,0,0,0,0,0,1,0,2,0,0,0,0
1817,791616,22,6,7,5,6,1,1,0,0,1,2,1,1,1,1,0,13
1818,781403,33,3,7,2,5,1,2,0,0,0,4,2,3,1,0,1,7
1818,792654,38,7,9,7,9,0,0,3,4,4,6,1,3,1,1,9,17
1818,797301,43,6,14,4,8,2,6,8,9,0,3,2,3,3,3,0,22
1818,780524,36,7,9,4,5,3,4,2,2,1,4,5,2,1,6,0,19
1818,781400,38,7,14,4,8,3,6,3,5,0,1,5,1,2,1,0,20
1818,786857,21,2,7,2,5,0,2,0,0,0,5,1,3,1,4,0,4
1818,792653,5,0,0,0,0,0,0,1,2,0,1,0,1,0,0,0,1
1818,797302,3,0,0,0,0,0,0,0,0,0,1,0,0,0,0,0,0
1818,797303,8,2,3,0,0,2,3,1,2,0,0,1,3,0,1,0,7
1819,785608,32,10,18,10,17,0,1,6,6,7,7,1,3,1,4,2,26
1819,797709,32,1,7,0,4,1,3,4,6,0,1,2,2,1,3,0,7
1819,792104,38,3,11,3,9,0,2,7,9,2,10,2,3,2,4,0,13
1819,797708,34,6,12,6,10,0,2,4,6,1,2,6,5,2,1,0,16
1819,786198,40,5,9,5,9,0,0,3,4,0,2,6,2,3,1,0,13
1819,775779,19,2,9,2,8,0,1,0,2,1,1,2,1,2,0,0,4
1819,786204,13,4,6,2,3,2,3,0,0,2,1,1,2,1,1,0,10
1819,776327,7,1,2,1,2,0,0,0,0,3,1,0,0,0,0,0,2
1819,797707,10,1,2,0,1,1,1,0,0,0,0,1,2,0,1,0,3
1822,797143,32,11,15,8,10,3,5,0,0,0,6,5,2,3,2,0,25
1822,797142,25,3,3,3,3,0,0,0,1,3,1,0,0,2,1,0,6
1822,786351,29,6,12,4,5,2,7,2,2,3,7,2,4,2,3,0,16
1822,791520,32,2,10,2,8,0,2,0,0,3,4,2,1,3,1,0,4
1822,797146,32,5,17,3,9,2,8,7,8,0,3,2,2,0,2,0,19
1822,786348,11,1,2,1,2,0,0,0,0,2,2,0,2,0,1,1,2
1822,786771,3,0,0,0,0,0,0,0,0,0,1,1,2,0,1,0,0
1822,797147,11,0,3,0,2,0,1,2,2,0,2,1,0,0,2,0,2
1822,785816,14,2,2,2,2,0,0,1,2,4,4,0,3,0,2,0,5
1822,797144,11,3,4,2,3,1,1,2,2,0,1,1,1,2,2,0,9
1823,797364,9,2,3,2,3,0,0,0,0,0,1,0,2,0,0,0,4
1823,791807,30,6,15,4,8,2,7,2,2,0,2,2,0,0,2,0,16
1823,786130,30,3,12,1,3,2,9,5,6,0,3,1,4,1,4,0,13
1823,797367,26,3,5,3,5,0,0,2,2,2,4,0,4,0,1,0,8
1823,797366,24,3,4,3,4,0,0,3,3,2,3,5,3,2,4,0,9
1823,797363,16,2,9,1,5,1,4,0,0,0,2,2,1,0,2,0,5
1823,797369,19,0,3,0,0,0,3,0,0,2,1,1,2,1,3,0,0
1823,791808,9,0,1,0,1,0,0,0,0,1,0,0,1,0,1,0,0
1823,797368,3,0,1,0,1,0,0,0,0,0,0,0,0,0,0,0,0
1823,797365,25,3,9,0,0,3,9,0,0,1,2,1,1,0,2,0,9
1823,797371,9,1,1,1,1,0,0,0,2,1,2,1,1,0,1,0,2
1824,791858,18,4,8,3,7,1,1,3,5,3,2,2,2,1,2,0,12
1824,797464,28,2,4,2,4,0,0,3,4,1,6,1,4,1,0,1,7
1824,797469,19,4,6,2,2,2,4,0,0,1,3,1,3,2,3,0,10
1824,797463,28,7,14,5,10,2,4,4,4,2,6,3,1,3,1,1,20
1824,791854,35,7,12,6,9,1,3,2,3,0,6,3,4,1,0,0,17
1824,797468,21,1,4,1,4,0,0,0,0,1,5,2,3,1,2,0,2
1824,791859,4,0,2,0,0,0,2,0,0,0,2,0,2,0,0,0,0
1824,797467,9,2,7,2,7,0,0,0,0,2,1,0,3,0,1,0,4
1824,797465,10,1,2,1,1,0,1,0,0,0,3,2,2,0,0,1,2
1824,791857,16,2,5,1,3,1,2,1,2,0,1,1,1,0,0,0,6
1824,789074,8,1,5,0,0,1,5,0,0,0,0,0,0,0,0,0,3
1824,799688,4,1,1,1,1,0,0,0,1,2,0,0,0,0,0,0,2
1826,797292,30,2,5,2,5,0,0,2,2,0,10,2,2,1,1,2,6
1826,791661,19,5,7,5,6,0,1,1,2,0,1,0,1,0,1,1,11
1826,797290,29,2,5,0,2,2,3,2,4,0,7,1,3,0,0,1,8
1826,791660,31,2,3,0,0,2,3,2,2,1,0,3,3,2,5,1,8
1826,786064,32,4,9,4,5,0,4,5,5,3,5,2,2,1,3,0,13
1826,791658,6,0,1,0,1,0,0,0,0,1,1,1,2,0,0,1,0
1826,780509,23,3,6,3,5,0,1,6,8,1,5,1,1,0,4,1,12
1826,797293,3,0,0,0,0,0,0,0,0,0,1,0,0,1,2,0,0
1826,797291,27,5,9,5,6,0,3,7,9,0,1,3,3,1,3,1,17
1827,791230,26,3,9,2,5,1,4,0,0,2,4,1,4,2,1,0,7
1827,785557,31,6,13,4,8,2,5,3,5,0,3,1,5,3,3,1,17
1827,791228,21,6,8,6,7,0,1,1,2,2,4,0,4,1,1,0,13
1827,796932,33,7,16,6,10,1,6,1,2,0,1,5,4,0,2,1,16
1827,785624,38,0,7,0,3,0,4,2,2,0,1,2,4,1,1,0,2
1827,791227,20,1,3,1,1,0,2,0,0,0,2,0,0,0,2,0,2
1827,796935,9,1,4,1,1,0,3,0,0,1,2,0,2,2,0,1,2
1827,791226,9,0,0,0,0,0,0,1,2,0,1,0,2,1,2,1,1
1827,781201,6,1,2,1,2,0,0,0,0,0,1,0,2,1,1,0,2
1827,781198,7,0,2,0,2,0,0,0,0,0,0,2,0,0,0,0,0
1828,791299,32,6,11,6,11,0,0,1,1,5,3,2,1,1,2,2,13
1828,791296,39,6,13,5,8,1,5,4,5,0,2,2,0,0,1,0,17
1828,775871,35,3,8,3,6,0,2,4,4,5,6,1,3,1,2,0,10
1828,791519,38,7,13,6,9,1,4,6,8,0,8,5,1,0,2,2,21
1828,781390,33,2,5,1,1,1,4,2,2,2,1,0,4,0,2,1,7
1828,786276,12,2,2,0,0,2,2,2,3,0,0,0,0,0,0,0,8
1828,780525,7,0,0,0,0,0,0,0,0,1,1,0,2,1,1,0,0
1828,791298,27,4,9,4,7,0,2,0,0,0,1,2,1,5,1,0,8
1828,796591,2,0,1,0,1,0,0,0,0,0,0,0,0,0,0,0,0
1828,796590,0,0,0,0,0,0,0,0,0,0,0,0,0,0,0,0,0
1829,792110,22,4,5,4,5,0,0,2,3,3,1,1,4,0,1,0,10
1829,786031,34,5,8,4,6,1,2,2,2,3,2,1,4,1,1,0,13
1829,797734,38,7,16,7,14,0,2,2,2,1,4,4,1,2,4,0,16
1829,786036,37,1,4,1,1,0,3,0,0,0,1,4,3,1,1,0,2
1829,781386,41,10,21,9,16,1,5,3,4,0,5,1,0,1,0,0,24
1829,786033,23,4,4,4,4,0,0,0,0,2,1,0,3,0,0,5,8
1829,797733,13,0,2,0,1,0,1,2,2,0,2,1,1,0,1,0,2
1829,792109,11,0,2,0,0,0,2,4,4,0,0,0,3,1,1,0,4
1829,792105,6,2,3,0,0,2,3,0,0,0,0,0,1,0,0,0,6
1830,791610,20,7,8,7,8,0,0,2,4,1,5,5,2,0,1,0,16
1830,780471,28,8,16,8,15,0,1,0,1,7,10,2,2,1,3,1,16
1830,796994,23,1,4,1,2,0,2,0,0,0,0,8,1,0,1,0,2
1830,791608,22,3,11,0,0,3,11,0,0,1,1,2,2,1,1,0,9
1830,776011,25,6,8,4,6,2,2,2,2,3,2,5,1,2,0,0,16
1830,796996,14,4,6,4,6,0,0,3,3,4,5,1,0,0,0,0,11
1830,786413,8,1,2,1,1,0,1,0,0,0,0,0,0,0,0,0,2
1830,791613,20,5,12,4,10,1,2,4,4,3,1,2,2,0,0,0,15
1830,791612,3,1,1,1,1,0,0,0,0,0,0,0,0,1,0,0,2
1830,791611,5,3,3,2,2,1,1,0,1,0,1,0,0,1,0,0,7
1830,786353,21,4,8,2,3,2,5,0,0,1,0,3,1,1,1,0,10
1830,785680,8,2,5,2,3,0,2,0,0,0,0,2,0,1,0,0,4
1830,780417,3,0,0,0,0,0,0,0,0,0,0,1,0,0,0,0,0
1832,796592,25,4,5,4,4,0,1,0,1,3,2,1,2,1,2,0,8
1832,780210,38,12,19,10,14,2,5,5,5,2,6,0,1,1,2,0,31
1832,796594,23,8,11,4,6,4,5,0,0,0,1,1,4,2,1,0,20
1832,792432,35,2,4,2,3,0,1,0,0,0,2,7,0,4,3,0,4
1832,775005,35,4,11,1,4,3,7,2,2,2,3,2,3,1,5,1,13
1832,791306,17,1,2,1,2,0,0,1,3,0,2,2,2,0,2,0,3
1832,792433,14,1,5,0,2,1,3,0,0,1,1,1,0,1,2,0,3
1832,786422,13,0,2,0,2,0,0,0,0,0,0,4,4,0,0,0,0
1834,785714,31,2,5,2,5,0,0,3,5,0,4,1,5,1,0,2,7
1834,775894,33,6,7,4,4,2,3,3,6,3,3,3,0,1,2,1,17
1834,785711,33,4,13,4,6,0,7,0,0,0,2,5,1,2,2,0,8
1834,780985,38,9,15,1,1,8,14,0,1,0,6,3,0,1,1,0,26
1834,775266,31,5,13,1,5,4,8,7,10,4,0,1,4,1,1,0,21
1834,796829,5,0,0,0,0,0,0,0,0,0,1,0,4,0,0,0,0
1834,791167,13,0,2,0,2,0,0,0,0,0,0,1,2,1,0,0,0
1834,785378,15,2,3,2,3,0,0,0,1,1,0,2,1,0,0,0,4
1834,780988,1,0,0,0,0,0,0,1,2,0,1,0,0,0,0,1,1
1835,797050,28,6,10,6,8,0,2,2,4,6,4,3,0,0,1,2,14
1835,780394,22,2,5,1,3,1,2,0,2,2,1,2,5,1,0,0,5
1835,780391,20,3,3,3,3,0,0,1,2,0,6,1,4,0,2,1,7
1835,790871,34,6,13,1,6,5,7,3,4,0,5,5,4,2,3,0,20
1835,776473,38,5,9,3,4,2,5,6,7,0,3,4,4,1,3,1,18
1835,797048,31,3,10,3,9,0,1,5,7,4,5,1,1,0,1,1,11
1835,780392,27,5,6,1,2,4,4,0,0,1,3,3,4,1,2,0,14
1836,775640,19,4,6,3,4,1,2,3,3,1,3,1,1,1,1,3,12
1836,780919,21,5,7,5,7,0,0,4,6,1,7,1,1,0,3,1,14
1836,785803,21,3,5,3,5,0,0,1,1,0,1,0,1,0,2,1,7
1836,780920,27,8,10,5,6,3,4,0,0,0,5,7,0,1,1,0,19
1836,780914,18,1,4,0,3,1,1,0,0,0,3,1,3,0,0,0,3
1836,796797,13,1,5,1,4,0,1,1,2,3,1,0,4,2,2,1,3
1836,791141,18,3,7,3,5,0,2,0,0,0,1,3,0,2,1,1,6
1836,775816,22,3,5,2,4,1,1,2,2,0,5,0,0,0,1,0,9
1836,791142,20,3,6,3,6,0,0,0,0,1,1,1,1,2,1,0,6
1836,796801,8,0,3,0,2,0,1,0,1,0,0,2,1,2,0,1,0
1836,796796,4,1,2,1,1,0,1,0,0,1,0,0,0,0,0,0,2
1836,775639,2,0,0,0,0,0,0,0,0,0,0,0,1,0,1,0,0
1836,796799,7,0,0,0,0,0,0,0,0,0,1,0,0,0,0,0,0
1837,786509,28,2,5,2,5,0,0,2,4,1,7,0,2,0,2,0,6
1837,786508,26,4,12,1,5,3,7,0,0,3,2,1,3,2,3,0,11
1837,786507,27,2,8,2,7,0,1,2,2,1,2,1,1,0,1,0,6
1837,785796,24,2,9,2,6,0,3,1,2,0,1,1,2,0,5,1,5
1837,797576,32,2,5,1,4,1,1,2,2,0,2,0,2,1,3,0,7
1837,797582,2,0,1,0,1,0,0,0,0,1,0,0,1,0,0,0,0
1837,781325,15,0,5,0,3,0,2,0,0,0,0,1,1,0,1,0,0
1837,797580,8,1,2,0,0,1,2,0,0,0,1,0,1,0,1,0,3
1837,791897,16,1,2,1,2,0,0,0,0,1,2,1,2,0,2,0,2
1837,786511,5,0,1,0,0,0,1,0,0,0,0,0,1,0,0,0,0
1837,786505,6,1,2,0,1,1,1,0,0,0,0,0,0,0,2,0,3
1837,791896,4,0,0,0,0,0,0,0,0,0,1,0,2,0,1,0,0
1837,797577,4,0,0,0,0,0,0,2,2,0,1,0,0,0,0,1,2
1837,797579,3,0,0,0,0,0,0,0,0,0,0,1,0,0,0,0,0
1840,796759,22,3,6,3,5,0,1,2,3,1,5,0,2,1,0,4,8
1840,796758,20,6,10,6,10,0,0,3,6,4,4,0,1,3,1,0,15
1840,791101,22,4,8,3,5,1,3,0,0,1,5,3,1,3,0,0,9
1840,791105,19,2,8,2,8,0,0,3,4,1,1,4,0,3,1,0,7
1840,780794,20,3,5,2,2,1,3,0,1,0,2,0,3,1,0,0,7
1840,796761,18,2,4,2,4,0,0,1,1,3,4,0,4,1,4,0,5
1840,798158,5,1,2,1,2,0,0,0,0,1,1,0,0,0,0,0,2
1840,780109,21,3,5,2,3,1,2,3,9,0,5,2,1,4,2,0,10
1840,796760,8,2,2,1,1,1,1,0,0,0,0,1,0,1,0,0,5
1840,796757,17,5,7,4,6,1,1,0,0,0,4,0,2,0,2,0,11
1840,791104,7,3,4,2,2,1,2,1,1,0,1,0,0,1,0,0,8
1840,785597,21,2,8,2,5,0,3,0,0,0,1,4,4,3,1,0,4
1842,785622,29,4,7,1,1,3,6,3,4,1,2,0,0,0,3,0,14
1842,781058,31,5,9,5,7,0,2,1,3,2,8,0,0,1,0,0,11
1842,780327,26,1,2,1,2,0,0,2,2,6,0,0,3,0,1,2,4
1842,797451,22,4,11,4,11,0,0,4,7,1,1,2,3,0,2,0,12
1842,791849,26,1,7,1,3,0,4,5,5,0,3,1,2,3,3,0,7
1842,791848,4,0,0,0,0,0,0,0,0,0,1,2,1,0,0,0,0
1842,797455,12,3,3,3,3,0,0,0,1,1,2,0,1,0,1,0,6
1842,797458,27,1,5,0,2,1,3,4,4,0,2,2,2,1,2,0,7
1842,797453,2,0,0,0,0,0,0,1,2,0,0,0,0,0,0,0,1
1842,786607,21,2,3,1,1,1,2,0,0,0,0,2,3,1,0,1,5
1843,797174,12,0,0,0,0,0,0,0,0,1,0,1,5,0,1,1,0
1843,791510,27,1,4,0,1,1,3,2,2,1,4,2,3,0,2,0,5
1843,791507,14,1,1,1,1,0,0,2,2,1,0,0,3,0,0,0,4
1843,797168,30,3,8,1,4,2,4,0,0,1,3,3,4,0,4,0,8
1843,775357,34,10,19,3,7,7,12,2,3,0,4,5,3,2,3,0,29
1843,791509,3,1,1,1,1,0,0,0,0,0,1,0,0,0,0,0,2
1843,791506,26,1,8,0,0,1,8,0,0,0,1,0,1,0,1,0,3
1843,786699,23,2,4,2,4,0,0,2,3,1,2,1,2,0,0,1,6
1843,798345,6,1,1,0,0,1,1,0,0,0,1,1,1,0,0,0,3
1843,791508,5,0,0,0,0,0,0,0,0,0,0,0,2,0,0,0,0
1843,791504,7,0,1,0,1,0,0,0,0,0,0,0,0,0,0,0,0
1843,791505,13,2,2,0,0,2,2,0,0,0,3,2,3,0,2,0,6
1844,791585,32,6,10,3,5,3,5,5,6,1,7,2,3,1,4,1,20
1844,780062,20,3,6,3,6,0,0,1,2,3,2,0,2,0,1,2,7
1844,786395,37,3,11,3,8,0,3,6,6,0,1,1,1,1,0,0,12
1844,786394,28,3,8,3,5,0,3,0,0,2,5,3,0,1,3,0,6
1844,780404,31,3,13,3,9,0,4,0,1,2,6,2,3,1,1,0,6
1844,785228,19,2,7,1,3,1,4,0,0,1,0,1,3,0,0,0,5
1844,797041,9,1,3,1,3,0,0,1,1,1,3,0,3,0,0,0,3
1844,791581,22,0,3,0,2,0,1,1,2,1,1,1,1,0,0,1,1
1844,791582,2,0,0,0,0,0,0,0,0,0,0,0,0,0,0,0,0
1845,797389,21,3,6,3,6,0,0,0,2,1,4,0,2,0,2,1,6
1845,791826,24,0,1,0,1,0,0,3,4,0,2,4,3,0,0,0,3
1845,786785,30,10,17,5,9,5,8,2,5,0,5,4,2,1,1,1,27
1845,786784,35,2,8,2,5,0,3,0,2,1,2,2,4,2,2,0,4
1845,776009,35,5,11,4,9,1,2,0,1,0,1,3,1,2,3,0,11
1845,780634,25,4,4,4,4,0,0,2,2,3,13,2,4,0,0,3,10
1845,780633,28,5,13,2,7,3,6,0,0,2,1,3,1,0,0,0,13
1845,780635,2,0,0,0,0,0,0,0,0,0,0,0,1,0,0,0,0
1846,781319,18,7,11,7,10,0,1,5,7,3,5,0,2,0,1,0,19
1846,792220,21,2,6,2,3,0,3,0,0,0,3,3,3,1,1,0,4
1846,786691,25,6,13,2,7,4,6,0,0,3,6,3,3,0,1,0,16
1846,786693,20,2,4,2,2,0,2,2,2,0,4,0,3,2,1,1,6
1846,781455,21,0,1,0,1,0,0,2,2,0,1,4,0,2,0,0,2
1846,797876,16,2,2,2,2,0,0,1,5,0,6,0,2,0,1,0,5
1846,792222,13,5,8,3,4,2,4,2,3,1,0,1,1,2,1,0,14
1846,786843,10,1,2,1,2,0,0,2,3,2,1,0,1,0,0,0,4
1846,781408,17,2,4,0,2,2,2,3,4,2,4,2,2,1,0,2,9
1846,792046,17,2,9,2,5,0,4,0,0,0,3,5,2,2,2,0,4
1846,792447,3,0,1,0,1,0,0,0,0,0,0,0,0,0,0,0,0
1846,792221,15,2,3,0,0,2,3,0,0,1,0,1,0,1,0,0,6
1846,776059,4,0,1,0,0,0,1,0,0,0,0,1,0,1,0,0,0
1848,786447,18,2,6,2,4,0,2,2,2,1,2,0,3,1,0,0,6
1848,775074,30,4,5,4,5,0,0,1,3,3,6,1,3,1,5,3,9
1848,786448,28,2,11,1,5,1,6,7,8,2,6,4,4,2,1,0,12
1848,780731,24,1,9,1,5,0,4,0,1,0,0,1,1,1,1,0,2
1848,780462,37,5,14,3,9,2,5,8,9,0,4,4,1,2,0,0,20
1848,791631,12,1,4,1,2,0,2,0,0,0,3,1,3,1,1,2,2
1848,786132,20,5,8,5,7,0,1,2,2,4,2,1,0,0,1,0,12
1848,796971,15,1,6,0,2,1,4,0,0,1,0,2,0,0,0,0,3
1848,791632,4,0,0,0,0,0,0,0,0,0,0,0,1,0,1,0,0
1848,775121,8,0,1,0,0,0,1,0,0,0,2,0,4,0,0,0,0
1848,791634,3,1,1,1,1,0,0,0,1,1,0,0,0,0,0,1,2
1848,791630,1,0,0,0,0,0,0,0,0,0,0,0,0,0,0,0,0
1849,781208,19,1,4,1,3,0,1,1,2,0,2,0,0,0,1,0,3
1849,775489,29,3,8,2,4,1,4,0,1,0,5,1,2,0,5,0,7
1849,785561,18,1,3,1,3,0,0,3,4,0,0,0,5,0,1,0,5
1849,780313,37,5,12,3,7,2,5,2,3,0,3,3,3,0,3,0,14
1849,780766,17,0,2,0,2,0,0,2,2,0,1,4,5,0,4,0,2
1849,780758,20,2,3,2,3,0,0,0,1,0,7,1,1,1,1,0,4
1849,785563,28,3,10,3,8,0,2,2,2,2,5,1,3,2,2,0,8
1849,785560,11,0,2,0,1,0,1,2,2,0,1,0,2,0,1,0,2
1849,791088,17,2,3,1,1,1,2,4,4,1,3,1,0,0,2,0,9
1849,796751,1,0,0,0,0,0,0,0,0,0,0,0,1,0,1,0,0
1849,796750,2,0,1,0,0,0,1,0,0,0,0,0,0,0,0,0,0
1849,791087,1,0,0,0,0,0,0,0,0,0,0,0,0,0,0,0,0
1850,791147,20,1,3,1,2,0,1,0,0,2,4,0,3,0,1,1,2
1850,785782,24,3,8,0,2,3,6,0,0,0,4,0,1,1,0,1,9
1850,791145,31,5,11,4,7,1,4,3,3,1,7,4,1,1,1,1,14
1850,791146,33,8,11,6,8,2,3,5,5,0,5,9,1,0,2,0,23
1850,785777,28,5,9,3,5,2,4,0,0,0,2,4,3,4,1,0,12
1850,798159,2,1,1,0,0,1,1,0,0,0,0,0,0,0,0,0,3
1850,791144,20,5,6,5,6,0,0,2,4,1,3,1,0,0,1,1,12
1850,796804,17,2,4,1,3,1,1,1,2,0,1,1,2,0,0,0,6
1850,791148,15,3,7,3,6,0,1,1,2,1,1,0,1,0,1,0,7
1850,786748,9,1,2,0,1,1,1,0,0,1,1,1,3,0,0,0,3
1850,796803,1,0,0,0,0,0,0,0,0,0,0,0,0,0,0,0,0
1851,797587,23,2,3,2,3,0,0,1,2,1,6,2,1,0,1,0,5
1851,781078,18,3,3,2,2,1,1,1,1,0,1,1,4,0,1,0,8
1851,786502,34,6,16,5,10,1,6,5,6,0,2,1,1,1,3,0,18
1851,781561,22,0,2,0,0,0,2,0,0,1,1,1,1,0,1,0,0
1851,781080,29,4,9,2,3,2,6,2,2,0,3,2,1,3,1,0,12
1851,797586,6,0,0,0,0,0,0,0,0,0,1,0,1,1,0,2,0
1851,791891,12,1,2,0,0,1,2,0,0,1,2,1,4,0,2,2,3
1851,791894,11,1,1,1,1,0,0,0,0,0,2,0,0,0,1,0,2
1851,786501,19,1,8,1,3,0,5,0,0,1,0,0,2,0,1,0,2
1851,797584,12,0,2,0,1,0,1,0,0,0,2,0,0,0,1,0,0
1851,791895,12,1,7,1,6,0,1,0,0,0,2,0,0,0,1,0,2
1851,797583,1,0,0,0,0,0,0,0,0,0,0,0,0,0,0,0,0
1851,791892,1,0,0,0,0,0,0,0,0,0,0,0,0,0,0,0,0
1852,782643,24,2,5,2,5,0,0,1,2,0,6,1,2,0,1,4,5
1852,776037,27,3,5,3,5,0,0,2,2,2,1,1,2,0,1,0,8
1852,786147,32,2,10,0,2,2,8,0,0,1,4,2,3,1,4,1,6
1852,780667,27,3,12,1,5,2,7,4,4,0,2,1,0,0,3,0,12
1852,775680,27,6,14,1,4,5,10,5,8,0,2,1,1,1,1,0,22
1852,791758,4,1,1,1,1,0,0,0,0,0,1,0,0,0,0,0,2
1852,785987,24,3,7,1,3,2,4,1,1,1,3,4,3,0,2,1,9
1852,780588,16,3,4,3,4,0,0,0,2,2,4,0,1,1,0,0,6
1852,791759,13,1,4,1,2,0,2,0,0,0,3,2,3,1,0,0,2
1852,785229,6,0,1,0,0,0,1,0,0,0,0,0,1,0,0,0,0
1853,791699,32,3,5,3,5,0,0,0,0,0,4,0,1,0,0,0,6
1853,797523,30,0,3,0,2,0,1,5,6,1,5,5,2,1,1,1,5
1853,785402,11,1,2,1,2,0,0,1,1,0,2,0,5,0,4,1,3
1853,792118,36,9,18,7,13,2,5,5,5,0,6,7,1,2,1,0,25
1853,782593,33,9,19,2,8,7,11,2,2,0,4,2,2,3,1,0,27
1853,785828,14,0,2,0,1,0,1,0,0,0,1,0,4,0,1,1,0
1853,791702,8,0,1,0,1,0,0,0,0,0,4,0,2,0,1,0,0
1853,797525,9,2,2,2,2,0,0,2,3,0,0,0,0,0,1,0,6
1853,797526,12,2,3,1,2,1,1,0,0,0,1,0,2,0,0,0,5
1853,792663,5,0,0,0,0,0,0,0,0,0,0,0,0,0,1,0,0
1853,791700,10,1,4,1,2,0,2,0,0,0,1,0,0,0,0,0,2
1864,797849,31,7,8,6,6,1,2,4,6,1,5,3,1,1,1,1,19
1864,781537,29,4,10,3,8,1,2,3,4,4,7,2,3,1,1,1,12
1864,797843,32,6,11,4,6,2,5,0,0,0,5,3,0,2,1,0,14
1864,792202,17,1,5,1,2,0,3,0,0,0,1,0,0,0,0,0,2
1864,786079,27,2,6,1,3,1,3,2,2,3,3,4,3,2,0,0,7
1864,792201,16,0,3,0,3,0,0,3,4,1,5,0,4,0,1,7,3
1864,797846,27,7,15,4,8,3,7,0,1,1,2,1,3,2,3,2,17
1864,797842,21,3,9,3,9,0,0,15,17,5,1,1,4,1,1,0,21
1866,786616,29,4,8,2,5,2,3,4,4,1,1,1,1,1,0,0,14
1866,786736,29,3,7,1,3,2,4,0,0,0,3,5,0,3,2,0,8
1866,791839,26,3,5,3,5,0,0,2,2,10,6,4,2,1,0,0,8
1866,792381,28,1,7,1,1,0,6,2,2,0,1,4,2,3,2,1,4
1866,776341,19,2,7,2,6,0,1,0,0,2,1,0,1,1,0,0,4
1866,791842,22,12,20,6,11,6,9,5,7,2,4,0,1,0,3,0,35
1866,785322,22,4,11,2,5,2,6,1,2,1,8,0,3,0,1,0,11
1866,786613,12,1,6,1,3,0,3,3,4,0,2,1,1,0,1,0,5
1866,797444,8,0,4,0,2,0,2,1,2,1,2,1,1,0,0,0,1
1866,797442,5,0,1,0,1,0,0,0,0,0,2,0,2,0,0,0,0
1867,797013,27,5,12,2,5,3,7,2,2,0,1,4,4,1,0,0,15
1867,791441,20,4,7,3,4,1,3,0,0,0,3,2,3,0,2,0,9
1867,774959,19,1,4,0,0,1,4,0,0,0,2,3,2,0,0,1,3
1867,781629,17,0,0,0,0,0,0,0,0,0,2,1,1,0,2,0,0
1867,791440,16,0,2,0,2,0,0,0,0,1,4,1,3,0,2,1,0
1867,781378,28,8,16,6,11,2,5,1,3,0,9,1,0,1,2,2,19
1867,797015,12,5,9,3,6,2,3,1,1,1,1,1,0,2,1,0,13
1867,797016,16,2,4,1,2,1,2,2,3,0,2,2,0,0,1,0,7
1867,775739,12,3,4,3,4,0,0,0,0,1,1,0,4,0,2,2,6
1867,791443,19,2,4,2,2,0,2,0,0,0,1,1,2,0,0,1,4
1867,775267,11,1,3,0,1,1,2,0,0,0,1,3,0,0,1,0,3
1867,797019,3,0,1,0,1,0,0,0,0,0,1,0,0,0,0,0,0
1868,786525,24,6,10,3,4,3,6,8,8,0,3,0,1,0,1,1,23
1868,791914,21,5,13,2,5,3,8,2,2,1,4,4,3,1,2,0,15
1868,786030,26,6,13,5,9,1,4,1,2,1,2,1,2,1,0,1,14
1868,786526,21,4,7,2,5,2,2,2,2,4,3,1,3,0,1,1,12
1868,791917,18,3,4,2,2,1,2,0,0,1,2,4,3,0,0,1,7
1868,797550,20,3,6,0,2,3,4,0,2,2,2,2,0,1,1,0,9
1868,786856,15,3,6,3,6,0,0,2,2,2,4,4,1,0,0,0,8
1868,781109,18,1,5,0,4,1,1,1,2,4,7,2,2,1,0,1,4
1868,797551,4,2,3,2,3,0,0,0,0,2,0,0,0,0,0,0,4
1868,797552,4,1,1,1,1,0,0,2,2,2,0,0,0,0,0,0,4
1868,786524,20,0,4,0,2,0,2,0,0,0,2,1,0,0,2,0,0
1868,791918,4,0,3,0,3,0,0,0,0,0,0,0,0,1,0,0,0
1868,791920,4,0,1,0,1,0,0,0,2,1,1,1,0,0,0,0,0
1868,791919,1,0,0,0,0,0,0,0,0,0,0,0,0,0,0,0,0
1870,796753,24,5,10,1,2,4,8,3,4,1,4,2,4,0,1,0,17
1870,791093,32,6,11,4,9,2,2,2,2,1,3,0,2,2,2,0,16
1870,796752,28,3,8,2,5,1,3,3,4,0,2,7,4,2,4,0,10
1870,785577,15,5,7,5,7,0,0,0,0,1,3,0,4,0,1,1,10
1870,791094,29,3,7,0,3,3,4,0,0,0,4,4,0,0,0,0,9
1870,785569,29,4,7,4,6,0,1,0,0,0,3,0,2,3,1,0,8
1870,791089,11,3,5,2,3,1,2,0,0,2,3,0,0,0,2,0,7
1870,791091,14,2,3,1,2,1,1,0,0,0,1,6,3,1,2,0,5
1870,791097,18,2,8,2,8,0,0,0,3,1,3,0,1,2,2,1,4
1871,776386,37,8,17,3,7,5,10,0,0,1,7,2,1,2,4,0,21
1871,792101,34,5,14,4,8,1,6,7,10,1,2,2,0,5,2,0,18
1871,780923,35,7,13,5,9,2,4,2,4,0,7,7,1,2,3,0,18
1871,797700,20,5,6,5,6,0,0,2,2,3,3,0,4,0,1,0,12
1871,797701,22,4,4,4,4,0,0,2,5,1,2,0,2,0,0,0,10
1871,786160,18,1,3,1,2,0,1,1,3,1,2,1,2,3,1,0,3
1871,775564,23,2,8,2,7,0,1,0,0,3,3,0,1,0,1,0,4
1871,786156,3,1,1,0,0,1,1,0,0,0,0,1,1,0,1,0,3
1871,792102,7,1,2,1,1,0,1,0,0,0,0,1,0,0,0,0,2
1871,786165,1,0,1,0,0,0,1,0,0,0,0,0,1,0,0,0,0
1872,791312,18,2,2,2,2,0,0,2,3,1,2,1,0,0,2,0,6
1872,785664,10,3,6,3,5,0,1,1,2,3,3,0,1,1,0,2,7
1872,796609,19,4,6,3,3,1,3,0,0,0,4,5,1,2,0,0,9
1872,785841,18,4,6,3,3,1,3,2,3,0,1,0,1,1,1,0,11
1872,781504,19,3,5,3,3,0,2,3,4,0,2,4,0,1,1,3,9
1872,785840,25,4,8,1,1,3,7,1,1,1,5,1,2,1,1,0,12
1872,780728,13,4,6,4,6,0,0,0,0,1,5,0,0,1,1,0,8
1872,796620,7,1,5,1,5,0,0,0,0,3,4,1,1,0,2,0,2
1872,796611,21,4,5,3,3,1,2,1,1,0,2,1,1,2,1,0,10
1872,791313,8,2,5,2,3,0,2,0,1,0,0,0,1,0,0,0,4
1872,785848,13,0,1,0,1,0,0,2,2,0,2,0,1,0,0,0,2
1872,796203,15,2,2,2,2,0,0,1,2,0,1,2,1,0,1,0,5
1872,766623,14,3,4,3,4,0,0,1,2,0,3,0,1,4,0,0,7
1874,785622,26,2,5,0,0,2,5,0,0,0,2,0,1,0,4,0,6
1874,781058,24,0,3,0,3,0,0,0,0,2,3,2,4,0,2,0,0
1874,780327,25,2,4,2,4,0,0,0,0,2,2,1,2,0,2,1,4
1874,797451,31,5,13,3,8,2,5,2,2,1,0,2,1,1,1,0,14
1874,791849,34,2,8,2,3,0,5,5,5,0,4,1,1,4,3,0,9
1874,791848,11,2,4,1,1,1,3,0,0,0,3,1,1,0,0,0,5
1874,797455,13,3,3,3,3,0,0,1,4,1,4,0,2,0,1,0,7
1874,797458,14,1,1,0,0,1,1,4,4,1,4,2,4,1,1,0,7
1874,797453,2,0,1,0,0,0,1,2,2,0,0,0,1,0,0,0,2
1874,797452,4,0,1,0,0,0,1,1,2,1,1,0,0,0,0,0,1
1874,786607,16,1,4,0,0,1,4,4,5,0,0,1,2,1,0,0,7
1875,797174,25,2,2,1,1,1,1,0,2,0,4,1,2,1,2,0,5
1875,791510,26,1,3,1,1,0,2,3,5,1,0,1,3,0,1,0,5
1875,791507,12,3,4,3,4,0,0,1,1,1,0,0,3,0,2,0,7
1875,797168,34,6,13,4,9,2,4,0,0,1,6,1,3,1,4,0,14
1875,775357,35,4,15,3,9,1,6,1,2,0,2,4,4,1,5,0,10
1875,791509,6,0,0,0,0,0,0,0,0,1,2,0,2,0,0,0,0
1875,791506,13,1,2,0,0,1,2,0,0,0,1,0,1,1,1,0,3
1875,786699,21,0,0,0,0,0,0,0,1,2,2,0,3,0,2,1,0
1875,798345,9,0,3,0,1,0,2,0,0,1,0,0,1,0,0,0,0
1875,791508,5,0,0,0,0,0,0,0,0,0,0,1,1,1,0,0,0
1875,791505,14,3,6,0,0,3,6,0,0,0,4,0,2,0,1,0,9
1876,775954,25,6,9,6,9,0,0,0,0,1,4,1,1,3,0,2,12
1876,781006,22,3,8,2,5,1,3,0,0,1,5,1,1,2,2,1,7
1876,796194,25,2,5,1,1,1,4,0,0,1,3,4,4,2,1,0,5
1876,790917,22,4,9,1,6,3,3,0,0,5,3,2,2,0,1,1,11
1876,781157,19,6,14,5,9,1,5,0,0,2,1,0,1,1,0,0,13
1876,790918,8,2,2,2,2,0,0,0,0,0,0,0,0,0,1,0,4
1876,790919,4,0,1,0,0,0,1,0,0,0,0,0,1,0,0,0,0
1876,785238,5,0,1,0,1,0,0,1,2,2,0,0,0,0,0,1,1
1876,780648,17,2,3,2,3,0,0,2,2,2,4,1,1,0,1,0,6
1876,796464,23,2,7,2,5,0,2,2,2,2,2,3,1,4,0,0,6
1876,796459,22,6,8,6,8,0,0,0,1,0,1,0,4,1,0,0,12
1876,790916,8,0,0,0,0,0,0,2,2,0,1,0,0,0,0,0,2
1877,790962,33,2,10,1,6,1,4,3,8,1,0,1,4,1,6,1,8
1877,780832,13,1,3,1,3,0,0,0,0,0,2,0,1,0,1,0,2
1877,790961,33,1,4,1,3,0,1,3,4,3,3,0,2,0,0,0,5
1877,785278,28,2,6,1,2,1,4,0,0,0,1,0,2,0,5,1,5
1877,775860,35,3,12,2,5,1,7,2,2,0,6,3,1,1,0,0,9
1877,796556,11,1,1,1,1,0,0,1,1,1,0,0,3,0,1,0,3
1877,796554,18,0,3,0,1,0,2,0,0,1,2,0,0,0,0,1,0
1877,790965,16,2,3,0,1,2,2,0,0,1,3,0,1,0,4,0,6
1877,796555,8,0,1,0,0,0,1,0,0,0,0,0,0,0,1,0,0
1877,796553,5,0,0,0,0,0,0,0,0,0,0,0,0,0,0,0,0
1878,781249,21,2,7,0,2,2,5,0,0,1,2,1,4,0,1,2,6
1878,775165,34,0,3,0,0,0,3,0,0,1,6,1,1,0,0,0,0
1878,785514,40,4,11,1,5,3,6,4,4,0,4,1,3,0,1,0,15
1878,785515,39,7,13,7,12,0,1,6,8,0,3,5,3,1,2,1,20
1878,781253,36,4,6,2,2,2,4,1,2,0,3,0,0,0,0,0,11
1878,796953,25,3,6,3,6,0,0,3,4,3,3,0,2,0,1,1,9
1878,796951,12,1,3,0,1,1,2,0,0,0,1,0,1,2,1,0,3
1878,791252,4,0,2,0,1,0,1,0,0,0,1,0,2,0,0,0,0
1878,791251,2,0,1,0,0,0,1,0,0,0,0,0,0,0,0,0,0
1878,791687,12,0,2,0,2,0,0,2,4,0,3,0,1,1,1,0,2
1879,775913,29,6,11,6,11,0,0,1,3,0,9,1,4,0,2,0,13
1879,791737,27,1,5,1,3,0,2,0,0,0,7,4,5,1,3,0,2
1879,783524,25,1,9,1,6,0,3,2,3,0,2,0,4,0,4,0,4
1879,786223,28,1,3,1,2,0,1,0,0,0,6,0,1,1,2,0,2
1879,780561,28,4,6,0,2,4,4,2,2,3,2,0,3,0,1,0,14
1879,797332,15,2,3,2,3,0,0,2,2,3,0,0,3,0,0,0,6
1879,797333,11,1,1,0,0,1,1,0,0,0,0,1,1,0,0,0,3
1879,797331,38,6,11,3,6,3,5,1,3,1,3,1,0,1,2,0,16
1879,786220,24,1,6,1,6,0,0,1,2,1,1,2,3,1,2,0,3
1880,786746,31,4,8,3,5,1,3,1,2,0,6,4,3,1,1,1,10
1880,780178,18,2,4,2,4,0,0,2,2,1,2,2,2,2,2,0,6
1880,775075,27,5,6,5,6,0,0,1,1,0,2,2,0,2,0,1,11
1880,792376,28,11,17,5,6,6,11,3,3,0,1,3,2,2,2,0,31
1880,797883,23,1,3,1,1,0,2,0,0,0,3,4,2,0,0,0,2
1880,797890,18,6,11,3,5,3,6,0,0,0,3,0,3,1,0,0,15
1880,792378,21,3,3,3,3,0,0,2,2,1,3,4,0,1,1,0,8
1880,797888,4,0,1,0,1,0,0,0,0,1,0,0,0,0,0,0,0
1880,785744,1,0,0,0,0,0,0,0,0,0,0,0,0,0,0,0,0
1880,792375,1,0,0,0,0,0,0,0,0,0,1,0,0,0,0,0,0
1880,792374,16,3,6,3,4,0,2,0,0,0,2,1,2,4,1,0,6
1880,797885,12,2,4,2,4,0,0,0,0,1,0,1,0,0,0,0,4
1881,792140,26,7,10,7,10,0,0,2,2,1,4,2,2,0,4,1,16
1881,792144,37,5,8,3,3,2,5,0,0,1,5,3,3,0,4,0,12
1881,792148,32,4,11,3,5,1,6,0,0,0,2,4,2,0,3,0,9
1881,781429,39,2,6,0,0,2,6,6,7,0,2,3,0,1,1,0,12
1881,776092,38,3,10,1,5,2,5,1,1,0,4,1,2,0,5,0,9
1881,792146,14,2,5,2,5,0,0,0,0,0,4,0,1,0,0,0,4
1881,797793,1,1,1,0,0,1,1,0,0,0,0,0,0,0,0,0,3
1881,797786,6,1,2,1,1,0,1,1,1,0,0,1,0,0,2,0,3
1881,797789,2,0,1,0,0,0,1,0,0,0,0,0,0,0,0,0,0
1881,781431,5,0,1,0,1,0,0,0,0,0,0,0,0,0,0,0,0
1882,786575,35,4,10,4,10,0,0,3,4,3,11,0,2,1,3,7,11
1882,792334,27,3,5,3,4,0,1,4,4,4,4,0,4,1,3,0,10
1882,798094,31,1,6,1,4,0,2,0,0,0,2,7,1,0,1,0,2
1882,792338,31,6,11,6,11,0,0,3,4,1,2,3,3,5,5,2,15
1882,781666,37,8,18,8,11,0,7,4,5,0,2,3,4,1,3,0,20
1882,798097,5,0,1,0,1,0,0,0,0,0,1,0,2,0,2,0,0
1882,785531,11,3,4,1,1,2,3,0,1,1,2,0,1,1,1,0,8
1882,798095,4,0,0,0,0,0,0,0,0,0,0,1,0,1,0,0,0
1882,798100,4,0,0,0,0,0,0,0,1,0,0,0,2,0,0,0,0
1882,791636,15,3,6,2,3,1,3,0,1,0,2,1,1,0,2,0,7
1883,791768,11,2,5,2,4,0,1,0,0,0,1,0,1,0,2,0,4
1883,786460,21,2,4,2,4,0,0,1,2,0,2,1,3,0,3,0,5
1883,780604,37,6,15,5,12,1,3,2,4,1,5,2,2,0,6,0,15
1883,780603,35,3,8,1,4,2,4,5,6,1,4,4,4,1,5,0,13
1883,780602,30,4,8,4,8,0,0,2,3,0,3,4,4,0,2,0,10
1883,786071,20,2,4,2,4,0,0,1,2,2,4,0,1,1,0,2,5
1883,797564,1,0,0,0,0,0,0,0,0,0,0,0,1,0,0,0,0
1883,791766,29,2,5,1,3,1,2,0,0,1,2,1,2,0,0,0,5
1883,786230,16,2,6,2,3,0,3,2,2,0,1,0,1,3,3,0,6
1884,796347,23,1,6,1,5,0,1,0,0,0,1,2,1,0,2,1,2
1884,785243,27,2,4,2,2,0,2,4,4,3,2,1,4,0,2,2,8
1884,790788,37,4,12,0,2,4,10,4,4,3,4,0,3,0,5,1,16
1884,781028,37,9,17,4,5,5,12,0,0,0,7,2,1,1,1,0,23
1884,781026,32,1,7,1,2,0,5,0,0,0,3,3,3,2,0,1,2
1884,785242,4,0,0,0,0,0,0,0,0,0,1,0,1,0,1,0,0
1884,781027,10,0,0,0,0,0,0,0,0,1,2,1,3,0,0,0,0
1884,796348,9,0,0,0,0,0,0,0,0,0,0,0,2,1,1,0,0
1884,796349,21,0,4,0,0,0,4,1,2,2,0,1,1,1,2,0,1
1885,780824,28,4,9,4,9,0,0,3,3,2,1,1,3,0,1,0,11
1885,791117,34,2,4,2,4,0,0,1,2,0,5,1,1,0,2,0,5
1885,791118,36,5,12,5,7,0,5,8,9,2,5,2,0,1,0,1,18
1885,785676,31,4,8,3,4,1,4,0,0,1,1,3,3,2,3,0,9
1885,774974,36,4,5,4,5,0,0,8,10,0,7,0,2,2,2,0,16
1885,796771,6,1,4,0,2,1,2,1,2,0,1,0,0,0,0,0,4
1885,791115,7,0,1,0,1,0,0,0,0,0,0,0,4,0,0,0,0
1885,796769,10,0,1,0,0,0,1,0,0,0,1,0,2,0,0,0,0
1885,791116,12,0,1,0,1,0,0,0,0,0,1,0,0,0,0,0,0
1886,792277,15,1,1,1,1,0,0,2,4,1,2,1,1,0,1,0,4
1886,781464,31,4,11,1,1,3,10,0,0,2,5,1,1,0,0,0,11
1886,785282,17,2,7,1,1,1,6,3,4,1,2,0,4,2,1,0,8
1886,781502,32,4,8,2,4,2,4,1,3,0,1,5,3,1,2,0,11
1886,780259,36,6,16,5,8,1,8,4,6,4,7,2,2,0,5,1,17
1886,792274,7,0,0,0,0,0,0,0,1,0,2,0,1,0,0,0,0
1886,785913,19,3,5,3,5,0,0,1,3,1,3,0,4,0,0,0,7
1886,798058,5,0,1,0,1,0,0,0,0,0,0,0,0,0,1,0,0
1886,786516,10,1,3,0,0,1,3,0,0,0,1,2,0,0,0,0,3
1886,781501,28,2,3,2,3,0,0,0,0,3,1,1,3,0,0,0,4
1887,786029,10,1,1,1,1,0,0,0,0,1,0,1,5,1,2,0,2
1887,781398,28,5,12,4,8,1,4,0,0,2,5,1,3,1,1,0,11
1887,792114,24,1,5,0,1,1,4,1,2,0,2,0,4,0,0,0,4
1887,786018,29,2,5,0,1,2,4,0,1,0,1,1,3,0,3,1,6
1887,775678,32,4,12,2,7,2,5,3,5,0,3,4,1,2,0,0,13
1887,797746,7,2,4,1,2,1,2,1,2,0,2,0,0,0,1,0,6
1887,792112,11,0,3,0,2,0,1,0,0,0,1,0,3,0,0,0,0
1887,786022,19,3,6,2,4,1,2,3,4,3,2,0,0,0,0,0,10
1887,797740,16,6,10,5,7,1,3,0,1,3,5,1,2,0,0,0,13
1887,797737,24,1,3,0,2,1,1,1,2,1,5,5,1,1,1,1,4
1888,785800,25,3,6,2,2,1,4,0,0,1,4,2,0,0,1,0,7
1888,785799,23,3,6,3,6,0,0,3,4,4,2,1,1,0,2,0,9
1888,780760,23,3,5,3,3,0,2,0,0,0,4,0,1,0,0,2,6
1888,791676,25,3,7,2,5,1,2,2,4,0,4,5,2,0,3,0,9
1888,780554,29,2,5,2,4,0,1,2,4,1,3,0,0,1,1,0,6
1888,797426,15,2,3,2,2,0,1,0,0,0,4,0,1,1,2,1,4
1888,791678,8,0,0,0,0,0,0,0,0,1,0,0,1,0,0,0,0
1888,791679,8,1,4,1,4,0,0,0,0,0,3,0,3,0,2,0,2
1888,785807,18,5,8,1,4,4,4,2,2,0,1,1,1,0,0,0,16
1888,797427,11,2,7,2,2,0,5,0,0,0,1,0,0,0,0,0,4
1888,791677,15,0,5,0,4,0,1,2,2,0,0,2,1,2,2,0,2
1889,792025,11,2,2,2,2,0,0,0,0,1,1,0,2,0,1,0,4
1889,785946,28,2,4,1,1,1,3,1,2,1,6,0,3,0,3,0,6
1889,792020,36,5,17,4,9,1,8,2,2,1,7,4,1,2,7,0,13
1889,785941,31,2,8,0,2,2,6,3,3,1,2,1,1,0,0,1,9
1889,785938,28,4,6,1,2,3,4,1,2,0,5,2,2,1,1,0,12
1889,785948,29,5,6,5,6,0,0,1,5,1,1,0,2,1,1,1,11
1889,797634,2,0,1,0,1,0,0,0,0,0,1,0,0,0,0,0,0
1889,792023,20,0,4,0,3,0,1,0,0,0,2,1,2,1,0,0,0
1889,785939,15,0,7,0,7,0,0,2,2,0,1,1,2,0,1,0,2
1890,780494,30,7,12,6,11,1,1,1,2,1,7,2,3,5,2,0,16
1890,797276,13,1,3,1,2,0,1,1,1,0,0,1,2,2,1,0,3
1890,780497,32,2,7,2,5,0,2,0,0,3,1,1,4,1,2,1,4
1890,780496,36,10,17,1,3,9,14,3,5,0,2,3,3,1,1,0,32
1890,780495,37,9,21,4,9,5,12,1,1,0,0,4,3,4,0,0,24
1890,797277,9,2,2,2,2,0,0,0,0,0,0,1,1,0,2,0,4
1890,797274,5,0,2,0,2,0,0,0,0,0,1,0,1,0,0,0,0
1890,785693,15,0,3,0,3,0,0,2,2,2,3,0,1,0,1,1,2
1890,797275,3,0,0,0,0,0,0,0,0,0,0,0,0,0,0,0,0
1890,785692,20,1,2,1,2,0,0,1,2,0,1,5,5,0,1,0,3
1891,781425,24,3,4,3,4,0,0,1,1,1,8,0,3,0,6,1,7
1891,797001,15,1,5,0,2,1,3,0,0,0,2,5,0,1,0,0,3
1891,791343,29,2,2,2,2,0,0,4,4,0,3,2,4,2,5,0,8
1891,781602,38,9,15,5,9,4,6,7,7,0,2,4,4,2,6,0,29
1891,775746,36,5,13,1,1,4,12,14,16,0,5,2,1,1,4,0,28
1891,791344,22,3,4,3,4,0,0,0,0,3,4,0,0,0,0,0,6
1891,781601,16,3,4,3,4,0,0,0,1,4,6,1,4,0,2,1,6
1891,797000,11,2,3,0,0,2,3,0,0,0,1,0,0,1,0,0,6
1891,786611,9,0,1,0,1,0,0,3,3,0,0,0,0,0,0,0,3
1892,797546,21,2,2,2,2,0,0,2,2,2,1,2,2,0,2,3,6
1892,797549,22,6,9,6,9,0,0,1,2,4,6,4,2,0,2,0,13
1892,791715,18,3,5,0,1,3,4,0,0,1,3,2,0,2,1,2,9
1892,790857,19,2,13,1,6,1,7,1,1,0,2,4,1,1,1,0,6
1892,780586,24,6,10,4,7,2,3,3,8,1,5,0,1,3,0,2,17
1892,797544,17,5,5,5,5,0,0,1,2,1,5,2,1,0,1,1,11
1892,791799,4,0,1,0,1,0,0,0,0,1,0,1,0,1,0,0,0
1892,780351,18,6,6,6,6,0,0,4,5,1,3,0,0,0,2,1,16
1892,797547,3,0,2,0,0,0,2,0,0,0,1,0,0,0,0,0,0
1892,797539,3,0,0,0,0,0,0,0,0,0,0,0,0,0,1,0,0
1892,797545,5,1,1,0,0,1,1,0,0,0,1,0,1,0,2,0,3
1892,797540,12,3,3,2,2,1,1,0,0,0,1,2,0,1,0,0,7
1892,791716,9,1,2,1,1,0,1,2,3,0,2,1,1,2,1,0,4
1892,791714,2,0,0,0,0,0,0,0,0,0,0,1,0,0,0,0,0
1892,789065,7,1,1,0,0,1,1,0,0,0,0,1,1,0,0,0,3
1892,785855,16,4,7,3,4,1,3,0,0,0,3,1,2,0,1,0,9
1894,797139,21,4,5,4,5,0,0,0,3,1,2,0,1,3,1,1,8
1894,775394,22,3,7,2,5,1,2,2,3,1,2,0,0,0,0,0,9
1894,791526,26,2,5,1,2,1,3,2,2,0,3,5,0,1,2,1,7
1894,780272,21,1,4,1,2,0,2,0,0,0,1,1,3,0,5,0,2
1894,775592,22,5,11,3,6,2,5,5,5,0,1,1,1,3,1,0,17
1894,791524,19,4,6,3,4,1,2,0,0,2,2,2,2,0,1,0,9
1894,785970,15,3,7,3,7,0,0,3,4,5,4,0,2,0,1,2,9
1894,797136,21,5,8,3,5,2,3,4,4,0,4,1,1,1,0,0,16
1894,791523,6,0,2,0,1,0,1,0,0,0,1,0,0,0,0,0,0
1894,791525,2,0,0,0,0,0,0,1,2,0,0,0,0,0,0,0,1
1894,797137,4,0,1,0,1,0,0,0,0,0,0,0,0,0,1,0,0
1894,780273,21,2,6,1,2,1,4,2,2,0,3,1,1,2,0,0,7
1895,789177,33,6,14,6,14,0,0,2,3,5,7,0,4,0,2,3,14
1895,775758,25,3,9,3,9,0,0,1,1,0,5,0,5,0,3,0,7
1895,797264,18,0,1,0,1,0,0,0,0,0,0,1,0,0,5,0,0
1895,791336,10,0,1,0,1,0,0,0,0,0,0,0,3,0,0,0,0
1895,791340,30,6,12,6,11,0,1,0,0,1,2,2,4,3,6,0,12
1895,797262,16,3,4,2,2,1,2,1,1,1,4,1,3,0,1,0,8
1895,797260,3,0,1,0,0,0,1,0,0,0,0,0,0,0,0,0,0
1895,792189,2,0,0,0,0,0,0,0,0,0,0,0,1,0,0,0,0
1895,797261,14,2,5,1,3,1,2,0,0,1,2,0,3,0,1,0,5
1895,789178,10,0,1,0,0,0,1,0,0,0,0,0,0,1,0,0,0
1895,780181,24,4,9,3,5,1,4,3,3,0,5,1,2,3,5,0,12
1895,776089,15,0,3,0,3,0,0,0,0,1,0,1,0,1,1,0,0
1896,780651,24,4,5,4,5,0,0,0,0,2,6,3,2,0,3,3,8
1896,791815,31,7,12,5,9,2,3,2,4,0,2,1,2,1,2,0,18
1896,791810,32,3,5,3,4,0,1,0,0,0,3,10,1,3,3,0,6
1896,791814,21,3,9,2,5,1,4,0,0,1,1,0,1,0,1,0,7
1896,780650,35,9,15,6,9,3,6,1,2,4,7,2,3,0,1,0,22
1896,791809,3,0,0,0,0,0,0,0,0,0,0,0,0,0,0,0,0
1896,791812,9,1,3,1,2,0,1,0,0,0,2,1,1,0,0,0,2
1896,781596,14,5,6,5,6,0,0,0,0,2,2,1,2,1,1,1,10
1896,786645,12,0,2,0,1,0,1,0,0,0,2,1,4,1,0,0,0
1896,786644,19,2,3,2,3,0,0,1,2,0,1,2,1,0,1,0,5
1897,791391,34,5,7,4,6,1,1,1,4,1,4,0,2,0,3,1,12
1897,797156,17,1,4,1,3,0,1,0,0,1,0,3,1,2,0,0,2
1897,791390,18,4,8,2,5,2,3,0,0,2,4,0,4,0,1,1,10
1897,780133,28,2,7,0,2,2,5,0,0,0,3,0,0,1,5,0,6
1897,780130,35,3,10,2,4,1,6,9,9,1,2,4,1,1,1,0,16
1897,797158,5,0,1,0,1,0,0,0,0,0,0,0,1,0,0,0,0
1897,791388,15,1,5,1,3,0,2,2,2,3,1,0,0,0,0,0,4
1897,791389,7,0,1,0,0,0,1,2,3,0,0,0,2,0,0,0,2
1897,775743,18,0,3,0,2,0,1,1,2,0,1,1,0,1,1,0,1
1897,776446,22,3,6,3,4,0,2,0,0,0,1,1,2,0,0,0,6
1897,780407,1,0,1,0,1,0,0,0,0,0,0,0,0,0,0,0,0
1898,781592,21,0,2,0,1,0,1,2,2,0,4,2,0,2,1,2,2
1898,780229,25,2,8,2,7,0,1,1,2,1,8,3,2,1,6,0,5
1898,795572,32,6,14,5,9,1,5,1,1,1,2,0,3,3,1,1,14
1898,791483,31,3,8,2,6,1,2,6,8,1,5,6,1,1,0,0,13
1898,786322,19,4,6,3,4,1,2,3,3,1,2,0,2,1,1,0,12
1898,797197,1,0,0,0,0,0,0,0,0,0,0,0,0,0,0,0,0
1898,791484,5,0,2,0,0,0,2,0,0,1,0,0,1,0,1,0,0
1898,791487,5,1,2,1,1,0,1,0,0,1,1,0,0,0,0,1,2
1898,797195,6,1,3,1,1,0,2,0,0,0,1,0,1,0,1,0,2
1898,797194,16,1,3,0,0,1,3,0,0,0,1,0,0,0,0,0,3
1898,791485,19,3,7,1,1,2,6,0,0,0,1,1,0,0,2,0,8
1898,786323,20,0,1,0,0,0,1,0,0,0,5,1,0,0,0,0,0
1900,791884,29,6,12,6,10,0,2,2,3,0,3,3,2,0,1,0,14
1900,781066,22,5,8,5,8,0,0,2,5,1,5,0,2,1,3,0,12
1900,780695,29,4,6,2,2,2,4,0,0,0,3,1,2,1,0,0,10
1900,797594,20,3,4,0,0,3,4,0,0,0,1,0,0,0,0,2,9
1900,791883,28,4,6,4,6,0,0,0,0,3,2,2,2,0,3,1,8
1900,797600,13,4,5,4,5,0,0,3,3,2,3,2,1,3,0,0,11
1900,797596,23,4,8,2,4,2,4,0,0,0,2,3,0,2,1,0,10
1900,786496,17,1,1,0,0,1,1,1,2,0,1,1,1,0,0,0,4
1900,797597,11,1,3,1,2,0,1,1,2,0,1,1,0,2,0,1,3
1900,797598,5,0,2,0,2,0,0,0,0,0,1,0,1,0,0,0,0
1900,791885,3,0,1,0,1,0,0,0,2,0,0,0,1,0,1,0,0
1901,792422,31,7,12,7,12,0,0,0,0,2,1,1,4,1,1,0,14
1901,792418,28,6,14,6,11,0,3,2,2,1,3,0,2,0,3,1,14
1901,789484,38,2,12,2,11,0,1,4,4,1,9,0,1,1,5,1,8
1901,796693,34,2,8,2,5,0,3,2,2,0,1,3,3,1,3,0,6
1901,782654,17,0,2,0,2,0,0,0,0,2,4,3,0,1,1,1,0
1901,796691,17,4,5,1,1,3,4,0,0,0,0,0,1,0,2,0,11
1901,796692,8,1,2,0,0,1,2,0,0,0,1,0,0,0,1,0,3
1901,792424,13,0,0,0,0,0,0,0,0,1,2,1,5,0,2,0,0
1901,792419,6,0,0,0,0,0,0,0,0,0,0,0,1,0,0,0,0
1901,796694,3,0,0,0,0,0,0,0,0,0,0,0,1,0,1,0,0
1901,792423,2,0,0,0,0,0,0,0,0,0,0,0,0,0,0,0,0
1901,799739,2,0,0,0,0,0,0,0,0,0,1,0,0,0,0,0,0
1901,799738,1,0,0,0,0,0,0,0,0,0,0,0,0,0,0,0,0
1902,797482,27,3,3,3,3,0,0,1,4,0,4,3,3,0,3,1,7
1902,797485,19,6,7,4,4,2,3,7,10,3,3,0,3,0,2,0,21
1902,797481,29,3,8,2,4,1,4,2,4,0,3,1,1,1,0,1,9
1902,797480,26,2,11,1,8,1,3,2,2,1,3,2,2,4,2,0,7
1902,785944,27,9,12,7,7,2,5,2,3,0,2,2,1,1,0,0,22
1902,797484,14,2,4,2,4,0,0,0,0,1,7,1,3,0,1,3,4
1902,797483,6,1,1,1,1,0,0,0,0,0,1,1,2,0,0,1,2
1902,786579,3,0,0,0,0,0,0,0,1,0,1,0,0,0,0,0,0
1902,797479,8,0,1,0,0,0,1,0,0,0,1,0,0,0,1,0,0
1902,797478,19,4,8,1,3,3,5,0,0,0,1,0,2,3,3,0,11
1902,791873,15,1,2,1,1,0,1,3,4,1,0,4,2,0,1,0,5
1902,786574,2,0,0,0,0,0,0,0,0,0,0,0,0,0,0,0,0
1902,781217,5,0,1,0,0,0,1,0,0,0,0,0,4,0,0,0,0
1904,796592,9,0,1,0,1,0,0,1,2,0,1,1,0,0,0,0,1
1904,792432,32,3,6,1,2,2,4,1,2,1,1,0,1,1,3,0,9
1904,796594,18,2,9,1,4,1,5,0,0,0,1,1,1,0,1,0,5
1904,775005,22,3,8,2,4,1,4,3,4,3,1,0,3,0,1,0,10
1904,780210,36,5,14,5,10,0,4,3,3,4,4,0,1,3,1,0,13
1904,790880,6,1,1,1,1,0,0,0,0,1,0,0,0,0,0,0,2
1904,791306,30,5,7,5,7,0,0,8,9,2,5,1,2,1,2,1,18
1904,792433,25,2,8,1,2,1,6,0,0,0,1,3,2,2,2,0,5
1904,786422,22,2,4,1,2,1,2,2,2,1,0,2,3,1,5,0,7
1905,780129,24,0,3,0,2,0,1,3,4,0,3,0,2,2,6,0,3
1905,786798,40,11,15,10,14,1,1,4,6,1,1,6,1,5,4,0,27
1905,798206,29,4,10,1,5,3,5,0,0,1,3,1,2,1,3,1,11
1905,781658,30,4,6,4,5,0,1,0,1,0,4,2,4,2,1,1,8
1905,781656,28,2,4,2,4,0,0,0,0,3,2,1,4,0,1,2,4
1905,791264,4,0,3,0,2,0,1,0,0,1,2,0,0,0,1,0,0
1905,791263,24,6,8,6,8,0,0,0,0,3,3,1,1,0,0,0,12
1905,796967,20,3,5,0,0,3,5,2,3,0,2,0,3,0,3,0,11
1905,790256,1,0,0,0,0,0,0,0,0,0,0,0,1,0,0,0,0
1906,776110,18,4,6,3,4,1,2,0,0,4,2,2,1,1,0,2,9
1906,780059,32,7,16,5,14,2,2,2,4,7,5,4,1,0,2,2,18
1906,790944,29,4,9,3,4,1,5,4,8,1,3,1,3,1,3,0,13
1906,780061,35,2,9,2,3,0,6,2,4,1,5,6,2,1,2,0,6
1906,796494,22,2,6,1,1,1,5,0,1,0,2,1,2,0,1,0,5
1906,780058,11,2,5,0,0,2,5,0,0,0,0,1,1,0,0,0,6
1906,786754,17,1,2,0,1,1,1,0,0,0,0,3,2,0,0,0,3
1906,790943,20,3,6,1,3,2,3,3,4,3,4,0,2,2,2,0,11
1906,796496,8,1,3,1,1,0,2,0,0,0,0,1,0,0,0,0,2
1906,790941,8,4,5,4,5,0,0,2,4,1,2,0,0,0,0,0,10
1907,785775,29,1,3,1,2,0,1,1,2,1,5,5,4,0,1,0,3
1907,781335,36,4,8,2,4,2,4,5,6,0,3,0,1,0,2,1,15
1907,776351,16,8,11,4,4,4,7,1,1,0,2,2,5,0,1,0,21
1907,785770,34,8,19,3,8,5,11,2,2,0,6,2,4,2,2,0,23
1907,781341,37,2,10,1,1,1,9,0,0,1,2,3,2,3,2,0,5
1907,796542,11,1,1,1,1,0,0,2,2,2,1,2,1,0,1,0,4
1907,785767,23,1,3,0,0,1,3,0,0,0,1,1,3,1,0,0,3
1907,796538,6,1,2,1,1,0,1,0,0,0,1,1,0,2,0,0,2
1907,791283,8,2,2,2,2,0,0,0,0,0,1,0,1,0,0,0,4
1908,776328,27,2,6,2,3,0,3,6,7,1,5,7,1,0,3,1,10
1908,791740,11,1,4,0,1,1,3,2,2,0,1,2,2,1,1,0,5
1908,791738,21,6,9,6,9,0,0,0,0,2,4,0,0,0,1,4,12
1908,780717,34,6,10,5,6,1,4,4,6,2,8,4,1,1,6,1,17
1908,786203,33,4,6,2,3,2,3,5,6,1,10,6,2,2,0,0,15
1908,797334,16,1,4,0,3,1,1,1,2,0,0,1,1,1,1,0,4
1908,786315,8,0,1,0,1,0,0,0,0,0,0,1,4,0,0,0,0
1908,791741,25,4,6,1,2,3,4,2,2,0,1,0,1,0,0,0,13
1908,786200,3,0,0,0,0,0,0,0,0,0,1,0,0,1,0,0,0
1908,797337,3,0,0,0,0,0,0,0,2,0,0,1,1,0,1,0,0
1908,774859,3,0,0,0,0,0,0,0,0,1,1,0,0,0,0,0,0
1908,786197,16,5,9,5,9,0,0,2,3,3,2,1,3,0,2,0,12
1918,797784,24,6,9,6,7,0,2,0,0,1,2,3,2,1,5,0,12
1918,780527,21,4,4,2,2,2,2,2,2,0,1,2,1,1,0,0,12
1918,780049,22,5,7,5,7,0,0,0,0,1,6,5,2,0,2,1,10
1918,785674,21,3,8,1,3,2,5,0,0,0,1,1,1,0,2,2,8
1918,789059,24,2,8,2,7,0,1,2,3,4,6,0,1,1,1,1,6
1918,792171,20,2,5,2,5,0,0,4,4,0,7,7,1,4,1,6,8
1918,797783,12,3,4,3,4,0,0,2,2,1,3,0,2,1,1,2,8
1918,792173,13,2,3,0,0,2,3,0,0,0,0,0,2,0,0,0,6
1918,792174,6,1,2,1,2,0,0,2,4,0,1,0,0,0,1,0,4
1918,780980,6,1,1,0,0,1,1,0,0,1,0,0,1,1,0,0,3
1918,792175,6,1,4,1,3,0,1,1,2,1,0,0,0,0,0,0,3
1918,797782,6,1,1,1,1,0,0,0,0,1,3,1,0,0,0,0,2
1918,786658,6,0,2,0,1,0,1,1,2,0,2,1,1,0,0,0,1
1918,797785,13,0,3,0,2,0,1,0,0,2,0,3,2,1,3,0,0
1920,790937,18,6,8,6,8,0,0,0,0,3,2,1,4,1,2,0,12
1920,790935,27,4,7,3,3,1,4,0,0,1,2,1,5,1,1,0,9
1920,775340,38,7,17,5,8,2,9,6,6,0,0,7,3,1,3,0,22
1920,790938,18,2,3,2,3,0,0,2,2,0,3,1,0,0,1,0,6
1920,774826,29,1,11,0,3,1,8,0,0,0,5,0,2,1,2,0,3
1920,796491,17,0,3,0,0,0,3,9,10,3,6,0,3,2,2,0,9
1920,780933,16,0,4,0,0,0,4,0,0,0,1,0,2,0,2,0,0
1920,796190,15,2,4,0,0,2,4,0,0,1,2,0,3,0,1,0,6
1920,792442,22,2,3,2,3,0,0,3,3,0,4,0,2,1,3,1,7
1921,786123,36,10,15,10,14,0,1,5,9,1,7,3,3,1,0,1,25
1921,786117,39,5,10,5,7,0,3,7,8,0,4,5,3,1,4,0,17
1921,786118,37,6,13,5,7,1,6,5,5,1,4,4,3,3,2,0,18
1921,797673,27,4,9,4,8,0,1,1,4,2,0,3,3,1,2,0,9
1921,780437,27,3,5,3,5,0,0,0,0,1,1,0,2,1,2,1,6
1921,792093,14,0,5,0,4,0,1,2,2,0,2,0,0,1,0,0,2
1921,792094,5,0,2,0,0,0,2,0,0,0,1,0,3,0,0,0,0
1921,797672,14,2,5,2,5,0,0,0,0,4,0,0,0,0,0,0,4
1921,797675,1,0,1,0,1,0,0,0,0,0,1,0,0,0,0,0,0
1922,791411,28,6,12,2,2,4,10,6,6,0,4,2,1,2,1,0,22
1922,785776,32,5,9,0,2,5,7,2,6,1,5,6,2,1,0,0,17
1922,791413,22,3,11,0,3,3,8,2,2,1,3,4,1,0,1,0,11
1922,797103,19,5,5,5,5,0,0,1,3,2,2,0,4,0,1,0,11
1922,791414,13,2,2,2,2,0,0,0,0,0,1,0,1,1,0,0,4
1922,781209,22,4,10,0,2,4,8,1,2,2,3,1,2,0,2,0,13
1922,797100,23,2,5,2,5,0,0,0,0,1,8,5,1,3,6,2,4
1922,785911,15,2,3,2,2,0,1,0,0,1,0,2,1,1,0,4,4
1922,797101,2,1,1,0,0,1,1,0,0,0,0,0,0,0,0,0,3
1922,797102,7,1,2,1,2,0,0,0,0,1,1,3,1,0,1,0,2
1922,797105,13,0,0,0,0,0,0,0,0,0,4,1,3,1,0,0,0
1922,797099,2,0,0,0,0,0,0,0,0,0,0,0,0,0,0,0,0
1922,797104,2,0,1,0,0,0,1,0,0,0,0,0,0,0,0,0,0
1923,792698,38,7,17,6,12,1,5,7,9,1,4,2,4,2,4,0,22
1923,792702,37,7,14,5,8,2,6,1,2,1,4,1,3,1,1,1,17
1923,792695,30,3,7,3,7,0,0,2,2,2,10,1,3,1,3,1,8
1923,796772,38,2,7,1,3,1,4,2,2,0,2,2,1,1,2,0,7
1923,792699,29,1,7,0,3,1,4,0,0,0,2,0,3,2,2,0,3
1923,792704,28,2,7,2,6,0,1,1,2,2,2,0,2,1,0,0,5
1924,796837,24,2,6,1,2,1,4,0,0,0,3,2,3,0,0,0,5
1924,791171,24,3,8,3,8,0,0,1,1,2,3,1,3,1,1,0,7
1924,791170,29,7,18,1,3,6,15,0,0,0,1,0,3,1,1,0,20
1924,785700,28,1,7,0,3,1,4,1,2,3,1,5,4,2,0,0,4
1924,780269,38,6,15,3,11,3,4,4,5,4,1,4,3,5,4,0,19
1924,780194,16,3,4,3,4,0,0,2,4,4,0,0,3,1,2,0,8
1924,796834,13,1,3,1,1,0,2,1,1,0,1,1,2,1,1,0,3
1924,785706,16,1,5,0,2,1,3,2,2,1,2,0,0,0,1,0,5
1924,796838,5,0,0,0,0,0,0,0,0,1,1,0,2,0,2,0,0
1924,796833,7,0,0,0,0,0,0,0,0,0,0,0,2,0,0,0,0
1925,792143,28,3,5,1,1,2,4,2,4,0,1,3,4,2,0,1,10
1925,797753,29,5,12,5,11,0,1,2,2,1,5,2,2,1,3,1,12
1925,780953,36,9,11,9,11,0,0,14,14,3,6,2,2,0,3,2,32
1925,797750,14,1,2,1,1,0,1,0,0,1,0,2,1,0,1,0,2
1925,786287,37,3,3,3,3,0,0,3,7,2,6,2,3,1,5,0,9
1925,797748,8,0,1,0,0,0,1,0,0,0,0,0,1,0,0,0,0
1925,797751,31,4,8,2,2,2,6,2,2,0,5,3,2,2,4,0,12
1925,786293,13,2,3,2,3,0,0,1,2,0,4,0,0,1,1,0,5
1925,792147,4,0,0,0,0,0,0,0,0,1,0,0,2,0,1,0,0
1926,781125,20,2,5,2,5,0,0,4,4,0,3,1,1,1,0,1,8
1926,780440,22,3,10,1,3,2,7,0,0,0,4,0,1,0,2,0,8
1926,775620,11,1,6,1,6,0,0,0,0,1,0,0,0,0,1,0,2
1926,791621,14,2,4,2,4,0,0,0,0,0,1,2,5,2,2,0,4
1926,786431,30,3,7,2,4,1,3,3,3,0,1,3,3,1,3,0,10
1926,796975,7,2,3,2,3,0,0,0,0,0,1,0,0,0,0,1,4
1926,791619,14,3,5,2,2,1,3,0,0,2,4,3,1,0,0,0,7
1926,791620,7,0,3,0,0,0,3,0,0,1,0,0,1,0,0,0,0
1926,786434,10,1,5,1,5,0,0,0,0,0,1,1,2,0,1,1,2
1926,796976,12,1,1,1,1,0,0,2,3,1,1,0,4,0,0,0,4
1926,796977,5,0,1,0,0,0,1,0,1,0,1,0,2,0,0,0,0
1926,786432,7,0,1,0,1,0,0,0,0,1,1,0,1,0,0,0,0
1926,781088,32,4,12,2,5,2,7,2,2,1,3,1,0,1,1,0,12
1926,775622,9,0,1,0,1,0,0,1,3,0,1,1,0,0,0,0,1
1927,785490,15,2,2,2,2,0,0,0,0,3,3,1,0,0,1,0,4
1927,785495,27,9,15,7,11,2,4,1,2,1,5,4,2,1,1,1,21
1927,775377,14,1,1,1,1,0,0,0,0,0,3,0,3,2,0,2,2
1927,785494,24,3,5,0,1,3,4,0,0,1,1,2,2,0,2,0,9
1927,780698,26,4,10,3,6,1,4,4,6,1,6,2,0,0,1,0,13
1927,785958,15,2,7,2,4,0,3,4,4,0,2,2,1,1,2,0,8
1927,785659,17,2,2,2,2,0,0,0,0,1,3,2,4,0,2,2,4
1927,791034,5,2,3,0,1,2,2,1,2,1,1,0,0,0,1,1,7
1927,791130,20,2,8,0,1,2,7,2,2,0,5,0,2,0,1,1,8
1927,791033,6,1,2,1,1,0,1,0,1,0,1,1,0,0,0,0,2
1927,785486,4,0,0,0,0,0,0,0,0,0,0,0,2,0,0,0,0
1927,780427,27,3,6,2,5,1,1,5,8,2,3,3,1,2,2,0,12
1928,792041,26,3,9,1,3,2,6,0,0,1,1,1,3,0,0,1,8
1928,786054,27,2,5,2,5,0,0,6,10,5,2,2,4,3,2,1,10
1928,791964,34,7,15,3,7,4,8,3,4,1,3,2,2,1,1,0,21
1928,781339,35,4,8,0,0,4,8,1,2,0,7,2,1,0,2,0,13
1928,781337,38,8,12,5,6,3,6,7,8,2,1,7,1,1,3,0,26
1928,799737,10,2,3,1,1,1,2,0,0,0,1,1,1,0,0,0,5
1928,797713,0,0,0,0,0,0,0,0,0,0,0,0,0,0,0,0,0
1928,797712,13,0,0,0,0,0,0,2,2,2,0,1,5,1,1,1,2
1928,791966,0,0,0,0,0,0,0,0,0,0,0,0,0,0,0,0,0
1928,786056,17,1,2,0,0,1,2,0,0,0,2,4,3,0,2,0,3
1929,791131,20,2,4,0,0,2,4,4,4,3,1,2,4,0,2,0,10
1929,791135,28,5,8,5,8,0,0,5,7,4,5,0,3,1,0,0,15
1929,786090,37,11,24,9,16,2,8,1,2,2,5,2,2,3,3,0,25
1929,786088,36,0,1,0,1,0,0,1,2,2,3,3,1,0,4,0,1
1929,774921,8,0,1,0,0,0,1,1,2,0,0,0,0,0,0,0,1
1929,791134,1,0,0,0,0,0,0,0,0,0,0,0,1,0,0,0,0
1929,785541,9,0,2,0,0,0,2,1,2,0,1,0,3,0,1,0,1
1929,786097,8,0,0,0,0,0,0,0,0,0,1,0,1,0,0,0,0
1929,791521,11,0,1,0,1,0,0,2,2,0,0,0,2,0,0,3,2
1929,796790,32,6,15,2,5,4,10,3,3,0,1,1,5,0,2,0,19
1929,791132,10,1,5,1,2,0,3,1,2,0,3,1,2,0,1,0,3
1930,781342,25,2,4,2,2,0,2,9,12,0,4,2,3,0,2,0,13
1930,781593,25,1,6,1,3,0,3,2,2,2,0,3,3,1,4,2,4
1930,790901,29,4,7,1,2,3,5,2,2,0,4,2,2,0,1,0,13
1930,785452,36,5,11,5,11,0,0,5,6,0,2,1,2,1,2,2,15
1930,781620,33,2,5,2,4,0,1,1,2,0,2,1,1,0,1,0,5
1930,796450,5,0,1,0,1,0,0,0,0,2,1,0,1,0,1,0,0
1930,774835,15,1,3,1,3,0,0,3,3,0,5,0,2,0,2,0,5
1930,790902,20,3,5,1,1,2,4,3,4,0,6,0,2,0,0,0,11
1930,790903,12,0,2,0,1,0,1,0,0,0,1,0,1,0,1,0,0
1931,780879,31,4,6,3,5,1,1,6,6,1,2,1,4,2,2,2,15
1931,775785,23,2,6,1,4,1,2,2,2,0,3,0,2,3,0,2,7
1931,790768,37,6,14,1,3,5,11,1,2,0,4,3,1,1,5,1,18
1931,785743,24,1,6,0,3,1,3,0,0,1,1,4,2,0,3,0,3
1931,780875,24,3,7,1,4,2,3,1,2,0,3,1,4,0,1,1,9
1931,796326,9,1,4,1,2,0,2,0,0,0,1,0,3,0,0,0,2
1931,796324,9,0,1,0,0,0,1,0,0,0,1,0,1,0,0,0,0
1931,790769,16,2,5,2,4,0,1,0,0,1,2,1,2,0,2,0,4
1931,790767,8,0,0,0,0,0,0,0,0,0,0,0,3,0,0,0,0
1931,785226,19,0,1,0,0,0,1,2,2,0,3,0,2,1,0,0,2
1932,792560,19,0,1,0,1,0,0,0,0,0,1,0,2,0,1,0,0
1932,792565,34,8,11,8,11,0,0,4,6,5,5,3,2,0,3,1,20
1932,798135,16,0,1,0,0,0,1,0,0,0,1,0,1,0,1,0,0
1932,792561,22,3,8,3,6,0,2,4,5,0,3,4,1,0,1,0,10
1932,780270,31,3,6,1,1,2,5,1,1,0,3,1,1,0,2,0,9
1932,798133,13,1,3,0,0,1,3,0,0,0,0,0,3,1,0,0,3
1932,798134,19,3,6,2,4,1,2,0,0,0,3,1,2,0,4,0,7
1932,776333,13,2,3,2,3,0,0,4,4,2,5,0,2,0,1,0,8
1932,792563,20,3,5,3,4,0,1,2,3,0,1,2,2,2,2,0,8
1932,780266,13,1,3,1,1,0,2,2,2,1,1,2,1,0,1,0,4
1933,791512,15,0,0,0,0,0,0,0,0,0,0,0,2,0,1,0,0
1933,786338,26,1,9,0,3,1,6,1,2,1,4,2,2,1,4,0,4
1933,797647,11,0,0,0,0,0,0,0,0,0,0,1,2,0,2,0,0
1933,792050,30,2,4,1,1,1,3,0,0,0,0,4,2,0,0,1,5
1933,775601,35,4,12,3,8,1,4,5,5,0,2,2,4,1,3,0,14
1933,792052,15,0,2,0,1,0,1,0,0,0,1,0,1,0,1,1,0
1933,786825,11,1,1,1,1,0,0,3,6,1,1,0,1,0,1,0,5
1933,797648,17,2,4,2,3,0,1,0,0,2,0,2,3,0,0,0,4
1933,792047,13,4,6,1,2,3,4,0,0,1,3,0,2,0,2,0,11
1933,775476,7,1,3,0,0,1,3,0,0,0,0,0,0,0,0,0,3
1933,792051,5,1,2,1,1,0,1,0,0,0,0,1,0,0,0,0,2
1933,780862,8,1,3,0,0,1,3,1,1,0,0,0,0,0,0,0,4
1933,792045,7,0,0,0,0,0,0,0,0,0,1,0,1,1,0,0,0
1934,786765,16,4,5,3,3,1,2,1,2,0,5,5,2,1,1,0,10
1934,792379,21,5,9,0,1,5,8,0,0,0,4,3,1,1,0,0,15
1934,792380,16,4,9,1,2,3,7,0,0,2,0,2,0,1,2,0,11
1934,781672,17,6,8,6,8,0,0,0,0,2,3,1,0,1,1,3,12
1934,781669,20,6,9,1,2,5,7,0,0,0,0,5,0,1,1,0,17
1934,797857,6,1,2,0,1,1,1,2,2,1,1,2,1,0,1,0,5
1934,792384,4,1,2,1,1,0,1,0,0,0,2,0,1,0,1,0,2
1934,786764,7,0,1,0,0,0,1,0,0,0,1,1,0,0,1,0,0
1934,781668,11,2,2,1,1,1,1,0,0,1,3,0,0,0,0,0,5
1934,797860,12,2,3,2,3,0,0,0,0,2,0,4,1,0,4,0,4
1934,797854,20,3,6,0,0,3,6,0,0,1,2,3,2,0,2,0,9
1934,797853,17,2,6,1,2,1,4,0,0,0,1,0,2,0,0,0,5
1934,797852,18,5,8,4,5,1,3,0,0,2,3,3,0,2,0,0,11
1934,781671,15,0,2,0,1,0,1,0,0,0,6,4,0,0,1,0,0
1936,792351,22,2,3,2,3,0,0,0,0,0,3,2,2,0,1,0,4
1936,786723,36,8,17,8,16,0,1,3,4,3,3,2,2,2,3,0,19
1936,792349,32,6,10,6,10,0,0,2,6,0,2,2,0,2,0,4,14
1936,792355,32,4,10,2,7,2,3,2,2,0,4,1,4,1,1,0,12
1936,792352,30,4,7,2,3,2,4,2,2,2,1,4,3,2,1,0,12
1936,786724,20,2,6,2,5,0,1,2,3,0,2,4,3,0,0,0,6
1936,798061,12,1,2,1,1,0,1,0,0,0,2,0,2,0,0,0,2
1936,798060,16,1,4,1,4,0,0,4,4,0,4,0,3,0,1,0,6
1937,781454,38,12,16,11,15,1,1,6,8,2,8,0,1,0,3,2,31
1937,786424,28,3,7,3,7,0,0,1,2,1,8,3,4,0,4,1,7
1937,797979,21,1,2,0,0,1,2,0,1,0,1,0,2,0,2,1,3
1937,792279,21,0,3,0,1,0,2,2,2,0,2,0,5,0,4,1,2
1937,785483,31,4,8,4,4,0,4,2,3,0,2,8,4,1,6,1,10
1937,797991,2,0,1,0,1,0,0,0,0,0,0,0,0,0,0,0,0
1937,785959,12,2,5,2,5,0,0,1,2,2,3,1,2,0,0,0,5
1937,791015,20,0,0,0,0,0,0,0,0,0,0,2,2,0,0,0,0
1937,775335,13,2,4,0,0,2,4,0,0,0,0,1,2,0,0,0,6
1937,797988,14,1,3,0,1,1,2,0,0,0,2,2,1,0,0,0,3
1938,791482,15,1,2,0,0,1,2,0,0,0,3,2,0,0,0,0,3
1938,786319,17,5,7,5,7,0,0,3,6,7,4,1,1,1,0,0,13
1938,786318,24,6,10,2,2,4,8,0,0,1,2,1,2,0,0,1,16
1938,784268,25,5,8,4,6,1,2,0,0,0,1,8,1,5,4,0,11
1938,780223,26,6,10,2,3,4,7,0,0,0,4,2,0,0,1,0,16
1938,797198,11,1,4,1,3,0,1,4,4,0,2,0,0,1,0,1,6
1938,791481,14,2,3,2,2,0,1,0,0,1,5,0,1,0,2,0,4
1938,780225,19,2,4,1,1,1,3,0,0,0,3,0,3,0,1,0,5
1938,797200,12,2,4,0,0,2,4,0,0,0,1,0,2,0,0,1,6
1938,797199,10,0,3,0,2,0,1,2,2,1,2,0,2,0,2,0,2
1938,797201,9,0,1,0,0,0,1,0,0,1,0,3,0,1,0,0,0
1938,796079,3,0,1,0,0,0,1,0,0,0,0,0,0,0,1,0,0
1938,791480,4,0,0,0,0,0,0,0,0,0,0,0,0,0,1,0,0
1938,791479,3,0,1,0,0,0,1,0,0,0,0,0,0,0,0,0,0
1938,786317,3,0,0,0,0,0,0,0,0,0,1,1,0,0,1,0,0
1938,786320,5,0,1,0,0,0,1,0,0,0,1,0,0,0,1,0,0
1939,798968,28,3,7,1,3,2,4,2,2,0,1,0,1,2,1,1,10
1939,798966,10,0,1,0,1,0,0,0,0,0,1,0,3,0,0,0,0
1939,798967,31,4,6,3,4,1,2,0,2,0,3,2,0,0,0,0,9
1939,798965,25,3,5,2,3,1,2,0,0,0,4,0,1,0,1,0,7
1939,791718,28,5,12,2,6,3,6,1,2,0,1,1,1,0,2,0,14
1939,787996,8,0,1,0,1,0,0,0,0,0,0,0,1,0,0,0,0
1939,798962,9,0,2,0,2,0,0,0,0,2,0,1,0,1,1,0,0
1939,791720,4,0,0,0,0,0,0,0,0,0,1,0,1,0,1,0,0
1939,791717,5,1,4,1,3,0,1,0,0,0,0,0,1,1,2,0,2
1939,798964,12,0,1,0,1,0,0,0,1,0,0,0,1,1,2,0,0
1939,798969,4,1,2,1,1,0,1,0,0,0,1,2,0,2,0,0,2
1939,791719,20,2,5,1,2,1,3,1,2,0,4,2,1,1,1,0,6
1939,781446,7,1,2,1,2,0,0,0,0,1,1,0,0,1,2,0,2
1939,768880,9,0,3,0,1,0,2,0,0,0,1,1,0,0,1,0,0
1940,780096,30,3,8,1,3,2,5,2,2,0,3,2,3,0,0,0,10
1940,785906,30,5,14,5,12,0,2,0,0,1,6,5,2,0,4,0,10
1940,780100,29,1,2,1,2,0,0,0,0,1,7,3,2,1,1,0,2
1940,791416,25,12,15,12,15,0,0,9,15,4,9,0,3,0,3,2,33
1940,797096,26,5,13,1,4,4,9,0,0,0,3,1,4,1,0,0,14
1940,797093,22,3,4,2,2,1,2,2,2,0,6,9,4,0,2,0,9
1940,785907,15,2,3,2,3,0,0,0,2,1,4,0,2,0,0,0,4
1940,797094,12,0,1,0,0,0,1,2,2,0,1,1,3,0,1,0,2
1940,781614,4,1,1,1,1,0,0,2,2,0,2,0,0,0,1,0,4
1940,791417,4,2,3,2,3,0,0,0,0,0,1,0,3,0,1,0,4
1940,797098,1,0,0,0,0,0,0,0,0,0,0,0,1,0,0,0,0
1940,797097,1,0,0,0,0,0,0,0,0,0,0,0,0,0,0,0,0
1940,797095,1,0,0,0,0,0,0,0,0,0,0,0,0,0,0,0,0
1941,785635,16,4,8,2,3,2,5,0,4,1,1,0,5,0,1,1,10
1941,786720,26,0,9,0,8,0,1,1,2,0,3,2,2,0,2,0,1
1941,786440,28,3,8,2,4,1,4,2,2,1,2,3,3,1,1,0,9
1941,791628,22,1,7,1,3,0,4,1,2,4,3,0,2,0,2,2,3
1941,781199,33,3,13,2,10,1,3,9,10,0,6,4,0,0,0,1,16
1941,776462,18,1,8,1,6,0,2,6,7,4,4,0,1,1,0,2,8
1941,775642,16,3,4,2,2,1,2,0,0,0,0,0,2,1,1,0,7
1941,791629,14,2,3,1,1,1,2,1,3,0,0,1,2,3,0,0,6
1941,786439,8,0,0,0,0,0,0,0,0,0,2,0,2,0,0,0,0
1941,796974,17,1,7,1,4,0,3,0,2,0,1,0,0,0,1,0,2
1941,796973,2,1,2,0,0,1,2,0,0,0,0,0,0,1,0,0,3
1942,792167,25,6,7,6,7,0,0,0,0,2,6,0,5,0,2,2,12
1942,792170,16,1,3,1,3,0,0,0,0,0,1,1,2,0,0,1,2
1942,791372,24,3,6,0,1,3,5,0,0,0,2,0,2,0,3,0,9
1942,792164,32,6,14,4,8,2,6,5,8,1,7,4,0,0,4,1,19
1942,780974,28,6,10,3,6,3,4,2,2,0,2,1,3,0,2,0,17
1942,797766,7,2,4,2,3,0,1,1,1,0,0,0,2,0,2,0,5
1942,797767,20,0,1,0,0,0,1,0,0,0,2,6,1,1,2,0,0
1942,797772,9,2,3,0,0,2,3,0,0,0,1,1,1,0,0,0,6
1942,792163,24,3,4,1,1,2,3,0,0,3,2,3,0,0,0,0,8
1942,797764,3,0,1,0,0,0,1,0,0,0,0,0,0,0,0,0,0
1942,797777,12,0,0,0,0,0,0,0,0,0,3,1,2,1,0,1,0
1943,776253,27,4,11,4,6,0,5,0,0,0,4,0,3,0,0,0,8
1943,775651,27,6,8,6,8,0,0,4,4,1,3,1,1,0,1,0,16
1943,791070,30,3,9,3,6,0,3,1,2,1,2,1,2,3,1,0,7
1943,791627,31,5,10,4,7,1,3,2,2,1,5,4,1,3,2,0,13
1943,776178,29,4,8,3,7,1,1,0,2,1,0,3,1,3,0,1,9
1943,796505,8,0,3,0,3,0,0,0,0,0,1,0,1,1,0,0,0
1943,791071,3,0,0,0,0,0,0,0,0,0,0,0,1,0,0,0,0
1943,785660,2,0,1,0,0,0,1,0,0,0,0,0,0,0,0,0,0
1943,796504,1,1,1,1,1,0,0,0,1,1,0,0,0,0,0,0,2
1943,796502,14,2,4,1,1,1,3,2,2,2,0,1,2,1,1,0,7
1943,796501,11,3,4,3,4,0,0,0,2,0,1,0,0,0,0,0,6
1943,785665,17,0,4,0,2,0,2,1,2,0,1,0,3,0,1,0,1
1944,796699,23,2,6,2,5,0,1,3,4,5,2,0,1,3,0,2,7
1944,790983,26,6,12,6,8,0,4,3,4,2,4,0,0,2,2,2,15
1944,790978,26,2,7,1,2,1,5,3,7,0,3,0,2,0,0,0,8
1944,790979,24,6,12,4,6,2,6,4,7,1,2,0,2,2,0,0,18
1944,796700,32,6,11,5,7,1,4,2,2,2,5,6,1,0,3,0,15
1944,796701,17,1,2,1,2,0,0,1,2,4,3,1,1,0,1,1,3
1944,788820,20,1,5,1,3,0,2,4,5,0,0,1,0,1,0,0,6
1944,796698,12,2,2,2,2,0,0,0,1,0,1,0,1,0,0,1,4
1944,790981,3,0,2,0,1,0,1,0,0,0,0,1,0,0,0,0,0
1944,790976,12,1,1,1,1,0,0,0,0,0,0,0,2,0,2,0,2
1944,790980,1,0,0,0,0,0,0,0,0,0,0,0,1,0,0,0,0
1944,789457,1,1,1,1,1,0,0,0,0,0,0,0,0,0,0,0,2
1944,792693,1,0,0,0,0,0,0,0,0,0,0,0,0,0,0,0,0
1944,790977,1,0,0,0,0,0,0,0,0,0,0,0,0,0,0,0,0
1944,789458,1,0,0,0,0,0,0,0,0,0,1,0,0,0,0,0,0
1945,799000,26,4,8,4,8,0,0,1,2,1,4,0,3,0,1,0,9
1945,785471,27,4,7,3,5,1,2,0,0,0,4,3,2,1,6,0,9
1945,780263,21,4,7,3,6,1,1,1,1,0,2,3,4,1,0,1,10
1945,786697,15,1,2,0,0,1,2,0,0,0,0,1,2,1,1,0,3
1945,775628,31,5,8,4,7,1,1,0,0,0,3,2,4,1,4,1,11
1945,775198,17,2,4,2,3,0,1,0,0,1,0,0,2,0,1,0,4
1945,792399,16,2,7,1,4,1,3,2,2,1,4,1,0,0,2,0,7
1945,775547,10,1,3,1,3,0,0,2,2,0,1,1,0,0,2,0,4
1945,780571,13,0,0,0,0,0,0,2,2,1,1,1,3,0,0,0,2
1945,792397,12,2,3,2,2,0,1,0,0,0,1,0,2,0,1,0,4
1945,792400,8,0,2,0,2,0,0,0,0,0,1,0,0,0,0,0,0
1945,786695,3,0,0,0,0,0,0,0,0,0,0,0,1,0,0,0,0
1945,798999,1,0,0,0,0,0,0,0,0,0,0,0,0,0,0,0,0
1946,791220,26,4,6,3,3,1,3,1,1,0,1,3,3,2,2,0,10
1946,776217,14,1,4,1,4,0,0,0,0,0,4,0,4,0,2,0,2
1946,790818,29,5,12,2,8,3,4,5,6,1,1,7,3,2,1,0,18
1946,786396,17,0,4,0,0,0,4,0,0,1,3,1,0,0,1,0,0
1946,780730,25,5,13,2,2,3,11,1,3,0,4,0,3,1,1,1,14
1946,786824,22,3,7,2,3,1,4,2,2,2,1,1,2,0,0,1,9
1946,796923,18,1,1,1,1,0,0,2,3,2,4,1,2,2,1,0,4
1946,791219,27,2,9,1,4,1,5,0,0,1,5,2,1,3,1,1,5
1946,796921,19,1,2,0,1,1,1,0,0,0,1,2,0,1,2,0,3
1946,796920,3,0,2,0,0,0,2,0,0,0,1,0,0,0,0,0,0
1947,791289,26,4,9,4,9,0,0,0,1,2,5,0,3,1,4,0,8
1947,785786,24,0,1,0,0,0,1,0,0,0,4,2,2,1,0,0,0
1947,796571,26,2,8,2,5,0,3,0,1,2,6,3,1,0,1,0,4
1947,791291,23,1,4,0,1,1,3,6,6,0,0,0,1,0,1,0,9
1947,781346,24,3,7,0,2,3,5,0,1,2,5,3,4,0,5,1,9
1947,796576,23,6,12,2,4,4,8,1,2,0,4,2,4,0,2,0,17
1947,796574,4,0,1,0,1,0,0,0,0,0,1,0,1,0,1,0,0
1947,791290,26,3,6,0,0,3,6,2,2,1,3,0,0,2,0,2,11
1947,791288,17,1,3,1,2,0,1,0,0,0,1,3,2,1,2,0,2
1947,796572,7,0,1,0,0,0,1,0,0,0,1,0,0,1,1,0,0
1948,791610,25,7,9,7,9,0,0,0,0,2,5,4,2,3,2,0,14
1948,780471,27,5,7,5,6,0,1,2,2,3,16,1,1,1,1,1,12
1948,796994,20,7,11,2,3,5,8,0,0,0,1,1,0,2,3,0,19
1948,791608,27,4,12,0,0,4,12,0,0,2,3,10,0,1,0,0,12
1948,776011,23,8,9,4,5,4,4,1,2,1,3,6,0,2,1,0,21
1948,796996,12,4,6,4,6,0,0,1,2,4,1,1,0,1,1,0,9
1948,786413,8,1,4,1,2,0,2,0,0,0,2,1,0,0,0,0,2
1948,791613,16,5,8,5,6,0,2,2,4,0,0,1,0,3,1,0,12
1948,791612,6,0,3,0,2,0,1,0,0,2,2,0,0,0,0,0,0
1948,791611,9,1,3,0,0,1,3,0,0,0,0,2,0,0,1,0,3
1948,786353,8,0,2,0,1,0,1,0,0,1,0,0,0,0,0,0,0
1948,785680,12,3,3,1,1,2,2,0,0,1,1,0,1,1,0,0,8
1948,780417,7,1,2,1,1,0,1,0,0,0,0,1,0,0,1,0,2
1950,792227,28,1,5,1,4,0,1,0,0,3,8,1,1,1,0,1,2
1950,781352,20,0,1,0,1,0,0,2,2,1,1,1,1,2,2,0,2
1950,792223,30,7,12,7,8,0,4,1,3,1,2,0,2,0,1,1,15
1950,785935,40,6,13,5,9,1,4,0,0,0,5,5,1,2,2,0,13
1950,781340,32,2,4,2,4,0,0,2,3,0,2,0,3,0,2,0,6
1950,797881,20,4,5,4,5,0,0,2,4,1,1,0,3,0,0,2,10
1950,781351,10,0,4,0,2,0,2,0,0,1,1,1,1,0,1,0,0
1950,797882,15,1,2,0,0,1,2,0,0,0,1,0,2,0,1,0,3
1950,786453,5,0,0,0,0,0,0,0,0,0,0,0,0,0,0,0,0
1951,776018,32,6,7,6,7,0,0,1,2,2,2,1,2,2,2,2,13
1951,797859,30,0,2,0,1,0,1,2,2,1,4,1,2,0,1,0,2
1951,792208,29,1,7,0,4,1,3,0,0,0,1,1,2,0,4,0,3
1951,786262,35,6,9,3,5,3,4,4,4,1,2,1,2,0,0,0,19
1951,781314,38,3,11,2,8,1,3,0,0,0,4,1,4,0,4,0,7
1951,797856,20,1,3,1,2,0,1,0,2,0,5,2,2,1,3,0,2
1951,781317,16,0,4,0,2,0,2,0,0,0,2,1,1,1,0,0,0
1952,780201,29,1,5,1,5,0,0,4,4,1,4,0,5,1,3,0,6
1952,791469,29,3,4,3,4,0,0,2,2,2,3,1,4,0,2,0,8
1952,791467,38,2,14,2,4,0,10,4,5,0,5,0,0,1,1,0,8
1952,786311,37,6,15,3,5,3,10,4,4,0,2,0,0,3,0,0,19
1952,775516,27,3,4,2,3,1,1,3,4,0,0,2,0,4,2,0,10
1952,798344,9,2,4,1,3,1,1,0,0,1,1,0,1,0,0,1,5
1952,797210,31,2,7,2,7,0,0,3,3,2,2,8,4,1,2,0,7
1953,792078,26,4,5,4,5,0,0,0,0,1,6,0,3,0,2,0,8
1953,786067,38,3,8,3,8,0,0,1,2,3,9,2,3,0,2,2,7
1953,797661,19,1,3,1,1,0,2,0,0,1,0,3,0,0,3,0,2
1953,785591,32,5,8,3,4,2,4,1,1,0,0,3,2,1,3,0,13
1953,780258,24,2,6,0,1,2,5,0,1,0,4,2,4,1,4,0,6
1953,792082,22,5,8,2,3,3,5,2,2,2,2,2,2,1,3,0,15
1953,791952,1,0,0,0,0,0,0,0,0,0,0,0,0,0,0,0,0
1953,797659,6,1,2,0,0,1,2,0,0,0,0,0,0,0,0,0,3
1953,797660,10,3,6,2,4,1,2,1,1,0,3,1,1,0,1,1,8
1953,792083,22,2,6,2,5,0,1,0,0,0,1,3,4,0,3,0,4
1954,786860,20,6,11,5,7,1,4,0,0,2,4,0,1,0,0,1,13
1954,786547,18,3,7,3,3,0,4,0,0,3,6,2,2,0,2,1,6
1954,797507,18,6,10,6,8,0,2,1,1,3,3,4,0,1,0,0,13
1954,786546,23,3,7,0,2,3,5,3,3,1,5,4,1,0,2,0,12
1954,775084,20,4,8,0,1,4,7,0,0,0,2,3,2,0,2,0,12
1954,797511,10,2,3,2,2,0,1,0,0,1,0,0,1,0,1,0,4
1954,797510,21,3,10,2,5,1,5,0,0,0,5,1,0,2,2,0,7
1954,797508,19,1,4,1,3,0,1,0,0,0,0,0,1,0,1,0,2
1954,792013,31,6,18,6,16,0,2,4,6,12,9,2,1,2,0,1,16
1954,787622,15,3,5,0,0,3,5,0,0,0,3,1,0,0,0,0,9
1954,799740,5,0,5,0,1,0,4,2,2,0,0,0,1,1,1,0,2
1956,791669,21,4,4,4,4,0,0,0,0,2,3,2,1,0,2,2,8
1956,785762,22,5,7,5,7,0,0,0,3,2,7,0,1,1,0,1,10
1956,797409,18,3,6,3,6,0,0,0,0,0,1,2,0,0,2,0,6
1956,780535,17,4,7,1,2,3,5,0,1,1,5,0,0,1,3,0,11
1956,780531,29,5,10,4,4,1,6,1,1,0,3,5,3,1,0,0,12
1956,797414,10,1,2,1,2,0,0,0,1,1,1,0,1,0,0,0,2
1956,797411,6,1,1,1,1,0,0,0,1,1,4,1,3,1,1,1,2
1956,780534,20,3,4,3,4,0,0,4,4,2,1,1,2,1,2,0,10
1956,797407,6,1,3,1,2,0,1,1,3,0,0,0,0,1,1,1,3
1956,791671,5,0,2,0,0,0,2,0,0,0,1,0,0,0,0,1,0
1956,791666,16,5,6,1,2,4,4,0,2,0,1,3,0,1,0,0,14
1956,797415,10,3,4,2,2,1,2,1,1,0,0,0,2,1,0,0,8
1956,785760,20,2,4,2,2,0,2,0,0,0,1,2,0,0,1,0,4
1958,776004,20,3,6,0,2,3,4,4,4,3,4,1,3,0,0,0,13
1958,780358,25,3,10,1,7,2,3,0,0,0,3,1,4,0,1,0,8
1958,775011,26,2,6,2,5,0,1,0,0,0,6,1,2,0,1,1,4
1958,780357,36,4,7,2,3,2,4,7,9,0,2,2,1,1,0,0,17
1958,775018,32,6,15,5,11,1,4,4,5,0,1,2,1,2,0,0,17
1958,790930,22,0,1,0,1,0,0,1,2,0,6,2,4,0,1,2,1
1958,776270,15,2,2,1,1,1,1,0,0,0,1,0,0,0,1,0,5
1958,796480,23,5,10,4,9,1,1,1,3,2,3,2,1,1,0,0,12
1958,796484,1,0,0,0,0,0,0,0,0,0,0,0,0,0,0,0,0
1959,775897,20,0,1,0,1,0,0,0,2,0,4,1,2,0,0,0,0
1959,780324,31,7,13,7,13,0,0,5,7,2,3,2,2,1,3,2,19
1959,786530,36,2,9,0,1,2,8,0,0,1,4,3,4,0,3,0,6
1959,784246,25,2,7,1,4,1,3,0,0,1,4,3,3,1,3,0,5
1959,780317,34,5,9,2,2,3,7,2,3,0,5,0,4,1,2,0,15
1959,791545,12,0,1,0,1,0,0,2,2,0,2,2,3,0,1,0,2
1959,791543,19,2,7,1,4,1,3,1,1,1,0,3,3,0,1,0,6
1959,791546,7,2,3,1,1,1,2,0,0,1,2,0,2,0,0,0,5
1959,786360,13,1,3,0,0,1,3,0,0,0,0,1,1,0,0,0,3
1959,797091,3,0,1,0,1,0,0,2,2,0,0,0,0,0,1,0,2
1960,781300,30,1,5,1,4,0,1,2,2,2,4,2,4,0,2,0,4
1960,790803,26,4,5,4,5,0,0,2,4,2,5,3,0,0,2,0,10
1960,796360,30,6,10,6,7,0,3,4,6,0,6,1,3,2,3,0,16
1960,781304,35,4,9,2,5,2,4,4,4,1,3,1,1,1,2,0,14
1960,781302,34,4,7,2,3,2,4,0,0,0,2,3,1,3,1,0,10
1960,790802,5,1,2,0,0,1,2,0,0,0,0,0,1,0,0,0,3
1960,780598,19,1,3,1,3,0,0,0,0,0,1,1,3,0,1,0,2
1960,781305,11,4,7,1,4,3,3,0,0,1,0,1,1,0,0,1,11
1960,796363,6,1,2,1,2,0,0,0,0,0,1,1,0,0,1,0,2
1960,796362,4,1,1,1,1,0,0,0,0,1,0,0,1,0,1,0,2
1961,781462,33,3,6,3,5,0,1,6,8,2,0,0,5,1,1,0,12
1961,780876,26,5,9,3,5,2,4,0,0,1,3,3,3,2,3,1,12
1961,785353,35,7,15,5,9,2,6,5,6,1,4,0,2,0,4,0,21
1961,781673,17,0,2,0,0,0,2,0,0,0,2,1,1,1,1,0,0
1961,781457,38,3,7,2,4,1,3,0,0,0,1,1,3,2,2,0,7
1961,785355,26,2,7,2,4,0,3,0,0,0,5,4,0,1,0,0,4
1961,790895,23,2,5,2,4,0,1,1,1,0,1,2,2,0,1,1,5
1961,796365,2,0,0,0,0,0,0,0,0,0,0,0,1,0,0,0,0
1962,781480,30,2,10,2,6,0,4,0,0,0,3,2,4,2,3,0,4
1962,774846,31,4,6,4,6,0,0,0,0,2,4,0,2,2,3,0,8
1962,797182,31,2,4,1,3,1,1,1,2,1,6,0,4,0,2,0,6
1962,786558,36,7,10,7,8,0,2,5,7,0,2,7,4,0,7,0,19
1962,766611,26,3,9,1,3,2,6,0,0,0,2,0,2,0,1,0,8
1962,797183,13,3,3,2,2,1,1,3,5,0,2,0,2,2,0,1,10
1962,797272,30,3,8,1,1,2,7,2,2,0,0,1,3,2,1,0,10
1962,786185,3,0,0,0,0,0,0,0,0,0,0,0,1,0,0,1,0
1962,791377,0,0,0,0,0,0,0,0,0,0,0,0,0,0,0,0,0
1963,796372,30,5,7,5,7,0,0,4,4,1,3,0,2,0,3,0,14
1963,796377,29,2,6,2,3,0,3,4,4,1,2,1,1,3,2,0,8
1963,796379,36,3,12,3,5,0,7,2,2,0,2,2,2,3,3,0,8
1963,790815,39,2,8,2,4,0,4,11,11,3,8,0,1,1,3,0,15
1963,780176,26,2,8,1,3,1,5,2,2,1,1,3,5,0,1,0,7
1963,796376,9,4,4,2,2,2,2,0,0,0,3,0,4,1,1,0,10
1963,796378,19,3,4,2,2,1,2,3,6,0,2,2,0,0,3,0,10
1963,790814,12,1,1,1,1,0,0,0,0,0,2,1,4,0,1,0,2
1964,786257,36,5,12,5,10,0,2,0,1,3,3,2,3,0,2,4,10
1964,775825,40,14,23,13,19,1,4,5,6,0,7,6,0,2,0,0,34
1964,786263,13,1,3,1,2,0,1,0,2,1,3,0,1,0,2,0,2
1964,792122,24,3,5,1,1,2,4,0,0,0,0,0,4,0,0,0,8
1964,797724,9,1,3,0,2,1,1,0,0,0,2,0,1,1,0,0,3
1964,785661,22,1,4,0,3,1,1,6,8,2,2,1,2,1,2,0,9
1964,797725,4,1,1,1,1,0,0,0,0,1,1,0,1,0,1,0,2
1964,792121,27,4,5,2,2,2,3,0,0,2,6,1,2,1,0,2,10
1964,786249,9,1,3,1,1,0,2,0,0,0,1,0,0,0,0,0,2
1964,797722,16,0,5,0,1,0,4,0,0,2,0,1,3,0,1,0,0
1965,776205,32,6,19,5,15,1,4,2,2,1,2,2,3,1,3,1,15
1965,791245,38,5,8,0,1,5,7,2,3,0,5,2,2,1,2,0,17
1965,781243,31,4,10,3,6,1,4,3,3,2,6,3,3,0,0,1,12
1965,781244,31,7,10,7,9,0,1,3,4,1,6,1,3,0,1,2,17
1965,785529,26,2,8,2,6,0,2,2,3,2,2,1,0,0,1,0,6
1965,781237,7,0,0,0,0,0,0,0,0,0,0,0,1,0,0,0,0
1965,791241,20,2,3,2,3,0,0,0,0,0,1,0,3,0,1,0,4
1965,791243,15,2,4,2,4,0,0,0,0,0,3,0,1,0,0,0,4
1976,797904,15,0,3,0,3,0,0,0,0,1,3,1,0,0,1,0,0
1976,792306,31,4,9,3,6,1,3,1,2,3,3,1,4,2,3,0,10
1976,792303,34,8,22,7,17,1,5,8,8,3,0,2,2,0,4,0,25
1976,781603,16,0,1,0,0,0,1,0,0,0,0,0,1,0,3,0,0
1976,786618,15,0,0,0,0,0,0,0,0,1,1,0,3,0,0,1,0
1976,797914,27,5,10,2,3,3,7,2,2,2,3,1,1,1,1,0,15
1976,781605,9,0,2,0,2,0,0,0,0,0,3,0,1,0,1,0,0
1976,792300,25,7,8,6,7,1,1,2,2,1,6,1,3,0,0,0,17
1976,796155,22,0,3,0,0,0,3,0,0,0,1,3,0,1,0,0,0
1976,790813,6,0,2,0,0,0,2,0,0,0,1,1,0,0,1,0,0
1977,780609,37,3,7,1,2,2,5,0,1,1,1,5,3,6,2,0,8
1977,776395,38,7,12,4,6,3,6,4,4,0,3,4,2,0,2,0,21
1977,791837,29,4,8,3,7,1,1,4,6,0,4,0,2,0,1,1,13
1977,780613,31,6,6,6,6,0,0,1,1,0,3,2,1,1,0,0,13
1977,775097,26,7,12,7,11,0,1,0,0,0,8,3,1,1,2,1,14
1977,786621,9,0,1,0,0,0,1,0,0,0,1,0,3,0,0,0,0
1977,786622,16,1,3,1,2,0,1,0,0,0,3,0,1,0,0,0,2
1977,786169,11,2,2,2,2,0,0,2,2,0,0,0,0,0,2,0,6
1977,786619,3,0,0,0,0,0,0,1,2,0,0,0,2,0,1,1,1
1978,792181,39,6,10,6,10,0,0,6,9,7,9,1,4,0,0,1,18
1978,780986,40,7,13,7,12,0,1,0,0,2,2,1,2,1,3,0,14
1978,785902,24,0,4,0,1,0,3,0,0,0,4,1,2,2,3,0,0
1978,792179,39,5,16,3,7,2,9,9,9,0,4,3,2,6,3,0,21
1978,786662,33,1,12,1,9,0,3,0,0,0,2,1,3,1,1,0,2
1978,797796,18,0,4,0,3,0,1,5,6,0,1,1,1,0,0,1,5
1978,797794,7,0,1,0,0,0,1,2,2,0,2,0,0,0,0,0,2
1979,781071,28,3,6,2,2,1,4,2,2,1,5,0,3,0,3,0,9
1979,780098,30,1,3,1,3,0,0,0,0,1,9,0,4,1,0,1,2
1979,797591,35,3,11,0,2,3,9,0,0,0,2,5,1,0,0,0,9
1979,791890,20,2,5,1,1,1,4,2,2,0,1,4,2,2,4,0,7
1979,780719,34,2,8,2,4,0,4,2,2,1,7,3,5,1,5,0,6
1979,797589,27,5,9,2,5,3,4,3,4,1,0,0,4,2,6,1,16
1979,785424,9,1,1,1,1,0,0,0,2,0,1,1,2,0,1,0,2
1979,791888,17,1,4,0,1,1,3,2,2,0,1,0,1,1,0,0,5
1979,791889,0,0,0,0,0,0,0,0,0,0,0,0,0,0,0,0,0
1980,797382,22,1,6,0,2,1,4,2,3,2,4,1,4,3,3,1,5
1980,797379,18,2,4,2,3,0,1,1,1,2,5,0,3,2,1,0,5
1980,791818,37,3,15,0,6,3,9,0,1,1,2,2,2,0,4,0,9
1980,786636,24,2,11,2,7,0,4,2,4,0,1,2,4,0,2,0,6
1980,780646,25,3,5,3,3,0,2,2,2,0,3,4,3,1,4,1,8
1980,797380,14,0,3,0,0,0,3,1,2,1,0,0,5,0,0,0,1
1980,789043,22,4,7,4,7,0,0,2,2,5,5,0,3,1,3,1,10
1980,797378,2,0,1,0,1,0,0,0,0,0,0,0,1,0,1,0,0
1980,797377,22,3,4,1,1,2,3,2,2,1,1,1,3,0,1,0,10
1980,775168,14,0,2,0,2,0,0,1,2,0,0,0,2,0,3,0,1
1981,775556,38,8,16,8,15,0,1,4,5,6,7,1,3,0,2,0,20
1981,780234,20,2,3,2,2,0,1,6,9,1,3,1,4,0,1,2,10
1981,781110,26,1,4,1,3,0,1,1,2,0,5,3,3,0,2,0,3
1981,786411,40,4,8,3,4,1,4,3,4,0,5,1,3,1,2,1,12
1981,781104,33,5,15,2,9,3,6,4,7,1,3,0,1,0,2,1,17
1981,797184,2,0,0,0,0,0,0,0,0,1,0,0,1,0,1,0,0
1981,786328,9,0,0,0,0,0,0,0,1,1,1,0,2,1,1,0,0
1981,797185,13,0,2,0,2,0,0,0,1,2,1,1,0,0,0,0,0
1981,786405,19,6,12,6,10,0,2,1,2,0,1,3,4,2,4,0,13
1981,797189,0,0,0,0,0,0,0,0,0,0,0,0,0,0,0,0,0
1981,792656,0,0,0,0,0,0,0,0,0,0,0,0,0,0,0,0,0
1982,796404,25,5,9,5,6,0,3,3,4,1,2,3,3,0,0,1,13
1982,785434,12,0,5,0,4,0,1,0,0,0,1,0,0,0,0,0,0
1982,790853,5,1,2,1,2,0,0,0,0,2,0,0,3,0,0,0,2
1982,781164,23,2,5,1,2,1,3,5,6,1,5,4,2,1,3,0,10
1982,781163,34,5,13,2,6,3,7,9,10,1,1,3,2,0,4,0,22
1982,790849,19,2,6,2,4,0,2,0,0,0,4,1,2,1,0,0,4
1982,790850,25,2,6,1,2,1,4,8,9,1,5,3,0,0,0,0,13
1982,796406,16,2,2,2,2,0,0,0,0,1,2,0,1,0,0,1,4
1982,796405,9,0,1,0,1,0,0,0,0,0,0,0,0,0,0,0,0
1982,790854,24,2,2,2,2,0,0,1,2,0,6,0,3,2,1,0,5
1982,790848,8,0,1,0,0,0,1,0,0,0,1,1,0,1,1,0,0
1983,781624,24,4,6,3,4,1,2,5,5,3,2,1,4,0,1,2,14
1983,792246,18,2,5,2,5,0,0,0,0,1,4,1,3,1,2,0,4
1983,791701,31,2,4,2,2,0,2,2,2,4,4,0,2,1,3,1,6
1983,781420,27,1,11,0,5,1,6,2,2,1,2,3,5,1,3,0,5
1983,781405,35,3,18,2,8,1,10,3,6,1,4,3,2,0,2,1,10
1983,792244,22,2,5,1,3,1,2,0,0,0,5,0,4,0,0,0,5
1983,797924,11,2,3,2,3,0,0,0,0,0,0,0,0,0,0,0,4
1983,792245,25,2,4,0,0,2,4,0,0,0,0,1,5,0,1,0,6
1983,797925,7,3,4,3,3,0,1,1,2,2,1,0,3,0,2,0,7
1983,781417,0,0,0,0,0,0,0,0,0,0,0,0,0,0,0,0,0
1984,780870,29,6,9,6,9,0,0,4,6,7,13,1,4,0,2,1,16
1984,785380,12,0,2,0,0,0,2,0,0,0,1,0,4,0,0,1,0
1984,781079,29,6,14,5,9,1,5,4,6,2,1,5,1,1,0,1,17
1984,781443,33,6,16,5,13,1,3,2,4,1,4,9,2,1,0,1,15
1984,775822,28,6,12,3,5,3,7,1,4,0,0,2,2,0,3,0,16
1984,796626,1,0,0,0,0,0,0,0,0,0,0,0,1,0,0,0,0
1984,791316,14,4,6,4,5,0,1,0,0,1,0,0,1,0,0,1,8
1984,796625,12,0,1,0,0,0,1,0,0,0,1,1,0,1,0,0,0
1984,796621,18,3,5,1,1,2,4,0,0,0,2,0,0,0,1,1,8
1984,785831,24,4,5,4,5,0,0,0,0,1,0,0,3,0,0,2,8
1985,780797,33,5,7,5,5,0,2,0,0,1,7,3,2,0,1,0,10
1985,776418,13,4,6,4,6,0,0,3,4,2,0,0,3,0,0,0,11
1985,785505,27,5,14,4,12,1,2,6,6,2,0,3,4,0,3,0,17
1985,780555,35,5,12,2,4,3,8,0,0,1,3,4,2,0,0,0,13
1985,775604,33,3,11,1,2,2,9,4,5,1,5,2,2,0,0,0,12
1985,791616,15,1,2,1,1,0,1,0,0,0,1,1,0,0,0,0,2
1985,786429,14,1,2,1,2,0,0,2,4,3,4,0,2,0,0,0,4
1985,796986,13,2,4,1,1,1,3,0,0,0,0,2,0,0,0,0,5
1985,796984,1,0,0,0,0,0,0,0,0,0,0,0,1,0,2,0,0
1985,796981,16,3,7,3,5,0,2,1,6,1,3,0,2,1,2,0,7
1986,796723,23,1,9,1,5,0,4,0,0,0,4,1,2,1,3,0,2
1986,766998,22,5,7,5,7,0,0,0,1,3,4,1,0,0,3,2,10
1986,796718,27,4,7,2,3,2,4,0,0,0,1,2,0,2,0,0,10
1986,776374,33,5,12,3,8,2,4,0,0,1,0,3,3,2,2,0,12
1986,775412,31,2,5,0,2,2,3,1,4,1,1,0,2,0,1,1,7
1986,796719,16,1,4,1,2,0,2,0,0,1,5,0,1,0,0,0,2
1986,791042,11,4,7,4,7,0,0,0,0,1,5,1,1,0,1,0,8
1986,785512,6,1,1,1,1,0,0,0,0,2,0,1,0,0,1,0,2
1986,796717,19,2,4,2,3,0,1,4,6,1,1,0,2,3,0,0,8
1986,796720,11,0,4,0,4,0,0,0,0,1,1,0,1,0,2,0,0
1986,796721,1,0,0,0,0,0,0,0,0,0,0,0,0,0,0,0,0
1987,782643,22,3,5,3,5,0,0,0,0,3,8,2,4,0,3,3,6
1987,776037,27,6,10,6,10,0,0,4,4,4,1,1,0,0,1,1,16
1987,786147,31,3,8,3,6,0,2,0,0,1,1,0,2,2,3,1,6
1987,780667,34,7,15,5,10,2,5,2,2,0,7,4,0,3,1,2,18
1987,775680,19,1,6,1,4,0,2,0,0,1,0,2,0,1,0,0,2
1987,791758,2,0,1,0,1,0,0,0,0,0,1,0,0,0,0,0,0
1987,785987,24,2,2,1,1,1,1,0,0,0,3,4,2,2,0,0,5
1987,781647,7,0,2,0,2,0,0,2,2,1,0,2,0,0,0,0,2
1987,780588,19,4,5,4,5,0,0,0,0,1,3,0,2,0,4,1,8
1987,791759,14,3,6,3,6,0,0,1,3,0,1,1,3,1,1,1,7
1987,785229,1,0,0,0,0,0,0,0,0,0,0,0,0,1,0,0,0
1988,792266,26,4,5,4,5,0,0,13,14,2,3,1,2,3,5,0,21
1988,786152,37,4,9,3,6,1,3,11,15,5,8,4,1,1,2,1,20
1988,792265,38,5,12,3,8,2,4,5,6,3,9,0,2,1,1,5,17
1988,798006,16,1,4,0,1,1,3,2,2,0,0,1,1,1,2,0,5
1988,798003,18,1,3,1,2,0,1,2,4,0,2,3,3,0,2,0,4
1988,792267,27,1,10,1,4,0,6,3,3,1,3,1,3,1,1,0,5
1988,797998,14,2,8,1,3,1,5,0,0,2,0,0,0,0,0,0,5
1988,798009,18,1,7,1,3,0,4,0,0,0,3,0,2,0,1,0,2
1988,798007,4,0,2,0,2,0,0,0,0,1,1,0,1,0,0,0,0
1988,798002,2,0,0,0,0,0,0,0,0,0,0,0,0,0,0,0,0
1989,785416,27,8,17,8,16,0,1,2,4,4,9,4,3,0,1,0,18
1989,786138,28,6,13,4,7,2,6,2,6,0,2,2,5,0,1,0,16
1989,785669,27,1,4,0,1,1,3,0,0,1,3,2,1,1,3,0,3
1989,786140,11,0,0,0,0,0,0,1,2,1,3,2,4,0,1,0,1
1989,797359,3,0,0,0,0,0,0,0,0,0,0,0,3,0,1,0,0
1989,776236,24,3,7,3,6,0,1,2,2,0,3,0,2,1,1,0,8
1989,797358,24,2,6,1,2,1,4,1,2,0,1,1,4,4,2,0,6
1989,786578,14,3,4,3,4,0,0,0,1,0,3,2,1,0,0,1,6
1989,775195,17,2,6,1,1,1,5,0,0,1,0,0,2,0,1,1,5
1989,786136,12,2,5,2,2,0,3,0,0,0,1,0,2,0,1,0,4
1989,781145,9,1,2,1,2,0,0,0,0,0,3,1,3,0,2,2,2
1989,797357,4,1,1,1,1,0,0,0,0,0,0,0,0,0,0,0,2
1989,791365,0,0,0,0,0,0,0,0,0,0,0,0,0,0,0,0,0
1990,786066,34,6,13,5,10,1,3,2,2,0,9,5,0,2,4,0,15
1990,791123,35,3,7,2,4,1,3,3,4,0,1,0,2,1,1,0,10
1990,785636,38,3,8,1,4,2,4,0,0,1,2,5,2,2,1,1,8
1990,780890,29,2,9,1,6,1,3,0,0,0,2,1,2,0,1,0,5
1990,775757,15,0,1,0,1,0,0,1,2,1,3,0,4,0,1,0,1
1990,786646,22,6,7,3,3,3,4,1,2,2,6,1,1,0,1,1,16
1990,785969,26,5,9,4,7,1,2,3,4,1,5,2,0,1,2,0,14
1990,791119,1,0,1,0,1,0,0,0,0,0,0,0,0,0,0,0,0
1991,780550,26,6,13,6,12,0,1,2,4,1,3,2,1,0,0,0,14
1991,780552,33,5,6,2,2,3,4,0,0,1,0,0,0,0,1,0,13
1991,791674,32,5,12,4,7,1,5,0,1,1,3,3,1,3,6,0,11
1991,791672,27,5,10,5,10,0,0,0,1,4,1,1,3,0,1,0,10
1991,775606,20,4,6,4,6,0,0,0,1,1,6,1,5,0,2,2,8
1991,785793,14,2,3,1,1,1,2,0,0,0,1,0,1,0,0,0,5
1991,785791,25,1,6,0,0,1,6,0,0,1,6,3,1,3,1,2,3
1991,797424,9,1,1,1,1,0,0,0,0,0,2,0,0,1,0,0,2
1991,780538,11,0,5,0,3,0,2,0,0,0,3,1,2,0,1,0,0
1991,797423,3,0,0,0,0,0,0,0,0,0,1,0,0,0,0,0,0
1992,791511,18,2,4,2,4,0,0,0,0,3,2,0,1,0,1,4,4
1992,786637,29,1,5,1,3,0,2,4,6,1,2,0,2,0,3,0,6
1992,780946,20,1,3,0,1,1,2,2,2,1,2,4,2,1,3,0,5
1992,797150,28,3,10,1,4,2,6,3,5,1,3,1,2,1,1,0,11
1992,778442,27,5,16,3,10,2,6,1,2,1,4,0,3,0,2,0,13
1992,791514,11,2,4,1,2,1,2,0,0,0,2,0,1,0,0,0,5
1992,797149,12,0,4,0,3,0,1,3,4,0,2,0,0,0,1,0,3
1992,797151,19,3,5,2,4,1,1,2,2,5,2,2,1,1,0,1,9
1992,797152,13,1,4,1,3,0,1,0,1,2,2,0,0,0,0,1,2
1992,791513,15,0,5,0,4,0,1,0,0,2,2,2,0,1,0,0,0
1992,791515,3,0,0,0,0,0,0,0,0,0,0,0,2,0,1,1,0
1992,797154,5,1,3,0,1,1,2,0,0,0,0,0,0,0,0,0,3
1993,792626,29,2,6,2,5,0,1,2,2,0,5,7,2,1,3,1,6
1993,780250,23,7,11,4,6,3,5,0,0,1,4,2,4,1,1,1,17
1993,792632,11,1,1,1,1,0,0,0,0,2,2,0,4,0,2,0,2
1993,781491,32,4,12,2,5,2,7,1,2,0,3,2,1,0,0,0,11
1993,796637,24,6,6,5,5,1,1,3,3,1,5,0,1,1,2,1,16
1993,796645,22,6,10,3,7,3,3,2,4,0,3,1,1,0,0,0,17
1993,796642,5,0,0,0,0,0,0,0,0,0,0,0,2,0,0,0,0
1993,792631,1,0,0,0,0,0,0,0,0,0,0,0,0,0,0,0,0
1993,796638,5,0,2,0,0,0,2,0,0,0,1,0,0,0,1,0,0
1993,796634,7,1,3,1,3,0,0,0,0,1,0,1,0,1,0,0,2
1993,792629,17,2,3,0,0,2,3,1,2,0,1,3,1,1,2,0,7
1993,792627,8,0,2,0,1,0,1,0,0,0,1,0,1,0,1,0,0
1993,781289,16,0,0,0,0,0,0,0,0,0,5,0,0,0,1,2,0
1994,785675,36,8,16,5,9,3,7,3,3,2,3,0,0,3,3,0,22
1994,791080,32,5,11,5,8,0,3,2,5,2,7,4,1,1,0,0,12
1994,796514,26,3,8,3,6,0,2,2,2,0,1,6,4,2,4,0,8
1994,785294,22,1,5,1,5,0,0,2,2,6,8,0,1,1,5,0,4
1994,791081,6,0,0,0,0,0,0,0,0,1,0,0,1,0,0,0,0
1994,791083,26,4,9,2,4,2,5,0,1,2,2,0,1,0,1,1,10
1994,791085,14,4,5,4,4,0,1,0,0,0,0,1,2,0,2,0,8
1994,796512,19,2,8,1,4,1,4,0,0,1,2,0,2,0,1,0,5
1994,786446,13,0,3,0,1,0,2,0,0,0,3,1,2,0,2,0,0
1994,796511,6,0,0,0,0,0,0,0,0,0,0,0,1,1,1,0,0
1995,785685,32,8,10,6,8,2,2,5,6,1,2,6,1,1,4,0,23
1995,785977,28,6,10,5,6,1,4,3,3,3,5,1,0,1,0,0,16
1995,791269,29,5,14,1,3,4,11,0,0,0,2,0,1,3,0,0,14
1995,791266,23,3,9,3,9,0,0,0,4,4,4,1,2,2,0,4,6
1995,791265,33,1,5,0,2,1,3,0,0,3,2,5,2,2,3,0,3
1995,796525,16,4,6,3,4,1,2,0,0,0,3,0,3,1,2,0,9
1995,796522,10,3,6,0,1,3,5,0,0,0,0,0,0,0,0,0,9
1995,781313,10,2,5,1,2,1,3,0,0,0,1,1,0,0,2,0,5
1995,788872,10,0,1,0,1,0,0,0,0,0,0,0,3,0,1,0,0
1995,796523,5,0,1,0,0,0,1,0,0,0,2,0,1,0,1,0,0
1995,791270,4,0,0,0,0,0,0,0,0,0,0,0,1,0,0,0,0
1996,790839,16,3,3,3,3,0,0,0,0,0,0,1,2,1,0,1,6
1996,796393,12,0,3,0,3,0,0,1,1,2,3,0,2,0,3,2,1
1996,790840,26,4,6,2,3,2,3,0,1,0,7,0,3,1,1,0,10
1996,785386,32,6,11,5,8,1,3,2,3,0,1,2,2,2,4,0,15
1996,780373,37,2,7,0,0,2,7,4,4,0,2,3,3,1,1,0,10
1996,790841,13,0,0,0,0,0,0,0,0,2,0,1,0,0,1,0,0
1996,780370,24,2,3,1,1,1,2,0,0,1,5,1,4,3,1,0,5
1996,785388,27,6,12,6,12,0,0,4,4,2,7,8,3,0,4,0,16
1996,796395,9,2,7,2,3,0,4,0,0,0,1,0,0,1,0,0,4
1996,796396,4,0,1,0,0,0,1,0,0,0,0,0,0,0,0,0,0
1997,780054,32,5,11,3,6,2,5,2,4,2,3,2,3,2,5,0,14
1997,796433,22,2,6,2,6,0,0,1,2,3,0,0,2,0,0,1,5
1997,786851,31,4,14,2,5,2,9,3,3,0,4,2,2,1,3,0,13
1997,780343,7,1,1,1,1,0,0,1,1,0,0,0,0,0,0,0,3
1997,781139,25,3,6,3,4,0,2,1,1,1,2,1,1,1,2,1,7
1997,781140,24,3,7,3,6,0,1,0,0,3,5,2,3,0,0,1,6
1997,776357,35,2,7,2,6,0,1,2,2,1,2,7,4,2,3,0,6
1997,796432,7,1,2,0,0,1,2,0,0,0,1,0,2,0,0,0,3
1997,785429,17,1,4,0,0,1,4,0,0,0,2,0,1,0,0,0,3
1998,791482,11,0,1,0,0,0,1,0,0,0,5,5,0,0,0,0,0
1998,786319,13,1,3,1,3,0,0,1,2,2,5,1,1,1,0,0,3
1998,780225,14,4,5,1,1,3,4,0,0,0,2,0,1,1,0,0,11
1998,786318,12,2,4,0,0,2,4,0,0,0,0,1,0,0,1,1,6
1998,784268,12,3,4,3,4,0,0,0,0,0,1,1,0,1,1,0,6
1998,797198,19,6,7,6,7,0,0,5,5,0,2,5,0,1,0,1,17
1998,791481,12,2,3,1,2,1,1,0,0,0,3,0,1,0,0,1,5
1998,797200,16,2,5,0,0,2,5,0,0,0,2,2,0,0,1,0,6
1998,797199,17,3,5,2,3,1,2,2,2,0,3,1,1,0,1,1,9
1998,797201,17,2,3,1,1,1,2,0,0,0,3,2,1,0,1,0,5
1998,796079,14,3,4,1,1,2,3,0,0,0,0,0,0,2,0,0,8
1998,791480,10,0,1,0,0,0,1,0,0,1,0,0,0,2,3,0,0
1998,791479,10,3,4,2,2,1,2,0,0,0,1,2,1,2,0,1,7
1998,786317,10,2,3,2,2,0,1,0,0,0,2,1,0,1,0,0,4
1998,786320,13,1,4,1,1,0,3,2,2,0,1,0,2,0,0,0,4
2000,789219,35,4,8,0,2,4,6,2,2,0,4,0,0,2,4,0,14
2000,782133,20,1,6,1,3,0,3,0,0,0,8,0,0,0,0,2,2
2000,790990,31,4,8,4,7,0,1,0,0,0,5,5,4,0,2,0,8
2000,796623,31,2,7,2,5,0,2,1,3,0,1,2,1,0,4,0,5
2000,785123,33,11,17,11,16,0,1,3,6,1,5,4,3,0,3,1,25
2000,796622,3,0,1,0,1,0,0,0,0,1,1,0,3,0,2,0,0
2000,785303,16,1,1,1,1,0,0,0,0,0,3,0,0,0,0,0,2
2000,790988,9,1,3,0,1,1,2,0,0,0,3,0,1,0,1,0,3
2000,785122,16,1,1,0,0,1,1,2,2,0,3,1,0,0,0,0,5
2000,785305,3,0,0,0,0,0,0,0,0,0,0,0,1,1,0,0,0
2000,796624,3,0,0,0,0,0,0,0,0,0,0,0,1,0,0,0,0
2001,791367,23,2,6,2,6,0,0,0,0,1,1,1,3,1,2,0,4
2001,797232,33,4,12,2,6,2,6,0,0,1,5,1,2,1,2,1,10
2001,797234,31,2,8,2,4,0,4,2,3,1,7,1,2,1,4,0,6
2001,797235,21,1,4,1,4,0,0,2,3,2,3,0,0,0,1,1,4
2001,797239,39,6,19,2,9,4,10,4,6,1,6,1,1,2,2,0,20
2001,791369,4,0,0,0,0,0,0,0,0,0,1,0,0,0,0,0,0
2001,786535,6,0,3,0,0,0,3,0,0,0,0,0,3,0,0,0,0
2001,797233,13,1,3,1,2,0,1,0,0,1,2,0,5,2,0,1,2
2001,785446,16,1,4,0,1,1,3,0,0,0,1,2,0,0,1,0,3
2001,791368,9,1,2,1,2,0,0,0,0,2,1,0,1,1,0,1,2
2001,786251,5,1,1,1,1,0,0,0,0,0,0,0,3,0,2,0,2
2002,796469,22,5,11,3,4,2,7,5,7,3,7,0,4,2,3,2,17
2002,779981,22,2,5,2,5,0,0,3,4,2,2,1,1,1,1,2,7
2002,785463,33,6,10,1,3,5,7,0,2,1,3,6,2,0,4,0,17
2002,779978,33,2,6,1,2,1,4,4,4,1,3,3,1,2,1,0,9
2002,776003,24,3,8,2,5,1,3,6,8,1,2,3,2,2,2,0,13
2002,790923,21,3,6,3,4,0,2,0,1,1,3,0,3,0,0,1,6
2002,785466,18,1,4,0,0,1,4,0,0,2,2,2,3,0,0,0,3
2002,790924,11,2,4,2,2,0,2,3,3,0,0,0,2,1,3,1,7
2002,785467,2,0,1,0,0,0,1,0,0,0,0,0,0,0,1,0,0
2002,785462,9,0,1,0,0,0,1,0,0,1,1,0,2,0,3,0,0
2002,779980,5,0,0,0,0,0,0,0,0,1,2,0,5,0,0,0,0
2003,797367,34,1,7,1,7,0,0,6,11,2,3,0,2,0,4,0,8
2003,797364,15,0,2,0,2,0,0,1,2,3,1,1,5,0,3,0,1
2003,797366,13,1,2,1,2,0,0,0,0,0,1,1,1,0,2,0,2
2003,791807,23,2,6,2,3,0,3,0,0,1,1,2,1,0,0,0,4
2003,786130,35,8,18,4,12,4,6,3,6,1,3,1,2,2,4,1,23
2003,797369,25,3,5,1,3,2,2,3,5,0,1,2,1,2,0,0,11
2003,797368,4,0,1,0,1,0,0,1,2,0,1,0,1,0,0,1,1
2003,797365,18,1,5,0,2,1,3,0,0,0,0,0,2,1,0,0,3
2003,797363,10,0,2,0,1,0,1,2,2,0,0,1,2,0,3,0,2
2003,791808,11,1,1,0,0,1,1,0,0,0,0,1,2,0,0,0,3
2003,797371,12,2,5,2,5,0,0,1,1,2,6,2,0,0,0,0,5
2004,796860,35,2,10,2,10,0,0,1,2,1,3,2,2,1,0,0,5
2004,791185,21,0,1,0,0,0,1,0,1,0,3,1,5,0,1,1,0
2004,791187,20,6,8,6,8,0,0,3,3,1,5,0,5,1,2,0,15
2004,785650,24,1,4,1,3,0,1,0,0,0,0,2,5,1,0,1,2
2004,785649,37,11,18,9,13,2,5,9,9,0,4,2,2,2,2,0,33
2004,791183,3,0,1,0,1,0,0,0,1,1,0,0,1,0,1,0,0
2004,775208,16,5,8,5,8,0,0,0,1,0,5,0,3,0,0,0,10
2004,796861,8,1,2,0,0,1,2,0,0,0,0,0,0,0,3,0,3
2004,796857,23,0,4,0,3,0,1,2,2,0,2,1,3,0,0,0,2
2004,791184,13,2,5,2,3,0,2,1,2,0,0,0,2,6,3,1,5
2004,791186,0,0,0,0,0,0,0,0,0,0,0,0,0,0,0,0,0
2005,786509,15,0,2,0,2,0,0,0,2,1,4,0,5,0,3,0,0
2005,786508,38,7,16,5,10,2,6,5,9,3,6,2,4,0,5,3,21
2005,786507,22,2,5,1,2,1,3,0,2,0,4,1,2,1,4,0,5
2005,785796,33,6,13,4,9,2,4,12,14,1,5,2,2,1,1,1,26
2005,797576,36,6,8,3,5,3,3,6,6,0,2,2,1,1,2,1,21
2005,797577,23,0,0,0,0,0,0,4,4,2,2,1,0,0,0,2,4
2005,786511,1,0,0,0,0,0,0,0,0,0,0,0,1,0,0,0,0
2005,797582,1,0,0,0,0,0,0,0,0,0,1,0,1,0,2,0,0
2005,797580,18,2,4,0,1,2,3,0,0,1,5,0,0,1,1,0,6
2005,791897,13,0,1,0,0,0,1,0,0,1,0,0,4,0,1,0,0
2006,785432,20,3,6,3,6,0,0,0,1,1,3,0,2,0,2,0,6
2006,779985,29,7,16,4,7,3,9,0,0,4,5,1,1,1,2,2,17
2006,790882,24,4,7,4,6,0,1,0,0,1,5,0,1,0,0,0,8
2006,790876,26,0,4,0,2,0,2,2,2,0,0,0,2,0,2,0,2
2006,774987,32,5,9,5,9,0,0,8,9,3,7,7,1,0,3,1,18
2006,790877,11,1,2,0,1,1,1,0,0,0,1,2,2,0,1,0,3
2006,785699,10,0,3,0,2,0,1,0,0,0,4,1,2,0,2,0,0
2006,781062,16,5,9,1,2,4,7,0,0,1,3,0,0,1,0,1,14
2006,790879,20,0,4,0,4,0,0,4,6,3,3,2,1,1,2,1,4
2006,796434,12,2,4,1,1,1,3,2,3,1,1,0,1,0,0,0,7
2007,786547,27,2,7,2,2,0,5,0,0,0,3,2,4,1,1,1,4
2007,786544,33,5,14,5,10,0,4,6,6,2,6,1,4,1,0,0,16
2007,797507,28,3,9,0,4,3,5,2,2,0,3,1,1,1,0,1,11
2007,792012,38,7,13,3,6,4,7,2,2,1,3,2,1,2,3,0,20
2007,775084,23,2,9,1,4,1,5,0,0,1,5,0,2,0,5,0,5
2007,786860,15,0,6,0,3,0,3,0,0,0,2,0,5,0,1,1,0
2007,792013,14,1,3,1,2,0,1,0,0,3,3,0,1,1,1,0,2
2007,786546,14,1,4,1,3,0,1,2,2,0,0,0,0,0,0,0,4
2007,797510,8,1,2,0,1,1,1,0,0,0,0,0,0,0,0,0,3
2008,791997,34,5,11,4,7,1,4,0,0,0,3,3,0,1,1,0,11
2008,786566,32,7,10,6,9,1,1,4,6,2,5,1,2,1,1,2,19
2008,791993,26,6,7,5,5,1,2,0,0,0,3,3,4,1,1,2,13
2008,781189,22,5,7,5,7,0,0,2,2,1,3,2,1,1,2,0,12
2008,781188,36,6,9,6,9,0,0,9,9,0,3,8,3,1,5,0,21
2008,786567,2,0,1,0,1,0,0,0,0,0,0,0,0,0,0,0,0
2008,791995,7,2,2,2,2,0,0,0,1,0,1,0,0,0,1,0,4
2008,786565,3,0,1,0,1,0,0,0,0,0,1,0,1,0,0,0,0
2008,786562,15,2,3,2,3,0,0,2,2,0,1,4,5,0,2,0,6
2008,786563,22,1,1,1,1,0,0,1,2,1,3,0,0,0,1,1,3
2008,781186,1,1,1,1,1,0,0,0,0,0,0,0,0,0,0,0,2
2010,785423,28,3,6,2,4,1,2,0,1,1,7,0,2,0,2,1,7
2010,775676,19,2,5,2,5,0,0,3,3,0,1,1,0,1,1,2,7
2010,786298,34,1,7,0,2,1,5,2,2,1,4,3,2,1,2,0,5
2010,785425,37,10,12,6,6,4,6,1,1,0,1,2,3,1,3,1,25
2010,785422,36,4,9,2,3,2,6,2,2,0,1,3,1,1,3,0,12
2010,786210,21,3,7,2,6,1,1,2,2,1,2,1,2,0,1,0,9
2010,774957,19,0,1,0,0,0,1,0,0,0,2,1,0,0,0,0,0
2010,796431,1,0,0,0,0,0,0,0,0,0,1,1,0,0,0,0,0
2010,796429,5,0,2,0,2,0,0,0,0,0,1,0,1,0,0,0,0
2011,790764,38,8,17,8,15,0,2,2,2,2,5,4,2,2,1,2,18
2011,775668,9,1,4,1,4,0,0,0,0,1,2,2,2,1,0,0,2
2011,796319,29,6,11,3,7,3,4,1,1,1,4,1,2,2,1,0,16
2011,796320,35,5,6,3,3,2,3,2,2,1,1,0,1,1,2,0,14
2011,779993,33,4,8,3,4,1,4,0,0,0,1,2,3,1,1,0,9
2011,790761,9,0,2,0,2,0,0,0,0,0,4,1,1,0,2,0,0
2011,796321,24,4,8,2,6,2,2,0,0,2,3,1,2,0,0,0,10
2011,796322,8,2,2,2,2,0,0,0,0,0,2,0,0,0,0,0,4
2011,785219,15,1,2,1,2,0,0,0,0,0,1,0,0,1,1,0,2
2012,790781,21,4,7,4,7,0,0,1,2,1,2,0,1,0,1,1,9
2012,780040,13,0,3,0,2,0,1,0,0,0,0,1,0,1,0,1,0
2012,790785,30,5,10,5,9,0,1,3,5,0,3,3,2,1,3,0,13
2012,796340,36,10,20,10,16,0,4,4,5,0,6,1,2,4,2,2,24
2012,780037,34,2,7,2,3,0,4,5,5,0,2,2,0,0,2,0,9
2012,785239,15,1,5,0,1,1,4,0,0,1,3,0,4,0,0,1,3
2012,781232,21,0,4,0,1,0,3,0,0,0,1,2,3,2,2,0,0
2012,796339,11,0,1,0,0,0,1,0,0,0,0,0,1,1,0,0,0
2012,796343,19,2,3,2,3,0,0,1,4,1,0,0,2,1,0,1,5
2013,780095,32,5,6,5,6,0,0,0,0,4,5,1,4,0,1,1,10
2013,786081,34,3,6,2,3,1,3,0,0,0,5,1,1,2,5,0,7
2013,785431,31,3,8,2,4,1,4,0,0,0,3,5,4,1,5,0,7
2013,780232,33,5,12,2,6,3,6,5,5,0,6,3,2,1,2,0,18
2013,797918,4,0,1,0,0,0,1,0,0,0,1,1,1,0,0,0,0
2013,786020,6,2,2,2,2,0,0,0,0,0,3,0,0,0,0,1,4
2013,785356,7,1,3,0,1,1,2,0,0,1,2,0,1,0,1,2,3
2013,789040,18,1,6,1,5,0,1,3,4,1,1,1,4,1,1,0,5
2013,776321,35,9,16,7,11,2,5,2,2,1,9,2,3,1,4,0,22
2022,786299,14,1,2,1,2,0,0,0,0,0,2,1,5,0,3,0,2
2022,797215,25,2,6,1,4,1,2,0,0,0,2,2,1,0,1,0,5
2022,786295,17,4,6,3,3,1,3,0,0,1,1,1,2,1,1,1,9
2022,780792,31,7,12,5,7,2,5,1,1,0,3,2,1,0,1,0,17
2022,775598,21,3,6,1,2,2,4,0,0,1,4,1,2,1,2,0,8
2022,780122,12,2,3,2,3,0,0,0,1,0,2,0,4,0,1,2,4
2022,797214,27,4,12,4,11,0,1,1,2,0,3,1,2,1,2,1,9
2022,791461,20,3,4,2,3,1,1,0,0,3,5,1,2,1,3,0,7
2022,791459,14,0,4,0,4,0,0,0,0,1,0,2,1,0,0,0,0
2022,791460,16,1,3,0,0,1,3,2,6,0,1,1,0,1,1,0,5
2022,797216,3,0,0,0,0,0,0,0,0,0,0,0,0,0,0,0,0
2023,797028,16,2,2,2,2,0,0,0,0,1,1,2,1,0,0,0,4
2023,791598,36,13,17,11,14,2,3,9,14,0,5,2,2,1,1,2,37
2023,797025,21,0,5,0,3,0,2,4,5,0,3,0,2,0,1,0,4
2023,792116,32,3,7,0,1,3,6,2,2,1,1,9,1,5,1,0,11
2023,780410,29,5,13,1,1,4,12,0,0,0,2,3,1,1,1,0,14
2023,797026,6,0,1,0,1,0,0,0,0,0,1,1,1,0,0,0,0
2023,785687,18,2,5,1,2,1,3,0,0,2,5,2,2,0,2,0,5
2023,775047,3,0,0,0,0,0,0,0,0,0,0,0,1,0,0,0,0
2023,797027,23,3,5,3,5,0,0,1,2,4,5,0,2,0,3,0,7
2023,791597,3,0,0,0,0,0,0,0,0,0,0,0,1,0,0,0,0
2023,791600,13,1,5,0,3,1,2,0,0,0,1,0,0,0,2,0,3
2024,785523,13,1,2,1,2,0,0,0,0,0,0,0,1,0,3,0,2
2024,781247,20,0,1,0,1,0,0,0,0,2,3,0,2,1,2,0,0
2024,791249,34,6,14,3,7,3,7,8,8,2,5,3,5,2,4,1,23
2024,785521,32,4,8,0,0,4,8,0,0,1,2,2,3,0,1,0,12
2024,775358,29,1,1,0,0,1,1,1,3,0,3,3,4,1,5,0,4
2024,785522,17,1,1,1,1,0,0,0,1,2,1,1,3,0,2,0,2
2024,791250,25,4,8,3,6,1,2,2,2,1,6,0,2,2,1,0,11
2024,780703,18,5,9,3,6,2,3,0,0,1,0,1,0,0,0,0,12
2024,796947,12,0,0,0,0,0,0,0,0,0,0,0,1,2,2,0,0
2025,791062,39,5,12,5,9,0,3,2,3,0,5,0,1,3,4,1,12
2025,791063,16,2,5,2,4,0,1,1,2,2,3,0,3,1,1,0,5
2025,785542,22,0,1,0,0,0,1,2,6,0,1,1,2,1,0,0,2
2025,780743,31,5,6,4,5,1,1,3,3,2,1,2,5,3,4,0,14
2025,780055,24,1,4,0,0,1,4,1,2,2,0,1,3,0,2,0,4
2025,796741,5,0,0,0,0,0,0,0,0,1,0,0,0,0,0,1,0
2025,791060,21,2,6,2,5,0,1,0,0,0,1,2,5,1,2,1,4
2025,796735,21,3,6,1,2,2,4,2,8,0,1,0,0,0,0,1,10
2025,791064,21,1,5,0,1,1,4,2,2,0,1,1,1,3,2,0,5
2026,791023,26,5,6,5,6,0,0,2,5,2,7,0,3,1,0,2,12
2026,791027,21,1,3,0,1,1,2,3,4,0,3,2,1,1,2,1,6
2026,791024,36,4,10,1,4,3,6,0,2,0,4,3,1,2,3,0,11
2026,781507,28,0,1,0,1,0,0,1,2,1,1,3,2,1,3,0,1
2026,777572,35,6,10,5,6,1,4,9,11,0,0,3,2,3,2,0,22
2026,796686,6,1,1,1,1,0,0,0,0,0,3,2,0,0,1,0,2
2026,791727,5,0,1,0,0,0,1,0,0,0,1,0,1,0,0,0,0
2026,796685,25,3,6,0,1,3,5,5,5,0,2,1,1,0,3,0,14
2026,796684,18,3,6,3,6,0,0,0,0,0,0,0,0,1,0,0,6
2026,796683,0,0,0,0,0,0,0,0,0,0,0,0,0,0,0,0,0
2027,792388,7,1,1,1,1,0,0,0,0,2,1,0,2,0,0,0,2
2027,797845,35,5,15,2,4,3,11,2,2,3,0,2,2,0,1,0,15
2027,797851,32,1,8,1,4,0,4,0,0,2,0,4,2,3,2,1,2
2027,792391,37,11,16,11,16,0,0,1,3,5,5,0,3,3,3,0,23
2027,792395,36,5,18,5,14,0,4,0,2,6,6,6,3,2,6,1,10
2027,781533,22,2,9,0,2,2,7,0,0,1,3,1,4,1,1,0,6
2027,780840,14,2,2,2,2,0,0,0,0,1,4,0,2,1,0,1,4
2027,781541,15,0,2,0,1,0,1,0,2,2,2,1,3,0,2,0,0
2027,792394,2,0,0,0,0,0,0,0,0,0,0,0,0,0,0,0,0
2028,775640,19,4,5,2,3,2,2,4,6,1,1,0,2,1,1,1,14
2028,780919,22,4,8,4,5,0,3,1,2,2,6,1,3,0,1,0,9
2028,785803,20,2,3,1,1,1,2,0,0,0,1,1,0,0,0,0,5
2028,780920,27,6,8,5,6,1,2,4,4,0,5,8,0,0,0,0,17
2028,780914,19,4,8,2,6,2,2,1,1,2,2,1,2,1,3,0,11
2028,775816,20,3,7,1,3,2,4,0,0,1,4,1,0,1,2,0,8
2028,791142,18,1,8,0,3,1,5,0,0,1,4,0,1,0,0,0,3
2028,796797,16,4,8,3,5,1,3,6,7,0,9,1,4,1,1,0,15
2028,791141,22,2,6,2,4,0,2,0,0,1,0,4,1,0,0,1,4
2028,796801,6,1,1,0,0,1,1,2,2,0,0,0,2,0,1,0,5
2028,796796,6,0,0,0,0,0,0,0,0,0,0,1,0,0,0,0,0
2028,775639,2,0,0,0,0,0,0,0,0,0,1,0,0,0,0,0,0
2028,796798,1,0,0,0,0,0,0,0,0,0,1,0,0,0,0,0,0
2028,796802,2,0,0,0,0,0,0,0,0,0,0,0,0,0,0,0,0
2029,780570,18,3,5,3,5,0,0,0,0,0,1,0,4,0,1,0,6
2029,780569,28,3,8,3,8,0,0,0,0,2,9,1,1,0,1,0,6
2029,797438,28,3,6,2,3,1,3,0,0,1,0,3,0,1,2,0,7
2029,791697,23,1,11,0,7,1,4,1,2,1,1,0,3,0,0,0,4
2029,780565,24,1,5,0,2,1,3,0,0,0,1,5,1,1,2,0,3
2029,791695,15,1,4,1,4,0,0,0,0,0,3,0,3,0,2,0,2
2029,797434,1,0,0,0,0,0,0,0,0,0,1,0,1,0,0,0,0
2029,791696,15,3,10,3,10,0,0,5,6,0,1,1,1,0,1,0,11
2029,797432,26,3,9,1,4,2,5,0,0,0,1,3,2,1,1,0,8
2029,785824,11,0,1,0,0,0,1,0,0,2,2,1,3,0,2,0,0
2029,797433,3,1,1,1,1,0,0,0,1,0,3,0,2,0,0,1,2
2029,797436,3,0,1,0,0,0,1,0,0,0,0,0,0,0,1,0,0
2029,791693,4,0,0,0,0,0,0,0,0,0,0,0,1,0,0,0,0
2029,791694,1,0,0,0,0,0,0,0,0,0,0,0,0,0,0,0,0
2030,790821,35,4,12,3,6,1,6,3,8,3,7,0,1,0,2,2,12
2030,775585,24,1,3,1,3,0,0,0,0,1,3,0,4,0,1,1,2
2030,790822,37,6,10,3,5,3,5,6,9,1,2,1,2,2,1,1,21
2030,790820,35,3,11,2,6,1,5,2,8,0,4,3,1,1,7,0,9
2030,780982,37,2,12,2,5,0,7,3,4,1,1,3,2,2,2,0,7
2030,796381,14,1,4,1,3,0,1,2,2,0,2,0,1,1,0,0,4
2030,780445,15,0,0,0,0,0,0,0,0,0,3,0,3,0,0,1,0
2030,785365,3,0,0,0,0,0,0,0,0,0,0,0,0,0,0,0,0
2031,791876,24,4,9,4,7,0,2,2,3,3,6,3,4,1,1,0,10
2031,791877,22,2,3,2,3,0,0,0,0,0,4,2,4,0,0,0,4
2031,785667,26,6,11,2,5,4,6,2,2,1,1,2,0,1,0,0,18
2031,786572,39,5,10,3,6,2,4,3,4,0,5,3,2,2,1,1,15
2031,786570,21,3,8,3,5,0,3,1,1,0,4,3,4,2,5,0,7
2031,780436,8,1,2,0,1,1,1,0,0,1,1,0,2,0,3,0,3
2031,797490,13,3,5,3,5,0,0,3,5,0,0,1,3,1,1,1,9
2031,797487,12,0,0,0,0,0,0,0,0,0,4,1,1,0,0,0,0
2031,797491,9,0,2,0,1,0,1,0,0,0,0,0,0,0,0,0,0
2031,797486,19,2,4,2,4,0,0,0,1,0,3,1,1,1,4,0,4
2031,781205,5,0,0,0,0,0,0,0,0,0,1,0,1,0,0,0,0
2031,790396,2,0,0,0,0,0,0,0,0,0,0,0,1,0,0,0,0
2032,780023,29,5,9,5,9,0,0,1,3,3,6,0,4,1,2,6,11
2032,792493,23,2,3,1,1,1,2,0,0,2,0,0,0,0,0,1,5
2032,792495,16,3,7,3,6,0,1,2,3,1,1,1,5,1,3,0,8
2032,792491,38,7,16,7,16,0,0,4,4,0,1,8,4,1,4,1,18
2032,781144,38,6,14,6,11,0,3,0,3,0,4,0,3,0,1,0,12
2032,798960,2,0,0,0,0,0,0,0,0,0,2,0,1,0,0,0,0
2032,792492,32,2,8,2,7,0,1,0,0,2,2,0,3,2,5,1,4
2032,793441,1,0,0,0,0,0,0,0,0,0,0,0,1,0,1,0,0
2032,792490,5,0,0,0,0,0,0,0,0,0,1,0,3,0,2,0,0
2032,786832,16,0,1,0,1,0,0,0,0,0,3,1,1,2,0,1,0
2033,792110,9,2,3,2,3,0,0,0,0,2,1,1,5,0,1,0,4
2033,786031,23,5,6,4,4,1,2,3,6,1,3,0,3,0,0,0,14
2033,797734,30,5,12,3,9,2,3,0,2,0,2,1,1,1,6,0,12
2033,786036,28,1,1,0,0,1,1,2,2,0,5,8,1,1,3,1,5
2033,781386,33,6,11,2,6,4,5,4,5,0,3,2,1,1,2,0,20
2033,797732,2,0,0,0,0,0,0,0,0,0,0,0,0,0,0,0,0
2033,786033,29,3,8,3,8,0,0,4,8,6,5,1,3,0,2,4,10
2033,797733,14,0,4,0,1,0,3,2,3,0,4,0,0,1,1,1,2
2033,792109,14,1,2,1,1,0,1,0,1,0,0,0,1,0,0,1,2
2033,792107,1,0,0,0,0,0,0,0,2,0,0,0,0,0,0,0,0
2033,797735,17,2,4,0,2,2,2,0,0,0,0,1,1,1,3,0,6
2034,797047,21,4,5,3,3,1,2,0,0,1,2,1,4,0,3,2,9
2034,775515,29,5,8,4,4,1,4,2,2,0,3,0,2,0,0,5,13
2034,791579,41,2,7,1,4,1,3,4,4,0,8,5,3,2,2,0,9
2034,786387,40,8,14,7,10,1,4,3,4,0,7,6,4,1,4,0,20
2034,780399,38,5,18,2,8,3,10,0,0,1,4,6,3,2,4,0,13
2034,786846,20,3,8,0,2,3,6,5,7,0,5,2,1,1,3,1,14
2034,780400,11,1,2,1,1,0,1,0,0,1,1,1,2,0,0,2,2
2034,791575,9,1,1,1,1,0,0,0,0,0,0,0,0,0,1,0,2
2034,797046,4,1,3,1,2,0,1,0,0,0,1,1,0,0,1,0,2
2034,791577,12,1,3,0,0,1,3,0,0,2,0,0,0,0,0,0,3
2035,797967,31,4,7,1,4,3,3,4,4,2,5,4,4,0,1,0,15
2035,797962,12,2,2,2,2,0,0,0,2,0,1,0,3,1,0,0,4
2035,797970,33,6,16,4,11,2,5,2,2,3,10,2,2,1,4,0,16
2035,781453,39,7,21,4,10,3,11,6,6,0,7,8,1,4,6,1,23
2035,774869,40,1,5,0,1,1,4,1,2,0,1,2,1,1,0,0,4
2035,797972,30,4,12,4,7,0,5,4,4,6,2,0,4,2,1,0,12
2035,792254,16,4,5,3,4,1,1,0,0,1,2,0,2,0,1,0,9
2035,797961,8,2,2,2,2,0,0,0,0,0,3,1,1,0,2,0,4
2035,786098,16,4,5,4,4,0,1,1,3,0,2,0,0,1,0,0,9
2036,796442,3,0,0,0,0,0,0,0,0,0,0,0,1,0,1,0,0
2036,796436,31,6,18,6,15,0,3,5,8,3,5,3,3,0,1,2,17
2036,790885,18,3,6,2,3,1,3,1,1,1,4,0,2,0,1,0,8
2036,785436,36,3,5,3,4,0,1,4,7,4,5,6,1,2,1,0,10
2036,781262,19,2,8,0,1,2,7,0,0,0,0,2,2,2,1,0,6
2036,796439,19,5,9,5,9,0,0,0,0,3,2,0,2,0,1,0,10
2036,790884,17,3,6,3,6,0,0,2,2,3,0,0,1,1,5,0,8
2036,791635,15,1,4,1,3,0,1,1,2,0,1,0,3,2,0,0,3
2036,796438,26,4,7,4,5,0,2,4,6,0,2,0,0,1,0,0,12
2036,790883,16,1,4,1,4,0,0,0,0,0,1,2,2,3,2,0,2
2037,785638,18,0,1,0,0,0,1,0,0,0,6,0,3,0,2,1,0
2037,781326,33,7,12,7,12,0,0,4,8,3,5,0,3,1,0,7,18
2037,797870,37,5,10,4,7,1,3,5,6,0,2,3,2,0,4,0,16
2037,792210,22,1,2,0,1,1,1,0,0,0,2,1,3,0,2,0,3
2037,781323,40,9,15,6,10,3,5,0,0,0,4,4,1,1,5,0,21
2037,785430,7,1,3,1,3,0,0,0,1,0,2,0,2,0,1,0,2
2037,780874,14,2,4,1,1,1,3,0,0,0,3,0,1,3,1,0,5
2037,792215,27,4,7,2,3,2,4,0,0,0,4,2,3,0,5,1,10
2037,792213,2,1,1,1,1,0,0,0,0,1,0,0,1,0,0,0,2
2038,791981,28,8,12,6,9,2,3,0,0,1,4,4,4,0,0,0,18
2038,780342,27,3,7,3,7,0,0,6,7,1,5,2,4,0,0,0,12
2038,791982,30,5,11,4,8,1,3,2,2,1,4,2,3,0,1,0,13
2038,780333,33,5,9,3,5,2,4,6,6,0,1,5,0,1,0,0,18
2038,781493,29,3,11,1,4,2,7,0,1,1,2,4,3,0,2,1,8
2038,786756,19,3,6,1,1,2,5,0,0,0,2,1,1,1,1,0,8
2038,791984,15,1,1,1,1,0,0,3,4,0,4,0,3,0,1,0,5
2038,786755,18,1,1,0,0,1,1,0,2,1,1,0,2,0,1,0,3
2038,791985,1,0,0,0,0,0,0,0,0,0,0,0,1,0,0,0,0
2039,796709,23,2,4,2,3,0,1,0,0,0,1,0,5,0,2,0,4
2039,776469,30,3,5,3,4,0,1,3,7,2,6,2,3,0,4,0,9
2039,796705,36,4,10,2,6,2,4,2,4,0,2,1,2,0,2,0,12
2039,780701,26,5,10,5,9,0,1,4,5,0,3,6,3,0,2,0,14
2039,776322,33,5,13,1,6,4,7,4,5,1,4,2,3,0,3,0,18
2039,796708,4,0,0,0,0,0,0,2,2,0,0,0,2,0,0,0,2
2039,796706,20,3,3,2,2,1,1,0,1,1,4,0,2,0,1,0,7
2039,785500,12,0,0,0,0,0,0,0,0,0,0,0,3,0,1,0,0
2039,791036,16,0,0,0,0,0,0,0,0,0,1,0,1,0,0,1,0
2040,785999,29,4,7,4,7,0,0,2,4,4,6,0,3,0,1,1,10
2040,775654,23,3,5,3,5,0,0,0,1,2,3,0,2,1,2,2,6
2040,775171,29,3,8,0,3,3,5,6,6,0,3,0,1,0,0,1,15
2040,791639,26,5,13,3,9,2,4,2,4,1,2,1,3,2,3,0,14
2040,785389,36,7,13,4,6,3,7,0,0,0,6,5,2,1,2,0,17
2040,785255,22,3,6,3,6,0,0,3,4,3,5,0,1,0,0,0,9
2040,796399,15,0,3,0,1,0,2,0,0,0,1,2,0,0,2,0,0
2040,796398,14,2,2,1,1,1,1,0,0,0,2,2,1,0,1,1,5
2040,791640,4,1,2,1,2,0,0,0,0,1,0,0,0,0,0,0,2
2040,796403,1,0,1,0,0,0,1,0,0,0,0,1,0,0,0,0,0
2040,796400,1,1,1,0,0,1,1,0,0,0,0,0,0,0,0,0,3
2041,781208,26,2,8,2,8,0,0,2,2,1,3,2,2,1,0,1,6
2041,775489,17,1,7,1,5,0,2,0,0,1,2,0,1,0,0,1,2
2041,785561,23,1,3,1,3,0,0,0,0,0,0,1,4,0,1,0,2
2041,780313,37,5,12,4,11,1,1,4,6,1,1,5,3,3,0,0,15
2041,780766,32,4,9,2,4,2,5,0,0,0,3,4,2,1,6,0,10
2041,785560,14,1,4,0,0,1,4,0,0,0,1,0,0,0,0,1,3
2041,785563,26,8,11,6,8,2,3,2,2,1,5,1,2,1,2,0,20
2041,780758,12,1,4,1,3,0,1,2,2,2,4,1,2,0,0,0,4
2041,791088,9,1,3,0,1,1,2,0,0,2,0,0,0,0,1,0,3
2041,791087,1,0,0,0,0,0,0,0,0,0,0,0,0,0,0,0,0
2041,796750,1,0,0,0,0,0,0,0,0,0,0,0,0,0,0,0,0
2041,796751,2,0,0,0,0,0,0,0,0,0,0,0,0,0,0,0,0
2042,790909,33,7,13,2,6,5,7,3,4,0,4,3,1,1,1,0,22
2042,787175,30,3,7,0,1,3,6,0,0,2,8,2,3,2,0,0,9
2042,781393,30,5,9,3,6,2,3,6,9,1,4,4,1,1,2,0,18
2042,782126,27,5,9,4,6,1,3,2,2,0,3,0,0,1,0,0,13
2042,775351,32,6,7,6,7,0,0,2,2,0,1,7,2,4,3,0,14
2042,790907,19,5,6,5,6,0,0,4,7,2,2,1,1,1,2,0,14
2042,796454,3,0,0,0,0,0,0,0,0,0,0,0,0,0,0,0,0
2042,790910,3,0,1,0,0,0,1,0,0,0,0,0,0,0,0,0,0
2042,796455,23,5,7,5,7,0,0,3,6,2,4,0,1,0,1,1,13
2044,796778,24,4,7,3,5,1,2,4,6,5,4,3,0,2,2,1,13
2044,781107,26,5,12,5,12,0,0,3,6,1,3,3,2,0,2,1,13
2044,791974,27,2,7,1,4,1,3,0,0,0,0,1,0,0,0,0,5
2044,785366,24,2,5,1,1,1,4,0,0,0,1,2,2,0,0,1,5
2044,780863,22,6,9,4,5,2,4,1,1,2,3,2,5,2,3,1,15
2044,776069,20,2,3,1,1,1,2,0,0,0,4,0,2,0,5,0,5
2044,791971,15,1,2,0,0,1,2,0,0,0,0,2,2,0,1,0,3
2044,796777,16,2,4,2,4,0,0,4,4,0,2,4,2,1,1,0,8
2044,791972,26,2,7,2,4,0,3,0,0,1,1,0,2,1,1,0,4
2045,785996,31,6,10,6,10,0,0,2,3,6,4,1,2,0,0,2,14
2045,780858,37,6,10,4,5,2,5,2,2,3,9,3,3,1,0,1,16
2045,797646,19,2,9,2,8,0,1,3,5,0,1,4,3,2,4,0,7
2045,780849,33,3,9,1,4,2,5,0,0,1,2,0,2,1,0,0,8
2045,780853,29,5,11,4,10,1,1,0,0,0,1,4,3,1,2,1,11
2045,792235,9,2,2,2,2,0,0,0,0,1,0,0,2,0,1,0,4
2045,786010,3,0,1,0,0,0,1,0,0,0,1,0,0,0,1,0,0
2045,785998,3,0,0,0,0,0,0,0,0,0,0,0,1,0,1,0,0
2045,785990,25,6,10,4,7,2,3,0,0,0,2,2,0,1,3,0,14
2045,792039,11,0,1,0,0,0,1,0,2,1,0,1,1,0,0,2,0
2046,786232,21,4,7,3,3,1,4,4,5,0,2,1,1,2,0,2,13
2046,776309,22,5,11,5,9,0,2,3,3,0,8,2,2,3,2,0,13
2046,780287,26,6,11,6,9,0,2,0,0,1,3,0,0,1,1,0,12
2046,786237,29,4,6,4,6,0,0,3,5,0,2,3,2,0,1,0,11
2046,785227,12,2,4,2,4,0,0,0,0,0,3,1,2,0,3,0,4
2046,798072,8,0,0,0,0,0,0,0,0,0,3,0,1,0,1,0,0
2046,792288,20,5,8,5,8,0,0,0,1,1,10,0,0,0,0,0,10
2046,798084,5,0,3,0,2,0,1,0,0,0,1,0,1,0,0,0,0
2046,792282,2,0,0,0,0,0,0,0,2,0,0,0,1,0,1,0,0
2046,798067,21,2,3,2,3,0,0,6,6,3,3,1,1,0,0,2,10
2046,798077,10,0,2,0,0,0,2,0,0,0,0,0,0,0,1,0,0
2046,798068,4,0,0,0,0,0,0,0,2,0,0,0,0,0,0,0,0
2046,792278,20,5,9,3,4,2,5,3,3,0,1,3,1,1,0,0,15
2047,775323,19,2,10,1,5,1,5,0,1,0,2,0,3,1,3,0,5
2047,776426,10,0,1,0,0,0,1,0,0,0,0,0,2,0,0,0,0
2047,792059,20,1,4,1,3,0,1,1,2,0,1,1,3,1,1,1,3
2047,792062,6,0,3,0,3,0,0,0,0,1,1,0,0,0,0,0,0
2047,792055,33,6,9,6,9,0,0,0,0,0,11,3,3,2,2,1,12
2047,792067,12,2,3,2,2,0,1,1,1,0,3,2,1,0,0,1,5
2047,792058,21,2,3,2,3,0,0,0,0,2,0,3,2,0,4,0,4
2047,797651,19,1,5,1,3,0,2,0,0,0,0,0,2,0,1,0,2
2047,775523,10,1,3,1,3,0,0,1,2,1,4,0,4,0,1,0,3
2047,790779,3,0,2,0,2,0,0,0,0,1,1,0,0,0,0,0,0
2047,792056,5,0,0,0,0,0,0,0,0,0,0,0,2,0,0,1,0
2047,797649,5,2,3,1,1,1,2,0,0,1,2,0,0,0,3,0,5
2047,789053,11,0,4,0,1,0,3,2,2,0,0,1,0,0,1,0,2
2047,797650,12,2,4,2,4,0,0,1,2,1,3,0,1,0,0,0,5
2047,789029,14,0,9,0,3,0,6,0,0,1,2,0,0,0,1,0,0
2048,796980,13,0,2,0,2,0,0,0,0,1,2,0,1,0,1,0,0
2048,776200,21,0,4,0,4,0,0,0,0,0,2,0,2,0,3,2,0
2048,785620,34,7,17,7,14,0,3,5,6,0,1,2,2,1,2,0,19
2048,780925,20,2,5,0,0,2,5,0,0,0,3,0,1,0,2,0,6
2048,781034,32,1,11,0,6,1,5,3,4,1,2,2,0,2,3,0,6
2048,791622,16,0,1,0,1,0,0,2,2,1,2,0,3,0,2,0,2
2048,780446,19,0,2,0,1,0,1,0,0,1,1,0,1,0,3,0,0
2048,791624,15,2,5,2,3,0,2,2,3,2,2,0,2,1,1,0,6
2048,791625,27,5,9,3,4,2,5,0,0,3,5,0,5,1,1,0,12
2048,791637,2,0,1,0,0,0,1,0,0,0,0,0,0,0,0,0,0
2048,796978,1,0,0,0,0,0,0,0,0,0,0,0,0,0,0,0,0
2049,786447,22,4,4,4,4,0,0,3,4,0,7,2,1,2,0,1,11
2049,775074,32,7,8,7,8,0,0,2,5,2,4,0,2,2,1,0,16
2049,786448,23,5,7,5,7,0,0,0,0,0,5,1,2,3,2,1,10
2049,780731,30,4,8,3,6,1,2,1,1,0,1,1,1,1,0,0,10
2049,780462,31,3,9,2,4,1,5,3,3,0,3,2,1,2,5,0,10
2049,786132,9,0,0,0,0,0,0,2,4,0,1,0,2,1,2,0,2
2049,791631,15,2,5,2,4,0,1,0,0,0,2,1,2,0,3,0,4
2049,796971,15,2,4,2,2,0,2,1,2,2,3,0,2,0,1,0,5
2049,775121,6,0,1,0,1,0,0,0,0,0,1,0,3,0,2,0,0
2049,791632,10,0,2,0,0,0,2,0,0,0,1,0,1,0,0,0,0
2049,791634,4,0,1,0,0,0,1,0,0,0,1,0,0,0,0,0,0
2049,791630,3,1,2,1,1,0,1,0,0,0,0,0,2,0,1,0,2
2050,786041,30,5,9,4,6,1,3,0,0,3,7,1,1,0,4,1,11
2050,780881,29,1,8,1,4,0,4,5,8,2,7,1,0,2,2,1,7
2050,780275,19,3,7,3,7,0,0,0,0,1,4,0,3,0,2,1,6
2050,792075,22,2,6,0,3,2,3,1,2,0,2,3,2,0,2,0,7
2050,786686,32,7,12,5,7,2,5,1,1,1,2,6,3,1,1,0,17
2050,785437,14,1,1,1,1,0,0,0,0,0,1,0,2,0,1,3,2
2050,792074,15,3,7,2,3,1,4,0,0,0,2,1,0,1,0,0,7
2050,780052,29,5,9,2,4,3,5,0,0,1,1,3,3,2,0,0,13
2050,780882,8,0,1,0,0,0,1,0,0,0,0,1,0,0,0,0,0
2050,786051,1,0,0,0,0,0,0,0,0,0,0,0,0,0,0,0,0
2050,792076,1,0,0,0,0,0,0,0,0,0,0,0,0,0,0,0,0
2051,785589,31,5,14,5,14,0,0,3,4,0,4,2,2,0,2,0,13
2051,791216,26,1,6,1,5,0,1,2,5,1,2,1,3,1,3,1,4
2051,791209,20,1,2,1,2,0,0,0,0,2,3,1,2,0,2,0,2
2051,791215,24,3,5,2,2,1,3,0,0,1,1,4,0,2,1,0,7
2051,791214,32,4,11,3,8,1,3,0,0,0,4,3,2,0,1,0,9
2051,791213,17,3,8,2,6,1,2,0,0,0,4,0,3,1,1,1,7
2051,796917,3,0,2,0,1,0,1,0,0,0,0,0,0,0,2,0,0
2051,776313,23,4,5,1,1,3,4,0,0,0,3,1,2,0,1,1,11
2051,776364,16,1,4,1,2,0,2,0,0,0,3,1,3,0,1,0,2
2051,791207,5,0,1,0,1,0,0,0,0,1,1,0,0,0,0,0,0
2051,791210,2,0,1,0,1,0,0,0,0,0,0,0,0,0,0,0,0
2051,785592,1,0,0,0,0,0,0,0,0,0,0,0,0,0,0,0,0
2052,786805,24,7,14,6,13,1,1,5,8,4,2,1,2,0,1,0,20
2052,774936,12,4,8,4,8,0,0,4,7,3,1,1,1,0,0,1,12
2052,790932,22,3,6,3,5,0,1,4,6,1,1,0,3,1,1,1,10
2052,781345,28,2,5,1,1,1,4,4,7,2,2,6,3,4,1,0,9
2052,786803,21,2,5,2,3,0,2,0,0,0,1,3,2,3,2,0,4
2052,790934,18,6,8,5,6,1,2,3,4,2,7,3,3,1,0,1,16
2052,790931,14,4,6,4,6,0,0,0,0,2,1,0,0,0,1,0,8
2052,790933,14,2,4,2,2,0,2,2,5,0,0,1,1,2,0,0,6
2052,796487,16,1,4,0,1,1,3,2,2,1,1,0,1,0,3,0,5
2052,786804,16,1,4,1,3,0,1,2,2,1,4,0,1,2,2,1,4
2052,780033,7,0,1,0,1,0,0,1,2,0,1,1,1,0,0,0,1
2052,796488,3,0,1,0,0,0,1,0,0,0,0,0,0,0,0,0,0
2052,796490,2,0,1,0,1,0,0,0,0,0,0,0,0,0,0,0,0
2052,780030,2,0,0,0,0,0,0,0,0,0,0,0,0,0,0,0,0
2052,796489,1,0,1,0,1,0,0,0,0,0,0,0,0,0,0,0,0
2054,790870,26,9,11,9,11,0,0,2,4,3,3,8,2,1,2,2,20
2054,790869,30,6,12,6,11,0,1,1,1,2,3,2,2,2,8,0,13
2054,780493,29,4,10,2,4,2,6,0,0,1,3,0,3,0,2,0,10
2054,790866,31,6,13,3,6,3,7,1,4,2,6,5,1,1,2,0,16
2054,780116,33,3,6,3,4,0,2,0,0,2,2,1,2,2,0,0,6
2054,796426,7,2,2,2,2,0,0,0,0,0,1,0,0,0,2,0,4
2054,780492,3,0,0,0,0,0,0,0,0,0,0,0,0,0,0,0,0
2054,796428,5,0,1,0,1,0,0,0,0,0,1,0,1,0,0,0,0
2054,796427,30,0,3,0,2,0,1,2,2,2,7,3,2,0,2,0,2
2054,796424,6,1,1,1,1,0,0,0,0,0,1,0,0,0,1,0,2
2056,797247,27,5,8,4,5,1,3,0,0,1,1,4,1,4,3,0,11
2056,791352,17,6,8,1,2,5,6,0,0,1,3,1,4,0,1,0,17
2056,797251,24,2,4,0,1,2,3,1,2,0,5,0,0,2,2,1,7
2056,776297,27,1,3,1,1,0,2,0,0,1,5,4,2,0,4,1,2
2056,780455,13,4,4,4,4,0,0,2,2,0,5,0,1,0,0,0,10
2056,797248,14,1,3,1,1,0,2,0,0,0,2,1,1,1,2,0,2
2056,797249,15,2,3,2,2,0,1,0,0,0,3,2,2,2,2,0,4
2056,797250,6,1,3,1,3,0,0,0,0,1,0,1,0,0,0,0,2
2056,785837,18,5,9,3,4,2,5,0,0,1,0,1,1,0,3,1,12
2056,791354,18,2,4,2,2,0,2,0,0,0,2,2,0,1,1,1,4
2056,797255,3,0,1,0,1,0,0,0,2,0,1,0,0,0,0,0,0
2056,791355,12,1,5,0,1,1,4,0,0,0,0,1,0,2,0,0,3
2056,797252,4,0,1,0,0,0,1,0,0,0,0,0,0,0,0,0,0
2056,797253,2,0,1,0,1,0,0,0,0,1,0,0,0,0,0,0,0
2057,797822,21,2,7,2,4,0,3,0,0,1,1,0,3,0,4,0,4
2057,792190,20,2,3,2,2,0,1,0,0,0,1,0,0,1,1,0,4
2057,786664,20,1,9,0,3,1,6,2,2,0,2,0,1,3,2,0,5
2057,797824,19,1,9,0,4,1,5,0,0,0,3,1,0,2,1,1,3
2057,775116,16,0,2,0,0,0,2,0,0,3,1,2,0,1,1,0,0
2057,781266,8,1,1,0,0,1,1,0,0,0,0,0,0,0,0,0,3
2057,797827,6,1,3,0,0,1,3,0,0,0,1,1,0,1,0,0,3
2057,791928,13,1,4,1,3,0,1,0,0,0,2,2,3,1,2,0,2
2057,792191,12,0,1,0,1,0,0,0,0,0,1,0,0,0,0,0,0
2057,792192,14,2,2,2,2,0,0,0,0,0,3,0,2,0,1,0,4
2057,797830,21,4,8,2,3,2,5,2,2,0,2,2,0,0,2,0,12
2057,797828,9,0,1,0,0,0,1,0,0,0,1,1,1,0,0,0,0
2057,792193,21,3,4,3,3,0,1,4,5,0,3,0,1,1,3,0,10
2058,791686,23,4,7,3,4,1,3,3,4,1,4,2,4,1,1,2,12
2058,798028,23,1,3,1,1,0,2,2,2,1,2,2,5,0,3,0,4
2058,792270,22,2,4,1,1,1,3,3,4,1,4,1,3,0,0,1,8
2058,790940,39,3,13,1,5,2,8,7,8,0,4,0,4,2,3,0,15
2058,780770,38,6,14,5,8,1,6,3,3,1,2,4,4,2,2,0,16
2058,786060,33,8,17,6,10,2,7,0,0,0,5,0,0,0,1,1,18
2058,792269,14,0,0,0,0,0,0,0,0,1,1,0,1,0,1,0,0
2058,792271,5,0,1,0,1,0,0,0,0,1,1,0,2,0,1,0,0
2058,792305,3,0,0,0,0,0,0,1,2,0,1,0,0,0,0,1,1
2058,798022,0,0,0,0,0,0,0,0,0,0,0,0,0,0,0,0,0
2059,790833,38,7,13,5,10,2,3,2,4,5,6,3,2,3,6,0,18
2059,796390,15,1,6,1,6,0,0,2,5,2,4,2,0,0,0,2,4
2059,785451,27,4,11,2,4,2,7,6,8,1,2,1,3,0,2,0,16
2059,790830,20,1,2,1,1,0,1,2,2,0,1,3,2,0,2,0,4
2059,790834,30,8,13,4,6,4,7,0,0,1,5,2,4,3,2,0,20
2059,785377,20,1,4,1,3,0,1,2,2,0,2,2,2,0,0,0,4
2059,785518,17,4,5,4,5,0,0,2,9,4,2,2,4,1,1,1,10
2059,780297,9,0,2,0,1,0,1,0,0,0,1,0,1,0,1,0,0
2059,785379,10,0,1,0,0,0,1,4,4,0,0,1,0,0,1,0,4
2059,790832,14,0,3,0,2,0,1,0,0,0,1,1,2,0,0,0,0
2060,786772,29,6,7,6,7,0,0,1,3,3,7,0,5,0,1,1,13
2060,781484,24,2,5,1,1,1,4,0,2,0,3,0,4,1,2,0,5
2060,786769,24,0,2,0,2,0,0,1,4,0,3,0,1,1,2,1,1
2060,786024,17,2,5,2,3,0,2,0,0,2,2,3,1,2,4,0,4
2060,780002,31,1,11,1,10,0,1,2,2,0,2,4,5,1,2,0,4
2060,797840,29,5,12,4,10,1,2,2,5,1,0,2,1,1,1,0,13
2060,791970,20,4,8,4,6,0,2,0,0,2,4,0,3,0,2,1,8
2060,786773,10,4,4,4,4,0,0,2,3,2,2,0,2,0,0,2,10
2060,791967,7,0,3,0,2,0,1,0,0,0,0,1,0,0,1,0,0
2060,790823,6,0,0,0,0,0,0,0,0,0,0,0,1,0,1,0,0
2060,785441,3,0,0,0,0,0,0,0,0,0,0,0,0,0,0,0,0
2061,797281,34,3,8,3,6,0,2,6,6,2,10,3,4,2,2,0,12
2061,791648,33,4,18,4,17,0,1,5,6,4,2,3,3,0,3,0,13
2061,786195,26,4,6,4,6,0,0,3,4,1,1,0,3,0,3,0,11
2061,791649,32,3,7,1,2,2,5,4,4,0,5,0,2,1,0,0,12
2061,797280,37,3,6,1,2,2,4,2,4,1,2,2,3,1,1,0,10
2061,786640,27,3,7,3,6,0,1,2,3,0,2,1,3,1,3,0,8
2061,791647,10,0,2,0,2,0,0,0,0,0,2,1,4,0,0,0,0
2061,797278,1,0,0,0,0,0,0,0,0,0,0,0,0,0,0,0,0
2066,792068,25,3,9,3,9,0,0,2,2,1,4,4,1,1,1,1,8
2066,784640,19,1,1,1,1,0,0,2,2,2,3,1,2,1,1,0,4
2066,792072,30,3,5,0,0,3,5,1,3,0,1,1,2,1,0,0,10
2066,792069,32,5,9,2,4,3,5,5,6,1,3,7,0,5,3,0,18
2066,785572,28,7,11,5,9,2,2,2,4,0,5,0,1,1,2,0,18
2066,786025,5,1,1,1,1,0,0,0,0,1,0,1,0,0,0,0,2
2066,797655,14,4,5,4,5,0,0,1,2,2,3,1,3,0,0,1,9
2066,797654,1,0,1,0,1,0,0,0,0,0,0,0,0,0,0,0,0
2066,797657,18,2,6,1,3,1,3,0,0,0,1,2,0,0,1,0,5
2066,797652,18,4,6,3,5,1,1,0,0,0,4,1,2,1,2,0,9
2066,774844,9,1,1,1,1,0,0,0,0,0,0,1,0,1,1,0,2
2066,797653,1,0,0,0,0,0,0,0,0,0,0,0,0,0,0,0,0
2067,797628,17,2,5,2,4,0,1,0,0,0,0,2,2,0,2,0,4
2067,786481,25,5,6,5,5,0,1,2,3,1,3,2,3,0,1,0,12
2067,797626,30,3,8,2,5,1,3,1,2,1,2,3,2,3,1,0,8
2067,797624,27,3,7,0,2,3,5,0,0,2,5,2,2,1,5,1,9
2067,785965,32,4,8,1,3,3,5,2,2,1,1,1,0,1,2,0,13
2067,791793,17,5,7,2,2,3,5,0,0,0,4,1,3,0,3,0,13
2067,791791,13,0,2,0,1,0,1,0,0,0,0,4,3,0,0,0,0
2067,797627,6,0,3,0,1,0,2,2,2,0,0,0,0,0,0,0,2
2067,791790,19,0,3,0,1,0,2,0,0,0,1,2,0,1,2,0,0
2067,786480,1,0,1,0,0,0,1,0,0,0,0,0,0,0,0,0,0
2067,781032,13,1,5,0,0,1,5,0,0,0,2,2,0,0,1,0,3
2068,797382,17,1,4,1,4,0,0,0,0,3,1,0,3,0,0,0,2
2068,797379,18,2,3,1,2,1,1,2,2,1,5,0,0,0,4,0,7
2068,791818,37,8,21,4,9,4,12,3,4,3,6,6,0,1,1,1,23
2068,786636,34,4,10,3,7,1,3,11,13,0,1,2,4,1,4,0,20
2068,780646,25,5,8,2,2,3,6,2,2,0,3,1,2,3,0,0,15
2068,797380,23,3,9,2,4,1,5,1,3,4,2,2,3,0,1,1,8
2068,789043,21,1,5,1,5,0,0,4,4,4,6,1,3,1,0,2,6
2068,797377,22,2,4,0,1,2,3,0,0,0,4,3,2,0,0,0,6
2068,775168,3,0,2,0,1,0,1,0,0,0,1,0,1,0,0,0,0
2069,775556,36,7,19,5,13,2,6,7,9,2,3,0,3,2,1,0,23
2069,780234,37,5,10,5,8,0,2,5,5,4,6,3,2,2,1,2,15
2069,781110,24,2,9,2,4,0,5,5,6,1,6,1,4,0,2,0,9
2069,786411,22,0,5,0,2,0,3,0,0,1,3,1,4,0,1,1,0
2069,786328,2,0,0,0,0,0,0,0,0,1,0,0,2,0,1,0,0
2069,797185,12,0,1,0,0,0,1,0,0,0,2,1,3,0,0,1,0
2069,786405,30,2,8,2,7,0,1,0,0,0,2,2,1,0,1,0,4
2069,781104,37,7,17,2,6,5,11,2,2,0,3,5,2,0,2,0,21
2070,790962,18,4,7,4,6,0,1,0,0,0,2,2,2,0,0,2,8
2070,775860,25,2,6,0,1,2,5,0,0,0,1,3,0,2,2,0,6
2070,790961,20,5,6,5,6,0,0,8,9,0,2,5,1,0,0,1,18
2070,796556,22,0,2,0,1,0,1,2,2,1,2,0,2,1,0,1,2
2070,785278,25,3,7,1,2,2,5,4,4,2,5,0,1,1,2,0,12
2070,796553,7,2,2,2,2,0,0,0,0,1,2,1,2,0,1,0,4
2070,786240,19,2,13,2,9,0,4,6,8,3,2,1,2,3,0,0,10
2070,796554,17,4,8,3,5,1,3,0,0,3,2,0,1,1,1,0,9
2070,796555,14,1,1,0,0,1,1,0,0,0,3,1,0,0,1,0,3
2070,790963,3,0,2,0,1,0,1,0,0,1,1,0,1,0,0,0,0
2070,790960,4,1,2,0,1,1,1,2,2,2,0,0,0,0,1,0,5
2070,790965,7,1,2,1,2,0,0,0,0,2,2,1,2,0,0,0,2
2070,780832,11,2,3,2,3,0,0,2,2,3,5,0,1,2,2,1,6
2070,780363,3,1,2,1,2,0,0,0,0,0,0,0,0,0,0,0,2
2070,796557,5,0,4,0,3,0,1,0,2,1,0,0,0,1,0,1,0
2072,796790,32,8,14,5,9,3,5,2,2,1,3,2,2,2,2,0,21
2072,786088,31,3,5,2,3,1,2,2,3,0,3,7,1,1,4,0,9
2072,791131,17,3,9,2,4,1,5,0,0,2,3,1,3,0,1,0,7
2072,786090,29,10,14,9,12,1,2,12,13,3,4,4,3,6,1,0,33
2072,791135,26,6,10,6,10,0,0,3,4,5,7,2,2,0,3,0,15
2072,796792,2,0,0,0,0,0,0,0,0,0,1,0,1,0,0,0,0
2072,786092,5,0,0,0,0,0,0,0,0,0,0,0,1,0,0,0,0
2072,786097,5,0,0,0,0,0,0,0,0,0,0,1,1,0,0,0,0
2072,791132,21,3,5,3,4,0,1,2,2,5,4,2,1,1,0,0,8
2072,791133,4,0,1,0,1,0,0,0,0,0,1,0,0,0,0,0,0
2072,792585,2,0,0,0,0,0,0,0,0,0,0,0,0,0,1,0,0
2072,791521,16,2,4,2,4,0,0,2,4,1,3,0,1,1,0,3,6
2072,791134,3,0,1,0,1,0,0,0,0,1,1,0,0,0,0,0,0
2072,796791,2,0,0,0,0,0,0,0,0,0,0,0,0,0,1,0,0
2072,785541,5,0,2,0,1,0,1,0,0,0,1,0,1,0,2,0,0
2073,790494,12,0,2,0,1,0,1,0,0,1,1,0,1,0,1,0,0
2073,788866,22,1,1,1,1,0,0,0,0,0,6,1,3,1,2,0,2
2073,781659,24,3,5,2,2,1,3,0,1,0,2,3,3,1,1,0,7
2073,796854,32,3,8,2,6,1,2,5,6,3,1,4,3,1,2,0,12
2073,796851,26,5,12,2,4,3,8,6,6,1,3,4,4,1,2,0,19
2073,780610,17,2,4,1,1,1,3,1,1,0,0,0,0,0,2,0,6
2073,792683,19,4,9,0,3,4,6,2,2,0,1,1,1,0,4,0,14
2073,782162,23,4,14,4,10,0,4,2,2,1,0,1,4,3,1,0,10
2073,796855,5,0,0,0,0,0,0,0,0,0,0,0,0,1,0,0,0
2073,788865,20,1,8,0,4,1,4,0,0,1,0,0,2,0,0,0,3
2074,781322,18,2,8,2,4,0,4,0,1,3,3,1,0,0,0,1,4
2074,785989,21,5,7,4,5,1,2,2,4,2,9,10,1,1,2,3,13
2074,786571,21,4,9,4,6,0,3,0,1,0,1,3,0,2,0,0,8
2074,780563,16,3,7,3,4,0,3,2,2,0,2,0,0,0,0,0,8
2074,781439,18,7,14,5,7,2,7,0,0,1,4,1,1,2,2,0,16
2074,784248,26,4,5,0,0,4,5,0,1,1,5,2,0,0,0,0,12
2074,781419,20,5,7,3,4,2,3,0,0,1,2,2,1,1,0,0,12
2074,791690,18,3,5,3,5,0,0,7,10,4,9,1,3,0,1,0,13
2074,781207,16,1,3,0,1,1,2,4,4,0,1,3,2,2,3,1,7
2074,797299,14,4,4,4,4,0,0,1,2,1,3,1,3,0,0,2,9
2074,797300,12,3,5,1,1,2,4,0,0,0,3,1,0,0,0,0,8
2076,797895,15,6,7,6,7,0,0,0,0,6,4,2,4,2,4,1,12
2076,785286,17,3,4,3,3,0,1,6,8,1,4,2,1,1,1,0,12
2076,797898,17,5,7,3,3,2,4,0,0,1,2,0,0,2,2,0,12
2076,792237,23,2,9,1,3,1,6,2,2,0,3,9,0,0,0,0,7
2076,781374,15,5,8,3,4,2,4,3,3,0,6,5,0,3,0,0,15
2076,792238,7,0,0,0,0,0,0,0,0,0,0,0,1,0,0,0,0
2076,789058,6,1,5,0,3,1,2,0,0,2,0,1,2,1,1,0,3
2076,785818,16,2,4,2,2,0,2,2,2,1,2,2,1,1,1,1,6
2076,776337,5,2,2,2,2,0,0,4,4,3,2,0,0,0,0,0,8
2076,797896,8,1,4,0,1,1,3,0,0,1,3,1,0,0,1,0,3
2076,797897,15,4,7,2,2,2,5,3,5,0,2,2,2,0,3,0,13
2076,792240,11,1,4,1,1,0,3,0,0,1,0,1,2,1,3,0,2
2076,792359,15,2,5,0,0,2,5,0,0,0,1,0,2,1,0,0,6
2076,785986,14,1,3,0,0,1,3,0,0,0,0,0,0,2,0,0,3
2076,787239,16,2,3,2,3,0,0,3,3,1,3,0,2,1,2,5,7
2078,797629,18,3,8,3,7,0,1,3,4,1,3,7,1,1,1,0,9
2078,789041,22,4,8,0,1,4,7,1,2,1,0,5,2,2,0,0,13
2078,791787,25,7,15,7,12,0,3,4,5,4,10,2,0,2,4,0,18
2078,789046,18,4,7,2,3,2,4,2,2,2,2,0,1,0,0,2,12
2078,789048,29,9,15,9,15,0,0,2,5,7,12,1,2,0,1,1,20
2078,797630,21,3,9,1,2,2,7,0,0,1,1,0,1,1,2,0,8
2078,785540,20,0,2,0,1,0,1,0,1,1,4,2,1,0,2,1,0
2078,797632,8,0,0,0,0,0,0,0,0,0,2,0,1,1,0,0,0
2078,791786,23,4,10,3,5,1,5,4,4,1,3,1,2,0,1,1,13
2078,797633,2,0,0,0,0,0,0,0,0,0,0,0,0,0,2,0,0
2078,789044,10,1,3,0,1,1,2,0,0,1,3,1,1,0,1,2,3
2078,799762,4,1,3,0,0,1,3,0,0,0,1,1,1,1,0,0,3
2080,780323,19,0,2,0,2,0,0,0,0,2,3,3,4,0,0,2,0
2080,792233,33,7,16,3,9,4,7,2,5,1,8,0,3,0,1,0,20
2080,797894,27,4,6,4,6,0,0,0,1,3,3,1,2,0,2,0,8
2080,785954,37,0,9,0,4,0,5,0,0,0,1,1,0,1,0,0,0
2080,785811,34,5,16,3,8,2,8,9,10,0,2,1,1,0,2,0,21
2080,792234,8,2,3,2,3,0,0,0,0,2,1,0,0,0,0,1,4
2080,786016,21,1,4,1,3,0,1,0,2,0,1,2,1,1,2,0,2
2080,797892,21,1,6,1,4,0,2,0,0,1,1,0,3,3,0,0,2
2081,790810,29,2,4,1,1,1,3,2,2,0,3,2,3,1,4,1,7
2081,785362,20,3,10,3,10,0,0,1,1,0,3,0,4,1,3,1,7
2081,790808,30,0,5,0,2,0,3,2,2,1,9,2,4,0,4,0,2
2081,785361,34,8,11,4,4,4,7,3,4,0,5,1,0,0,1,1,23
2081,779997,35,3,10,3,7,0,3,4,4,2,8,4,2,1,1,0,10
2081,774854,6,1,2,1,2,0,0,0,0,0,0,0,1,0,0,0,2
2081,790809,24,1,2,0,1,1,1,0,0,0,3,3,2,0,2,0,3
2081,796368,4,1,2,1,1,0,1,0,0,0,2,0,2,0,0,0,2
2081,790811,4,0,0,0,0,0,0,0,0,0,0,1,2,0,0,0,0
2081,796370,14,0,1,0,1,0,0,2,2,0,0,0,2,0,0,0,2
2082,791884,29,8,10,7,9,1,1,2,2,0,3,10,1,2,1,0,19
2082,780695,29,7,9,3,4,4,5,0,0,0,2,1,3,1,1,0,18
2082,797594,25,3,8,1,3,2,5,0,0,0,5,2,1,0,0,0,8
2082,781066,23,4,5,4,5,0,0,0,2,3,1,1,0,0,4,0,8
2082,791883,28,2,6,2,5,0,1,1,2,2,8,1,2,0,3,3,5
2082,797600,16,6,7,6,7,0,0,0,0,2,4,2,0,1,0,0,12
2082,797596,15,3,7,3,5,0,2,2,2,0,4,3,1,3,0,0,8
2082,797598,9,2,3,2,3,0,0,0,2,0,2,0,1,0,1,1,4
2082,786497,5,1,1,0,0,1,1,0,0,0,0,0,0,0,0,0,3
2082,786496,21,0,3,0,0,0,3,0,0,0,1,0,2,0,1,0,0
2083,797013,33,5,14,1,8,4,6,2,2,0,5,1,1,0,0,0,16
2083,791441,18,0,5,0,3,0,2,2,2,0,0,0,2,1,3,0,2
2083,791443,16,0,3,0,2,0,1,2,2,0,1,1,2,0,2,0,2
2083,781629,14,1,6,1,5,0,1,0,0,3,2,0,0,1,3,0,2
2083,791440,16,0,1,0,1,0,0,0,0,0,1,1,3,0,1,0,0
2083,781378,29,5,12,2,8,3,4,1,1,1,6,1,1,2,3,2,14
2083,797015,18,6,8,5,7,1,1,1,1,1,2,1,0,0,1,0,14
2083,775267,19,1,4,0,0,1,4,0,0,0,1,3,0,0,1,1,3
2083,797019,16,1,2,1,2,0,0,0,0,0,0,1,1,2,1,0,2
2083,797016,12,0,0,0,0,0,0,0,0,0,0,0,0,1,2,0,0
2083,775739,9,0,2,0,2,0,0,0,0,1,0,0,0,0,0,0,0
2084,780094,36,5,11,5,9,0,2,6,8,2,4,0,0,2,2,0,16
2084,775142,32,7,15,5,10,2,5,3,5,2,3,1,3,1,3,0,19
2084,790842,10,2,3,2,3,0,0,0,2,2,2,0,2,0,1,1,4
2084,790843,35,4,11,3,7,1,4,2,2,0,5,2,1,1,3,0,11
2084,781563,36,4,8,4,5,0,3,3,3,0,3,3,0,0,1,1,11
2084,790844,13,2,4,1,3,1,1,0,0,0,4,1,2,0,0,0,5
2084,796914,5,0,0,0,0,0,0,0,0,0,0,0,2,0,1,0,0
2084,792125,1,0,0,0,0,0,0,0,0,0,0,0,1,0,0,0,0
2084,786212,31,3,8,3,4,0,4,2,3,3,6,0,3,3,1,0,8
2084,790847,1,0,0,0,0,0,0,0,0,0,0,0,0,0,0,0,0
2085,791750,21,0,2,0,0,0,2,0,0,0,3,1,3,0,4,0,0
2085,786177,28,3,12,0,1,3,11,0,0,1,6,0,4,0,2,3,9
2085,780244,35,5,5,4,4,1,1,4,5,2,2,1,3,2,0,1,15
2085,786179,25,3,13,2,4,1,9,4,5,1,3,2,3,2,1,0,11
2085,780238,33,4,8,3,6,1,2,1,1,0,2,4,2,1,3,0,10
2085,791752,6,0,1,0,1,0,0,0,0,0,1,0,1,0,1,0,0
2085,785909,16,1,2,1,2,0,0,0,1,1,1,0,0,0,0,0,2
2085,790773,16,2,9,1,2,1,7,2,2,2,1,0,3,0,0,0,7
2085,781500,20,4,8,3,5,1,3,1,2,0,3,2,1,1,2,0,10
2086,786357,36,7,13,7,11,0,2,4,6,1,4,2,1,0,2,1,18
2086,780306,37,4,7,4,7,0,0,3,6,0,6,0,4,0,4,0,11
2086,791537,21,2,8,2,3,0,5,1,1,2,2,1,1,1,2,0,5
2086,797116,24,1,9,1,5,0,4,0,0,1,0,2,1,0,2,0,2
2086,780312,36,0,4,0,2,0,2,0,0,0,3,4,1,3,3,0,0
2086,775418,19,2,3,2,3,0,0,3,5,4,6,1,2,1,1,2,7
2086,786358,23,2,7,1,3,1,4,0,1,0,7,0,0,0,0,1,5
2086,775846,4,1,2,0,1,1,1,0,0,1,0,0,2,0,0,0,3
2087,798096,29,6,13,6,13,0,0,0,0,1,1,0,2,0,0,0,12
2087,781530,29,4,12,4,10,0,2,3,6,3,16,2,3,2,1,0,11
2087,776423,27,4,9,4,8,0,1,0,0,3,1,0,3,1,1,3,8
2087,792319,20,1,2,0,0,1,2,0,0,1,1,1,0,1,4,0,3
2087,786296,10,0,2,0,1,0,1,0,0,0,0,0,3,0,2,0,0
2087,792307,28,3,7,2,3,1,4,0,0,0,1,1,1,1,0,0,7
2087,792309,19,2,8,1,6,1,2,0,0,0,1,1,1,1,1,0,5
2087,792314,14,1,1,1,1,0,0,0,0,0,2,0,3,0,2,0,2
2087,792320,10,0,2,0,2,0,0,0,0,0,4,0,3,0,0,0,0
2087,798106,7,0,1,0,1,0,0,0,0,0,0,0,0,1,1,0,0
2087,798104,7,0,2,0,1,0,1,0,0,0,0,0,0,0,0,0,0
2088,797050,25,3,10,3,8,0,2,2,2,2,10,0,5,0,2,0,8
2088,780394,38,5,9,3,5,2,4,0,0,3,5,1,3,3,0,0,12
2088,780391,28,6,9,5,8,1,1,0,0,0,1,2,2,1,2,4,13
2088,790871,32,5,11,3,5,2,6,4,4,1,2,3,2,1,4,1,16
2088,776473,39,3,10,2,7,1,3,0,0,1,2,2,1,0,2,0,7
2088,797048,27,2,8,1,6,1,2,2,2,3,5,2,2,0,3,0,7
2088,780392,11,0,2,0,1,0,1,0,0,0,0,0,0,1,0,0,0
2089,780765,39,6,16,5,12,1,4,4,5,2,4,7,0,3,2,0,17
2089,781301,22,0,1,0,1,0,0,0,0,1,1,0,2,0,0,2,0
2089,786255,35,5,11,3,7,2,4,4,5,0,8,0,3,1,3,0,16
2089,780762,28,3,5,0,1,3,4,2,2,0,4,1,1,1,1,0,11
2089,780768,26,3,5,2,4,1,1,4,4,0,4,4,3,0,1,0,11
2089,791729,15,3,4,2,2,1,2,1,2,1,0,0,0,0,1,0,8
2089,780755,23,2,5,2,3,0,2,0,0,1,2,0,1,0,2,0,4
2089,776241,12,1,6,0,2,1,4,0,0,0,1,1,1,1,1,0,3
2090,797699,32,5,9,4,6,1,3,4,6,0,3,0,1,0,3,0,15
2090,780846,37,3,9,2,7,1,2,7,10,2,10,8,3,1,2,1,14
2090,780844,30,4,11,2,2,2,9,0,0,1,2,1,5,0,0,0,10
2090,791956,23,1,3,0,0,1,3,0,1,1,6,0,0,0,0,1,3
2090,797698,14,0,1,0,1,0,0,0,0,1,3,1,3,0,2,0,0
2090,797694,25,6,14,1,2,5,12,2,2,0,3,0,2,0,0,1,19
2090,791954,25,6,10,5,9,1,1,4,7,3,2,1,0,1,0,0,17
2090,797696,10,2,5,2,5,0,0,0,0,2,2,0,3,0,1,0,4
2090,797692,4,0,1,0,1,0,0,0,0,0,0,0,0,0,1,0,0
2091,780570,34,10,17,10,17,0,0,7,9,2,7,1,3,1,3,4,27
2091,780569,33,8,16,8,16,0,0,1,5,3,5,1,2,1,0,3,17
2091,780565,32,5,12,3,7,2,5,2,2,1,5,1,3,0,2,0,14
2091,791697,30,4,11,3,8,1,3,0,0,0,5,3,5,2,0,0,9
2091,797438,33,0,5,0,4,0,1,0,0,1,1,2,1,1,0,0,0
2091,791696,8,3,4,3,3,0,1,0,0,1,2,0,0,0,0,0,6
2091,791695,13,2,4,2,4,0,0,1,1,0,2,0,4,0,2,0,5
2091,797432,17,0,3,0,1,0,2,0,0,0,2,0,3,0,1,0,0
2096,791023,34,2,4,2,4,0,0,8,9,2,8,0,3,0,2,7,12
2096,791027,37,7,13,3,5,4,8,0,0,2,3,2,3,4,2,0,18
2096,791024,35,4,11,1,4,3,7,9,13,0,3,10,3,2,3,0,20
2096,781507,7,0,1,0,0,0,1,0,0,0,2,1,0,0,0,0,0
2096,777572,37,7,10,4,6,3,4,3,4,2,2,3,3,4,3,0,20
2096,796686,6,0,2,0,2,0,0,0,0,0,1,0,1,0,0,0,0
2096,796685,28,4,12,2,3,2,9,0,0,0,5,3,2,0,1,0,10
2096,796684,16,0,1,0,1,0,0,1,2,1,2,0,2,1,2,0,1
2097,792388,15,1,2,1,2,0,0,0,0,0,2,0,4,1,1,0,2
2097,797845,33,3,12,1,5,2,7,3,4,1,1,0,2,0,1,0,11
2097,797851,28,1,9,0,6,1,3,0,0,1,5,4,4,2,2,0,3
2097,792391,37,10,13,10,13,0,0,9,11,2,6,1,4,1,4,0,29
2097,792395,38,7,17,7,13,0,4,3,3,2,6,7,3,2,5,0,17
2097,781533,12,0,1,0,1,0,0,0,0,0,1,0,4,1,0,0,0
2097,780840,17,2,5,2,5,0,0,0,0,5,4,0,2,1,0,0,4
2097,792394,15,3,5,0,0,3,5,0,0,0,0,0,2,0,0,0,9
2097,786115,5,0,1,0,0,0,1,0,0,0,0,0,2,0,2,0,0
2098,797544,15,4,13,4,12,0,1,0,0,4,3,1,0,0,2,1,8
2098,780351,18,6,7,6,7,0,0,1,2,3,5,0,1,0,0,1,13
2098,797549,19,2,5,2,4,0,1,3,7,3,5,2,1,0,1,0,7
2098,790857,13,1,3,1,3,0,0,0,0,0,3,2,0,1,2,0,2
2098,780586,21,6,8,6,8,0,0,3,4,4,8,3,1,0,1,1,15
2098,797546,19,7,14,7,14,0,0,2,6,6,4,0,0,0,2,1,16
2098,791799,9,3,4,2,3,1,1,0,0,1,1,0,0,0,0,0,7
2098,797539,10,0,2,0,1,0,1,0,0,0,1,1,0,0,0,0,0
2098,797545,11,2,2,1,1,1,1,0,0,0,2,2,1,0,0,0,5
2098,797540,10,1,4,1,3,0,1,2,4,2,1,1,0,1,0,0,4
2098,791716,15,2,6,2,6,0,0,0,0,3,3,0,1,3,1,0,4
2098,791715,16,3,7,3,6,0,1,0,0,2,3,1,1,0,1,0,6
2098,791714,3,1,1,1,1,0,0,1,1,0,1,0,1,0,0,0,3
2098,789065,7,0,3,0,1,0,2,0,0,0,2,1,2,0,1,0,0
2098,785855,12,0,4,0,1,0,3,0,0,2,1,2,1,0,4,0,0
2098,797547,2,0,0,0,0,0,0,0,0,0,0,0,0,0,0,0,0
2100,785627,33,2,6,2,3,0,3,1,2,0,4,2,3,1,4,0,5
2100,785628,38,4,14,3,13,1,1,5,6,0,4,7,3,1,4,0,14
2100,791202,30,2,4,0,0,2,4,3,4,1,2,1,2,0,2,0,9
2100,791201,21,4,8,3,5,1,3,4,5,2,1,2,2,1,1,0,13
2100,775767,32,7,13,7,13,0,0,7,7,5,11,2,2,0,1,0,21
2100,796901,12,3,4,0,0,3,4,0,0,0,1,1,3,0,1,0,9
2100,796902,7,2,3,2,2,0,1,1,2,0,0,1,0,0,1,0,5
2100,781135,8,1,1,1,1,0,0,0,0,1,1,0,2,0,0,0,2
2100,785629,19,1,3,0,2,1,1,0,0,0,1,1,5,2,0,0,3
2101,791950,25,0,6,0,1,0,5,0,1,1,3,2,2,0,1,0,0
2101,775754,37,9,18,7,13,2,5,10,12,2,3,0,3,0,2,1,30
2101,792115,31,4,9,3,5,1,4,3,4,1,0,4,5,2,1,0,12
2101,797715,29,3,7,3,4,0,3,1,2,1,3,4,3,1,1,0,7
2101,780937,27,4,7,3,5,1,2,5,7,2,6,1,2,1,2,1,14
2101,797716,3,0,0,0,0,0,0,0,0,0,0,0,1,0,1,0,0
2101,780938,10,2,2,2,2,0,0,1,1,1,0,0,2,0,1,0,5
2101,797717,14,0,1,0,0,0,1,3,4,0,1,0,2,2,0,0,3
2101,791149,24,2,6,2,2,0,4,2,2,0,4,0,2,0,3,0,6
2102,786739,23,2,3,2,3,0,0,3,4,0,2,6,3,2,5,0,7
2102,792370,23,4,7,4,5,0,2,1,2,0,7,3,3,2,3,5,9
2102,775303,28,1,3,0,0,1,3,2,4,0,1,3,1,2,2,0,5
2102,792373,23,4,9,4,9,0,0,4,4,1,7,0,3,2,3,0,12
2102,797960,27,4,8,2,2,2,6,2,2,0,0,1,0,2,0,0,12
2102,792368,17,2,5,2,2,0,3,2,2,0,1,2,0,1,0,0,6
2102,781597,3,0,1,0,0,0,1,2,2,0,0,0,0,1,0,0,2
2102,797951,11,1,6,1,5,0,1,2,2,0,1,1,0,2,2,0,4
2102,792369,2,0,0,0,0,0,0,0,0,0,0,0,0,0,0,0,0
2102,775809,24,7,8,5,6,2,2,5,6,0,2,1,2,3,3,1,21
2102,797958,19,4,4,4,4,0,0,3,4,0,3,1,1,0,1,1,11
2104,776217,18,3,4,3,4,0,0,2,2,1,4,3,2,0,3,0,8
2104,790818,18,2,4,1,2,1,2,0,0,0,2,5,2,0,0,0,5
2104,791219,18,4,6,2,2,2,4,1,2,0,5,2,1,2,2,0,11
2104,791220,18,3,5,2,3,1,2,0,0,0,4,3,1,1,0,0,7
2104,780730,19,7,9,4,6,3,3,2,2,1,2,2,1,3,1,0,19
2104,786396,22,5,6,4,4,1,2,0,0,0,1,0,3,1,2,0,11
2104,796920,21,3,4,1,1,2,3,0,0,0,1,1,1,0,0,0,8
2104,796921,18,3,9,3,6,0,3,0,0,0,1,2,2,2,0,0,6
2104,786824,22,3,10,3,7,0,3,4,4,2,6,2,0,0,1,1,10
2104,796923,18,3,5,3,5,0,0,2,3,3,3,0,0,1,0,0,8
2104,796924,4,0,0,0,0,0,0,0,0,0,0,0,1,0,1,0,0
2104,792496,4,1,1,0,0,1,1,0,0,0,3,0,0,0,0,0,3
2106,791230,9,1,2,1,1,0,1,0,0,2,1,2,0,0,0,1,2
2106,785557,27,12,18,12,17,0,1,0,0,4,8,3,4,2,1,2,24
2106,791228,18,4,7,4,5,0,2,2,2,1,4,2,2,0,2,0,10
2106,791227,12,2,4,2,2,0,2,0,0,0,1,2,1,2,0,0,4
2106,796932,15,0,3,0,2,0,1,0,0,0,2,3,1,0,1,0,0
2106,796935,19,4,7,0,1,4,6,1,2,2,7,3,3,0,1,1,13
2106,796933,13,3,4,3,4,0,0,1,1,1,2,0,1,4,1,0,7
2106,791229,1,1,1,1,1,0,0,0,0,0,0,0,0,1,0,0,2
2106,785624,14,0,3,0,1,0,2,0,0,1,2,1,0,3,2,0,0
2106,781211,7,0,0,0,0,0,0,0,0,0,0,2,1,0,1,0,0
2106,781201,12,4,8,3,6,1,2,1,2,0,1,2,0,3,2,1,10
2106,781198,14,6,7,3,4,3,3,0,0,0,2,5,0,1,0,0,15
2106,781444,20,10,17,5,7,5,10,0,1,0,5,0,3,1,3,0,25
2106,791226,11,0,0,0,0,0,0,6,6,1,3,0,0,0,0,1,6
2108,785608,19,3,6,2,4,1,2,0,1,0,3,1,2,0,0,1,7
2108,792104,32,5,13,0,5,5,8,2,2,1,4,2,0,0,1,0,17
2108,797708,28,6,11,5,8,1,3,0,0,0,1,3,3,1,3,0,13
2108,786198,26,2,6,1,4,1,2,1,2,0,2,1,1,1,1,0,6
2108,775779,34,5,13,5,9,0,4,0,0,0,3,7,0,1,0,0,10
2108,786204,14,1,2,1,1,0,1,2,2,0,3,1,1,1,3,0,4
2108,797707,22,5,10,4,8,1,2,1,3,1,2,0,3,0,0,0,12
2108,797709,7,0,1,0,0,0,1,0,0,0,0,1,0,0,1,1,0
2108,776327,8,1,2,1,2,0,0,0,0,0,1,0,1,0,0,0,2
2108,786180,5,1,1,1,1,0,0,0,0,1,1,0,1,0,0,0,2
2108,781631,5,1,2,0,0,1,2,0,0,0,1,1,1,0,0,0,3
2109,785714,18,5,10,5,10,0,0,1,2,3,7,1,3,0,2,0,11
2109,775894,28,4,5,3,3,1,2,1,3,2,8,8,0,1,0,0,10
2109,785711,32,7,10,1,3,6,7,0,0,0,2,5,0,0,1,0,20
2109,780985,34,3,5,0,0,3,5,0,0,0,3,1,2,0,3,0,9
2109,775266,28,6,10,3,3,3,7,1,1,0,5,0,2,1,4,0,16
2109,796829,16,7,13,7,13,0,0,1,1,3,2,1,1,0,1,2,15
2109,779994,12,3,7,3,6,0,1,0,0,0,2,1,0,1,1,0,6
2109,791167,10,1,2,1,2,0,0,0,0,0,1,2,1,1,0,0,2
2109,785378,12,1,2,1,1,0,1,0,0,1,2,2,2,0,0,1,2
2109,780988,6,0,2,0,2,0,0,0,0,1,1,2,1,0,1,2,0
2109,791169,2,1,1,1,1,0,0,1,2,0,0,0,1,0,0,0,3
2109,785710,2,0,0,0,0,0,0,0,0,0,0,0,0,0,0,0,0
2110,791012,29,5,10,2,3,3,7,6,6,1,6,1,1,2,3,0,19
2110,781385,29,6,12,3,4,3,8,1,2,0,1,5,3,3,2,1,16
2110,780303,29,3,5,3,5,0,0,4,4,2,5,2,3,1,3,0,10
2110,791594,28,3,9,3,7,0,2,1,2,0,2,4,1,1,1,0,7
2110,785335,13,1,4,1,4,0,0,0,0,3,5,0,5,1,2,0,2
2110,785337,20,3,5,2,4,1,1,9,10,1,2,0,2,0,1,0,16
2110,781221,12,3,4,2,2,1,2,1,1,0,3,1,0,0,1,0,8
2110,791011,21,2,5,2,2,0,3,1,2,4,4,0,1,1,3,2,5
2110,786349,15,0,3,0,1,0,2,0,0,1,1,2,4,2,2,0,0
2110,791013,2,0,0,0,0,0,0,0,0,0,0,0,0,0,0,0,0
2110,796671,2,0,0,0,0,0,0,0,2,1,1,0,0,0,0,0,0
2111,780181,32,7,17,5,11,2,6,6,10,1,4,4,2,4,3,0,22
2111,789177,32,8,10,8,10,0,0,5,6,0,9,1,4,2,2,1,21
2111,791336,27,3,6,2,4,1,2,2,2,0,2,2,1,1,1,0,9
2111,791340,21,1,10,1,7,0,3,0,2,0,2,0,4,0,3,0,2
2111,775758,19,0,1,0,1,0,0,2,2,5,0,2,4,1,3,0,2
2111,797262,18,1,3,1,1,0,2,0,0,0,0,0,2,1,1,0,2
2111,797261,14,1,6,1,2,0,4,0,0,0,1,2,0,2,2,0,2
2111,776089,14,0,1,0,0,0,1,0,0,0,0,0,1,0,0,0,0
2111,789178,11,0,0,0,0,0,0,0,0,0,1,0,2,1,0,0,0
2111,797264,7,0,0,0,0,0,0,0,0,0,1,2,0,0,1,0,0
2111,797260,5,0,2,0,2,0,0,0,0,0,1,0,1,1,0,0,0
2112,780651,25,2,6,2,6,0,0,0,0,3,10,1,4,0,2,2,4
2112,791815,34,7,16,6,14,1,2,5,6,0,5,2,3,0,3,0,20
2112,791810,38,6,11,6,10,0,1,5,6,0,4,5,4,1,5,0,17
2112,791814,27,4,7,1,1,3,6,1,1,0,1,0,1,0,2,0,12
2112,780650,36,5,11,5,9,0,2,6,8,6,9,5,1,2,4,1,16
2112,781596,11,0,0,0,0,0,0,3,4,0,2,0,3,0,2,0,3
2112,786645,6,0,2,0,2,0,0,1,2,1,2,1,1,1,2,0,1
2112,786644,15,2,4,1,3,1,1,2,4,1,3,2,0,0,0,0,7
2112,791809,4,0,1,0,1,0,0,0,0,2,0,0,0,0,0,0,0
2112,791812,4,0,0,0,0,0,0,0,0,0,1,0,0,0,0,0,0
2113,785409,37,8,15,8,15,0,0,4,6,2,5,0,4,1,2,8,20
2113,785408,35,2,9,2,6,0,3,2,4,2,7,1,3,2,2,0,6
2113,780539,34,5,10,3,6,2,4,1,2,0,2,3,0,1,1,0,13
2113,780560,34,2,9,0,5,2,4,2,2,0,1,1,1,2,0,0,8
2113,776484,36,5,16,5,10,0,6,5,5,0,1,3,5,3,2,1,15
2113,790861,10,1,3,1,3,0,0,0,0,0,2,0,2,0,0,0,2
2113,796415,13,2,4,2,3,0,1,1,2,1,0,3,3,3,0,0,5
2113,796417,1,0,0,0,0,0,0,0,0,0,0,0,0,0,0,0,0
2114,797323,35,3,7,2,3,1,4,9,9,0,3,6,2,0,3,0,16
2114,786236,34,6,14,5,8,1,6,2,2,1,2,0,2,0,1,1,15
2114,797322,30,5,12,4,6,1,6,2,2,0,2,0,4,1,2,0,13
2114,797325,26,6,10,6,10,0,0,0,0,6,4,1,2,0,1,0,12
2114,797329,28,3,6,2,2,1,4,0,0,1,7,1,1,2,1,1,7
2114,781002,16,3,6,3,6,0,0,0,2,2,3,2,0,1,1,4,6
2114,786239,4,0,1,0,0,0,1,4,5,0,0,1,2,1,0,0,4
2114,776478,12,1,3,0,0,1,3,0,0,0,1,0,0,0,0,0,3
2114,797324,7,1,1,1,1,0,0,0,0,0,0,1,1,1,0,0,2
2114,786233,5,0,3,0,1,0,2,0,0,0,1,1,0,2,0,0,0
2114,786246,3,0,0,0,0,0,0,0,0,0,0,0,2,0,0,0,0
2116,775738,24,4,8,4,7,0,1,2,2,5,3,0,4,0,1,0,10
2116,786091,36,3,6,3,5,0,1,0,3,4,4,3,2,1,0,0,6
2116,786728,36,9,10,9,10,0,0,4,6,0,3,5,4,2,3,1,22
2116,785904,30,5,19,1,7,4,12,3,5,3,1,3,2,2,2,0,17
2116,780892,15,1,4,0,0,1,4,3,4,0,3,1,2,0,3,0,6
2116,797666,14,0,4,0,3,0,1,0,0,1,3,1,1,0,2,0,0
2116,786788,11,1,2,0,0,1,2,0,0,0,3,1,0,1,0,0,3
2116,786096,20,2,9,2,7,0,2,2,2,1,3,2,4,0,0,0,6
2116,781030,14,5,8,0,0,5,8,0,0,0,3,1,0,0,0,0,15
2117,796891,20,3,10,3,7,0,3,1,2,0,2,1,5,0,1,0,7
2117,796886,27,4,8,3,5,1,3,6,8,0,1,2,1,1,1,1,15
2117,796884,23,4,6,2,3,2,3,3,3,2,8,1,2,1,1,1,13
2117,796882,36,5,11,2,4,3,7,3,3,0,3,2,4,0,4,0,16
2117,790447,32,4,9,4,8,0,1,0,0,0,3,2,2,1,2,1,8
2117,796892,6,1,2,1,2,0,0,0,0,0,1,2,2,0,0,0,2
2117,796890,3,0,2,0,2,0,0,0,0,1,1,0,1,0,0,0,0
2117,796896,20,3,5,2,2,1,3,2,4,0,3,1,4,1,2,0,9
2117,796888,6,0,0,0,0,0,0,0,0,0,1,1,0,0,0,0,0
2117,796887,21,2,5,1,3,1,2,0,0,1,2,0,3,0,1,0,5
2117,796881,6,1,1,0,0,1,1,0,0,0,0,0,1,0,0,0,3
2118,791421,31,8,14,4,7,4,7,2,2,1,3,3,3,1,3,1,22
2118,797085,26,5,6,4,4,1,2,2,4,3,4,3,3,1,0,1,13
2118,791424,17,6,12,6,12,0,0,1,2,1,2,1,3,2,1,0,13
2118,785899,31,2,7,1,1,1,6,0,0,1,4,3,2,3,3,1,5
2118,785509,21,1,6,1,1,0,5,0,0,0,3,2,2,0,1,0,2
2118,791425,16,4,6,4,6,0,0,3,6,5,4,2,1,1,0,0,11
2118,797079,16,1,1,1,1,0,0,5,9,2,1,2,1,0,1,0,7
2118,797087,8,1,2,0,1,1,1,2,2,2,1,1,2,0,2,0,5
2118,797083,3,2,2,1,1,1,1,0,0,0,1,1,0,0,1,0,5
2118,797084,15,1,6,1,3,0,3,2,2,0,0,1,0,2,1,0,4
2118,797090,4,1,1,1,1,0,0,0,0,0,0,0,3,0,0,0,2
2118,797086,6,0,0,0,0,0,0,0,0,0,2,1,0,0,0,0,0
2118,797088,3,0,0,0,0,0,0,0,0,0,0,0,1,0,0,0,0
2118,797081,2,0,0,0,0,0,0,0,0,0,0,0,0,0,0,0,0
2118,797078,0,0,1,0,0,0,1,0,0,0,0,0,0,0,0,0,0
2118,797089,1,0,0,0,0,0,0,0,0,0,2,0,0,0,0,0,0
2124,780870,20,5,9,5,9,0,0,6,6,5,4,2,0,0,1,1,16
2124,781079,24,6,9,4,5,2,4,0,0,2,4,10,0,3,0,0,14
2124,785380,17,3,6,2,4,1,2,0,0,1,3,1,1,0,0,0,7
2124,781443,23,6,8,6,7,0,1,0,0,0,1,5,0,2,0,1,12
2124,775822,21,3,8,0,2,3,6,0,0,1,3,3,1,4,1,0,9
2124,796626,21,7,9,7,9,0,0,0,2,0,2,0,1,0,0,1,14
2124,796189,2,1,1,1,1,0,0,0,0,0,0,0,0,0,0,1,2
2124,796625,22,5,8,3,4,2,4,1,1,0,5,5,2,4,1,0,13
2124,796621,21,8,13,4,4,4,9,0,0,1,0,4,1,2,1,0,20
2124,796202,2,1,1,1,1,0,0,0,0,0,0,1,0,0,0,0,2
2124,791314,8,1,2,0,0,1,2,0,0,0,1,2,0,1,0,0,3
2124,785831,19,5,7,5,7,0,0,0,0,2,1,1,3,0,0,0,10
2126,783269,16,6,7,4,4,2,3,0,0,0,4,2,2,0,2,0,14
2126,780017,23,3,7,2,5,1,2,0,0,1,4,6,1,2,4,1,7
2126,787524,23,2,4,2,3,0,1,0,0,2,7,2,1,2,1,0,4
2126,775961,16,1,6,0,2,1,4,0,0,0,1,4,1,3,3,0,3
2126,791774,6,0,1,0,1,0,0,1,2,1,1,0,1,0,1,0,1
2126,775541,13,6,7,5,6,1,1,3,4,1,3,1,1,1,0,2,16
2126,797610,18,4,9,2,4,2,5,0,0,2,1,0,2,0,1,1,10
2126,797611,17,4,5,3,3,1,2,0,0,2,6,0,1,0,3,2,9
2126,791722,19,2,4,0,1,2,3,1,2,0,1,1,1,1,2,0,7
2126,776790,16,1,4,1,3,0,1,4,5,1,5,3,3,0,2,0,6
2126,787522,11,2,2,2,2,0,0,1,2,1,1,0,1,0,3,2,5
2126,797608,10,2,2,2,2,0,0,0,2,1,1,1,0,0,0,0,4
2126,797606,5,1,4,1,1,0,3,1,2,3,2,2,0,0,0,0,3
2126,791773,7,0,0,0,0,0,0,2,4,1,0,1,0,0,0,0,2
2128,792068,33,7,12,6,7,1,5,2,2,0,2,5,2,0,2,3,17
2128,784640,21,4,8,4,6,0,2,3,4,0,8,0,3,1,1,0,11
2128,792069,29,3,9,2,6,1,3,0,0,1,3,7,4,3,2,1,7
2128,785572,29,4,6,2,2,2,4,2,2,1,8,0,2,0,3,0,12
2128,792072,31,1,4,0,0,1,4,0,0,0,2,1,2,2,0,0,3
2128,797652,25,1,3,0,1,1,2,0,0,0,0,1,1,0,3,0,3
2128,797655,16,3,6,3,6,0,0,3,3,3,5,1,2,0,4,1,9
2128,797657,11,0,3,0,1,0,2,0,0,0,4,1,1,0,1,0,0
2128,774844,2,0,1,0,1,0,0,0,0,0,0,0,0,1,0,0,0
2128,786025,3,0,0,0,0,0,0,0,0,0,0,0,1,0,0,0,0
2129,786481,32,4,10,3,9,1,1,2,6,1,7,1,1,1,2,0,11
2129,797628,16,2,5,2,4,0,1,0,0,1,1,0,0,1,2,0,4
2129,785965,26,3,8,3,5,0,3,0,0,0,2,2,2,2,0,0,6
2129,797624,36,3,10,0,2,3,8,0,1,2,4,1,2,1,0,0,9
2129,797626,37,2,7,1,4,1,3,1,3,0,5,7,1,1,4,0,6
2129,791791,9,1,5,1,3,0,2,0,0,1,0,0,0,0,0,0,2
2129,781032,28,1,4,0,0,1,4,2,4,0,3,3,2,2,1,0,5
2129,797627,8,0,0,0,0,0,0,0,0,0,1,0,1,1,3,0,0
2129,791793,8,3,3,3,3,0,0,1,1,1,1,0,3,0,1,0,7
2130,791777,33,6,13,6,12,0,1,4,7,1,2,0,1,1,2,0,16
2130,780488,11,1,5,1,4,0,1,0,0,0,1,0,1,2,0,0,2
2130,786476,8,1,1,1,1,0,0,0,0,2,0,0,2,0,1,2,2
2130,791783,9,0,0,0,0,0,0,0,0,0,1,1,3,0,1,0,0
2130,791780,8,0,3,0,3,0,0,0,0,0,0,0,0,0,1,0,0
2130,776285,27,10,15,10,15,0,0,4,6,2,2,0,4,0,0,0,24
2130,775503,25,3,4,1,1,2,3,4,4,1,3,1,2,1,0,0,12
2130,786474,18,2,9,1,4,1,5,1,2,0,5,1,3,0,2,0,6
2130,781025,32,2,6,1,4,1,2,0,2,4,0,4,1,1,0,0,5
2130,791781,4,2,2,2,2,0,0,1,2,0,2,0,2,0,0,0,5
2130,791776,19,0,1,0,0,0,1,0,0,0,2,0,3,0,0,0,0
2130,791829,5,0,0,0,0,0,0,0,0,0,0,1,0,0,1,0,0
2130,791778,1,0,0,0,0,0,0,0,0,0,0,0,0,0,0,0,0
2131,791356,33,5,8,4,7,1,1,8,9,6,4,1,4,1,0,2,19
2131,785812,39,4,18,2,8,2,10,8,8,2,3,1,3,0,3,0,18
2131,791680,35,4,9,0,3,4,6,6,6,2,5,2,3,2,2,1,18
2131,780104,30,2,9,2,5,0,4,3,4,1,6,7,4,0,3,0,7
2131,785815,21,1,4,0,2,1,2,0,1,0,4,0,4,0,4,0,3
2131,791681,24,4,5,4,5,0,0,2,2,4,2,0,4,0,1,3,10
2131,791682,4,1,1,1,1,0,0,1,1,1,0,0,1,0,0,0,3
2131,791684,13,1,3,1,1,0,2,0,0,0,0,1,1,0,1,0,2
2131,790530,1,0,0,0,0,0,0,0,0,0,0,0,0,0,0,0,0
2132,786157,24,2,2,2,2,0,0,4,5,1,2,1,5,0,1,3,8
2132,786150,20,1,5,1,3,0,2,0,0,2,2,0,1,3,3,0,2
2132,780676,31,12,17,7,8,5,9,6,7,1,2,2,3,2,2,0,35
2132,791756,31,1,9,1,7,0,2,1,2,1,3,5,3,1,3,0,3
2132,780677,32,1,9,0,4,1,5,0,0,1,2,1,2,0,1,0,3
2132,791754,9,0,2,0,2,0,0,0,0,2,0,0,0,0,0,0,0
2132,775533,15,1,4,0,2,1,2,0,1,0,2,2,1,2,0,0,3
2132,797348,5,0,1,0,1,0,0,0,0,0,0,1,0,0,2,0,0
2132,780992,16,1,5,1,3,0,2,0,0,0,0,0,1,1,1,0,2
2132,780673,17,2,3,0,0,2,3,0,0,0,1,0,1,2,0,0,6
2133,785126,16,2,6,2,5,0,1,0,0,3,2,1,2,0,1,0,4
2133,779857,25,5,6,5,5,0,1,0,0,2,6,0,2,0,0,1,10
2133,785339,22,0,4,0,1,0,3,4,4,0,4,0,1,1,0,0,4
2133,779976,33,7,11,5,8,2,3,6,6,2,5,7,0,1,2,0,22
2133,774990,26,4,9,2,4,2,5,0,0,2,0,1,2,1,4,1,10
2133,796673,2,0,0,0,0,0,0,0,0,0,0,0,1,0,0,0,0
2133,796674,21,1,3,1,3,0,0,2,2,3,2,2,5,0,3,1,4
2133,781586,17,1,3,1,3,0,0,0,0,1,3,2,1,0,4,0,2
2133,785961,24,3,7,2,2,1,5,1,2,0,0,0,1,0,1,0,8
2133,791014,14,2,5,0,0,2,5,2,2,0,1,2,1,1,0,0,8
2134,796790,30,4,13,2,4,2,9,2,3,0,2,1,3,2,1,0,12
2134,786088,27,3,5,3,5,0,0,3,3,1,5,5,2,0,2,0,9
2134,791131,21,3,6,2,3,1,3,0,0,1,1,1,2,0,1,2,7
2134,786090,32,14,18,10,12,4,6,3,3,2,1,3,2,5,1,1,35
2134,791135,28,5,9,5,9,0,0,2,4,7,8,1,1,0,2,2,12
2134,796792,2,0,0,0,0,0,0,0,0,0,1,0,0,0,0,0,0
2134,786092,16,1,3,1,2,0,1,1,4,2,2,2,2,0,2,0,3
2134,786097,12,1,2,1,1,0,1,0,0,0,2,0,0,1,2,0,2
2134,791132,16,2,5,2,3,0,2,0,0,1,4,2,0,0,3,0,4
2134,791133,2,0,1,0,1,0,0,0,0,0,0,0,0,0,0,0,0
2134,792585,2,0,0,0,0,0,0,0,0,0,0,0,0,0,0,0,0
2134,791521,6,0,1,0,1,0,0,0,0,0,0,0,0,0,0,1,0
2134,791134,4,0,1,0,1,0,0,0,0,1,1,0,0,0,0,0,0
2134,796791,2,1,3,1,3,0,0,0,0,1,2,0,0,0,0,0,2
2136,775897,15,0,1,0,0,0,1,0,0,1,2,0,4,0,1,0,0
2136,780324,31,6,10,6,10,0,0,2,6,6,5,2,1,2,3,0,14
2136,786530,39,8,12,3,3,5,9,0,0,0,1,5,4,1,1,0,21
2136,784246,31,5,12,3,7,2,5,0,0,0,3,5,0,1,1,0,12
2136,780317,28,3,10,1,3,2,7,0,0,1,3,2,4,1,3,0,8
2136,791546,9,3,4,3,4,0,0,0,0,1,1,1,0,0,2,0,6
2136,791543,26,0,2,0,1,0,1,8,10,0,1,2,2,0,3,0,8
2136,797091,3,0,0,0,0,0,0,2,2,0,1,0,0,0,0,0,2
2136,791545,6,1,1,1,1,0,0,0,0,0,0,0,1,0,1,0,2
2136,786360,9,0,3,0,0,0,3,0,0,0,2,1,3,0,2,0,0
2136,791547,3,0,0,0,0,0,0,0,0,0,0,0,0,0,0,0,0
2137,791837,34,2,7,2,7,0,0,0,0,3,6,2,2,3,1,0,4
2137,780613,23,2,4,2,4,0,0,1,2,1,1,1,3,0,1,0,5
2137,775097,30,7,9,7,9,0,0,0,0,0,7,2,4,1,8,0,14
2137,780609,39,6,13,4,7,2,6,5,6,0,1,3,3,4,1,0,19
2137,776395,39,9,17,5,12,4,5,5,7,0,3,2,3,2,3,0,27
2137,786621,4,0,1,0,0,0,1,0,0,0,0,0,0,0,0,0,0
2137,786619,6,1,1,1,1,0,0,0,0,0,1,0,0,1,0,0,2
2137,786622,18,0,0,0,0,0,0,4,4,0,2,0,1,0,1,0,4
2137,786169,7,0,0,0,0,0,0,0,0,0,0,0,1,1,0,0,0
2138,797290,32,5,13,4,7,1,6,0,0,3,3,1,1,1,0,1,11
2138,797292,30,7,10,7,10,0,0,0,0,3,3,0,0,0,6,1,14
2138,786064,34,3,11,0,1,3,10,3,4,5,9,0,3,0,3,1,12
2138,791661,15,1,8,0,2,1,6,2,2,2,0,0,4,1,2,0,5
2138,791660,27,1,9,0,4,1,5,2,2,1,2,5,1,1,2,0,5
2138,797291,25,5,10,5,9,0,1,1,1,0,1,6,1,0,2,0,11
2138,780509,26,2,5,1,4,1,1,1,2,3,0,1,5,0,1,1,6
2138,797293,3,0,0,0,0,0,0,0,0,0,0,0,0,0,1,0,0
2138,791658,8,0,1,0,1,0,0,1,2,1,3,0,1,0,1,1,1
2139,780956,35,7,14,5,11,2,3,2,4,2,7,5,2,1,4,1,18
2139,781617,13,2,5,2,3,0,2,0,0,0,2,1,2,0,1,0,4
2139,797310,21,2,5,1,4,1,1,0,0,0,0,4,3,3,3,0,5
2139,791724,31,2,7,0,2,2,5,0,0,0,3,1,3,0,4,1,6
2139,791723,22,3,3,3,3,0,0,0,0,1,3,1,0,1,0,2,6
2139,797308,2,0,0,0,0,0,0,0,0,0,0,0,0,0,0,0,0
2139,785580,32,5,9,4,7,1,2,2,2,2,3,2,3,2,2,0,13
2139,797311,17,3,4,3,4,0,0,2,2,0,2,0,1,1,1,3,8
2139,786285,27,2,5,0,2,2,3,3,4,0,2,2,3,2,1,0,9
2139,780706,0,0,0,0,0,0,0,0,0,0,0,0,0,0,0,0,0
2140,791648,17,5,6,5,6,0,0,0,0,4,5,0,4,0,2,0,10
2140,786195,15,9,11,9,10,0,1,0,0,2,3,0,2,1,3,0,18
2140,797280,19,2,3,2,3,0,0,0,0,0,0,1,2,2,0,0,4
2140,797281,29,5,9,5,7,0,2,6,8,4,8,0,0,1,2,0,16
2140,791649,29,2,5,1,3,1,2,0,0,0,1,4,0,0,0,0,5
2140,785697,10,1,4,1,2,0,2,0,0,0,3,0,1,0,0,0,2
2140,786640,20,3,6,3,6,0,0,1,2,1,2,4,0,1,3,0,7
2140,797278,3,1,1,1,1,0,0,0,0,0,0,0,0,0,0,0,2
2140,785694,9,0,0,0,0,0,0,1,2,2,1,0,3,1,1,2,1
2140,785695,7,1,2,1,1,0,1,0,0,0,0,2,0,0,1,0,2
2140,791647,26,2,6,2,5,0,1,2,2,1,4,1,2,0,3,2,6
2140,797282,5,0,1,0,0,0,1,0,0,0,1,0,1,0,0,0,0
2140,797279,11,2,6,1,3,1,3,0,0,0,1,0,2,0,0,0,5
2142,792186,20,2,5,2,5,0,0,2,2,3,2,1,3,1,2,1,6
2142,781447,15,2,5,2,4,0,1,1,2,1,3,0,3,0,2,1,5
2142,781490,33,7,12,4,7,3,5,0,1,1,2,1,2,2,2,0,17
2142,792183,32,3,9,2,5,1,4,5,6,0,3,2,1,3,4,0,12
2142,786675,31,2,7,1,2,1,5,0,0,0,2,3,1,2,2,2,5
2142,797821,16,1,4,0,1,1,3,0,0,0,4,1,2,0,2,0,3
2142,797820,4,0,0,0,0,0,0,0,0,0,0,0,0,0,0,0,0
2142,780433,10,2,3,2,3,0,0,2,2,1,0,0,3,0,2,0,6
2142,797816,19,2,7,1,1,1,6,0,0,0,0,1,2,1,2,0,5
2142,792188,15,2,4,2,2,0,2,0,0,0,1,0,3,0,2,0,4
2142,792187,4,0,0,0,0,0,0,0,0,0,0,0,1,0,0,0,0
2142,792185,1,0,1,0,1,0,0,0,0,0,0,0,0,0,0,0,0
2143,782133,17,3,4,3,3,0,1,0,0,0,3,1,1,1,0,0,6
2143,785123,17,3,4,3,4,0,0,4,4,2,5,1,2,0,3,1,10
2143,789219,28,4,11,2,5,2,6,0,0,1,3,2,1,4,2,0,10
2143,785059,25,4,7,4,5,0,2,0,0,2,7,3,0,1,1,0,8
2143,796624,4,1,1,0,0,1,1,0,0,0,0,0,0,0,0,0,3
2143,785305,9,2,2,2,2,0,0,2,2,0,1,0,2,0,1,1,6
2143,796622,12,2,4,2,4,0,0,0,0,1,2,1,2,0,0,0,4
2143,796623,27,6,13,5,10,1,3,6,8,2,0,3,4,1,4,0,19
2143,790988,11,2,3,1,1,1,2,0,0,0,3,1,2,1,3,0,5
2143,785303,17,4,7,1,1,3,6,0,0,0,0,0,0,0,1,0,11
2143,785122,17,0,1,0,0,0,1,1,2,2,1,3,0,0,1,0,1
2143,790990,16,1,5,1,3,0,2,3,4,2,3,2,3,0,1,0,5
2144,775954,21,6,10,6,10,0,0,1,1,2,4,2,1,0,0,1,13
2144,781157,20,5,8,3,6,2,2,3,3,0,2,2,1,0,0,0,15
2144,796194,21,0,4,0,1,0,3,0,0,0,4,3,4,0,1,0,0
2144,781006,24,5,9,5,8,0,1,0,0,3,2,4,0,1,1,2,10
2144,790917,26,6,8,3,3,3,5,0,0,3,3,3,0,0,0,2,15
2144,796459,22,8,10,6,7,2,3,3,4,1,5,6,0,1,0,0,21
2144,796464,17,5,8,3,5,2,3,1,2,0,4,3,2,1,1,1,13
2144,780648,14,2,3,2,3,0,0,0,0,1,3,1,0,1,1,0,4
2144,790916,7,0,2,0,1,0,1,0,0,0,0,0,1,0,0,1,0
2144,790918,10,3,5,3,5,0,0,2,4,0,2,1,0,3,1,0,8
2144,790919,6,0,1,0,0,0,1,0,0,0,2,3,1,1,1,1,0
2144,785238,6,2,4,2,4,0,0,0,0,0,1,0,0,0,1,0,4
2144,796461,3,0,0,0,0,0,0,0,0,0,0,0,0,0,0,0,0
2144,785460,3,0,0,0,0,0,0,0,0,0,0,0,0,0,0,0,0
2145,797822,27,2,10,1,4,1,6,3,4,0,2,1,4,0,1,0,8
2145,797824,19,2,3,0,1,2,2,0,0,1,3,1,2,1,2,0,6
2145,792190,34,5,12,3,6,2,6,0,0,0,2,3,1,0,1,0,12
2145,775116,20,1,2,1,2,0,0,0,0,0,1,2,1,0,0,0,2
2145,786664,31,4,13,2,5,2,8,3,4,0,4,1,3,2,4,0,13
2145,791928,5,1,2,1,2,0,0,0,0,0,1,0,2,0,1,0,2
2145,792192,21,0,1,0,1,0,0,0,1,1,3,0,2,0,2,1,0
2145,797830,13,1,6,1,4,0,2,0,0,0,1,0,0,0,0,0,2
2145,792193,15,2,7,2,6,0,1,0,0,0,2,0,1,0,1,1,4
2145,792191,11,0,0,0,0,0,0,0,0,0,0,1,1,0,1,0,0
2145,781266,3,0,2,0,1,0,1,0,0,1,0,0,0,0,0,0,0
2145,797828,1,0,0,0,0,0,0,0,0,0,0,0,0,0,0,0,0
2146,780580,33,2,11,2,8,0,3,1,2,0,3,6,3,1,3,1,5
2146,776150,19,0,3,0,1,0,2,0,0,0,1,4,1,0,0,0,0
2146,781407,24,0,3,0,1,0,2,2,2,2,8,2,3,2,1,1,2
2146,785623,26,7,9,3,3,4,6,2,5,2,2,0,3,0,0,1,20
2146,791583,23,6,10,6,10,0,0,0,0,2,4,1,5,2,2,2,12
2146,786608,21,3,3,3,3,0,0,0,7,2,3,0,0,0,0,1,6
2146,786110,12,3,7,1,1,2,6,0,0,0,0,0,1,1,0,0,8
2146,797445,16,1,4,0,3,1,1,2,2,0,0,0,1,0,1,0,5
2146,786659,14,0,3,0,3,0,0,0,0,1,3,0,1,0,2,0,0
2146,797448,12,0,2,0,1,0,1,0,0,0,2,0,0,2,1,0,0
2147,790788,27,6,10,2,4,4,6,0,0,1,3,1,1,0,0,0,16
2147,796347,20,0,3,0,2,0,1,1,2,1,1,1,3,1,1,0,1
2147,781026,35,8,14,5,9,3,5,3,6,1,4,3,1,2,4,1,22
2147,781028,32,3,11,1,5,2,6,3,6,1,1,2,3,1,4,0,11
2147,785243,16,4,5,4,4,0,1,2,3,3,3,0,4,0,2,2,10
2147,796348,13,1,5,0,2,1,3,0,0,0,0,1,1,1,0,0,3
2147,790787,1,0,0,0,0,0,0,0,0,0,0,1,0,0,0,0,0
2147,796349,16,1,2,1,2,0,0,0,0,1,1,2,1,1,0,1,2
2147,781027,25,0,5,0,2,0,3,0,0,2,10,0,1,0,0,0,0
2147,785242,15,1,1,1,1,0,0,0,0,0,6,2,1,0,1,0,2
2148,786623,27,5,6,5,6,0,0,6,6,3,5,0,2,0,3,0,16
2148,797405,26,2,8,2,7,0,1,0,0,1,0,0,1,1,3,0,4
2148,791833,22,2,4,2,4,0,0,4,6,1,2,3,4,0,2,0,8
2148,785920,35,2,9,2,9,0,0,0,0,0,6,6,2,0,2,0,4
2148,785698,28,5,9,2,2,3,7,0,0,0,3,1,2,3,1,0,13
2148,797413,8,0,3,0,1,0,2,0,0,0,1,0,1,0,1,0,0
2148,786624,14,3,5,3,5,0,0,0,0,0,2,0,1,0,0,1,6
2148,797404,3,0,0,0,0,0,0,0,0,0,0,0,0,0,1,0,0
2148,791834,20,0,2,0,0,0,2,0,0,0,1,3,0,0,3,1,0
2148,784077,17,2,4,1,1,1,3,0,0,1,1,0,1,0,0,0,5
2149,797163,33,9,15,9,15,0,0,1,1,3,4,1,2,2,1,1,19
2149,791385,35,2,9,2,3,0,6,1,2,3,7,6,2,1,2,3,5
2149,786450,39,3,6,2,4,1,2,1,2,1,3,1,4,2,3,2,8
2149,797165,17,0,4,0,1,0,3,1,3,0,3,2,1,1,0,0,1
2149,776396,35,8,15,7,10,1,5,1,2,2,1,2,3,2,1,0,18
2149,797162,7,1,1,1,1,0,0,0,0,0,0,1,3,0,1,0,2
2149,797164,5,0,0,0,0,0,0,0,0,0,2,0,0,0,0,0,0
2149,797161,3,0,0,0,0,0,0,0,0,0,0,0,1,0,0,0,0
2149,776199,26,5,10,3,5,2,5,5,7,1,2,3,3,1,2,0,17
2150,781398,20,1,6,1,6,0,0,1,4,4,3,3,1,0,1,0,3
2150,786029,14,7,7,7,7,0,0,4,5,1,2,1,2,0,0,3,18
2150,797737,16,0,1,0,1,0,0,0,0,2,2,1,0,1,0,0,0
2150,792114,23,4,13,0,4,4,9,2,2,1,0,4,0,2,1,0,14
2150,786018,23,3,10,1,3,2,7,0,0,3,3,0,2,1,1,1,8
2150,797740,17,5,8,4,6,1,2,2,4,2,6,1,0,1,3,1,13
2150,775678,19,2,8,2,5,0,3,2,2,0,5,3,0,4,0,0,6
2150,797743,13,0,3,0,1,0,2,0,2,1,0,0,2,0,2,0,0
2150,797745,13,1,4,0,2,1,2,0,0,1,1,0,1,1,3,0,3
2150,797746,18,0,5,0,5,0,0,0,0,5,2,1,1,0,0,1,0
2150,786022,12,3,3,3,3,0,0,0,0,4,1,0,0,0,1,0,6
2150,797744,7,1,4,1,1,0,3,0,0,0,0,0,2,0,0,0,2
2150,797741,2,0,1,0,0,0,1,0,0,0,0,0,0,0,0,0,0
2150,780352,2,0,0,0,0,0,0,0,0,0,0,0,0,0,0,0,0
2150,780354,1,0,0,0,0,0,0,0,0,0,0,0,0,0,0,0,0
2152,775913,18,1,1,1,1,0,0,1,2,1,1,1,3,0,1,0,3
2152,791737,32,5,7,4,5,1,2,0,0,0,6,4,2,2,3,1,11
2152,783524,32,7,14,5,9,2,5,7,10,0,1,1,2,0,3,0,23
2152,786223,21,1,3,1,1,0,2,2,4,3,2,6,3,1,1,0,4
2152,780561,30,2,7,1,2,1,5,0,0,0,3,2,2,1,1,0,5
2152,781516,5,0,0,0,0,0,0,0,0,0,4,0,0,0,0,0,0
2152,797332,9,1,2,1,2,0,0,0,1,0,2,0,1,0,0,1,2
2152,797333,7,0,0,0,0,0,0,0,0,0,1,0,1,0,0,0,0
2152,797331,27,3,10,1,3,2,7,2,2,0,1,1,2,0,0,1,10
2152,786220,19,3,7,0,1,3,6,0,0,1,1,2,2,1,2,0,9
2153,781537,26,1,5,1,2,0,3,0,0,3,3,2,4,0,1,0,2
2153,797842,31,8,14,7,13,1,1,7,7,2,8,1,3,4,3,0,24
2153,797849,29,5,9,2,6,3,3,0,0,1,5,0,3,0,2,1,13
2153,786079,26,4,7,3,5,1,2,0,2,0,2,3,1,0,2,0,9
2153,797843,40,4,10,2,6,2,4,0,0,0,1,5,2,2,0,0,10
2153,792201,13,0,1,0,1,0,0,2,2,0,1,0,2,0,1,1,2
2153,797846,35,3,11,3,7,0,4,3,6,2,2,1,2,0,0,0,9
2154,786724,21,2,8,2,4,0,4,2,2,1,5,1,0,2,0,0,6
2154,786723,25,6,13,4,10,2,3,8,8,2,4,1,1,2,2,0,22
2154,792349,14,1,2,1,2,0,0,2,2,0,0,0,3,0,0,1,4
2154,792355,22,4,10,3,6,1,4,0,0,0,2,1,2,2,1,1,9
2154,792352,23,2,4,2,3,0,1,0,0,0,2,7,0,2,0,1,4
2154,798061,15,3,5,2,3,1,2,0,1,1,5,2,3,1,1,2,7
2154,798060,20,4,8,3,6,1,2,6,6,2,1,2,1,1,2,0,15
2154,786726,20,2,3,2,3,0,0,0,0,4,5,0,1,2,2,0,4
2154,792348,14,1,6,0,2,1,4,0,0,1,0,2,0,1,0,0,3
2154,798059,12,1,4,1,3,0,1,1,2,2,1,0,1,0,2,1,3
2154,792353,5,0,0,0,0,0,0,2,2,0,2,0,0,0,1,0,2
2154,792357,7,0,2,0,0,0,2,0,0,1,1,0,2,0,0,0,0
2154,781573,2,0,0,0,0,0,0,0,0,0,0,0,0,0,0,0,0
2155,781650,22,4,6,4,6,0,0,5,5,1,1,0,4,0,2,0,13
2155,797070,28,2,9,2,7,0,2,0,0,0,3,0,0,0,3,0,4
2155,776079,15,0,4,0,1,0,3,0,0,1,2,1,0,1,2,0,0
2155,797068,23,1,5,1,1,0,4,0,0,0,6,5,3,1,2,0,2
2155,791432,26,2,9,0,3,2,6,0,0,0,2,0,2,0,3,0,6
2155,797066,18,1,4,1,4,0,0,0,0,3,3,0,1,1,0,3,2
2155,780180,12,0,2,0,1,0,1,0,0,0,1,0,2,1,2,1,0
2155,777865,25,4,11,2,5,2,6,0,1,1,3,2,3,2,3,1,10
2155,791429,10,0,3,0,2,0,1,0,0,0,0,0,2,0,2,0,0
2155,797067,13,0,2,0,2,0,0,0,0,1,2,0,3,1,1,1,0
2155,781203,8,2,2,2,2,0,0,0,0,0,0,0,0,1,0,0,4
2156,785509,22,6,9,1,2,5,7,0,0,1,2,3,2,0,0,2,17
2156,791424,24,9,13,8,12,1,1,0,0,3,7,0,2,0,1,3,19
2156,797085,32,8,8,3,3,5,5,5,6,0,16,4,1,4,2,0,26
2156,791421,29,4,10,2,3,2,7,0,0,0,4,5,1,0,0,0,10
2156,785899,26,3,7,1,4,2,3,2,2,2,0,6,2,1,1,0,10
2156,797079,10,1,3,1,3,0,0,2,2,2,1,0,2,1,1,0,4
2156,797081,2,2,2,1,1,1,1,0,0,1,1,0,0,0,0,0,5
2156,791425,15,4,6,4,6,0,0,2,2,3,2,1,1,1,1,0,10
2156,797086,3,1,1,1,1,0,0,1,2,0,0,0,0,0,1,0,3
2156,797089,1,0,1,0,1,0,0,0,0,0,0,0,0,0,0,0,0
2156,797090,5,1,1,1,1,0,0,0,0,0,2,1,0,0,0,1,2
2156,797084,8,0,0,0,0,0,0,2,2,0,2,0,1,0,0,0,2
2156,797083,8,0,1,0,0,0,1,0,0,0,0,0,2,0,1,0,0
2156,797078,2,0,0,0,0,0,0,0,0,0,0,1,0,0,1,0,0
2156,797088,4,0,0,0,0,0,0,0,0,0,0,0,0,0,0,0,0
2156,797087,9,1,2,0,1,1,1,2,2,0,0,1,0,0,1,0,5
2158,791699,25,3,6,2,3,1,3,7,9,3,5,0,4,1,3,1,14
2158,797523,29,0,3,0,1,0,2,0,2,1,1,3,1,1,2,0,0
2158,785402,21,6,7,6,7,0,0,4,8,1,6,0,5,0,0,0,16
2158,792118,32,3,7,2,5,1,2,1,1,0,5,9,2,1,2,0,8
2158,785828,9,1,1,1,1,0,0,1,2,2,2,0,5,0,3,0,3
2158,791702,6,0,0,0,0,0,0,0,0,0,0,0,1,0,2,0,0
2158,797525,9,2,2,2,2,0,0,0,0,0,1,0,1,0,1,0,4
2158,797526,13,0,2,0,0,0,2,0,0,0,0,1,3,0,1,0,0
2158,792663,1,0,0,0,0,0,0,0,0,0,0,0,0,1,0,0,0
2158,791700,21,2,3,0,0,2,3,0,0,1,1,0,2,1,1,0,6
2158,782593,34,7,16,3,7,4,9,5,5,0,7,5,1,1,3,2,23
2159,792473,22,2,4,2,3,0,1,1,6,2,4,1,5,2,2,1,5
2159,780043,39,2,5,2,3,0,2,5,6,1,2,4,2,3,3,0,9
2159,799276,36,5,8,2,4,3,4,2,2,0,3,2,4,1,2,0,15
2159,785249,35,5,10,3,6,2,4,2,3,0,0,2,4,2,0,0,14
2159,780035,35,2,7,2,5,0,2,2,4,0,2,4,1,0,3,0,6
2159,785251,4,0,0,0,0,0,0,1,2,0,1,1,0,0,1,0,1
2159,799281,3,0,2,0,1,0,1,0,0,0,0,0,1,0,1,0,0
2159,792477,10,1,2,0,1,1,1,0,0,1,2,0,0,0,1,0,3
2159,780036,16,2,8,2,6,0,2,0,0,0,2,0,3,2,2,0,4
2162,791289,22,2,3,2,3,0,0,0,0,1,1,2,4,0,3,2,4
2162,785786,31,4,5,3,3,1,2,2,3,1,6,1,2,0,1,2,11
2162,796571,31,6,13,4,8,2,5,2,2,0,4,3,2,1,2,0,16
2162,791291,19,3,4,1,1,2,3,2,2,0,0,0,3,0,0,0,10
2162,781346,31,6,12,2,5,4,7,5,5,2,3,0,1,0,1,0,21
2162,796576,18,2,5,1,2,1,3,0,0,0,2,4,1,2,0,0,5
2162,796574,10,1,3,1,2,0,1,2,2,0,2,0,1,0,0,0,4
2162,791290,13,1,4,1,1,0,3,0,0,0,2,1,2,0,1,0,2
2162,791288,9,2,2,1,1,1,1,0,1,0,0,0,1,0,0,0,5
2162,796572,16,3,3,3,3,0,0,4,8,2,2,1,0,0,0,0,10
2163,792379,34,3,8,2,2,1,6,0,0,0,1,2,3,0,2,0,7
2163,792380,37,5,11,0,1,5,10,1,2,0,1,4,3,0,2,0,16
2163,781672,26,3,8,2,6,1,2,0,0,1,5,0,3,1,0,0,7
2163,781669,37,4,8,2,2,2,6,2,2,0,1,6,2,0,0,0,12
2163,797854,16,2,3,0,0,2,3,2,2,1,2,1,3,0,2,0,8
2163,797852,12,0,2,0,1,0,1,1,2,0,1,0,0,0,1,0,1
2163,786764,2,0,0,0,0,0,0,0,0,0,0,0,0,0,0,0,0
2163,786765,36,7,15,5,10,2,5,10,11,2,7,3,3,0,2,2,26
2164,775455,27,7,10,7,10,0,0,3,4,2,9,4,1,0,3,0,17
2164,792123,31,6,10,4,6,2,4,2,3,0,2,1,2,0,5,1,16
2164,781397,26,4,5,3,3,1,2,0,0,0,4,2,2,0,1,1,9
2164,792124,25,4,7,4,7,0,0,0,0,2,4,1,1,0,1,2,8
2164,786002,20,2,9,0,3,2,6,0,0,0,2,2,2,0,0,0,6
2164,786003,19,3,4,1,1,2,3,2,2,2,2,0,1,1,4,1,10
2164,792120,22,3,5,2,3,1,2,0,0,0,4,3,3,1,0,0,7
2164,797754,7,1,1,1,1,0,0,1,2,2,1,1,0,0,0,0,3
2164,797749,10,0,0,0,0,0,0,0,0,0,0,1,1,0,0,0,0
2164,786005,5,0,2,0,1,0,1,0,0,0,0,0,1,0,0,0,0
2164,797752,5,0,1,0,1,0,0,0,0,0,1,0,2,0,1,0,0
2164,792119,3,0,0,0,0,0,0,0,0,0,0,0,0,0,0,0,0
2165,796758,28,6,15,6,15,0,0,6,9,5,3,0,1,2,2,0,18
2165,791105,36,3,9,2,6,1,3,6,6,2,1,2,4,5,1,0,13
2165,791101,25,6,15,5,9,1,6,0,0,3,2,0,0,0,2,0,13
2165,780794,25,3,5,1,2,2,3,0,0,1,1,2,1,1,0,0,8
2165,796759,23,2,6,2,5,0,1,0,0,1,1,0,3,0,1,0,4
2165,780109,23,1,8,0,2,1,6,0,0,0,3,1,4,0,1,1,3
2165,796757,17,1,3,1,3,0,0,0,0,0,1,0,2,0,1,1,2
2165,796761,19,0,2,0,2,0,0,0,0,2,3,0,2,0,1,0,0
2165,785597,4,0,0,0,0,0,0,0,0,0,0,0,0,0,2,0,0
2166,790962,24,3,5,2,3,1,2,3,4,0,6,3,2,0,2,0,10
2166,796554,24,4,7,4,5,0,2,0,0,3,3,0,1,1,2,1,8
2166,775860,25,2,4,1,1,1,3,4,4,0,7,2,3,1,2,0,9
2166,790961,27,3,7,3,7,0,0,7,10,4,5,3,1,2,1,1,13
2166,785278,24,6,11,4,6,2,5,0,0,1,2,2,1,2,1,0,14
2166,796553,4,0,0,0,0,0,0,0,0,0,0,3,0,1,0,0,0
2166,786240,15,1,6,1,4,0,2,0,0,0,1,0,2,1,2,0,2
2166,796555,7,0,0,0,0,0,0,0,0,0,1,0,0,0,1,0,0
2166,790963,4,1,1,0,0,1,1,0,0,0,1,0,0,0,0,0,3
2166,790960,4,0,1,0,0,0,1,2,2,0,1,0,1,0,0,0,2
2166,796556,15,1,3,1,2,0,1,2,2,2,2,0,0,2,2,1,4
2166,790965,5,1,1,1,1,0,0,1,1,0,2,0,2,0,1,0,3
2166,780832,14,1,2,1,2,0,0,1,2,2,0,0,0,0,1,1,3
2166,780363,4,0,1,0,0,0,1,0,0,0,1,0,1,0,0,0,0
2166,796557,4,2,2,0,0,2,2,0,0,0,1,0,1,0,0,0,6
2168,789066,29,5,10,4,7,1,3,3,3,0,3,2,1,0,1,0,14
2168,790232,34,6,8,5,6,1,2,0,0,0,3,3,3,1,3,0,13
2168,776278,27,2,6,0,1,2,5,4,4,0,4,0,3,0,0,0,10
2168,780614,22,2,5,1,3,1,2,3,4,0,5,1,3,1,1,2,8
2168,780093,18,2,6,2,6,0,0,0,0,1,2,0,1,0,0,0,4
2168,780255,19,3,4,3,4,0,0,2,4,0,3,3,2,0,0,0,8
2168,785806,25,2,6,1,3,1,3,1,2,0,4,4,1,0,0,0,6
2168,792411,17,1,2,0,0,1,2,0,0,0,3,0,1,0,0,0,3
2168,786463,9,1,5,1,3,0,2,0,1,0,1,0,2,1,1,0,2
2169,781606,38,5,11,4,8,1,3,1,2,1,4,2,1,1,1,0,12
2169,786620,32,3,10,0,2,3,8,2,2,0,3,1,5,0,1,0,11
2169,781257,31,3,8,1,3,2,5,2,2,1,5,1,3,0,2,0,10
2169,796955,18,1,3,1,3,0,0,2,2,2,3,0,0,0,2,0,4
2169,781263,21,1,10,1,6,0,4,0,0,2,2,1,2,2,2,0,2
2169,791838,19,2,6,1,2,1,4,2,2,1,1,2,3,0,0,0,7
2169,796954,21,1,6,0,1,1,5,2,2,1,3,1,1,0,1,0,5
2169,791257,18,0,3,0,2,0,1,0,2,3,4,0,2,0,1,2,0
2169,791255,1,0,0,0,0,0,0,0,0,0,1,0,0,0,0,0,0
2169,780900,1,0,0,0,0,0,0,0,0,0,0,0,0,0,1,0,0
2169,785508,0,0,0,0,0,0,0,0,0,0,0,0,0,0,0,0,0
2170,780495,35,8,21,7,16,1,5,5,7,1,3,3,1,3,5,0,22
2170,780496,23,5,8,0,1,5,7,2,5,0,1,1,3,2,4,0,17
2170,785693,16,3,5,3,5,0,0,3,3,3,3,0,4,0,2,0,9
2170,780494,17,2,2,2,2,0,0,0,0,0,2,1,1,0,1,0,4
2170,785692,21,0,1,0,0,0,1,0,0,0,1,0,2,0,5,0,0
2170,785644,18,3,8,1,4,2,4,2,4,2,1,3,3,1,3,0,10
2170,780497,26,2,7,1,6,1,1,1,2,1,7,1,3,0,0,0,6
2170,797276,17,2,2,2,2,0,0,1,1,0,4,2,1,2,2,0,5
2170,797277,6,1,2,1,1,0,1,1,1,2,1,1,0,0,0,1,3
2170,791643,8,0,3,0,2,0,1,0,0,1,0,1,0,0,0,1,0
2170,797274,1,0,0,0,0,0,0,0,0,0,0,0,0,0,0,0,0
2170,791645,12,1,2,1,2,0,0,0,0,1,1,0,4,1,0,0,2
2171,792126,29,5,10,0,0,5,10,4,5,1,2,1,4,3,1,0,19
2171,792127,30,6,14,3,8,3,6,0,0,2,7,2,4,2,4,0,15
2171,792132,31,4,8,3,5,1,3,4,7,0,2,9,4,0,1,0,13
2171,786838,22,3,10,3,9,0,1,0,0,3,1,1,4,1,4,4,6
2171,792128,25,1,5,1,3,0,2,3,6,5,3,2,3,2,0,0,5
2171,797736,21,4,9,2,5,2,4,1,2,0,3,0,2,2,1,0,11
2171,792131,26,2,6,2,6,0,0,1,2,5,5,0,2,0,4,1,5
2171,791668,4,1,4,1,3,0,1,0,0,0,0,0,0,0,0,0,2
2171,799273,8,0,3,0,3,0,0,0,0,2,1,0,0,1,0,3,0
2171,797739,4,0,0,0,0,0,0,0,0,0,0,1,0,0,4,0,0
2172,791437,36,4,7,4,6,0,1,11,15,0,7,9,3,0,3,0,19
2172,791438,39,6,12,6,9,0,3,6,7,3,9,2,2,1,1,2,18
2172,797053,35,5,10,5,10,0,0,8,11,1,4,1,3,2,1,0,18
2172,776137,35,4,10,2,4,2,6,3,4,0,10,1,2,1,4,3,13
2172,797060,36,3,9,2,4,1,5,0,0,0,3,1,1,0,2,1,7
2172,791439,5,2,2,2,2,0,0,0,0,0,0,1,1,2,2,0,4
2172,791436,5,1,2,1,2,0,0,0,0,0,2,0,0,0,0,0,2
2172,797059,7,0,0,0,0,0,0,0,0,0,1,0,1,0,1,0,0
2172,786305,2,0,0,0,0,0,0,0,0,0,0,0,0,0,1,0,0
2173,792495,38,10,19,10,15,0,4,1,5,1,7,6,3,3,4,1,21
2173,792493,30,8,16,3,4,5,12,0,0,0,3,2,3,3,1,0,21
2173,792491,33,4,13,4,13,0,0,6,7,0,3,8,4,1,0,0,14
2173,780023,17,2,4,2,4,0,0,1,2,0,2,0,5,1,1,0,5
2173,781144,33,0,11,0,2,0,9,0,0,1,1,3,3,0,0,0,0
2173,792492,28,5,11,4,8,1,3,2,2,3,9,1,2,1,2,0,13
2173,793441,5,1,1,1,1,0,0,0,0,1,0,1,0,0,0,0,2
2173,786832,14,0,0,0,0,0,0,0,0,0,0,0,3,1,0,1,0
2173,798960,2,0,0,0,0,0,0,0,0,0,2,0,1,0,0,1,0
2174,780828,34,6,12,6,10,0,2,2,2,0,3,3,3,0,3,0,14
2174,792032,33,5,11,4,9,1,2,1,2,0,6,4,4,3,2,0,12
2174,761149,27,4,8,3,5,1,3,2,3,1,1,1,2,1,1,0,11
2174,792029,10,1,1,0,0,1,1,1,2,0,1,0,2,0,1,1,4
2174,792031,19,2,4,1,1,1,3,2,2,0,1,3,4,0,1,0,7
2174,792027,16,0,2,0,1,0,1,0,0,0,2,1,1,0,2,1,0
2174,797637,12,0,4,0,2,0,2,2,2,0,1,0,2,0,2,0,2
2174,797636,3,0,1,0,1,0,0,0,0,0,0,0,0,0,2,0,0
2174,797638,7,0,1,0,0,0,1,0,0,0,0,1,1,0,0,0,0
2174,792030,10,2,2,2,2,0,0,0,0,0,1,1,1,0,0,1,4
2174,797640,11,0,1,0,1,0,0,0,0,1,2,0,2,0,1,0,0
2174,797641,7,1,1,1,1,0,0,0,0,0,0,0,1,0,1,0,2
2174,785822,8,0,1,0,1,0,0,0,0,1,0,0,2,0,1,1,0
2174,797642,3,0,0,0,0,0,0,1,2,0,0,0,0,0,1,0,1
2175,785630,23,4,9,1,2,3,7,1,2,0,1,0,2,2,1,0,12
2175,780777,26,7,10,6,8,1,2,10,11,0,2,5,2,2,3,0,25
2175,785631,29,5,8,2,4,3,4,2,3,1,6,1,1,1,1,0,15
2175,785863,21,4,6,4,6,0,0,4,6,1,1,0,3,0,1,0,12
2175,786248,17,1,3,1,3,0,0,0,2,2,5,0,2,1,2,1,2
2175,791200,12,1,5,1,3,0,2,0,0,1,1,1,4,0,3,0,2
2175,791196,3,0,1,0,0,0,1,0,0,0,0,0,1,0,0,0,0
2175,796898,3,0,0,0,0,0,0,0,0,0,0,0,1,0,2,0,0
2175,791199,6,0,2,0,2,0,0,0,0,1,1,0,1,0,0,0,0
2175,791198,17,0,1,0,0,0,1,0,0,0,0,1,1,0,0,0,0
2175,796899,1,0,0,0,0,0,0,0,0,0,0,0,0,0,0,0,0
2175,791197,17,0,1,0,1,0,0,1,2,0,3,0,1,0,1,0,1
2175,781129,2,0,1,0,1,0,0,0,0,0,0,0,0,0,0,0,0
2175,785632,23,2,4,2,3,0,1,2,3,1,4,0,1,2,0,1,6
2176,780625,29,2,6,0,2,2,4,2,2,0,1,5,3,1,1,0,8
2176,797394,23,4,6,4,4,0,2,0,0,0,6,2,1,2,1,1,8
2176,780631,34,3,9,2,4,1,5,0,2,1,7,2,2,0,0,0,7
2176,786625,31,2,6,1,2,1,4,3,4,0,2,2,3,1,1,0,8
2176,791827,29,8,12,8,12,0,0,4,6,2,6,1,4,1,5,0,20
2176,797395,25,4,10,4,8,0,2,0,0,1,0,0,0,0,1,0,8
2176,785481,4,0,0,0,0,0,0,0,0,0,1,0,2,0,2,0,0
2176,786630,11,1,2,1,2,0,0,3,3,1,0,1,2,0,1,0,5
2176,791830,6,0,0,0,0,0,0,0,2,0,0,0,1,0,1,0,0
2176,797397,8,0,0,0,0,0,0,1,2,2,0,0,1,0,1,1,1
2177,775305,37,8,17,7,16,1,1,7,8,1,7,11,1,1,0,0,24
2177,780291,25,7,10,6,8,1,2,0,0,3,10,0,3,2,2,0,15
2177,785333,34,5,8,2,4,3,4,0,0,1,2,5,3,0,3,1,13
2177,785607,7,2,4,2,4,0,0,1,2,1,1,0,1,0,1,0,5
2177,796665,29,1,6,1,4,0,2,0,0,1,1,0,1,0,1,0,2
2177,796663,13,1,4,1,4,0,0,0,0,2,0,0,2,0,0,0,2
2177,796666,12,3,3,3,3,0,0,1,2,2,1,2,3,0,1,0,7
2177,791004,23,5,10,2,5,3,5,0,0,1,0,0,3,0,0,0,13
2177,796664,20,2,4,2,3,0,1,0,0,0,1,0,1,1,1,0,4
2178,797463,38,5,13,4,8,1,5,4,4,1,6,1,2,1,1,0,15
2178,791854,36,3,8,3,5,0,3,1,1,1,2,3,1,0,5,0,7
2178,791858,18,2,5,2,2,0,3,2,2,3,1,1,5,1,1,0,6
2178,785625,34,2,10,2,7,0,3,3,4,4,10,2,4,1,0,2,7
2178,791109,29,3,9,3,9,0,0,4,5,2,0,1,3,0,1,0,10
2178,797464,7,0,1,0,0,0,1,0,0,0,3,0,2,1,0,0,0
2178,797465,2,0,0,0,0,0,0,0,0,0,1,0,1,0,0,0,0
2178,797467,2,0,0,0,0,0,0,0,0,0,0,0,1,0,1,1,0
2178,797468,19,5,8,5,8,0,0,3,4,5,1,0,4,0,2,0,13
2178,797469,15,1,5,1,4,0,1,2,2,1,2,0,2,2,3,0,4
2179,798965,20,1,4,0,2,1,2,0,0,0,4,0,4,1,1,1,3
2179,791718,34,2,9,1,4,1,5,1,2,0,4,3,1,0,1,0,6
2179,798966,5,0,0,0,0,0,0,3,4,1,0,0,3,0,2,0,3
2179,798968,19,2,6,2,4,0,2,3,5,1,2,0,5,1,1,0,7
2179,798967,25,1,5,0,3,1,2,0,0,0,1,1,0,0,0,0,3
2179,798963,9,0,1,0,1,0,0,1,5,0,1,2,3,0,3,0,1
2179,781446,11,0,1,0,1,0,0,2,2,0,1,2,2,0,2,0,2
2179,798962,26,4,6,4,6,0,0,6,10,2,1,0,3,2,1,3,14
2179,791720,11,3,5,2,4,1,1,0,0,0,0,0,0,0,2,0,7
2179,768880,2,0,0,0,0,0,0,0,0,0,0,0,0,0,0,0,0
2179,791717,14,2,3,2,3,0,0,0,1,0,2,1,0,0,1,0,4
2179,791719,20,2,3,0,1,2,2,0,0,0,0,0,1,0,0,0,6
2179,787996,4,0,0,0,0,0,0,0,0,0,1,0,2,0,1,0,0
2180,785294,15,3,6,3,6,0,0,2,2,4,3,2,1,1,4,0,8
2180,796514,21,1,3,1,2,0,1,0,0,0,1,4,3,5,1,0,2
2180,791085,20,4,6,3,4,1,2,0,1,1,0,4,3,1,1,1,9
2180,791080,15,6,7,5,6,1,1,1,1,2,2,2,1,0,0,0,14
2180,785675,14,3,7,1,2,2,5,0,0,0,3,2,0,1,0,0,8
2180,796511,19,2,5,0,1,2,4,2,2,1,5,4,0,2,0,0,8
2180,791084,13,3,3,3,3,0,0,2,2,2,5,1,0,1,1,0,8
2180,791083,12,3,4,2,2,1,2,0,0,1,1,0,0,0,0,6,7
2180,791081,8,3,3,3,3,0,0,2,4,1,2,0,1,0,1,1,8
2180,796512,27,9,15,5,5,4,10,0,0,0,2,1,1,2,0,0,22
2180,791082,5,1,2,1,1,0,1,0,0,1,1,0,0,0,1,0,2
2180,791079,5,2,3,2,2,0,1,0,0,0,1,0,0,0,0,0,4
2180,786446,26,4,9,2,2,2,7,2,4,1,6,10,1,2,3,0,12
2182,791107,27,7,13,7,11,0,2,0,0,4,6,0,5,1,2,0,14
2182,791106,28,1,5,1,2,0,3,0,1,1,3,2,2,0,1,0,2
2182,775538,40,2,2,2,2,0,0,2,2,3,6,1,3,0,2,0,6
2182,785603,41,5,16,4,8,1,8,5,6,3,1,1,3,2,3,0,16
2182,776425,39,6,16,3,9,3,7,1,3,0,4,2,2,0,3,1,16
2182,775820,16,3,4,0,0,3,4,0,0,1,1,1,4,1,0,0,9
2182,791110,32,2,7,2,5,0,2,3,5,0,0,1,4,1,1,0,7
2182,786494,2,0,0,0,0,0,0,0,0,0,0,0,0,0,0,0,0
2183,792140,37,4,6,4,6,0,0,3,4,4,5,1,5,0,4,0,11
2183,792144,40,4,6,2,3,2,3,1,4,0,5,1,3,2,0,1,11
2183,792148,26,3,4,3,3,0,1,2,4,0,1,3,2,1,2,0,8
2183,781429,40,3,10,0,2,3,8,4,6,0,3,0,2,0,1,0,13
2183,776092,37,5,9,5,7,0,2,4,8,0,4,4,2,2,2,0,14
2183,792146,6,1,3,1,3,0,0,0,0,0,0,0,1,0,0,0,2
2183,786596,34,4,11,4,7,0,4,9,9,1,6,3,2,0,4,0,17
2183,797793,4,0,0,0,0,0,0,0,0,0,0,0,1,0,0,0,0
2183,797786,1,0,0,0,0,0,0,0,0,0,0,0,0,0,1,0,0
2184,781464,23,1,4,1,3,0,1,2,2,0,1,1,3,1,2,0,4
2184,780259,22,2,7,1,5,1,2,4,5,3,5,3,1,2,0,1,9
2184,785282,21,4,9,2,3,2,6,1,2,0,2,1,0,1,3,0,11
2184,781502,23,3,4,3,4,0,0,0,0,0,5,5,1,0,1,0,6
2184,792277,14,2,5,2,5,0,0,1,5,6,2,0,1,0,1,0,5
2184,781501,24,3,4,3,4,0,0,1,2,3,0,3,1,2,4,1,7
2184,785913,20,5,8,5,8,0,0,0,0,1,7,0,3,0,1,1,10
2184,786516,23,7,14,2,4,5,10,0,0,0,3,1,1,1,1,0,19
2184,798058,20,1,4,0,3,1,1,4,4,0,4,5,1,2,0,1,7
2184,792274,5,0,0,0,0,0,0,0,0,1,1,1,1,0,0,0,0
2184,798051,3,2,2,2,2,0,0,0,0,0,2,0,0,0,2,0,4
2184,798056,2,0,0,0,0,0,0,0,0,0,0,0,0,1,1,0,0
2185,781112,18,0,3,0,2,0,1,0,0,0,1,3,1,1,1,0,0
2185,791926,22,2,10,0,0,2,10,0,0,0,2,1,1,2,0,0,6
2185,791923,19,5,9,5,9,0,0,2,3,2,2,0,4,0,5,1,12
2185,781122,5,0,0,0,0,0,0,0,0,0,0,0,1,0,0,0,0
2185,791925,21,4,12,3,6,1,6,0,1,0,1,3,3,2,2,1,9
2185,786527,17,1,3,1,1,0,2,0,0,2,2,1,0,0,0,0,2
2185,786858,13,1,4,1,4,0,0,0,0,1,0,1,1,2,1,0,2
2185,797541,16,2,6,2,6,0,0,0,0,3,3,1,2,2,4,0,4
2185,778952,9,0,0,0,0,0,0,0,0,0,1,1,1,0,1,0,0
2185,791927,10,1,2,1,2,0,0,1,2,0,0,0,1,1,1,0,3
2185,791922,14,0,2,0,0,0,2,0,0,1,4,1,0,0,0,0,0
2185,786529,16,0,2,0,2,0,0,1,3,1,4,0,1,0,2,1,1
2185,797542,18,5,9,1,1,4,8,2,2,0,1,1,1,0,2,0,16
2185,797543,2,0,1,0,1,0,0,0,0,0,0,0,0,0,0,0,0
2186,797574,20,1,6,0,2,1,4,0,0,2,1,0,1,0,0,2,3
2186,797575,28,5,7,5,7,0,0,1,1,4,4,1,0,0,0,1,11
2186,797571,22,2,3,2,2,0,1,2,2,0,3,2,2,1,3,0,6
2186,791899,34,7,14,7,13,0,1,1,1,3,9,4,2,2,1,0,15
2186,786512,36,4,15,3,8,1,7,3,4,2,3,1,2,1,1,1,12
2186,797573,12,1,2,1,2,0,0,2,2,1,1,0,1,0,1,0,4
2186,791900,3,0,0,0,0,0,0,0,0,0,0,0,0,0,0,0,0
2186,786435,16,0,3,0,3,0,0,0,2,1,0,4,1,1,1,0,0
2186,786032,29,5,10,4,7,1,3,2,2,0,5,1,1,2,1,0,13
2187,792704,14,1,5,1,3,0,2,0,0,0,0,1,3,0,0,0,2
2187,792702,33,2,5,1,2,1,3,0,0,1,2,2,4,1,3,0,5
2187,791427,36,3,6,3,5,0,1,2,2,1,7,3,2,0,3,0,8
2187,796772,40,4,10,3,6,1,4,1,2,0,3,4,0,1,4,0,10
2187,792698,38,8,16,3,6,5,10,2,2,0,5,0,3,1,2,0,23
2187,796774,12,0,2,0,1,0,1,0,0,0,2,0,1,0,0,1,0
2187,796775,6,0,1,0,1,0,0,0,0,0,2,1,1,0,1,0,0
2187,792699,21,2,5,1,2,1,3,1,2,2,0,0,1,1,1,0,6
2188,781462,33,9,17,9,17,0,0,6,8,2,5,0,2,1,2,0,24
2188,780876,28,2,4,2,3,0,1,2,4,2,4,2,2,0,2,1,6
2188,785353,37,6,11,4,7,2,4,1,2,0,4,8,1,1,3,1,15
2188,781673,36,5,11,2,4,3,7,0,0,3,5,3,2,0,0,0,13
2188,781457,31,3,10,0,2,3,8,2,2,0,2,4,1,2,1,0,11
2188,796365,6,1,2,1,2,0,0,0,0,2,2,0,4,0,1,0,2
2188,785355,23,1,2,0,0,1,2,0,0,1,3,0,0,0,0,1,3
2188,790895,5,0,0,0,0,0,0,0,0,0,0,1,0,0,0,0,0
2188,791305,1,0,0,0,0,0,0,0,0,0,0,0,0,0,0,0,0
2189,781656,11,0,3,0,3,0,0,0,0,0,2,0,2,1,1,0,0
2189,781658,32,2,5,2,5,0,0,1,2,1,6,1,3,1,0,0,5
2189,796962,30,5,7,3,4,2,3,0,0,0,0,1,0,1,1,0,12
2189,786798,39,7,13,7,12,0,1,3,4,0,6,3,1,0,0,0,17
2189,780129,29,2,7,1,3,1,4,3,5,1,1,2,0,0,1,0,8
2189,791263,18,4,8,4,8,0,0,2,2,3,1,0,0,1,2,0,10
2189,796967,18,2,6,0,1,2,5,0,0,0,1,1,1,0,2,0,6
2189,791264,5,0,0,0,0,0,0,0,0,0,0,0,3,0,1,0,0
2189,798206,18,2,6,0,2,2,4,0,0,0,3,1,3,0,0,0,6
2190,791493,19,2,2,2,2,0,0,1,2,2,4,1,0,1,1,2,5
2190,789036,17,1,4,1,4,0,0,1,2,2,4,2,1,0,2,0,3
2190,791495,13,2,4,1,1,1,3,0,0,0,3,0,0,0,0,0,5
2190,786324,27,7,13,4,6,3,7,0,2,0,4,10,2,5,0,0,17
2190,776494,15,3,7,3,5,0,2,0,0,1,1,0,1,0,0,0,6
2190,781307,16,3,3,3,3,0,0,1,2,1,1,1,0,0,1,1,7
2190,780504,16,3,3,3,3,0,0,0,0,2,2,0,1,0,0,0,6
2190,797192,11,3,3,3,3,0,0,1,3,0,1,0,1,0,0,0,7
2190,797191,9,0,1,0,1,0,0,0,0,0,0,1,2,0,1,0,0
2190,791490,2,0,0,0,0,0,0,0,0,0,0,0,2,0,1,0,0
2190,791492,10,2,6,2,2,0,4,0,0,0,0,0,0,0,0,1,4
2190,791494,23,3,11,3,7,0,4,0,0,1,4,5,0,0,2,1,6
2190,778888,20,4,5,1,2,3,3,1,2,0,3,0,1,0,0,0,12
2190,786325,2,0,0,0,0,0,0,0,0,0,0,0,0,0,0,0,0
2192,791975,21,4,5,4,5,0,0,4,5,3,2,1,2,1,1,1,12
2192,785972,33,2,6,1,4,1,2,4,4,1,0,1,1,0,2,0,9
2192,785967,28,7,10,7,10,0,0,4,8,6,6,2,3,0,3,0,18
2192,791977,23,1,7,1,4,0,3,0,0,0,0,0,0,0,0,0,2
2192,791978,38,5,14,3,9,2,5,6,8,0,6,2,2,3,3,0,18
2192,780160,28,0,2,0,2,0,0,1,6,2,5,4,2,3,0,0,1
2192,797799,3,0,0,0,0,0,0,0,0,0,1,0,0,0,1,0,0
2192,785973,2,0,1,0,1,0,0,0,0,0,0,0,1,0,0,0,0
2192,791976,21,2,7,2,5,0,2,6,6,2,1,1,0,1,3,0,10
2192,791980,3,0,3,0,1,0,2,0,0,0,0,0,0,0,0,0,0
2193,781480,27,4,8,4,4,0,4,0,1,0,2,0,5,0,5,0,8
2193,774846,27,3,6,3,6,0,0,1,2,2,5,3,3,2,1,1,7
2193,797182,9,1,2,1,2,0,0,0,0,0,1,0,3,1,1,0,2
2193,786558,40,9,17,7,12,2,5,5,5,0,4,4,3,1,0,0,25
2193,766611,37,4,8,1,3,3,5,0,0,1,4,1,4,3,3,0,11
2193,797183,6,0,0,0,0,0,0,0,0,0,1,0,3,0,2,0,0
2193,797181,16,0,2,0,1,0,1,0,0,0,2,3,1,0,4,0,0
2193,797272,25,3,7,1,2,2,5,0,1,1,2,0,3,2,3,0,8
2193,786185,13,2,2,2,2,0,0,0,0,2,3,0,3,0,0,1,4
2193,791377,0,0,1,0,0,0,1,0,0,0,0,0,1,0,0,0,0
2194,797831,35,4,9,2,3,2,6,0,0,1,6,2,0,0,0,0,10
2194,797823,34,5,9,3,4,2,5,7,8,4,11,1,4,0,3,2,19
2194,792286,20,3,6,3,6,0,0,0,0,2,5,0,3,1,1,2,6
2194,792284,33,3,7,2,3,1,4,5,6,0,3,3,1,2,1,0,12
2194,792280,35,7,16,5,12,2,4,5,7,0,6,3,2,2,1,0,21
2194,799468,20,3,4,3,3,0,1,0,0,0,2,1,3,0,2,0,6
2194,797826,8,1,3,1,3,0,0,0,0,0,1,0,2,0,1,0,2
2194,797829,7,1,2,1,2,0,0,2,3,2,0,0,5,0,2,0,4
2194,785950,5,1,1,1,1,0,0,0,0,0,1,0,2,0,0,0,2
2194,792287,3,0,0,0,0,0,0,0,0,0,2,0,0,0,1,0,0
2195,791653,23,1,6,1,4,0,2,0,0,1,2,0,1,0,1,0,2
2195,791652,23,1,6,1,6,0,0,6,8,2,4,5,4,1,0,2,8
2195,797285,28,1,4,0,1,1,3,0,0,0,2,0,1,0,0,1,3
2195,791650,21,3,8,2,6,1,2,5,6,0,3,1,0,0,1,0,12
2195,776384,20,2,6,1,5,1,1,1,3,0,0,1,3,0,2,0,6
2195,786495,12,0,2,0,1,0,1,1,2,1,1,1,4,0,1,0,1
2195,797283,16,1,4,0,0,1,4,0,0,0,1,1,0,0,1,0,3
2195,797289,21,2,5,2,4,0,1,0,1,0,2,1,4,0,0,0,4
2195,797286,17,3,11,1,4,2,7,3,4,0,2,0,1,0,2,0,11
2195,791654,9,0,0,0,0,0,0,2,2,0,0,0,0,0,1,0,2
2195,791651,10,1,4,1,2,0,2,0,0,1,1,1,1,1,1,0,2
2196,781579,32,6,11,6,10,0,1,0,1,4,7,2,1,2,0,0,12
2196,786731,24,2,5,2,5,0,0,2,2,2,5,3,4,1,5,1,6
2196,798023,32,6,13,6,12,0,1,0,0,1,3,4,1,2,1,1,12
2196,781584,33,3,7,2,5,1,2,0,0,1,1,0,0,1,1,0,7
2196,780347,33,7,20,5,17,2,3,3,4,1,0,2,1,2,1,0,19
2196,775696,6,0,1,0,1,0,0,0,0,1,3,1,0,0,0,0,0
2196,798026,5,1,1,1,1,0,0,1,4,1,0,0,0,0,0,0,3
2196,776481,11,1,2,1,2,0,0,0,0,2,3,0,2,1,1,0,2
2196,798017,5,0,0,0,0,0,0,0,0,0,1,0,0,0,0,0,0
2196,798008,10,0,1,0,1,0,0,2,2,1,1,0,0,0,0,0,2
2196,792358,9,0,1,0,0,0,1,0,0,0,0,1,1,0,0,0,0
2197,786509,28,5,9,5,9,0,0,1,1,1,2,1,2,0,3,0,11
2197,786508,38,4,10,2,4,2,6,0,0,0,6,1,3,0,4,1,10
2197,786507,17,2,4,1,1,1,3,0,0,0,3,0,0,0,0,0,5
2197,785796,31,4,10,4,7,0,3,5,8,0,6,0,3,1,5,2,13
2197,797576,37,0,6,0,1,0,5,0,0,0,1,3,2,2,1,0,0
2197,797577,11,0,2,0,2,0,0,0,0,2,0,1,1,0,1,0,0
2197,797580,9,1,1,1,1,0,0,0,0,1,0,0,2,0,1,0,2
2197,791897,10,1,2,0,0,1,2,0,0,1,2,0,2,0,1,0,3
2197,786505,19,2,4,0,0,2,4,0,0,0,1,2,0,0,0,0,6
2198,790784,14,5,6,3,4,2,2,0,0,1,1,0,2,1,3,0,12
2198,786548,8,0,4,0,4,0,0,0,0,1,0,0,5,0,0,0,0
2198,791871,9,0,1,0,0,0,1,1,2,0,1,2,0,0,2,0,1
2198,786719,26,2,8,2,5,0,3,1,2,1,4,3,2,1,1,0,5
2198,775229,25,7,13,5,8,2,5,0,1,2,3,0,4,2,1,0,16
2198,786583,6,0,0,0,0,0,0,1,2,2,0,0,1,0,0,0,1
2198,776219,21,2,6,1,1,1,5,3,4,1,5,2,3,3,2,0,8
2198,786235,14,0,0,0,0,0,0,0,0,0,3,0,3,0,1,0,0
2198,797477,3,1,1,1,1,0,0,4,4,0,1,0,0,0,0,0,6
2198,797476,4,0,2,0,2,0,0,0,0,0,0,0,0,0,0,0,0
2198,797475,18,2,10,0,5,2,5,2,2,0,1,1,1,1,1,0,8
2198,786581,11,0,1,0,0,0,1,2,3,0,0,0,0,0,0,0,2
2198,786770,16,0,6,0,2,0,4,0,0,0,2,3,1,1,5,0,0
2198,786229,10,1,3,1,1,0,2,3,4,0,0,0,1,0,0,0,5
2198,781518,15,1,3,1,2,0,1,0,0,3,2,0,0,1,2,0,2
2199,783072,20,5,7,4,6,1,1,3,4,3,6,1,2,1,1,0,14
2199,781463,26,2,5,1,2,1,3,2,4,1,7,1,1,0,3,1,7
2199,791540,27,3,8,2,6,1,2,4,4,0,0,4,2,1,2,0,11
2199,787782,29,9,17,6,12,3,5,3,4,1,3,2,2,0,3,1,24
2199,776068,25,5,10,4,8,1,2,7,8,0,5,4,3,2,3,0,18
2199,797817,16,3,4,2,3,1,1,0,0,1,0,0,0,2,1,0,7
2199,785647,4,0,1,0,1,0,0,2,2,0,0,0,0,0,1,1,2
2199,785962,4,1,1,1,1,0,0,0,0,2,0,1,2,0,1,0,2
2199,774879,16,2,2,1,1,1,1,0,0,1,4,0,2,1,1,0,5
2199,797818,1,0,1,0,0,0,1,0,0,0,1,0,0,0,0,0,0
2199,793057,4,0,4,0,3,0,1,0,0,0,0,1,3,1,0,0,0
2199,792153,22,0,3,0,2,0,1,1,2,0,4,4,1,2,0,0,1
2199,781202,6,1,1,0,0,1,1,0,0,0,1,0,0,1,1,0,3
2212,791401,36,7,9,7,9,0,0,7,10,0,8,1,2,1,4,5,21
2212,780125,32,4,8,4,6,0,2,2,3,1,6,3,1,0,3,1,10
2212,791400,36,7,12,2,5,5,7,1,2,0,2,3,3,2,5,1,20
2212,785931,19,1,3,1,2,0,1,1,2,0,0,3,4,1,0,0,3
2212,780118,36,5,10,4,5,1,5,0,3,1,7,4,3,1,1,1,11
2212,786837,13,1,3,0,2,1,1,0,0,0,1,0,1,0,1,0,3
2212,797125,26,0,2,0,2,0,0,0,0,1,1,5,3,1,0,0,0
2212,797130,2,0,0,0,0,0,0,0,0,0,0,0,0,0,0,0,0
2213,785498,32,5,16,5,16,0,0,0,0,4,4,1,3,0,1,0,10
2213,776469,27,1,8,1,8,0,0,2,4,3,7,3,3,0,4,2,4
2213,796705,27,3,8,3,5,0,3,0,0,0,2,3,3,1,0,0,6
2213,796708,37,3,6,1,2,2,4,2,5,1,2,2,1,0,4,2,10
2213,776322,36,6,12,0,3,6,9,2,2,0,4,2,3,0,0,0,20
2213,796706,20,0,1,0,0,0,1,0,0,0,2,0,2,0,2,0,0
2213,796709,21,4,5,3,3,1,2,1,3,1,3,0,4,1,3,1,10
2214,796699,19,4,6,4,5,0,1,2,2,0,2,0,1,1,1,2,10
2214,790983,16,5,6,4,4,1,2,0,0,0,6,2,3,2,3,0,11
2214,790978,19,2,6,0,2,2,4,0,0,0,1,0,1,0,1,0,6
2214,790979,25,4,7,3,3,1,4,5,5,0,3,4,3,0,7,1,14
2214,796700,22,1,4,0,3,1,1,0,0,0,4,8,1,0,1,0,3
2214,796698,14,4,5,4,4,0,1,0,1,4,2,0,3,3,2,0,8
2214,796701,21,2,2,2,2,0,0,4,6,0,1,0,0,1,0,0,8
2214,790976,12,2,3,2,3,0,0,1,2,0,1,0,1,0,0,1,5
2214,788820,22,1,3,1,1,0,2,2,3,1,2,1,0,1,0,0,4
2214,790980,9,0,0,0,0,0,0,0,1,0,1,1,2,0,0,1,0
2214,790981,7,1,1,1,1,0,0,0,0,0,2,2,3,0,1,0,2
2214,790977,6,1,3,0,0,1,3,0,0,0,0,0,0,0,0,0,3
2214,792693,3,1,2,0,0,1,2,0,0,1,0,0,0,0,0,0,3
2214,789458,2,0,0,0,0,0,0,0,0,0,1,1,0,0,0,0,0
2214,789457,3,0,1,0,1,0,0,0,0,0,0,0,1,1,1,0,0
2215,792265,30,5,11,3,7,2,4,1,2,1,2,0,1,2,3,0,13
2215,792266,24,1,2,1,2,0,0,2,2,0,1,0,4,0,0,0,4
2215,786152,32,0,7,0,5,0,2,4,5,3,3,0,3,0,3,0,4
2215,798003,24,2,6,2,6,0,0,1,1,0,2,5,3,3,2,0,5
2215,798006,17,2,5,1,2,1,3,0,0,0,0,0,4,0,2,0,5
2215,798007,10,1,2,1,2,0,0,0,0,0,1,0,2,0,0,0,2
2215,798009,24,2,7,2,3,0,4,0,3,0,0,0,1,1,3,0,4
2215,792267,14,0,1,0,0,0,1,0,0,0,1,1,1,1,2,0,0
2215,797998,14,0,4,0,3,0,1,0,3,0,1,1,2,0,0,0,0
2215,798002,8,2,2,2,2,0,0,0,0,1,2,1,1,0,1,1,4
2215,797999,1,0,0,0,0,0,0,0,0,0,0,0,0,0,1,0,0
2215,797997,2,0,0,0,0,0,0,0,0,0,0,0,0,0,0,0,0
2216,791510,19,2,5,2,3,0,2,4,4,2,4,1,4,0,2,0,8
2216,797168,31,5,10,5,9,0,1,8,10,0,7,2,3,2,1,0,18
2216,797174,26,2,8,2,4,0,4,4,4,1,1,0,4,0,2,0,8
2216,786699,24,3,7,3,7,0,0,0,0,0,3,0,3,0,0,1,6
2216,775357,31,4,11,3,9,1,2,4,4,0,3,3,3,0,1,0,13
2216,791507,13,9,11,9,11,0,0,2,5,1,2,1,5,0,1,0,20
2216,791509,3,1,1,1,1,0,0,0,0,1,0,1,1,0,0,0,2
2216,791504,6,0,0,0,0,0,0,0,0,0,0,0,2,0,1,0,0
2216,791505,4,0,0,0,0,0,0,0,0,0,0,0,1,0,0,0,0
2216,791508,6,0,0,0,0,0,0,0,0,0,0,0,0,0,0,0,0
2216,785593,29,6,10,6,8,0,2,2,2,0,3,1,2,2,1,0,14
2216,791506,8,0,0,0,0,0,0,0,0,0,0,0,1,0,0,0,0
2217,781445,36,6,16,2,4,4,12,3,4,1,1,1,3,0,2,0,19
2217,768845,26,3,6,3,3,0,3,5,7,0,5,3,4,0,3,0,11
2217,792253,14,2,4,2,4,0,0,5,6,2,2,0,5,0,2,0,9
2217,781430,29,6,15,3,7,3,8,11,12,2,8,1,5,1,2,0,26
2217,792248,39,5,11,1,3,4,8,2,3,1,1,2,2,0,1,2,16
2217,792249,13,1,1,1,1,0,0,0,0,1,1,2,4,0,2,0,2
2217,797941,12,0,0,0,0,0,0,2,2,1,1,2,3,1,0,0,2
2217,786076,14,2,2,2,2,0,0,2,2,0,0,2,1,0,3,0,6
2217,797957,17,0,0,0,0,0,0,0,2,1,3,0,0,0,0,0,0
2217,781448,0,0,0,0,0,0,0,0,0,0,0,0,0,0,0,0,0
2218,785589,36,5,12,5,12,0,0,3,4,1,4,2,3,0,1,0,13
2218,791209,11,0,1,0,1,0,0,0,0,1,3,0,0,0,1,1,0
2218,791215,25,2,4,2,2,0,2,2,2,0,0,7,4,1,5,0,6
2218,791214,36,5,10,1,4,4,6,0,0,0,6,5,3,0,2,0,14
2218,776364,24,2,7,2,3,0,4,2,2,0,0,2,1,1,0,0,6
2218,791216,24,7,13,6,10,1,3,3,5,1,3,0,4,0,3,0,18
2218,776313,30,5,9,4,6,1,3,5,6,3,4,1,2,5,0,0,16
2218,791207,3,0,0,0,0,0,0,0,0,0,0,0,0,1,1,0,0
2218,796917,7,0,1,0,1,0,0,0,0,0,0,0,1,0,0,0,0
2218,791210,4,0,2,0,2,0,0,0,0,1,1,0,1,0,1,0,0
2219,797241,25,5,8,5,8,0,0,0,0,4,0,0,4,0,0,0,10
2219,791366,25,2,6,1,3,1,3,0,0,2,4,1,3,0,2,0,5
2219,797244,25,1,5,1,2,0,3,5,6,0,2,2,1,2,3,0,7
2219,785742,22,2,4,1,1,1,3,2,4,0,2,1,1,0,1,0,7
2219,780163,35,6,14,5,8,1,6,6,9,0,6,3,1,0,3,1,19
2219,797243,19,2,3,1,1,1,2,0,0,3,5,1,0,0,4,0,5
2219,786155,7,0,0,0,0,0,0,0,0,1,0,0,2,0,2,0,0
2219,791361,4,0,3,0,0,0,3,0,0,0,1,1,0,0,2,0,0
2219,786340,21,3,7,0,0,3,7,0,2,1,0,1,2,1,0,0,9
2219,791363,9,0,1,0,0,0,1,2,2,1,1,0,5,0,2,0,2
2219,780170,4,0,1,0,1,0,0,0,0,1,0,0,0,0,0,0,0
2219,797242,4,0,1,0,1,0,0,0,0,0,0,0,0,0,0,0,0
2220,792340,17,10,11,10,11,0,0,4,4,3,5,1,1,2,0,0,24
2220,798086,20,3,6,3,4,0,2,2,3,0,1,3,5,0,2,1,8
2220,792344,33,1,4,0,1,1,3,0,0,1,3,11,3,2,2,1,3
2220,792341,33,8,13,6,11,2,2,0,2,2,10,3,1,1,1,0,18
2220,792342,20,4,6,1,1,3,5,0,0,0,2,4,1,2,3,1,11
2220,798080,21,4,6,2,4,2,2,2,2,1,3,2,1,1,2,0,12
2220,798087,8,1,5,1,5,0,0,0,2,2,1,1,1,0,1,0,2
2220,798088,23,4,6,3,3,1,3,0,0,0,3,3,2,0,1,1,9
2220,798091,25,4,7,3,4,1,3,2,2,1,3,3,4,2,1,0,11
2222,796491,12,1,2,1,1,0,1,0,0,1,1,0,0,0,0,0,2
2222,790935,21,2,4,2,3,0,1,0,0,0,0,0,1,0,0,0,4
2222,790937,10,0,2,0,2,0,0,1,2,1,2,0,3,0,1,0,1
2222,775340,35,9,19,7,13,2,6,14,15,0,3,10,2,1,1,0,34
2222,774826,29,4,9,3,5,1,4,1,1,0,2,1,0,1,0,1,10
2222,796190,12,3,3,3,3,0,0,0,0,1,1,0,3,1,1,0,6
2222,792442,30,11,14,11,14,0,0,0,0,8,13,0,4,2,3,3,22
2222,785445,16,2,5,2,3,0,2,0,1,4,1,1,3,1,0,0,4
2222,796492,12,1,5,1,4,0,1,1,2,0,0,1,0,0,0,1,3
2222,780933,23,2,11,1,4,1,7,2,2,0,2,0,2,0,1,0,7
2224,797139,23,5,10,5,10,0,0,1,3,2,5,4,3,3,2,1,11
2224,775394,25,3,5,2,4,1,1,5,7,4,4,3,1,0,1,0,12
2224,791526,20,3,7,2,3,1,4,2,2,0,3,2,3,0,3,0,9
2224,780272,26,6,12,5,9,1,3,1,3,2,1,6,2,0,2,0,14
2224,775592,30,3,12,1,6,2,6,2,2,0,4,0,1,1,1,0,10
2224,791524,25,5,9,4,5,1,4,2,3,1,5,1,0,0,1,2,13
2224,785970,13,3,3,3,3,0,0,0,0,0,6,1,3,1,0,2,6
2224,797141,4,1,2,1,2,0,0,0,0,0,0,0,1,0,1,0,2
2224,791525,2,0,0,0,0,0,0,0,0,0,0,0,1,0,0,0,0
2224,797137,5,2,2,2,2,0,0,0,0,1,0,0,1,0,1,1,4
2224,780273,27,2,8,1,5,1,3,0,0,1,1,1,1,1,0,0,5
2225,780201,31,1,8,1,8,0,0,0,0,0,6,2,0,1,2,0,2
2225,797208,27,4,8,4,8,0,0,1,1,0,3,0,2,0,4,0,9
2225,791467,28,1,7,1,2,0,5,6,6,1,3,0,2,1,3,1,8
2225,786311,25,4,12,2,3,2,9,2,2,1,2,0,2,1,0,0,12
2225,775516,15,0,4,0,2,0,2,0,0,0,4,0,1,0,1,0,0
2225,798344,13,2,5,2,3,0,2,1,2,0,1,0,3,0,1,0,5
2225,797209,4,0,1,0,0,0,1,1,2,0,1,0,0,0,0,0,1
2225,791470,13,3,5,3,4,0,1,0,2,1,4,1,1,0,0,0,6
2225,791469,15,2,3,2,3,0,0,0,0,2,0,0,3,1,0,3,4
2225,797210,29,3,8,3,7,0,1,4,4,0,2,4,2,1,0,0,10
2226,796633,14,3,4,3,4,0,0,0,0,1,2,0,1,1,1,0,6
2226,790998,35,2,4,2,2,0,2,3,6,0,3,1,1,1,1,0,7
2226,790997,18,2,5,0,0,2,5,0,1,0,2,1,4,1,2,1,6
2226,790995,19,1,6,1,3,0,3,0,0,1,0,2,0,0,1,0,2
2226,786375,24,3,8,3,7,0,1,2,2,3,6,1,1,1,5,1,8
2226,796631,15,2,4,0,1,2,3,0,0,0,1,0,2,0,2,2,6
2226,790999,5,0,1,0,1,0,0,0,0,0,0,0,1,1,0,0,0
2226,790992,7,2,3,2,3,0,0,0,0,0,2,0,0,0,0,0,4
2226,796632,13,1,3,1,1,0,2,2,2,0,1,1,1,0,1,1,4
2226,790996,23,2,9,2,8,0,1,0,0,1,0,1,3,1,3,0,4
2226,785621,20,4,8,0,3,4,5,0,0,0,0,2,1,0,1,0,12
2226,785313,2,0,0,0,0,0,0,0,2,1,0,0,0,0,0,0,0
2226,781520,5,0,1,0,1,0,0,0,0,0,3,0,0,0,1,0,0
2227,780049,24,5,10,5,10,0,0,2,2,3,2,1,0,1,4,0,12
2227,785674,30,4,8,1,3,3,5,4,4,0,6,1,1,0,1,0,15
2227,780527,16,3,5,3,5,0,0,0,0,2,3,3,3,0,0,0,6
2227,797784,28,4,11,3,8,1,3,0,0,3,3,1,2,0,4,0,9
2227,789059,31,5,7,4,6,1,1,4,5,0,4,1,1,3,2,1,15
2227,797782,8,1,4,1,4,0,0,0,0,1,1,0,3,1,1,0,2
2227,797783,14,2,4,2,4,0,0,0,0,1,4,0,2,1,0,0,4
2227,792171,20,2,4,2,4,0,0,1,4,1,0,2,2,2,4,3,5
2227,797785,1,0,0,0,0,0,0,0,0,0,0,0,0,0,1,0,0
2227,792175,1,0,0,0,0,0,0,0,0,0,0,0,1,0,0,0,0
2227,792173,12,1,2,1,1,0,1,0,1,0,2,0,0,0,0,0,2
2227,780980,13,1,1,1,1,0,0,1,2,0,1,5,0,1,0,0,3
2227,786658,1,0,0,0,0,0,0,0,0,0,0,0,0,0,0,0,0
2227,792174,1,0,0,0,0,0,0,0,0,0,0,0,0,0,0,0,0
2228,797558,23,3,9,3,5,0,4,2,3,2,4,3,3,0,1,2,8
2228,786519,32,3,8,3,7,0,1,0,0,4,6,0,2,1,2,0,6
2228,797556,31,7,9,4,4,3,5,1,3,2,3,3,2,1,3,2,18
2228,791913,35,3,6,1,3,2,3,4,4,0,3,2,3,0,0,0,12
2228,786520,35,5,8,5,5,0,3,1,2,1,3,4,3,2,3,0,11
2228,791911,21,6,7,0,0,6,7,0,0,0,1,2,1,0,0,0,18
2228,797557,1,0,1,0,0,0,1,0,0,0,0,0,0,0,0,0,0
2228,797555,11,2,5,2,3,0,2,0,2,2,1,1,0,0,3,1,4
2228,781105,5,0,1,0,0,0,1,0,0,0,0,0,1,0,0,0,0
2228,781076,5,1,1,1,1,0,0,0,0,0,0,0,1,0,0,0,2
2228,797560,1,0,0,0,0,0,0,0,0,0,0,0,0,0,0,0,0
2229,780686,28,5,12,5,11,0,1,2,2,6,3,1,1,0,2,0,12
2229,780683,23,3,8,3,6,0,2,9,10,4,5,0,2,1,1,0,15
2229,797681,30,1,8,1,5,0,3,4,4,0,2,0,3,0,3,0,6
2229,786112,29,4,12,3,8,1,4,2,2,0,1,4,5,3,0,0,11
2229,780688,29,0,3,0,1,0,2,2,4,3,1,2,2,0,1,0,2
2229,797683,6,0,1,0,0,0,1,0,0,0,2,1,1,0,2,0,0
2229,797682,5,0,1,0,1,0,0,0,0,0,1,0,0,1,0,0,0
2229,797679,14,1,4,0,2,1,2,0,0,0,2,1,1,0,0,0,3
2229,791941,17,2,5,2,3,0,2,0,2,1,0,0,0,0,0,0,4
2229,780689,17,5,6,4,5,1,1,0,0,1,0,0,1,1,0,0,11
2229,791942,2,0,0,0,0,0,0,0,0,0,0,0,0,0,0,0,0
2230,786033,15,0,1,0,1,0,0,2,2,0,1,0,2,0,0,1,2
2230,786031,22,2,9,2,7,0,2,0,1,4,6,0,1,0,0,0,4
2230,797734,27,4,8,2,4,2,4,0,2,1,2,1,0,1,5,0,10
2230,786036,18,0,7,0,2,0,5,0,0,0,1,0,0,1,4,0,0
2230,781386,36,5,7,4,5,1,2,2,2,1,2,3,4,4,1,0,13
2230,792110,25,1,3,1,2,0,1,2,2,2,3,0,4,2,1,0,4
2230,797733,13,0,5,0,2,0,3,2,4,0,1,0,0,0,1,0,2
2230,792109,11,1,3,1,2,0,1,2,2,1,0,1,0,0,1,0,4
2230,792105,6,1,4,0,0,1,4,0,0,0,0,0,1,0,0,0,3
2230,797735,23,2,8,1,3,1,5,2,2,0,4,1,0,0,1,0,7
2230,792107,2,0,0,0,0,0,0,0,0,0,0,0,0,0,0,0,0
2230,789100,2,0,0,0,0,0,0,0,0,0,0,0,0,0,0,0,0
2231,791337,18,1,2,1,2,0,0,2,2,2,2,1,2,2,1,0,4
2231,797877,33,7,13,7,12,0,1,0,1,2,5,3,2,2,1,1,14
2231,797872,30,5,9,5,7,0,2,0,0,1,6,3,2,2,3,0,10
2231,791338,16,1,6,1,4,0,2,0,0,0,2,1,2,1,2,0,2
2231,791339,30,6,10,5,6,1,4,1,1,1,2,4,2,2,5,0,14
2231,797873,2,1,1,1,1,0,0,1,2,0,0,0,2,0,0,1,3
2231,791335,7,1,2,0,1,1,1,0,0,1,1,0,2,0,1,0,3
2231,781599,20,1,4,1,3,0,1,2,2,3,4,1,1,0,3,4,4
2231,797875,17,1,3,0,1,1,2,2,3,1,5,2,3,0,2,0,5
2231,797874,24,4,6,0,1,4,5,0,0,0,3,2,2,0,0,0,12
2231,785882,1,0,0,0,0,0,0,0,0,0,1,0,0,0,0,0,0
2231,792446,2,0,0,0,0,0,0,0,0,0,0,0,0,0,0,0,0
2232,791258,32,3,8,0,3,3,5,0,0,0,3,1,2,0,2,0,9
2232,781272,29,7,9,5,6,2,3,0,0,0,2,2,3,1,6,2,16
2232,781270,34,8,18,6,14,2,4,0,0,0,3,1,4,3,3,0,18
2232,796960,17,2,5,2,5,0,0,3,3,1,1,0,4,0,2,0,7
2232,785501,29,1,10,0,3,1,7,1,2,0,4,2,1,3,2,1,4
2232,796958,27,3,4,3,3,0,1,1,2,2,3,1,2,1,2,0,7
2232,796959,17,1,1,1,1,0,0,1,2,2,1,0,1,0,0,1,3
2232,785502,3,0,0,0,0,0,0,0,0,0,0,0,0,0,0,0,0
2232,785503,3,0,1,0,1,0,0,0,0,0,0,0,1,0,0,0,0
2232,791260,7,2,2,2,2,0,0,0,0,1,0,0,2,0,0,0,4
2232,799825,2,0,1,0,0,0,1,0,0,0,0,0,0,0,0,0,0
2233,785628,32,12,16,7,9,5,7,2,2,1,1,1,3,0,1,0,31
2233,791202,23,2,5,1,2,1,3,0,0,2,2,3,0,0,1,0,5
2233,791201,25,4,9,4,5,0,4,5,9,0,0,2,4,2,3,0,13
2233,785627,27,3,8,2,5,1,3,0,0,0,4,2,0,1,1,0,7
2233,775767,24,6,9,6,9,0,0,3,3,3,4,2,1,0,1,2,15
2233,796901,14,0,3,0,2,0,1,0,1,3,4,1,0,0,1,0,0
2233,789974,1,0,0,0,0,0,0,0,0,0,0,0,0,0,0,0,0
2233,781135,8,1,1,1,1,0,0,1,2,0,0,0,2,0,0,0,3
2233,796903,1,0,1,0,0,0,1,0,0,0,0,0,0,0,0,0,0
2233,785629,25,1,2,1,1,0,1,4,4,1,1,4,1,2,1,0,6
2233,788869,2,0,0,0,0,0,0,0,0,0,0,0,0,0,0,0,0
2233,796904,6,1,2,1,2,0,0,0,0,1,4,1,1,0,1,0,2
2233,781138,1,0,0,0,0,0,0,0,0,0,0,0,0,0,0,0,0
2233,796902,11,1,3,1,1,0,2,1,2,0,2,1,1,0,2,0,3
2234,786404,35,2,8,2,6,0,2,0,0,2,5,1,3,1,6,0,4
2234,780378,26,1,2,1,2,0,0,2,4,1,5,0,1,1,7,0,4
2234,786374,33,4,10,3,5,1,5,0,0,1,2,1,3,4,2,1,9
2234,786253,26,3,8,3,4,0,4,5,6,0,1,2,2,0,3,0,11
2234,785798,35,1,9,0,3,1,6,4,4,1,1,0,1,2,4,0,7
2234,797065,9,0,2,0,0,0,2,0,0,0,1,0,1,0,0,0,0
2234,797061,16,1,3,1,1,0,2,0,0,0,3,0,0,2,1,0,2
2234,791562,17,1,2,1,1,0,1,0,0,0,0,0,2,1,1,0,2
2234,780121,3,0,0,0,0,0,0,0,0,1,0,0,2,0,1,0,0
2235,780425,14,0,0,0,0,0,0,0,0,1,0,1,2,1,1,2,0
2235,797056,23,2,9,0,3,2,6,6,6,0,3,3,2,0,2,0,12
2235,797054,28,4,6,2,3,2,3,0,0,0,3,1,2,1,8,0,10
2235,791568,16,1,3,1,3,0,0,0,0,0,2,1,3,0,1,0,2
2235,786381,31,0,1,0,0,0,1,0,0,1,2,0,2,1,1,0,0
2235,797058,8,1,2,0,0,1,2,0,0,0,0,0,1,0,1,0,3
2235,791564,25,4,7,1,1,3,6,1,1,0,5,1,0,2,2,0,12
2235,775549,26,1,6,1,6,0,0,0,1,3,4,2,3,2,2,1,2
2235,797055,29,7,11,3,5,4,6,2,2,0,3,4,0,3,5,0,20
2236,788113,28,6,8,5,7,1,1,0,0,2,3,3,4,3,1,0,13
2236,776497,23,2,5,1,3,1,2,1,2,0,2,1,1,1,4,4,6
2236,785729,32,3,7,3,7,0,0,0,0,1,2,2,4,1,4,0,6
2236,785731,35,6,13,6,13,0,0,7,8,3,4,2,2,4,2,1,19
2236,785443,22,3,4,2,3,1,1,1,1,0,5,1,2,0,4,1,8
2236,792402,13,1,3,1,2,0,1,0,0,0,2,1,1,0,1,0,2
2236,792405,2,0,0,0,0,0,0,0,0,0,0,0,1,0,0,0,0
2236,786231,17,0,7,0,5,0,2,0,0,1,1,1,2,2,1,0,0
2236,780864,28,3,7,1,3,2,4,5,6,0,0,2,3,1,2,0,13
2238,785423,30,4,7,3,4,1,3,4,6,1,4,2,1,0,0,0,13
2238,786210,29,8,13,3,3,5,10,6,7,0,4,5,1,0,1,1,27
2238,786298,35,5,13,1,2,4,11,0,0,1,2,4,4,0,4,0,14
2238,785425,32,3,12,0,5,3,7,0,0,3,3,3,0,0,0,0,9
2238,785422,38,0,7,0,3,0,4,0,0,2,4,4,3,0,2,1,0
2238,774957,16,3,5,0,0,3,5,2,2,0,1,1,1,1,1,0,11
2238,775676,19,1,4,1,3,0,1,2,2,1,2,2,4,0,1,2,4
2238,796429,1,0,0,0,0,0,0,0,0,0,0,0,0,0,0,0,0
2238,796431,0,0,0,0,0,0,0,0,0,0,0,0,0,0,0,0,0
2239,790839,24,4,4,2,2,2,2,2,2,3,6,1,3,0,0,0,12
2239,785388,23,7,12,7,12,0,0,0,3,4,3,2,2,1,2,0,14
2239,790840,24,3,9,1,4,2,5,0,0,0,1,4,2,0,0,1,8
2239,785386,34,6,15,2,8,4,7,2,2,1,4,8,2,3,0,0,18
2239,780373,34,6,8,1,1,5,7,1,2,0,2,2,2,1,0,1,18
2239,780370,18,0,3,0,0,0,3,2,2,1,6,2,2,0,2,0,2
2239,796393,15,3,6,3,6,0,0,3,4,1,2,0,3,0,1,0,9
2239,796395,13,2,5,2,4,0,1,0,0,0,3,1,2,1,0,0,4
2239,796396,6,0,1,0,0,0,1,0,0,0,0,0,0,0,0,0,0
2239,790841,9,1,2,0,0,1,2,0,0,0,0,0,0,0,0,0,3
2240,792078,37,2,7,2,7,0,0,2,3,6,4,1,1,3,0,0,6
2240,786067,23,1,2,1,2,0,0,4,4,1,2,0,4,0,2,0,6
2240,797661,28,3,13,1,7,2,6,0,0,0,5,1,2,1,0,0,8
2240,785591,35,5,9,5,8,0,1,6,7,0,3,2,0,2,2,0,16
2240,780258,28,6,15,1,4,5,11,0,0,3,7,0,2,2,2,0,17
2240,797662,8,0,1,0,1,0,0,0,1,1,0,0,0,0,0,0,0
2240,792082,24,0,7,0,3,0,4,1,2,0,3,3,1,0,1,0,1
2240,797660,5,0,0,0,0,0,0,0,0,0,1,0,1,0,1,0,0
2240,792083,12,3,4,3,3,0,1,0,1,0,0,0,4,1,1,0,6
2241,797151,21,3,4,3,4,0,0,0,1,2,3,0,4,0,2,0,6
2241,791511,20,2,5,2,5,0,0,0,0,1,5,0,4,0,3,2,4
2241,778442,29,2,12,1,6,1,6,4,4,0,4,0,1,2,3,0,9
2241,791514,21,3,6,1,2,2,4,0,0,0,1,2,2,0,2,0,8
2241,786637,30,1,6,0,2,1,4,0,0,0,3,2,0,0,2,0,3
2241,791515,20,1,4,1,1,0,3,1,2,1,3,0,0,0,1,2,3
2241,797152,19,3,6,2,4,1,2,0,0,1,2,0,2,0,1,0,7
2241,797150,5,1,2,0,1,1,1,0,0,0,0,0,0,0,0,0,3
2241,780946,19,1,1,1,1,0,0,0,0,1,0,1,1,0,1,0,2
2241,791513,16,1,5,1,4,0,1,0,0,2,2,3,3,0,1,0,2
2242,785227,31,4,7,4,7,0,0,0,1,4,8,2,1,1,2,2,8
2242,786237,26,4,9,4,9,0,0,2,2,1,1,0,4,0,1,0,10
2242,786232,36,2,8,2,5,0,3,0,0,2,0,1,1,0,0,1,4
2242,780287,33,9,19,9,15,0,4,0,2,1,5,2,2,0,3,0,18
2242,776309,14,1,3,1,3,0,0,2,2,0,6,0,1,1,1,0,4
2242,792288,26,4,5,4,5,0,0,0,0,3,5,1,2,2,1,3,8
2242,798067,8,0,1,0,1,0,0,0,0,1,0,0,2,1,1,1,0
2242,798068,6,0,1,0,0,0,1,0,0,0,1,0,1,0,0,0,0
2242,792278,20,5,12,2,4,3,8,1,2,0,1,0,0,2,2,0,14
2242,798084,0,0,0,0,0,0,0,0,0,0,0,0,0,0,0,0,0
2243,780890,27,1,6,0,3,1,3,8,8,0,4,0,1,1,1,1,11
2243,775757,15,3,6,3,4,0,2,0,0,0,1,0,1,0,2,0,6
2243,791123,33,3,7,3,3,0,4,0,0,1,1,5,2,0,0,0,6
2243,786066,36,7,17,6,14,1,3,1,2,3,7,4,3,1,4,0,16
2243,785636,34,4,6,0,1,4,5,0,1,0,5,0,4,2,2,0,12
2243,791119,3,0,0,0,0,0,0,0,0,0,0,0,0,0,0,0,0
2243,786646,26,1,2,0,0,1,2,0,0,1,1,1,0,0,0,1,3
2243,785969,26,6,10,6,10,0,0,3,6,0,7,4,3,3,1,0,15
2244,791988,42,10,16,10,16,0,0,4,7,7,4,2,2,3,2,1,24
2244,792443,36,5,6,5,6,0,0,3,4,3,11,2,5,0,0,1,13
2244,796507,12,2,4,1,1,1,3,2,3,0,2,0,3,0,1,0,7
2244,791989,47,8,17,1,3,7,14,0,0,0,4,1,4,1,6,0,23
2244,791987,42,2,6,2,2,0,4,5,6,0,2,10,3,3,5,0,9
2244,796509,21,2,4,2,3,0,1,2,2,1,0,0,0,0,1,0,6
2244,785292,15,0,2,0,1,0,1,0,0,0,3,0,2,0,0,1,0
2244,780077,6,0,2,0,1,0,1,0,0,0,1,1,2,0,1,0,0
2244,796506,2,0,0,0,0,0,0,1,2,0,0,0,2,0,0,0,1
2244,796508,2,0,2,0,0,0,2,0,0,0,0,0,0,0,1,0,0
2244,796503,24,3,8,2,2,1,6,3,3,0,2,2,4,1,3,0,10
2244,785258,1,0,1,0,1,0,0,0,0,0,1,1,0,0,1,0,0
2245,787175,30,3,8,2,2,1,6,0,0,1,2,1,5,1,1,0,7
2245,782126,41,5,13,5,10,0,3,3,4,2,3,1,1,0,2,1,13
2245,790909,35,4,10,3,4,1,6,2,3,0,3,1,3,5,1,0,11
2245,781393,49,7,18,5,8,2,10,10,11,1,7,3,2,6,4,0,26
2245,775351,40,4,9,4,9,0,0,1,4,1,5,2,4,1,4,0,9
2245,796455,21,1,2,1,2,0,0,2,5,1,2,0,2,1,0,0,4
2245,790907,30,5,10,5,10,0,0,10,14,5,4,1,5,0,3,1,20
2245,796454,4,0,0,0,0,0,0,0,0,0,0,0,1,0,0,0,0
2246,780094,24,2,5,2,4,0,1,0,0,2,4,5,1,2,5,0,4
2246,775142,20,4,4,2,2,2,2,0,0,0,2,3,2,1,5,2,10
2246,790843,23,7,11,3,3,4,8,3,3,1,3,1,0,2,1,3,21
2246,786212,22,6,11,6,8,0,3,3,5,3,3,2,3,1,0,2,15
2246,781563,23,1,5,1,5,0,0,0,0,0,1,5,1,1,0,1,2
2246,790844,23,4,5,4,4,0,1,0,0,0,5,0,3,1,3,0,8
2246,796914,18,1,3,1,2,0,1,0,0,0,5,3,1,1,2,2,2
2246,792125,18,2,4,2,2,0,2,0,0,0,3,1,1,0,1,0,4
2246,790847,15,3,4,2,2,1,2,0,0,2,3,0,2,0,1,0,7
2246,796915,4,1,2,0,1,1,1,0,0,0,0,0,1,0,0,0,3
2246,781161,4,1,2,1,2,0,0,2,3,0,1,1,1,1,1,0,4
2246,785396,3,0,0,0,0,0,0,0,0,0,1,0,0,0,0,0,0
2246,796105,3,0,0,0,0,0,0,0,0,0,0,0,0,0,0,0,0
2247,797482,20,1,6,1,5,0,1,0,0,0,1,0,2,1,2,0,2
2247,797485,21,1,6,0,4,1,2,0,0,2,0,0,4,1,1,0,3
2247,797481,20,2,4,1,2,1,2,2,2,0,2,1,0,2,3,0,7
2247,797480,18,1,5,1,4,0,1,0,0,0,1,0,1,1,4,1,2
2247,785944,25,0,7,0,5,0,2,6,6,1,0,2,3,2,4,0,6
2247,791873,21,3,8,3,7,0,1,3,4,1,2,0,3,0,3,0,9
2247,797478,19,0,3,0,1,0,2,0,0,0,2,1,0,0,0,0,0
2247,781217,18,2,8,1,3,1,5,2,2,0,2,0,0,1,1,0,7
2247,797484,11,0,0,0,0,0,0,0,1,0,0,0,0,0,0,0,0
2247,797483,8,2,4,2,4,0,0,1,1,3,3,0,0,0,0,1,5
2247,797479,12,0,2,0,0,0,2,0,0,0,0,0,0,0,0,0,0
2247,786579,4,0,2,0,1,0,1,0,0,1,1,0,0,0,0,0,0
2247,786574,3,0,1,0,1,0,0,0,0,0,0,0,0,1,0,0,0
2248,789101,23,3,7,3,3,0,4,3,4,1,2,1,3,0,3,0,9
2248,781367,24,7,12,5,7,2,5,2,2,0,3,0,0,3,2,0,18
2248,781371,12,1,1,0,0,1,1,0,0,0,1,1,4,2,0,0,3
2248,785459,17,2,4,2,4,0,0,0,0,1,3,1,1,0,2,1,4
2248,789102,32,3,4,3,4,0,0,1,4,0,8,7,3,3,5,0,7
2248,792063,18,4,5,2,3,2,2,2,5,0,4,1,2,0,0,0,12
2248,797731,11,1,2,1,2,0,0,2,4,3,0,0,4,0,3,0,4
2248,792061,17,4,7,2,3,2,4,1,2,0,1,2,3,1,0,1,11
2248,788037,17,3,9,2,7,1,2,4,4,0,4,4,1,1,2,1,11
2248,792064,9,0,2,0,0,0,2,0,0,0,1,1,1,1,1,0,0
2248,792066,20,2,3,2,3,0,0,4,4,0,1,0,3,2,0,0,8
2249,785770,38,4,16,4,9,0,7,8,11,2,6,3,4,1,5,0,16
2249,781335,26,3,7,1,3,2,4,6,8,1,6,0,5,0,3,0,14
2249,781341,29,4,10,1,3,3,7,1,2,1,2,5,2,3,4,0,12
2249,785775,32,2,4,2,2,0,2,4,6,0,4,3,3,2,4,3,8
2249,776351,16,0,6,0,3,0,3,0,0,3,1,0,5,0,2,0,0
2249,791284,3,0,1,0,0,0,1,0,0,0,0,0,1,0,0,0,0
2249,791283,14,3,4,2,2,1,2,2,2,1,3,0,4,3,1,0,9
2249,791285,3,0,1,0,0,0,1,0,0,0,0,0,0,0,0,0,0
2249,796542,26,5,5,5,5,0,0,2,5,0,4,0,2,0,2,0,12
2249,796538,13,0,1,0,0,0,1,0,0,0,0,1,0,0,1,0,0
2250,791118,38,9,11,7,7,2,4,7,10,0,5,3,0,2,4,1,27
2250,774974,21,3,5,2,2,1,3,2,3,1,1,3,3,1,3,0,9
2250,791117,38,5,10,4,5,1,5,2,2,1,3,2,2,1,0,1,13
2250,785676,35,2,6,0,2,2,4,1,2,0,1,4,2,1,3,0,7
2250,780824,29,6,9,6,9,0,0,2,2,4,7,3,3,1,1,0,14
2250,791116,6,0,0,0,0,0,0,0,0,0,1,0,2,0,3,0,0
2250,796769,22,1,3,1,2,0,1,0,0,0,1,3,0,1,1,0,2
2250,791115,11,2,3,2,3,0,0,0,0,1,0,0,3,0,0,0,4
2251,775961,24,3,7,2,4,1,3,0,0,1,2,2,5,1,3,0,7
2251,787522,19,1,1,1,1,0,0,1,1,1,1,0,0,1,0,0,3
2251,787524,29,2,7,2,5,0,2,2,2,1,3,1,4,1,0,0,6
2251,783269,28,6,11,0,3,6,8,1,2,0,0,3,4,0,1,0,19
2251,780017,32,6,13,5,12,1,1,2,2,1,2,4,1,1,5,0,15
2251,797611,24,2,5,2,2,0,3,4,4,2,2,2,0,1,2,0,8
2251,791722,25,4,6,4,4,0,2,0,0,0,2,1,2,0,2,0,8
2251,775541,19,2,2,0,0,2,2,0,0,0,0,1,0,0,0,0,6
2252,780084,28,4,11,3,6,1,5,4,5,0,0,1,0,0,1,0,13
2252,774874,29,4,9,4,9,0,0,1,2,3,3,3,3,0,2,0,9
2252,780085,15,3,5,3,5,0,0,0,0,1,4,0,3,1,1,0,6
2252,786475,24,3,9,2,7,1,2,3,4,2,2,1,2,0,0,1,10
2252,776038,19,0,3,0,1,0,2,2,2,0,1,5,1,0,2,0,2
2252,785270,22,5,9,1,2,4,7,0,0,1,1,1,3,0,1,0,14
2252,780083,1,0,0,0,0,0,0,0,0,0,1,0,1,0,0,0,0
2252,790946,9,0,2,0,2,0,0,0,0,0,1,1,0,1,0,0,0
2252,786037,19,2,7,2,5,0,2,0,0,1,3,1,1,2,0,0,4
2252,775468,7,0,1,0,1,0,0,0,0,0,1,0,1,0,0,0,0
2252,781134,7,0,1,0,0,0,1,0,0,0,0,0,0,0,1,1,0
2252,796531,20,3,5,3,5,0,0,0,0,0,1,1,3,0,1,0,6
2253,786034,26,2,7,1,3,1,4,0,1,0,5,0,4,1,6,0,5
2253,786419,27,5,6,4,5,1,1,3,4,0,4,6,2,0,2,0,14
2253,781652,34,7,13,6,10,1,3,3,7,3,4,0,3,1,2,0,18
2253,781283,32,5,9,1,2,4,7,0,0,1,1,4,3,0,1,0,14
2253,781158,20,0,1,0,1,0,0,1,2,2,5,1,1,0,1,0,1
2253,791615,24,2,5,2,4,0,1,0,0,2,0,1,1,2,2,0,4
2253,781653,18,1,7,1,7,0,0,3,4,2,7,0,2,0,0,0,5
2253,796993,4,0,1,0,0,0,1,0,0,0,0,0,0,0,0,0,0
2253,785277,15,1,4,0,0,1,4,1,2,1,2,1,2,2,1,1,4
2254,791219,18,3,9,2,3,1,6,4,4,0,6,1,3,0,0,1,11
2254,791220,24,4,7,4,6,0,1,2,3,1,2,1,2,0,1,0,10
2254,780730,26,3,10,2,6,1,4,2,6,1,7,3,3,1,2,2,9
2254,776217,27,3,3,3,3,0,0,2,3,3,5,1,1,1,2,0,8
2254,790818,31,2,8,1,6,1,2,2,2,0,0,3,1,1,2,1,7
2254,786824,18,4,10,4,7,0,3,0,1,0,2,0,1,0,1,0,8
2254,786396,21,2,3,1,1,1,2,2,2,1,0,2,2,5,0,0,7
2254,796923,12,1,2,1,2,0,0,0,0,0,2,1,1,2,1,0,2
2254,796921,14,0,2,0,1,0,1,0,2,1,1,1,1,0,1,0,0
2254,796920,9,0,0,0,0,0,0,0,0,0,1,1,1,0,2,0,0
2256,797232,39,6,14,5,6,1,8,6,7,0,5,1,1,1,2,1,19
2256,797234,33,3,7,2,5,1,2,4,5,4,7,2,5,2,3,0,11
2256,797239,21,4,10,2,3,2,7,0,0,0,2,1,4,0,5,1,10
2256,797235,29,4,4,4,4,0,0,1,2,2,5,1,2,2,0,1,9
2256,791367,32,2,8,2,7,0,1,3,6,1,3,2,1,1,4,2,7
2256,785446,28,2,7,0,3,2,4,1,4,0,3,0,1,0,2,0,7
2256,791368,7,0,0,0,0,0,0,0,2,0,2,0,1,0,0,0,0
2256,797233,6,0,0,0,0,0,0,0,0,0,0,0,1,0,0,0,0
2256,786535,5,0,1,0,0,0,1,0,0,0,1,1,0,0,0,0,0
2256,791369,0,0,0,0,0,0,0,0,0,0,0,0,0,0,0,0,0
2257,786138,30,6,17,6,14,0,3,5,6,1,3,2,4,1,4,0,17
2257,786578,27,4,8,2,5,2,3,0,0,3,5,1,2,0,1,2,10
2257,785669,21,0,3,0,1,0,2,1,2,0,4,1,0,1,1,0,1
2257,786140,5,0,2,0,2,0,0,0,0,1,0,0,1,0,0,0,0
2257,797359,4,0,0,0,0,0,0,0,0,0,0,0,1,1,1,0,0
2257,797358,24,5,10,3,5,2,5,2,5,2,5,0,2,3,2,0,14
2257,786136,17,5,11,5,11,0,0,1,2,3,2,1,5,0,2,0,11
2257,776236,22,2,8,1,4,1,4,0,0,0,1,0,3,1,1,0,5
2257,781145,9,2,5,1,3,1,2,0,0,0,0,0,3,1,0,0,5
2257,797357,20,0,0,0,0,0,0,2,2,0,4,4,0,1,2,0,2
2257,775195,14,0,2,0,0,0,2,0,0,2,0,2,0,0,1,0,0
2257,791365,6,0,0,0,0,0,0,0,0,0,0,0,2,0,0,0,0
2257,797361,1,0,0,0,0,0,0,0,0,0,0,0,0,0,0,0,0
2258,790873,19,4,8,3,5,1,3,0,0,1,2,0,5,1,0,0,9
2258,780054,19,2,5,2,3,0,2,2,2,1,4,1,3,0,2,0,6
2258,781140,23,2,4,2,3,0,1,3,5,2,2,0,3,0,1,0,7
2258,786851,32,4,12,2,6,2,6,4,4,0,5,3,1,0,2,0,14
2258,776357,36,3,6,3,5,0,1,4,4,0,2,4,2,0,2,1,10
2258,781139,28,3,5,2,2,1,3,1,4,1,2,3,2,1,0,1,8
2258,796433,22,3,4,3,4,0,0,5,7,3,3,0,2,0,0,1,11
2258,785429,10,1,1,0,0,1,1,0,0,0,0,0,1,0,0,1,3
2258,796432,7,3,3,0,0,3,3,0,0,0,0,0,0,0,0,0,9
2258,776245,2,0,1,0,0,0,1,0,0,0,0,0,0,0,0,0,0
2258,780343,2,0,1,0,0,0,1,0,0,0,0,0,0,0,0,0,0
2259,780283,21,7,9,7,9,0,0,1,2,1,4,1,4,0,2,0,15
2259,790925,32,2,9,1,7,1,2,2,2,3,3,2,3,1,1,0,7
2259,791456,31,5,13,4,7,1,6,2,2,2,1,2,1,1,1,0,13
2259,785476,34,1,10,1,9,0,1,1,2,0,1,5,1,1,0,0,3
2259,780285,20,2,8,2,7,0,1,2,2,1,4,0,0,0,1,0,6
2259,785474,28,1,3,1,2,0,1,6,7,3,3,3,4,0,0,0,8
2259,790926,9,1,1,0,0,1,1,0,0,0,0,0,2,0,0,0,3
2259,785480,6,1,1,0,0,1,1,2,2,0,1,0,1,0,1,0,5
2259,780292,19,4,6,4,6,0,0,2,5,3,1,0,2,0,0,1,10
2260,797616,18,3,5,2,4,1,1,0,0,3,3,1,5,0,1,3,7
2260,791882,24,1,6,1,4,0,2,0,0,1,7,0,2,0,2,0,2
2260,786491,38,4,11,2,4,2,7,4,6,0,7,2,1,2,7,0,14
2260,791881,37,3,5,1,2,2,3,0,1,1,3,4,4,0,1,0,8
2260,786420,36,10,17,4,7,6,10,0,2,0,2,4,3,0,2,0,26
2260,797618,12,2,3,2,2,0,1,0,1,0,1,1,2,0,0,1,4
2260,797614,4,0,0,0,0,0,0,0,0,0,1,1,0,0,0,0,0
2260,797613,14,1,4,0,0,1,4,2,2,1,2,0,0,0,0,1,5
2260,781258,4,0,0,0,0,0,0,0,0,0,0,1,0,0,1,0,0
2260,781052,13,0,3,0,0,0,3,0,0,3,0,0,0,1,1,0,0
2262,785432,15,3,4,3,4,0,0,0,0,1,4,0,1,0,0,2,6
2262,779985,20,6,12,5,7,1,5,0,0,0,2,0,2,0,0,0,13
2262,790882,23,4,7,4,7,0,0,2,2,3,4,3,1,0,0,1,10
2262,790876,28,4,8,4,6,0,2,0,0,0,1,3,1,2,0,0,8
2262,774987,20,4,7,3,3,1,4,6,6,0,4,5,0,2,4,0,15
2262,790879,19,6,8,6,8,0,0,0,0,2,1,0,5,0,2,0,12
2262,790877,17,2,4,2,3,0,1,0,0,2,2,1,2,1,1,0,4
2262,796434,8,1,3,0,1,1,2,0,0,1,1,0,1,0,0,0,3
2262,785699,18,0,4,0,4,0,0,3,4,0,3,3,0,3,2,0,3
2262,781062,14,2,5,0,1,2,4,0,0,1,1,0,0,1,0,0,6
2262,790875,3,1,2,1,1,0,1,0,0,0,0,0,0,0,0,0,2
2262,790878,3,1,1,1,1,0,0,0,0,0,0,0,0,0,0,0,2
2262,779987,3,0,3,0,0,0,3,0,0,1,1,1,0,0,0,0,0
2262,790881,3,0,0,0,0,0,0,0,0,0,2,0,0,0,0,0,0
2262,790874,3,0,1,0,0,0,1,0,0,0,0,0,0,0,0,0,0
2262,796435,3,0,0,0,0,0,0,0,0,0,0,0,0,0,1,0,0
2263,791443,23,3,6,2,3,1,3,0,0,0,1,1,2,0,1,0,7
2263,781629,12,0,1,0,0,0,1,1,2,0,3,0,1,0,0,0,1
2263,791440,22,4,7,4,7,0,0,0,0,1,1,2,2,0,0,1,8
2263,797013,32,5,15,2,5,3,10,0,0,1,2,0,2,0,4,0,13
2263,791441,14,2,3,2,3,0,0,0,0,1,3,0,1,0,2,0,4
2263,781378,30,5,10,3,6,2,4,1,2,2,4,2,1,1,3,1,13
2263,775267,18,0,4,0,1,0,3,0,0,0,3,1,0,1,3,1,0
2263,797015,18,4,8,1,5,3,3,4,4,0,2,0,0,2,2,0,15
2263,797019,21,0,1,0,1,0,0,1,2,0,1,1,2,0,0,0,1
2263,797016,10,1,2,0,0,1,2,0,0,0,0,0,1,0,1,0,3
2264,785902,39,8,14,7,8,1,6,7,8,4,6,3,2,2,2,3,24
2264,792181,45,8,13,6,8,2,5,9,12,2,9,0,4,0,1,0,27
2264,792179,16,1,6,1,3,0,3,0,0,0,1,2,1,1,0,0,2
2264,780986,42,7,9,7,9,0,0,5,7,6,2,5,4,1,2,4,19
2264,786662,42,8,24,8,19,0,5,6,7,1,1,4,2,3,1,0,22
2264,797796,32,4,9,4,9,0,0,5,8,1,7,5,1,1,2,3,13
2264,797794,6,0,0,0,0,0,0,0,0,0,0,0,1,0,0,0,0
2264,792176,3,0,0,0,0,0,0,0,0,0,0,0,0,0,0,0,0
2265,785494,41,5,11,2,6,3,5,0,0,1,3,6,5,0,2,0,13
2265,785495,28,8,16,6,11,2,5,1,2,4,3,4,3,0,3,0,19
2265,785490,5,0,0,0,0,0,0,0,0,1,1,1,1,0,0,0,0
2265,780698,41,9,19,7,14,2,5,2,2,2,6,7,1,4,1,1,22
2265,775377,20,0,1,0,1,0,0,0,0,1,2,0,3,0,1,0,0
2265,785958,32,11,18,11,18,0,0,5,8,1,6,1,5,1,4,0,27
2265,780427,19,1,4,1,3,0,1,1,1,1,3,1,1,0,3,0,3
2265,791034,1,0,0,0,0,0,0,0,0,0,0,0,1,0,0,0,0
2265,785659,15,1,2,1,2,0,0,0,0,3,1,1,4,0,0,0,2
2265,791130,23,4,8,2,2,2,6,0,0,0,1,1,3,0,2,0,10
2266,792167,17,3,4,3,4,0,0,7,10,2,3,0,2,1,2,2,13
2266,792170,17,5,8,5,8,0,0,2,2,2,3,0,4,0,2,0,12
2266,791372,22,6,10,1,2,5,8,2,2,0,0,3,0,3,0,0,19
2266,792164,25,4,10,3,7,1,3,2,3,0,4,10,0,1,2,0,11
2266,780974,23,5,9,4,7,1,2,0,0,1,7,2,0,3,0,0,11
2266,797777,17,1,6,1,5,0,1,0,0,2,3,0,1,0,1,0,2
2266,797766,21,6,8,5,6,1,2,1,4,3,4,0,2,1,0,1,14
2266,797767,14,1,5,1,5,0,0,0,0,1,1,3,0,1,2,1,2
2266,797772,20,1,8,1,5,0,3,0,0,4,2,3,1,2,2,0,2
2266,797764,16,1,1,0,0,1,1,0,0,0,2,1,0,1,0,2,3
2266,797765,4,2,3,0,0,2,3,0,0,2,0,0,0,1,0,0,6
2266,792169,4,0,2,0,1,0,1,0,2,0,1,0,0,0,0,0,0
2268,797587,18,1,2,1,2,0,0,1,2,2,3,4,3,1,1,2,3
2268,791894,21,2,5,2,5,0,0,1,4,1,1,0,2,0,1,0,5
2268,786502,33,8,15,6,12,2,3,5,8,0,6,0,2,1,1,0,23
2268,781561,21,2,8,2,3,0,5,1,2,0,2,2,3,1,1,0,5
2268,781080,32,3,11,0,5,3,6,0,0,0,1,2,0,0,1,0,9
2268,797586,5,0,1,0,1,0,0,0,1,1,0,0,1,1,0,0,0
2268,791891,14,3,3,2,2,1,1,0,0,1,0,1,5,0,1,0,7
2268,786501,16,0,5,0,2,0,3,2,2,0,1,0,0,0,0,0,2
2268,781078,9,0,3,0,2,0,1,1,2,1,1,1,1,0,0,0,1
2268,797584,17,3,4,2,3,1,1,0,0,0,1,1,2,2,0,0,7
2268,791895,11,0,2,0,1,0,1,2,2,1,2,1,1,0,0,0,2
2268,791892,1,0,0,0,0,0,0,0,0,0,0,0,0,0,0,0,0
2268,797583,2,0,0,0,0,0,0,0,0,0,0,0,1,0,0,0,0
2269,781244,29,9,13,9,13,0,0,8,9,0,13,3,2,0,1,0,26
2269,791245,25,3,7,3,4,0,3,0,0,1,3,1,2,0,2,0,6
2269,785529,21,1,2,1,1,0,1,0,0,0,0,3,2,0,2,0,2
2269,781243,27,6,8,1,1,5,7,2,3,2,7,2,3,0,2,2,19
2269,776205,21,4,8,4,5,0,3,0,0,0,3,1,3,1,2,0,8
2269,796943,3,0,0,0,0,0,0,0,0,0,0,0,1,0,0,0,0
2269,796940,4,0,1,0,1,0,0,1,4,0,1,1,1,0,1,0,1
2269,791243,21,1,2,0,1,1,1,0,0,0,0,5,4,0,2,0,3
2269,791241,20,3,5,3,5,0,0,1,3,2,5,1,3,0,1,0,7
2269,791246,3,1,1,1,1,0,0,0,0,0,1,0,0,0,0,0,2
2269,785528,3,0,0,0,0,0,0,0,0,0,0,0,1,0,0,0,0
2269,781237,23,2,4,0,2,2,2,0,0,0,0,1,0,0,1,0,6
2270,791281,25,5,17,4,16,1,1,3,5,3,8,1,2,1,2,0,14
2270,792276,24,4,9,3,6,1,3,3,3,0,1,6,1,3,4,0,12
2270,791278,28,2,6,0,0,2,6,0,0,1,9,0,3,2,1,1,6
2270,786026,24,3,8,3,6,0,2,4,5,2,2,2,2,1,2,2,10
2270,785507,32,5,7,3,3,2,4,5,5,2,4,1,3,2,1,0,17
2270,796534,13,3,6,3,4,0,2,0,0,3,1,0,1,0,0,0,6
2270,796536,16,1,2,1,2,0,0,0,3,3,3,1,1,1,0,2,2
2270,796537,4,2,3,0,0,2,3,0,0,1,0,0,2,0,0,0,6
2270,796535,13,1,3,1,2,0,1,1,2,0,1,1,1,1,2,0,3
2270,785398,6,1,3,1,2,0,1,0,0,0,0,0,0,0,1,0,2
2270,775814,15,0,5,0,3,0,2,0,0,0,3,2,1,0,0,1,0
2272,785916,28,3,5,3,5,0,0,0,0,1,8,0,5,2,0,1,6
2272,786183,31,2,11,1,6,1,5,0,0,4,0,2,1,0,0,1,5
2272,780105,21,2,10,2,9,0,1,0,0,3,2,3,5,0,2,0,4
2272,785894,36,7,17,2,3,5,14,0,0,1,4,2,4,1,2,0,19
2272,781131,39,6,15,6,12,0,3,3,5,2,6,11,4,1,5,2,15
2272,780106,7,0,1,0,1,0,0,0,0,1,2,0,1,0,0,0,0
2272,797108,1,0,0,0,0,0,0,0,0,0,0,1,0,1,1,0,0
2272,791409,4,0,1,0,0,0,1,0,0,0,0,0,4,0,0,0,0
2272,785915,33,8,12,0,0,8,12,1,2,0,2,1,2,1,0,2,25
2273,797529,37,7,13,7,12,0,1,3,7,2,6,1,3,2,0,3,17
2273,797527,17,0,1,0,1,0,0,1,2,0,3,0,2,0,0,0,1
2273,791936,37,7,10,7,10,0,0,1,5,9,9,1,1,1,3,0,15
2273,797532,38,9,19,8,15,1,4,6,9,0,6,5,3,1,6,0,25
2273,785688,39,1,12,0,2,1,10,3,3,1,5,3,2,2,2,0,6
2273,791931,2,1,1,1,1,0,0,0,0,0,0,0,0,0,0,0,2
2273,791932,6,0,1,0,1,0,0,2,2,0,0,0,2,0,0,0,2
2273,791933,4,0,0,0,0,0,0,1,2,0,0,0,0,0,0,0,1
2273,785988,20,1,5,1,4,0,1,1,2,0,3,1,1,0,0,0,3
2274,786296,13,3,3,3,3,0,0,0,0,2,0,2,2,0,2,0,6
2274,781530,24,7,12,6,11,1,1,1,1,1,7,2,1,2,1,1,16
2274,776423,20,3,8,3,7,0,1,2,2,2,7,0,4,1,2,1,8
2274,798096,20,4,7,3,5,1,2,1,1,1,2,0,1,1,1,0,10
2274,792319,22,4,5,1,1,3,4,0,0,1,0,6,0,0,2,0,11
2274,798109,4,0,0,0,0,0,0,0,0,0,0,0,1,0,0,0,0
2274,792314,17,3,6,3,6,0,0,1,1,2,5,0,1,0,2,0,7
2274,792320,7,2,4,2,4,0,0,3,3,2,0,0,1,0,0,0,7
2274,798106,22,3,8,2,6,1,2,2,2,0,4,2,1,2,1,0,9
2274,798104,22,3,8,2,2,1,6,0,0,0,1,3,2,1,0,0,7
2274,798102,4,0,0,0,0,0,0,0,0,0,0,0,1,0,0,0,0
2274,792307,17,0,2,0,0,0,2,0,0,1,2,4,1,0,1,0,0
2274,792321,8,1,1,1,1,0,0,2,3,0,0,0,2,1,0,0,4
2275,782643,23,1,4,1,4,0,0,0,0,1,2,1,2,1,3,2,2
2275,776037,21,4,7,4,6,0,1,1,3,0,0,2,2,1,0,0,9
2275,791759,25,0,4,0,4,0,0,0,0,0,0,2,2,2,1,0,0
2275,780667,25,4,9,3,6,1,3,5,5,0,4,1,1,0,1,1,14
2275,775680,22,2,8,1,3,1,5,0,0,0,2,1,0,0,3,0,5
2275,791758,7,1,1,0,0,1,1,2,2,0,2,1,0,0,1,0,5
2275,785987,21,0,2,0,1,0,1,1,2,0,1,0,0,0,1,0,1
2275,781647,15,3,4,1,1,2,3,2,2,1,0,0,1,1,1,0,10
2275,780588,17,1,3,1,3,0,0,4,4,0,1,2,4,3,1,0,6
2275,797355,3,0,0,0,0,0,0,0,0,0,0,0,1,0,0,0,0
2275,786147,12,0,1,0,0,0,1,1,2,0,2,0,3,0,1,0,1
2275,785229,9,0,4,0,4,0,0,0,0,0,1,2,1,0,2,0,0
2276,780521,32,3,7,1,2,2,5,4,4,0,4,2,1,0,1,0,12
2276,780145,15,0,0,0,0,0,0,0,0,0,5,0,4,0,0,0,0
2276,791370,25,1,5,1,2,0,3,0,0,0,4,1,2,1,4,0,2
2276,786199,36,5,13,2,7,3,6,8,9,4,4,3,0,2,9,0,21
2276,780991,32,0,3,0,1,0,2,1,3,0,1,3,2,0,1,0,1
2276,781611,10,0,1,0,1,0,0,0,0,2,0,1,0,0,1,0,0
2276,775163,14,3,3,3,3,0,0,0,0,1,2,0,1,0,2,0,6
2276,797271,23,4,8,1,2,3,6,1,1,0,0,1,2,3,5,0,12
2276,743593,13,3,4,2,3,1,1,0,0,0,4,2,1,0,3,0,7
2277,785681,33,6,10,6,10,0,0,1,2,5,2,0,2,2,1,2,13
2277,796789,26,2,8,1,4,1,4,0,0,1,2,4,2,5,2,0,5
2277,791126,34,8,13,8,11,0,2,0,1,1,2,3,2,2,2,0,16
2277,791124,30,1,2,1,2,0,0,2,4,0,2,4,2,2,2,0,4
2277,780050,36,4,9,1,3,3,6,2,3,0,5,2,2,3,7,0,13
2277,784479,8,1,4,0,1,1,3,2,2,0,0,0,1,0,1,0,5
2277,796786,3,1,3,0,0,1,3,0,0,0,0,0,0,0,0,0,3
2277,796788,4,0,0,0,0,0,0,0,0,0,2,0,1,0,0,0,0
2277,796784,10,2,3,2,2,0,1,0,2,0,0,0,1,0,0,0,4
2277,796783,1,0,0,0,0,0,0,0,0,0,0,0,0,0,0,0,0
2277,796782,14,0,1,0,1,0,0,0,0,0,1,1,1,0,1,0,0
2277,792711,1,0,0,0,0,0,0,0,0,0,0,0,2,0,0,0,0
2278,792306,32,5,12,3,6,2,6,0,0,0,6,1,2,1,2,2,12
2278,786618,30,3,3,3,3,0,0,1,2,4,4,0,1,0,0,0,7
2278,797904,19,1,1,1,1,0,0,0,0,0,2,0,0,2,0,0,2
2278,792303,35,8,20,5,13,3,7,6,8,3,0,7,3,4,4,0,25
2278,781603,17,1,5,1,2,0,3,0,2,0,0,2,1,1,1,0,2
2278,776424,4,0,1,0,0,0,1,0,0,0,0,0,2,0,0,1,0
2278,780456,11,1,5,0,2,1,3,0,0,0,1,0,1,0,1,0,3
2278,781605,4,0,0,0,0,0,0,0,0,0,0,0,0,1,0,0,0
2278,797914,22,2,6,1,2,1,4,0,0,0,3,0,2,0,0,0,5
2278,796155,9,0,0,0,0,0,0,0,0,2,0,0,3,0,1,0,0
2278,792300,10,0,2,0,1,0,1,0,0,1,2,0,2,0,1,0,0
2278,790813,7,1,2,0,0,1,2,0,0,1,1,0,0,0,1,0,3
2278,781607,0,0,0,0,0,0,0,0,0,0,0,0,0,0,0,0,0
2279,785622,20,0,5,0,2,0,3,0,1,2,3,1,0,0,0,0,0
2279,781058,33,7,9,6,8,1,1,0,0,4,2,1,1,0,4,0,15
2279,780327,22,1,4,1,4,0,0,0,0,0,5,0,1,0,1,1,2
2279,797451,27,2,9,2,7,0,2,0,0,0,2,2,2,2,5,0,4
2279,791849,22,0,2,0,1,0,1,0,0,1,2,1,2,1,2,0,0
2279,797458,24,2,4,2,4,0,0,2,4,0,3,3,1,2,2,0,6
2279,797455,17,5,8,5,8,0,0,2,4,2,3,0,0,0,1,1,12
2279,786607,16,2,4,2,2,0,2,0,0,0,3,0,3,0,0,0,4
2279,797453,7,2,3,2,3,0,0,3,4,0,1,0,0,0,1,0,7
2279,791848,7,0,0,0,0,0,0,0,0,1,0,0,0,0,0,0,0
2279,797452,4,0,0,0,0,0,0,0,0,0,0,0,0,0,1,0,0
2279,797456,1,0,0,0,0,0,0,0,0,0,0,0,0,0,0,0,0
2280,785335,18,4,7,4,7,0,0,2,2,3,4,0,2,1,0,3,10
2280,781385,29,3,7,3,4,0,3,3,4,2,1,4,1,1,2,0,9
2280,791594,32,6,11,5,8,1,3,1,1,1,0,5,1,2,0,0,14
2280,780303,33,5,11,4,9,1,2,2,2,3,5,1,3,0,4,2,13
2280,791012,32,4,11,2,4,2,7,0,0,0,5,1,0,0,1,0,10
2280,786349,16,1,3,1,1,0,2,0,0,0,1,1,1,0,0,0,2
2280,781221,3,0,1,0,0,0,1,0,0,0,0,0,0,0,0,0,0
2280,785337,24,3,5,1,2,2,3,0,0,1,4,1,4,0,2,0,8
2280,791011,13,1,4,1,2,0,2,1,1,0,1,1,1,1,0,0,3
2281,791619,19,1,2,0,0,1,2,0,0,0,2,0,0,1,0,0,3
2281,786431,35,3,5,1,2,2,3,0,0,0,1,7,1,0,4,0,8
2281,791621,31,6,14,2,6,4,8,1,2,1,2,0,0,0,2,0,17
2281,781125,25,1,4,1,4,0,0,2,5,1,5,0,2,1,0,1,4
2281,780440,29,7,12,4,7,3,5,0,0,2,9,0,4,0,0,0,17
2281,781088,27,5,6,2,2,3,4,1,1,0,1,3,1,0,2,0,14
2281,775620,14,1,3,1,3,0,0,0,0,0,1,0,3,0,0,1,2
2281,775622,17,1,3,1,2,0,1,1,1,0,0,1,2,2,1,0,3
2281,786434,3,0,1,0,0,0,1,0,0,1,0,0,0,0,1,0,0
2282,790869,25,6,12,4,8,2,4,4,5,0,3,4,3,0,0,0,18
2282,780116,27,4,7,4,4,0,3,2,2,1,7,0,3,0,1,0,10
2282,780493,29,6,13,0,0,6,13,0,0,0,3,1,1,1,2,3,18
2282,790866,36,3,8,1,1,2,7,1,2,0,5,3,2,0,1,0,9
2282,790870,28,9,12,9,12,0,0,8,13,4,5,9,2,1,1,4,26
2282,796426,10,0,0,0,0,0,0,0,0,1,2,0,2,0,0,0,0
2282,796427,22,2,5,2,3,0,2,0,2,2,3,1,3,0,1,0,4
2282,796424,6,2,5,0,1,2,4,0,0,0,1,0,2,0,1,0,6
2282,796422,2,0,0,0,0,0,0,0,2,0,1,0,0,0,0,0,0
2282,780492,7,0,1,0,1,0,0,1,2,0,1,3,1,0,0,0,1
2282,783997,4,0,0,0,0,0,0,0,0,0,1,0,0,0,0,0,0
2282,796428,4,1,2,1,1,0,1,0,0,0,0,0,0,0,0,0,2
2283,781112,20,1,4,1,4,0,0,0,0,0,1,2,1,0,0,0,2
2283,791926,25,1,3,0,2,1,1,4,4,1,0,0,2,0,0,0,7
2283,791923,23,3,9,3,9,0,0,1,4,2,5,0,4,0,2,0,7
2283,791925,24,5,11,5,10,0,1,0,3,0,4,2,2,1,2,0,10
2283,781122,10,0,3,0,3,0,0,2,2,2,1,0,1,0,0,0,2
2283,786527,14,1,3,1,2,0,1,2,2,0,1,2,1,0,1,0,4
2283,797542,14,5,9,2,3,3,6,1,2,1,2,1,2,0,1,0,14
2283,791927,14,1,4,0,1,1,3,0,0,1,0,0,5,0,2,0,3
2283,786858,15,3,7,1,5,2,2,0,0,0,1,0,0,0,1,0,8
2283,791922,10,1,3,1,2,0,1,0,0,0,4,0,1,1,0,0,2
2283,786529,10,0,0,0,0,0,0,2,2,0,1,0,4,0,1,0,2
2283,797541,13,2,4,2,4,0,0,0,0,1,7,0,3,0,0,0,4
2283,797543,3,0,1,0,0,0,1,2,2,0,0,0,0,0,0,0,2
2283,778952,5,0,1,0,0,0,1,0,0,0,1,0,2,0,1,0,0
2284,791981,33,8,14,6,9,2,5,7,10,2,5,6,0,1,1,1,25
2284,780342,25,4,6,3,4,1,2,3,3,2,6,3,1,0,2,0,12
2284,791982,32,8,14,7,10,1,4,1,1,0,6,7,1,1,1,0,18
2284,780333,30,3,8,2,3,1,5,0,0,0,3,2,2,1,1,0,7
2284,781493,34,7,13,4,8,3,5,2,2,3,2,0,1,1,0,0,19
2284,786755,3,0,0,0,0,0,0,0,0,0,0,0,1,0,0,0,0
2284,786756,25,1,5,0,1,1,4,0,0,1,2,1,2,1,0,0,3
2284,791984,15,1,4,1,4,0,0,2,2,1,0,2,3,1,3,1,4
2284,791985,3,0,0,0,0,0,0,0,0,0,0,0,0,0,0,0,0
2285,797715,34,6,15,3,7,3,8,2,2,2,4,6,1,2,3,0,17
2285,791950,35,3,9,1,2,2,7,0,0,1,3,1,1,0,4,0,8
2285,792115,22,1,2,1,2,0,0,0,0,0,3,0,3,0,1,0,2
2285,780937,26,5,11,1,3,4,8,3,4,0,3,0,3,1,0,2,17
2285,775754,31,5,9,5,6,0,3,1,1,0,5,1,3,0,5,0,11
2285,780938,15,2,2,2,2,0,0,2,2,0,2,4,2,0,1,0,6
2285,791149,17,1,5,1,1,0,4,0,0,0,0,2,0,0,0,0,2
2285,797717,15,2,3,1,1,1,2,0,0,2,2,0,2,0,0,0,5
2285,797716,5,0,0,0,0,0,0,0,0,0,0,0,1,0,0,0,0
2286,780306,27,7,10,7,9,0,1,2,3,1,5,6,1,0,3,0,16
2286,786357,35,6,9,5,6,1,3,3,5,2,6,0,4,2,4,1,16
2286,780312,29,2,2,0,0,2,2,1,2,0,1,3,3,0,0,1,7
2286,797116,26,3,8,1,4,2,4,0,0,1,2,4,0,3,2,0,8
2286,791537,20,1,2,1,1,0,1,5,6,0,3,0,2,0,3,0,7
2286,775846,6,0,2,0,1,0,1,0,0,0,0,1,0,1,1,0,0
2286,791535,7,0,0,0,0,0,0,0,0,0,0,0,2,0,0,0,0
2286,775418,17,4,4,4,4,0,0,5,6,2,4,0,4,0,2,0,13
2286,786358,23,4,9,3,3,1,6,0,0,0,3,2,1,0,0,1,9
2286,791538,3,0,1,0,1,0,0,0,2,0,0,0,2,0,0,0,0
2286,797118,2,0,0,0,0,0,0,0,0,0,0,0,1,0,0,0,0
2286,797119,3,0,0,0,0,0,0,0,0,0,0,0,0,0,0,0,0
2286,797121,2,0,2,0,0,0,2,0,0,0,0,0,0,0,0,0,0
2287,776374,18,1,4,1,3,0,1,1,2,0,1,3,0,0,3,0,3
2287,796718,16,0,3,0,2,0,1,0,0,0,0,0,0,1,0,0,0
2287,796719,15,0,1,0,1,0,0,4,5,0,6,0,3,0,0,0,4
2287,775412,29,1,6,0,1,1,5,3,4,3,0,0,2,0,2,1,6
2287,766998,18,2,3,2,3,0,0,0,0,0,2,0,3,0,2,0,4
2287,796717,24,5,8,5,7,0,1,0,0,0,2,3,1,1,3,0,10
2287,791043,25,3,8,1,2,2,6,0,0,1,2,1,3,4,2,0,8
2287,785512,11,0,0,0,0,0,0,2,2,2,0,0,3,0,0,0,2
2287,791042,15,2,5,1,3,1,2,0,4,0,2,0,5,0,0,0,5
2287,796723,26,2,8,0,5,2,3,2,2,0,2,0,0,1,2,0,8
2287,796720,3,0,1,0,1,0,0,2,2,0,0,0,1,0,1,0,2
2288,791334,22,5,12,3,4,2,8,3,3,1,3,1,0,1,0,0,15
2288,780256,25,5,8,2,4,3,4,0,0,3,7,3,1,1,6,0,13
2288,785874,15,3,3,3,3,0,0,1,2,2,5,2,2,0,0,0,7
2288,796879,28,2,5,1,4,1,1,1,4,1,3,5,1,2,3,0,6
2288,791757,12,2,4,1,3,1,1,1,2,0,2,2,3,0,1,0,6
2288,791760,13,3,4,3,4,0,0,6,7,0,5,0,1,0,2,1,12
2288,781590,22,4,6,4,6,0,0,2,4,1,1,1,2,1,1,1,10
2288,796880,14,4,8,3,6,1,2,0,0,1,2,1,4,0,1,0,9
2288,796883,17,1,6,0,3,1,3,0,0,0,0,2,3,0,0,0,3
2288,785876,7,1,1,1,1,0,0,1,2,1,1,0,0,0,3,0,3
2288,791330,12,1,3,1,3,0,0,0,0,3,6,0,4,1,1,0,2
2288,796877,1,1,1,1,1,0,0,0,0,0,1,0,0,0,0,0,2
2288,791331,7,0,2,0,2,0,0,1,2,0,0,0,0,0,2,0,1
2288,796885,5,0,1,0,1,0,0,0,0,1,1,0,1,0,1,0,0
2302,790799,16,2,4,2,4,0,0,1,3,1,2,1,4,0,1,1,5
2302,790798,25,6,10,6,10,0,0,3,4,5,4,3,5,0,4,0,15
2302,780140,25,5,10,2,3,3,7,0,0,0,2,6,5,1,1,0,13
2302,796355,33,8,17,1,7,7,10,4,7,1,6,4,2,3,7,1,27
2302,780137,38,5,10,5,9,0,1,1,2,5,13,6,2,0,2,0,11
2302,785245,30,4,10,3,7,1,3,4,6,2,3,3,3,3,1,0,13
2302,790796,9,3,3,3,3,0,0,0,0,0,1,0,1,0,1,0,6
2302,775553,19,3,5,1,1,2,4,1,2,2,1,2,0,1,1,0,9
2302,796359,2,0,1,0,0,0,1,0,0,0,1,0,0,0,0,0,0
2302,796354,3,0,0,0,0,0,0,0,0,0,0,0,1,0,0,0,0
2303,780027,37,13,18,13,16,0,2,4,7,1,9,2,3,0,1,3,30
2303,786176,35,8,16,5,8,3,8,1,3,3,6,4,2,3,2,0,20
2303,786173,23,2,7,1,4,1,3,3,3,0,0,2,4,1,1,0,8
2303,780028,25,1,2,1,2,0,0,1,2,0,3,2,4,1,1,0,3
2303,774828,24,1,8,1,3,0,5,0,0,0,2,3,1,1,4,0,2
2303,780029,23,4,10,4,8,0,2,2,5,6,2,1,2,0,0,2,10
2303,791380,18,6,11,6,9,0,2,2,4,2,0,2,2,1,3,0,14
2303,797175,5,0,2,0,2,0,0,1,2,0,1,0,1,0,0,0,1
2303,791379,10,0,1,0,1,0,0,0,0,0,0,0,1,0,0,0,0
2304,780358,24,3,7,2,4,1,3,1,1,0,1,3,1,0,2,1,8
2304,775011,26,5,10,3,5,2,5,0,0,0,2,2,2,1,0,1,12
2304,776004,20,7,13,5,10,2,3,4,4,0,7,0,2,0,2,0,20
2304,780357,27,3,7,0,1,3,6,1,2,0,2,4,1,2,0,0,10
2304,775018,19,3,3,0,0,3,3,0,0,0,2,5,2,1,0,0,9
2304,790930,23,1,3,1,3,0,0,1,3,2,3,2,2,3,1,0,3
2304,796480,22,3,4,2,3,1,1,0,1,2,4,3,0,2,2,1,7
2304,776270,20,4,4,1,1,3,3,0,0,0,0,3,2,0,0,0,11
2304,796485,6,1,2,1,2,0,0,0,0,1,1,0,1,0,1,0,2
2304,785496,4,1,3,0,2,1,1,0,0,1,0,0,2,0,0,0,3
2304,796482,3,0,0,0,0,0,0,0,0,0,0,0,0,0,1,0,0
2304,785491,2,0,1,0,1,0,0,0,0,0,0,0,0,0,0,0,0
2304,796486,4,0,0,0,0,0,0,0,0,0,0,0,0,0,0,0,0
2305,791531,30,4,7,4,6,0,1,3,4,0,5,1,3,0,0,0,11
2305,791534,14,3,5,3,4,0,1,0,0,1,2,1,0,1,1,0,6
2305,797127,35,0,5,0,3,0,2,0,0,2,1,1,2,0,4,0,0
2305,791533,40,2,8,1,5,1,3,2,2,1,6,1,3,0,3,0,7
2305,791528,36,5,13,3,10,2,3,0,0,1,3,4,3,2,7,0,12
2305,797124,26,2,7,0,3,2,4,2,2,0,2,0,2,1,2,2,8
2305,791527,7,0,1,0,1,0,0,0,2,0,0,0,2,0,0,0,0
2305,797129,12,1,1,1,1,0,0,2,2,0,1,0,3,0,1,0,4
2306,791249,32,2,8,1,5,1,3,4,4,0,2,2,5,0,5,0,9
2306,785523,13,1,2,1,2,0,0,3,4,3,1,1,3,0,0,0,5
2306,785521,28,3,5,1,1,2,4,0,0,0,1,0,0,0,0,0,8
2306,775358,26,4,8,3,6,1,2,6,7,1,5,3,4,0,0,0,15
2306,791250,36,6,14,4,7,2,7,5,6,0,8,1,2,3,3,1,19
2306,785522,20,1,6,1,3,0,3,1,2,1,0,1,1,0,0,0,3
2306,796944,10,0,1,0,1,0,0,0,0,0,0,0,0,0,0,0,0
2306,796947,13,1,1,1,1,0,0,0,0,0,1,0,0,0,2,0,2
2306,796949,6,0,0,0,0,0,0,2,2,0,4,1,1,0,2,0,2
2306,781247,16,0,1,0,1,0,0,1,3,1,1,1,2,0,0,0,1
2307,791676,34,7,18,2,6,5,12,2,2,0,2,3,2,1,1,0,21
2307,780553,29,3,8,3,8,0,0,6,6,1,3,2,5,2,2,1,12
2307,785799,23,3,6,3,6,0,0,0,1,3,8,0,3,0,2,1,6
2307,785800,28,5,8,3,5,2,3,2,2,1,2,1,3,1,0,0,14
2307,780760,14,0,2,0,2,0,0,0,0,0,1,0,0,0,0,0,0
2307,797427,13,2,4,0,0,2,4,0,0,0,0,0,2,1,3,0,6
2307,791677,11,1,2,1,2,0,0,0,0,0,1,1,3,1,0,0,2
2307,785807,18,0,7,0,2,0,5,2,2,2,4,1,1,1,0,1,2
2307,791679,9,2,3,2,3,0,0,0,2,2,0,0,2,1,1,0,4
2307,797426,5,1,3,1,1,0,2,0,0,1,0,0,0,0,0,0,2
2307,791678,16,1,1,1,1,0,0,0,3,0,2,2,3,1,1,0,2
2308,791391,33,1,8,1,7,0,1,1,4,1,9,1,4,1,4,1,3
2308,797156,27,2,5,2,4,0,1,1,2,1,3,3,1,1,2,0,5
2308,780130,37,5,14,4,8,1,6,1,2,0,2,0,2,3,4,0,12
2308,791390,23,7,10,7,9,0,1,13,14,3,3,1,4,3,4,0,27
2308,780133,17,2,4,1,3,1,1,0,0,1,6,0,2,0,1,0,5
2308,780407,2,0,0,0,0,0,0,0,0,0,0,0,1,0,0,0,0
2308,776446,19,1,3,0,1,1,2,0,0,0,0,5,0,1,1,0,3
2308,791388,8,0,2,0,0,0,2,0,0,0,2,0,1,0,1,1,0
2308,797158,6,1,2,1,2,0,0,0,0,1,0,0,2,0,0,0,2
2308,775743,28,2,7,1,3,1,4,5,6,0,3,1,0,0,2,0,10
2309,780406,18,2,4,1,2,1,2,0,0,2,4,0,3,2,2,0,5
2309,767245,30,5,9,5,9,0,0,3,5,1,5,1,2,1,4,0,13
2309,775087,16,1,3,1,3,0,0,0,0,0,2,0,2,2,3,2,2
2309,790984,28,1,6,1,3,0,3,0,0,0,3,1,0,0,1,0,2
2309,780212,35,6,19,4,10,2,9,4,7,0,3,3,2,2,5,0,18
2309,785297,7,0,0,0,0,0,0,1,2,0,1,0,2,0,2,0,1
2309,780214,12,1,2,1,1,0,1,0,0,2,2,0,5,0,0,0,2
2309,791168,25,3,9,1,5,2,4,2,2,0,3,0,2,0,0,1,10
2309,796596,6,0,1,0,0,0,1,0,0,0,1,1,1,0,1,0,0
2309,790985,1,0,1,0,1,0,0,0,0,1,1,0,0,0,0,0,0
2309,780215,22,2,4,2,4,0,0,0,0,2,2,0,3,2,0,2,4
2310,790943,10,0,2,0,0,0,2,0,0,0,1,0,4,1,1,0,0
2310,776110,28,4,8,3,4,1,4,5,6,3,3,0,2,1,2,1,14
2310,780059,32,6,10,5,9,1,1,3,4,1,3,0,3,1,3,0,16
2310,790944,33,2,9,1,4,1,5,7,8,1,3,1,1,1,0,0,12
2310,780061,34,3,10,1,3,2,7,1,2,2,5,3,1,4,3,0,9
2310,796494,25,2,4,0,1,2,3,2,2,2,2,0,3,0,2,1,8
2310,780058,8,0,4,0,2,0,2,0,0,0,0,0,0,0,1,0,0
2310,796496,2,0,1,0,1,0,0,1,2,1,0,0,0,0,0,0,1
2310,786754,21,4,7,4,5,0,2,1,2,0,1,3,2,0,6,1,9
2310,790941,7,1,1,1,1,0,0,0,0,0,1,0,0,0,0,0,2
2311,776100,23,2,8,2,6,0,2,1,3,4,2,0,1,0,1,1,5
2311,785991,33,11,14,11,14,0,0,5,8,5,7,1,3,1,2,1,27
2311,781406,16,1,3,1,3,0,0,2,2,0,1,1,4,2,5,0,4
2311,781401,32,3,10,3,8,0,2,0,0,0,4,1,3,3,2,1,6
2311,775317,8,0,3,0,2,0,1,0,0,0,1,0,4,0,0,0,0
2311,792133,30,6,14,4,9,2,5,6,6,1,0,0,1,3,3,0,20
2311,797762,28,2,6,2,6,0,0,0,0,1,4,6,4,2,3,0,4
2311,781029,19,1,1,1,1,0,0,2,2,0,1,1,3,0,0,0,4
2311,797760,9,1,1,0,0,1,1,0,0,0,0,0,0,0,0,0,3
2311,797758,2,0,0,0,0,0,0,0,0,0,0,0,0,0,0,0,0
2312,796860,37,4,6,4,6,0,0,7,8,1,2,4,1,0,5,0,15
2312,791187,25,1,3,1,3,0,0,2,2,2,5,2,4,2,3,0,4
2312,791185,9,4,5,3,3,1,2,0,0,0,1,0,0,0,0,0,9
2312,785649,39,7,16,4,7,3,9,5,7,0,4,2,2,1,4,0,22
2312,785650,26,0,2,0,0,0,2,2,2,0,1,1,3,0,5,0,2
2312,791184,23,3,6,2,5,1,1,0,0,0,1,2,3,3,3,0,7
2312,775208,11,2,3,2,3,0,0,0,1,1,2,0,2,0,0,0,4
2312,796861,12,2,3,1,1,1,2,0,0,0,0,2,1,0,3,0,5
2312,791183,4,0,0,0,0,0,0,0,0,0,0,0,1,0,0,0,0
2312,796857,14,0,2,0,2,0,0,0,0,0,0,0,2,0,0,0,0
2313,792227,22,2,3,1,2,1,1,0,0,0,3,3,5,2,2,2,5
2313,785935,34,4,12,2,9,2,3,5,6,0,1,1,2,3,4,0,15
2313,792223,38,10,15,6,8,4,7,4,7,0,2,2,2,4,3,0,28
2313,781352,24,5,6,5,6,0,0,0,0,1,2,1,4,0,4,1,10
2313,781340,31,3,8,3,8,0,0,0,0,0,2,2,4,0,0,0,6
2313,797882,13,0,1,0,1,0,0,2,2,1,1,1,0,0,2,0,2
2313,797889,10,1,1,1,1,0,0,0,1,2,0,0,1,1,1,0,2
2313,797886,4,0,0,0,0,0,0,0,0,0,0,0,0,0,0,0,0
2313,781351,14,0,1,0,0,0,1,0,0,0,0,0,1,0,0,0,0
2313,786453,3,0,0,0,0,0,0,0,0,1,0,1,0,0,0,0,0
2313,797881,7,0,2,0,2,0,0,2,2,1,2,0,3,0,2,1,2
2314,797967,37,5,11,3,8,2,3,2,2,1,4,3,4,0,0,0,14
2314,797962,4,0,0,0,0,0,0,0,0,0,2,0,1,0,0,0,0
2314,797970,30,3,11,2,7,1,4,4,4,0,7,4,3,1,1,0,11
2314,781453,36,6,17,2,5,4,12,2,2,0,6,5,0,0,0,1,18
2314,774869,37,2,10,0,2,2,8,2,2,2,6,2,1,0,0,2,8
2314,797972,22,1,3,1,3,0,0,3,6,2,2,1,1,1,0,0,5
2314,792254,17,4,6,3,5,1,1,0,0,0,3,0,0,0,1,0,9
2314,797961,4,0,0,0,0,0,0,0,2,0,1,0,1,0,1,0,0
2314,786098,13,1,4,1,1,0,3,4,5,0,0,1,1,0,1,0,6
2315,792373,29,8,11,8,11,0,0,0,0,1,6,0,1,0,2,1,16
2315,792370,37,6,14,4,8,2,6,3,4,0,13,1,4,0,1,0,17
2315,797960,13,0,0,0,0,0,0,0,0,0,0,1,5,0,0,0,0
2315,786739,21,0,5,0,2,0,3,0,0,0,1,2,2,0,1,0,0
2315,775303,33,4,10,4,7,0,3,1,3,1,3,3,1,0,0,0,9
2315,797958,9,0,1,0,0,0,1,0,0,0,0,0,1,0,1,0,0
2315,781598,8,1,4,0,1,1,3,0,0,0,0,0,1,0,0,2,3
2315,790499,21,2,7,2,6,0,1,0,0,0,1,0,4,1,2,0,4
2315,775809,29,3,6,2,3,1,3,1,1,0,4,2,3,0,2,0,8
2316,796656,22,1,2,1,2,0,0,0,0,2,0,0,2,1,1,0,2
2316,791321,24,1,3,1,3,0,0,4,5,2,4,1,3,0,2,1,6
2316,791320,30,7,11,3,6,4,5,0,0,2,2,2,3,2,1,0,18
2316,785912,32,9,19,8,11,1,8,2,3,1,4,5,1,0,0,1,21
2316,781511,25,3,7,2,4,1,3,1,1,0,5,1,5,2,3,0,8
2316,796657,21,3,7,3,5,0,2,0,0,3,2,1,0,0,1,0,6
2316,796651,13,0,3,0,0,0,3,0,0,0,2,0,1,0,2,0,0
2316,792257,10,0,7,0,5,0,2,1,2,1,1,0,0,0,1,0,1
2316,791323,23,1,5,0,2,1,3,0,0,0,5,4,2,1,1,0,3
2317,786039,13,3,4,3,4,0,0,0,0,1,1,0,2,0,1,1,6
2317,792043,19,1,5,0,0,1,5,1,2,0,2,0,2,1,0,0,4
2317,786266,22,2,5,2,5,0,0,0,0,0,3,0,0,0,2,0,4
2317,792040,32,2,7,2,6,0,1,3,4,0,2,1,2,0,2,0,7
2317,775028,32,8,14,7,12,1,2,4,6,1,6,6,2,3,2,0,21
2317,797728,13,1,4,1,2,0,2,0,0,0,3,0,0,0,1,0,2
2317,797726,11,0,0,0,0,0,0,0,0,0,4,2,4,0,1,0,0
2317,792036,23,5,8,5,6,0,2,3,3,0,2,1,2,1,1,1,13
2317,797723,6,1,2,1,1,0,1,0,0,0,0,1,1,0,0,0,2
2317,797719,9,1,2,0,0,1,2,0,0,0,0,0,0,0,0,0,3
2317,797718,20,1,2,0,0,1,2,3,3,0,1,0,1,1,2,0,6
2318,786787,32,6,17,5,10,1,7,2,2,0,2,1,1,2,2,0,15
2318,789020,32,4,7,1,2,3,5,1,4,0,3,5,3,0,1,3,12
2318,792091,29,4,9,2,4,2,5,0,0,2,6,2,1,0,4,0,10
2318,774954,31,8,12,7,10,1,2,2,3,2,2,3,1,1,1,0,19
2318,786795,20,1,4,0,0,1,4,0,0,2,2,4,0,1,0,0,3
2318,774815,3,0,0,0,0,0,0,0,0,0,0,0,0,0,0,0,0
2318,791961,2,0,1,0,1,0,0,0,0,0,0,0,0,0,0,0,0
2318,786792,10,0,1,0,1,0,0,0,0,0,2,1,2,1,0,0,0
2318,796876,6,0,3,0,0,0,3,0,0,0,0,0,1,0,0,0,0
2318,781456,17,1,8,1,6,0,2,0,0,0,3,1,0,0,1,0,2
2318,781497,18,4,7,4,7,0,0,1,1,1,1,0,3,0,1,2,9
2319,781332,22,2,3,1,1,1,2,0,2,0,1,3,4,0,4,0,5
2319,791960,36,7,9,4,4,3,5,2,2,0,7,5,2,1,2,0,19
2319,776174,25,7,14,7,14,0,0,0,0,0,9,2,0,2,3,0,14
2319,791958,37,7,11,6,9,1,2,4,5,3,3,3,1,0,0,0,19
2319,785861,2,0,0,0,0,0,0,0,0,0,0,0,0,0,0,0,0
2319,786063,2,0,1,0,1,0,0,0,0,0,0,0,1,0,0,1,0
2319,786059,31,8,14,7,11,1,3,1,1,1,5,2,1,0,0,1,18
2319,797706,3,0,0,0,0,0,0,0,0,0,1,0,0,0,0,0,0
2319,781334,16,3,7,2,3,1,4,0,0,1,5,1,2,0,2,0,7
2319,797704,22,4,6,1,2,3,4,0,0,0,3,2,1,2,0,0,11
2319,791957,1,0,0,0,0,0,0,0,0,0,0,0,0,0,0,0,0
2319,791959,3,0,0,0,0,0,0,0,0,0,0,0,0,0,1,0,0
2320,786861,26,4,6,1,2,3,4,0,1,0,1,3,1,0,2,0,11
2320,796870,5,1,3,1,3,0,0,0,0,2,0,0,0,0,0,0,2
2320,780387,34,3,7,3,6,0,1,3,6,4,4,2,4,2,3,0,9
2320,767033,30,4,9,1,5,3,4,4,4,1,5,1,2,3,3,0,15
2320,792415,36,3,9,3,6,0,3,2,2,0,3,3,2,2,6,0,8
2320,792416,16,2,4,2,3,0,1,0,0,1,1,0,0,0,0,0,4
2320,792417,27,2,7,2,4,0,3,1,3,2,6,0,3,1,2,1,5
2320,786867,18,2,4,0,0,2,4,0,0,0,3,2,0,0,3,0,6
2320,786866,8,1,1,0,0,1,1,0,0,0,0,0,0,0,0,0,3
2321,786371,33,3,10,2,6,1,4,1,2,3,7,2,3,1,3,5,8
2321,797072,33,4,9,1,1,3,8,2,2,2,0,4,3,2,4,0,13
2321,791559,26,2,6,0,0,2,6,0,2,0,1,2,2,1,2,0,6
2321,797074,32,6,12,4,5,2,7,0,0,1,3,2,3,3,0,1,14
2321,786369,25,3,4,3,3,0,1,0,2,2,3,2,1,1,4,0,6
2321,786373,5,0,1,0,1,0,0,0,0,0,0,0,0,0,0,0,0
2321,791555,4,1,4,1,4,0,0,0,0,0,1,0,1,0,0,0,2
2321,797073,7,1,2,1,2,0,0,0,0,1,1,1,0,0,0,0,2
2321,791556,11,1,3,1,1,0,2,0,0,0,2,2,0,0,0,0,2
2321,791554,3,0,0,0,0,0,0,0,0,1,0,0,0,1,2,0,0
2321,786372,8,2,3,2,2,0,1,0,0,0,0,0,2,0,0,0,4
2321,797076,4,0,1,0,0,0,1,0,0,0,0,0,0,0,0,0,0
2321,791558,9,1,1,0,0,1,1,0,0,0,3,1,2,0,1,0,3
2322,792269,26,2,3,1,2,1,1,0,0,0,3,1,3,0,2,1,5
2322,792270,27,2,7,0,2,2,5,1,2,2,2,2,1,2,0,0,7
2322,790940,38,8,12,3,4,5,8,0,0,1,5,3,1,0,0,0,21
2322,786060,35,6,14,2,8,4,6,2,2,0,2,5,1,2,1,0,18
2322,780770,32,3,10,1,6,2,4,3,4,1,1,5,1,1,0,0,11
2322,792271,3,1,2,1,2,0,0,0,0,0,0,0,1,0,0,0,2
2322,798028,23,1,2,1,2,0,0,4,5,3,3,4,2,0,2,0,6
2322,791686,14,1,4,1,2,0,2,5,6,1,3,0,4,0,1,2,7
2322,798022,2,0,1,0,0,0,1,0,0,0,0,0,0,0,0,0,0
2323,796637,15,2,2,2,2,0,0,0,0,1,1,1,0,0,2,0,4
2323,792632,20,1,1,1,1,0,0,0,2,1,3,4,1,0,1,1,2
2323,792626,29,0,2,0,1,0,1,2,2,0,2,5,2,0,4,0,2
2323,781491,36,6,11,2,5,4,6,2,3,0,5,3,3,0,0,1,18
2323,780250,39,5,10,1,3,4,7,2,2,0,9,2,0,1,2,1,16
2323,792627,21,5,12,5,10,0,2,0,0,2,1,0,3,0,2,0,10
2323,781289,3,0,0,0,0,0,0,0,0,0,0,0,2,0,1,1,0
2323,792629,21,1,2,0,0,1,2,3,4,0,1,1,3,0,2,0,6
2323,796634,16,2,5,2,5,0,0,3,3,2,2,0,3,0,2,0,7
2324,786123,31,6,11,6,11,0,0,2,2,3,9,2,3,0,3,2,14
2324,797673,32,3,13,1,7,2,6,0,0,1,8,2,3,0,3,0,8
2324,786118,37,5,10,2,6,3,4,2,2,4,4,3,0,1,1,1,15
2324,786117,34,6,12,5,8,1,4,3,5,0,4,9,2,0,1,0,16
2324,780437,27,4,6,4,6,0,0,1,2,2,3,2,3,2,1,1,9
2324,797675,9,2,3,2,3,0,0,0,0,0,1,0,3,1,1,0,4
2324,792094,13,2,7,2,7,0,0,2,2,0,2,0,2,0,0,0,6
2324,797672,3,0,1,0,1,0,0,0,0,0,0,0,1,0,0,0,0
2324,792093,14,2,4,1,2,1,2,0,0,0,1,1,1,0,1,0,5
2325,781425,33,6,10,6,10,0,0,3,8,4,9,0,0,0,0,2,15
2325,797000,16,0,5,0,1,0,4,0,0,0,3,0,2,0,0,0,0
2325,791343,31,2,6,2,4,0,2,1,1,0,3,6,3,1,2,0,5
2325,781602,39,9,19,3,9,6,10,4,5,1,1,3,2,2,3,0,28
2325,775746,33,2,10,0,1,2,9,3,5,1,1,2,2,1,1,0,9
2325,791344,24,1,2,1,2,0,0,0,1,1,6,0,3,0,3,1,2
2325,781601,7,2,3,2,3,0,0,0,0,0,1,0,2,0,0,0,4
2325,797001,8,0,2,0,0,0,2,1,2,0,1,0,0,0,0,0,1
2325,786611,9,2,4,1,1,1,3,0,0,0,0,2,0,0,1,0,5
2326,797222,15,1,2,1,2,0,0,1,2,1,4,0,5,0,2,1,3
2326,781526,19,0,0,0,0,0,0,2,4,1,3,1,5,0,3,1,2
2326,797219,25,3,11,3,8,0,3,0,1,0,3,0,5,0,3,0,6
2326,797218,35,5,14,5,11,0,3,5,8,3,4,2,3,0,2,1,15
2326,775697,37,6,11,3,5,3,6,2,5,3,5,2,3,0,2,0,17
2326,797217,26,3,6,3,5,0,1,6,8,1,3,3,2,1,2,1,12
2326,797223,21,2,3,2,3,0,0,0,0,4,3,0,5,2,1,0,4
2326,791846,19,1,6,1,6,0,0,2,2,1,1,0,0,1,1,0,4
2326,797221,2,0,0,0,0,0,0,0,0,0,0,0,1,1,0,0,0
2326,791453,1,0,0,0,0,0,0,0,0,0,0,0,1,0,0,0,0
2327,790856,28,5,8,5,8,0,0,4,6,5,3,1,2,0,0,2,14
2327,780452,26,5,7,5,6,0,1,1,3,2,4,1,4,1,3,1,11
2327,796409,17,1,6,0,2,1,4,0,1,0,0,1,2,0,0,0,3
2327,796408,30,4,14,4,9,0,5,3,3,0,0,6,4,0,2,0,11
2327,796407,32,1,7,1,4,0,3,4,6,1,5,0,3,1,0,0,6
2327,796410,21,3,8,3,7,0,1,1,4,6,5,2,3,0,2,0,7
2327,780450,24,2,6,1,3,1,3,1,2,1,3,2,4,0,1,0,6
2327,796413,15,3,3,0,0,3,3,4,4,0,0,1,1,0,2,0,13
2327,796411,2,1,1,1,1,0,0,0,0,0,1,0,1,0,0,0,2
2327,775941,0,0,0,0,0,0,0,0,0,0,0,0,0,0,0,0,0
2327,796412,5,1,1,1,1,0,0,0,0,0,1,0,1,0,0,0,2
2327,781286,0,0,0,0,0,0,0,0,0,0,0,0,0,0,0,0,0
2327,796414,0,0,0,0,0,0,0,0,0,0,0,0,0,0,0,0,0
2328,780107,34,1,8,1,8,0,0,0,0,0,3,1,2,1,4,2,2
2328,775833,26,4,5,4,5,0,0,0,2,1,4,1,4,1,2,0,8
2328,781036,38,7,12,3,6,4,6,5,7,0,4,4,1,0,2,0,23
2328,775571,35,8,13,7,9,1,4,4,7,1,1,4,2,5,6,0,21
2328,774894,39,3,5,0,1,3,4,2,2,0,4,0,2,0,1,0,11
2328,785439,8,0,0,0,0,0,0,0,0,0,1,1,0,0,1,0,0
2328,796846,15,0,1,0,0,0,1,0,0,0,0,0,2,1,1,0,0
2328,791178,5,0,1,0,1,0,0,0,0,0,1,0,1,0,0,0,0
2329,786447,21,5,8,5,7,0,1,2,4,2,1,1,5,1,2,0,12
2329,775074,30,4,7,4,7,0,0,0,0,3,5,3,4,0,3,1,8
2329,786448,37,3,7,1,3,2,4,1,2,2,12,1,3,2,2,2,9
2329,780731,27,3,9,1,5,2,4,2,2,0,2,0,1,0,2,0,10
2329,780462,35,4,16,2,7,2,9,2,3,1,1,1,2,1,3,0,12
2329,791632,10,1,3,0,2,1,1,0,0,0,1,0,1,0,0,0,3
2329,786132,15,3,6,3,5,0,1,0,0,3,1,1,0,0,2,1,6
2329,791631,10,0,1,0,0,0,1,0,0,0,0,2,1,0,1,0,0
2329,796971,10,0,1,0,1,0,0,0,0,0,0,0,2,0,1,0,0
2329,791630,4,1,1,1,1,0,0,0,1,1,2,0,0,0,1,0,2
2329,775121,1,0,0,0,0,0,0,0,0,0,0,0,1,0,0,0,0
2330,776018,25,10,12,10,12,0,0,2,4,5,4,2,4,1,5,0,22
2330,797859,26,2,6,2,3,0,3,2,2,0,5,3,1,1,3,0,6
2330,792208,27,8,13,7,12,1,1,7,12,1,9,4,4,0,4,2,24
2330,786262,32,3,6,0,1,3,5,5,5,0,3,2,2,1,1,0,14
2330,781314,30,3,7,2,3,1,4,2,2,1,2,12,3,3,2,0,9
2330,797863,8,3,4,3,4,0,0,0,0,1,4,0,1,0,1,0,6
2330,797858,4,0,0,0,0,0,0,0,0,0,0,0,1,0,0,0,0
2330,797856,14,0,1,0,0,0,1,3,4,0,3,1,0,0,2,0,3
2330,792206,4,0,0,0,0,0,0,1,5,0,1,0,0,0,0,0,1
2330,786682,8,1,2,0,0,1,2,0,0,0,0,0,1,0,0,0,3
2330,781317,22,4,5,1,2,3,3,0,1,1,1,1,2,0,1,0,11
2332,797367,18,4,6,4,6,0,0,0,0,3,2,2,1,1,0,1,8
2332,797369,35,1,7,1,3,0,4,0,0,0,3,4,2,2,1,2,2
2332,797366,12,0,0,0,0,0,0,0,0,0,1,1,4,1,4,0,0
2332,791807,34,8,15,4,7,4,8,1,3,1,6,0,1,3,1,0,21
2332,786130,30,10,15,9,12,1,3,3,4,1,6,3,0,2,5,0,24
2332,797364,21,2,5,2,5,0,0,0,0,0,3,0,2,0,2,2,4
2332,797365,15,4,6,0,0,4,6,0,0,0,1,4,2,0,0,0,12
2332,797363,31,3,7,2,4,1,3,4,6,0,2,5,2,0,1,0,11
2332,791805,3,0,0,0,0,0,0,0,0,0,0,1,0,0,0,0,0
2332,791804,1,0,0,0,0,0,0,0,0,0,0,0,0,0,0,0,0
2333,791839,25,5,9,5,9,0,0,0,0,6,2,3,0,2,3,1,10
2333,776341,21,1,4,1,3,0,1,0,0,0,3,1,2,2,2,0,2
2333,786736,16,0,2,0,1,0,1,0,0,1,2,2,1,0,4,0,0
2333,792381,27,4,9,1,3,3,6,0,0,0,4,3,2,0,3,0,11
2333,786616,33,6,15,5,11,1,4,2,2,1,3,5,1,1,1,1,15
2333,797444,19,1,3,0,0,1,3,1,2,1,1,6,2,0,1,0,4
2333,785322,15,2,3,1,1,1,2,0,0,0,2,0,0,0,1,0,5
2333,797442,4,0,0,0,0,0,0,0,0,0,3,0,1,0,0,0,0
2333,791842,24,7,15,4,8,3,7,0,0,0,5,0,0,0,1,0,17
2333,786613,16,2,3,2,2,0,1,1,3,1,0,1,3,0,2,0,5
2334,781208,19,1,6,1,4,0,2,4,4,2,4,0,3,0,2,0,6
2334,775489,19,3,7,3,7,0,0,2,2,1,4,0,2,1,0,1,8
2334,785561,17,5,7,5,7,0,0,2,2,0,2,0,1,2,3,0,12
2334,780313,26,6,10,5,6,1,4,0,2,1,3,5,3,1,1,0,13
2334,780766,17,2,4,1,2,1,2,1,2,0,3,4,0,1,1,0,6
2334,780758,11,3,4,3,4,0,0,2,2,0,1,0,1,0,1,0,8
2334,796751,11,4,4,4,4,0,0,1,1,3,4,0,1,0,1,1,9
2334,791087,12,1,4,1,3,0,1,0,0,0,3,0,0,1,1,0,2
2334,796750,9,2,3,0,0,2,3,0,0,0,0,0,1,0,0,0,6
2334,796749,6,0,1,0,1,0,0,0,0,0,0,0,3,0,0,0,0
2334,796748,8,1,3,0,2,1,1,0,0,0,2,0,0,0,3,0,3
2334,791088,14,3,4,2,3,1,1,2,2,0,1,0,1,0,1,0,9
2334,785560,14,1,3,0,1,1,2,0,0,0,6,4,1,1,0,1,3
2334,785563,17,3,5,2,3,1,2,0,0,1,7,4,1,1,0,0,7
2336,790821,33,5,10,5,9,0,1,8,8,1,9,1,3,1,2,3,18
2336,775585,20,0,3,0,3,0,0,2,4,2,6,0,3,1,4,1,2
2336,790822,35,9,18,6,11,3,7,4,5,4,5,1,1,0,2,0,25
2336,790820,27,2,7,1,2,1,5,0,0,2,2,3,4,1,1,0,5
2336,780982,20,1,4,1,3,0,1,2,2,0,0,0,4,0,2,0,4
2336,796380,26,3,5,2,3,1,2,5,6,1,4,2,3,1,4,0,12
2336,780445,4,0,2,0,2,0,0,0,0,2,0,1,1,0,0,0,0
2336,796381,29,3,9,2,6,1,3,0,0,5,3,0,1,0,1,1,7
2336,785365,5,0,2,0,1,0,1,0,0,0,0,1,0,0,0,0,0
2336,775634,1,0,0,0,0,0,0,0,0,0,0,0,0,0,0,0,0
2337,797258,4,0,1,0,1,0,0,0,0,0,0,0,1,0,0,0,0
2337,786080,21,7,10,2,2,5,8,0,0,1,1,0,5,0,2,1,19
2337,791348,36,4,7,4,7,0,0,0,0,1,4,5,1,1,3,0,8
2337,786218,35,3,6,1,1,2,5,0,1,0,4,0,1,1,2,0,8
2337,780150,7,0,2,0,0,0,2,0,0,0,0,1,2,1,0,0,0
2337,791350,32,3,7,0,0,3,7,0,0,0,3,1,2,2,0,0,9
2337,797257,9,1,4,1,4,0,0,0,2,2,0,0,1,1,0,1,2
2337,780663,30,2,15,2,10,0,5,0,1,0,4,6,3,0,3,0,4
2337,780156,7,0,1,0,0,0,1,0,0,0,0,1,0,0,0,0,0
2337,786216,19,5,5,5,5,0,0,4,6,0,2,0,5,0,0,0,14
2338,789066,33,7,13,3,6,4,7,6,8,0,8,3,2,3,1,0,24
2338,790232,29,6,8,6,8,0,0,5,6,0,3,3,4,1,0,0,17
2338,776278,26,3,4,0,0,3,4,0,0,1,1,2,0,2,0,0,9
2338,780614,28,3,9,3,6,0,3,0,1,1,2,2,2,1,2,0,6
2338,780093,14,0,1,0,1,0,0,1,3,3,1,0,3,0,2,1,1
2338,780255,25,6,8,6,8,0,0,1,1,2,2,2,3,0,1,0,13
2338,792411,17,2,4,0,0,2,4,0,0,0,1,1,0,0,0,0,6
2338,786463,7,1,1,1,1,0,0,2,2,0,1,0,0,0,1,0,4
2338,785806,21,0,2,0,1,0,1,1,2,0,0,0,4,0,0,0,1
2339,781257,32,6,9,2,3,4,6,2,2,2,3,2,2,0,2,0,18
2339,786620,35,2,9,0,2,2,7,2,2,1,2,3,1,0,2,0,8
2339,791838,26,2,6,1,3,1,3,2,3,2,5,1,0,0,4,0,7
2339,796955,12,1,1,1,1,0,0,1,2,1,2,0,4,1,1,0,3
2339,781606,27,1,5,1,4,0,1,0,2,1,0,2,4,2,2,0,2
2339,796954,23,5,6,1,1,4,5,2,2,1,2,4,2,1,1,0,16
2339,791257,19,2,8,2,8,0,0,1,4,2,4,2,4,0,0,0,5
2339,796956,2,1,1,1,1,0,0,0,0,0,0,0,0,0,0,0,2
2339,780900,18,0,2,0,2,0,0,0,2,3,2,1,4,1,1,1,0
2339,781263,6,0,1,0,1,0,0,0,0,0,0,0,1,0,0,0,0
2340,796372,19,2,3,2,3,0,0,0,1,1,0,0,4,0,0,0,4
2340,796377,28,5,11,2,6,3,5,1,3,0,0,3,0,2,4,0,14
2340,796379,29,2,5,2,4,0,1,0,0,2,3,5,2,1,0,0,4
2340,780176,30,2,7,2,4,0,3,1,2,2,4,3,2,1,4,0,5
2340,790815,31,3,10,2,5,1,5,1,2,2,2,4,1,2,1,0,8
2340,790814,22,9,9,8,8,1,1,4,7,4,2,0,2,0,2,0,23
2340,796378,19,3,7,2,3,1,4,0,0,0,0,3,1,0,2,0,7
2340,796376,6,1,2,1,1,0,1,0,0,0,0,0,1,0,0,0,2
2340,796375,14,1,4,1,4,0,0,0,0,0,2,0,0,1,0,0,2
2340,796373,1,0,1,0,0,0,1,0,0,0,0,0,0,0,0,0,0
2340,790817,1,0,0,0,0,0,0,0,0,0,0,0,0,0,0,0,0
2341,785298,18,1,1,1,1,0,0,1,3,6,1,1,2,0,3,0,3
2341,775224,19,3,4,3,4,0,0,1,2,2,0,0,2,2,1,0,7
2341,778046,30,4,8,2,2,2,6,4,6,0,5,13,1,1,1,1,14
2341,782121,32,7,12,1,2,6,10,0,0,0,3,3,3,2,4,0,20
2341,775793,37,8,14,3,5,5,9,2,3,4,6,2,0,1,1,0,23
2341,785485,24,6,10,6,10,0,0,1,2,3,1,1,2,2,0,0,13
2341,796598,19,3,5,1,1,2,4,0,0,0,1,3,0,1,1,0,8
2341,785302,16,3,8,3,5,0,3,2,2,1,4,1,2,0,1,0,8
2341,796599,3,1,1,1,1,0,0,0,0,0,2,0,2,0,0,0,2
2341,778469,1,1,1,1,1,0,0,0,0,0,1,0,0,0,0,0,2
2341,785301,1,0,0,0,0,0,0,0,0,0,0,0,0,0,0,0,0
2342,785409,19,4,5,4,5,0,0,2,2,2,4,1,4,0,3,2,10
2342,785408,34,7,12,6,9,1,3,4,4,2,5,5,3,0,3,0,19
2342,780539,30,2,6,1,2,1,4,0,0,0,1,2,1,1,0,0,5
2342,780560,27,2,7,1,2,1,5,0,1,1,3,1,0,2,3,0,5
2342,776484,33,6,13,6,9,0,4,0,1,1,6,4,3,4,3,0,12
2342,796415,18,3,5,1,3,2,2,0,0,0,5,2,3,2,3,0,8
2342,796417,10,0,1,0,1,0,0,0,0,0,0,0,1,0,2,0,0
2342,790861,22,2,7,2,6,0,1,1,2,2,2,0,2,0,1,0,5
2342,796419,7,2,2,2,2,0,0,1,2,0,1,0,2,0,1,1,5
2343,791062,31,4,10,4,8,0,2,2,4,0,2,2,4,1,3,0,10
2343,791063,23,4,8,3,6,1,2,0,0,0,3,3,2,1,0,1,9
2343,785542,24,2,2,2,2,0,0,3,3,0,1,2,2,2,1,0,7
2343,780743,36,2,5,2,3,0,2,0,1,0,5,1,1,0,7,0,4
2343,780055,24,1,5,0,0,1,5,1,2,0,2,0,0,0,1,0,4
2343,796735,21,4,5,4,5,0,0,2,3,0,4,0,3,1,2,0,10
2343,791060,20,1,5,1,3,0,2,2,3,0,2,3,3,0,3,1,4
2343,791064,16,0,4,0,0,0,4,0,0,1,2,1,2,0,1,0,0
2343,796741,2,0,1,0,1,0,0,0,0,0,0,0,0,0,1,0,0
2343,796736,2,1,2,1,2,0,0,0,0,0,0,0,0,0,0,0,2
2343,796737,1,0,0,0,0,0,0,0,0,0,0,0,0,0,0,0,0
2344,780792,29,6,10,5,7,1,3,5,7,0,1,1,2,2,2,1,18
2344,797215,26,4,7,2,4,2,3,2,2,0,2,2,1,1,2,0,12
2344,786295,36,2,9,2,3,0,6,0,0,2,4,2,3,2,3,1,4
2344,780122,18,2,5,2,5,0,0,0,1,0,5,0,2,0,1,0,4
2344,775598,12,1,5,1,1,0,4,0,0,0,2,0,2,1,1,0,2
2344,791460,22,5,8,3,5,2,3,4,4,0,4,3,1,1,0,0,16
2344,791461,20,4,4,3,3,1,1,0,2,1,2,2,4,0,2,0,9
2344,797214,26,2,5,2,5,0,0,2,2,0,4,5,1,1,2,0,6
2344,797216,7,0,2,0,2,0,0,0,0,1,2,0,1,0,0,1,0
2344,791459,4,0,2,0,1,0,1,0,0,0,0,0,0,0,1,0,0
2345,781054,35,6,16,3,7,3,9,2,4,0,1,4,1,1,1,0,17
2345,791181,33,4,6,2,3,2,3,1,3,1,6,0,2,2,1,0,11
2345,774969,29,2,5,2,5,0,0,5,6,1,6,3,1,0,4,2,9
2345,781053,38,3,9,3,6,0,3,2,2,0,3,5,3,1,4,0,8
2345,785670,20,2,4,0,1,2,3,1,2,1,2,0,3,1,4,0,7
2345,791179,16,2,4,0,0,2,4,1,2,0,0,1,5,1,0,0,7
2345,796850,21,1,5,1,4,0,1,0,0,1,5,1,2,0,3,1,2
2345,780981,6,0,0,0,0,0,0,0,1,0,2,0,0,0,0,0,0
2345,796848,2,0,0,0,0,0,0,0,0,0,0,0,1,0,0,0,0
2345,796849,0,0,2,0,2,0,0,0,0,1,0,0,0,0,0,0,0
2345,785672,0,0,0,0,0,0,0,0,0,0,0,0,0,0,0,0,0
2346,785930,11,3,5,3,5,0,0,2,2,1,1,0,4,0,1,0,8
2346,780996,32,4,13,3,8,1,5,3,4,4,10,1,1,0,2,1,12
2346,780995,24,3,4,0,0,3,4,1,2,0,4,3,4,2,2,0,10
2346,796468,32,4,9,3,6,1,3,2,4,3,1,4,0,2,2,2,11
2346,790920,37,4,12,4,11,0,1,10,13,3,4,5,1,0,4,0,18
2346,785492,15,1,5,1,2,0,3,4,5,0,2,1,0,0,1,0,6
2346,785461,10,1,2,1,2,0,0,0,0,1,2,0,4,0,2,0,2
2346,775709,25,1,4,0,0,1,4,0,0,0,5,2,3,1,0,0,3
2346,796466,12,1,1,1,1,0,0,0,0,2,1,0,2,0,1,2,2
2346,796467,2,0,0,0,0,0,0,0,0,0,0,0,0,0,0,0,0
2347,791709,9,1,3,1,3,0,0,0,0,2,1,0,1,0,0,0,2
2347,785845,32,4,8,4,8,0,0,0,1,1,5,2,4,0,3,0,8
2347,780578,20,3,9,2,5,1,4,1,2,2,2,0,2,2,0,0,8
2347,785847,8,0,2,0,1,0,1,0,0,0,0,0,5,0,0,0,0
2347,780579,40,6,23,4,19,2,4,4,4,1,3,0,1,2,1,0,18
2347,785843,12,0,2,0,0,0,2,0,0,0,0,0,2,0,0,0,0
2347,785293,31,2,9,2,6,0,3,3,4,1,4,6,3,1,1,0,7
2347,797536,19,2,4,1,2,1,2,1,1,0,2,1,1,0,0,0,6
2347,797538,21,5,6,4,4,1,2,0,0,0,2,1,3,0,3,0,11
2347,791712,0,0,0,0,0,0,0,0,0,0,0,0,0,0,1,0,0
2347,797537,8,0,1,0,1,0,0,0,0,0,1,0,0,0,1,0,0
2348,775926,27,6,8,1,2,5,6,2,3,0,1,0,0,0,0,0,19
2348,791055,27,5,5,5,5,0,0,0,0,0,6,8,2,2,1,0,10
2348,775573,25,7,14,3,6,4,8,5,6,0,2,1,1,0,3,0,23
2348,791058,22,3,4,3,4,0,0,2,2,2,4,2,3,2,0,0,8
2348,785532,26,3,5,3,4,0,1,1,3,1,6,1,2,1,1,0,7
2348,791057,15,1,1,1,1,0,0,1,1,0,0,4,4,0,2,2,3
2348,791059,8,1,1,1,1,0,0,2,2,0,4,0,5,0,3,0,4
2348,791280,18,3,7,3,5,0,2,0,0,0,1,3,1,1,2,0,6
2348,796733,12,1,2,1,2,0,0,1,2,0,1,0,1,0,0,0,3
2348,796734,6,1,2,1,2,0,0,0,0,0,1,0,0,2,0,0,2
2348,791056,10,0,0,0,0,0,0,2,3,0,2,0,2,0,1,0,2
2348,785538,2,0,2,0,2,0,0,0,0,0,0,0,0,0,0,0,0
2348,791054,2,0,0,0,0,0,0,0,0,0,0,0,0,0,0,0,0
2349,791171,16,1,3,1,3,0,0,0,2,1,2,0,1,0,1,0,2
2349,791170,27,3,10,1,6,2,4,0,0,0,5,0,0,0,2,0,8
2349,780269,27,3,7,2,5,1,2,6,6,1,0,3,0,2,4,0,13
2349,785700,25,1,3,0,1,1,2,0,0,0,1,1,1,0,0,0,3
2349,796837,23,3,7,2,3,1,4,0,0,0,2,2,3,0,2,0,7
2349,780194,14,1,4,1,4,0,0,2,3,0,0,1,1,0,1,0,4
2349,796834,18,1,3,1,3,0,0,0,0,0,0,2,2,0,2,0,2
2349,796838,17,2,5,2,5,0,0,3,6,1,6,0,5,2,0,0,7
2349,796833,13,2,6,0,1,2,5,4,4,0,0,1,1,0,3,0,10
2349,785706,9,0,1,0,1,0,0,0,0,1,0,0,1,0,0,0,0
2349,796832,6,0,0,0,0,0,0,0,0,0,1,0,1,0,0,0,0
2349,796836,5,0,0,0,0,0,0,0,2,0,1,0,0,0,0,0,0
2350,785693,16,1,6,1,6,0,0,2,2,3,5,0,4,0,2,0,4
2350,780494,20,1,3,1,2,0,1,4,6,1,2,4,1,1,1,2,6
2350,785692,27,1,5,1,4,0,1,2,4,0,0,5,2,0,0,0,4
2350,780496,23,4,9,2,2,2,7,2,2,1,0,0,1,0,3,0,12
2350,780495,25,5,11,4,7,1,4,4,7,0,1,1,1,1,2,0,15
2350,797277,8,0,2,0,2,0,0,2,2,2,1,0,2,0,0,1,2
2350,797274,4,1,1,1,1,0,0,0,0,0,1,0,0,0,0,0,2
2350,797276,14,1,3,1,3,0,0,3,4,1,3,1,2,2,2,1,5
2350,797275,3,0,1,0,0,0,1,0,0,0,0,1,0,0,0,0,0
2350,791643,6,1,3,1,1,0,2,0,0,1,1,0,3,0,0,0,2
2350,785644,20,4,9,2,5,2,4,3,3,0,2,1,3,3,3,0,13
2350,780497,18,1,3,1,3,0,0,3,4,2,3,1,3,1,0,0,5
2350,791645,16,3,6,3,5,0,1,0,0,2,6,0,1,0,0,2,6
2351,792128,32,2,5,2,4,0,1,3,4,1,5,2,3,0,2,0,7
2351,786838,17,4,5,4,4,0,1,5,6,0,1,1,4,0,2,6,13
2351,792132,29,3,6,0,2,3,4,6,8,0,2,4,1,0,1,0,15
2351,792127,27,5,13,2,6,3,7,0,0,1,2,4,3,1,0,0,13
2351,792126,31,4,10,2,5,2,5,3,5,1,6,0,2,1,2,0,13
2351,799273,6,0,0,0,0,0,0,0,2,1,0,0,1,0,1,1,0
2351,792131,23,4,11,3,9,1,2,1,1,4,5,1,5,2,3,0,10
2351,797736,19,2,5,1,2,1,3,0,0,1,4,1,4,0,0,0,5
2351,797739,9,1,3,1,1,0,2,0,0,0,2,1,1,2,0,0,2
2351,791668,7,0,0,0,0,0,0,0,0,0,0,0,0,1,1,0,0
2352,781342,27,4,10,2,8,2,2,2,2,4,3,2,1,1,4,0,12
2352,781593,25,2,4,1,1,1,3,4,4,1,5,0,1,0,4,3,9
2352,790901,27,6,11,1,2,5,9,1,2,0,4,2,1,1,2,0,18
2352,785452,15,1,1,0,0,1,1,2,4,2,2,1,3,0,0,0,5
2352,781620,19,1,3,1,1,0,2,0,0,0,4,5,1,1,4,0,2
2352,790902,19,3,4,1,1,2,3,3,4,0,1,5,4,1,0,0,11
2352,790903,22,6,12,1,1,5,11,1,1,0,1,4,2,0,0,0,18
2352,796450,18,1,3,1,3,0,0,2,5,1,5,0,5,1,3,0,4
2352,774835,4,0,0,0,0,0,0,0,0,0,1,0,0,0,0,0,0
2352,796452,9,3,4,0,1,3,3,0,0,1,0,1,2,0,1,0,9
2352,796449,9,3,4,2,2,1,2,2,2,1,2,0,2,0,0,1,9
2352,790906,3,0,1,0,0,0,1,0,0,0,0,0,0,0,0,0,0
2352,796451,3,0,1,0,1,0,0,0,0,0,1,0,1,0,0,1,0
2353,796817,12,1,2,1,2,0,0,0,0,1,1,0,3,0,1,0,2
2353,791161,23,2,6,1,2,1,4,0,0,2,4,1,2,0,5,0,5
2353,780629,31,2,8,2,6,0,2,0,0,2,5,1,5,4,4,0,4
2353,775888,30,7,15,6,11,1,4,4,9,2,0,2,2,4,2,1,19
2353,796816,25,2,3,1,1,1,2,2,7,0,1,2,0,0,0,0,7
2353,785346,30,1,7,0,0,1,7,1,2,0,4,1,1,2,0,0,4
2353,791159,14,3,6,2,2,1,4,5,6,1,2,0,2,0,1,0,12
2353,796815,15,1,2,1,2,0,0,0,0,0,0,1,0,0,0,0,2
2353,796819,20,1,6,1,3,0,3,0,3,0,0,2,5,1,3,0,2
2354,791997,14,1,5,1,3,0,2,0,0,1,1,0,0,0,1,0,2
2354,791993,28,1,5,1,4,0,1,0,0,0,3,1,0,1,1,0,2
2354,786563,37,4,9,4,7,0,2,0,0,3,4,1,4,1,1,0,8
2354,781189,27,1,5,1,3,0,2,0,0,1,4,3,3,2,2,0,2
2354,781188,37,7,14,4,8,3,6,3,4,0,2,6,3,1,1,0,20
2354,797493,20,6,7,6,7,0,0,4,6,0,2,0,1,2,3,1,16
2354,786566,17,1,7,1,3,0,4,2,2,0,5,1,2,0,2,1,4
2354,797494,18,1,5,1,4,0,1,7,8,0,2,1,4,0,1,1,9
2354,786562,2,0,0,0,0,0,0,0,0,0,0,0,1,0,0,0,0
2355,786704,32,4,13,4,12,0,1,1,2,2,10,1,4,0,0,1,9
2355,785395,23,2,5,2,4,0,1,0,0,0,5,3,3,0,1,0,4
2355,775840,35,4,8,1,2,3,6,4,4,0,2,2,2,1,1,0,15
2355,775955,36,7,11,6,8,1,3,8,9,1,3,8,1,1,3,0,23
2355,775811,10,0,0,0,0,0,0,0,0,1,2,1,1,0,0,0,0
2355,786706,10,1,2,1,2,0,0,1,2,2,1,0,4,0,3,1,3
2355,775287,12,1,4,1,2,0,2,0,0,0,1,0,3,0,2,0,2
2355,790921,17,1,3,1,1,0,2,1,4,1,3,4,2,2,1,0,3
2355,786551,23,5,9,0,1,5,8,1,2,0,3,1,1,2,1,0,16
2355,786703,2,0,0,0,0,0,0,0,0,0,0,0,0,0,0,0,0
2356,792340,23,9,15,9,14,0,1,2,2,8,5,3,0,2,1,1,20
2356,798086,37,6,11,4,8,2,3,0,1,0,4,7,2,0,1,0,14
2356,792344,20,3,7,2,4,1,3,2,2,1,1,3,1,3,1,0,9
2356,792341,12,2,2,1,1,1,1,5,6,1,5,2,3,0,2,0,10
2356,792342,23,5,6,2,2,3,4,1,2,1,0,3,1,2,1,2,14
2356,798080,26,2,7,1,2,1,5,0,1,2,3,2,2,1,1,0,5
2356,798087,12,3,6,3,6,0,0,0,0,1,4,0,2,1,1,2,6
2356,798088,18,0,6,0,3,0,3,0,0,0,3,1,2,0,0,0,0
2356,798091,29,7,8,4,4,3,4,0,0,0,1,3,2,4,1,0,17
2358,796524,14,0,1,0,1,0,0,0,0,0,3,0,5,0,2,1,0
2358,785977,37,4,7,3,5,1,2,5,6,2,2,1,2,1,2,1,14
2358,791265,45,5,9,1,1,4,8,5,7,1,0,4,4,1,2,0,19
2358,791269,26,5,11,0,1,5,10,2,2,0,2,2,5,0,2,0,17
2358,785685,35,6,9,4,7,2,2,8,12,0,2,6,5,2,7,1,22
2358,788872,2,0,0,0,0,0,0,0,1,1,0,0,1,0,1,0,0
2358,796523,32,5,7,1,1,4,6,0,0,0,4,2,0,1,4,0,14
2358,796522,19,1,4,0,0,1,4,0,0,0,1,1,4,0,0,0,3
2358,796525,11,1,3,1,2,0,1,0,0,0,0,1,2,0,2,0,2
2358,791271,17,2,3,2,3,0,0,4,6,3,5,0,3,0,3,1,8
2358,781313,12,0,1,0,1,0,0,0,0,0,0,1,1,0,1,0,0
2359,791312,21,3,4,3,4,0,0,0,0,3,2,1,3,0,1,0,6
2359,785664,11,2,3,2,3,0,0,1,3,2,1,0,3,1,0,0,5
2359,785841,35,3,7,2,3,1,4,2,2,1,6,4,5,1,8,0,9
2359,796609,43,6,14,4,10,2,4,15,16,1,6,3,2,4,3,0,29
2359,781504,34,8,12,6,10,2,2,10,12,2,2,2,5,2,5,1,28
2359,796613,16,1,2,1,1,0,1,0,0,0,0,0,5,0,1,0,2
2359,792232,30,5,9,5,9,0,0,1,2,2,3,1,2,1,1,0,11
2359,796611,30,4,10,3,5,1,5,0,0,2,1,0,2,0,1,1,9
2359,766623,30,1,1,1,1,0,0,0,0,0,1,0,4,0,1,0,2
2359,785840,0,0,0,0,0,0,0,2,4,0,0,0,0,0,0,0,2
2360,786623,18,0,4,0,4,0,0,4,6,2,2,0,4,0,1,0,4
2360,797405,34,7,13,7,12,0,1,6,7,1,7,1,4,0,1,0,20
2360,791833,30,4,8,4,8,0,0,2,4,0,2,0,4,2,4,0,10
2360,785920,40,3,7,3,6,0,1,9,10,1,5,0,4,1,0,0,15
2360,784077,28,2,9,1,7,1,2,0,0,0,4,1,1,1,1,0,5
2360,797413,4,0,1,0,0,0,1,0,0,0,1,1,2,0,1,0,0
2360,786624,22,2,4,2,4,0,0,2,2,4,1,0,4,0,1,1,6
2360,791834,24,2,6,2,2,0,4,0,0,0,0,1,3,0,0,0,4
2361,797163,38,5,7,5,7,0,0,3,7,3,6,1,3,1,4,2,13
2361,791385,24,2,8,1,3,1,5,0,2,0,3,2,5,0,1,0,5
2361,786450,37,3,4,0,0,3,4,0,0,0,3,3,2,1,2,1,9
2361,776396,38,7,9,2,3,5,6,6,8,0,1,1,1,1,2,0,25
2361,776199,39,3,9,1,3,2,6,7,9,1,3,10,3,1,2,0,15
2361,797160,3,0,0,0,0,0,0,0,0,0,0,0,0,0,0,0,0
2361,797164,13,2,5,2,4,0,1,1,2,0,3,1,5,1,1,0,5
2361,797161,2,0,0,0,0,0,0,0,0,0,0,0,1,0,0,0,0
2361,797165,6,0,1,0,0,0,1,0,0,0,0,0,1,0,0,0,0
2361,797166,0,0,0,0,0,0,0,0,0,0,0,0,0,0,0,0,0
2361,797162,0,0,0,0,0,0,0,0,0,0,0,0,0,0,0,0,0
2362,780955,27,5,9,5,7,0,2,1,2,0,2,7,1,1,3,0,11
2362,786287,35,5,13,5,13,0,0,3,6,3,4,4,1,1,3,0,13
2362,797753,35,5,11,2,6,3,5,3,4,0,2,4,3,0,2,0,16
2362,780953,36,8,13,8,12,0,1,5,8,1,6,1,3,2,2,1,21
2362,792143,13,3,4,0,0,3,4,0,0,1,0,0,4,0,0,0,9
2362,786293,15,2,3,2,3,0,0,1,2,2,4,1,3,0,1,1,5
2362,797751,21,1,1,0,0,1,1,0,0,1,0,0,1,0,1,0,3
2362,792147,12,0,1,0,1,0,0,0,0,1,1,0,1,0,1,0,0
2362,786302,6,0,0,0,0,0,0,0,0,0,1,0,2,0,1,0,0
2363,786289,36,9,17,1,4,8,13,3,3,0,1,0,3,1,1,0,29
2363,796332,16,1,3,1,1,0,2,0,0,1,0,0,3,1,1,0,2
2363,785813,39,2,8,1,4,1,4,2,9,0,1,9,2,0,6,0,7
2363,785827,19,2,7,2,7,0,0,3,5,4,3,1,2,0,1,1,7
2363,790776,19,1,1,1,1,0,0,0,1,1,5,0,5,0,1,0,2
2363,796330,15,2,3,1,2,1,1,0,0,0,1,0,2,1,2,0,5
2363,796334,22,3,7,3,5,0,2,4,5,3,3,1,3,1,3,1,10
2363,779975,17,3,3,3,3,0,0,0,0,2,4,1,2,2,0,0,6
2363,796337,17,3,5,2,4,1,1,0,0,0,1,0,4,1,0,0,7
2364,791053,15,5,6,5,6,0,0,0,0,2,0,1,3,1,2,0,10
2364,780739,9,1,1,1,1,0,0,2,3,1,0,0,0,0,1,0,4
2364,785524,16,1,4,1,3,0,1,0,0,3,1,1,1,1,1,0,2
2364,781115,22,2,5,2,5,0,0,0,0,0,5,2,1,2,2,0,4
2364,775094,23,2,6,1,4,1,2,0,0,1,3,1,1,2,3,1,5
2364,796731,13,0,0,0,0,0,0,0,0,0,2,2,2,0,0,0,0
2364,796730,15,2,5,0,1,2,4,0,0,0,0,1,1,0,1,1,6
2364,785784,8,1,1,0,0,1,1,1,2,0,0,1,0,1,0,0,4
2364,791051,13,3,3,3,3,0,0,1,2,2,3,0,1,1,0,1,7
2364,791052,10,1,2,1,2,0,0,0,0,2,0,0,0,1,1,0,2
2364,790819,19,6,11,1,3,5,8,0,0,1,4,5,3,2,3,0,17
2364,786310,18,3,7,2,3,1,4,0,0,0,1,0,0,1,0,0,7
2364,775456,19,9,13,8,11,1,2,0,0,2,2,4,0,1,1,2,19
2366,792183,29,5,10,3,3,2,7,4,5,0,2,5,0,3,3,0,16
2366,792186,24,3,5,3,5,0,0,1,3,4,5,3,2,2,1,0,7
2366,786675,18,5,9,3,4,2,5,0,0,1,1,0,1,1,2,0,12
2366,781490,26,2,7,2,4,0,3,0,0,3,3,3,1,0,2,0,4
2366,781447,17,5,7,5,7,0,0,0,1,2,4,2,3,1,2,0,10
2366,797816,23,6,11,3,4,3,7,2,2,1,2,1,4,2,1,0,17
2366,792185,10,0,3,0,1,0,2,0,0,0,1,1,0,0,0,0,0
2366,780433,9,1,1,1,1,0,0,6,6,0,2,0,1,0,0,1,8
2366,792187,9,1,1,0,0,1,1,0,0,0,0,1,1,0,0,0,3
2366,792188,13,2,3,2,2,0,1,0,0,1,0,2,2,2,2,0,4
2366,797821,13,1,5,1,3,0,2,3,4,1,6,2,1,0,2,1,5
2366,797819,3,0,0,0,0,0,0,0,0,0,0,0,0,0,0,0,0
2366,797820,4,2,3,2,3,0,0,0,0,0,2,0,1,0,1,1,4
2366,796255,2,0,1,0,0,0,1,0,0,0,0,0,0,0,0,0,0
2368,786257,20,2,2,2,2,0,0,0,0,1,3,1,3,1,4,0,4
2368,786263,23,4,5,2,2,2,3,0,0,1,6,2,2,2,1,2,10
2368,797724,24,1,6,1,3,0,3,0,0,1,2,0,0,2,0,1,2
2368,792122,9,3,4,2,2,1,2,0,0,0,3,1,1,0,2,0,7
2368,775825,36,5,14,3,9,2,5,2,2,0,3,6,2,2,3,0,14
2368,797721,6,0,2,0,0,0,2,0,0,0,1,0,2,0,1,0,0
2368,792121,17,1,5,1,1,0,4,0,0,2,3,0,2,0,0,0,2
2368,797725,18,2,4,2,4,0,0,0,0,3,5,1,4,3,0,0,4
2368,792356,2,0,0,0,0,0,0,0,0,0,0,0,0,1,0,0,0
2368,786249,14,2,8,0,1,2,7,0,0,0,1,0,1,0,1,0,6
2368,785661,31,2,10,2,5,0,5,0,0,1,4,3,3,2,1,1,4
2369,791147,22,3,7,2,6,1,1,1,5,1,3,1,0,1,2,1,8
2369,785782,26,0,4,0,0,0,4,0,0,0,1,0,2,0,0,1,0
2369,791145,31,2,6,2,5,0,1,2,2,2,3,0,2,1,4,0,6
2369,791146,33,3,13,3,9,0,4,0,0,0,4,0,0,2,2,0,6
2369,785777,27,2,4,1,3,1,1,0,0,0,4,0,1,2,2,0,5
2369,791144,17,2,8,2,6,0,2,0,1,3,4,0,0,0,2,0,4
2369,796804,18,0,2,0,1,0,1,2,2,1,3,2,2,0,1,0,2
2369,791148,15,0,3,0,3,0,0,2,2,0,1,0,0,0,1,0,2
2369,786748,11,0,1,0,0,0,1,0,0,0,0,1,0,0,2,0,0
2370,791302,31,7,10,6,7,1,3,4,6,0,10,0,3,2,4,1,19
2370,781622,22,1,2,1,1,0,1,0,0,2,2,0,2,0,0,0,2
2370,791309,35,4,14,2,10,2,4,2,2,0,2,7,3,3,6,0,12
2370,785835,28,6,9,6,9,0,0,5,6,4,5,2,2,1,4,0,17
2370,776334,33,6,11,5,7,1,4,5,5,0,2,3,3,3,2,0,18
2370,791301,15,3,5,3,5,0,0,3,4,1,0,0,2,1,2,0,9
2370,775862,16,1,4,1,4,0,0,0,0,1,3,1,2,0,1,0,2
2370,796602,7,1,2,1,2,0,0,0,0,0,1,1,2,0,0,0,2
2370,791304,6,0,1,0,1,0,0,2,2,0,2,0,1,0,0,0,2
2370,796603,5,0,1,0,0,0,1,0,0,0,0,0,2,0,1,0,0
2370,796605,2,0,0,0,0,0,0,0,0,0,1,0,0,0,1,1,0
2371,776069,20,2,4,1,1,1,3,0,0,0,6,0,2,3,1,0,5
2371,781107,19,0,1,0,1,0,0,0,4,4,1,1,1,1,3,0,0
2371,791974,26,3,13,3,8,0,5,2,2,0,2,2,1,2,0,1,8
2371,785366,28,3,9,2,4,1,5,0,0,0,3,1,3,1,3,0,7
2371,780863,23,5,11,5,7,0,4,4,4,2,1,1,5,0,2,0,14
2371,796778,26,5,7,4,6,1,1,0,1,2,4,2,1,2,3,2,11
2371,791971,14,1,6,1,4,0,2,0,1,0,0,0,5,1,2,0,2
2371,791972,23,6,13,5,7,1,6,5,6,5,1,0,2,1,4,1,18
2371,796777,14,0,2,0,0,0,2,0,2,0,0,2,3,1,3,0,0
2371,796781,7,1,1,0,0,1,1,0,0,1,0,0,1,0,1,0,3
2372,781666,32,8,14,5,8,3,6,4,4,1,3,1,3,1,5,0,23
2372,786575,21,2,4,2,4,0,0,0,4,0,7,0,5,0,5,7,4
2372,792338,34,5,10,5,9,0,1,2,2,1,1,2,2,0,2,2,12
2372,792334,28,4,9,3,6,1,3,5,7,2,11,1,3,2,3,0,14
2372,798094,29,0,1,0,0,0,1,0,4,0,1,7,3,0,1,0,0
2372,791636,17,3,7,1,4,2,3,0,1,1,2,0,1,0,1,0,8
2372,798100,3,0,0,0,0,0,0,0,0,0,0,2,0,0,0,0,0
2372,785531,8,0,2,0,0,0,2,0,0,0,2,1,2,0,0,0,0
2372,798095,3,1,2,0,0,1,2,0,0,0,1,1,1,0,0,0,3
2372,798097,19,5,7,5,7,0,0,1,2,1,6,0,4,0,0,0,11
2372,799842,6,0,0,0,0,0,0,0,0,0,0,1,0,0,0,0,0
2373,791608,22,1,5,1,2,0,3,1,2,0,1,0,1,0,0,0,3
2373,780471,31,5,13,5,12,0,1,7,9,2,10,2,3,0,1,0,17
2373,796994,22,1,4,1,3,0,1,0,0,0,2,0,2,1,0,0,2
2373,776011,30,4,11,4,9,0,2,1,4,2,3,3,3,2,3,0,9
2373,791610,25,2,4,2,4,0,0,2,2,2,1,2,5,2,1,0,6
2373,786413,2,0,1,0,1,0,0,0,0,0,0,0,0,0,0,0,0
2373,791613,26,5,14,5,10,0,4,4,7,0,3,1,3,1,2,0,14
2373,785680,22,2,6,0,2,2,4,0,0,1,7,0,2,1,0,1,6
2373,796996,20,3,5,3,5,0,0,2,2,1,1,0,2,0,0,0,8
2374,781300,27,5,7,3,5,2,2,2,2,0,3,2,4,2,1,0,14
2374,790803,14,1,1,1,1,0,0,4,6,0,1,0,2,0,1,1,6
2374,796360,29,3,8,2,5,1,3,1,3,1,2,3,2,1,1,0,8
2374,781304,37,6,13,2,6,4,7,6,8,1,2,2,2,1,2,1,22
2374,781302,31,5,8,2,4,3,4,1,2,4,2,1,3,0,3,0,14
2374,781305,15,1,6,1,2,0,4,0,0,0,2,1,1,1,0,0,2
2374,780598,13,0,0,0,0,0,0,0,0,2,3,0,2,0,1,0,0
2374,796364,5,0,0,0,0,0,0,0,0,0,0,0,0,0,1,1,0
2374,796363,8,1,3,1,1,0,2,2,2,0,0,0,1,0,0,0,4
2374,790801,15,1,4,1,3,0,1,0,0,0,1,2,3,0,3,0,2
2374,796362,2,1,1,1,1,0,0,0,1,0,0,0,0,0,0,0,2
2374,781306,4,0,0,0,0,0,0,0,2,0,0,0,1,0,1,0,0
2375,790846,28,2,8,2,8,0,0,0,0,1,2,1,2,1,2,3,4
2375,796754,37,6,11,5,8,1,3,9,12,4,4,2,4,3,3,0,22
2375,791099,30,6,12,0,3,6,9,2,2,1,2,0,0,0,4,0,20
2375,785470,33,10,13,8,9,2,4,10,10,2,4,2,3,0,1,0,32
2375,785586,32,1,4,1,2,0,2,0,0,0,5,4,3,1,2,0,2
2375,780298,18,2,6,2,5,0,1,2,2,0,0,0,3,1,1,0,6
2375,780814,1,0,0,0,0,0,0,0,0,0,0,0,1,0,0,0,0
2375,780315,19,0,0,0,0,0,0,0,0,1,2,2,5,0,0,0,0
2375,780795,2,0,0,0,0,0,0,0,0,0,1,0,0,0,0,0,0
2376,796882,27,2,6,2,4,0,2,2,6,0,3,5,0,2,3,0,6
2376,790447,26,4,6,4,6,0,0,1,2,0,1,5,2,0,0,0,9
2376,796884,25,6,8,6,6,0,2,2,8,0,1,3,2,3,0,0,14
2376,796886,24,6,8,5,6,1,2,1,5,1,11,1,1,1,3,0,14
2376,796891,19,4,9,4,8,0,1,0,0,3,4,3,1,1,1,0,8
2376,796881,11,0,0,0,0,0,0,2,2,0,3,3,0,0,0,0,2
2376,776336,14,3,4,1,1,2,3,0,0,0,1,2,0,1,0,0,8
2376,796888,11,1,4,0,2,1,2,0,0,0,1,0,2,0,2,0,3
2376,796889,8,0,0,0,0,0,0,0,0,0,2,0,1,0,0,0,0
2376,796892,10,3,3,3,3,0,0,4,4,1,2,0,4,0,2,0,10
2376,796894,4,1,1,1,1,0,0,0,0,0,0,0,0,0,0,0,2
2376,796896,21,6,8,5,5,1,3,1,1,1,2,3,1,1,2,0,14
2382,781480,20,2,5,1,3,1,2,0,0,0,4,1,1,0,4,0,5
2382,774846,32,8,14,8,14,0,0,2,2,3,5,0,2,0,0,4,18
2382,797182,21,1,2,1,2,0,0,1,2,1,2,0,1,1,4,0,3
2382,786558,39,2,8,1,4,1,4,1,2,1,5,5,3,1,4,1,6
2382,766611,35,6,12,4,7,2,5,2,2,1,8,0,3,0,3,1,16
2382,797181,8,1,2,1,2,0,0,4,4,0,1,0,0,0,0,0,6
2382,786185,3,0,1,0,1,0,0,0,0,0,2,0,0,1,0,0,0
2382,797183,8,1,1,1,1,0,0,2,2,2,1,0,4,0,1,0,4
2382,797272,11,0,2,0,0,0,2,0,0,0,0,0,0,0,1,0,0
2382,797273,22,1,2,1,2,0,0,0,1,0,3,2,1,1,1,0,2
2382,791377,1,0,0,0,0,0,0,0,0,0,0,0,0,0,0,0,0
2383,789177,35,6,10,6,10,0,0,3,4,4,3,0,3,1,2,1,15
2383,775758,24,0,5,0,5,0,0,0,0,2,4,0,2,0,0,0,0
2383,791336,30,3,12,3,12,0,0,1,2,1,5,3,1,1,3,0,7
2383,791340,18,0,5,0,4,0,1,2,2,0,0,0,1,2,1,0,2
2383,780181,38,4,18,2,10,2,8,8,8,1,5,3,2,2,3,1,18
2383,797262,14,0,1,0,1,0,0,1,2,2,3,0,3,0,1,0,1
2383,797264,13,1,5,1,3,0,2,0,0,0,0,1,0,1,0,0,2
2383,789178,13,0,1,0,0,0,1,0,1,0,0,0,1,1,1,0,0
2383,776089,2,0,0,0,0,0,0,0,0,0,0,0,1,0,0,0,0
2383,797260,13,0,1,0,1,0,0,0,0,2,0,0,4,0,1,0,0
2384,796759,23,5,5,5,5,0,0,3,5,4,9,0,3,0,1,0,13
2384,796758,24,4,7,4,7,0,0,5,8,2,7,3,1,0,3,0,13
2384,791101,20,5,14,3,9,2,5,3,3,2,6,1,3,3,3,0,15
2384,791105,22,1,2,1,1,0,1,1,2,0,4,4,2,1,3,0,3
2384,780794,20,3,6,0,0,3,6,0,0,0,2,3,2,1,1,0,9
2384,796761,16,5,5,5,5,0,0,2,3,2,6,1,3,1,0,2,12
2384,798158,4,1,1,1,1,0,0,1,1,1,3,0,0,0,0,0,3
2384,780109,24,5,8,2,2,3,6,4,4,3,8,4,3,1,1,0,17
2384,796760,6,1,4,0,2,1,2,2,3,0,0,1,0,0,0,0,5
2384,796757,19,12,16,9,9,3,7,3,5,1,0,3,1,2,0,0,30
2384,791104,4,0,2,0,0,0,2,0,0,0,0,0,1,0,0,0,0
2384,785597,18,2,8,1,2,1,6,2,2,0,1,3,2,1,1,0,7
2386,797047,23,3,9,3,7,0,2,9,10,3,0,1,1,0,1,1,15
2386,775515,33,9,17,4,7,5,10,1,2,2,4,1,2,2,1,3,24
2386,791579,22,3,7,2,5,1,2,0,0,4,2,1,1,0,3,0,7
2386,786387,33,7,9,6,7,1,2,2,2,1,4,2,0,3,2,1,17
2386,780399,35,6,11,4,6,2,5,0,0,0,9,8,1,7,1,0,14
2386,786846,12,0,3,0,0,0,3,0,0,0,1,2,1,0,4,1,0
2386,791575,10,0,5,0,5,0,0,2,2,2,3,1,0,0,2,0,2
2386,797046,7,1,1,0,0,1,1,0,0,0,1,1,1,0,2,0,3
2386,791574,5,0,1,0,0,0,1,0,0,0,0,0,0,1,1,0,0
2386,791577,5,1,2,0,0,1,2,0,0,0,0,0,0,0,0,0,3
2386,786391,3,0,0,0,0,0,0,0,0,0,0,1,0,0,1,0,0
2386,786390,12,0,1,0,0,0,1,0,0,0,2,0,1,2,1,0,0
2387,780631,4,1,3,1,2,0,1,0,0,1,0,0,0,0,0,0,2
2387,797394,23,2,8,2,7,0,1,1,2,4,1,0,3,5,1,0,5
2387,791827,36,8,19,8,19,0,0,2,2,1,5,0,0,1,3,0,18
2387,786625,33,4,10,2,5,2,5,2,2,0,4,4,3,2,7,1,12
2387,780625,33,5,11,0,4,5,7,0,0,0,4,4,0,0,2,0,15
2387,797397,7,0,2,0,2,0,0,0,0,1,0,1,3,1,0,2,0
2387,785481,27,5,7,3,4,2,3,1,2,4,1,1,2,2,1,3,13
2387,791830,7,0,2,0,2,0,0,0,0,1,1,0,0,0,1,0,0
2387,797395,17,2,4,2,4,0,0,0,0,0,2,3,1,3,5,0,4
2387,786630,13,1,3,1,3,0,0,0,0,1,3,0,1,1,3,0,2
2388,785536,9,1,5,0,2,1,3,0,0,1,2,0,0,0,0,0,3
2388,780119,39,9,20,9,17,0,3,4,5,10,7,0,2,2,3,1,22
2388,776097,39,4,10,4,9,0,1,0,0,3,3,4,4,1,5,0,8
2388,796559,28,7,12,6,8,1,4,3,6,4,3,1,1,1,2,1,18
2388,785280,34,6,13,5,9,1,4,3,4,4,6,2,3,1,1,1,16
2388,780149,30,4,13,4,7,0,6,7,8,0,5,3,2,1,2,3,15
2388,796561,2,0,0,0,0,0,0,0,0,0,1,0,2,0,0,1,0
2388,775679,10,1,3,0,0,1,3,2,4,1,3,2,1,1,0,0,5
2388,796558,9,0,1,0,1,0,0,0,0,0,1,2,3,1,1,0,0
2389,786547,19,0,4,0,2,0,2,2,3,2,1,0,3,1,1,2,2
2389,786544,36,7,12,7,11,0,1,7,8,2,8,0,2,1,2,1,21
2389,797507,34,5,14,2,8,3,6,0,0,2,4,3,2,0,2,1,13
2389,792012,33,4,11,3,5,1,6,2,3,0,0,4,4,3,2,0,11
2389,775084,33,5,13,4,7,1,6,3,4,0,4,2,4,0,2,0,14
2389,786860,24,4,7,1,1,3,6,0,0,0,5,1,5,1,1,3,11
2389,786546,18,0,2,0,1,0,1,4,6,0,1,1,2,3,2,0,4
2389,797510,3,0,1,0,0,0,1,0,0,0,0,0,0,1,0,0,0
2390,786795,10,0,0,0,0,0,0,0,0,0,0,0,5,0,1,0,0
2390,789020,40,7,15,3,7,4,8,3,3,0,4,0,3,4,2,2,21
2390,786787,38,3,18,3,11,0,7,4,6,0,1,6,3,0,2,0,10
2390,781456,18,1,2,1,1,0,1,1,1,1,0,1,1,0,2,0,3
2390,774954,34,3,10,3,10,0,0,4,5,2,5,5,4,2,3,0,10
2390,786792,23,3,5,3,5,0,0,0,0,3,3,1,5,1,2,2,6
2390,781497,9,0,1,0,0,0,1,2,2,0,1,0,0,2,1,1,2
2390,792091,28,8,14,5,7,3,7,1,1,1,5,1,3,0,0,1,20
2391,786059,38,7,10,6,8,1,2,6,10,0,8,4,3,1,1,2,21
2391,776174,34,10,14,10,14,0,0,6,9,4,9,6,1,1,3,3,26
2391,791958,37,5,7,4,6,1,1,4,4,0,6,2,2,1,3,0,15
2391,791960,37,2,7,2,4,0,3,2,4,1,1,3,2,2,3,1,6
2391,781332,35,4,9,2,6,2,3,5,6,0,6,3,4,1,1,0,15
2391,781334,3,1,2,1,2,0,0,0,0,0,0,0,2,0,2,0,2
2391,797704,16,0,1,0,0,0,1,0,0,0,0,0,4,0,0,0,0
2392,796633,31,4,5,4,5,0,0,2,3,4,2,0,4,1,2,1,10
2392,790998,42,7,14,6,10,1,4,1,2,1,7,2,5,2,2,1,16
2392,790996,38,5,17,1,8,4,9,0,0,0,3,5,1,0,1,0,14
2392,790995,34,4,8,4,7,0,1,0,0,1,1,3,4,0,3,0,8
2392,786375,16,2,4,1,2,1,2,0,2,1,2,0,0,0,1,2,5
2392,796631,9,1,5,0,2,1,3,0,0,1,1,0,4,0,1,0,3
2392,790999,2,0,1,0,1,0,0,0,0,0,0,0,1,0,0,0,0
2392,790992,3,0,0,0,0,0,0,0,0,0,1,0,1,0,0,0,0
2392,790997,32,5,9,1,2,4,7,0,0,1,4,1,1,1,2,0,14
2392,785621,7,0,2,0,0,0,2,0,1,0,1,0,0,0,0,0,0
2392,781520,11,0,1,0,0,0,1,0,0,0,0,2,1,1,0,0,0
2393,785674,39,3,6,1,1,2,5,8,8,0,4,2,3,1,0,0,16
2393,780049,29,4,7,4,7,0,0,0,0,1,5,1,1,0,0,1,8
2393,780527,35,6,10,5,9,1,1,1,5,1,3,3,2,2,3,0,14
2393,797784,38,5,15,2,7,3,8,1,1,2,1,3,0,1,3,0,14
2393,789059,40,4,7,2,4,2,3,6,7,3,8,2,3,1,2,1,16
2393,797783,11,1,2,1,2,0,0,0,0,1,1,0,2,0,0,0,2
2393,792171,19,3,9,3,8,0,1,4,6,1,3,1,4,0,3,1,10
2393,792173,6,0,2,0,1,0,1,0,0,0,1,0,0,0,0,0,0
2393,780980,8,0,0,0,0,0,0,0,0,0,1,1,0,0,1,0,0
2394,796870,11,3,4,3,4,0,0,0,1,1,1,0,2,0,1,1,6
2394,786861,34,1,8,1,5,0,3,2,3,1,3,2,1,0,1,0,4
2394,792415,26,1,5,1,1,0,4,0,0,1,6,1,4,1,4,0,2
2394,780387,26,1,5,1,4,0,1,1,2,1,2,2,3,0,2,0,3
2394,767033,12,1,2,1,1,0,1,0,0,0,1,0,5,1,2,0,2
2394,792417,22,6,9,5,8,1,1,4,6,3,5,0,2,0,1,0,17
2394,796867,2,0,1,0,0,0,1,0,0,1,0,0,0,0,0,0,0
2394,796868,1,0,0,0,0,0,0,0,0,0,0,0,0,0,1,0,0
2394,792416,26,2,6,2,5,0,1,0,0,0,4,7,0,1,2,0,4
2394,786867,25,7,9,1,1,6,8,1,1,1,1,0,0,2,1,0,21
2394,786866,12,2,3,0,0,2,3,0,0,2,1,1,0,1,0,0,6
2394,796869,1,0,0,0,0,0,0,0,0,0,0,0,0,0,0,0,0
2394,786865,1,0,0,0,0,0,0,0,0,0,0,0,0,0,0,0,0
2394,796864,1,0,0,0,0,0,0,0,0,0,0,0,0,0,0,0,0
2395,786371,25,1,5,1,5,0,0,4,8,1,2,2,1,1,2,1,6
2395,786369,35,4,8,2,5,2,3,1,2,0,5,0,0,0,2,2,11
2395,797074,25,2,6,1,3,1,3,4,5,0,1,1,3,0,1,1,9
2395,797072,32,2,3,0,0,2,3,3,5,0,2,0,0,0,1,0,9
2395,791559,23,0,2,0,0,0,2,0,0,0,5,0,3,3,1,0,0
2395,797076,4,0,2,0,0,0,2,0,0,0,0,2,0,0,0,0,0
2395,791558,9,1,2,0,0,1,2,0,0,0,0,1,4,1,3,0,3
2395,791555,13,2,4,2,4,0,0,1,2,3,0,1,3,0,1,0,5
2395,786372,14,2,4,2,4,0,0,0,1,0,1,4,2,0,3,0,4
2395,797073,9,0,1,0,0,0,1,0,0,0,2,1,0,0,0,0,0
2395,791556,11,1,3,0,1,1,2,0,0,1,1,1,2,0,3,1,3
2396,786519,32,4,7,4,7,0,0,1,2,6,6,0,4,1,1,0,9
2396,797558,25,2,8,1,4,1,4,0,0,0,2,1,1,0,1,0,5
2396,797556,35,3,11,1,3,2,8,0,0,0,2,3,3,0,4,0,8
2396,791913,30,3,6,2,4,1,2,2,2,0,2,3,1,1,3,0,9
2396,786520,38,8,18,7,14,1,4,3,3,1,6,1,3,2,2,0,20
2396,791911,23,1,3,0,0,1,3,0,0,2,2,2,4,0,0,0,3
2396,797555,6,0,0,0,0,0,0,2,2,0,0,0,1,0,0,1,2
2396,781076,11,2,3,2,2,0,1,0,0,0,0,1,0,1,1,0,4
2397,780683,32,4,7,3,5,1,2,5,6,4,8,1,3,1,0,0,14
2397,780686,32,7,14,7,13,0,1,5,5,3,4,2,2,1,2,0,19
2397,786112,35,2,8,1,5,1,3,2,2,0,2,1,3,0,3,0,7
2397,797681,35,4,8,1,3,3,5,2,3,1,2,3,2,1,1,0,13
2397,780688,33,3,9,3,6,0,3,3,4,2,1,1,2,2,4,0,9
2397,780689,15,0,3,0,2,0,1,0,2,1,2,0,1,0,0,0,0
2397,797679,17,3,6,1,1,2,5,0,0,1,2,0,1,0,0,0,8
2397,797682,1,0,0,0,0,0,0,0,0,0,0,0,0,0,0,0,0
2398,791787,28,8,15,6,11,2,4,2,9,5,6,1,1,1,3,2,20
2398,789048,29,5,7,5,7,0,0,4,7,9,8,0,1,1,4,0,14
2398,789041,27,5,12,2,5,3,7,1,2,0,2,1,2,4,1,0,14
2398,789046,20,3,5,2,2,1,3,4,4,1,2,0,4,1,1,0,11
2398,791786,26,2,7,2,5,0,2,2,2,1,1,3,2,0,0,0,6
2398,797630,18,4,6,3,4,1,2,0,0,0,3,2,2,0,2,0,9
2398,785540,16,1,5,1,4,0,1,2,2,1,2,0,1,1,0,1,4
2398,789044,8,1,2,1,1,0,1,2,2,0,1,0,0,2,0,0,4
2398,797629,16,0,4,0,3,0,1,0,0,0,3,3,0,1,1,1,0
2398,791785,9,0,3,0,1,0,2,0,0,1,1,0,1,0,1,0,0
2398,797632,1,0,0,0,0,0,0,0,0,0,0,0,0,0,0,0,0
2398,797633,1,0,0,0,0,0,0,0,0,0,0,0,0,0,0,0,0
2398,799762,1,0,0,0,0,0,0,0,0,0,0,0,0,0,0,0,0
2400,781624,15,2,6,2,4,0,2,1,2,2,4,1,2,0,3,0,5
2400,792246,20,6,9,6,9,0,0,5,6,6,6,0,1,0,0,2,17
2400,791701,21,1,6,1,4,0,2,0,0,2,3,4,2,2,0,0,2
2400,781420,31,5,16,3,8,2,8,1,2,1,3,7,1,2,1,2,13
2400,781405,30,10,15,7,8,3,7,4,6,2,4,4,2,0,7,0,27
2400,797924,14,1,5,1,5,0,0,0,0,4,5,0,0,0,0,1,2
2400,792244,10,6,9,5,6,1,3,1,1,1,1,1,1,0,0,0,14
2400,781417,9,0,3,0,3,0,0,3,4,7,1,0,0,0,0,0,3
2400,780615,11,1,4,1,4,0,0,0,0,3,2,0,3,2,1,0,2
2400,797920,2,1,1,1,1,0,0,2,2,0,0,0,0,0,0,0,4
2400,797930,2,0,0,0,0,0,0,0,0,0,1,0,0,0,0,0,0
2400,797925,15,1,5,1,4,0,1,2,2,3,1,3,3,1,3,0,4
2400,797933,6,1,6,0,3,1,3,2,2,0,0,0,1,2,0,0,5
2400,792245,14,1,3,0,1,1,2,1,2,0,1,2,5,0,1,0,4
2402,785287,20,6,8,6,8,0,0,6,9,2,4,1,3,1,0,2,18
2402,776286,34,2,5,2,3,0,2,0,1,11,5,3,3,1,0,1,4
2402,797012,22,4,12,3,5,1,7,1,1,1,0,3,3,2,5,0,10
2402,785357,37,9,17,5,9,4,8,5,5,2,8,1,4,2,1,0,27
2402,775560,31,3,6,2,3,1,3,2,6,0,2,7,4,1,3,0,9
2402,797010,31,4,11,4,9,0,2,1,2,1,3,4,2,1,1,0,9
2402,791444,12,1,1,1,1,0,0,0,0,2,2,1,0,0,0,0,2
2402,775557,4,1,1,1,1,0,0,0,2,0,0,0,0,0,0,0,2
2402,797011,9,3,5,3,5,0,0,1,2,2,3,0,1,0,0,1,7
2403,796540,19,2,3,2,2,0,1,0,0,2,2,0,4,0,1,0,4
2403,775037,30,1,5,1,4,0,1,2,2,1,3,0,4,1,2,0,4
2403,796544,12,1,4,0,0,1,4,0,1,0,0,1,1,0,1,0,3
2403,786089,35,6,13,2,3,4,10,0,0,1,3,0,2,1,1,0,16
2403,780087,31,7,18,7,16,0,2,9,14,1,2,0,4,0,3,0,23
2403,796543,11,0,0,0,0,0,0,0,0,0,1,0,2,0,0,0,0
2403,796545,25,0,1,0,0,0,1,3,5,0,3,3,5,1,2,0,3
2403,790952,26,0,2,0,2,0,0,1,3,0,1,1,2,1,3,0,1
2403,798697,3,0,0,0,0,0,0,0,0,0,0,0,1,0,0,0,0
2403,796541,8,0,1,0,1,0,0,1,2,1,1,0,1,1,0,0,1
2404,785916,26,9,13,7,9,2,4,3,4,3,5,1,5,0,2,2,23
2404,786183,28,1,9,1,5,0,4,0,0,1,0,3,1,0,3,0,2
2404,780105,32,6,10,5,8,1,2,0,0,3,4,5,5,2,2,1,13
2404,785894,22,1,5,0,0,1,5,2,2,0,3,2,3,0,0,0,5
2404,781131,40,10,17,8,12,2,5,0,2,1,10,11,2,0,4,0,22
2404,791409,16,3,6,1,2,2,4,0,0,0,0,0,1,0,0,0,8
2404,785915,32,5,6,0,0,5,6,2,2,0,4,0,3,0,1,1,17
2404,780106,4,0,0,0,0,0,0,0,0,0,4,1,1,0,0,0,0
2405,797529,37,4,7,4,6,0,1,5,8,4,6,0,2,1,2,1,13
2405,797527,13,0,3,0,1,0,2,0,2,0,0,0,2,1,0,0,0
2405,791936,39,9,12,9,12,0,0,1,1,8,10,3,0,4,0,0,19
2405,797532,33,5,16,5,12,0,4,0,3,0,5,10,0,0,2,0,10
2405,785688,38,7,18,2,6,5,12,1,2,0,0,2,3,0,3,0,20
2405,797530,3,0,0,0,0,0,0,0,0,0,1,0,0,0,0,0,0
2405,791932,9,0,5,0,2,0,3,0,0,0,0,1,1,1,0,0,0
2405,791935,3,0,1,0,1,0,0,0,0,2,1,0,2,0,0,0,0
2405,785988,21,3,11,2,4,1,7,4,4,0,1,1,2,1,0,0,11
2405,791931,1,0,0,0,0,0,0,0,0,0,0,0,0,0,0,0,0
2405,797531,3,0,0,0,0,0,0,0,0,0,0,0,0,0,0,0,0
2406,797241,14,1,2,1,2,0,0,0,0,2,4,1,0,0,0,0,2
2406,791366,17,5,9,4,7,1,2,0,2,0,1,0,0,0,1,0,11
2406,797244,27,3,5,2,2,1,3,0,0,1,6,6,3,1,1,1,7
2406,786340,23,2,6,1,1,1,5,1,2,2,3,4,1,0,3,0,6
2406,780163,25,10,14,5,5,5,9,4,5,0,1,3,0,3,2,0,29
2406,791361,19,4,7,2,3,2,4,2,2,3,1,1,1,2,1,1,12
2406,786155,13,1,3,1,3,0,0,4,4,0,4,0,2,0,3,1,6
2406,780170,12,2,4,2,4,0,0,0,0,2,3,0,1,0,1,2,4
2406,797246,2,1,2,0,0,1,2,0,0,0,0,0,0,0,0,0,3
2406,797245,2,1,1,1,1,0,0,0,0,0,1,0,0,0,0,0,2
2406,797243,25,3,7,2,5,1,2,2,4,2,4,8,2,1,0,0,9
2406,797242,21,3,6,2,2,1,4,0,0,2,2,0,2,1,2,1,7
2408,797842,18,3,6,3,6,0,0,6,8,2,3,0,4,1,2,0,12
2408,797849,25,1,7,1,4,0,3,2,2,2,3,2,0,0,2,0,4
2408,781537,23,3,7,2,5,1,2,2,2,1,2,3,4,1,1,0,9
2408,786079,26,1,3,1,1,0,2,0,1,0,2,2,1,0,1,0,2
2408,797843,24,1,7,0,3,1,4,2,2,1,1,2,1,1,1,0,5
2408,797848,9,1,2,0,1,1,1,0,0,0,1,0,0,0,0,0,3
2408,779986,8,1,2,1,2,0,0,0,2,1,1,0,0,0,2,0,2
2408,797844,16,0,1,0,1,0,0,4,4,1,1,3,4,1,3,0,4
2408,797836,5,3,3,2,2,1,1,1,1,0,1,0,1,1,1,0,8
2408,797835,19,1,5,1,1,0,4,2,3,0,3,0,2,0,1,1,4
2408,797846,25,3,9,0,3,3,6,1,2,0,1,0,4,1,0,0,10
2408,792201,2,0,0,0,0,0,0,0,0,0,2,0,0,0,0,1,0
2409,797779,33,6,14,1,4,5,10,1,2,3,2,1,3,1,2,1,18
2409,797769,25,3,6,3,5,0,1,0,3,0,4,2,3,2,2,0,6
2409,786256,24,4,5,4,5,0,0,3,6,2,4,0,4,0,1,3,11
2409,797768,31,6,11,3,6,3,5,0,0,0,2,5,3,0,3,0,15
2409,775106,29,3,5,3,4,0,1,3,6,2,6,3,2,0,1,0,9
2409,785568,17,5,10,5,9,0,1,1,2,4,6,0,0,2,2,1,11
2409,797778,11,0,1,0,0,0,1,1,2,0,3,1,1,0,0,0,1
2409,797774,11,0,2,0,0,0,2,0,0,0,0,1,2,0,1,0,0
2409,797773,11,1,1,0,0,1,1,2,2,0,0,0,2,1,1,0,5
2409,797781,2,0,2,0,2,0,0,0,0,0,0,0,0,0,0,0,0
2409,797780,3,1,1,0,0,1,1,2,2,0,0,0,2,1,0,0,5
2409,797775,3,0,0,0,0,0,0,0,0,0,1,0,0,0,0,0,0
2410,781462,22,7,9,7,8,0,1,2,2,0,4,3,0,2,2,0,16
2410,780876,26,3,5,2,2,1,3,3,3,0,5,6,4,4,1,1,10
2410,785353,24,2,5,1,2,1,3,0,0,1,4,5,3,1,1,0,5
2410,781673,20,1,6,0,2,1,4,2,2,1,2,1,2,0,0,0,5
2410,781457,28,11,14,7,9,4,5,3,3,1,1,5,3,2,3,0,29
2410,785355,22,2,3,0,1,2,2,5,6,1,2,1,1,0,1,0,11
2410,790895,15,1,4,1,3,0,1,2,3,0,2,2,2,0,1,0,4
2410,796365,10,1,6,1,5,0,1,0,1,1,5,1,2,0,0,0,2
2410,791305,10,3,3,3,3,0,0,1,3,0,1,0,2,0,0,1,7
2410,796366,8,0,2,0,0,0,2,3,3,0,0,0,0,0,0,0,3
2410,792435,5,0,0,0,0,0,0,0,0,0,1,0,0,0,0,0,0
2410,790806,2,0,1,0,0,0,1,0,0,0,1,0,0,0,0,0,0
2410,781476,2,1,1,1,1,0,0,1,2,0,0,1,0,0,0,0,3
2410,776275,2,1,1,1,1,0,0,0,0,0,0,0,0,0,0,0,2
2410,790805,2,0,0,0,0,0,0,0,0,0,0,0,0,0,0,0,0
2410,792434,2,0,0,0,0,0,0,0,0,0,0,0,0,0,0,0,0
2411,790494,22,2,7,2,4,0,3,0,0,1,4,1,2,1,3,1,4
2411,788866,12,3,3,3,3,0,0,0,0,2,2,0,3,0,2,0,6
2411,781659,22,1,1,1,1,0,0,4,5,1,1,0,0,0,3,0,6
2411,796854,17,0,2,0,1,0,1,0,0,0,3,2,3,1,0,0,0
2411,796851,33,3,8,0,2,3,6,0,0,0,3,3,2,1,2,0,9
2411,782162,26,6,11,4,7,2,4,3,3,0,5,3,1,0,3,0,17
2411,781005,11,1,6,1,3,0,3,0,0,0,0,0,1,0,1,0,2
2411,792683,14,0,5,0,2,0,3,2,2,1,2,2,2,0,1,0,2
2411,780610,20,3,6,0,0,3,6,1,2,0,0,1,3,1,1,0,10
2411,796855,10,2,2,2,2,0,0,2,5,0,2,0,1,0,1,0,6
2411,788865,13,2,2,2,2,0,0,3,4,0,2,0,4,0,2,0,7
2412,791917,32,1,4,0,0,1,4,2,2,0,2,1,4,0,0,0,5
2412,786526,29,6,8,5,6,1,2,2,2,0,12,4,2,0,4,0,15
2412,786525,28,1,3,1,2,0,1,3,3,0,1,3,0,1,1,0,5
2412,791914,24,9,15,4,9,5,6,7,8,0,3,4,0,0,3,0,30
2412,786030,24,2,8,2,5,0,3,0,0,2,1,0,4,3,2,0,4
2412,781109,12,2,2,2,2,0,0,0,0,0,3,1,3,0,0,0,4
2412,786524,20,1,3,1,2,0,1,0,0,0,3,2,1,0,1,0,2
2412,797550,20,4,5,1,1,3,4,1,3,0,0,1,0,3,1,0,12
2412,786856,11,1,3,1,3,0,0,0,0,1,2,0,0,0,0,0,2
2413,785374,18,1,2,1,2,0,0,0,0,2,0,1,2,0,0,0,2
2413,785372,25,5,10,5,8,0,2,1,1,0,2,3,2,1,1,0,11
2413,786384,21,2,7,1,2,1,5,0,0,1,1,1,0,3,3,0,5
2413,790825,21,2,11,1,6,1,5,0,0,0,1,3,1,0,0,0,5
2413,774905,16,4,8,3,5,1,3,0,0,0,2,2,5,0,0,0,9
2413,785373,25,4,5,3,3,1,2,1,1,2,3,1,0,0,1,0,10
2413,790827,22,4,7,3,5,1,2,1,4,4,5,3,0,1,1,0,10
2413,785371,25,2,8,0,1,2,7,0,0,0,5,2,2,1,2,0,6
2413,790828,9,1,2,1,2,0,0,1,2,0,2,0,0,0,0,0,3
2413,796385,6,1,4,0,1,1,3,0,0,1,1,1,2,1,0,0,3
2413,785375,8,0,1,0,1,0,0,0,0,0,0,1,1,0,0,1,0
2413,780007,2,0,2,0,0,0,2,1,2,1,0,1,1,0,0,0,1
2413,796387,2,0,0,0,0,0,0,0,0,0,0,0,0,0,0,0,0
2414,791312,13,4,4,4,4,0,0,0,0,3,0,0,0,0,1,0,8
2414,785664,15,5,8,5,8,0,0,3,4,3,6,1,0,2,0,0,13
2414,796609,5,0,0,0,0,0,0,0,0,0,1,0,1,1,1,0,0
2414,781504,11,4,4,4,4,0,0,0,0,0,0,4,1,0,0,0,8
2414,766623,20,2,4,2,4,0,0,1,2,1,2,2,0,2,1,0,5
2414,796613,22,13,18,10,13,3,5,0,0,2,7,2,1,0,3,0,29
2414,792232,12,1,6,1,4,0,2,1,2,1,1,1,2,1,0,0,3
2414,785840,20,3,7,3,4,0,3,0,0,4,3,1,0,0,0,0,6
2414,780728,16,7,9,7,9,0,0,2,6,6,4,0,1,1,0,1,16
2414,796620,13,1,2,1,2,0,0,0,0,0,3,0,2,0,1,2,2
2414,792869,13,1,4,0,0,1,4,0,0,0,1,2,1,0,0,0,3
2414,791313,8,2,2,0,0,2,2,0,0,0,0,1,0,0,1,0,6
2414,785848,11,3,3,3,3,0,0,2,3,0,1,0,0,0,0,0,8
2414,796203,21,4,4,1,1,3,3,1,2,1,3,3,2,0,0,0,12
2416,775640,17,6,7,6,7,0,0,10,10,1,2,0,4,0,0,0,22
2416,780919,23,0,1,0,1,0,0,6,6,0,6,3,2,0,0,1,6
2416,785803,25,2,4,2,3,0,1,0,0,1,1,2,3,0,1,1,4
2416,780920,28,2,6,2,4,0,2,1,2,0,4,5,1,1,1,0,5
2416,780914,23,4,9,1,4,3,5,2,2,1,1,2,2,0,1,0,13
2416,791142,18,3,7,0,3,3,4,1,2,1,6,4,2,1,0,0,10
2416,775816,22,6,12,6,11,0,1,4,4,2,4,1,2,0,1,0,16
2416,791141,19,3,7,1,1,2,6,2,2,1,0,2,1,0,1,0,10
2416,796797,12,3,5,3,5,0,0,0,0,2,4,1,1,0,2,0,6
2416,796801,5,0,1,0,1,0,0,0,0,0,0,0,1,0,0,0,0
2416,775639,2,0,0,0,0,0,0,0,0,0,0,1,0,0,0,0,0
2416,796796,5,0,1,0,0,0,1,0,0,0,0,0,0,0,0,0,0
2416,796802,1,0,0,0,0,0,0,0,0,0,0,0,0,0,0,0,0
2417,786772,26,1,2,1,2,0,0,0,1,0,5,0,3,1,2,1,2
2417,781484,11,0,2,0,1,0,1,0,0,0,0,1,2,1,0,0,0
2417,797840,36,7,17,7,15,0,2,1,2,0,1,5,1,3,2,0,15
2417,791970,13,0,4,0,1,0,3,0,0,1,1,0,3,0,1,0,0
2417,780002,27,4,14,4,9,0,5,4,4,0,0,2,2,0,2,0,12
2417,786773,19,7,8,7,8,0,0,2,3,5,3,0,2,0,0,0,16
2417,786024,7,0,2,0,0,0,2,0,0,0,0,2,1,0,0,1,0
2417,786769,26,3,7,1,4,2,3,0,0,0,2,0,1,2,1,0,8
2417,790823,15,0,1,0,1,0,0,0,0,0,3,0,4,0,1,0,0
2417,791967,12,4,4,2,2,2,2,4,6,0,1,0,0,0,0,1,14
2417,785441,8,1,2,1,2,0,0,0,0,0,0,0,1,0,0,0,2
2420,780952,19,3,3,3,3,0,0,1,3,0,3,1,5,2,1,1,7
2420,780945,19,1,3,1,3,0,0,0,0,2,3,0,4,1,2,3,2
2420,791155,40,13,24,8,12,5,12,9,12,2,2,2,1,1,3,0,40
2420,786609,35,1,6,1,5,0,1,0,0,4,6,0,2,1,1,0,2
2420,796810,40,2,13,0,5,2,8,6,8,0,0,2,4,1,2,0,12
2420,796812,12,2,4,2,4,0,0,1,1,1,3,1,2,0,1,0,5
2420,785752,27,1,5,1,2,0,3,0,0,1,2,0,1,0,0,0,2
2420,796814,5,0,1,0,0,0,1,0,0,1,0,0,0,1,0,0,0
2420,791156,28,1,8,1,3,0,5,2,2,2,5,3,2,2,2,0,4
2421,785714,28,8,11,8,11,0,0,3,6,3,2,1,4,0,0,2,19
2421,775894,31,4,9,2,4,2,5,0,0,1,4,4,4,3,4,0,10
2421,785711,42,4,14,3,6,1,8,2,2,0,8,3,4,2,5,0,11
2421,780985,39,4,7,2,3,2,4,3,4,1,3,1,1,1,0,0,13
2421,775266,38,4,11,3,6,1,5,1,2,2,11,1,3,0,2,1,10
2421,796829,12,1,4,1,4,0,0,3,4,2,1,1,4,0,2,0,5
2421,779994,8,1,1,1,1,0,0,0,0,0,2,0,1,0,0,0,2
2421,785378,16,1,6,0,2,1,4,3,6,0,0,1,2,0,2,0,6
2421,791167,8,0,2,0,1,0,1,0,0,0,0,1,1,0,0,0,0
2421,780988,3,0,0,0,0,0,0,0,0,0,0,0,0,0,0,0,0
2422,797389,10,0,0,0,0,0,0,0,2,1,1,0,2,1,1,2,0
2422,791826,30,1,4,1,3,0,1,6,6,4,3,1,3,0,2,1,8
2422,786785,35,9,15,4,7,5,8,5,6,1,8,1,0,1,1,0,28
2422,786784,29,5,13,3,8,2,5,3,7,1,0,0,3,0,0,2,15
2422,776009,35,8,15,7,13,1,2,7,8,0,0,4,3,1,3,0,24
2422,780634,30,4,8,4,8,0,0,1,3,6,7,1,4,3,1,3,9
2422,780633,31,2,7,2,3,0,4,3,4,0,1,5,2,2,1,0,7
2423,791416,33,7,14,7,14,0,0,3,4,5,7,0,1,0,0,0,17
2423,797096,20,0,3,0,2,0,1,0,0,0,0,1,4,0,1,0,0
2423,785906,38,10,20,9,18,1,2,1,3,2,9,6,4,1,4,0,22
2423,780100,24,4,4,0,0,4,4,0,0,0,2,2,5,1,2,0,12
2423,780096,39,6,10,3,4,3,6,4,4,0,0,5,5,1,4,0,19
2423,785907,23,5,7,5,7,0,0,1,2,1,3,0,2,0,2,0,11
2423,797093,16,1,4,1,3,0,1,2,2,0,2,5,5,1,0,0,4
2423,797094,4,0,0,0,0,0,0,0,0,0,0,1,0,0,0,0,0
2423,781614,3,1,1,0,0,1,1,0,0,0,1,0,0,0,0,0,3
2424,786542,32,5,6,4,5,1,1,0,0,0,7,0,1,2,3,1,11
2424,786540,26,6,8,5,7,1,1,4,4,3,5,1,0,2,3,4,17
2424,792019,30,3,8,2,3,1,5,2,2,0,2,2,1,1,1,0,9
2424,792015,35,4,9,4,7,0,2,2,2,0,5,8,3,1,4,0,10
2424,775995,33,2,8,0,5,2,3,0,0,1,2,4,2,0,1,1,6
2424,785364,14,2,4,2,4,0,0,0,0,0,2,1,1,1,2,0,4
2424,797515,8,1,1,0,0,1,1,0,0,0,2,2,0,0,0,0,3
2424,792016,14,2,4,2,3,0,1,0,0,0,1,0,2,1,0,0,4
2424,791845,8,1,2,1,1,0,1,0,0,0,1,0,0,0,0,0,2
2425,797591,24,5,10,3,6,2,4,0,0,0,1,0,2,1,0,0,12
2425,781071,35,3,9,2,2,1,7,0,0,0,3,1,1,0,0,0,7
2425,780098,20,1,2,0,1,1,1,0,0,1,2,1,0,2,3,0,3
2425,791890,36,4,17,3,11,1,6,1,2,0,2,8,0,2,3,0,10
2425,780719,37,6,14,5,9,1,5,4,5,1,5,1,3,1,2,0,17
2425,785424,20,4,6,4,6,0,0,0,0,5,4,1,1,1,1,0,8
2425,797588,12,1,3,1,3,0,0,0,0,2,2,0,1,0,0,0,2
2425,791889,2,0,0,0,0,0,0,0,0,0,0,0,1,0,0,0,0
2425,791888,14,1,2,0,1,1,1,0,0,0,0,0,0,0,0,0,3
2426,786404,24,1,3,0,2,1,1,2,2,4,0,0,4,1,2,0,5
2426,780378,18,2,4,2,4,0,0,1,4,2,2,0,5,0,1,1,5
2426,797065,32,1,7,0,2,1,5,1,1,3,1,1,3,0,5,1,4
2426,786253,41,7,19,5,12,2,7,7,8,0,3,5,3,2,3,1,23
2426,785798,40,8,20,5,10,3,10,0,0,0,3,1,2,0,0,0,19
2426,780382,12,1,1,1,1,0,0,0,0,2,1,0,5,2,1,0,2
2426,797061,40,3,9,2,7,1,2,2,2,4,4,4,1,3,2,0,9
2426,791562,5,0,0,0,0,0,0,0,0,0,0,0,1,0,0,0,0
2426,780381,3,0,0,0,0,0,0,0,0,0,0,0,2,0,0,0,0
2426,780121,10,0,1,0,0,0,1,0,0,0,2,0,3,0,0,0,0
2427,797056,35,5,11,4,7,1,4,7,9,1,1,2,3,2,5,0,18
2427,797054,36,4,9,4,8,0,1,5,5,0,2,2,1,0,1,0,13
2427,791568,28,0,4,0,3,0,1,9,11,2,3,0,4,0,1,0,9
2427,786381,27,1,3,1,1,0,2,2,5,0,4,2,4,0,3,0,4
2427,797058,7,0,2,0,0,0,2,0,0,0,0,0,0,0,0,1,0
2427,791564,28,1,1,1,1,0,0,0,0,0,1,2,2,0,2,0,2
2427,775549,17,3,4,3,4,0,0,2,2,1,5,1,4,2,1,3,8
2427,797055,19,2,3,1,1,1,2,2,2,0,0,0,2,0,5,0,7
2427,780425,28,3,6,3,6,0,0,5,6,5,10,0,4,0,2,1,11
2428,791949,34,2,8,1,5,1,3,4,6,5,2,4,2,1,0,1,9
2428,776014,25,2,4,1,2,1,2,2,6,3,1,4,3,0,0,0,7
2428,797690,24,2,2,2,2,0,0,2,2,0,2,4,4,3,2,1,6
2428,780747,34,11,19,6,11,5,8,2,2,0,4,6,2,3,4,0,29
2428,776363,33,4,8,0,2,4,6,2,2,1,4,1,0,0,2,0,14
2428,784336,15,1,3,1,3,0,0,0,2,0,2,1,1,0,1,1,2
2428,791946,10,1,2,1,1,0,1,0,0,0,0,1,1,0,0,0,2
2428,781539,5,0,1,0,1,0,0,0,0,0,2,0,1,0,1,0,0
2428,797689,3,0,0,0,0,0,0,0,0,0,0,0,1,1,0,0,0
2428,785304,17,7,9,5,5,2,4,6,6,1,1,0,1,2,1,0,22
2429,797050,32,8,11,7,9,1,2,3,3,2,2,0,2,0,1,1,20
2429,780394,33,5,8,5,8,0,0,0,0,1,6,3,2,0,3,0,10
2429,780391,27,5,9,5,8,0,1,4,4,2,2,0,5,0,3,0,14
2429,790871,27,3,7,1,3,2,4,2,2,1,1,5,5,0,3,0,10
2429,776473,38,6,12,2,5,4,7,4,5,0,2,4,3,1,1,0,20
2429,797048,20,3,8,3,5,0,3,0,0,0,3,3,2,0,0,0,6
2429,780392,11,1,1,0,0,1,1,2,2,0,1,1,1,0,0,0,5
2429,791573,12,1,2,1,2,0,0,1,1,0,1,1,1,0,1,0,3
2430,791321,24,2,3,2,3,0,0,3,6,1,3,0,3,1,1,0,7
2430,791320,38,7,13,4,9,3,4,4,4,0,3,2,3,1,1,0,21
2430,785912,26,4,10,2,4,2,6,2,2,0,2,3,2,0,3,0,12
2430,781511,30,4,12,1,4,3,8,2,2,0,2,1,2,1,2,0,13
2430,796656,14,2,6,2,6,0,0,0,0,1,2,1,1,1,0,1,4
2430,796657,23,1,4,1,3,0,1,0,3,0,5,0,1,0,0,0,2
2430,796651,12,0,1,0,0,0,1,0,0,0,1,1,5,0,0,0,0
2430,792257,6,0,2,0,1,0,1,0,0,0,2,1,0,0,1,0,0
2430,791323,27,1,3,0,0,1,3,0,0,2,2,4,1,1,1,0,3
2431,786039,17,4,7,4,7,0,0,3,4,2,5,3,1,0,0,2,11
2431,792043,16,0,1,0,0,0,1,0,0,0,2,0,0,0,1,0,0
2431,786266,35,8,15,7,12,1,3,1,2,2,8,0,3,1,2,0,18
2431,792040,30,6,10,5,7,1,3,2,2,0,5,3,0,0,0,0,15
2431,775028,28,2,7,1,5,1,2,6,8,1,6,5,1,0,4,0,11
2431,797728,18,1,4,1,2,0,2,1,2,0,0,0,3,0,0,0,3
2431,797726,10,2,3,2,2,0,1,0,0,1,0,0,1,0,1,0,4
2431,792036,18,1,3,1,3,0,0,0,0,2,1,0,4,0,0,1,2
2431,797723,11,0,1,0,0,0,1,0,0,0,2,1,0,1,0,0,0
2431,797719,2,1,1,0,0,1,1,0,0,0,0,0,0,0,0,0,3
2431,797718,15,1,4,1,3,0,1,5,5,0,1,1,1,0,0,1,7
2432,780085,30,2,3,2,3,0,0,3,4,2,5,1,4,0,0,1,7
2432,774874,26,5,9,5,9,0,0,1,2,1,4,0,4,0,2,0,11
2432,786475,21,0,5,0,3,0,2,0,0,0,1,1,0,0,2,1,0
2432,780084,27,1,9,0,4,1,5,0,0,0,2,4,1,3,1,0,3
2432,776038,17,2,8,1,6,1,2,4,6,0,2,2,2,0,0,0,9
2432,781134,11,3,4,2,2,1,2,0,0,1,2,0,3,0,0,0,7
2432,796531,23,3,7,2,6,1,1,3,4,0,3,0,4,0,2,0,10
2432,790946,9,1,2,1,1,0,1,0,0,2,1,0,2,0,0,0,2
2432,786037,4,0,1,0,1,0,0,0,0,0,1,0,0,0,0,0,0
2432,785270,26,3,10,1,3,2,7,3,3,0,1,1,2,2,1,0,11
2432,775468,6,0,4,0,2,0,2,0,0,0,1,0,1,1,2,0,0
2432,780083,0,0,0,0,0,0,0,0,0,0,0,0,0,0,0,0,0
2433,781158,16,1,2,1,2,0,0,0,2,1,1,0,1,0,0,0,2
2433,781652,36,10,14,7,10,3,4,4,4,3,6,2,3,0,3,2,27
2433,786034,33,1,3,0,0,1,3,1,2,0,4,1,0,0,1,0,4
2433,786419,28,2,8,2,7,0,1,1,2,1,4,2,3,0,3,0,5
2433,781283,23,2,7,0,2,2,5,2,4,0,1,4,4,2,3,0,8
2433,781653,28,1,4,1,4,0,0,8,12,1,11,0,3,0,2,3,10
2433,791615,22,2,6,2,4,0,2,2,3,0,2,1,3,0,4,2,6
2433,785277,14,1,3,0,0,1,3,0,0,0,1,0,1,0,1,0,3
2434,796469,26,7,14,4,7,3,7,7,11,5,9,0,3,0,3,3,24
2434,779981,17,1,1,1,1,0,0,0,0,0,3,0,3,1,3,1,2
2434,785463,31,0,6,0,3,0,3,0,0,0,1,1,5,1,2,0,0
2434,779978,40,2,11,0,5,2,6,9,10,1,6,4,1,2,0,0,15
2434,776003,34,8,17,5,11,3,6,3,3,1,6,4,1,0,3,0,22
2434,790923,24,2,6,1,3,1,3,1,2,2,2,0,1,2,0,1,6
2434,779980,8,1,1,1,1,0,0,0,0,0,0,0,3,0,0,1,2
2434,785466,4,0,0,0,0,0,0,0,0,1,0,0,3,0,0,0,0
2434,785467,3,0,1,0,0,0,1,0,0,0,0,0,1,0,0,0,0
2434,790924,13,3,6,3,5,0,1,0,0,4,1,0,2,0,0,0,6
2435,796439,23,3,8,3,8,0,0,0,1,3,2,1,2,0,0,0,6
2435,790883,35,4,8,3,6,1,2,2,3,0,6,1,5,3,0,0,11
2435,796436,38,9,19,8,13,1,6,6,8,0,3,3,2,0,6,0,25
2435,785436,37,3,5,3,5,0,0,0,0,1,8,2,2,0,3,0,6
2435,790885,17,3,7,2,3,1,4,1,2,3,3,0,0,0,0,0,8
2435,790884,10,2,3,2,3,0,0,0,1,1,1,0,2,0,1,1,4
2435,796438,15,0,2,0,1,0,1,1,2,1,0,0,1,0,0,0,1
2435,791635,21,4,6,2,3,2,3,3,4,0,3,0,4,0,2,2,13
2435,781262,4,0,1,0,0,0,1,0,0,0,0,0,1,0,0,0,0
2436,785863,27,9,10,9,10,0,0,3,5,1,5,2,2,0,2,0,21
2436,785630,19,5,8,1,2,4,6,0,0,1,2,1,0,1,0,0,14
2436,786248,19,7,8,7,8,0,0,0,0,4,5,0,1,1,1,0,14
2436,780777,24,5,7,3,4,2,3,0,1,1,1,7,2,3,5,0,12
2436,785631,22,4,7,3,4,1,3,0,0,0,2,3,2,0,0,2,9
2436,791198,16,4,10,1,1,3,9,0,0,0,2,2,0,0,0,0,11
2436,785632,21,3,6,3,6,0,0,2,2,4,2,3,1,0,0,0,8
2436,791197,13,3,5,3,5,0,0,2,2,0,3,0,1,0,1,1,8
2436,791196,5,2,4,0,0,2,4,0,0,0,0,0,0,0,0,0,6
2436,791200,13,2,3,2,3,0,0,0,0,0,2,6,1,2,1,0,4
2436,791199,7,1,1,1,1,0,0,0,1,2,1,0,3,0,0,0,2
2436,791195,3,1,2,1,2,0,0,0,0,2,3,1,0,0,0,0,2
2436,796898,5,0,3,0,1,0,2,0,0,0,0,0,0,0,0,0,0
2436,796899,3,0,1,0,1,0,0,0,0,1,1,0,0,0,0,0,0
2436,781129,3,0,1,0,0,0,1,0,0,1,0,0,0,0,1,0,0
2437,796772,39,7,18,5,10,2,8,2,4,0,1,3,2,0,4,0,18
2437,791427,39,7,11,7,10,0,1,3,4,3,6,1,3,2,6,0,17
2437,792698,37,5,15,0,4,5,11,0,0,0,0,1,0,0,3,0,15
2437,792704,38,4,7,4,6,0,1,2,2,1,4,0,3,1,0,0,10
2437,792702,35,3,7,3,3,0,4,1,2,2,2,3,4,2,1,0,7
2437,792699,6,0,2,0,2,0,0,0,0,0,1,2,0,2,0,0,0
2437,792701,6,0,0,0,0,0,0,0,0,0,0,1,0,0,0,0,0
2438,775229,36,9,17,6,12,3,5,5,8,3,3,3,3,6,6,1,26
2438,790784,32,7,14,4,8,3,6,3,5,3,3,0,3,2,3,0,20
2438,786548,8,2,3,2,3,0,0,3,4,2,0,1,5,0,3,0,7
2438,786229,21,2,6,2,4,0,2,0,0,1,5,2,2,0,0,0,4
2438,786719,23,0,4,0,3,0,1,2,2,0,0,0,2,0,1,0,2
2438,786581,19,2,5,1,3,1,2,2,2,1,4,2,0,0,1,0,7
2438,797475,21,1,5,0,3,1,2,1,2,0,2,0,2,1,1,0,4
2438,776219,18,2,5,2,2,0,3,0,0,0,3,1,4,0,2,1,4
2438,786235,15,0,0,0,0,0,0,0,0,0,2,1,4,0,0,3,0
2438,781518,6,0,1,0,0,0,1,0,0,1,0,0,2,1,1,0,0
2438,786583,1,0,0,0,0,0,0,0,0,0,0,0,0,0,1,0,0
2439,776068,38,6,17,5,12,1,5,2,3,0,5,4,2,1,3,2,15
2439,787782,37,2,7,2,4,0,3,9,12,0,5,5,3,0,3,1,13
2439,783072,18,5,8,5,8,0,0,1,2,1,1,0,2,0,1,1,11
2439,791540,36,3,10,3,8,0,2,1,2,0,1,2,2,2,3,0,7
2439,781463,18,1,1,1,1,0,0,2,2,2,0,2,3,1,1,0,4
2439,797817,28,4,5,4,4,0,1,4,6,0,2,4,3,4,1,0,12
2439,774879,19,5,7,5,7,0,0,0,0,2,4,1,3,1,1,0,10
2439,792153,6,0,0,0,0,0,0,0,0,0,0,0,4,0,2,0,0
2440,796566,21,4,7,4,7,0,0,6,6,6,10,1,0,2,1,3,14
2440,796568,21,4,6,4,6,0,0,4,4,3,2,0,1,1,0,0,12
2440,775107,20,3,6,0,0,3,6,0,0,0,2,2,0,1,1,0,9
2440,780166,20,3,8,2,5,1,3,0,0,0,1,3,1,0,0,0,7
2440,790969,20,2,5,1,3,1,2,0,0,0,1,3,0,1,0,0,5
2440,790967,14,4,7,0,1,4,6,0,0,0,1,0,1,0,1,0,12
2440,796569,13,4,7,3,6,1,1,0,0,2,1,1,2,2,0,0,9
2440,796563,6,3,4,2,2,1,2,0,0,0,1,1,1,0,0,0,7
2440,790971,16,1,1,1,1,0,0,2,4,2,0,3,1,1,1,0,4
2440,796564,7,2,3,2,2,0,1,0,2,2,3,1,0,0,0,0,4
2440,796565,8,1,2,0,1,1,1,0,0,0,0,1,0,0,1,0,3
2440,790968,18,1,6,1,2,0,4,0,0,1,3,3,1,3,0,0,2
2440,781380,11,1,2,1,2,0,0,0,0,0,1,1,1,0,4,0,2
2440,796567,5,0,1,0,0,0,1,0,0,0,2,0,0,0,1,0,0
2442,780765,41,6,17,6,13,0,4,8,12,2,4,6,2,3,3,0,20
2442,781301,30,2,6,2,6,0,0,2,2,3,6,0,3,0,0,3,6
2442,786255,38,5,11,5,7,0,4,6,6,1,3,2,2,1,2,0,16
2442,780762,38,6,9,2,4,4,5,0,1,2,3,0,3,2,2,0,16
2442,780768,39,5,9,3,5,2,4,0,0,0,3,2,4,4,4,0,12
2442,791729,14,1,3,1,2,0,1,0,0,0,2,2,0,1,0,1,2
2442,780755,15,2,5,1,3,1,2,0,0,0,0,2,3,0,0,0,5
2442,790864,3,0,0,0,0,0,0,0,0,0,0,0,1,0,0,0,0
2442,776241,7,0,2,0,1,0,1,0,0,0,0,0,0,0,0,0,0
2443,781046,13,2,3,1,2,1,1,0,0,1,0,0,2,1,1,0,5
2443,780025,37,10,16,10,16,0,0,3,4,7,4,1,2,1,2,1,23
2443,786228,43,4,14,3,11,1,3,0,0,1,2,8,2,2,2,0,9
2443,785385,21,2,5,0,1,2,4,1,2,1,1,0,1,0,2,0,7
2443,785383,40,4,13,2,9,2,4,8,8,0,10,3,3,0,2,0,18
2443,790837,35,2,5,1,2,1,3,0,0,0,4,1,3,1,1,2,5
2443,786297,8,1,1,1,1,0,0,1,2,0,2,2,1,0,0,1,3
2443,785384,25,4,5,2,2,2,3,0,0,0,2,1,5,1,2,0,10
2443,785382,3,0,0,0,0,0,0,0,0,0,0,0,0,0,1,1,0
2444,780521,31,5,10,4,7,1,3,1,1,4,1,4,5,1,1,0,12
2444,775163,19,1,1,1,1,0,0,1,4,0,2,0,1,0,1,0,3
2444,791370,23,2,5,1,1,1,4,0,0,1,1,2,3,2,4,0,5
2444,786199,34,7,13,2,4,5,9,4,4,0,1,1,2,2,1,0,23
2444,780991,26,5,8,4,6,1,2,3,3,1,0,1,1,0,1,0,14
2444,780145,7,1,1,1,1,0,0,0,0,1,2,0,1,0,0,0,2
2444,781611,12,0,0,0,0,0,0,1,3,1,1,0,0,0,0,0,1
2444,797271,28,4,11,0,2,4,9,0,0,0,4,3,1,4,2,0,12
2444,743593,20,1,3,1,2,0,1,6,7,0,3,2,5,0,1,0,8
2444,797270,0,0,1,0,0,0,1,0,0,0,0,0,0,0,0,0,0
2445,785681,20,1,2,1,2,0,0,3,4,1,1,2,3,1,1,1,5
2445,796789,32,15,23,5,8,10,15,6,7,3,4,3,2,4,2,1,46
2445,791126,32,1,3,1,3,0,0,3,4,1,4,4,3,1,1,0,5
2445,791124,29,2,5,2,3,0,2,2,2,0,3,3,0,1,2,0,6
2445,780050,35,6,9,6,6,0,3,1,3,0,5,4,1,0,3,0,13
2445,784479,4,1,1,1,1,0,0,1,1,0,0,0,4,0,1,0,3
2445,796786,16,1,5,0,0,1,5,5,5,0,2,0,3,0,0,0,8
2445,796788,13,0,0,0,0,0,0,0,0,0,1,0,2,0,0,0,0
2445,796784,12,1,2,0,1,1,1,0,0,1,1,0,0,0,2,0,3
2445,796782,4,0,1,0,1,0,0,0,0,0,0,0,0,0,0,0,0
2445,796783,3,0,0,0,0,0,0,0,0,2,0,0,1,0,0,0,0
2446,780095,24,6,7,6,7,0,0,3,3,2,8,1,1,2,0,2,15
2446,776321,21,3,8,2,4,1,4,2,2,1,7,1,0,0,2,0,9
2446,786081,13,1,2,0,0,1,2,2,4,0,3,3,2,0,0,0,5
2446,785431,20,3,8,2,4,1,4,1,3,0,2,3,2,1,0,1,8
2446,780232,19,3,10,2,5,1,5,0,0,1,4,0,2,0,1,0,7
2446,786020,9,1,4,1,3,0,1,1,2,2,2,0,1,1,1,0,3
2446,785356,18,1,5,1,2,0,3,0,0,0,4,0,3,0,1,1,2
2446,789019,15,1,3,0,0,1,3,0,0,0,1,0,1,0,0,0,3
2446,797918,23,2,5,1,2,1,3,0,0,0,8,3,2,1,1,0,5
2446,789040,26,6,13,5,7,1,6,3,5,0,6,2,1,1,2,0,16
2446,797917,6,1,2,1,2,0,0,0,0,1,0,0,0,1,0,1,2
2446,797911,2,0,1,0,1,0,0,0,0,0,0,1,1,1,0,0,0
2446,781328,4,2,3,2,2,0,1,0,0,0,0,0,0,0,0,0,4
2448,791699,34,5,11,4,6,1,5,7,8,5,3,2,2,2,4,0,18
2448,797523,19,0,1,0,0,0,1,1,2,0,0,1,0,1,2,1,1
2448,785402,22,4,4,4,4,0,0,0,2,4,8,3,2,1,3,0,8
2448,792118,29,4,12,4,8,0,4,2,3,0,1,4,2,1,2,0,10
2448,782593,26,4,12,3,3,1,9,0,0,1,3,2,5,0,0,0,9
2448,785828,18,3,4,3,4,0,0,2,4,0,3,0,3,0,1,1,8
2448,797525,3,1,2,1,2,0,0,0,0,0,1,0,1,0,0,0,2
2448,797526,12,1,3,1,1,0,2,2,2,1,0,0,1,0,2,0,4
2448,792663,8,1,1,1,1,0,0,0,0,0,1,1,1,1,1,0,2
2448,791700,26,0,4,0,1,0,3,4,5,0,0,1,2,0,1,0,4
2448,791702,3,0,0,0,0,0,0,0,0,0,0,0,0,0,0,0,0
2449,792473,21,3,3,2,2,1,1,0,0,1,4,4,5,4,3,0,7
2449,780043,36,2,6,2,3,0,3,2,2,1,4,6,3,1,0,1,6
2449,799276,33,2,2,1,1,1,1,2,2,0,2,1,2,0,3,0,7
2449,785249,39,11,18,9,14,2,4,3,4,1,3,3,1,3,5,0,27
2449,780035,36,5,12,3,5,2,7,6,6,1,3,2,4,1,1,0,18
2449,785251,19,0,2,0,1,0,1,3,4,0,1,0,4,0,1,0,3
2449,799281,3,0,0,0,0,0,0,0,0,0,1,0,0,0,0,0,0
2449,792477,9,0,4,0,2,0,2,0,0,0,1,0,0,0,0,0,0
2449,780036,4,0,0,0,0,0,0,0,0,0,0,0,0,0,0,0,0
2450,776327,19,0,0,0,0,0,0,1,2,2,3,3,3,1,0,0,1
2450,792104,29,6,12,2,4,4,8,4,4,3,6,4,2,2,1,2,20
2450,797709,26,5,11,2,3,3,8,4,4,1,4,3,1,0,2,1,17
2450,797708,28,4,9,4,8,0,1,2,2,1,1,3,1,3,3,0,10
2450,786198,34,7,12,3,6,4,6,8,11,0,3,1,4,0,1,2,26
2450,785608,13,5,7,4,5,1,2,1,1,1,2,0,2,0,0,1,12
2450,797707,11,0,3,0,2,0,1,0,0,0,3,1,1,0,1,0,0
2450,775779,21,1,3,1,2,0,1,1,2,0,2,1,2,2,1,0,3
2450,786204,16,2,6,1,4,1,2,0,0,0,3,2,2,0,0,1,5
2450,786180,3,0,0,0,0,0,0,0,0,0,0,1,1,0,0,0,0
2451,781403,33,2,12,2,10,0,2,2,4,1,10,2,2,0,1,1,6
2451,792654,24,3,6,3,6,0,0,6,7,1,5,0,5,1,2,2,12
2451,797301,34,2,7,1,4,1,3,0,0,0,2,3,1,2,4,0,5
2451,780524,30,7,11,2,2,5,9,0,0,1,1,1,1,1,1,0,19
2451,781400,36,7,16,4,7,3,9,8,9,0,5,6,4,0,2,0,25
2451,786857,16,2,6,1,3,1,3,2,2,1,0,1,2,0,1,0,7
2451,792653,5,3,3,3,3,0,0,0,0,1,2,0,0,0,0,0,6
2451,797302,8,1,1,1,1,0,0,0,2,0,1,0,2,0,1,0,2
2451,797303,8,0,0,0,0,0,0,0,0,0,0,1,1,1,0,0,0
2451,797306,5,0,0,0,0,0,0,1,2,2,1,0,0,0,1,0,1
2451,797304,1,0,0,0,0,0,0,0,0,0,0,0,0,0,0,0,0
2452,791750,28,1,4,0,2,1,2,0,0,2,4,0,3,0,4,0,3
2452,786177,30,3,9,2,2,1,7,1,4,0,6,2,3,4,0,0,8
2452,780244,35,2,9,1,2,1,7,0,1,0,2,3,3,1,1,1,5
2452,786179,34,7,15,2,6,5,9,3,5,2,3,2,0,1,2,0,22
2452,780238,32,6,12,3,6,3,6,2,3,1,3,3,3,0,4,1,17
2452,791752,14,1,2,1,2,0,0,0,0,1,0,0,3,0,1,0,2
2452,785909,2,0,0,0,0,0,0,0,0,0,0,0,1,0,0,0,0
2452,790773,16,3,4,0,0,3,4,2,3,1,0,0,0,0,1,0,11
2452,781500,8,0,2,0,0,0,2,0,0,0,1,1,0,0,1,0,0
2452,797347,1,0,0,0,0,0,0,0,0,0,0,0,0,0,0,0,0
2453,776279,28,4,8,2,3,2,5,4,4,0,4,1,3,1,3,0,14
2453,781505,32,6,11,6,9,0,2,0,4,1,2,0,2,0,1,0,12
2453,780353,34,9,11,9,11,0,0,0,1,1,9,0,2,0,4,2,18
2453,790851,18,1,4,1,4,0,0,0,0,1,2,1,2,0,0,0,2
2453,791317,38,4,12,4,8,0,4,2,2,0,2,9,5,2,2,0,10
2453,786222,12,1,2,1,2,0,0,0,0,1,2,1,5,0,1,1,2
2453,785966,3,0,0,0,0,0,0,0,0,0,2,0,0,0,0,0,0
2453,796647,5,0,1,0,1,0,0,0,0,0,0,0,0,0,0,0,0
2453,796649,6,1,1,1,1,0,0,0,1,1,0,1,0,1,1,0,2
2453,796648,24,2,7,2,4,0,3,1,1,0,1,1,1,0,1,0,5
2454,776462,12,0,1,0,0,0,1,0,0,0,1,0,1,1,1,0,0
2454,785635,19,2,4,2,3,0,1,6,6,0,6,1,4,1,0,4,10
2454,786440,26,2,8,0,2,2,6,5,5,1,1,2,3,0,4,0,11
2454,786720,35,3,6,1,2,2,4,3,3,2,6,2,4,0,5,1,11
2454,781199,40,8,15,6,8,2,7,14,19,0,3,7,2,4,2,1,32
2454,791628,27,2,3,1,1,1,2,5,6,1,9,0,1,0,3,3,10
2454,791629,8,0,1,0,0,0,1,1,2,0,0,0,1,0,0,0,1
2454,775642,18,4,6,3,5,1,1,0,0,1,1,2,3,0,3,0,9
2454,796974,15,2,4,0,2,2,2,0,0,0,0,2,1,0,1,0,6
2454,791626,0,0,0,0,0,0,0,0,0,0,0,0,0,0,0,0,0
2455,780651,24,6,11,6,11,0,0,0,2,3,2,0,5,0,0,0,12
2455,791815,29,4,12,4,10,0,2,3,4,0,1,1,5,1,2,0,11
2455,791810,32,2,4,2,3,0,1,0,0,0,2,7,5,1,2,0,4
2455,791814,21,3,7,3,5,0,2,2,2,1,1,1,4,0,1,0,8
2455,780650,36,7,17,6,12,1,5,6,8,2,8,7,3,2,4,0,21
2455,781596,14,3,7,3,7,0,0,0,0,1,1,0,3,0,1,0,6
2455,791809,1,0,0,0,0,0,0,0,0,0,1,0,0,0,0,0,0
2455,786645,20,5,11,5,10,0,1,1,1,5,3,1,2,4,0,0,11
2455,786644,16,2,3,1,1,1,2,0,0,0,2,1,2,0,2,0,5
2455,791812,7,2,5,2,3,0,2,0,0,0,1,0,1,0,0,0,4
2458,780875,25,2,7,2,4,0,3,4,4,0,5,2,2,2,2,0,8
2458,790768,23,4,9,0,0,4,9,0,0,0,0,3,1,0,2,0,12
2458,790769,19,0,5,0,3,0,2,0,0,0,0,2,2,0,0,0,0
2458,796324,12,0,4,0,3,0,1,0,0,1,0,1,2,0,0,0,0
2458,780879,25,4,6,4,6,0,0,4,4,5,5,0,5,2,5,0,12
2458,775785,24,2,4,1,3,1,1,1,2,3,5,2,1,2,0,1,6
2458,785743,22,5,6,1,1,4,5,0,1,0,0,2,2,2,1,0,14
2458,790767,14,1,4,0,1,1,3,6,6,0,1,0,0,1,1,0,9
2458,785226,23,0,5,0,2,0,3,0,0,0,1,2,1,2,0,0,0
2458,796326,13,2,2,2,2,0,0,1,2,1,2,0,1,1,0,0,5
2459,797290,28,2,6,2,2,0,4,3,6,0,4,1,5,1,1,0,7
2459,786064,30,7,10,2,2,5,8,3,5,0,3,0,3,0,5,0,22
2459,791660,31,2,6,1,1,1,5,0,0,0,3,1,1,0,3,0,5
2459,797292,23,2,4,2,4,0,0,2,4,0,3,2,3,1,0,2,6
2459,791661,10,0,1,0,0,0,1,0,0,0,1,0,4,0,1,0,0
2459,797291,21,2,3,1,1,1,2,0,0,0,3,4,1,0,6,0,5
2459,780509,23,0,4,0,2,0,2,0,0,2,1,0,4,0,2,1,0
2459,797293,8,0,0,0,0,0,0,0,0,0,2,0,0,0,1,0,0
2459,791658,15,2,2,2,2,0,0,2,2,1,0,0,1,1,1,0,6
2459,791663,9,0,0,0,0,0,0,0,0,0,0,0,0,0,0,1,0
2459,797295,2,0,0,0,0,0,0,0,0,0,0,0,0,1,0,0,0
2460,791062,39,9,19,8,13,1,6,4,4,4,5,2,4,1,3,2,23
2460,791063,22,2,3,2,3,0,0,2,2,1,3,2,5,2,4,0,6
2460,785542,3,0,0,0,0,0,0,0,0,0,0,0,0,0,0,0,0
2460,780743,40,1,11,1,9,0,2,0,0,1,2,2,1,1,3,0,2
2460,780055,16,4,9,4,5,0,4,0,0,2,2,1,0,0,0,0,8
2460,791060,23,4,6,4,5,0,1,1,2,0,2,1,2,3,3,0,9
2460,796735,25,2,3,1,1,1,2,0,1,1,4,1,3,0,0,0,5
2460,796736,3,0,0,0,0,0,0,1,2,0,0,0,1,0,1,0,1
2460,791064,29,2,7,1,4,1,3,0,0,0,3,3,2,0,1,0,5
2461,797431,17,3,8,0,3,3,5,0,0,0,0,0,4,0,1,0,9
2461,791356,36,5,8,5,8,0,0,4,6,6,7,2,1,2,3,1,14
2461,791680,30,2,6,2,4,0,2,1,2,0,4,0,3,0,0,0,5
2461,785812,37,5,13,3,4,2,9,3,3,1,1,3,4,1,2,0,15
2461,780104,35,6,11,3,5,3,6,2,2,0,5,3,1,3,2,0,17
2461,791681,11,1,2,1,2,0,0,1,2,2,1,0,1,0,0,0,3
2461,785815,34,6,12,6,10,0,2,3,4,3,6,4,1,1,5,0,15
2462,781592,14,5,7,5,7,0,0,0,0,1,5,0,0,4,4,0,10
2462,780229,16,2,4,2,4,0,0,2,3,1,12,4,2,1,1,1,6
2462,795572,15,6,7,4,4,2,3,0,0,1,1,1,0,0,1,1,14
2462,791483,16,0,2,0,1,0,1,0,0,0,0,4,0,0,2,0,0
2462,791485,14,4,9,1,3,3,6,2,2,1,0,1,1,0,0,0,13
2462,797197,4,1,2,1,1,0,1,0,0,0,0,0,1,0,0,0,2
2462,791489,17,2,9,1,3,1,6,0,0,2,6,1,2,1,1,1,5
2462,791484,15,4,7,3,3,1,4,0,0,1,3,0,2,0,0,0,9
2462,791487,19,3,4,2,3,1,1,0,0,1,4,0,2,1,1,0,7
2462,797195,21,4,11,3,4,1,7,3,4,0,2,2,1,0,2,0,12
2462,797194,18,2,4,0,0,2,4,0,0,0,1,1,0,1,1,0,6
2462,797193,19,3,4,3,3,0,1,2,4,2,4,4,0,0,0,0,8
2462,786323,12,2,4,1,2,1,2,0,0,1,1,4,0,1,0,0,5
2464,786091,26,7,10,3,6,4,4,5,7,4,4,0,2,1,2,0,23
2464,775738,16,0,0,0,0,0,0,2,2,2,4,0,0,0,0,0,2
2464,786728,24,3,4,3,3,0,1,4,4,2,8,1,1,3,4,2,10
2464,786096,10,2,2,1,1,1,1,1,3,0,1,0,4,1,3,0,6
2464,780892,22,5,8,2,3,3,5,0,0,0,5,5,0,2,0,0,13
2464,786350,3,0,0,0,0,0,0,1,2,1,1,0,1,0,0,0,1
2464,797669,3,1,1,1,1,0,0,0,0,1,1,0,0,0,2,1,2
2464,797670,6,2,5,2,5,0,0,0,0,3,0,1,1,0,0,0,4
2464,797665,2,0,1,0,0,0,1,0,0,0,1,0,0,0,0,0,0
2464,797666,18,3,5,1,2,2,3,2,2,0,0,1,1,1,1,0,10
2464,792087,17,1,5,1,4,0,1,0,0,1,1,4,1,3,2,0,2
2464,785734,11,1,4,0,1,1,3,1,2,1,0,1,0,0,0,0,4
2464,786788,12,1,2,1,1,0,1,0,0,0,3,0,1,0,2,0,2
2464,785904,17,6,13,5,7,1,6,0,0,1,3,0,3,0,3,0,13
2464,781030,13,1,5,0,2,1,3,1,2,0,1,1,0,2,2,0,4
2466,791839,27,2,2,2,2,0,0,3,4,5,7,6,0,1,3,2,7
2466,785322,30,3,7,2,2,1,5,7,8,2,5,0,1,0,2,0,14
2466,792381,29,5,15,1,5,4,10,4,4,1,1,0,2,2,0,0,18
2466,791842,33,4,13,2,7,2,6,4,4,0,3,0,1,0,1,0,14
2466,786616,28,2,6,0,3,2,3,1,2,1,6,2,0,0,0,0,7
2466,797444,3,0,1,0,0,0,1,0,0,0,0,0,0,0,0,0,0
2466,786736,21,4,8,3,4,1,4,0,0,1,3,3,0,1,1,0,9
2466,786613,13,1,2,1,2,0,0,0,0,0,2,1,2,1,2,1,2
2466,776341,16,1,3,1,3,0,0,0,0,2,1,0,1,1,2,1,2
2467,786071,11,0,0,0,0,0,0,0,0,0,2,0,2,0,1,0,0
2467,786460,29,4,5,4,5,0,0,1,2,0,5,1,2,0,1,0,9
2467,780604,35,2,9,1,5,1,4,0,0,1,6,2,2,1,4,0,5
2467,780603,28,4,9,1,1,3,8,3,3,1,3,2,0,0,0,0,14
2467,780602,36,1,11,1,10,0,1,1,1,5,4,4,4,1,2,3,3
2467,791768,18,3,6,2,5,1,1,0,1,1,0,1,3,1,1,0,7
2467,791766,26,6,13,3,3,3,10,0,0,0,0,3,1,3,0,1,15
2467,791767,2,0,1,0,0,0,1,0,0,1,0,0,0,0,2,0,0
2467,786230,15,3,11,0,4,3,7,0,0,2,1,4,4,0,0,0,9
2468,785775,9,0,0,0,0,0,0,0,0,0,1,2,3,3,1,0,0
2468,781335,22,7,10,5,7,2,3,3,4,1,3,2,0,1,4,0,19
2468,776351,22,4,8,0,1,4,7,2,2,1,4,1,0,0,1,0,14
2468,785770,20,5,7,4,4,1,3,2,3,2,2,6,2,0,1,1,13
2468,781341,21,4,6,0,0,4,6,0,0,0,5,3,1,2,1,0,12
2468,796542,18,1,1,1,1,0,0,0,0,1,1,5,1,0,2,0,2
2468,791282,9,4,4,4,4,0,0,1,3,0,2,2,0,1,0,1,9
2468,791285,19,5,7,0,1,5,6,0,0,2,2,1,4,2,3,1,15
2468,796538,15,2,2,0,0,2,2,0,0,0,2,4,4,2,1,0,6
2468,791286,4,1,1,1,1,0,0,1,1,0,1,1,1,0,0,0,3
2468,791284,22,6,10,3,3,3,7,1,2,1,2,3,0,0,0,0,16
2468,791283,10,0,1,0,0,0,1,2,2,0,3,2,0,1,0,0,2
2468,785773,9,3,3,3,3,0,0,1,1,0,1,1,0,0,1,0,7
2469,798968,17,1,3,1,2,0,1,0,1,0,2,2,1,1,3,0,2
2469,798966,16,0,1,0,1,0,0,1,2,1,1,0,1,1,1,0,1
2469,798962,17,2,5,2,5,0,0,0,0,5,1,1,2,1,1,0,4
2469,798967,11,0,2,0,2,0,0,0,0,0,1,0,0,1,2,0,0
2469,791718,25,3,9,2,6,1,3,4,4,1,1,3,0,2,3,0,11
2469,787996,9,1,2,1,2,0,0,2,3,2,0,0,1,1,2,2,4
2469,791720,14,1,6,1,6,0,0,0,0,1,1,0,0,1,0,0,2
2469,791717,14,1,3,0,1,1,2,0,0,0,0,0,1,0,0,0,3
2469,798964,4,0,0,0,0,0,0,0,2,0,0,0,3,0,0,0,0
2469,798969,8,3,6,2,2,1,4,0,0,1,0,0,1,2,0,0,7
2469,798965,12,1,3,1,1,0,2,0,0,0,1,0,2,1,1,0,2
2469,798963,4,0,4,0,4,0,0,0,0,0,0,0,0,0,0,0,0
2469,791719,8,0,1,0,1,0,0,0,0,0,2,0,0,0,1,0,0
2469,781446,26,6,13,5,8,1,5,3,4,0,2,0,3,1,3,0,16
2469,768880,15,0,2,0,1,0,1,0,0,0,1,0,0,0,3,0,0
2470,791606,32,1,5,1,2,0,3,1,2,0,2,1,1,2,1,0,3
2470,786410,31,4,7,2,4,2,3,6,8,0,2,2,4,2,2,0,16
2470,775095,10,2,3,2,3,0,0,1,1,0,0,2,3,2,2,1,5
2470,786406,35,1,5,1,3,0,2,0,0,1,3,5,5,0,2,0,2
2470,780414,18,5,10,2,5,3,5,4,6,0,2,2,4,0,1,0,17
2470,797020,14,0,1,0,1,0,0,4,6,0,1,1,5,0,1,3,4
2470,792392,12,1,1,1,1,0,0,0,2,0,2,0,1,0,1,0,2
2470,797021,4,0,0,0,0,0,0,0,0,0,0,0,1,0,1,0,0
2470,791605,5,0,1,0,0,0,1,0,0,0,1,1,0,0,0,0,0
2470,791603,34,9,12,3,4,6,8,0,0,0,10,1,1,1,3,0,24
2470,791843,5,0,3,0,2,0,1,0,0,2,2,0,0,0,1,0,0
2471,792329,23,1,4,0,2,1,2,0,0,1,4,0,3,1,3,0,3
2471,786749,27,1,4,1,2,0,2,1,4,3,3,5,1,0,0,0,3
2471,781384,31,7,11,6,8,1,3,2,3,1,5,1,4,1,3,0,17
2471,781616,32,5,12,1,3,4,9,4,6,0,4,1,5,0,4,0,18
2471,776350,29,3,10,2,6,1,4,6,8,1,4,1,4,0,3,0,13
2471,792330,9,1,4,1,1,0,3,0,0,1,1,1,0,0,0,1,2
2471,785435,10,0,1,0,1,0,0,0,0,0,0,0,1,0,0,0,0
2471,781615,20,2,3,1,1,1,2,1,2,0,2,1,1,1,0,0,6
2471,792601,17,1,2,1,1,0,1,1,2,0,1,0,2,0,3,0,3
2471,792331,2,0,0,0,0,0,0,0,0,0,0,0,0,0,0,0,0
2472,781300,25,1,5,1,1,0,4,2,2,0,8,2,2,1,1,2,4
2472,790803,23,4,5,4,5,0,0,6,6,2,6,0,2,0,0,2,14
2472,796360,22,2,7,1,4,1,3,1,2,1,1,5,2,2,2,1,6
2472,781304,23,2,9,1,2,1,7,2,2,0,2,2,4,0,5,0,7
2472,781302,28,5,8,4,5,1,3,4,7,2,7,1,2,2,0,1,15
2472,796364,2,0,0,0,0,0,0,1,2,1,3,0,2,0,2,0,1
2472,781305,12,0,4,0,2,0,2,0,0,0,1,1,1,0,2,1,0
2472,780598,17,3,7,3,5,0,2,2,3,6,2,0,4,0,4,1,8
2472,796363,10,0,3,0,1,0,2,2,2,0,1,0,0,0,0,0,2
2472,790802,11,1,5,0,0,1,5,2,3,1,0,0,1,0,0,0,5
2472,790801,24,2,6,0,2,2,4,2,3,2,2,0,0,1,0,0,8
2472,776366,1,0,1,0,0,0,1,0,0,1,0,0,0,0,0,0,0
2472,796362,1,0,0,0,0,0,0,0,0,0,0,0,0,0,0,0,0
2472,776372,0,0,0,0,0,0,0,0,0,0,0,0,0,0,0,0,0
2472,781306,0,0,0,0,0,0,0,0,0,0,0,0,0,0,0,0,0
2472,781303,1,1,1,1,1,0,0,0,0,0,0,0,0,0,0,0,2
2473,791289,15,1,1,1,1,0,0,0,0,1,1,0,4,0,1,1,2
2473,785786,22,1,4,0,2,1,2,0,0,0,3,1,4,0,0,0,3
2473,796571,27,0,7,0,3,0,4,2,2,1,4,3,1,1,1,1,2
2473,791291,30,8,19,5,10,3,9,4,4,0,2,2,2,0,2,0,23
2473,781346,32,1,7,0,0,1,7,4,4,1,6,2,2,0,4,0,7
2473,791290,20,2,6,0,1,2,5,0,0,0,3,0,2,1,4,0,6
2473,796576,12,1,5,0,1,1,4,3,5,0,0,0,0,3,0,0,6
2473,791288,11,1,1,1,1,0,0,0,0,0,1,2,2,0,0,0,2
2473,796572,15,1,3,1,2,0,1,0,2,0,1,0,4,1,1,0,2
2473,796574,9,1,3,0,2,1,1,0,0,0,1,0,1,0,1,0,3
2473,791287,7,1,2,1,2,0,0,1,1,1,0,0,3,0,0,0,3
2474,797831,28,3,8,0,2,3,6,2,2,1,3,1,3,1,1,0,11
2474,797823,28,5,7,4,6,1,1,5,6,6,8,1,2,0,2,4,16
2474,792286,12,4,6,4,6,0,0,1,1,4,1,1,0,0,0,0,9
2474,792280,26,4,11,1,6,3,5,2,2,0,5,3,2,1,2,0,13
2474,780505,35,5,12,5,9,0,3,2,4,3,2,7,1,2,6,0,12
2474,792284,25,2,4,0,0,2,4,1,2,1,4,0,3,1,1,0,7
2474,785950,15,4,5,1,1,3,4,0,1,1,1,1,0,0,0,0,11
2474,799468,18,1,5,0,2,1,3,0,0,1,2,3,1,0,1,0,3
2474,797826,5,1,2,1,1,0,1,0,0,0,1,0,0,3,2,0,2
2474,797829,8,1,2,1,2,0,0,4,6,0,2,0,0,1,0,0,6
2475,797473,14,4,5,4,5,0,0,0,0,2,1,0,4,0,1,3,8
2475,797470,24,0,5,0,2,0,3,0,0,2,0,2,2,0,2,1,0
2475,791864,29,5,14,5,10,0,4,1,1,0,3,1,1,0,1,0,11
2475,797472,31,3,11,2,6,1,5,0,1,1,1,0,1,1,1,0,7
2475,776447,37,7,17,6,11,1,6,0,0,3,5,1,3,2,2,0,15
2475,780965,40,3,9,2,4,1,5,7,8,1,2,10,2,3,3,1,14
2475,786307,10,1,1,0,0,1,1,0,0,0,3,0,5,0,2,0,3
2475,780195,4,0,0,0,0,0,0,0,0,0,1,0,0,1,1,0,0
2475,797471,11,2,2,2,2,0,0,0,2,1,2,0,2,0,0,0,4
2476,792388,12,1,1,1,1,0,0,0,0,0,5,0,1,0,0,0,2
2476,781533,24,2,5,0,0,2,5,0,0,0,4,1,2,0,0,2,6
2476,797845,25,5,10,1,3,4,7,0,0,0,0,0,4,0,1,0,14
2476,797851,30,5,11,2,7,3,4,0,0,1,3,3,4,1,1,0,13
2476,792395,30,6,11,4,8,2,3,4,7,1,4,5,0,2,2,1,18
2476,792396,4,0,1,0,1,0,0,0,0,2,1,0,1,0,0,0,0
2476,780840,16,0,1,0,1,0,0,0,0,0,0,1,1,1,0,0,0
2476,792393,20,4,7,4,6,0,1,0,1,2,8,4,4,0,1,0,8
2476,792391,25,5,9,5,9,0,0,0,3,3,3,2,0,2,2,1,10
2476,786115,14,1,4,1,2,0,2,1,2,1,4,1,1,0,2,2,3
2477,797382,15,0,4,0,1,0,3,2,2,1,2,0,2,0,2,0,2
2477,797379,32,5,7,5,5,0,2,0,1,2,6,1,2,0,0,1,10
2477,791818,27,0,7,0,1,0,6,2,2,1,2,3,0,0,2,0,2
2477,786636,31,5,11,5,10,0,1,1,2,1,1,0,0,0,3,0,11
2477,780646,25,2,5,0,0,2,5,4,4,0,1,0,3,2,0,1,10
2477,797380,9,1,5,1,4,0,1,0,1,1,1,0,2,0,1,0,2
2477,797375,5,0,0,0,0,0,0,0,1,0,0,0,0,0,1,0,0
2477,789043,13,1,4,1,4,0,0,1,5,1,6,0,2,0,0,0,3
2477,797378,5,1,1,1,1,0,0,0,0,0,1,0,0,1,0,0,2
2477,797377,22,1,5,1,1,0,4,2,2,0,2,3,1,1,0,0,4
2477,775168,16,0,5,0,4,0,1,0,0,0,1,0,1,1,1,0,0
2478,780809,32,2,9,2,6,0,3,0,0,1,3,7,4,2,3,0,4
2478,780813,21,0,1,0,0,0,1,0,0,0,2,0,2,1,3,0,0
2478,796767,31,2,8,0,5,2,3,0,0,2,4,1,0,0,4,0,6
2478,785618,26,5,7,0,0,5,7,0,0,0,2,0,2,0,0,1,15
2478,780812,33,7,25,3,12,4,13,3,6,2,8,1,4,1,1,1,21
2478,796766,14,1,6,1,2,0,4,5,5,1,3,0,1,1,2,2,7
2478,785614,8,0,0,0,0,0,0,0,0,1,1,0,3,0,1,1,0
2478,791111,19,0,1,0,0,0,1,0,0,0,2,0,2,0,0,0,0
2478,796765,16,1,3,1,3,0,0,0,0,0,0,3,2,2,2,0,2
2479,792492,36,3,11,2,7,1,4,5,8,3,10,3,1,1,4,1,12
2479,780023,26,5,6,5,6,0,0,4,5,1,5,0,3,2,0,2,14
2479,792493,33,3,6,1,1,2,5,0,0,1,0,1,1,1,2,0,8
2479,792495,34,6,15,5,10,1,5,2,2,0,6,4,2,5,2,2,15
2479,792491,40,4,9,4,9,0,0,6,9,3,6,3,2,2,6,0,14
2479,798960,8,0,3,0,3,0,0,0,0,1,0,0,0,1,0,1,0
2479,792490,9,0,1,0,0,0,1,0,1,1,1,0,1,0,0,0,0
2479,786832,14,2,4,2,3,0,1,0,1,0,2,0,1,0,1,0,4
2480,785670,25,1,7,0,1,1,6,0,0,1,2,0,3,0,1,0,3
2480,774969,24,1,6,1,6,0,0,5,6,4,5,2,3,0,1,2,7
2480,791181,33,4,6,3,4,1,2,3,5,0,5,1,3,3,2,0,12
2480,781054,36,7,14,3,5,4,9,4,6,0,2,0,4,1,2,0,22
2480,781053,38,2,13,2,6,0,7,8,9,1,3,6,2,2,1,0,12
2480,796850,11,0,1,0,0,0,1,0,2,1,1,1,3,1,1,0,0
2480,780981,6,0,1,0,0,0,1,0,0,0,2,0,1,0,2,0,0
2480,796848,5,0,0,0,0,0,0,0,0,0,0,1,0,0,0,0,0
2480,791179,22,1,3,0,0,1,3,0,2,1,2,1,0,0,0,0,3
2481,788113,24,4,5,1,1,3,4,2,2,1,6,1,3,2,2,0,13
2481,776497,33,7,12,5,10,2,2,6,7,1,3,0,4,1,3,2,22
2481,785731,28,2,9,2,9,0,0,1,1,3,7,1,3,1,3,1,5
2481,785729,20,1,5,1,4,0,1,4,4,0,2,2,2,1,1,0,6
2481,780864,26,1,6,0,3,1,3,0,2,1,1,3,2,0,2,0,3
2481,799881,7,1,2,1,2,0,0,0,2,0,0,0,1,0,2,1,2
2481,792405,7,0,0,0,0,0,0,0,0,0,2,0,0,0,2,0,0
2481,792402,20,0,3,0,1,0,2,1,2,0,0,1,1,0,0,0,1
2481,796211,16,2,3,1,2,1,1,0,0,4,2,0,3,0,0,0,5
2481,786231,19,3,7,3,4,0,3,2,3,0,4,1,4,0,1,0,8
2482,785498,29,6,10,6,8,0,2,5,8,2,7,1,3,1,3,0,17
2482,776469,34,6,8,5,7,1,1,1,2,5,6,5,2,1,4,1,14
2482,796705,33,8,16,5,11,3,5,3,3,2,2,6,4,1,3,1,22
2482,796708,35,4,10,2,5,2,5,2,2,0,0,3,5,2,1,1,12
2482,776322,36,2,8,0,1,2,7,0,0,0,3,0,0,0,0,1,6
2482,796709,11,0,2,0,0,0,2,0,0,1,3,1,2,0,1,0,0
2482,796706,19,0,2,0,2,0,0,2,2,0,1,1,0,0,0,1,2
2482,791036,3,0,1,0,1,0,0,0,0,0,0,0,1,0,0,0,0
2483,792068,40,11,20,8,12,3,8,1,1,1,3,0,2,0,3,0,26
2483,784640,16,1,3,1,2,0,1,1,2,0,1,2,3,1,0,0,3
2483,792072,34,7,9,2,3,5,6,2,2,0,3,1,3,0,0,0,21
2483,792069,30,5,10,5,9,0,1,1,3,0,2,5,4,1,2,0,11
2483,785572,26,1,5,1,4,0,1,2,2,0,2,1,2,1,2,0,4
2483,797657,9,0,0,0,0,0,0,0,0,0,0,1,0,0,0,0,0
2483,797652,21,3,4,2,2,1,2,2,2,0,3,3,4,2,2,0,9
2483,797655,24,1,2,1,2,0,0,0,2,0,5,0,1,2,1,1,2
2484,790833,29,2,7,2,7,0,0,2,6,1,6,1,4,1,3,1,6
2484,785518,38,4,8,4,7,0,1,5,8,1,8,3,2,3,4,1,13
2484,796390,13,2,2,2,2,0,0,0,2,2,4,0,4,1,5,2,4
2484,785451,28,2,10,0,1,2,9,2,2,1,2,0,2,0,2,0,8
2484,790834,22,3,8,2,5,1,3,1,2,3,4,1,4,1,1,0,8
2484,796388,8,0,1,0,1,0,0,0,0,1,2,0,1,0,1,0,0
2484,790830,18,0,5,0,4,0,1,0,0,0,2,3,4,0,1,0,0
2484,785379,18,2,5,2,4,0,1,0,1,2,2,1,0,1,1,1,4
2484,790832,24,2,7,0,3,2,4,0,0,1,3,1,2,0,1,0,6
2484,780297,2,0,0,0,0,0,0,0,0,0,0,0,1,0,0,0,0
2485,792277,11,2,3,2,3,0,0,1,2,1,1,0,1,0,0,0,5
2485,781464,21,0,8,0,3,0,5,0,0,0,2,0,1,1,1,0,0
2485,785282,25,2,5,2,2,0,3,2,3,1,2,0,3,0,2,0,6
2485,781502,31,0,3,0,1,0,2,5,6,0,6,6,3,0,2,0,5
2485,780259,34,1,7,0,4,1,3,1,4,1,6,3,4,0,2,1,4
2485,798058,0,0,1,0,0,0,1,0,0,0,0,0,1,1,1,0,0
2485,785913,29,4,8,4,8,0,0,5,8,0,5,2,3,2,1,0,13
2485,786516,24,4,8,0,1,4,7,2,2,1,3,0,0,0,0,0,14
2485,781501,25,4,6,4,5,0,1,1,3,0,2,2,2,2,1,0,9
2486,790870,23,3,4,3,4,0,0,4,4,2,3,0,3,2,2,0,10
2486,790869,32,7,11,4,6,3,5,9,10,0,8,6,2,2,2,0,26
2486,780493,38,3,12,0,0,3,12,0,0,0,3,5,4,0,1,0,9
2486,780116,16,2,3,2,2,0,1,1,2,2,0,1,4,0,0,1,5
2486,790866,40,7,11,0,0,7,11,5,6,1,1,1,4,0,4,0,26
2486,796426,15,3,5,3,5,0,0,0,0,1,2,0,2,0,1,0,6
2486,780492,3,0,0,0,0,0,0,0,0,0,0,0,1,0,0,0,0
2486,796427,32,0,4,0,1,0,3,3,6,1,5,3,3,2,2,0,3
2486,796424,1,0,0,0,0,0,0,0,0,0,1,1,0,0,0,0,0
2487,791493,37,7,8,7,8,0,0,2,6,0,5,0,2,0,5,1,16
2487,789036,22,6,10,6,10,0,0,1,4,3,4,0,5,1,0,0,13
2487,791494,34,5,10,3,7,2,3,2,3,0,3,3,2,1,1,0,14
2487,786324,35,5,18,2,7,3,11,5,5,0,4,7,3,1,3,0,18
2487,776494,35,2,6,1,1,1,5,0,1,3,1,1,4,2,1,0,5
2487,781307,12,3,5,3,5,0,0,0,0,2,0,0,5,1,1,0,6
2487,797192,15,1,3,1,3,0,0,0,0,1,3,1,5,0,1,0,2
2487,778888,10,1,3,0,2,1,1,0,0,0,1,1,1,0,0,0,3
2488,785298,16,2,3,2,3,0,0,0,0,2,6,1,1,1,1,1,4
2488,775224,11,2,5,2,5,0,0,0,0,1,4,1,0,1,0,2,4
2488,778046,23,6,14,5,11,1,3,1,2,0,4,7,0,2,1,0,14
2488,782121,24,4,7,3,3,1,4,0,0,0,1,6,3,2,1,1,9
2488,775793,28,3,6,1,3,2,3,5,5,3,1,2,0,0,1,0,13
2488,785485,18,5,8,5,8,0,0,0,0,4,4,1,4,0,0,0,10
2488,796598,25,4,7,0,1,4,6,3,4,0,0,2,2,2,0,0,15
2488,785302,19,5,9,4,6,1,3,1,2,1,2,3,1,1,1,0,12
2488,796599,16,4,5,4,5,0,0,0,0,1,3,0,0,0,0,0,8
2488,790987,14,1,5,0,2,1,3,4,4,1,3,2,2,0,0,0,7
2488,778469,3,1,2,0,1,1,1,0,0,0,0,0,1,0,0,0,3
2488,785301,3,0,0,0,0,0,0,0,0,0,0,0,0,0,0,0,0
2489,792418,29,3,9,3,8,0,1,0,0,1,2,1,5,1,2,2,6
2489,796693,29,0,8,0,3,0,5,4,4,0,0,3,0,0,4,0,4
2489,796691,31,1,5,1,5,0,0,0,0,2,3,0,2,0,3,0,2
2489,792422,28,2,7,2,7,0,0,1,1,4,5,0,1,0,7,0,5
2489,789484,37,9,20,6,15,3,5,4,8,3,7,2,2,0,3,1,25
2489,792424,15,0,2,0,2,0,0,0,0,0,0,1,5,0,1,0,0
2489,796695,17,0,1,0,1,0,0,0,0,1,2,1,0,0,1,0,0
2489,796692,2,0,1,0,1,0,0,0,0,0,0,0,0,0,0,0,0
2489,792419,7,0,0,0,0,0,0,0,0,0,0,0,2,0,0,0,0
2489,792423,2,0,0,0,0,0,0,0,0,0,1,0,0,0,1,0,0
2489,799739,3,0,0,0,0,0,0,0,0,0,1,0,0,0,0,0,0
2490,785126,9,2,3,2,2,0,1,0,0,1,0,2,3,1,2,0,4
2490,779857,20,6,13,6,12,0,1,4,4,3,1,0,2,1,0,1,16
2490,785339,29,3,4,0,0,3,4,0,0,2,1,5,1,1,1,1,9
2490,779976,34,4,8,2,5,2,3,0,0,0,4,10,2,0,4,0,10
2490,774990,33,10,19,4,6,6,13,4,6,0,5,1,3,2,1,0,30
2490,796673,8,1,2,1,2,0,0,0,0,1,0,1,1,0,0,0,2
2490,796674,17,1,6,1,3,0,3,0,0,2,4,2,4,1,2,0,2
2490,786737,7,0,2,0,0,0,2,1,2,0,0,1,0,0,0,0,1
2490,781586,20,5,7,5,7,0,0,3,5,0,5,4,2,0,0,0,13
2490,785961,17,0,0,0,0,0,0,0,2,0,2,0,2,1,1,1,0
2490,791014,6,0,2,0,0,0,2,0,0,0,0,0,0,0,1,0,0
2491,799000,16,1,2,1,2,0,0,0,0,1,2,0,5,0,0,0,2
2491,785471,29,4,10,3,7,1,3,4,4,2,6,2,1,0,4,3,13
2491,780263,21,2,6,2,3,0,3,2,4,1,2,0,2,0,2,0,6
2491,780571,7,0,4,0,2,0,2,0,0,0,0,0,1,0,2,0,0
2491,775628,27,8,12,8,11,0,1,7,7,1,2,5,3,6,2,0,23
2491,792399,29,6,13,5,10,1,3,2,2,4,8,1,3,1,3,0,15
2491,775198,28,3,9,3,7,0,2,2,2,2,2,0,1,0,1,0,8
2491,792400,13,1,2,1,2,0,0,0,0,0,1,1,1,0,1,0,2
2491,786697,15,0,0,0,0,0,0,0,0,0,3,0,1,0,1,0,0
2491,792397,15,0,3,0,1,0,2,2,2,1,1,1,3,0,0,0,2
2492,781579,20,8,10,8,10,0,0,0,0,4,7,4,0,0,0,0,16
2492,786731,15,3,3,3,3,0,0,2,2,1,8,5,2,1,0,6,8
2492,798023,21,2,9,2,3,0,6,2,2,1,0,7,2,2,1,0,6
2492,781584,21,5,9,1,2,4,7,0,0,1,0,1,1,0,0,0,14
2492,780347,23,5,9,5,8,0,1,2,4,2,2,2,1,1,2,0,12
2492,798021,2,0,0,0,0,0,0,0,0,0,1,0,1,0,0,0,0
2492,775696,17,4,11,4,8,0,3,1,1,1,1,0,2,0,0,0,9
2492,798026,9,1,3,1,3,0,0,1,2,4,2,0,5,0,0,0,3
2492,792360,3,0,0,0,0,0,0,0,0,0,0,0,0,0,0,1,0
2492,776481,13,4,7,4,7,0,0,0,2,5,5,0,2,3,0,0,8
2492,798019,8,3,6,1,2,2,4,0,0,0,1,1,0,0,1,0,8
2492,798017,13,2,6,0,2,2,4,0,0,0,3,1,2,0,3,0,6
2492,798008,15,3,6,1,1,2,5,2,2,0,3,4,3,0,1,0,10
2492,792358,18,3,4,2,3,1,1,0,0,0,3,2,1,0,1,0,7
2492,798018,2,0,0,0,0,0,0,0,0,0,0,0,0,0,0,0,0
2493,797345,10,0,4,0,4,0,0,0,0,2,2,0,0,0,2,0,0
2493,797342,18,0,0,0,0,0,0,0,0,0,3,1,2,0,0,2,0
2493,791747,28,8,16,6,10,2,6,2,3,1,2,1,1,1,2,0,20
2493,791746,22,1,4,1,3,0,1,1,5,2,3,2,3,1,2,2,3
2493,786188,32,2,10,2,7,0,3,3,5,2,4,0,3,0,0,0,7
2493,797343,10,0,3,0,2,0,1,0,0,1,2,2,0,0,0,0,0
2493,791743,20,3,9,3,9,0,0,1,2,1,4,0,2,0,3,1,7
2493,791744,3,3,3,3,3,0,0,0,2,2,0,0,1,0,0,0,6
2493,797341,19,4,9,2,3,2,6,1,2,2,0,0,0,1,2,0,11
2493,786193,20,1,6,0,2,1,4,2,2,0,2,2,0,0,1,1,5
2493,786184,5,0,1,0,0,0,1,0,0,0,0,0,0,0,1,0,0
2493,780711,13,1,5,0,1,1,4,0,0,0,0,1,1,1,0,0,3
2494,781174,26,1,3,1,3,0,0,1,2,1,4,1,2,0,3,2,3
2494,781159,26,4,7,4,6,0,1,4,6,0,5,3,4,2,2,0,12
2494,791001,36,7,11,6,8,1,3,1,1,1,2,5,2,3,1,0,16
2494,779972,33,4,8,4,6,0,2,4,6,2,6,4,3,1,4,2,12
2494,775255,32,8,13,5,8,3,5,1,3,2,4,3,2,2,2,0,20
2494,796643,9,0,1,0,1,0,0,0,0,0,1,0,2,1,0,0,0
2494,796644,12,2,2,2,2,0,0,1,2,1,3,0,0,1,0,1,5
2494,796641,2,1,1,1,1,0,0,0,0,0,0,0,1,0,0,0,2
2494,796639,2,0,1,0,0,0,1,0,0,0,0,0,1,0,0,0,0
2494,785320,21,3,5,2,2,1,3,0,0,0,1,3,3,0,0,0,7
2494,791601,1,0,0,0,0,0,0,0,0,0,0,0,0,0,0,0,0
2495,797546,18,2,5,2,5,0,0,0,0,0,2,0,4,0,0,0,4
2495,780351,19,0,3,0,3,0,0,2,2,1,1,1,3,0,1,0,2
2495,797549,22,2,3,2,3,0,0,1,5,3,1,3,0,0,2,0,5
2495,790857,26,0,5,0,2,0,3,0,0,0,2,2,0,0,4,0,0
2495,780586,27,5,12,4,10,1,2,2,3,0,3,1,3,0,2,0,13
2495,797544,21,2,6,2,5,0,1,2,2,0,2,0,2,0,1,1,6
2495,791799,5,0,1,0,1,0,0,0,0,2,0,0,0,0,0,0,0
2495,797539,2,0,0,0,0,0,0,0,0,0,0,1,0,0,0,0,0
2495,797545,4,0,2,0,1,0,1,0,2,0,0,0,1,0,0,0,0
2495,797540,9,1,4,0,3,1,1,0,0,0,0,0,3,0,0,0,3
2495,791716,15,3,4,3,4,0,0,2,3,2,0,0,0,1,0,0,8
2495,791715,16,1,5,1,3,0,2,0,0,1,3,0,2,1,3,0,2
2495,791714,0,1,1,0,0,1,1,0,0,0,0,0,0,0,0,0,3
2495,789065,4,0,1,0,0,0,1,1,2,0,1,0,0,0,0,0,1
2495,785855,12,2,4,0,1,2,3,0,0,1,2,0,0,1,0,0,6
2498,792565,31,3,7,3,7,0,0,10,13,3,5,3,3,1,3,0,16
2498,776333,17,2,4,2,4,0,0,5,6,3,0,0,1,1,0,1,9
2498,792563,26,2,6,2,5,0,1,3,5,0,4,1,3,2,2,0,7
2498,792561,34,4,4,3,3,1,1,0,1,1,3,1,1,2,3,0,9
2498,780266,26,4,11,4,5,0,6,2,2,1,5,1,4,0,2,0,10
2498,798134,35,6,9,4,6,2,3,0,2,1,4,2,1,1,1,0,14
2498,792560,9,1,2,1,2,0,0,3,6,1,0,0,1,0,0,0,5
2498,798135,14,0,1,0,1,0,0,0,0,0,0,2,1,0,0,0,0
2498,789634,2,0,1,0,1,0,0,0,0,0,0,0,1,0,0,0,0
2498,798133,6,0,0,0,0,0,0,0,0,0,0,0,1,0,0,0,0
2499,786054,23,3,5,3,5,0,0,0,0,1,5,0,4,1,0,1,6
2499,791964,23,1,3,0,0,1,3,0,8,2,2,2,4,3,2,0,3
2499,786056,29,2,5,0,1,2,4,0,2,0,3,8,4,2,1,0,6
2499,781339,34,2,10,0,0,2,10,1,3,0,3,2,2,0,2,0,7
2499,781337,34,2,5,0,1,2,4,0,0,0,3,4,2,0,6,0,6
2499,797712,20,2,2,2,2,0,0,2,4,3,2,0,5,0,1,1,6
2499,797711,22,5,11,1,2,4,9,0,0,1,0,0,3,0,3,0,14
2499,797710,9,1,4,0,0,1,4,0,0,0,0,0,0,0,0,0,3
2499,799737,4,0,0,0,0,0,0,0,0,0,1,0,0,0,1,0,0
2499,797713,2,0,0,0,0,0,0,1,2,1,1,0,1,0,0,0,1
2500,791295,20,2,3,1,2,1,1,0,0,2,0,0,3,0,1,0,5
2500,776345,32,9,17,6,12,3,5,1,3,4,6,0,2,0,2,4,22
2500,791293,26,0,3,0,1,0,2,4,6,0,3,5,0,0,0,0,4
2500,796579,32,4,9,1,1,3,8,0,0,0,2,2,3,5,1,0,11
2500,781373,34,2,8,2,5,0,3,4,8,0,2,1,4,1,5,0,8
2500,781379,15,2,3,2,3,0,0,0,1,2,2,0,3,0,1,1,4
2500,791292,9,1,1,1,1,0,0,0,2,2,2,0,0,1,1,1,2
2500,796580,14,2,10,2,7,0,3,0,0,0,1,0,0,1,1,0,4
2500,785792,18,3,5,1,2,2,3,0,1,0,3,1,2,0,1,0,8
2501,786765,33,2,8,2,5,0,3,10,10,2,8,4,3,1,2,1,14
2501,792379,34,4,10,2,8,2,2,3,4,2,5,0,3,0,1,1,13
2501,792380,36,5,8,3,5,2,3,2,2,0,0,1,1,1,2,0,14
2501,781672,30,1,5,1,5,0,0,0,0,1,5,1,2,0,1,1,2
2501,781669,32,7,15,4,8,3,7,2,2,1,4,2,3,1,5,0,19
2501,786764,3,0,1,0,0,0,1,0,0,0,1,0,0,0,0,0,0
2501,781668,4,0,0,0,0,0,0,0,0,0,1,0,1,1,0,0,0
2501,797854,9,1,2,1,2,0,0,0,0,0,3,0,4,0,1,0,2
2501,797852,14,0,3,0,3,0,0,0,0,0,0,3,1,1,2,0,0
2501,781671,5,1,1,1,1,0,0,0,0,1,0,0,1,0,0,0,2
2502,796372,18,1,2,1,2,0,0,0,0,1,2,1,3,0,2,0,2
2502,796377,17,3,6,2,2,1,4,0,0,1,0,2,2,1,2,0,7
2502,796379,34,6,9,2,3,4,6,0,0,3,3,5,1,2,1,0,16
2502,790815,32,5,8,2,2,3,6,0,0,2,10,2,3,3,5,0,13
2502,780176,31,4,9,1,3,3,6,1,2,0,3,7,2,2,2,0,12
2502,790814,19,2,7,2,4,0,3,1,2,2,2,1,2,1,2,0,5
2502,796375,9,3,3,3,3,0,0,0,0,1,4,0,2,1,3,0,6
2502,796378,27,0,5,0,1,0,4,2,2,1,2,5,2,0,1,0,2
2502,796376,11,3,7,3,6,0,1,1,1,2,1,0,0,0,0,0,7
2502,790817,1,0,1,0,0,0,1,0,0,0,0,0,0,0,0,0,0
2502,796373,1,0,3,0,2,0,1,0,0,0,1,0,0,0,0,0,0
2503,786080,28,1,8,1,3,0,5,0,0,1,1,1,2,2,4,0,2
2503,786216,26,4,5,3,4,1,1,1,3,0,3,0,1,1,1,0,10
2503,791348,29,0,4,0,3,0,1,3,6,0,3,0,1,2,2,0,3
2503,786218,20,1,4,1,1,0,3,0,0,0,1,0,0,0,0,0,2
2503,780663,27,2,9,1,5,1,4,2,2,0,3,6,1,2,6,0,7
2503,791350,24,2,5,0,1,2,4,0,0,1,2,2,0,0,4,0,6
2503,780150,17,3,5,0,1,3,4,0,0,0,1,0,1,0,0,0,9
2503,797257,8,1,1,1,1,0,0,0,0,1,0,0,0,0,0,0,2
2503,780156,12,1,2,0,0,1,2,0,0,1,0,0,1,0,0,1,3
2503,781645,4,0,2,0,2,0,0,0,0,0,1,1,0,0,0,0,0
2503,797258,4,1,2,1,2,0,0,0,0,1,1,0,0,0,0,2,2
2503,786221,1,0,0,0,0,0,0,0,0,0,0,0,0,0,0,0,0
2504,797587,26,5,5,5,5,0,0,1,2,1,3,3,4,1,2,0,11
2504,791894,5,0,0,0,0,0,0,0,0,0,0,1,0,0,0,0,0
2504,786502,39,7,10,6,9,1,1,7,11,1,5,6,3,0,6,0,22
2504,781561,10,0,1,0,0,0,1,0,0,0,2,1,1,1,2,0,0
2504,781080,37,3,8,0,0,3,8,0,0,0,1,0,1,1,1,0,9
2504,791891,2,0,1,0,1,0,0,0,1,0,0,0,0,0,1,0,0
2504,781078,25,2,7,1,2,1,5,0,0,0,3,1,2,0,2,0,5
2504,797584,36,6,8,4,4,2,4,0,0,0,1,2,1,1,0,0,14
2504,791895,17,2,4,2,4,0,0,0,0,0,3,0,1,0,1,0,4
2504,797586,1,0,0,0,0,0,0,0,0,0,0,0,0,0,0,0,0
2504,786501,2,0,0,0,0,0,0,0,0,0,0,0,0,0,0,0,0
2505,792227,29,5,8,4,6,1,2,1,1,3,3,2,2,1,2,2,12
2505,781352,29,6,10,6,9,0,1,0,0,0,1,3,3,1,0,0,12
2505,792223,31,8,14,6,9,2,5,3,4,0,5,4,2,2,4,0,21
2505,785935,33,5,8,2,3,3,5,0,0,0,4,2,1,0,1,1,13
2505,781340,34,3,5,3,4,0,1,0,0,0,1,2,3,2,0,0,6
2505,797881,10,3,5,3,5,0,0,0,0,1,1,1,0,2,0,0,6
2505,797889,2,0,0,0,0,0,0,0,0,0,1,0,1,0,1,0,0
2505,781351,11,0,2,0,1,0,1,0,0,0,1,1,2,0,0,0,0
2505,776128,21,0,3,0,2,0,1,0,0,1,1,3,3,2,1,1,0
2506,797028,15,4,6,3,5,1,1,0,0,2,2,1,0,0,1,0,9
2506,791598,36,4,9,3,8,1,1,3,4,1,2,2,2,1,4,3,12
2506,797025,22,4,9,4,6,0,3,4,5,2,0,1,4,1,3,0,12
2506,792116,32,3,7,1,1,2,6,6,7,0,5,8,5,3,1,1,14
2506,780410,32,6,13,2,4,4,9,7,7,1,4,0,1,1,1,0,23
2506,797026,8,0,1,0,0,0,1,0,0,0,0,0,2,1,1,0,0
2506,785687,13,0,4,0,0,0,4,0,0,1,2,3,1,0,0,0,0
2506,797027,15,2,4,2,4,0,0,2,2,2,3,1,5,0,0,1,6
2506,791597,2,0,0,0,0,0,0,0,0,1,0,0,0,0,0,0,0
2506,791600,24,4,16,3,7,1,9,3,4,2,0,4,2,3,2,2,12
2506,775047,1,0,0,0,0,0,0,0,0,0,0,0,0,0,0,0,0
2507,791023,32,3,5,3,5,0,0,0,0,0,9,1,3,0,6,6,6
2507,791027,34,5,8,4,7,1,1,0,0,2,10,4,4,2,2,0,11
2507,791024,38,12,16,8,9,4,7,5,8,2,3,1,4,1,4,0,33
2507,781507,26,1,2,1,1,0,1,6,8,0,5,5,4,0,2,0,8
2507,777572,31,7,12,6,9,1,3,6,7,2,1,4,4,2,4,0,21
2507,791028,10,0,1,0,0,0,1,0,0,0,0,1,1,1,1,0,0
2507,796685,26,4,11,1,3,3,8,3,3,0,1,2,1,1,1,0,14
2507,796684,3,0,0,0,0,0,0,0,0,0,0,0,2,0,2,0,0
2508,776253,17,10,16,5,8,5,8,1,2,2,1,0,1,0,0,1,26
2508,775651,15,3,6,1,2,2,4,0,0,1,2,0,1,0,1,0,8
2508,796504,23,5,9,5,5,0,4,0,0,2,7,5,1,2,2,1,10
2508,791627,24,6,10,2,3,4,7,0,0,0,1,3,1,0,2,0,16
2508,785665,23,4,7,1,1,3,6,0,1,1,4,2,2,2,1,0,11
2508,791076,3,0,0,0,0,0,0,0,0,0,0,0,1,0,0,0,0
2508,796505,7,1,4,1,3,0,1,0,0,0,0,0,1,0,0,0,2
2508,791071,11,3,3,3,3,0,0,0,5,5,2,2,1,1,0,0,6
2508,785660,10,1,1,1,1,0,0,0,0,2,1,1,0,0,0,1,2
2508,796502,19,3,5,3,4,0,1,0,0,2,7,6,3,0,2,0,6
2508,796501,22,4,8,4,6,0,2,0,0,2,1,4,0,1,0,0,8
2508,791073,4,1,3,1,2,0,1,0,0,0,0,0,0,0,0,0,2
2508,791070,22,2,5,2,4,0,1,6,7,1,1,4,3,2,0,0,10
2510,775954,28,3,5,3,5,0,0,4,4,1,5,5,1,0,1,0,10
2510,781006,28,5,8,4,5,1,3,2,2,0,9,0,2,0,3,0,13
2510,796194,28,4,9,0,1,4,8,4,4,1,6,5,3,1,1,0,16
2510,790917,19,3,7,2,4,1,3,0,0,3,4,1,4,0,1,1,7
2510,781157,25,5,10,3,3,2,7,6,7,0,0,3,0,1,0,0,18
2510,796464,21,4,10,4,9,0,1,4,8,0,1,5,2,3,1,2,12
2510,796459,21,2,6,0,4,2,2,4,4,1,2,1,5,0,3,1,10
2510,780648,14,2,3,2,3,0,0,5,6,4,1,1,0,2,0,0,9
2510,790918,9,3,4,3,4,0,0,0,0,1,1,0,4,0,0,0,6
2510,785238,4,0,0,0,0,0,0,1,2,0,1,2,0,0,0,1,1
2510,790916,3,0,0,0,0,0,0,0,0,0,1,0,1,0,0,0,0
2511,797715,26,2,10,1,4,1,6,0,0,0,3,2,4,1,3,0,5
2511,797717,11,0,2,0,0,0,2,0,0,0,0,1,5,1,3,0,0
2511,780937,28,4,9,3,4,1,5,1,1,0,5,2,5,1,0,0,10
2511,780938,14,3,4,3,4,0,0,0,1,0,2,2,5,1,2,0,6
2511,775754,31,4,11,4,10,0,1,5,8,3,4,3,3,0,1,0,13
2511,792115,25,3,5,3,4,0,1,4,4,1,1,1,3,1,3,0,10
2511,797716,13,0,0,0,0,0,0,1,3,0,1,0,4,0,0,0,1
2511,791950,30,4,11,3,6,1,5,3,3,0,2,1,0,0,3,0,12
2511,791149,22,3,6,1,2,2,4,1,1,0,2,0,1,1,2,0,9
2512,780870,22,5,5,5,5,0,0,0,2,0,10,1,2,0,2,3,10
2512,781079,28,7,10,4,5,3,5,3,4,0,3,6,3,1,2,0,20
2512,785380,21,3,5,3,5,0,0,0,0,1,1,1,2,0,0,0,6
2512,781443,33,1,7,1,4,0,3,1,2,0,0,7,3,2,2,0,3
2512,775822,30,7,9,1,2,6,7,0,0,1,5,1,0,2,1,0,20
2512,796626,5,0,0,0,0,0,0,0,0,0,1,0,0,2,1,0,0
2512,791316,13,1,3,1,3,0,0,0,0,1,1,0,2,0,2,0,2
2512,796625,13,2,3,1,1,1,2,1,1,0,1,1,1,1,1,0,6
2512,796621,16,1,4,0,0,1,4,0,0,0,0,1,0,0,0,0,3
2512,785831,19,1,2,1,2,0,0,0,2,0,0,1,2,0,0,1,2
2513,791107,11,0,3,0,3,0,0,0,1,0,0,1,3,0,2,0,0
2513,791106,16,2,4,2,3,0,1,2,2,1,0,0,1,0,4,0,6
2513,775538,25,1,2,1,2,0,0,2,2,4,5,0,1,2,0,0,4
2513,785603,30,2,9,1,4,1,5,1,1,2,4,0,3,1,2,0,6
2513,776425,36,6,10,3,4,3,6,0,0,0,1,3,3,0,2,0,15
2513,796763,13,2,3,0,0,2,3,1,2,0,1,0,1,0,0,0,7
2513,775820,20,1,3,0,1,1,2,0,0,0,2,0,1,0,0,1,3
2513,791110,29,2,9,1,6,1,3,6,8,0,2,1,0,1,2,0,11
2513,796762,16,1,3,1,3,0,0,1,2,0,5,1,0,1,1,0,3
2513,786494,4,0,2,0,1,0,1,0,0,0,0,0,1,0,1,0,0
2514,797616,17,4,6,4,5,0,1,1,1,2,4,2,5,0,2,1,9
2514,791882,27,7,9,6,7,1,2,3,3,4,7,3,1,0,2,0,18
2514,786491,27,3,5,2,4,1,1,0,0,2,7,4,2,0,1,3,7
2514,791881,29,6,13,3,4,3,9,2,2,0,1,7,0,3,4,0,17
2514,786420,29,3,7,1,1,2,6,2,3,0,3,2,1,1,3,0,10
2514,797618,11,1,3,1,3,0,0,3,5,2,0,1,1,0,1,0,5
2514,797617,8,2,3,1,2,1,1,0,0,1,3,1,2,0,1,0,5
2514,797613,18,4,10,2,3,2,7,0,0,2,3,0,2,2,1,0,10
2514,786492,3,0,2,0,0,0,2,0,0,0,1,0,0,0,2,0,0
2514,781258,12,1,3,0,1,1,2,2,4,0,3,1,1,0,4,0,5
2514,781052,19,4,5,0,0,4,5,0,0,0,4,0,0,0,0,0,12
2516,781319,34,6,14,6,14,0,0,13,15,5,6,1,1,1,1,1,25
2516,792220,10,1,4,0,1,1,3,2,2,1,3,0,4,1,3,0,5
2516,786691,35,2,13,1,6,1,7,5,7,1,7,3,5,1,3,0,10
2516,786693,23,3,10,2,6,1,4,0,0,3,1,2,5,0,2,1,7
2516,781455,32,1,4,1,2,0,2,2,4,1,2,2,2,2,2,0,4
2516,797876,14,1,2,1,1,0,1,2,2,0,3,1,2,1,0,0,4
2516,792222,15,1,3,1,1,0,2,0,0,0,1,1,1,0,0,0,2
2516,786843,2,0,0,0,0,0,0,0,0,0,0,0,1,0,0,0,0
2516,781408,18,0,0,0,0,0,0,1,4,1,1,0,5,1,3,1,1
2516,792046,17,3,6,2,2,1,4,1,3,0,1,1,5,0,4,0,8
2517,797367,23,1,4,1,4,0,0,5,6,3,3,0,4,1,2,1,7
2517,797369,27,2,5,2,3,0,2,4,6,2,4,2,4,0,0,0,8
2517,797366,12,1,3,1,3,0,0,1,4,2,2,0,4,0,3,0,3
2517,791807,33,3,11,1,7,2,4,2,2,1,6,2,0,0,3,0,10
2517,786130,28,3,14,2,10,1,4,7,8,2,6,1,4,0,5,1,14
2517,797364,17,2,5,2,5,0,0,5,7,1,3,1,5,3,2,2,9
2517,797365,23,3,6,1,2,2,4,0,0,1,4,1,3,1,2,0,8
2517,797363,23,1,8,1,7,0,1,0,2,0,1,2,2,2,1,0,2
2517,791804,3,0,2,0,2,0,0,0,0,0,0,0,0,0,1,0,0
2517,791808,11,2,3,2,3,0,0,4,4,3,3,0,3,0,0,0,8
2518,781249,34,3,12,2,6,1,6,0,0,0,4,0,2,1,1,2,7
2518,775165,29,1,3,0,1,1,2,0,0,1,2,1,1,1,0,2,3
2518,785514,34,3,6,2,3,1,3,2,2,0,4,1,2,1,1,0,9
2518,785515,36,3,10,2,7,1,3,0,0,0,1,6,4,0,2,0,7
2518,781253,29,3,6,0,0,3,6,2,2,0,5,1,1,0,3,0,11
2518,796953,9,1,4,1,4,0,0,0,0,0,0,0,2,0,2,0,2
2518,796951,2,0,0,0,0,0,0,0,0,0,0,0,1,0,0,0,0
2518,791252,10,2,3,1,1,1,2,0,0,0,0,1,1,1,1,0,5
2518,791687,17,4,6,1,2,3,4,8,10,1,1,0,1,1,1,0,19
2519,782133,15,1,3,1,2,0,1,0,0,2,1,2,2,1,1,0,2
2519,785123,26,5,11,5,11,0,0,1,1,0,4,1,3,0,2,1,11
2519,790990,29,2,2,1,1,1,1,1,3,1,6,2,1,0,2,1,6
2519,789219,32,4,8,2,3,2,5,4,4,0,3,0,4,2,3,0,14
2519,785059,29,5,6,5,6,0,0,0,0,1,5,3,1,2,2,0,10
2519,785305,12,0,2,0,1,0,1,2,2,0,1,1,2,0,2,0,2
2519,796622,2,0,0,0,0,0,0,2,2,0,0,0,1,0,0,0,2
2519,796623,24,6,8,6,7,0,1,6,7,0,3,0,3,1,1,0,18
2519,790988,8,3,4,2,2,1,2,0,0,0,2,0,0,0,0,0,7
2519,785303,13,0,2,0,1,0,1,0,0,0,1,0,2,0,0,0,0
2519,785122,10,0,1,0,0,0,1,0,0,0,1,0,1,0,0,0,0
2520,791266,21,4,5,4,5,0,0,0,2,1,6,1,0,3,0,2,8
2520,785977,16,2,5,2,3,0,2,0,0,0,1,0,0,2,0,0,4
2520,791265,12,2,3,0,0,2,3,0,0,0,3,4,1,0,1,0,6
2520,791269,17,6,11,2,4,4,7,0,0,1,3,0,1,0,0,0,16
2520,785685,22,6,8,5,6,1,2,1,1,0,1,10,0,3,2,0,14
2520,796524,15,2,3,2,3,0,0,2,3,0,3,2,1,2,1,2,6
2520,788872,5,1,3,1,2,0,1,0,0,0,1,0,0,2,1,0,2
2520,796523,19,6,12,1,3,5,9,0,0,0,4,1,0,1,0,0,17
2520,796522,21,3,5,0,0,3,5,0,0,0,4,8,2,2,0,0,9
2520,796525,19,3,5,1,2,2,3,0,0,3,6,2,1,2,1,0,8
2520,791271,13,2,3,2,3,0,0,0,0,2,1,0,2,0,0,2,4
2520,781313,20,6,11,3,3,3,8,2,2,0,2,6,0,1,1,0,17
2522,785999,23,6,8,6,8,0,0,1,4,7,5,2,3,0,1,0,13
2522,775654,23,2,4,2,4,0,0,0,1,1,2,0,2,1,2,1,4
2522,775171,23,4,7,2,2,2,5,0,0,1,2,0,0,1,1,0,10
2522,791639,27,6,10,4,7,2,3,4,4,1,4,5,0,2,0,1,18
2522,785389,28,5,8,2,4,3,4,2,6,0,3,0,1,1,2,0,15
2522,796398,11,1,1,1,1,0,0,0,0,1,2,3,1,1,1,0,2
2522,785255,13,1,3,1,1,0,2,2,2,1,2,1,3,1,3,0,4
2522,791640,15,4,6,4,4,0,2,2,3,0,1,1,0,0,1,0,10
2522,796399,18,0,5,0,1,0,4,1,2,2,5,4,1,0,1,0,1
2522,796403,4,2,3,1,2,1,1,0,0,0,0,0,1,0,0,0,5
2522,796401,3,0,0,0,0,0,0,0,0,0,2,0,0,0,0,0,0
2522,796400,4,1,2,1,2,0,0,0,0,0,1,1,1,1,0,0,2
2522,791642,1,0,0,0,0,0,0,0,0,0,0,1,0,1,1,0,0
2522,791641,1,1,1,0,0,1,1,0,0,0,1,0,0,0,0,0,3
2522,796402,3,0,1,0,0,0,1,0,0,0,0,1,0,0,0,0,0
2522,785391,3,0,0,0,0,0,0,0,0,0,0,0,0,0,0,0,0
2523,799136,21,0,2,0,2,0,0,0,0,2,1,1,5,0,1,1,0
2523,799129,35,6,13,1,2,5,11,0,0,0,2,2,3,3,3,0,17
2523,799132,35,5,13,2,2,3,11,3,3,1,5,2,2,0,1,0,16
2523,799134,34,1,9,1,1,0,8,0,0,0,1,3,3,1,3,0,2
2523,792634,33,4,12,2,5,2,7,0,0,1,1,3,2,1,3,0,10
2523,799131,16,0,0,0,0,0,0,0,0,0,3,0,3,0,0,0,0
2523,799128,7,1,1,1,1,0,0,0,0,0,0,0,0,0,1,0,2
2523,799133,8,0,4,0,2,0,2,1,2,0,2,0,0,0,3,0,1
2523,799135,11,0,1,0,1,0,0,0,0,2,0,0,1,0,0,0,0
2524,781342,25,5,8,5,7,0,1,4,7,1,3,1,2,2,2,3,14
2524,781593,23,2,3,2,2,0,1,0,0,2,3,1,1,0,2,0,4
2524,790901,19,2,6,1,2,1,4,2,2,0,0,1,1,1,0,0,7
2524,785452,27,4,7,4,6,0,1,1,2,4,4,3,0,0,1,1,9
2524,781620,24,2,6,1,2,1,4,0,0,0,0,8,1,2,0,0,5
2524,796450,17,2,2,2,2,0,0,1,4,1,6,0,2,2,1,0,5
2524,774835,8,1,2,1,2,0,0,1,1,2,1,1,2,0,1,0,3
2524,790903,20,6,15,0,0,6,15,0,0,0,1,0,0,0,0,0,18
2524,790902,24,3,7,2,2,1,5,1,1,0,3,3,1,2,1,0,8
2524,796449,5,4,6,3,5,1,1,2,2,1,1,0,0,0,0,0,11
2524,796452,4,0,1,0,1,0,0,0,0,1,0,1,1,0,0,0,0
2524,796451,2,0,0,0,0,0,0,0,0,1,0,0,0,0,0,0,0
2524,790906,2,0,0,0,0,0,0,0,0,0,1,0,0,0,0,0,0
2525,797174,30,4,5,4,4,0,1,0,0,0,4,1,0,0,1,0,8
2525,791510,25,2,4,2,3,0,1,0,0,1,4,1,2,0,2,0,4
2525,786699,20,4,6,4,6,0,0,0,0,1,2,0,2,0,2,0,8
2525,797168,23,2,6,0,3,2,3,0,0,0,2,3,1,0,2,0,6
2525,775357,30,3,10,2,4,1,6,0,0,0,2,3,3,2,4,0,7
2525,791504,20,3,6,3,5,0,1,2,3,0,1,2,1,0,1,1,8
2525,785593,28,2,9,1,5,1,4,2,2,0,3,1,2,0,0,1,7
2525,791507,19,4,6,4,6,0,0,2,4,2,1,0,5,0,2,0,10
2525,786337,1,0,1,0,1,0,0,0,0,1,0,0,0,0,0,0,0
2525,791508,1,0,0,0,0,0,0,0,0,1,0,0,0,0,0,0,0
2525,791505,2,0,2,0,1,0,1,0,0,0,0,0,0,0,0,0,0
2525,791506,1,0,0,0,0,0,0,0,0,0,0,0,0,0,0,0,0
2526,786140,7,2,2,2,2,0,0,1,2,0,0,0,1,0,1,0,5
2526,786578,19,2,2,0,0,2,2,0,1,0,4,2,2,1,0,1,6
2526,797359,12,2,4,2,3,0,1,0,0,0,3,5,3,2,1,0,4
2526,785669,19,1,4,0,0,1,4,0,0,0,4,7,1,0,2,0,3
2526,775195,18,6,10,0,1,6,9,3,3,1,0,2,1,2,2,1,21
2526,797361,5,2,2,2,2,0,0,0,0,0,1,0,1,0,1,0,4
2526,791802,5,0,0,0,0,0,0,3,4,1,1,1,0,0,0,0,3
2526,797362,8,2,4,0,1,2,3,2,2,1,3,0,1,0,1,0,8
2526,786136,11,7,10,6,8,1,2,0,0,1,1,0,1,0,2,0,15
2526,775747,14,6,6,6,6,0,0,2,3,3,6,1,4,0,1,0,14
2526,797360,3,0,2,0,0,0,2,0,0,0,0,0,0,0,1,0,0
2526,797358,22,7,8,2,2,5,6,4,4,0,5,3,1,3,1,0,23
2526,797357,18,0,1,0,1,0,0,0,1,1,3,7,3,1,3,0,0
2526,791365,11,2,7,1,2,1,5,0,0,1,1,2,2,0,1,0,5
2526,786138,6,2,3,1,1,1,2,0,0,0,0,2,1,0,0,1,5
2526,781145,7,3,3,1,1,2,2,0,0,0,1,1,2,0,0,0,8
2526,776236,15,3,4,2,2,1,2,2,2,1,0,3,0,1,2,0,9
2528,796592,17,1,2,1,2,0,0,1,2,1,1,0,0,1,2,0,3
2528,780210,40,11,20,9,15,2,5,6,7,6,7,3,1,0,1,1,30
2528,796594,28,3,8,0,2,3,6,1,2,0,1,1,1,2,3,0,10
2528,792432,32,3,6,3,5,0,1,1,2,0,4,3,2,1,2,0,7
2528,775005,21,3,6,2,4,1,2,1,2,0,0,1,1,0,2,0,8
2528,790880,4,1,2,1,2,0,0,0,0,1,0,0,2,0,2,0,2
2528,791306,25,1,5,1,4,0,1,0,0,2,1,1,4,0,1,0,2
2528,792433,12,0,3,0,1,0,2,1,2,2,0,1,4,1,0,0,1
2528,786422,21,3,4,2,3,1,1,4,6,2,1,0,2,2,1,0,11
2529,791669,21,1,1,1,1,0,0,0,0,1,2,1,4,0,5,0,2
2529,785762,30,5,5,5,5,0,0,3,3,1,2,1,4,1,1,0,13
2529,797409,31,5,10,3,6,2,4,5,7,0,3,3,1,3,2,0,17
2529,780535,19,1,3,1,1,0,2,0,0,0,1,0,2,1,1,0,2
2529,780531,38,8,14,7,7,1,7,1,2,0,3,5,4,1,5,1,18
2529,797414,2,0,0,0,0,0,0,0,0,0,1,1,0,0,0,0,0
2529,780534,27,3,4,3,4,0,0,0,0,2,4,0,3,1,0,0,6
2529,791666,9,1,3,1,2,0,1,0,0,0,1,1,2,2,3,0,2
2529,785760,23,4,7,4,4,0,3,2,2,0,2,0,3,1,1,0,10
2530,790799,22,4,10,3,7,1,3,6,6,3,4,4,4,4,2,3,15
2530,790798,25,4,8,4,8,0,0,4,8,4,4,4,1,0,2,0,12
2530,780140,28,10,13,7,8,3,5,4,4,4,3,0,0,0,0,0,27
2530,796355,23,4,6,2,2,2,4,2,4,0,7,7,2,1,2,0,12
2530,780137,22,0,2,0,0,0,2,0,0,1,1,1,1,1,1,0,0
2530,785245,22,3,6,3,4,0,2,0,0,0,5,4,1,2,1,0,6
2530,775553,15,1,3,1,1,0,2,0,0,2,0,0,1,0,2,0,2
2530,796359,19,3,5,1,3,2,2,2,2,0,0,2,0,0,2,0,10
2530,796354,12,4,6,4,5,0,1,0,0,1,0,0,1,1,1,0,8
2530,790796,10,0,1,0,1,0,0,3,4,1,2,1,1,1,1,0,3
2530,794905,2,0,0,0,0,0,0,0,0,0,2,0,0,0,0,0,0
2531,791923,13,1,3,1,3,0,0,0,0,0,0,0,3,0,1,0,2
2531,781122,8,0,0,0,0,0,0,0,0,0,0,0,3,1,1,0,0
2531,791925,22,2,8,2,6,0,2,0,0,3,1,2,3,1,5,2,4
2531,791926,21,4,9,0,1,4,8,0,0,0,0,0,1,2,1,0,12
2531,781112,20,1,3,0,0,1,3,0,0,0,1,1,1,0,2,0,3
2531,791922,21,0,3,0,0,0,3,2,3,2,1,0,3,1,0,0,2
2531,797541,21,2,9,2,9,0,0,1,1,0,4,0,1,0,0,0,5
2531,797542,20,6,10,5,6,1,4,3,3,0,2,1,1,1,2,0,16
2531,786858,12,2,3,1,2,1,1,0,0,0,1,3,3,1,2,0,5
2531,786527,14,0,2,0,0,0,2,0,0,1,1,0,0,0,0,0,0
2531,786529,7,0,0,0,0,0,0,0,0,0,0,0,0,0,1,1,0
2531,791927,15,3,5,3,4,0,1,1,1,0,1,0,1,2,2,0,7
2531,778952,4,0,1,0,0,0,1,1,2,0,0,0,1,0,0,0,1
2531,797543,2,0,0,0,0,0,0,0,0,0,0,0,0,0,0,0,0
2532,792143,31,1,4,0,1,1,3,3,4,3,3,0,4,2,0,1,6
2532,780953,35,4,6,4,4,0,2,2,5,2,4,1,1,1,2,0,10
2532,786293,15,4,6,3,5,1,1,0,0,1,3,1,4,0,2,1,9
2532,797753,36,4,12,4,10,0,2,9,10,1,6,3,2,0,6,0,17
2532,786287,30,5,7,5,7,0,0,4,10,0,7,3,2,3,2,2,14
2532,797751,23,1,6,1,3,0,3,3,4,1,1,0,0,3,3,0,5
2532,792147,15,1,1,1,1,0,0,0,1,1,3,0,3,0,0,0,2
2532,797750,8,0,2,0,1,0,1,0,0,0,0,0,1,0,2,0,0
2532,797748,1,0,0,0,0,0,0,0,0,0,0,0,1,0,1,0,0
2532,786302,6,0,0,0,0,0,0,0,0,0,0,0,3,0,2,1,0
2533,781115,21,0,2,0,2,0,0,0,0,1,0,4,5,1,3,0,0
2533,785524,20,4,8,1,3,3,5,2,2,1,0,0,4,0,0,0,13
2533,775094,25,4,10,2,5,2,5,0,0,3,6,0,3,3,2,0,10
2533,780739,10,0,4,0,4,0,0,2,5,2,0,0,1,1,1,0,2
2533,791053,16,0,2,0,2,0,0,4,4,1,1,0,4,0,6,0,4
2533,775456,30,4,13,3,10,1,3,2,2,1,4,2,4,2,3,2,11
2533,790819,20,0,7,0,3,0,4,0,0,1,0,3,1,2,3,0,0
2533,791051,24,2,3,2,3,0,0,1,3,0,4,0,3,1,1,0,5
2533,796731,20,1,6,1,6,0,0,0,0,2,1,0,4,0,2,0,2
2533,796730,8,1,2,0,1,1,1,0,0,1,1,0,4,0,0,0,3
2533,786310,6,0,2,0,0,0,2,0,0,0,0,0,2,0,0,0,0
2540,791546,27,5,7,3,4,2,3,5,6,0,2,1,2,3,1,1,17
2540,775897,23,5,6,4,5,1,1,0,0,2,1,3,1,0,1,0,11
2540,784246,24,4,5,2,2,2,3,0,3,1,1,2,2,0,1,0,10
2540,786530,17,2,3,1,1,1,2,0,0,0,4,1,2,0,2,0,5
2540,780317,23,1,2,1,2,0,0,3,3,0,1,3,0,1,1,0,5
2540,786362,4,0,0,0,0,0,0,0,0,1,2,0,1,0,1,0,0
2540,785932,7,2,2,1,1,1,1,0,0,0,0,2,0,0,0,1,5
2540,797092,20,6,9,4,5,2,4,1,1,0,2,2,1,0,2,1,15
2540,791544,4,1,1,0,0,1,1,0,0,0,1,0,0,0,0,0,3
2540,797091,22,6,9,4,7,2,2,3,6,0,3,4,1,2,3,0,17
2540,791547,23,1,2,1,2,0,0,2,2,0,6,2,2,0,1,0,4
2540,775437,6,0,2,0,0,0,2,0,0,0,0,0,0,0,0,0,0
2542,791391,34,3,5,3,5,0,0,5,7,2,6,1,4,0,4,1,11
2542,797156,25,0,3,0,1,0,2,0,0,1,1,1,5,2,1,0,0
2542,791390,19,3,6,3,6,0,0,9,12,1,4,0,4,1,3,0,15
2542,780133,22,1,5,1,2,0,3,7,8,0,1,2,3,1,1,0,9
2542,780130,31,5,9,4,5,1,4,7,7,0,5,2,2,0,2,0,18
2542,797158,5,0,0,0,0,0,0,0,0,0,0,0,2,1,1,0,0
2542,791388,20,2,4,1,3,1,1,0,0,0,5,0,0,0,2,0,5
2542,775743,21,4,8,3,4,1,4,0,1,1,2,1,1,1,0,0,9
2542,776446,23,2,6,1,3,1,3,0,0,0,0,3,2,0,1,0,5
2543,775913,18,4,6,4,6,0,0,3,4,4,2,1,2,0,0,0,11
2543,791737,26,3,7,3,6,0,1,3,5,0,1,1,4,2,5,0,9
2543,783524,36,5,12,4,8,1,4,5,7,1,5,2,1,0,2,0,16
2543,786223,15,0,5,0,3,0,2,0,0,0,4,0,4,0,3,0,0
2543,780561,20,1,5,1,2,0,3,2,3,1,3,1,5,2,1,0,4
2543,791734,12,1,2,1,2,0,0,0,0,0,2,0,2,1,0,1,2
2543,781516,9,2,3,2,3,0,0,1,2,0,2,0,3,0,2,0,5
2543,797332,1,0,0,0,0,0,0,0,0,0,0,0,1,0,1,0,0
2543,797333,20,3,3,0,0,3,3,3,4,1,3,1,2,0,4,0,12
2543,797331,25,2,5,0,1,2,4,0,0,3,0,0,3,1,1,0,6
2543,786220,18,0,4,0,4,0,0,1,2,0,2,1,0,0,0,0,1
2544,796860,34,3,7,3,5,0,2,1,6,1,12,0,4,1,1,1,7
2544,791187,0,0,0,0,0,0,0,0,0,0,0,0,0,0,0,0,0
2544,796857,18,4,5,1,1,3,4,0,0,0,0,0,1,0,2,1,11
2544,785650,31,3,6,2,3,1,3,2,2,0,2,0,3,2,1,0,9
2544,785649,34,5,11,4,7,1,4,5,6,1,0,3,2,0,2,0,16
2544,791183,18,2,2,2,2,0,0,0,0,0,3,1,5,1,4,0,4
2544,775208,28,5,6,5,6,0,0,1,1,0,3,3,1,1,0,3,11
2544,796861,20,1,4,0,1,1,3,2,2,0,0,0,2,0,0,2,5
2544,791184,17,1,5,1,3,0,2,0,0,0,3,5,2,0,1,0,2
2545,797587,29,2,4,2,4,0,0,2,4,2,6,2,4,0,1,0,6
2545,791894,8,3,3,3,3,0,0,1,1,2,1,0,1,0,0,0,7
2545,786502,39,8,19,6,15,2,4,9,9,2,3,2,2,1,2,0,27
2545,781561,36,6,12,6,10,0,2,3,5,4,3,1,4,0,2,0,15
2545,781080,36,2,7,1,2,1,5,4,4,0,5,1,1,1,0,1,9
2545,797586,2,0,0,0,0,0,0,0,0,0,0,0,0,0,2,0,0
2545,781078,22,2,4,2,2,0,2,0,0,0,2,1,1,0,1,0,4
2545,797584,25,0,7,0,5,0,2,0,0,0,2,1,4,2,0,0,0
2545,791895,1,0,1,0,1,0,0,0,0,0,0,0,0,0,0,0,0
2545,786501,2,0,0,0,0,0,0,0,0,0,0,0,0,0,0,0,0
2546,791299,17,2,4,2,3,0,1,2,2,0,3,3,0,0,1,0,6
2546,791296,38,7,15,2,5,5,10,0,0,0,3,1,1,1,1,0,19
2546,775871,35,4,8,4,7,0,1,4,4,3,6,1,3,0,1,1,12
2546,796590,21,1,1,1,1,0,0,0,0,0,2,0,1,2,1,0,2
2546,791519,38,9,17,8,13,1,4,1,1,1,3,5,2,1,3,1,20
2546,792084,23,1,1,1,1,0,0,1,2,1,2,0,2,0,1,1,3
2546,786276,3,0,1,0,0,0,1,0,0,0,0,0,0,0,1,0,0
2546,791298,10,0,3,0,2,0,1,0,0,0,0,0,1,2,2,0,0
2546,781390,15,1,2,0,0,1,2,0,0,0,2,1,2,1,1,0,3
2547,780824,26,4,7,4,7,0,0,1,2,4,6,1,2,2,2,0,9
2547,791117,33,4,5,2,3,2,2,0,0,0,3,1,2,1,1,0,10
2547,791118,38,7,20,5,13,2,7,5,5,2,2,2,1,2,4,0,21
2547,785676,31,3,7,2,4,1,3,0,0,1,4,2,3,3,4,1,7
2547,774974,37,6,10,5,9,1,1,3,5,1,4,3,0,1,0,1,16
2547,796771,2,0,1,0,1,0,0,0,0,0,0,0,0,0,0,0,0
2547,791115,12,1,1,1,1,0,0,1,5,2,0,0,2,0,2,1,3
2547,796769,16,0,0,0,0,0,0,0,0,0,0,0,0,0,1,0,0
2547,791116,5,0,1,0,1,0,0,0,0,0,0,0,0,0,0,0,0
2548,790935,25,2,3,2,3,0,0,0,0,0,5,1,2,0,2,0,4
2548,792442,22,1,1,1,1,0,0,0,0,1,7,0,3,0,4,3,2
2548,775340,34,7,16,2,6,5,10,2,2,0,1,8,1,0,3,0,21
2548,774826,34,6,8,3,4,3,4,1,2,0,4,1,0,0,0,0,16
2548,796190,7,3,5,3,3,0,2,2,3,1,2,0,0,1,0,0,8
2548,790937,18,5,5,5,5,0,0,0,0,2,6,3,2,0,1,0,10
2548,785497,1,0,0,0,0,0,0,0,0,0,0,0,0,0,0,0,0
2548,785445,13,1,3,1,1,0,2,0,0,2,1,1,2,0,1,0,2
2548,780933,26,8,10,2,4,6,6,0,0,0,2,2,3,1,2,0,22
2548,790938,15,2,3,2,3,0,0,0,0,0,0,2,5,0,1,0,4
2548,796492,4,0,1,0,0,0,1,1,2,0,0,0,1,0,0,0,1
2548,786778,1,0,0,0,0,0,0,0,0,0,0,0,0,0,0,0,0
2549,781132,35,4,13,1,4,3,9,0,0,0,4,2,0,1,1,0,11
2549,797517,27,4,8,4,8,0,0,1,3,1,3,1,4,0,1,0,9
2549,791940,27,4,9,3,6,1,3,2,3,1,1,1,2,1,0,0,11
2549,786534,35,6,12,5,8,1,4,3,6,4,3,5,0,1,2,1,16
2549,797521,2,0,1,0,1,0,0,0,0,0,0,0,0,0,1,0,0
2549,797519,2,1,1,0,0,1,1,0,0,0,0,0,0,0,0,0,3
2549,792197,23,4,10,2,3,2,7,0,0,1,0,0,3,0,0,0,10
2549,797522,2,0,0,0,0,0,0,2,2,0,0,0,1,0,0,0,2
2549,786539,6,0,1,0,1,0,0,0,0,1,1,0,0,1,0,0,0
2549,797520,2,1,1,1,1,0,0,0,0,1,0,0,0,0,0,0,2
2549,797518,10,1,3,1,2,0,1,2,2,0,0,2,2,1,0,0,4
2549,791938,29,1,3,1,1,0,2,0,0,1,0,3,1,1,0,1,2
2550,775455,23,1,4,1,4,0,0,1,1,2,0,3,2,0,4,0,3
2550,792124,18,2,3,2,3,0,0,0,0,2,0,0,5,1,1,0,4
2550,792123,36,6,12,4,6,2,6,6,9,0,3,2,1,1,3,0,20
2550,786002,13,1,2,0,0,1,2,0,0,0,4,0,1,0,1,0,3
2550,781397,27,3,6,3,5,0,1,4,4,0,4,0,0,2,3,1,10
2550,797754,15,0,1,0,1,0,0,0,0,1,1,1,1,0,0,0,0
2550,786003,21,0,2,0,0,0,2,0,0,1,2,0,1,0,0,1,0
2550,797749,16,3,6,1,2,2,4,0,0,0,1,0,2,1,1,0,8
2550,792120,24,6,14,5,10,1,4,5,6,2,5,2,1,1,3,0,18
2550,786005,7,1,2,1,2,0,0,0,1,0,1,1,0,0,0,0,2
2551,780406,28,1,3,0,0,1,3,0,0,0,4,2,3,1,1,2,3
2551,775087,27,6,11,4,7,2,4,1,2,2,3,0,3,1,1,0,15
2551,790984,28,6,7,2,2,4,5,1,2,0,2,4,2,1,2,0,17
2551,780212,32,2,8,2,5,0,3,3,4,1,5,7,3,2,4,0,7
2551,767245,33,10,15,10,15,0,0,0,0,0,3,0,1,3,0,0,20
2551,780214,10,2,3,0,0,2,3,0,0,1,3,0,2,1,2,0,6
2551,780215,11,1,1,1,1,0,0,0,0,2,1,0,4,0,0,1,2
2551,796596,8,1,1,1,1,0,0,0,0,0,0,0,0,0,1,0,2
2551,791168,13,0,2,0,1,0,1,2,2,0,1,1,1,0,2,1,2
2551,785297,10,0,5,0,4,0,1,2,2,0,1,0,0,0,0,0,2
2552,780085,8,1,2,1,2,0,0,0,0,0,1,0,1,1,2,0,2
2552,774874,38,6,8,6,8,0,0,0,2,0,11,3,4,1,2,0,12
2552,786475,31,6,10,3,5,3,5,2,3,0,2,2,2,2,1,0,17
2552,785270,27,2,4,0,0,2,4,0,0,0,0,1,3,0,1,0,6
2552,776038,23,3,7,0,3,3,4,0,0,0,1,3,0,0,0,0,9
2552,781134,6,0,0,0,0,0,0,0,0,0,0,0,3,0,1,0,0
2552,780083,3,0,0,0,0,0,0,0,0,0,0,0,0,0,0,0,0
2552,796531,26,2,6,1,3,1,3,5,7,0,1,4,2,1,0,0,10
2552,790946,24,2,8,2,6,0,2,1,2,4,3,1,0,0,4,0,5
2552,786037,10,2,4,2,3,0,1,0,0,0,0,2,0,0,0,0,4
2552,775468,4,0,1,0,0,0,1,0,0,0,0,0,0,0,0,0,0
2553,790232,38,7,15,7,13,0,2,2,2,1,4,4,2,1,1,0,16
2553,780614,29,3,8,3,6,0,2,1,1,1,2,1,2,0,2,2,7
2553,780093,18,3,3,3,3,0,0,0,0,0,3,2,1,0,1,2,6
2553,789066,38,3,11,2,5,1,6,7,7,1,6,2,2,1,3,0,14
2553,776278,33,4,5,2,2,2,3,2,2,0,1,1,1,0,1,0,12
2553,797593,3,0,1,0,1,0,0,0,0,0,0,0,0,0,0,0,0
2553,780255,15,1,2,1,2,0,0,2,2,0,0,0,3,1,0,0,4
2553,792411,4,1,2,0,0,1,2,0,0,0,1,0,2,0,0,0,3
2553,786463,13,3,3,1,1,2,2,0,0,1,1,2,0,0,0,0,8
2553,785806,9,0,0,0,0,0,0,0,0,0,2,0,2,1,2,0,0
2554,791606,34,2,5,1,3,1,2,0,0,1,10,1,1,1,1,2,5
2554,786410,34,3,12,3,10,0,2,0,0,0,1,1,2,0,1,0,6
2554,775095,8,0,1,0,1,0,0,0,0,1,1,0,3,0,2,0,0
2554,786406,21,2,3,2,2,0,1,0,0,0,1,3,4,0,2,0,4
2554,780414,33,7,10,5,7,2,3,2,2,0,2,2,4,0,6,0,18
2554,797020,8,0,0,0,0,0,0,0,0,0,2,1,5,0,2,0,0
2554,792392,9,0,0,0,0,0,0,1,2,0,2,0,3,0,2,1,1
2554,791605,5,0,2,0,0,0,2,0,0,0,1,0,1,0,1,0,0
2554,791603,35,5,11,1,3,4,8,1,4,0,5,0,1,0,3,0,15
2554,791843,13,0,2,0,2,0,0,4,4,2,1,0,5,0,1,0,4
2555,792329,26,2,7,2,3,0,4,3,3,2,1,0,2,0,2,0,7
2555,786749,27,2,8,2,8,0,0,1,2,1,3,0,2,0,0,0,5
2555,781384,37,3,9,3,8,0,1,2,3,0,5,1,1,1,2,0,8
2555,781616,19,3,7,3,4,0,3,4,4,0,3,0,4,1,3,0,10
2555,776350,36,2,5,2,3,0,2,8,8,1,5,1,1,1,2,0,12
2555,792330,11,3,5,2,2,1,3,0,0,0,0,0,3,0,2,0,7
2555,785435,5,0,2,0,2,0,0,0,0,1,0,1,1,0,0,0,0
2555,781615,25,3,8,3,7,0,1,3,4,2,3,1,0,1,0,0,9
2555,792331,9,1,2,0,0,1,2,0,0,0,0,0,1,0,0,0,3
2555,792601,5,0,1,0,0,0,1,1,2,0,0,1,2,0,0,0,1
2556,797482,33,5,12,4,10,1,2,8,8,1,9,2,2,0,2,0,19
2556,797485,16,1,4,1,2,0,2,0,1,2,1,1,3,0,1,0,2
2556,797481,34,3,7,3,5,0,2,4,4,3,6,1,3,0,3,0,10
2556,797480,25,2,6,2,4,0,2,2,2,0,3,1,4,3,3,1,6
2556,785944,34,5,12,3,5,2,7,5,5,1,2,2,3,1,5,0,17
2556,797483,24,0,3,0,3,0,0,0,0,0,6,0,2,1,1,6,0
2556,797479,2,0,0,0,0,0,0,0,0,0,0,0,0,0,0,0,0
2556,797478,18,1,6,1,5,0,1,4,4,2,2,0,1,0,2,0,6
2556,791873,9,0,1,0,0,0,1,2,2,0,0,0,1,0,1,0,2
2556,781217,5,0,1,0,0,0,1,0,0,0,0,0,0,0,1,0,0
2557,791653,23,0,5,0,3,0,2,0,0,1,5,1,3,0,3,1,0
2557,791652,25,3,11,3,11,0,0,3,4,2,3,1,4,3,5,0,9
2557,797285,23,1,5,0,0,1,5,0,0,0,0,2,2,0,1,0,3
2557,791650,32,4,7,3,6,1,1,4,5,0,3,1,1,0,2,0,13
2557,776384,34,7,15,5,11,2,4,1,3,1,4,2,4,1,1,0,17
2557,791654,2,0,0,0,0,0,0,0,0,0,0,0,1,0,0,0,0
2557,786495,30,5,9,5,7,0,2,1,1,2,8,1,3,2,2,0,11
2557,797289,6,0,1,0,0,0,1,0,0,0,0,1,1,0,2,0,0
2557,797286,2,0,1,0,1,0,0,0,0,0,0,0,1,0,0,0,0
2557,797283,23,2,6,0,1,2,5,0,0,1,0,1,3,0,1,0,6
2558,796699,23,2,4,1,2,1,2,1,2,0,2,1,0,0,2,1,6
2558,790983,24,6,12,3,4,3,8,0,1,1,3,1,2,0,0,1,15
2558,790978,15,0,4,0,0,0,4,0,0,2,2,0,1,0,1,0,0
2558,790979,30,5,8,2,2,3,6,0,0,1,5,6,2,0,1,0,13
2558,796700,32,2,5,1,3,1,2,4,5,1,7,5,0,1,3,0,9
2558,790976,17,0,3,0,3,0,0,0,1,1,2,2,2,1,0,0,0
2558,788820,25,5,9,2,3,3,6,1,1,0,2,1,4,0,2,0,14
2558,796698,15,1,2,1,2,0,0,0,0,1,0,0,2,0,1,0,2
2558,796701,15,3,4,3,4,0,0,0,0,3,2,1,4,1,1,2,6
2558,789458,1,1,1,1,1,0,0,0,0,0,0,0,0,0,0,0,2
2558,789457,1,0,0,0,0,0,0,0,0,0,1,0,0,0,0,0,0
2558,790977,1,0,0,0,0,0,0,0,0,0,0,0,0,0,0,0,0
2558,792693,1,0,0,0,0,0,0,0,0,0,0,0,0,0,0,0,0
2559,796554,28,1,4,0,0,1,4,2,4,1,2,1,1,0,0,0,5
2559,790962,12,2,7,2,5,0,2,0,0,0,1,0,1,2,0,0,4
2559,790961,36,2,6,2,5,0,1,3,4,2,2,2,2,1,2,0,7
2559,786240,30,0,2,0,1,0,1,2,2,0,4,2,2,1,1,0,2
2559,785278,31,3,11,2,5,1,6,2,2,0,0,1,1,1,0,0,9
2559,780146,15,2,4,1,3,1,1,0,0,0,2,0,3,0,2,0,5
2559,775860,28,5,10,2,3,3,7,2,3,1,1,0,2,0,1,0,15
2559,780832,15,0,1,0,1,0,0,4,4,0,0,0,2,0,1,0,4
2559,796556,3,0,1,0,0,0,1,2,2,1,1,0,1,0,0,0,2
2559,796555,1,0,0,0,0,0,0,0,0,0,0,0,0,0,0,0,0
2559,796557,1,0,0,0,0,0,0,0,0,0,0,0,0,0,0,0,0
2560,785589,38,7,12,7,12,0,0,7,10,2,8,1,1,0,4,0,21
2560,791216,37,5,9,3,5,2,4,2,3,1,3,1,3,0,3,0,14
2560,791209,9,1,2,1,2,0,0,1,2,0,2,0,1,0,1,1,3
2560,791215,18,1,2,1,1,0,1,0,0,1,1,4,2,1,1,0,2
2560,791213,27,4,9,2,4,2,5,3,3,0,3,4,4,0,2,0,13
2560,791214,24,0,4,0,2,0,2,0,0,0,3,2,1,2,3,0,0
2560,776364,24,3,6,1,1,2,5,1,2,1,2,2,3,0,0,0,9
2560,776313,23,2,6,2,4,0,2,2,3,2,6,3,0,0,0,1,6
2561,792269,21,0,0,0,0,0,0,0,1,0,2,0,1,0,0,1,0
2561,792270,20,0,3,0,1,0,2,0,0,1,6,0,2,0,2,0,0
2561,790940,35,4,11,2,3,2,8,6,11,0,3,0,2,1,1,0,16
2561,786060,36,6,12,4,7,2,5,0,0,1,1,4,0,3,1,0,14
2561,780770,31,2,10,0,6,2,4,2,2,0,4,2,2,2,2,0,8
2561,791686,17,4,12,3,7,1,5,0,0,1,4,1,1,0,1,0,9
2561,792271,16,1,1,1,1,0,0,3,6,3,2,2,3,2,2,0,5
2561,798028,18,1,1,1,1,0,0,1,1,0,0,0,4,0,2,0,3
2561,798022,4,1,4,0,1,1,3,0,0,0,0,1,0,0,1,1,3
2561,792305,2,0,0,0,0,0,0,0,0,0,0,0,1,0,0,0,0
2562,796754,25,6,8,5,6,1,2,2,6,0,4,0,4,2,1,0,15
2562,780315,22,1,3,1,2,0,1,0,1,1,1,3,4,1,1,0,2
2562,791099,33,5,9,3,5,2,4,0,0,0,1,0,2,0,1,0,12
2562,785470,38,8,13,3,6,5,7,4,5,4,6,1,1,0,1,0,25
2562,785586,34,3,7,3,6,0,1,3,4,0,2,3,4,3,4,0,9
2562,780298,25,1,11,0,5,1,6,2,2,0,2,0,2,0,0,0,5
2562,790846,21,2,6,2,6,0,0,3,6,0,2,1,3,0,0,4,7
2562,780795,2,0,0,0,0,0,0,0,0,1,0,0,2,0,0,0,0
2563,796778,10,1,1,1,1,0,0,3,4,1,3,1,5,0,3,0,5
2563,781107,19,0,1,0,1,0,0,0,0,0,2,2,3,0,1,1,0
2563,791974,29,3,6,2,2,1,4,2,2,3,0,1,3,0,3,0,9
2563,785366,27,4,8,4,5,0,3,1,1,1,2,5,2,0,4,0,9
2563,780863,29,6,17,4,14,2,3,5,5,2,8,1,3,1,3,0,19
2563,791972,24,2,5,2,4,0,1,3,5,1,5,2,1,0,2,0,7
2563,796777,20,0,3,0,2,0,1,2,2,1,3,3,2,1,3,0,2
2563,776069,18,2,5,2,3,0,2,0,1,0,3,0,4,1,0,0,4
2563,791971,24,5,6,3,3,2,3,3,4,1,2,0,1,0,0,0,15
2564,786509,31,4,10,4,10,0,0,2,5,2,9,0,4,0,2,0,10
2564,786508,35,8,11,5,6,3,5,8,16,0,7,1,1,2,0,0,27
2564,797576,33,3,7,2,3,1,4,2,3,0,2,3,4,1,3,0,9
2564,785796,24,4,7,4,6,0,1,2,2,0,0,1,2,1,1,0,10
2564,786507,21,0,5,0,2,0,3,0,0,0,1,0,0,1,1,0,0
2564,786505,19,2,3,0,0,2,3,0,1,0,0,4,2,0,2,0,6
2564,791897,15,1,1,1,1,0,0,0,0,0,1,1,0,0,2,0,2
2564,797580,13,1,1,0,0,1,1,0,0,0,0,1,1,0,0,1,3
2564,797577,9,1,2,1,2,0,0,0,0,1,0,0,2,0,0,0,2
2565,785509,25,1,5,0,3,1,2,3,4,1,1,2,3,0,1,0,6
2565,791424,28,8,11,7,10,1,1,4,6,3,7,1,5,0,2,0,21
2565,797085,37,5,14,4,9,1,5,3,5,1,10,5,3,2,3,0,14
2565,785899,35,0,1,0,0,0,1,0,0,0,3,1,4,0,1,0,0
2565,791421,32,3,10,2,7,1,3,1,1,0,1,1,3,1,2,0,8
2565,797088,16,2,2,0,0,2,2,0,0,0,1,0,0,0,2,0,6
2565,791425,15,2,5,2,5,0,0,1,2,0,0,0,2,0,2,0,5
2565,797079,12,2,3,2,3,0,0,0,0,1,1,0,3,0,0,0,4
2566,785536,26,2,5,2,3,0,2,3,3,1,3,2,2,0,1,0,7
2566,780119,25,1,6,1,6,0,0,2,2,3,7,0,3,1,1,0,4
2566,776097,26,3,8,3,6,0,2,2,4,5,2,5,2,1,4,0,8
2566,796559,37,6,10,3,5,3,5,6,8,3,1,2,1,0,0,2,21
2566,785280,27,5,11,3,5,2,6,6,7,0,3,2,4,2,2,0,18
2566,780149,21,6,12,3,6,3,6,4,4,0,2,1,3,1,3,0,19
2566,775679,22,2,5,1,1,1,4,0,0,0,3,2,1,0,0,2,5
2566,796558,5,0,1,0,1,0,0,0,0,0,1,0,2,1,1,0,0
2566,796560,4,0,0,0,0,0,0,0,0,0,1,0,0,0,0,1,0
2566,796561,7,1,1,1,1,0,0,1,2,0,1,1,0,0,1,0,3
2567,786805,20,4,8,4,6,0,2,2,4,0,3,0,1,1,0,1,10
2567,774936,15,5,9,5,8,0,1,1,3,4,0,0,0,0,1,0,11
2567,790932,33,5,12,5,9,0,3,2,4,0,2,4,2,1,0,0,12
2567,781345,21,2,5,2,3,0,2,0,0,2,4,3,4,0,2,0,4
2567,786803,22,0,2,0,1,0,1,0,0,0,2,1,4,0,0,0,0
2567,790934,18,4,9,3,6,1,3,0,0,1,4,0,1,0,2,0,9
2567,790933,13,2,4,2,3,0,1,2,2,1,0,1,4,0,2,0,6
2567,786804,23,6,9,2,2,4,7,2,2,0,0,1,1,1,1,1,18
2567,796487,6,0,1,0,0,0,1,0,0,0,1,0,0,0,1,0,0
2567,790931,24,1,2,1,1,0,1,0,0,0,1,2,2,0,3,2,2
2567,780033,5,0,0,0,0,0,0,0,0,0,0,1,0,0,0,0,0
2567,796488,0,0,0,0,0,0,0,0,0,0,0,0,0,0,0,0,0
2568,791058,21,2,2,2,2,0,0,2,4,1,2,0,1,0,3,0,6
2568,785532,34,3,11,3,9,0,2,2,3,4,7,1,3,0,0,1,8
2568,791055,36,5,9,3,4,2,5,0,1,1,3,1,3,1,3,0,12
2568,775573,31,2,8,2,6,0,2,4,4,0,1,4,1,0,1,0,8
2568,775926,37,5,10,2,5,3,5,4,7,0,3,3,0,1,0,0,17
2568,791057,17,5,7,4,5,1,2,0,0,3,1,1,2,1,1,1,11
2568,796733,4,1,2,1,1,0,1,1,1,0,0,0,0,0,2,0,3
2568,791280,17,2,4,2,2,0,2,1,1,0,3,3,1,0,0,0,5
2568,791059,3,0,0,0,0,0,0,0,0,0,0,0,0,0,0,0,0
2569,797325,37,7,10,7,10,0,0,0,0,6,4,3,3,1,0,0,14
2569,797329,38,3,6,2,2,1,4,0,0,1,6,1,2,0,1,1,7
2569,797323,37,7,15,6,11,1,4,0,0,1,4,8,3,3,4,0,15
2569,797322,26,2,8,1,3,1,5,2,2,0,1,0,4,0,0,0,7
2569,786236,40,7,15,5,8,2,7,4,4,1,7,1,1,0,2,0,20
2569,786246,3,0,1,0,0,0,1,0,0,0,0,0,1,0,0,0,0
2569,786233,10,0,3,0,1,0,2,0,0,0,0,0,3,0,0,0,0
2569,797324,3,0,1,0,1,0,0,0,0,0,0,1,0,0,0,0,0
2569,781002,6,1,1,1,1,0,0,0,0,0,0,0,1,0,0,0,2
2569,776478,0,0,0,0,0,0,0,0,0,0,0,0,0,0,0,0,0
2570,780809,27,1,8,1,7,0,1,2,2,0,0,0,2,2,2,0,4
2570,780812,33,8,17,6,10,2,7,1,2,2,8,3,3,1,1,1,19
2570,780813,33,7,10,7,10,0,0,2,4,3,6,4,3,0,1,0,16
2570,796767,32,1,10,1,6,0,4,1,2,1,3,1,0,0,0,0,3
2570,785618,24,1,5,1,1,0,4,2,3,1,2,1,1,1,1,1,4
2570,796766,28,8,10,4,4,4,6,1,1,2,6,0,2,0,2,0,21
2570,785614,9,0,0,0,0,0,0,1,4,3,0,0,1,1,2,1,1
2570,796765,9,0,1,0,0,0,1,0,0,0,0,2,0,0,3,0,0
2570,791111,5,0,1,0,1,0,0,0,0,0,0,0,2,0,1,0,0
2571,792495,37,7,12,3,5,4,7,11,12,2,6,1,1,1,5,1,29
2571,792491,39,9,20,9,18,0,2,1,3,1,8,5,2,2,2,0,19
2571,792493,37,3,6,0,0,3,6,0,0,0,1,1,3,0,1,1,9
2571,780023,22,2,5,2,5,0,0,4,4,4,4,2,4,0,0,2,8
2571,792492,4,0,2,0,1,0,1,0,0,0,2,0,0,0,0,0,0
2571,792490,28,0,4,0,1,0,3,0,0,0,2,0,3,2,2,1,0
2571,786832,13,0,4,0,2,0,2,0,2,1,1,0,1,1,0,0,0
2571,798960,11,1,1,1,1,0,0,0,0,1,0,0,5,0,1,2,2
2571,788128,7,1,3,0,0,1,3,0,0,0,1,0,0,0,0,0,3
2571,798959,2,0,1,0,1,0,0,0,0,0,1,0,0,1,0,0,0
2572,776100,20,2,5,2,4,0,1,3,4,0,5,0,2,1,1,0,7
2572,781406,27,3,9,2,5,1,4,3,4,1,6,3,1,1,0,0,10
2572,781401,26,5,6,5,6,0,0,4,4,2,4,4,1,1,4,0,14
2572,781029,23,6,9,0,0,6,9,4,4,1,4,2,2,0,0,0,22
2572,775317,16,1,2,0,1,1,1,0,0,1,0,4,2,1,0,0,3
2572,797763,2,0,0,0,0,0,0,0,0,0,0,0,0,0,0,0,0
2572,797760,13,2,6,1,4,1,2,3,4,2,4,0,1,1,0,0,8
2572,792129,11,2,5,2,5,0,0,0,0,1,3,0,4,1,1,1,4
2572,797758,9,2,5,2,3,0,2,0,0,0,1,0,1,0,0,0,4
2572,792130,3,0,1,0,1,0,0,0,0,0,0,0,0,0,0,0,0
2572,792133,26,6,14,6,9,0,5,0,0,0,0,1,0,0,1,0,12
2572,797762,24,1,3,1,3,0,0,2,2,1,2,4,2,0,2,0,4
2573,797824,20,2,4,1,1,1,3,0,0,0,2,0,4,0,1,0,5
2573,775116,15,5,7,5,5,0,2,1,2,1,2,0,3,0,1,1,11
2573,797822,27,5,13,4,10,1,3,3,4,0,4,3,2,1,2,0,14
2573,792190,26,1,3,0,1,1,2,2,2,0,3,5,4,0,1,0,5
2573,786664,35,5,11,2,5,3,6,2,2,0,1,3,3,2,3,0,15
2573,797830,19,3,8,3,6,0,2,0,2,1,1,0,0,1,3,0,6
2573,792192,23,2,7,2,7,0,0,0,0,3,6,0,2,0,0,0,4
2573,792193,9,2,3,2,3,0,0,0,0,0,1,0,1,0,0,0,4
2573,792191,14,0,0,0,0,0,0,2,2,0,2,1,1,0,0,1,2
2573,791928,8,1,2,1,2,0,0,0,0,0,2,1,0,0,3,0,2
2573,781266,4,0,0,0,0,0,0,0,0,0,0,0,0,0,0,0,0
2574,785294,29,3,7,3,6,0,1,4,4,2,4,1,1,1,2,2,10
2574,796514,30,2,7,2,5,0,2,0,0,1,1,5,1,3,1,0,4
2574,791085,24,3,6,2,5,1,1,3,4,2,2,0,4,1,3,0,10
2574,791080,31,7,12,6,9,1,3,1,2,3,5,2,3,1,4,0,16
2574,785675,34,7,13,2,3,5,10,0,0,0,5,2,2,0,0,0,19
2574,796511,14,0,1,0,0,0,1,0,0,0,2,0,0,0,0,1,0
2574,791083,12,1,5,0,2,1,3,0,0,1,3,1,4,2,1,1,3
2574,791081,3,0,0,0,0,0,0,0,0,0,0,0,0,0,0,0,0
2574,796512,8,2,6,2,2,0,4,4,4,2,0,0,0,1,0,0,8
2574,786446,15,1,3,1,2,0,1,1,1,0,4,0,4,1,3,0,3
2575,785841,32,4,11,4,6,0,5,8,10,4,4,3,2,0,2,0,16
2575,785664,13,1,6,1,6,0,0,2,2,5,3,0,0,1,2,0,4
2575,796609,36,7,16,3,4,4,12,5,6,0,5,2,3,1,5,0,23
2575,796613,8,0,1,0,0,0,1,2,4,1,0,0,2,0,2,0,2
2575,766623,25,0,3,0,2,0,1,1,2,2,3,0,2,3,1,0,1
2575,781504,31,4,13,2,5,2,8,2,2,2,2,3,4,2,3,2,12
2575,792232,17,0,2,0,0,0,2,2,2,2,0,2,2,0,0,0,2
2575,785840,8,0,1,0,0,0,1,0,0,0,0,0,1,0,0,0,0
2575,796611,17,0,4,0,1,0,3,0,0,0,5,0,1,0,0,1,0
2575,791312,13,0,0,0,0,0,0,0,0,0,0,0,1,0,1,1,0
2576,785409,36,7,11,7,11,0,0,0,0,3,4,0,3,0,0,5,14
2576,785408,34,0,8,0,5,0,3,1,2,1,4,1,4,0,2,0,1
2576,780539,29,2,5,0,0,2,5,2,6,0,3,3,2,4,3,0,8
2576,780560,25,2,5,2,4,0,1,2,2,1,3,1,3,0,2,0,6
2576,776484,28,8,13,6,10,2,3,3,5,2,3,3,2,1,3,0,21
2576,796416,11,3,3,2,2,1,1,0,0,0,1,1,0,0,2,0,7
2576,796415,15,6,11,3,7,3,4,2,3,0,1,0,2,2,0,0,17
2576,790861,12,2,7,2,7,0,0,1,2,4,3,1,2,1,2,1,5
2576,796417,10,0,1,0,1,0,0,0,0,0,0,0,1,0,0,0,0
2577,790856,24,7,9,7,9,0,0,2,4,3,3,0,1,0,3,1,16
2577,780452,29,5,14,5,14,0,0,0,1,2,5,1,4,0,3,2,10
2577,796409,36,5,14,4,10,1,4,0,0,0,3,3,2,0,3,0,11
2577,796408,28,3,14,3,10,0,4,5,5,1,3,4,1,1,2,0,11
2577,796407,29,2,5,2,5,0,0,2,2,0,3,4,4,3,2,0,6
2577,796410,14,3,6,3,5,0,1,0,0,4,3,1,3,1,3,1,6
2577,780450,11,3,4,2,2,1,2,1,1,2,1,1,3,0,1,0,8
2577,796411,12,1,1,1,1,0,0,1,2,3,3,0,0,3,1,3,3
2577,796413,12,1,1,1,1,0,0,1,2,1,0,1,1,0,0,0,3
2577,796412,5,1,2,1,1,0,1,0,0,0,1,0,0,0,0,0,2
2578,791877,15,1,1,1,1,0,0,0,0,0,0,1,5,0,1,0,2
2578,797487,27,1,2,1,2,0,0,2,2,0,2,0,1,1,0,0,4
2578,785667,35,3,9,3,6,0,3,0,1,0,4,1,0,1,1,1,6
2578,786570,22,3,9,2,5,1,4,3,4,1,1,0,5,1,3,0,10
2578,780436,26,3,7,2,4,1,3,1,3,0,3,2,3,1,2,0,8
2578,797490,24,3,8,3,8,0,0,1,3,4,3,1,3,1,0,0,7
2578,797486,30,7,15,5,11,2,4,0,4,1,2,1,2,3,3,0,16
2578,781205,4,0,0,0,0,0,0,1,2,0,0,0,0,0,0,0,1
2578,797491,12,0,1,0,1,0,0,0,0,1,1,0,0,0,0,1,0
2578,791878,5,0,0,0,0,0,0,0,0,0,1,0,1,0,2,0,0
2579,791534,23,3,7,3,7,0,0,0,1,5,2,1,2,1,1,1,6
2579,797127,34,3,6,3,3,0,3,1,2,1,1,1,3,0,3,0,7
2579,791533,35,4,9,3,7,1,2,5,7,2,10,1,2,2,4,1,14
2579,791528,38,8,12,7,7,1,5,0,1,2,9,1,3,1,6,0,17
2579,775045,37,3,12,2,8,1,4,4,6,1,3,7,1,0,2,0,11
2579,797124,14,2,2,2,2,0,0,2,4,2,3,0,3,0,0,3,6
2579,791529,9,1,2,0,0,1,2,0,0,0,0,0,2,0,0,0,3
2579,797129,3,0,0,0,0,0,0,0,0,0,0,0,1,0,1,0,0
2579,791531,7,0,1,0,0,0,1,0,0,0,1,0,1,0,0,0,0
2580,781624,18,2,4,2,3,0,1,1,2,1,1,1,3,2,2,1,5
2580,792246,15,4,7,4,7,0,0,2,2,0,3,0,4,0,0,1,10
2580,791701,25,4,9,4,8,0,1,3,4,1,5,5,2,0,2,0,11
2580,781420,30,4,8,2,3,2,5,2,5,0,2,2,1,1,1,0,12
2580,781405,28,3,13,3,9,0,4,3,3,1,5,2,2,1,3,1,9
2580,797924,15,2,2,2,2,0,0,0,2,0,2,2,4,0,0,2,4
2580,792244,20,7,11,4,5,3,6,1,2,5,5,0,2,0,0,0,18
2580,781417,6,2,3,2,3,0,0,0,0,0,0,0,3,0,1,0,4
2580,780615,3,1,1,1,1,0,0,0,0,0,0,1,0,0,0,0,2
2580,797920,2,0,0,0,0,0,0,0,0,0,0,0,0,0,0,0,0
2580,797930,1,0,0,0,0,0,0,0,0,0,0,0,0,0,0,0,0
2580,797925,14,2,3,2,2,0,1,0,3,1,1,2,0,1,0,0,4
2580,797933,1,0,0,0,0,0,0,0,0,0,0,0,1,0,0,0,0
2580,792245,22,1,2,1,1,0,1,7,9,0,2,2,0,1,0,0,9
2581,780201,29,2,5,2,4,0,1,1,2,2,4,0,4,0,3,0,5
2581,797208,25,4,6,4,6,0,0,0,1,1,3,1,3,0,0,0,8
2581,791467,22,2,8,0,2,2,6,4,4,0,2,2,2,0,0,0,10
2581,786311,29,7,16,3,6,4,10,0,0,1,1,0,4,0,1,0,18
2581,775516,23,2,4,2,4,0,0,0,0,0,3,4,5,0,4,0,4
2581,798344,9,0,3,0,2,0,1,1,2,1,1,0,2,0,1,0,1
2581,797209,8,1,3,1,3,0,0,0,0,0,1,0,1,0,0,0,2
2581,791470,12,1,3,1,2,0,1,0,0,2,5,0,1,0,4,2,2
2581,791469,13,1,2,1,2,0,0,1,3,0,3,0,4,0,2,3,3
2581,797210,27,4,6,3,4,1,2,4,5,0,4,2,3,1,4,0,13
2581,791471,3,0,0,0,0,0,0,0,0,0,0,0,0,0,1,0,0
2582,785432,10,1,2,1,2,0,0,0,0,0,0,0,0,0,0,0,2
2582,779985,23,1,7,1,6,0,1,0,0,0,2,1,2,0,3,3,2
2582,790882,11,2,3,2,2,0,1,1,1,1,1,1,2,1,0,0,5
2582,790876,39,5,11,3,9,2,2,5,6,0,2,1,1,2,1,0,17
2582,774987,34,4,14,3,10,1,4,4,6,2,2,3,2,0,4,1,13
2582,781062,21,4,8,1,2,3,6,0,0,0,1,0,0,0,1,0,11
2582,790879,25,2,5,2,5,0,0,4,10,6,4,0,4,2,1,0,8
2582,785699,12,2,2,2,2,0,0,0,0,0,1,1,0,1,1,0,4
2582,790877,21,1,2,1,1,0,1,3,4,1,5,2,2,1,3,0,5
2582,796434,4,0,0,0,0,0,0,0,0,0,1,0,0,0,0,0,0
2583,780323,30,9,13,9,13,0,0,0,0,3,4,1,5,1,3,0,18
2583,792233,33,8,12,6,8,2,4,3,4,0,1,1,5,2,2,0,21
2583,797894,25,0,5,0,4,0,1,0,0,2,2,1,3,0,1,0,0
2583,785811,34,5,14,5,10,0,4,6,6,0,1,4,3,0,2,1,16
2583,786016,31,3,6,3,6,0,0,0,0,1,3,0,2,2,1,0,6
2583,785954,31,1,4,0,1,1,3,0,0,0,9,3,3,1,1,1,3
2583,792234,1,0,0,0,0,0,0,0,0,0,0,0,0,0,1,0,0
2583,797892,15,2,3,1,1,1,2,0,0,0,0,0,1,0,0,0,5
2584,796347,27,2,7,2,4,0,3,0,2,4,4,1,3,0,1,0,4
2584,785243,29,1,6,1,3,0,3,1,2,2,5,3,2,0,1,1,3
2584,790788,28,6,11,3,7,3,4,8,11,4,2,2,2,2,1,2,23
2584,781028,31,6,13,2,5,4,8,3,4,0,5,2,2,1,2,0,19
2584,781026,34,5,9,3,4,2,5,10,12,0,5,3,3,1,2,0,22
2584,796348,8,0,0,0,0,0,0,0,2,1,0,0,1,0,0,0,0
2584,785242,9,0,1,0,1,0,0,0,0,1,5,1,0,0,0,0,0
2584,796349,16,4,5,4,4,0,1,3,5,2,0,1,2,0,0,0,11
2584,781027,11,0,3,0,0,0,3,0,0,1,2,1,0,0,0,0,0
2584,790787,3,1,2,0,1,1,1,0,0,1,0,0,0,0,1,0,3
2584,790786,1,0,0,0,0,0,0,0,0,0,0,1,0,1,0,0,0
2584,797899,1,0,0,0,0,0,0,0,0,0,0,0,0,0,0,0,0
2584,796346,2,0,0,0,0,0,0,0,0,0,0,0,0,0,0,0,0
2585,792306,34,4,12,3,6,1,6,4,4,1,10,1,3,1,0,1,13
2585,786618,12,1,1,1,1,0,0,0,0,0,2,0,2,0,1,0,2
2585,797904,16,2,5,2,2,0,3,0,1,1,1,2,3,1,0,0,4
2585,792303,34,8,17,2,6,6,11,2,4,0,2,3,4,0,3,0,24
2585,780456,28,5,10,3,4,2,6,0,0,0,1,0,4,1,0,0,12
2585,776424,21,2,4,1,2,1,2,0,0,1,3,1,1,0,0,0,5
2585,781603,15,0,4,0,1,0,3,2,2,1,1,2,4,1,1,0,2
2585,796155,11,0,0,0,0,0,0,0,0,0,0,0,1,0,0,0,0
2585,797914,22,1,3,0,1,1,2,0,0,0,0,1,3,0,4,0,3
2585,790813,5,0,2,0,0,0,2,0,0,0,0,0,0,0,0,0,0
2585,781605,2,0,0,0,0,0,0,0,0,0,0,0,1,0,0,0,0
2586,796334,29,3,7,2,5,1,2,1,6,4,5,3,3,3,2,2,8
2586,785827,22,5,5,5,5,0,0,5,9,3,3,1,4,0,2,1,15
2586,796332,10,0,3,0,2,0,1,0,0,0,0,0,2,0,0,1,0
2586,785813,36,5,16,3,8,2,8,6,6,0,0,5,1,1,1,0,18
2586,786289,35,3,8,3,6,0,2,2,2,0,3,3,0,1,0,1,8
2586,790776,9,1,4,1,4,0,0,0,0,0,1,0,1,0,0,0,2
2586,796337,19,3,5,3,5,0,0,3,6,1,1,0,1,1,0,0,9
2586,779975,18,1,2,1,2,0,0,1,2,1,5,1,5,0,2,0,3
2586,796330,22,3,7,3,6,0,1,1,3,2,2,0,1,0,0,0,7
2587,797281,29,2,6,2,3,0,3,2,2,1,8,2,3,1,1,1,6
2587,791648,32,5,8,5,8,0,0,3,4,4,2,0,3,0,1,0,13
2587,786195,23,2,6,2,6,0,0,0,0,0,8,0,5,0,3,0,4
2587,791649,30,3,5,2,3,1,2,3,3,0,4,2,5,0,1,0,10
2587,797280,18,1,3,0,2,1,1,0,0,0,1,0,1,0,6,0,3
2587,791647,24,0,5,0,4,0,1,2,2,0,2,1,2,0,3,3,2
2587,786640,21,2,4,2,4,0,0,5,6,0,0,3,4,0,2,0,9
2587,797279,22,5,9,3,6,2,3,5,5,0,1,1,3,0,1,0,17
2587,785694,1,0,0,0,0,0,0,0,0,0,0,0,0,0,0,0,0
2588,785863,26,8,13,8,12,0,1,3,4,3,4,2,2,4,3,0,19
2588,785631,24,5,12,2,6,3,6,0,0,2,4,1,3,2,1,0,13
2588,786248,17,1,5,1,5,0,0,0,0,3,4,0,2,0,2,1,2
2588,785630,28,3,5,1,3,2,2,0,0,0,1,4,0,2,2,1,8
2588,780777,20,5,7,5,7,0,0,0,0,2,1,2,2,0,3,0,10
2588,791199,5,1,1,1,1,0,0,0,0,0,0,1,1,0,0,0,2
2588,791197,18,3,4,3,4,0,0,1,2,1,0,0,4,2,0,0,7
2588,796898,3,3,3,2,2,1,1,0,0,0,0,0,1,0,0,0,7
2588,791198,13,1,1,0,0,1,1,1,3,0,0,2,0,0,0,0,4
2588,791196,5,0,0,0,0,0,0,0,0,0,0,0,1,1,0,0,0
2588,791195,2,0,0,0,0,0,0,0,0,0,1,0,0,0,0,0,0
2588,791200,18,3,7,3,6,0,1,0,0,0,3,2,3,0,1,0,6
2588,785632,19,4,9,3,8,1,1,1,1,2,2,1,0,4,1,0,10
2588,781129,2,0,0,0,0,0,0,0,0,0,0,0,0,0,0,0,0
2589,797628,26,3,7,3,5,0,2,2,2,2,3,0,2,0,3,0,8
2589,786481,32,5,11,5,9,0,2,1,3,1,5,1,1,0,4,4,11
2589,797626,26,1,3,1,2,0,1,0,0,1,2,3,2,1,4,1,2
2589,797624,23,0,5,0,2,0,3,2,2,1,3,0,2,1,2,1,2
2589,785965,28,2,7,2,5,0,2,4,4,0,1,1,0,2,2,0,8
2589,797625,2,0,0,0,0,0,0,0,0,0,0,0,0,0,1,0,0
2589,791793,20,3,5,2,4,1,1,9,10,2,2,2,1,0,2,0,16
2589,791791,10,1,1,0,0,1,1,0,0,0,1,0,0,1,2,0,3
2589,797627,8,0,3,0,1,0,2,0,0,0,1,0,0,0,0,0,0
2589,786480,3,0,1,0,0,0,1,0,0,0,1,0,1,0,0,0,0
2589,781032,22,1,3,0,0,1,3,2,2,0,0,1,0,1,1,0,5
2590,776110,22,2,4,1,2,1,2,3,4,3,5,4,0,2,0,1,8
2590,780059,24,2,7,2,5,0,2,4,5,3,3,2,4,2,3,2,8
2590,796494,23,1,5,1,1,0,4,1,2,1,2,0,3,2,4,0,3
2590,790944,35,8,15,0,2,8,13,2,5,1,3,2,1,0,1,1,26
2590,786754,35,4,8,3,3,1,5,5,8,1,1,9,5,1,1,0,14
2590,796496,18,3,4,2,2,1,2,0,0,1,2,1,3,1,1,0,7
2590,780058,17,3,8,2,3,1,5,0,0,1,1,2,0,0,0,0,7
2590,790941,15,3,5,3,5,0,0,0,2,1,3,0,2,1,1,1,6
2590,796495,2,0,0,0,0,0,0,0,0,0,1,0,0,0,1,0,0
2590,796499,1,0,0,0,0,0,0,0,0,0,1,0,1,0,0,0,0
2590,796497,4,2,2,2,2,0,0,0,0,0,0,0,0,0,0,0,4
2590,796498,1,1,1,1,1,0,0,0,0,0,0,0,1,0,0,0,2
2590,785097,1,0,0,0,0,0,0,0,0,0,1,0,0,0,0,0,0
2590,788853,1,0,1,0,0,0,1,0,0,0,0,0,0,0,0,0,0
2590,798130,1,0,0,0,0,0,0,0,0,0,0,0,0,0,0,0,0
2591,791220,27,0,3,0,1,0,2,0,0,0,2,0,3,0,1,0,0
2591,791219,34,8,13,2,3,6,10,1,1,0,9,0,1,0,2,0,23
2591,776217,24,1,1,1,1,0,0,0,1,0,4,0,4,0,1,2,2
2591,790818,24,4,8,3,4,1,4,5,6,0,2,5,3,2,8,0,14
2591,780730,32,6,12,4,6,2,6,4,6,0,0,1,4,2,1,0,18
2591,796923,8,0,0,0,0,0,0,0,0,0,0,0,4,0,2,0,0
2591,786396,17,1,5,1,3,0,2,1,2,0,1,1,0,0,0,0,3
2591,786824,16,1,3,1,2,0,1,0,0,1,1,0,4,1,1,0,2
2591,796921,16,2,4,2,4,0,0,0,0,0,2,2,2,0,2,0,4
2591,796920,2,1,1,1,1,0,0,1,3,0,0,0,0,0,0,0,3
2592,780027,31,7,14,3,6,4,8,4,6,2,7,1,3,0,0,2,22
2592,786176,32,6,13,5,10,1,3,4,4,3,6,1,0,2,1,1,17
2592,786173,34,2,6,0,1,2,5,0,2,0,2,5,0,0,0,0,6
2592,780028,24,1,5,1,1,0,4,0,0,1,2,6,3,1,4,0,2
2592,774828,29,3,8,0,0,3,8,0,0,0,2,2,1,1,1,0,9
2592,791379,12,1,1,0,0,1,1,0,0,0,1,0,0,0,2,0,3
2592,780029,15,1,5,1,1,0,4,2,2,3,2,2,1,0,0,1,4
2592,791380,11,0,1,0,1,0,0,0,0,0,0,4,1,1,2,0,0
2592,797175,12,3,3,2,2,1,1,0,0,0,3,0,1,1,1,0,7
2593,790839,29,3,5,2,3,1,2,0,0,1,1,2,3,0,1,0,7
2593,785388,29,7,14,7,13,0,1,0,1,5,4,1,3,0,2,3,14
2593,790840,25,4,11,1,4,3,7,0,0,0,8,2,3,1,1,0,11
2593,785386,31,2,10,2,7,0,3,0,0,1,1,5,1,1,5,0,4
2593,780373,30,3,7,1,1,2,6,0,0,0,4,3,1,1,3,0,8
2593,796393,11,1,2,1,2,0,0,1,2,0,1,1,3,1,1,0,3
2593,796395,12,0,4,0,2,0,2,0,0,0,0,1,1,0,0,0,0
2593,790841,14,1,2,0,0,1,2,0,0,1,3,1,0,1,0,0,3
2593,780370,11,2,3,1,1,1,2,0,0,0,2,1,1,1,1,0,5
2593,796396,8,0,0,0,0,0,0,0,0,0,0,0,0,0,0,0,0
2594,790798,29,10,15,10,15,0,0,5,7,4,5,3,1,0,1,1,25
2594,780140,28,7,12,5,7,2,5,2,2,1,5,3,2,1,0,1,18
2594,796355,30,8,12,7,8,1,4,2,3,0,6,5,0,3,4,1,19
2594,785245,24,2,8,2,6,0,2,0,0,0,5,4,0,1,1,1,4
2594,780137,26,3,5,3,3,0,2,0,0,0,2,5,2,2,2,1,6
2594,790799,21,4,5,4,4,0,1,2,3,0,4,0,1,3,0,1,10
2594,796359,12,2,3,1,2,1,1,0,0,0,0,0,1,0,2,0,5
2594,775553,15,1,3,1,1,0,2,0,0,0,0,0,1,2,0,1,2
2594,796354,9,2,3,2,2,0,1,2,3,1,0,0,1,0,1,0,6
2594,790796,6,0,1,0,1,0,0,0,2,1,0,0,0,1,0,0,0
2595,791922,8,0,3,0,1,0,2,0,0,1,2,0,0,0,1,0,0
2595,781122,9,5,7,5,7,0,0,0,2,0,3,0,1,2,0,0,10
2595,791925,21,5,8,3,5,2,3,2,2,0,2,1,1,0,1,0,14
2595,791926,20,5,9,1,3,4,6,1,1,0,0,3,1,0,0,1,15
2595,781112,12,0,1,0,1,0,0,0,0,0,2,0,2,1,1,0,0
2595,791923,25,5,10,5,8,0,2,1,2,0,9,1,4,1,3,1,11
2595,786527,13,1,3,0,0,1,3,0,0,0,0,0,2,0,1,0,3
2595,797542,14,0,2,0,2,0,0,0,0,1,1,2,2,0,1,0,0
2595,797541,9,1,5,1,4,0,1,0,0,2,2,0,0,0,1,0,2
2595,786858,20,1,4,1,3,0,1,0,0,1,0,4,2,2,1,0,2
2595,791927,22,5,8,1,4,4,4,0,1,0,1,1,0,1,3,0,14
2595,778952,8,1,3,1,2,0,1,0,0,0,1,2,2,0,1,0,2
2595,786529,11,1,1,1,1,0,0,0,0,1,1,0,2,1,0,0,2
2595,797543,8,1,2,0,1,1,1,0,0,0,0,0,0,1,2,0,3
2596,780913,18,1,3,0,1,1,2,0,0,0,4,3,0,1,0,0,3
2596,798119,15,4,8,2,4,2,4,1,1,1,2,1,0,0,0,0,11
2596,798117,20,3,6,2,4,1,2,2,2,1,5,4,2,3,5,0,9
2596,780594,22,5,12,3,7,2,5,2,2,0,4,1,3,0,1,0,14
2596,775664,16,6,8,3,4,3,4,0,0,1,3,0,0,0,0,1,15
2596,798127,7,0,2,0,1,0,1,0,0,1,0,0,1,0,0,0,0
2596,798123,15,4,4,4,4,0,0,2,4,1,1,0,2,4,2,1,10
2596,798118,11,0,3,0,0,0,3,2,2,0,1,0,1,0,0,0,2
2596,769332,10,0,2,0,0,0,2,3,4,1,3,0,1,1,1,4,3
2596,786398,10,1,1,1,1,0,0,0,0,0,1,0,1,0,1,0,2
2596,798126,8,0,2,0,1,0,1,0,0,0,1,1,1,0,1,1,0
2596,798124,20,0,4,0,2,0,2,1,2,0,2,5,0,0,2,0,1
2596,798121,20,0,3,0,1,0,2,2,2,0,1,2,0,1,1,1,2
2596,798120,8,2,5,1,2,1,3,0,0,0,1,0,0,0,0,0,5
2598,790810,32,6,14,2,4,4,10,1,3,4,3,4,1,0,1,0,17
2598,785362,32,4,9,4,9,0,0,2,2,6,5,3,2,1,2,2,10
2598,790808,35,7,14,1,2,6,12,2,3,1,3,7,2,1,2,1,22
2598,785361,36,4,14,1,4,3,10,0,0,6,4,2,4,0,3,0,11
2598,779997,36,6,8,3,5,3,3,0,0,0,3,1,1,2,1,1,15
2598,774854,8,0,0,0,0,0,0,0,0,0,2,0,2,0,0,0,0
2598,796370,10,1,4,1,2,0,2,2,2,0,0,1,1,0,1,0,4
2598,790809,9,0,0,0,0,0,0,0,0,0,0,1,2,0,0,0,0
2598,790811,2,0,0,0,0,0,0,0,0,0,0,0,2,0,1,1,0
2599,791975,18,1,5,1,5,0,0,1,3,4,1,1,3,0,3,0,3
2599,785972,31,3,11,3,7,0,4,0,0,3,3,1,0,1,0,0,6
2599,785967,34,4,9,4,9,0,0,0,2,2,6,1,1,1,2,1,8
2599,791977,35,8,12,2,2,6,10,2,2,0,2,0,0,0,0,0,24
2599,791978,31,8,16,7,12,1,4,2,2,3,2,2,4,1,2,1,19
2599,780160,24,0,3,0,3,0,0,0,1,5,3,5,3,0,1,0,0
2599,791976,14,1,4,1,2,0,2,0,0,1,1,0,0,0,0,0,2
2599,785973,9,1,2,0,0,1,2,0,0,0,0,0,2,1,1,0,3
2599,797799,4,0,1,0,0,0,1,0,0,0,0,0,0,0,2,0,0
2604,790771,27,6,12,5,7,1,5,1,1,0,5,1,1,2,0,3,14
2604,780271,25,2,3,1,2,1,1,1,1,3,1,0,1,1,1,0,6
2604,790772,24,7,15,5,8,2,7,0,0,2,1,3,2,1,0,0,16
2604,785230,21,4,10,2,5,2,5,0,0,0,3,1,2,1,2,1,10
2604,780022,22,4,7,3,4,1,3,0,1,0,3,3,0,4,2,0,9
2604,780375,24,2,9,1,4,1,5,0,0,0,1,6,3,3,1,0,5
2604,780218,20,5,9,5,8,0,1,0,0,4,3,1,1,1,1,1,10
2604,796328,19,2,4,1,1,1,3,3,3,1,5,0,1,2,2,0,8
2604,792438,4,0,2,0,1,0,1,0,0,0,2,0,1,0,0,1,0
2604,790774,3,0,0,0,0,0,0,0,0,0,0,0,0,0,1,0,0
2604,782638,2,0,0,0,0,0,0,0,0,0,0,0,0,0,1,0,0
2604,796329,3,0,1,0,0,0,1,0,0,1,0,0,0,0,0,0,0
2604,794458,2,0,0,0,0,0,0,0,0,0,0,0,1,0,0,0,0
2604,782637,2,0,0,0,0,0,0,0,0,0,0,0,1,0,0,0,0
2604,796327,2,0,0,0,0,0,0,0,0,0,0,0,0,0,0,0,0
2605,786371,22,6,11,6,10,0,1,3,4,4,2,0,2,1,3,1,15
2605,786369,19,3,8,3,7,0,1,2,2,2,2,2,1,0,3,0,8
2605,797074,20,1,3,0,0,1,3,0,0,0,5,3,2,0,2,1,3
2605,797072,38,6,12,1,1,5,11,2,2,0,2,0,3,2,2,0,19
2605,791559,21,1,3,1,2,0,1,0,1,1,4,1,1,0,1,0,2
2605,791555,26,3,7,3,7,0,0,0,0,0,3,3,0,0,1,2,6
2605,786373,16,2,5,1,2,1,3,0,0,0,3,1,0,0,1,0,5
2605,791558,5,0,2,0,2,0,0,0,0,0,1,1,1,0,0,0,0
2605,791556,8,0,2,0,0,0,2,0,0,0,1,0,0,0,1,0,0
2605,797073,3,0,0,0,0,0,0,0,0,0,0,0,0,0,2,0,0
2605,786372,8,0,0,0,0,0,0,0,0,0,1,1,1,0,3,0,0
2605,791554,11,1,2,0,1,1,1,1,2,1,3,2,0,0,3,0,4
2605,797076,3,0,1,0,0,0,1,0,0,3,1,0,1,0,0,0,0
2606,791482,23,5,6,2,2,3,4,1,4,1,1,9,2,2,0,0,14
2606,786319,20,7,7,7,7,0,0,2,4,1,8,0,2,1,1,1,16
2606,786318,25,7,11,1,2,6,9,0,0,0,2,1,1,2,1,1,20
2606,784268,28,4,8,3,4,1,4,2,2,0,0,5,1,2,0,0,11
2606,780223,23,5,6,1,1,4,5,2,2,0,3,2,0,0,0,1,16
2606,797198,11,0,1,0,1,0,0,2,2,0,0,3,1,1,1,0,2
2606,791481,10,1,2,1,2,0,0,5,6,1,2,0,4,0,1,0,7
2606,780225,11,1,2,0,1,1,1,0,0,0,2,1,2,0,2,0,3
2606,797200,12,2,4,0,0,2,4,2,2,0,1,1,0,0,0,0,8
2606,797199,15,1,3,1,2,0,1,2,2,0,2,2,1,0,0,0,4
2606,797201,7,1,1,0,0,1,1,2,2,0,2,1,4,0,0,0,5
2606,796079,3,0,0,0,0,0,0,0,0,0,0,0,1,0,1,0,0
2606,791480,4,0,0,0,0,0,0,0,0,0,0,1,0,0,0,0,0
2606,791479,2,0,0,0,0,0,0,0,0,0,0,0,1,0,1,0,0
2606,786317,3,0,0,0,0,0,0,0,2,1,1,0,0,0,0,0,0
2606,786320,3,1,2,1,1,0,1,0,1,0,0,0,1,0,0,0,2
2607,775037,19,0,1,0,1,0,0,0,0,1,5,1,2,0,0,0,0
2607,796544,15,0,1,0,0,0,1,2,2,0,0,0,1,0,2,0,2
2607,790952,25,0,5,0,2,0,3,0,0,0,0,1,2,0,1,0,0
2607,786089,30,5,12,2,3,3,9,1,2,0,2,0,1,1,3,0,14
2607,780087,25,8,16,6,13,2,3,6,10,1,4,0,3,1,4,0,24
2607,796543,8,0,0,0,0,0,0,0,0,0,0,1,2,0,0,0,0
2607,796540,15,3,5,2,4,1,1,3,4,2,2,0,0,0,0,0,10
2607,790951,22,2,3,2,3,0,0,2,2,3,4,0,3,0,2,0,6
2607,796545,31,3,8,3,8,0,0,3,4,0,0,3,3,2,5,0,9
2607,798697,7,0,1,0,1,0,0,0,0,0,0,0,2,0,0,0,0
2607,796541,3,0,0,0,0,0,0,0,0,0,0,0,0,0,0,0,0
2608,797235,26,2,8,2,8,0,0,0,0,2,0,0,2,0,3,0,4
2608,797232,27,4,7,3,4,1,3,1,2,0,3,1,3,0,0,0,10
2608,791367,32,4,10,3,7,1,3,8,10,1,2,2,2,0,4,0,17
2608,797234,30,2,5,2,4,0,1,2,2,1,7,3,4,2,2,1,6
2608,797239,38,7,13,4,9,3,4,3,4,0,4,2,3,1,1,0,20
2608,797233,14,2,3,2,2,0,1,2,2,2,2,1,1,0,2,2,6
2608,791368,8,0,2,0,2,0,0,1,2,0,1,0,2,0,0,1,1
2608,797238,2,0,1,0,0,0,1,0,0,0,1,0,0,0,0,0,0
2608,797237,8,1,6,1,4,0,2,0,0,2,1,0,0,0,1,0,2
2608,785446,15,2,3,2,2,0,1,1,1,0,2,0,2,0,0,0,5
2609,780797,33,4,7,4,4,0,3,3,6,3,7,5,4,0,2,0,11
2609,776418,21,10,15,10,15,0,0,1,1,2,2,0,2,1,1,2,21
2609,785505,26,3,9,1,5,2,4,2,2,1,1,2,3,2,2,0,10
2609,780555,36,1,4,1,2,0,2,0,0,0,3,6,2,0,2,1,2
2609,775604,36,5,12,4,7,1,5,4,5,0,4,2,3,2,2,0,15
2609,791616,17,2,5,2,4,0,1,1,1,1,0,0,1,0,0,0,5
2609,796984,2,0,1,0,1,0,0,0,0,0,0,0,2,0,0,0,0
2609,796981,25,4,8,2,4,2,4,5,5,0,5,2,2,1,1,1,15
2609,791618,4,1,1,1,1,0,0,0,0,0,1,0,0,0,0,0,2
2610,791837,31,7,12,6,8,1,4,0,2,1,6,0,0,0,1,0,15
2610,780613,17,1,2,1,2,0,0,0,0,1,1,2,4,1,1,0,2
2610,775097,28,7,11,7,10,0,1,1,3,0,2,5,2,1,2,0,15
2610,780609,40,5,11,2,2,3,9,0,0,1,1,6,3,3,1,0,13
2610,776395,36,5,13,3,6,2,7,1,4,0,2,3,3,1,1,0,13
2610,786169,21,2,4,2,2,0,2,4,4,1,4,1,1,0,1,0,8
2610,786622,12,1,1,0,0,1,1,0,0,1,0,1,2,0,0,0,3
2610,786621,12,0,1,0,1,0,0,0,0,2,0,0,2,0,0,0,0
2610,786619,3,1,2,1,2,0,0,0,0,0,0,0,0,0,0,0,2
2611,781425,31,7,8,7,8,0,0,2,6,2,9,2,2,0,3,0,16
2611,797000,19,3,7,1,3,2,4,0,0,0,4,0,1,1,1,0,8
2611,791343,34,1,2,1,1,0,1,0,1,0,2,1,2,0,4,0,2
2611,781602,39,7,14,2,6,5,8,4,5,0,0,5,1,0,3,0,23
2611,775746,36,5,9,2,3,3,6,2,3,0,2,2,2,1,1,0,15
2611,791344,21,6,6,6,6,0,0,0,0,1,4,0,3,1,1,0,12
2611,781601,9,0,1,0,1,0,0,0,0,0,3,0,3,0,0,0,0
2611,797001,11,0,1,0,0,0,1,0,0,0,0,0,0,1,0,0,0
2612,797967,33,2,9,2,6,0,3,5,8,4,4,6,2,2,1,1,9
2612,797962,13,0,0,0,0,0,0,0,0,1,1,0,1,0,1,0,0
2612,797970,30,6,10,4,6,2,4,2,2,0,11,2,4,1,4,1,16
2612,781453,28,4,9,1,2,3,7,0,0,0,4,2,4,1,5,0,11
2612,774869,29,7,12,3,4,4,8,0,0,0,1,1,1,0,0,0,18
2612,797972,18,1,3,1,2,0,1,0,0,3,1,2,4,0,0,1,2
2612,792254,17,5,5,3,3,2,2,3,4,0,6,0,1,1,2,0,15
2612,797961,13,1,5,1,4,0,1,2,2,0,2,2,1,0,2,0,4
2612,786098,18,1,3,0,0,1,3,0,0,0,0,3,1,0,1,0,3
2612,786106,1,0,1,0,0,0,1,0,0,0,1,0,0,0,0,0,0
2613,797574,8,0,0,0,0,0,0,0,0,0,1,0,2,0,0,1,0
2613,797575,18,1,2,1,2,0,0,0,1,1,2,0,1,1,2,1,2
2613,791899,31,5,12,5,12,0,0,5,6,5,4,0,2,2,3,0,15
2613,786512,33,7,20,6,10,1,10,1,2,2,2,0,4,2,2,0,16
2613,786032,29,4,12,4,10,0,2,1,2,2,2,2,2,3,0,0,9
2613,797573,13,0,0,0,0,0,0,2,2,1,1,0,1,0,1,0,2
2613,791903,15,1,3,1,2,0,1,0,0,1,4,1,2,0,2,0,2
2613,786513,10,0,3,0,2,0,1,0,0,0,1,0,0,0,0,0,0
2613,797571,24,4,7,4,6,0,1,0,2,1,2,0,4,2,2,0,8
2613,791901,4,0,1,0,1,0,0,0,0,0,0,0,0,0,0,0,0
2613,786435,15,0,0,0,0,0,0,1,2,0,0,0,1,0,2,0,1
2614,780695,30,3,9,2,3,1,6,3,4,0,1,1,1,1,1,1,10
2614,797594,18,3,6,1,1,2,5,5,6,0,1,1,3,1,0,0,13
2614,791884,39,4,9,3,6,1,3,0,0,0,2,8,1,0,2,0,9
2614,791883,22,8,12,4,6,4,6,1,2,5,2,0,1,0,2,0,21
2614,781066,22,6,9,6,9,0,0,0,1,2,6,2,1,0,1,1,12
2614,786496,8,1,2,0,0,1,2,0,0,0,2,0,1,1,0,0,3
2614,797596,33,3,8,1,3,2,5,2,2,2,2,2,0,1,1,0,10
2614,786497,8,1,1,1,1,0,0,3,4,0,4,0,1,0,1,0,5
2614,797597,1,2,2,1,1,1,1,1,2,0,0,0,0,0,0,0,6
2614,797598,9,4,7,4,7,0,0,0,0,2,1,3,1,1,0,0,8
2614,797600,10,6,8,6,8,0,0,1,1,1,1,4,2,0,2,0,13
2614,791885,0,0,0,0,0,0,0,0,0,0,0,0,1,0,0,0,0
2616,775510,32,3,7,0,0,3,7,0,0,1,2,2,0,0,1,0,9
2616,774976,17,4,7,3,5,1,2,0,0,2,2,1,1,1,1,3,9
2616,792291,16,1,4,0,0,1,4,2,2,0,2,0,2,1,0,0,5
2616,786614,32,6,9,3,3,3,6,0,1,1,3,3,1,0,0,0,15
2616,786759,31,3,6,3,5,0,1,0,0,0,2,4,1,2,1,0,6
2616,792292,16,3,6,3,6,0,0,4,5,5,2,0,1,0,2,1,10
2616,792293,17,3,6,3,4,0,2,0,0,0,2,0,0,1,1,1,6
2616,797865,14,3,6,3,5,0,1,0,0,0,2,4,0,1,0,0,6
2616,786761,4,0,0,0,0,0,0,2,2,1,1,0,1,0,0,0,2
2616,792294,7,1,3,1,1,0,2,1,2,0,1,1,1,0,0,0,3
2616,797864,5,0,0,0,0,0,0,2,2,0,1,0,1,1,0,0,2
2616,780349,2,1,1,0,0,1,1,0,0,0,0,0,0,0,0,0,3
2616,797867,3,0,0,0,0,0,0,0,0,0,0,1,0,1,0,0,0
2616,792296,2,0,0,0,0,0,0,0,0,0,0,0,0,0,0,0,0
2616,786760,2,0,0,0,0,0,0,0,0,0,0,0,0,0,0,0,0
2617,786033,11,2,4,2,4,0,0,0,0,0,0,0,0,0,0,0,4
2617,786031,23,1,5,1,3,0,2,4,4,3,1,0,3,0,1,0,6
2617,797734,24,3,7,1,4,2,3,4,4,1,3,2,4,0,7,0,12
2617,797735,32,4,13,4,8,0,5,0,1,3,3,0,0,1,0,0,8
2617,781386,35,2,10,2,6,0,4,1,1,0,1,4,3,1,3,0,5
2617,792110,26,1,4,1,4,0,0,0,0,4,3,0,5,0,1,0,2
2617,797733,21,1,7,0,4,1,3,0,0,0,1,0,0,0,0,0,3
2617,792105,3,0,0,0,0,0,0,0,0,0,0,0,0,0,0,0,0
2617,792107,9,0,0,0,0,0,0,0,0,0,0,0,0,0,0,0,0
2617,789100,3,0,0,0,0,0,0,0,0,0,0,0,0,0,1,0,0
2617,786036,13,0,0,0,0,0,0,0,0,0,0,0,1,1,1,0,0
2618,776018,31,6,11,6,11,0,0,0,0,2,3,1,4,1,2,3,12
2618,797859,33,6,11,6,9,0,2,5,7,1,5,4,1,1,1,1,17
2618,792208,31,6,8,6,8,0,0,6,10,1,2,0,2,2,2,2,18
2618,786262,33,3,8,0,0,3,8,0,0,0,7,2,0,1,1,2,9
2618,781314,28,1,7,0,5,1,2,0,0,0,8,2,3,5,2,0,3
2618,797863,2,0,1,0,0,0,1,0,0,0,0,0,2,0,0,0,0
2618,797858,2,0,1,0,1,0,0,0,0,0,0,0,0,0,0,0,0
2618,797856,16,0,2,0,0,0,2,0,0,1,2,1,0,2,3,1,0
2618,786682,6,0,1,0,0,0,1,0,0,1,1,0,0,1,2,0,0
2618,781317,16,0,3,0,2,0,1,0,0,0,2,2,0,0,1,0,0
2618,792206,2,0,0,0,0,0,0,0,0,0,0,0,0,0,0,0,0
2620,796955,20,2,2,2,2,0,0,4,8,3,4,0,2,1,4,1,8
2620,791838,15,1,3,0,1,1,2,0,0,1,5,0,2,0,0,1,3
2620,786620,33,3,6,2,3,1,3,5,5,0,0,2,1,0,3,0,12
2620,781606,34,4,10,4,6,0,4,0,0,0,1,4,2,0,1,0,8
2620,781257,28,4,13,2,8,2,5,1,1,0,1,2,1,1,2,0,11
2620,791255,2,0,1,0,1,0,0,0,0,0,0,0,0,0,0,0,0
2620,791257,13,2,5,2,5,0,0,0,0,5,4,1,2,0,0,0,4
2620,780900,9,0,2,0,1,0,1,0,0,2,4,2,1,0,1,0,0
2620,796954,29,4,11,2,4,2,7,1,2,0,4,1,3,0,1,1,11
2620,781263,17,4,7,4,6,0,1,0,0,0,1,0,3,1,1,1,8
2621,796960,32,4,4,4,4,0,0,1,2,1,5,1,3,0,1,1,9
2621,781272,32,3,6,2,5,1,1,0,0,0,7,5,4,3,7,0,7
2621,791261,35,10,17,3,7,7,10,1,2,2,5,3,3,2,3,1,28
2621,785501,26,1,4,1,2,0,2,2,2,0,2,0,5,2,1,0,4
2621,781270,38,4,12,2,9,2,3,3,3,1,2,3,0,0,0,0,13
2621,791260,23,2,7,2,6,0,1,0,3,2,3,0,1,0,3,2,4
2621,785503,7,2,4,2,4,0,0,0,0,1,0,0,0,0,0,0,4
2621,785502,7,0,0,0,0,0,0,0,4,1,1,0,2,0,0,2,0
2622,792253,13,4,7,4,7,0,0,0,0,3,1,0,2,0,0,1,8
2622,781430,38,9,15,8,11,1,4,6,8,1,3,2,4,1,3,1,25
2622,792248,38,5,9,2,3,3,6,1,3,0,5,4,1,1,1,0,14
2622,781445,38,8,13,4,5,4,8,4,4,0,5,0,3,1,1,1,24
2622,768845,30,3,6,2,4,1,2,3,3,0,3,11,3,3,4,0,10
2622,797957,2,0,0,0,0,0,0,0,0,0,0,0,0,0,0,1,0
2622,792249,21,1,2,1,2,0,0,0,2,1,1,0,2,0,1,3,2
2622,797941,8,2,3,1,2,1,1,1,2,2,0,0,1,0,0,0,6
2622,792250,5,1,3,0,2,1,1,0,0,1,0,1,0,0,0,0,3
2622,792251,2,1,1,1,1,0,0,0,0,0,0,0,0,0,0,0,2
2622,786076,5,0,1,0,1,0,0,0,0,0,0,0,1,0,1,0,0
2623,791858,34,7,15,5,10,2,5,3,3,8,4,2,3,0,1,1,19
2623,797463,36,7,17,4,11,3,6,3,4,1,7,1,0,1,2,1,20
2623,791109,38,4,6,4,6,0,0,1,3,1,2,4,3,0,6,0,9
2623,791854,29,2,5,2,4,0,1,0,0,0,2,1,3,0,3,0,4
2623,785625,19,3,6,3,6,0,0,1,2,3,3,1,4,3,4,0,7
2623,797468,4,0,1,0,1,0,0,3,4,1,0,0,0,0,0,0,3
2623,797464,7,3,5,2,4,1,1,0,0,1,1,0,4,1,0,0,7
2623,797469,29,5,12,3,5,2,7,1,2,1,2,1,4,0,2,0,13
2623,797465,4,0,0,0,0,0,0,0,0,0,0,0,0,0,0,0,0
2624,792186,25,5,10,5,10,0,0,1,3,3,3,3,2,0,0,1,11
2624,781447,25,6,8,6,8,0,0,1,3,2,2,0,5,0,2,1,13
2624,781490,29,1,2,1,1,0,1,0,0,0,3,2,3,1,1,1,2
2624,792183,39,9,23,8,16,1,7,1,3,0,5,6,2,0,2,0,20
2624,786675,20,2,8,1,3,1,5,0,0,1,3,1,2,0,0,0,5
2624,797821,17,1,4,0,0,1,4,0,0,0,3,0,3,0,3,0,3
2624,797820,2,0,0,0,0,0,0,0,0,0,1,0,0,0,0,0,0
2624,780433,8,2,3,2,3,0,0,0,0,0,1,0,4,0,2,0,4
2624,792188,10,0,0,0,0,0,0,0,0,0,1,0,1,1,2,0,0
2624,792185,25,1,2,0,0,1,2,2,2,1,1,1,1,0,0,0,5
2625,780890,35,2,6,1,3,1,3,11,13,1,5,1,2,1,1,0,16
2625,775757,14,1,3,1,3,0,0,1,2,0,3,0,3,1,2,0,3
2625,791123,35,3,7,0,3,3,4,0,0,1,0,0,1,0,1,0,9
2625,786066,36,9,20,8,16,1,4,10,11,3,10,1,4,1,5,0,29
2625,785636,39,0,2,0,0,0,2,0,0,0,4,3,0,1,2,2,0
2625,791119,1,0,0,0,0,0,0,0,0,0,0,0,0,0,0,0,0
2625,786646,22,0,3,0,1,0,2,3,4,2,3,1,4,0,0,0,3
2625,785969,18,2,6,1,3,1,3,1,3,1,5,2,2,0,3,2,6
2626,786203,27,1,7,1,1,0,6,0,0,0,2,3,0,0,1,0,2
2626,780717,30,2,10,1,7,1,3,2,3,1,7,0,2,1,3,0,7
2626,791738,23,3,8,3,8,0,0,1,2,2,5,4,1,0,0,1,7
2626,791742,21,1,5,0,1,1,4,0,0,1,3,1,2,0,2,0,3
2626,776266,26,8,14,8,11,0,3,1,3,1,4,1,4,0,5,1,17
2626,786197,14,3,6,3,5,0,1,0,1,0,3,0,1,1,1,1,6
2626,774859,1,0,0,0,0,0,0,0,0,0,0,0,0,0,0,0,0
2626,776328,20,2,4,1,1,1,3,0,0,1,4,1,3,0,2,0,5
2626,797334,1,0,0,0,0,0,0,0,0,0,0,0,0,0,0,0,0
2626,791740,15,3,7,2,3,1,4,0,0,1,2,3,3,0,2,0,7
2626,791741,22,1,5,0,1,1,4,0,0,1,3,1,3,0,0,0,3
2627,791147,11,1,4,0,2,1,2,0,0,0,5,0,4,1,1,0,3
2627,785782,31,4,9,2,3,2,6,0,0,0,8,1,3,1,1,0,10
2627,791145,30,6,13,4,7,2,6,2,3,1,7,4,3,2,3,1,16
2627,791146,32,5,9,5,8,0,1,4,4,1,3,4,4,0,1,0,14
2627,785777,29,5,10,3,3,2,7,0,0,0,4,1,1,1,4,0,12
2627,791144,14,0,3,0,1,0,2,0,0,0,2,0,0,0,2,0,0
2627,796804,14,1,2,1,2,0,0,1,2,0,1,0,0,0,1,0,3
2627,791148,25,3,9,0,2,3,7,3,4,1,4,1,1,2,1,1,12
2627,786748,14,0,1,0,0,0,1,0,0,0,1,2,1,0,0,0,0
2628,786746,33,5,10,3,6,2,4,3,4,2,6,3,2,3,1,0,15
2628,780178,19,3,6,3,6,0,0,0,0,1,2,1,2,0,0,0,6
2628,775075,22,1,4,1,4,0,0,1,2,4,3,0,3,1,2,5,3
2628,792376,27,6,13,5,7,1,6,2,2,0,2,1,4,0,4,0,15
2628,797883,27,3,7,3,6,0,1,2,2,0,2,10,1,2,2,0,8
2628,797890,18,2,4,0,0,2,4,3,4,1,4,0,2,2,4,0,9
2628,792378,18,1,2,1,1,0,1,0,0,1,3,1,3,1,2,1,2
2628,797888,7,1,4,1,1,0,3,0,1,1,2,0,0,0,0,0,2
2628,792374,13,3,8,3,6,0,2,3,3,0,1,2,1,2,1,0,9
2628,797885,2,0,1,0,1,0,0,0,0,0,0,0,0,0,0,0,0
2628,786747,14,5,7,4,6,1,1,2,3,1,1,1,2,0,1,1,13
2629,797241,21,2,2,2,2,0,0,3,6,1,1,0,2,0,1,1,7
2629,791366,22,3,7,2,5,1,2,0,2,0,1,3,4,0,2,0,7
2629,797244,20,2,3,2,2,0,1,0,0,0,3,1,4,1,5,0,4
2629,786340,28,4,10,2,3,2,7,5,6,0,2,2,2,2,3,0,15
2629,780163,38,7,16,6,10,1,6,6,7,3,9,7,3,0,2,0,21
2629,791361,19,6,8,3,3,3,5,0,0,2,3,2,2,0,2,0,15
2629,786155,1,0,0,0,0,0,0,0,0,0,0,0,1,0,0,0,0
2629,780170,18,1,3,1,2,0,1,0,0,0,5,0,1,2,1,1,2
2629,797243,33,4,14,3,10,1,4,1,6,1,2,3,4,2,2,1,10
2630,792388,2,0,0,0,0,0,0,0,0,0,0,0,2,0,1,0,0
2630,781533,35,3,7,1,1,2,6,0,0,0,4,0,5,0,1,0,8
2630,797845,22,1,5,0,2,1,3,0,0,1,1,0,0,0,0,0,3
2630,797851,47,4,12,3,7,1,5,3,6,1,6,2,4,0,0,2,12
2630,792395,41,8,17,8,14,0,3,4,7,3,6,5,5,1,2,0,20
2630,780840,25,2,3,2,3,0,0,1,2,0,5,1,1,0,0,1,5
2630,792393,19,1,3,1,3,0,0,1,2,1,3,4,5,2,3,2,3
2630,792391,40,10,15,10,14,0,1,9,12,0,5,0,4,2,4,1,29
2630,786115,19,1,2,0,0,1,2,2,2,1,1,1,1,0,1,0,5
2631,797382,5,0,1,0,1,0,0,0,0,1,0,0,0,0,2,0,0
2631,797379,27,2,5,1,4,1,1,2,2,3,5,0,5,0,1,0,7
2631,791818,48,11,23,9,14,2,9,3,8,0,5,3,3,1,6,0,27
2631,786636,44,3,12,3,8,0,4,4,7,0,1,4,4,2,2,0,10
2631,780646,32,3,7,1,3,2,4,1,2,0,1,3,5,0,0,0,9
2631,797380,43,6,9,3,3,3,6,3,4,0,7,3,2,0,0,0,18
2631,789043,16,0,2,0,2,0,0,2,2,3,3,0,5,0,0,0,2
2631,797377,32,3,4,0,0,3,4,4,4,0,3,1,2,3,0,0,13
2631,775168,3,0,0,0,0,0,0,0,0,0,1,0,1,0,0,0,0
2632,786132,12,0,0,0,0,0,0,0,0,0,3,0,1,1,1,0,0
2632,786447,23,7,8,6,7,1,1,1,4,2,4,2,1,1,2,2,16
2632,786448,13,2,3,1,2,1,1,0,0,1,8,4,2,1,1,0,5
2632,780731,23,7,10,6,7,1,3,1,2,1,2,2,1,1,1,0,16
2632,780462,22,2,5,2,5,0,0,2,2,1,3,8,2,1,1,0,6
2632,791631,25,4,7,1,2,3,5,0,0,0,2,3,0,1,4,1,11
2632,775074,19,3,5,3,4,0,1,2,2,2,3,3,1,0,1,2,8
2632,775121,14,1,6,1,2,0,4,0,0,1,4,1,2,0,1,0,2
2632,791632,11,1,1,1,1,0,0,3,4,1,0,1,3,0,0,0,5
2632,796971,24,5,7,2,2,3,5,0,0,0,1,0,0,0,3,0,13
2632,791634,7,2,5,2,3,0,2,2,2,2,0,0,0,0,0,0,6
2632,791630,5,1,1,1,1,0,0,0,0,0,0,1,0,1,1,0,2
2632,786449,2,0,1,0,1,0,0,0,0,0,0,0,0,0,0,0,0
2633,797842,25,2,11,1,6,1,5,1,2,0,4,1,2,1,0,0,6
2633,797849,19,2,7,1,6,1,1,0,0,0,2,0,5,0,6,0,5
2633,781537,24,3,9,2,5,1,4,0,2,0,1,1,2,1,2,0,7
2633,786079,19,0,4,0,3,0,1,2,2,0,0,3,1,3,1,0,2
2633,797843,34,2,6,1,4,1,2,0,0,1,1,3,2,1,4,0,5
2633,779986,10,2,2,2,2,0,0,0,0,1,0,0,0,1,0,0,4
2633,797835,13,0,1,0,0,0,1,0,0,1,0,1,0,0,1,0,0
2633,797846,25,3,8,2,4,1,4,0,0,1,1,0,0,0,1,0,7
2633,797836,14,1,5,0,3,1,2,0,0,0,1,1,0,0,3,0,3
2633,797848,13,2,3,2,3,0,0,0,0,0,1,0,1,0,0,2,4
2633,792201,4,0,0,0,0,0,0,0,0,0,0,0,1,0,0,1,0
2634,787524,31,4,6,4,5,0,1,3,9,2,6,0,2,0,1,1,11
2634,787522,14,1,1,1,1,0,0,6,6,0,1,0,2,0,0,1,8
2634,797611,10,0,7,0,4,0,3,1,2,0,1,1,0,1,0,0,1
2634,781019,36,2,9,2,9,0,0,8,12,2,6,9,2,4,4,0,12
2634,775961,31,4,9,4,7,0,2,2,3,0,1,1,2,0,1,1,10
2634,791722,28,2,9,2,6,0,3,0,1,3,3,3,1,0,1,0,4
2634,783269,20,3,7,1,2,2,5,1,3,0,1,1,2,0,2,0,9
2634,791774,12,1,4,0,3,1,1,0,0,1,1,0,2,0,1,1,3
2634,775541,8,2,6,2,6,0,0,0,0,2,0,0,2,0,0,0,4
2634,797608,4,1,2,1,2,0,0,1,2,1,0,0,0,0,0,0,3
2634,797610,4,0,2,0,1,0,1,0,0,0,0,0,0,0,0,1,0
2634,776790,2,0,0,0,0,0,0,0,0,0,0,0,0,0,0,0,0
2635,785800,30,3,11,1,4,2,7,0,0,5,2,3,2,2,1,0,8
2635,785799,17,7,13,7,13,0,0,1,1,3,5,0,5,0,1,0,15
2635,780760,21,4,9,3,5,1,4,2,3,1,5,0,2,0,0,6,11
2635,780553,27,5,12,5,12,0,0,1,2,2,5,3,3,2,2,0,11
2635,791676,23,4,10,1,2,3,8,2,2,1,3,9,3,2,2,0,13
2635,797427,18,4,10,1,2,3,8,0,0,1,4,1,1,0,1,0,11
2635,785807,17,4,7,4,5,0,2,3,3,4,3,1,2,0,1,0,11
2635,791677,16,0,1,0,0,0,1,0,0,0,2,3,1,0,0,0,0
2635,791678,14,0,1,0,0,0,1,0,0,3,2,1,4,0,1,0,0
2635,791679,11,3,7,3,7,0,0,0,0,0,4,0,3,0,0,0,6
2635,797426,6,0,4,0,1,0,3,0,0,0,1,1,0,0,1,0,0
2636,797047,24,2,5,2,3,0,2,6,8,2,5,1,3,3,2,2,10
2636,775515,17,2,6,0,2,2,4,1,2,0,5,0,4,0,1,3,7
2636,791579,30,2,5,2,3,0,2,0,0,1,7,3,4,0,2,0,4
2636,786387,36,11,17,9,14,2,3,2,2,2,3,6,2,0,1,0,26
2636,780399,33,5,8,3,5,2,3,0,0,1,4,9,1,3,2,0,12
2636,786846,28,7,13,3,5,4,8,2,2,0,2,0,2,0,1,3,20
2636,791575,6,0,0,0,0,0,0,0,0,0,1,0,2,0,2,0,0
2636,797046,8,2,2,0,0,2,2,0,0,0,0,0,0,0,0,0,6
2636,791574,4,1,3,1,2,0,1,0,0,1,0,0,0,0,0,0,2
2636,791577,10,0,2,0,0,0,2,1,2,0,0,0,0,0,0,1,1
2636,786390,2,0,1,0,0,0,1,0,0,0,0,0,0,0,1,0,0
2636,786391,2,0,0,0,0,0,0,0,0,0,0,0,0,0,0,0,0
2637,785791,18,4,9,1,1,3,8,0,0,0,1,0,5,0,1,0,11
2637,775606,20,4,5,4,5,0,0,1,5,1,2,0,2,0,4,0,9
2637,791672,18,0,1,0,1,0,0,0,0,3,2,1,4,0,4,1,0
2637,791674,31,5,10,4,8,1,2,1,2,1,4,3,0,0,5,0,12
2637,780552,32,7,17,3,6,4,11,0,0,1,2,2,1,1,1,0,18
2637,797424,10,0,1,0,1,0,0,0,0,0,0,1,0,0,1,0,0
2637,785793,18,3,5,2,2,1,3,2,2,0,0,0,1,0,0,0,9
2637,797423,8,1,1,1,1,0,0,0,2,1,0,0,2,0,1,0,2
2637,791765,2,1,3,1,3,0,0,0,0,2,1,0,0,0,0,0,2
2637,780550,21,0,3,0,3,0,0,0,0,0,6,2,1,2,2,0,0
2637,780538,20,2,6,2,4,0,2,0,1,0,1,3,3,2,1,0,4
2637,785790,2,0,0,0,0,0,0,0,0,0,0,0,0,0,0,0,0
2638,790863,15,2,7,2,5,0,2,0,1,5,1,0,1,0,0,0,4
2638,780021,28,3,8,3,8,0,0,6,9,4,6,0,3,1,1,0,12
2638,785412,25,4,13,1,6,3,7,4,4,0,4,1,4,0,4,0,15
2638,780099,32,1,6,1,3,0,3,7,9,0,0,1,1,2,1,0,9
2638,776214,23,2,9,2,8,0,1,2,2,0,3,0,4,0,0,0,6
2638,775686,25,2,6,2,3,0,3,0,1,1,8,0,2,0,1,3,4
2638,785413,23,0,5,0,4,0,1,0,0,1,0,3,1,0,0,0,0
2638,785417,8,1,4,1,2,0,2,0,0,1,4,0,1,0,1,0,2
2638,776221,19,1,5,1,3,0,2,0,0,1,1,0,0,1,0,0,2
2638,785411,2,0,0,0,0,0,0,0,0,0,0,0,0,0,0,0,0
2639,785335,14,2,2,2,2,0,0,1,3,0,5,0,4,0,2,1,5
2639,785337,32,3,7,3,6,0,1,2,2,1,3,0,2,0,2,0,8
2639,780303,36,6,14,6,12,0,2,1,1,3,7,2,4,0,2,3,13
2639,791594,25,2,7,2,6,0,1,0,0,0,3,2,3,0,1,0,4
2639,791012,30,2,9,1,4,1,5,0,0,1,3,2,3,2,2,1,5
2639,791011,11,0,5,0,3,0,2,0,0,4,1,2,1,1,1,0,0
2639,786349,16,1,6,1,4,0,2,0,0,1,3,0,0,0,1,0,2
2639,796671,6,1,1,1,1,0,0,0,1,1,2,0,1,0,0,1,2
2639,781221,15,1,4,1,2,0,2,1,2,0,2,1,1,0,1,0,3
2639,796668,15,5,8,4,5,1,3,0,1,2,3,1,3,0,1,0,11
2640,791585,31,5,8,4,5,1,3,0,0,2,5,3,1,1,2,0,11
2640,780062,9,2,2,2,2,0,0,0,1,1,1,0,3,0,0,0,4
2640,786395,35,4,11,2,3,2,8,13,15,1,4,3,1,0,0,0,23
2640,786394,35,7,16,6,11,1,5,0,0,3,6,2,2,1,1,0,15
2640,780404,30,3,11,3,9,0,2,2,2,2,3,2,1,2,1,0,8
2640,785228,21,4,6,2,2,2,4,0,3,1,1,0,2,0,0,0,10
2640,791581,27,5,11,4,5,1,6,2,3,2,4,3,0,3,0,0,13
2640,791582,7,0,0,0,0,0,0,0,0,1,1,0,0,0,0,2,0
2640,797037,5,0,0,0,0,0,0,0,0,0,0,1,0,0,0,0,0
2641,780122,20,4,5,1,2,3,3,1,2,1,3,0,3,0,1,0,12
2641,797215,26,2,5,2,3,0,2,0,0,1,0,8,4,2,2,0,4
2641,786295,16,5,9,3,6,2,3,0,0,0,2,0,5,0,2,0,12
2641,780792,30,1,7,0,4,1,3,1,1,0,4,3,1,0,3,0,4
2641,775598,29,3,10,1,2,2,8,0,0,2,4,0,1,1,1,0,8
2641,791461,24,1,4,0,2,1,2,0,2,4,5,1,0,0,0,0,3
2641,797214,24,4,8,3,6,1,2,3,4,0,6,0,5,0,2,0,12
2641,791460,20,5,9,1,3,4,6,2,2,0,1,1,2,0,2,0,16
2641,797216,11,0,1,0,1,0,0,0,0,0,2,0,1,0,0,1,0
2642,791230,13,4,5,2,2,2,3,2,4,1,2,1,2,1,1,0,12
2642,785557,24,2,4,2,4,0,0,5,7,0,2,0,4,1,1,1,9
2642,791228,18,2,2,1,1,1,1,2,2,1,3,2,2,0,2,0,7
2642,796932,30,4,9,3,6,1,3,4,6,0,3,8,4,3,4,0,13
2642,781444,26,5,19,2,6,3,13,8,10,0,1,3,2,1,3,0,21
2642,796933,11,3,5,3,4,0,1,0,0,2,3,1,0,0,1,0,6
2642,791226,16,1,1,1,1,0,0,1,2,0,1,0,0,0,0,2,3
2642,791227,7,0,0,0,0,0,0,0,0,0,0,0,3,1,1,0,0
2642,785624,29,2,5,1,1,1,4,0,0,2,4,0,3,8,1,0,5
2642,781201,8,1,4,0,1,1,3,0,0,0,0,0,1,0,1,0,3
2642,781198,18,2,4,1,1,1,3,2,2,0,5,1,1,0,1,1,7
2643,791337,17,1,3,1,3,0,0,1,2,1,2,0,3,0,0,1,3
2643,797877,20,2,6,1,4,1,2,1,2,2,0,1,2,1,5,0,6
2643,797872,31,4,9,3,7,1,2,0,1,0,3,1,1,1,1,0,9
2643,791338,6,0,0,0,0,0,0,0,0,0,1,0,1,1,3,0,0
2643,791339,28,2,9,2,6,0,3,4,4,2,4,3,5,0,2,0,8
2643,791335,25,3,8,2,3,1,5,3,6,0,10,1,4,0,4,1,10
2643,781599,15,1,3,1,3,0,0,0,1,2,2,1,2,0,1,0,2
2643,797875,21,3,6,2,4,1,2,2,4,0,3,3,2,3,2,0,9
2643,797874,24,3,6,1,1,2,5,0,0,0,0,0,1,1,1,0,8
2643,781595,13,5,7,3,3,2,4,0,0,1,1,2,2,0,1,0,12
2644,797895,13,3,5,3,5,0,0,1,2,5,2,1,2,1,0,0,7
2644,785286,14,4,8,4,6,0,2,2,2,0,1,4,0,1,1,0,10
2644,797898,13,5,10,2,5,3,5,3,3,0,0,1,0,1,0,0,16
2644,792236,16,1,4,1,2,0,2,0,0,3,6,4,1,1,0,0,2
2644,781374,14,5,6,4,5,1,1,1,2,0,3,6,1,2,3,1,12
2644,787239,14,2,3,2,3,0,0,0,0,2,2,0,1,0,0,3,4
2644,789058,12,1,4,1,2,0,2,0,0,0,0,1,0,2,0,0,2
2644,785818,13,5,6,3,4,2,2,1,1,3,1,3,2,0,2,0,13
2644,776337,14,5,5,5,5,0,0,1,2,4,3,1,2,1,1,1,11
2644,797896,8,0,3,0,0,0,3,0,0,0,1,1,0,0,0,0,0
2644,797897,16,4,9,1,2,3,7,0,0,0,8,3,2,0,4,0,11
2644,792240,11,1,2,1,1,0,1,0,0,1,7,2,2,0,0,0,2
2644,792359,12,1,6,0,0,1,6,0,0,0,1,0,1,0,2,0,3
2644,792237,16,5,11,3,5,2,6,0,0,1,1,1,0,0,0,0,12
2644,785986,14,4,5,0,0,4,5,0,0,0,3,3,0,1,0,0,12
2646,786542,32,5,7,5,7,0,0,0,1,1,6,3,0,2,1,2,10
2646,786540,12,7,8,7,8,0,0,1,2,2,3,0,4,0,0,2,15
2646,792019,26,2,6,1,1,1,5,3,3,1,4,1,3,0,0,0,8
2646,792016,30,2,5,2,2,0,3,1,3,0,8,3,2,0,3,0,5
2646,775995,37,3,6,3,4,0,2,1,2,2,4,8,2,1,5,0,7
2646,797514,1,0,0,0,0,0,0,0,0,0,1,0,0,0,0,0,0
2646,785364,27,12,16,12,16,0,0,3,8,4,8,3,2,0,1,0,27
2646,797515,24,2,6,1,2,1,4,0,0,0,3,6,3,0,1,0,5
2646,797513,1,0,0,0,0,0,0,0,0,0,0,0,2,0,1,0,0
2646,791845,9,0,2,0,2,0,0,0,2,0,3,0,1,1,0,0,0
2646,781147,1,0,0,0,0,0,0,0,0,0,0,0,0,0,0,0,0
2648,791302,25,4,8,4,8,0,0,5,7,2,6,3,3,0,3,2,13
2648,781622,26,4,9,2,4,2,5,1,2,5,2,1,1,4,0,1,11
2648,791309,27,4,12,4,10,0,2,2,2,1,2,2,4,0,4,0,10
2648,785835,19,4,8,4,7,0,1,0,0,0,2,1,0,0,1,0,8
2648,776334,35,3,6,2,4,1,2,0,2,0,7,6,1,5,3,0,7
2648,775862,23,6,8,5,7,1,1,2,2,2,3,0,1,0,1,0,15
2648,796603,11,1,2,0,0,1,2,0,0,0,1,1,0,0,0,0,3
2648,796602,10,1,2,1,2,0,0,0,0,0,1,0,0,0,1,1,2
2648,791301,17,3,4,3,4,0,0,1,2,1,1,0,0,2,0,0,7
2648,791304,6,0,0,0,0,0,0,0,0,0,0,0,0,0,1,0,0
2648,796605,1,0,0,0,0,0,0,0,0,0,0,0,1,0,0,0,0
2649,797591,24,1,5,0,0,1,5,0,0,0,1,0,3,0,2,0,3
2649,781071,27,1,6,0,1,1,5,0,0,0,3,2,3,1,1,0,3
2649,780098,18,1,3,1,3,0,0,0,0,3,1,1,2,1,2,0,2
2649,780719,33,3,9,2,8,1,1,0,0,1,6,0,1,1,4,1,7
2649,791890,33,8,18,5,13,3,5,0,1,1,0,6,4,0,2,0,19
2649,785424,21,1,4,1,4,0,0,1,2,4,2,0,3,0,1,1,3
2649,797589,26,5,8,1,2,4,6,1,1,1,2,0,1,0,5,0,15
2649,791888,13,1,4,0,1,1,3,0,0,0,0,0,2,1,1,0,3
2649,797588,2,0,1,0,1,0,0,0,0,0,0,1,0,0,0,0,0
2649,797590,1,0,0,0,0,0,0,0,0,1,0,0,0,0,0,0,0
2649,791889,2,1,1,0,0,1,1,0,0,0,0,0,0,0,0,0,3
2650,780358,21,3,6,3,5,0,1,4,4,1,3,1,2,0,3,0,10
2650,775011,28,4,9,3,3,1,6,4,4,0,8,0,3,0,1,1,13
2650,776004,26,3,7,2,4,1,3,3,3,1,10,2,1,0,1,0,10
2650,780357,33,5,11,2,6,3,5,2,2,0,3,7,2,0,1,0,15
2650,775018,33,3,13,2,6,1,7,0,0,0,4,1,1,0,3,0,7
2650,790930,17,0,1,0,0,0,1,2,2,0,1,2,3,0,1,0,2
2650,796480,24,3,7,2,5,1,2,0,0,3,3,0,0,0,1,0,7
2650,776270,16,1,1,0,0,1,1,0,0,0,1,1,0,0,0,0,3
2650,796485,1,0,0,0,0,0,0,0,0,0,1,0,0,0,0,0,0
2650,796483,1,0,0,0,0,0,0,0,0,0,0,0,0,0,0,0,0
2650,796486,0,0,0,0,0,0,0,0,0,0,0,0,0,0,0,0,0
2651,791690,25,3,4,3,4,0,0,0,0,2,4,1,2,1,0,2,6
2651,781322,29,2,9,2,3,0,6,1,2,1,1,0,1,2,1,3,5
2651,785989,34,5,12,2,7,3,5,2,2,0,8,4,1,0,2,0,15
2651,786571,30,2,7,1,5,1,2,5,9,2,4,2,2,1,0,0,10
2651,781439,25,4,9,1,4,3,5,0,2,0,1,1,5,1,3,0,11
2651,784248,16,0,2,0,1,0,1,0,0,0,3,0,1,0,0,1,0
2651,780563,25,1,6,0,1,1,5,1,2,0,2,2,3,1,2,0,4
2651,781419,14,0,3,0,1,0,2,0,0,0,0,2,0,0,0,0,0
2651,781207,1,0,1,0,0,0,1,0,0,0,0,0,0,0,1,0,0
2651,797299,1,1,1,1,1,0,0,0,0,0,0,0,0,0,0,0,2
2651,797300,0,0,0,0,0,0,0,0,0,0,0,0,0,0,0,0,0
2652,785996,37,1,9,1,7,0,2,6,8,4,10,1,3,1,1,1,8
2652,780858,36,4,9,3,4,1,5,2,4,5,9,0,2,0,3,0,11
2652,797646,28,6,15,6,12,0,3,2,3,1,2,6,4,0,3,0,14
2652,780849,35,3,7,1,4,2,3,4,5,2,6,1,4,0,1,0,12
2652,780853,33,3,8,2,5,1,3,10,14,0,3,5,4,3,5,1,17
2652,792235,3,0,1,0,1,0,0,0,0,1,0,0,0,0,1,1,0
2652,785990,28,2,6,0,3,2,3,2,2,0,0,1,4,1,1,0,8
2652,785998,12,2,5,0,2,2,3,0,0,0,1,0,1,0,0,1,6
2652,792039,11,0,3,0,1,0,2,1,5,1,1,0,3,0,0,0,1
2652,780776,2,0,0,0,0,0,0,0,0,0,0,0,0,0,0,0,0
2653,786029,17,2,6,2,6,0,0,0,0,1,0,0,5,0,0,1,4
2653,781398,27,2,6,1,3,1,3,4,6,2,6,1,1,0,2,0,9
2653,792114,39,6,14,3,5,3,9,10,12,1,5,4,3,0,1,0,25
2653,786018,20,1,6,1,3,0,3,0,1,0,1,1,5,0,1,1,2
2653,775678,37,3,8,2,4,1,4,3,7,0,2,5,3,1,4,0,10
2653,797746,18,4,10,3,8,1,2,1,1,2,5,0,3,2,1,1,10
2653,797737,19,3,6,3,6,0,0,1,1,0,3,2,1,1,1,1,7
2653,786022,12,1,2,1,1,0,1,1,2,2,0,0,3,0,0,0,3
2653,792112,15,2,3,2,3,0,0,0,1,1,0,2,4,0,0,1,4
2653,797740,20,3,5,3,5,0,0,2,2,0,3,0,1,2,1,0,8
2653,797745,1,0,0,0,0,0,0,0,0,0,0,0,0,0,0,0,0
2654,797151,17,1,5,1,4,0,1,1,2,2,3,0,4,1,2,1,3
2654,791511,23,6,7,6,7,0,0,0,0,2,2,1,2,1,0,2,12
2654,778442,35,3,16,2,10,1,6,3,6,1,3,4,4,2,5,0,10
2654,791514,10,1,3,0,2,1,1,0,0,0,2,0,0,1,1,0,3
2654,786637,36,5,12,4,9,1,3,0,0,1,6,2,3,2,3,0,11
2654,791515,13,2,5,1,1,1,4,0,0,1,1,0,0,0,0,0,5
2654,797150,28,3,7,2,4,1,3,0,2,1,5,1,4,1,2,0,7
2654,797149,4,1,1,1,1,0,0,0,0,0,1,0,2,0,0,0,2
2654,780946,25,2,5,2,4,0,1,0,0,1,1,4,3,3,2,0,4
2654,791513,9,0,2,0,2,0,0,0,0,0,1,0,0,0,0,0,0
2655,797139,25,1,4,1,4,0,0,5,7,3,9,2,1,2,3,1,7
2655,775394,33,4,8,3,4,1,4,2,4,1,7,0,3,1,3,0,11
2655,791526,32,5,9,5,6,0,3,3,4,0,4,1,2,1,3,0,13
2655,780272,30,3,6,2,2,1,4,0,0,0,2,2,0,2,2,0,7
2655,775592,33,4,12,2,7,2,5,3,4,1,3,1,2,1,2,0,13
2655,791524,20,3,6,2,2,1,4,1,2,1,4,2,4,0,3,0,8
2655,785970,6,0,0,0,0,0,0,0,0,0,2,0,1,0,0,0,0
2655,797136,1,0,0,0,0,0,0,0,0,0,0,0,0,0,0,0,0
2655,780273,20,3,7,0,1,3,6,0,0,1,1,0,1,0,2,0,9
2656,776286,25,3,5,0,2,3,3,5,6,7,5,0,2,2,2,1,14
2656,775557,10,0,0,0,0,0,0,0,0,0,1,0,5,1,1,2,0
2656,797010,30,4,9,3,5,1,4,3,4,0,2,4,5,3,4,0,12
2656,785357,35,9,18,5,9,4,9,0,0,2,5,2,0,1,3,1,22
2656,775560,24,3,6,2,3,1,3,0,0,0,4,4,3,0,4,1,7
2656,791445,27,2,8,1,1,1,7,0,0,0,2,2,2,1,1,0,5
2656,785287,21,6,8,6,8,0,0,1,3,0,3,0,4,0,1,0,13
2656,797012,12,0,1,0,1,0,0,0,0,0,1,1,1,0,1,0,0
2656,791444,15,1,3,1,3,0,0,1,2,4,3,1,1,1,0,3,3
2656,797009,1,0,0,0,0,0,0,0,0,0,1,0,0,0,0,0,0
2657,785930,15,2,4,2,4,0,0,4,5,1,1,0,4,0,3,0,8
2657,780996,24,0,3,0,2,0,1,2,3,5,3,0,2,0,1,1,2
2657,780995,34,5,10,3,6,2,4,0,0,0,2,2,1,0,1,0,12
2657,796468,35,2,7,2,4,0,3,4,4,0,0,4,3,1,4,0,8
2657,790920,28,0,4,0,3,0,1,7,8,1,4,1,5,1,6,0,7
2657,775709,32,3,6,0,2,3,4,0,0,0,2,3,1,0,2,0,9
2657,785492,17,0,5,0,4,0,1,1,2,0,2,0,1,1,1,0,1
2657,785461,6,1,5,1,5,0,0,0,0,2,1,0,1,0,1,0,2
2657,796466,6,0,1,0,1,0,0,1,3,0,2,0,0,0,0,1,1
2657,796467,3,0,0,0,0,0,0,0,0,0,0,0,0,0,0,0,0
2658,786157,25,8,9,8,9,0,0,2,2,3,10,1,2,0,2,6,18
2658,786150,19,1,5,1,4,0,1,0,0,0,0,1,0,0,0,0,2
2658,780676,26,1,4,0,2,1,2,7,10,0,4,2,3,0,2,1,10
2658,791756,20,3,5,3,4,0,1,1,2,0,2,0,3,0,0,0,7
2658,780677,28,2,6,0,1,2,5,6,6,0,2,0,0,1,1,0,12
2658,797350,1,0,0,0,0,0,0,0,0,0,0,1,0,0,1,0,0
2658,791754,13,0,0,0,0,0,0,1,2,0,4,1,3,1,1,2,1
2658,775533,15,2,3,2,3,0,0,0,0,0,2,1,3,0,1,2,4
2658,797349,2,0,0,0,0,0,0,0,0,0,0,0,0,0,0,0,0
2658,797348,9,1,2,1,1,0,1,0,0,0,0,0,3,1,1,0,2
2658,780992,26,5,6,2,2,3,4,0,0,0,0,4,0,1,2,0,13
2658,780673,16,1,3,0,0,1,3,2,2,1,4,0,2,0,1,0,5
2659,786257,26,2,9,2,9,0,0,0,0,3,4,2,1,0,1,0,4
2659,786263,20,1,3,1,2,0,1,2,2,0,2,1,4,1,1,0,4
2659,797724,28,2,7,1,2,1,5,0,0,2,0,3,2,2,1,0,5
2659,785661,34,4,7,3,5,1,2,6,10,1,1,1,5,1,3,0,15
2659,775825,34,4,11,3,8,1,3,0,1,0,5,0,0,1,2,0,9
2659,797721,7,1,2,1,1,0,1,0,0,0,0,0,3,0,1,0,2
2659,792121,20,1,8,1,4,0,4,0,1,3,3,0,2,0,0,0,2
2659,797725,11,1,3,1,3,0,0,0,1,1,0,0,4,0,0,0,2
2659,792356,3,0,1,0,1,0,0,0,0,0,1,0,0,0,0,0,0
2659,786249,17,2,7,0,1,2,6,0,0,0,1,0,0,1,0,0,6
2660,796404,34,4,5,4,5,0,0,5,7,5,6,4,3,1,2,1,13
2660,785434,12,2,5,0,3,2,2,0,0,0,0,0,3,0,1,0,6
2660,790853,16,3,4,3,4,0,0,0,0,0,2,0,2,0,1,1,6
2660,781164,34,4,9,2,4,2,5,5,8,0,6,4,2,3,1,0,15
2660,781163,26,2,11,1,7,1,4,2,2,1,2,3,3,0,0,0,7
2660,790854,10,0,2,0,2,0,0,1,2,2,0,0,0,0,0,0,1
2660,790850,28,4,11,1,4,3,7,4,4,1,2,0,0,2,1,1,15
2660,790849,16,0,2,0,0,0,2,0,0,0,0,3,1,0,1,0,0
2660,781223,7,0,1,0,0,0,1,0,0,0,1,0,0,0,0,0,0
2660,796406,15,1,3,1,3,0,0,2,6,1,2,1,4,0,1,0,4
2660,790848,2,0,0,0,0,0,0,0,0,0,0,0,0,0,1,0,0
2661,790784,16,3,4,2,2,1,2,4,5,0,5,1,4,1,0,1,11
2661,786548,8,1,1,1,1,0,0,2,2,0,2,0,5,0,2,0,4
2661,786719,19,2,4,2,3,0,1,0,0,0,4,1,0,0,1,0,4
2661,786229,27,1,4,0,0,1,4,0,0,0,3,2,4,1,0,0,3
2661,775229,34,6,13,4,10,2,3,2,2,1,4,1,3,0,5,0,16
2661,786235,27,0,1,0,1,0,0,2,2,1,1,0,4,0,1,1,2
2661,797475,26,5,11,3,6,2,5,1,2,1,1,1,2,1,2,0,13
2661,786581,13,1,2,1,1,0,1,2,2,1,2,0,0,0,1,0,4
2661,776219,23,2,7,1,3,1,4,0,1,2,3,2,2,2,1,1,5
2661,781518,7,0,2,0,1,0,1,0,0,0,0,0,0,0,0,0,0
2662,785638,33,2,6,1,2,1,4,0,1,0,11,4,1,0,1,0,5
2662,781326,27,7,9,7,9,0,0,0,2,3,3,4,2,0,2,1,14
2662,797870,37,11,18,7,11,4,7,0,1,0,2,4,0,0,2,1,26
2662,792210,30,1,3,1,1,0,2,3,5,0,1,3,1,1,3,2,5
2662,781323,35,6,10,3,7,3,3,7,10,1,5,5,3,1,2,0,22
2662,780874,7,2,4,1,1,1,3,0,0,0,1,0,2,1,0,0,5
2662,785430,12,2,2,2,2,0,0,0,0,0,1,0,3,1,0,0,4
2662,792215,13,3,5,1,1,2,4,0,0,0,0,1,3,0,1,0,8
2662,792213,6,0,1,0,0,0,1,0,0,0,0,2,1,0,0,0,0
2663,797620,29,5,7,5,5,0,2,4,5,3,3,2,2,0,2,0,14
2663,781044,24,7,8,3,4,4,4,3,3,0,7,1,3,0,3,0,21
2663,791795,20,3,8,2,5,1,3,0,0,0,2,1,3,1,1,0,7
2663,786489,33,7,15,3,4,4,11,4,4,0,6,0,3,0,4,0,22
2663,786488,35,1,7,1,6,0,1,2,4,0,5,12,3,1,3,0,4
2663,797621,17,1,1,0,0,1,1,0,0,0,1,0,4,0,1,0,3
2663,786487,23,3,8,0,1,3,7,0,0,0,1,1,0,1,1,1,9
2663,797619,15,1,4,1,4,0,0,0,0,0,2,3,2,2,1,1,2
2663,791796,4,0,0,0,0,0,0,0,0,0,0,0,1,0,0,0,0
2664,776279,10,0,3,0,0,0,3,0,0,0,1,1,1,1,0,1,0
2664,781505,28,3,9,2,6,1,3,2,2,0,4,2,2,0,2,0,9
2664,780353,33,8,9,8,9,0,0,0,1,3,6,1,3,0,1,0,16
2664,791317,36,7,9,6,7,1,2,2,2,0,4,3,3,0,7,0,17
2664,777573,13,0,2,0,1,0,1,0,0,0,1,1,1,0,1,0,0
2664,786222,19,1,5,1,2,0,3,0,0,2,2,2,2,0,1,0,2
2664,790851,29,5,6,4,5,1,1,1,3,1,3,5,4,0,3,0,12
2664,796648,25,2,8,1,3,1,5,0,0,0,0,0,0,1,0,0,5
2664,796649,7,1,2,0,0,1,2,0,0,0,0,0,1,0,0,0,3
2665,775640,14,1,3,0,1,1,2,2,2,1,0,0,3,3,1,0,5
2665,780919,26,4,9,3,6,1,3,7,8,0,2,0,3,1,1,0,16
2665,785803,33,0,0,0,0,0,0,4,4,0,3,1,1,1,0,1,4
2665,780920,36,8,14,7,12,1,2,4,5,1,3,7,1,1,2,1,21
2665,780914,27,2,4,1,2,1,2,1,2,1,0,0,2,0,2,0,6
2665,796797,5,2,2,1,1,1,1,0,0,0,1,0,2,0,0,0,5
2665,791142,12,1,3,0,2,1,1,0,0,0,1,0,1,0,0,0,3
2665,791141,12,1,4,1,3,0,1,0,0,0,0,2,1,0,0,0,2
2665,775816,33,5,9,3,4,2,5,0,0,0,5,0,0,1,0,0,12
2665,775639,2,0,0,0,0,0,0,0,0,0,1,0,1,0,0,0,0
2668,797431,28,3,12,3,11,0,1,0,2,0,7,2,4,1,2,0,6
2668,791680,17,3,4,2,3,1,1,4,4,1,3,0,3,0,2,1,11
2668,785815,29,4,10,4,8,0,2,7,9,0,3,2,1,0,2,1,15
2668,785812,27,5,10,2,4,3,6,8,8,1,1,0,1,2,0,1,21
2668,780104,21,1,5,1,1,0,4,0,0,0,5,3,2,2,2,0,2
2668,791681,14,2,2,2,2,0,0,1,2,1,2,0,1,0,1,1,5
2668,791682,16,2,2,2,2,0,0,2,4,1,1,0,1,0,0,4,6
2668,791684,12,0,0,0,0,0,0,2,4,0,1,1,1,0,1,0,2
2668,791356,22,5,8,3,6,2,2,2,2,5,5,0,3,0,3,0,14
2668,790530,14,2,3,2,2,0,1,1,1,1,1,1,2,0,1,0,5
2669,790494,7,1,2,1,2,0,0,0,0,0,0,0,2,0,2,0,2
2669,788866,9,0,1,0,1,0,0,0,0,0,2,0,5,1,3,0,0
2669,781659,13,1,6,1,6,0,0,2,2,1,2,0,2,0,1,0,4
2669,796854,28,3,7,3,6,0,1,0,0,2,2,3,3,1,1,0,6
2669,796851,35,2,11,1,8,1,3,5,5,0,5,4,2,0,3,0,10
2669,796855,5,0,0,0,0,0,0,0,2,0,1,0,0,0,0,0,0
2669,781005,18,7,9,6,7,1,2,0,0,1,3,1,3,0,0,1,15
2669,792683,22,3,11,1,6,2,5,2,3,1,3,0,3,0,1,1,10
2669,782162,28,2,8,2,6,0,2,4,4,3,2,0,2,0,0,0,8
2669,780610,26,3,7,3,4,0,3,0,0,0,2,0,2,3,1,0,6
2669,788865,9,1,1,1,1,0,0,0,0,0,0,1,1,0,2,0,2
2670,797701,30,4,9,4,8,0,1,0,1,4,4,4,2,1,0,2,8
2670,792101,34,5,14,5,11,0,3,5,6,0,0,1,3,1,2,0,15
2670,780923,25,7,13,4,7,3,6,0,0,1,2,2,4,3,2,0,17
2670,775564,33,3,10,2,8,1,2,0,0,3,5,1,1,3,4,1,7
2670,776386,35,6,14,4,9,2,5,2,2,2,10,2,4,2,1,0,16
2670,797700,10,0,6,0,6,0,0,0,0,5,2,0,3,1,1,1,0
2670,780922,3,0,0,0,0,0,0,0,0,0,1,0,0,0,2,0,0
2670,792102,5,0,1,0,0,0,1,0,0,0,0,0,0,0,1,0,0
2670,786165,2,0,0,0,0,0,0,0,0,0,0,0,0,0,0,0,0
2670,786156,3,0,0,0,0,0,0,1,2,0,0,1,1,0,1,0,1
2670,786160,20,0,4,0,2,0,2,0,0,1,1,0,0,0,1,0,0
2671,792128,30,8,10,8,10,0,0,2,2,3,6,0,3,1,1,1,18
2671,786838,29,7,11,7,11,0,0,1,4,1,9,3,1,3,3,5,15
2671,792132,27,1,4,1,2,0,2,1,2,0,4,3,2,0,4,0,3
2671,792127,34,2,9,1,7,1,2,1,1,0,4,4,0,2,2,0,6
2671,792126,28,4,6,3,5,1,1,9,10,0,2,2,2,1,1,1,18
2671,799273,5,1,2,1,2,0,0,0,0,0,0,0,1,0,0,0,2
2671,792131,15,3,6,3,5,0,1,0,0,1,2,1,1,0,3,0,6
2671,797736,12,0,1,0,1,0,0,0,0,0,2,1,3,0,0,0,0
2671,797739,16,1,4,1,3,0,1,0,0,0,0,2,1,1,3,0,2
2671,791668,4,0,0,0,0,0,0,0,0,0,0,0,0,0,2,0,0
2672,785711,30,2,11,1,6,1,5,5,6,0,6,2,0,0,4,0,10
2672,785714,27,4,8,4,7,0,1,2,5,2,5,1,1,0,1,2,10
2672,775894,29,2,6,1,3,1,3,0,1,0,6,1,0,1,2,0,5
2672,780985,34,2,9,0,0,2,9,1,2,1,1,2,2,1,2,1,7
2672,775266,31,4,9,2,5,2,4,3,3,1,4,2,3,1,0,0,13
2672,796829,13,1,3,1,3,0,0,0,0,0,4,0,2,1,0,3,2
2672,779994,10,2,6,2,4,0,2,0,0,2,3,0,1,0,0,0,4
2672,791167,13,1,2,1,2,0,0,0,0,0,2,0,2,0,1,0,2
2672,785378,13,4,8,2,4,2,4,3,3,1,3,2,0,0,2,0,13
2673,780747,32,4,9,1,4,3,5,0,0,0,3,4,0,1,2,1,11
2673,797690,26,1,3,1,2,0,1,1,2,2,4,2,3,0,3,0,3
2673,776363,32,4,13,2,5,2,8,2,2,1,4,1,1,0,0,0,12
2673,776014,32,3,10,3,5,0,5,0,0,0,4,2,3,0,3,1,6
2673,791949,23,3,9,3,8,0,1,1,2,1,4,0,5,1,2,0,7
2673,785304,18,3,9,2,3,1,6,0,0,0,5,0,1,2,0,0,7
2673,784336,10,0,1,0,1,0,0,0,0,0,4,0,2,0,1,1,0
2673,781539,13,4,8,4,6,0,2,1,1,1,0,1,3,0,0,0,9
2673,791946,12,2,6,0,2,2,4,0,0,0,5,0,1,0,0,0,6
2673,797689,2,0,0,0,0,0,0,0,0,0,0,0,1,0,0,0,0
2674,796637,23,4,7,4,7,0,0,6,8,3,3,1,0,0,0,0,14
2674,792632,23,1,4,1,4,0,0,3,4,2,2,0,3,1,2,1,5
2674,792626,35,3,8,2,5,1,3,4,4,2,4,7,4,1,2,1,11
2674,781491,18,1,5,0,2,1,3,0,0,0,2,0,3,0,1,0,3
2674,780250,17,2,3,1,2,1,1,1,2,0,1,2,5,0,3,1,6
2674,796634,3,0,0,0,0,0,0,0,0,0,0,0,0,0,1,0,0
2674,781289,17,1,1,1,1,0,0,0,0,0,1,0,3,0,0,1,2
2674,796638,3,0,1,0,0,0,1,0,0,0,0,0,0,0,0,0,0
2674,796645,14,2,4,2,3,0,1,2,3,0,0,2,1,1,3,2,6
2674,792627,27,7,9,6,8,1,1,2,2,0,2,3,1,1,2,0,17
2674,792629,20,2,4,2,3,0,1,2,2,0,2,2,3,0,1,0,6
2675,786825,16,2,3,2,3,0,0,1,4,2,1,1,4,1,0,1,5
2675,786338,28,5,10,2,3,3,7,3,4,4,6,1,1,0,0,0,16
2675,792050,19,1,4,0,2,1,2,0,0,2,2,3,4,0,0,0,3
2675,785347,27,6,13,6,11,0,2,4,7,0,2,2,4,4,2,0,16
2675,775601,40,6,11,1,4,5,7,8,12,1,3,2,1,0,3,0,25
2675,791512,22,1,5,1,5,0,0,1,2,5,3,0,4,0,4,1,3
2675,797648,4,0,3,0,2,0,1,0,0,0,0,0,0,0,0,0,0
2675,797647,5,0,0,0,0,0,0,1,2,1,0,1,0,1,1,0,1
2675,792052,10,0,2,0,0,0,2,1,3,1,0,3,1,2,1,0,1
2675,792047,12,2,5,2,4,0,1,0,0,2,0,0,1,0,1,0,4
2675,792051,16,1,3,0,2,1,1,0,0,1,0,0,1,0,1,0,3
2675,792045,1,0,0,0,0,0,0,0,0,0,0,0,0,0,0,0,0
2676,790873,31,8,14,8,12,0,2,5,7,1,5,3,4,0,0,2,21
2676,780054,15,0,3,0,1,0,2,2,2,1,1,0,1,0,1,0,2
2676,781140,31,7,9,7,9,0,0,3,4,5,7,0,1,0,0,1,17
2676,786851,34,6,14,2,3,4,11,6,7,0,6,3,4,0,3,0,22
2676,776357,35,0,6,0,5,0,1,2,2,0,3,5,3,1,4,1,2
2676,781139,23,2,4,2,3,0,1,4,5,2,5,0,1,0,0,0,8
2676,796433,8,2,3,2,3,0,0,0,2,0,0,0,1,0,1,1,4
2676,796432,5,0,1,0,0,0,1,0,0,0,1,1,1,0,0,0,0
2676,785429,9,0,1,0,0,0,1,0,0,0,1,1,2,1,2,0,0
2676,776245,6,2,3,2,3,0,0,0,0,2,2,0,1,0,0,0,4
2676,780343,3,0,0,0,0,0,0,0,0,0,0,0,1,0,0,0,0
2677,780634,15,1,2,1,2,0,0,0,0,0,2,1,5,0,3,1,2
2677,791826,33,2,4,1,2,1,2,2,2,1,2,5,3,0,1,1,7
2677,786785,36,8,20,4,10,4,10,0,0,0,6,0,2,0,0,0,20
2677,786784,32,5,10,3,6,2,4,4,8,1,3,0,4,0,0,1,16
2677,776009,29,4,7,3,4,1,3,3,4,0,2,5,2,1,3,0,12
2677,780633,31,3,12,1,6,2,6,0,1,0,3,1,0,1,2,0,8
2677,780635,21,1,3,1,3,0,0,1,2,1,1,0,4,1,0,0,3
2677,797390,3,0,0,0,0,0,0,0,0,0,1,0,1,0,0,0,0
2678,780765,25,1,5,1,4,0,1,0,0,0,3,2,3,0,2,1,2
2678,781301,27,2,2,2,2,0,0,0,0,3,6,0,1,0,3,9,4
2678,786255,37,10,19,7,12,3,7,3,3,2,10,4,0,2,0,0,26
2678,780762,28,10,16,5,7,5,9,5,5,0,3,0,1,1,0,0,30
2678,780768,23,0,1,0,0,0,1,2,2,0,2,5,2,2,1,0,2
2678,776241,22,1,9,1,4,0,5,2,2,0,1,6,2,1,1,0,4
2678,791729,18,3,4,2,3,1,1,0,3,0,3,0,3,0,0,1,7
2678,780755,17,1,6,1,5,0,1,1,3,0,3,1,2,0,2,0,3
2678,797320,1,0,0,0,0,0,0,0,0,0,0,0,1,0,0,0,0
2678,797319,1,0,0,0,0,0,0,0,0,0,0,0,0,0,0,0,0
2678,798260,1,0,0,0,0,0,0,0,0,0,0,0,0,0,0,0,0
2679,781403,40,3,13,3,11,0,2,2,2,2,7,2,3,0,3,0,8
2679,792654,31,6,14,6,14,0,0,4,5,4,9,0,4,1,1,2,16
2679,797301,31,2,10,1,9,1,1,2,2,0,6,3,3,1,4,0,7
2679,780524,28,3,7,1,4,2,3,0,0,1,0,3,1,1,1,0,8
2679,781400,37,4,11,1,4,3,7,3,3,1,2,2,3,1,4,0,14
2679,786857,13,3,8,2,4,1,4,1,1,1,1,0,4,2,0,0,8
2679,792653,9,1,4,1,4,0,0,0,0,1,5,0,0,0,1,1,2
2679,797305,4,0,0,0,0,0,0,0,0,0,0,0,1,0,0,0,0
2679,797302,7,2,3,2,3,0,0,0,0,1,0,0,0,1,0,0,4
2680,791993,30,5,8,5,7,0,1,1,4,3,2,1,0,1,1,1,11
2680,781188,37,2,7,0,3,2,4,4,5,0,3,4,1,2,3,1,10
2680,786566,34,2,5,1,2,1,3,3,4,0,0,2,0,1,0,1,8
2680,781189,19,1,7,1,4,0,3,1,2,0,3,2,4,1,1,0,3
2680,791997,13,0,2,0,0,0,2,0,0,0,1,0,1,0,1,0,0
2680,797493,27,3,4,3,4,0,0,3,7,4,2,0,4,0,4,3,9
2680,797494,17,0,4,0,2,0,2,5,6,0,1,2,0,0,1,0,5
2680,786562,8,1,1,0,0,1,1,0,0,0,0,0,0,1,0,0,3
2680,786563,11,1,5,1,4,0,1,0,0,0,2,0,1,0,1,0,2
2680,791995,3,0,1,0,0,0,1,0,0,0,0,0,0,0,0,0,0
2680,786565,1,0,1,0,1,0,0,0,0,0,0,0,0,0,0,0,0
2681,775094,32,9,15,8,12,1,3,1,2,1,7,1,0,1,2,1,20
2681,791051,31,7,10,7,10,0,0,0,0,8,8,1,2,0,0,0,14
2681,781115,34,5,10,5,10,0,0,0,0,0,1,5,0,1,2,0,10
2681,785524,30,3,10,0,3,3,7,0,0,2,1,1,3,0,0,0,9
2681,775456,7,1,3,1,2,0,1,2,2,1,0,1,4,0,2,0,4
2681,786310,8,3,4,2,2,1,2,0,0,0,0,0,4,0,1,0,7
2681,790819,16,2,4,1,3,1,1,0,0,0,3,6,1,0,1,0,5
2681,796731,11,2,4,2,3,0,1,0,0,0,3,0,3,2,0,0,4
2681,780739,13,1,3,1,3,0,0,1,2,2,1,1,0,0,0,0,3
2681,791053,7,1,2,1,2,0,0,0,0,0,1,0,1,0,0,0,2
2681,785784,1,0,0,0,0,0,0,1,2,1,0,0,1,0,1,0,1
2681,796730,8,0,0,0,0,0,0,0,0,2,0,0,1,2,1,0,0
2681,791052,2,0,1,0,1,0,0,0,0,0,0,0,0,0,0,0,0
2682,786553,31,9,17,8,13,1,4,2,3,3,0,3,2,1,2,0,21
2682,792005,25,3,7,3,4,0,3,0,0,1,3,0,2,0,0,1,6
2682,780895,32,10,15,9,14,1,1,0,0,0,3,2,3,0,2,0,21
2682,781175,9,1,2,1,2,0,0,0,0,1,0,0,4,1,0,0,2
2682,781172,31,1,2,1,1,0,1,1,2,0,4,5,6,0,4,0,3
2682,781177,23,2,5,0,0,2,5,0,0,1,6,2,2,0,0,3,6
2682,786555,24,3,8,0,0,3,8,1,2,1,1,2,2,1,1,0,10
2682,785312,22,6,8,6,8,0,0,0,0,1,0,1,1,3,1,0,12
2682,797503,3,0,0,0,0,0,0,0,0,0,0,0,1,0,2,1,0
2682,797501,0,0,1,0,0,0,1,0,0,0,0,0,0,0,0,0,0
2683,780096,38,2,7,1,2,1,5,2,2,0,4,4,3,1,0,0,7
2683,785906,37,9,18,7,13,2,5,10,11,3,3,5,4,2,4,1,30
2683,780100,25,1,1,1,1,0,0,1,2,0,2,1,1,0,0,0,3
2683,791416,28,11,13,11,13,0,0,1,3,3,3,0,1,0,2,1,23
2683,797096,18,2,6,1,2,1,4,0,1,0,2,1,3,1,0,0,5
2683,785907,12,4,5,4,5,0,0,0,0,2,1,0,1,0,1,0,8
2683,797093,27,3,10,3,9,0,1,9,9,0,3,8,2,1,3,0,15
2683,781614,15,3,3,2,2,1,1,0,0,4,3,1,0,0,0,0,7
2683,797094,0,0,0,0,0,0,0,0,0,0,0,0,0,0,0,0,0
2683,791417,0,0,0,0,0,0,0,0,0,0,0,0,0,0,0,0,0
2684,779857,20,6,9,6,8,0,1,3,3,0,5,2,2,0,1,2,15
2684,774990,34,5,14,4,5,1,9,2,2,2,3,7,1,3,2,0,13
2684,796674,18,5,6,5,6,0,0,1,3,4,4,0,5,0,3,0,11
2684,781586,20,4,7,4,7,0,0,3,6,2,3,1,2,0,0,0,11
2684,785961,23,1,4,1,3,0,1,2,2,0,4,1,1,1,0,0,4
2684,791014,9,2,3,0,0,2,3,0,2,0,0,1,1,0,0,0,6
2684,796673,2,0,1,0,0,0,1,0,0,0,0,0,2,0,0,0,0
2684,785126,20,4,7,4,7,0,0,0,0,0,3,1,1,0,1,0,8
2684,785339,19,2,7,1,3,1,4,2,3,1,3,3,4,0,2,0,7
2684,779976,35,5,8,3,5,2,3,0,0,0,3,5,0,1,0,0,12
2685,797817,10,1,1,1,1,0,0,0,0,0,4,1,2,0,3,0,2
2685,791540,35,5,8,5,6,0,2,6,7,1,3,5,2,2,2,0,16
2685,792153,5,1,2,1,1,0,1,0,0,0,0,0,0,0,0,0,2
2685,787782,33,5,10,1,4,4,6,2,2,0,2,2,2,0,1,0,16
2685,783072,20,4,8,4,6,0,2,1,2,0,3,0,5,0,1,1,9
2685,774879,29,5,9,2,4,3,5,0,0,1,4,0,2,0,3,2,13
2685,776068,38,5,16,3,8,2,8,0,0,1,5,1,3,0,1,0,12
2685,781463,30,3,8,2,3,1,5,2,6,2,3,1,3,0,1,0,9
2686,776396,37,11,24,6,11,5,13,1,1,2,4,4,1,2,2,1,28
2686,776199,35,5,12,2,8,3,4,11,13,0,1,5,2,0,4,0,24
2686,797163,32,6,10,6,10,0,0,4,6,7,5,2,3,0,1,2,16
2686,791385,34,2,7,2,2,0,5,2,2,3,9,3,2,1,2,1,6
2686,786450,19,0,4,0,1,0,3,0,0,1,4,0,5,1,1,0,0
2686,797161,18,2,4,1,1,1,3,0,0,1,6,0,2,2,0,0,5
2686,797165,9,1,3,0,1,1,2,0,0,0,1,1,0,0,2,0,3
2686,797166,2,1,1,0,0,1,1,0,0,0,0,0,0,0,0,0,3
2686,797164,13,0,1,0,1,0,0,0,2,2,2,3,4,1,0,0,0
2686,791386,0,0,0,0,0,0,0,0,0,1,0,0,0,0,0,0,0
2686,793778,1,0,1,0,0,0,1,0,0,0,0,0,0,0,0,0,0
2687,785346,35,6,10,0,1,6,9,0,1,0,1,0,4,0,3,0,18
2687,780629,31,7,16,7,13,0,3,3,5,0,5,1,4,2,3,0,17
2687,775888,30,4,10,3,7,1,3,3,8,1,4,2,5,2,1,0,12
2687,791161,32,2,6,0,0,2,6,0,0,0,1,1,5,0,3,0,6
2687,796815,29,0,1,0,0,0,1,0,0,0,7,2,0,2,2,0,0
2687,796819,22,2,3,2,2,0,1,1,3,0,1,4,1,1,1,0,5
2687,791159,13,0,1,0,0,0,1,5,6,0,2,0,1,0,1,0,5
2687,796817,8,1,1,1,1,0,0,0,0,0,0,0,1,0,0,0,2
2688,780650,35,7,13,7,11,0,2,9,11,4,9,2,1,1,2,0,23
2688,791815,30,5,9,2,4,3,5,1,2,1,0,1,2,1,3,1,14
2688,780651,33,4,6,4,6,0,0,0,3,0,6,5,1,2,0,3,8
2688,791814,16,1,4,0,2,1,2,0,0,0,0,0,0,0,2,0,3
2688,791810,28,0,2,0,2,0,0,0,0,1,3,7,3,1,1,0,0
2688,786644,19,2,3,1,2,1,1,0,0,0,0,0,0,0,0,0,5
2688,791812,11,2,4,2,3,0,1,1,1,0,1,0,0,0,1,0,5
2688,786645,21,1,4,1,3,0,1,0,0,2,3,0,1,1,2,0,2
2688,781596,7,1,2,1,2,0,0,0,0,0,0,1,3,0,0,0,2
2689,781552,39,7,17,5,12,2,5,2,2,3,2,5,3,0,5,0,18
2689,792340,39,6,12,6,10,0,2,1,4,1,8,1,2,1,2,0,13
2689,792341,28,2,4,0,1,2,3,0,0,0,1,2,2,1,2,0,6
2689,792345,20,1,2,1,2,0,0,0,0,0,3,0,4,1,1,0,2
2689,792346,40,0,4,0,2,0,2,0,0,1,3,1,4,1,3,1,0
2689,792342,31,3,8,2,4,1,4,0,0,0,1,0,2,1,0,0,7
2689,798080,3,0,1,0,0,0,1,0,0,0,0,0,1,0,0,0,0
2690,781579,22,2,7,2,6,0,1,2,2,1,11,0,2,0,2,0,6
2690,786731,20,4,9,4,9,0,0,1,3,2,9,4,2,0,0,6,9
2690,798023,23,5,11,3,5,2,6,3,4,0,4,3,3,1,2,0,15
2690,781584,24,5,9,3,4,2,5,0,1,0,0,1,0,0,0,0,12
2690,780347,23,2,5,2,5,0,0,4,6,2,7,4,2,1,0,0,8
2690,776481,13,1,2,1,2,0,0,0,0,1,4,0,3,1,1,2,2
2690,798008,21,1,4,0,2,1,2,5,6,0,1,4,1,2,2,0,8
2690,775696,14,3,6,2,3,1,3,0,0,0,1,1,0,0,0,0,7
2690,798026,7,1,3,1,3,0,0,2,3,4,1,0,3,0,5,1,4
2690,792358,20,5,7,4,5,1,2,0,0,0,0,2,1,0,1,0,11
2690,798021,1,0,0,0,0,0,0,0,0,0,1,0,0,0,0,0,0
2690,792360,1,0,1,0,1,0,0,0,0,1,0,0,1,0,0,1,0
2690,798019,4,1,4,0,0,1,4,0,0,0,0,0,0,0,0,0,3
2690,798018,1,0,0,0,0,0,0,0,0,0,0,0,0,0,0,0,0
2690,798017,6,0,2,0,1,0,1,0,0,0,2,0,0,1,0,0,0
2691,791743,19,0,3,0,3,0,0,4,8,0,1,0,3,0,2,1,4
2691,797342,14,2,2,2,2,0,0,0,0,0,3,0,2,0,0,1,4
2691,797341,20,2,9,1,5,1,4,2,2,0,2,1,3,0,1,1,7
2691,791746,24,1,4,1,2,0,2,4,4,0,5,1,2,3,3,1,6
2691,786188,28,1,12,1,11,0,1,2,2,2,7,2,4,2,5,0,4
2691,797345,11,0,2,0,2,0,0,2,4,0,0,0,3,0,0,0,2
2691,791747,27,4,17,4,13,0,4,3,4,0,4,0,0,0,2,2,11
2691,797343,11,1,3,1,2,0,1,0,0,0,2,0,1,0,0,0,2
2691,786193,18,2,7,1,3,1,4,0,0,1,1,1,0,1,0,0,5
2691,780711,21,2,3,0,0,2,3,1,2,3,6,3,2,1,3,0,7
2691,791744,7,0,2,0,1,0,1,0,0,1,0,0,1,0,0,0,0
2692,781174,24,2,4,2,4,0,0,1,2,2,1,0,2,1,1,0,5
2692,781159,21,2,3,2,3,0,0,2,2,2,3,2,4,2,2,0,6
2692,791001,30,2,7,1,3,1,4,0,0,0,2,6,4,3,2,0,5
2692,779972,25,3,11,3,6,0,5,1,2,0,4,6,2,0,3,1,7
2692,775255,29,9,9,6,6,3,3,1,1,0,4,6,1,2,3,1,22
2692,796644,9,3,3,3,3,0,0,0,0,0,1,0,1,0,0,2,6
2692,785320,24,9,13,5,6,4,7,0,0,1,6,1,2,0,0,0,22
2692,781215,20,5,7,2,4,3,3,0,0,0,5,1,2,0,1,0,13
2692,796643,4,0,0,0,0,0,0,0,0,1,1,1,0,0,0,0,0
2692,796640,4,1,1,1,1,0,0,0,0,0,0,0,1,0,0,0,2
2692,796641,4,0,2,0,2,0,0,0,0,0,0,0,0,0,0,0,0
2692,791601,3,0,0,0,0,0,0,0,0,0,0,0,0,0,0,0,0
2692,796639,3,0,0,0,0,0,0,1,2,0,1,0,1,0,1,0,1
2693,797546,23,2,6,2,6,0,0,1,4,4,0,0,2,0,0,0,5
2693,780351,21,4,7,4,7,0,0,0,0,0,3,1,2,0,3,0,8
2693,797549,21,1,8,1,8,0,0,6,7,0,0,0,1,2,2,0,8
2693,790857,21,3,8,3,7,0,1,0,0,0,1,0,0,0,0,0,6
2693,780586,25,2,10,2,7,0,3,4,4,0,4,0,1,2,6,1,8
2693,797544,10,2,5,2,5,0,0,0,1,0,1,0,0,0,0,0,4
2693,791799,10,0,1,0,0,0,1,0,0,0,2,0,0,0,1,0,0
2693,797539,14,0,0,0,0,0,0,0,0,0,0,0,0,0,3,0,0
2693,797540,14,2,4,2,3,0,1,3,3,0,1,0,0,0,1,0,7
2693,791716,19,1,2,1,2,0,0,1,2,3,2,1,2,0,1,0,3
2693,791715,13,1,1,0,0,1,1,0,0,0,2,0,3,0,1,1,3
2693,785850,2,0,0,0,0,0,0,0,0,0,0,0,0,0,0,0,0
2693,797547,1,0,1,0,0,0,1,0,0,0,0,0,0,0,0,0,0
2693,797545,3,0,0,0,0,0,0,0,0,0,0,1,2,0,0,0,0
2693,791714,1,0,0,0,0,0,0,0,0,0,0,0,0,0,0,0,0
2693,789065,2,0,1,0,0,0,1,0,0,0,0,0,0,0,0,0,0
2696,785423,31,7,7,5,5,2,2,0,1,1,7,0,2,0,1,0,16
2696,786210,29,0,3,0,1,0,2,2,3,0,1,4,2,0,3,0,2
2696,786298,22,2,7,1,3,1,4,2,2,1,4,1,2,0,2,1,7
2696,785425,37,8,10,8,9,0,1,11,11,1,6,0,1,0,3,0,27
2696,785422,38,5,11,1,1,4,10,4,4,1,1,4,1,0,0,0,18
2696,775676,24,2,3,2,3,0,0,2,4,1,5,1,3,1,3,2,6
2696,774957,19,2,2,1,1,1,1,0,0,1,3,2,0,0,1,0,5
2697,796617,10,2,2,2,2,0,0,0,0,0,2,1,3,0,0,0,4
2697,775131,29,3,9,1,3,2,6,2,2,0,1,2,5,1,0,0,10
2697,796616,34,5,9,0,3,5,6,0,0,0,1,4,2,0,0,1,15
2697,796606,32,2,4,2,4,0,0,0,0,0,2,5,3,0,1,0,4
2697,785562,33,4,7,3,6,1,1,2,3,0,6,4,1,1,1,0,11
2697,792429,7,3,3,2,2,1,1,0,0,0,0,1,1,0,1,0,7
2697,796612,31,7,15,5,11,2,4,0,0,0,1,0,2,0,2,0,16
2697,796607,18,1,5,1,3,0,2,1,1,0,2,1,2,1,1,0,3
2697,796610,3,0,0,0,0,0,0,0,0,0,0,0,1,0,0,0,0
2697,796614,3,0,0,0,0,0,0,0,0,0,0,0,0,0,0,0,0
2698,786623,14,4,4,4,4,0,0,0,0,2,1,0,4,1,2,0,8
2698,797405,26,5,13,5,13,0,0,0,1,5,2,0,1,0,1,0,10
2698,791833,26,3,8,2,5,1,3,0,0,2,6,3,2,1,2,0,7
2698,785920,30,2,10,1,8,1,2,0,0,0,3,4,3,0,4,0,5
2698,784077,31,4,12,4,11,0,1,0,0,0,3,0,1,0,1,0,8
2698,797413,6,0,0,0,0,0,0,0,0,0,0,0,3,0,1,0,0
2698,797410,4,0,1,0,1,0,0,0,0,0,1,0,1,0,0,0,0
2698,786624,19,1,6,1,6,0,0,4,4,5,4,1,3,1,1,1,6
2698,797404,9,1,4,1,3,0,1,1,1,1,1,3,2,0,2,0,3
2698,797403,10,2,2,0,0,2,2,3,4,2,0,0,5,0,1,0,9
2698,791834,13,3,7,1,3,2,4,0,0,0,1,1,2,0,0,1,8
2698,785698,12,1,4,1,1,0,3,0,0,2,0,1,1,0,0,0,2
2698,797406,0,0,0,0,0,0,0,0,0,0,0,0,0,0,0,0,0
2699,785845,30,2,4,2,4,0,0,4,5,1,4,2,3,2,0,1,8
2699,780578,23,4,8,4,7,0,1,0,4,2,1,1,3,1,2,0,8
2699,785293,33,3,7,2,3,1,4,2,2,0,4,3,2,2,1,1,9
2699,785847,22,1,5,0,0,1,5,0,0,0,1,2,0,1,0,0,3
2699,780579,35,5,10,3,7,2,3,5,6,0,7,1,1,2,4,0,17
2699,797536,14,2,3,0,1,2,2,3,5,1,1,1,2,0,1,0,9
2699,791712,4,0,3,0,3,0,0,0,0,1,0,0,0,1,0,0,0
2699,791709,0,0,0,0,0,0,0,0,0,0,0,0,1,0,0,0,0
2699,785843,6,1,1,0,0,1,1,0,0,0,0,0,4,0,0,0,3
2699,797537,6,1,1,1,1,0,0,3,4,1,0,0,1,0,0,0,5
2699,797538,27,6,8,3,4,3,4,4,4,0,5,0,1,0,2,0,19
2700,791295,27,8,14,7,13,1,1,2,4,2,6,0,2,0,5,0,19
2700,776345,24,2,14,1,11,1,3,0,0,2,4,2,4,1,1,2,5
2700,791293,30,1,5,0,1,1,4,2,4,1,4,3,1,3,1,0,5
2700,796579,33,2,9,0,0,2,9,2,4,1,3,2,2,1,0,1,8
2700,781373,28,5,9,4,5,1,4,2,4,0,2,2,2,0,2,0,13
2700,781379,20,3,5,3,5,0,0,1,3,3,4,1,4,0,0,1,7
2700,791292,9,0,0,0,0,0,0,0,2,3,2,3,2,0,2,0,0
2700,796580,11,0,3,0,1,0,2,1,2,0,0,1,2,1,1,0,1
2700,785792,18,4,6,1,2,3,4,1,1,0,2,0,0,0,0,0,12
2701,792261,23,4,7,4,7,0,0,0,0,1,4,0,3,2,1,1,8
2701,775206,25,5,8,4,6,1,2,3,3,0,1,0,5,0,2,0,14
2701,786122,30,4,13,2,9,2,4,4,6,0,2,0,2,0,2,0,14
2701,786113,20,1,2,1,2,0,0,0,0,0,6,0,1,0,2,0,2
2701,776284,24,3,11,2,5,1,6,4,6,1,4,1,1,0,1,0,11
2701,797980,6,1,2,1,2,0,0,0,0,1,1,0,1,0,0,0,2
2701,786124,23,2,2,2,2,0,0,3,4,2,7,0,3,1,3,0,7
2701,780877,14,0,2,0,2,0,0,1,2,0,2,0,1,2,1,0,1
2701,786331,13,1,2,1,2,0,0,1,3,1,3,0,5,0,1,0,3
2701,780308,22,1,4,1,2,0,2,1,2,0,2,3,2,0,1,0,3
2702,786509,23,5,12,5,12,0,0,1,3,4,3,0,4,2,4,1,11
2702,786508,27,3,5,3,4,0,1,2,3,0,1,0,5,1,2,0,8
2702,786507,27,3,7,3,6,0,1,4,6,1,5,2,2,4,2,0,10
2702,785796,32,4,13,4,12,0,1,7,10,3,0,0,0,1,0,0,15
2702,797576,35,1,6,1,4,0,2,0,0,0,0,1,2,1,3,0,2
2702,797577,6,1,1,1,1,0,0,0,0,0,0,0,2,0,0,0,2
2702,797582,5,0,1,0,1,0,0,0,0,1,2,0,1,0,1,0,0
2702,797580,17,0,2,0,1,0,1,0,0,1,3,0,3,0,1,0,0
2702,791897,12,0,1,0,0,0,1,0,0,0,1,0,0,0,0,0,0
2702,786505,14,3,7,2,3,1,4,1,2,0,0,0,2,0,2,0,8
2702,797579,2,0,0,0,0,0,0,0,0,0,0,0,0,0,0,0,0
2703,785509,26,0,1,0,0,0,1,0,0,0,3,2,3,0,2,0,0
2703,791424,24,8,13,7,11,1,2,9,13,1,5,1,1,0,0,3,26
2703,797085,31,3,8,2,6,1,2,3,4,0,6,4,4,0,7,0,10
2703,791421,33,5,7,5,6,0,1,3,4,1,2,2,4,2,6,0,13
2703,785899,33,1,3,1,1,0,2,0,0,0,4,0,3,1,1,0,2
2703,791425,20,4,4,4,4,0,0,5,6,2,3,1,2,2,2,1,13
2703,797090,9,1,2,1,2,0,0,0,0,1,3,0,2,1,1,0,2
2703,797088,18,2,4,1,3,1,1,0,0,0,1,0,2,0,1,0,5
2703,797087,5,0,0,0,0,0,0,0,0,0,0,0,3,0,0,0,0
2703,797086,1,0,0,0,0,0,0,0,0,0,0,0,0,0,0,0,0
2704,797831,23,0,8,0,3,0,5,3,6,4,8,1,2,1,3,0,3
2704,797823,30,5,10,5,8,0,2,5,5,4,8,0,2,1,2,4,15
2704,792286,12,2,2,2,2,0,0,0,0,1,0,0,0,0,0,1,4
2704,792280,10,1,2,1,1,0,1,0,0,0,0,0,0,0,1,0,2
2704,780505,33,3,13,3,8,0,5,7,10,0,6,2,2,3,2,0,13
2704,785950,20,2,5,1,1,1,4,2,2,2,1,0,0,0,1,0,7
2704,797829,17,1,5,1,5,0,0,3,6,1,3,0,1,0,3,1,5
2704,799468,22,3,6,1,2,2,4,3,6,0,4,2,3,0,1,0,11
2704,797826,6,0,1,0,0,0,1,0,0,0,0,0,2,0,0,0,0
2704,792284,24,0,1,0,0,0,1,0,0,0,6,1,1,0,2,0,0
2704,792287,3,1,2,1,2,0,0,0,0,1,0,0,0,0,0,0,2
2705,791922,2,0,0,0,0,0,0,0,0,0,0,0,0,0,0,0,0
2705,781122,20,4,8,4,8,0,0,1,2,1,9,0,0,1,2,0,9
2705,791925,24,2,9,1,5,1,4,0,0,2,2,1,0,1,2,0,5
2705,791926,22,5,14,1,2,4,12,0,0,0,2,0,5,0,0,0,14
2705,781112,15,1,3,1,2,0,1,0,0,0,0,4,2,1,1,0,2
2705,791923,23,1,11,1,10,0,1,1,3,1,1,0,4,0,0,0,3
2705,786529,13,2,3,2,3,0,0,0,0,4,1,1,2,0,1,1,4
2705,797541,10,0,3,0,3,0,0,0,0,0,3,0,2,0,1,0,0
2705,797542,21,2,7,0,3,2,4,0,0,0,2,2,3,1,2,0,6
2705,791927,19,0,4,0,3,0,1,2,2,1,4,1,2,2,2,0,2
2705,786858,16,1,1,1,1,0,0,0,0,0,0,0,2,1,1,0,2
2705,786527,15,2,4,1,2,1,2,0,0,0,2,1,1,1,1,1,5
2705,778952,0,0,0,0,0,0,0,0,0,0,0,0,0,0,0,0,0
2706,775954,28,2,4,2,4,0,0,6,6,4,2,2,1,2,2,0,10
2706,796194,27,3,6,0,0,3,6,0,0,0,0,8,1,0,2,0,9
2706,790917,28,3,5,3,3,0,2,5,6,2,6,5,0,3,1,1,11
2706,781157,28,8,12,6,8,2,4,0,0,1,2,1,2,2,0,1,18
2706,781006,22,2,5,2,4,0,1,1,2,0,2,1,0,1,1,2,5
2706,780648,13,2,3,2,3,0,0,1,2,0,2,0,2,0,1,0,5
2706,796459,20,3,8,3,6,0,2,3,4,2,2,3,0,0,1,2,9
2706,796464,16,1,3,1,2,0,1,2,2,1,2,0,3,0,4,0,4
2706,790918,13,4,4,4,4,0,0,1,1,0,1,1,3,1,0,1,9
2706,785238,4,0,0,0,0,0,0,0,0,0,1,0,0,0,0,0,0
2706,790916,1,0,0,0,0,0,0,0,0,0,0,0,0,0,0,0,0
2707,785948,29,4,7,4,7,0,0,0,0,2,0,1,3,1,0,0,8
2707,792020,34,7,12,3,6,4,6,0,0,1,2,6,3,1,8,0,18
2707,785946,29,0,2,0,2,0,0,0,0,1,4,1,1,1,0,1,0
2707,785941,25,3,5,0,0,3,5,0,0,0,0,1,2,0,2,0,9
2707,785938,31,2,7,2,3,0,4,1,1,0,2,2,2,3,4,0,5
2707,785939,27,5,14,3,11,2,3,1,2,0,2,1,2,1,0,0,13
2707,792025,14,2,4,2,4,0,0,1,1,1,1,0,2,0,1,0,5
2707,792026,7,1,2,1,2,0,0,0,0,0,0,0,3,0,0,0,2
2707,792024,2,0,0,0,0,0,0,0,0,0,0,0,1,0,0,0,0
2707,797634,2,0,0,0,0,0,0,0,0,0,0,0,0,0,0,0,0
2708,796705,23,4,7,2,5,2,2,0,0,0,2,1,4,1,1,0,10
2708,776469,30,4,8,3,6,1,2,1,4,1,4,1,0,1,4,1,10
2708,796708,35,2,11,1,6,1,5,3,4,1,7,7,3,2,2,0,8
2708,785498,32,5,10,5,9,0,1,1,2,2,2,1,1,2,1,0,11
2708,776322,38,4,12,3,6,1,6,2,6,0,5,2,2,1,0,1,11
2708,796706,22,3,3,3,3,0,0,0,0,3,3,0,2,0,2,0,6
2708,796709,14,4,5,4,4,0,1,6,7,1,2,0,3,0,0,0,14
2708,785500,6,0,1,0,1,0,0,0,0,2,0,1,0,0,0,0,0
2709,780025,36,9,12,9,12,0,0,1,1,2,2,0,0,0,0,1,19
2709,785383,39,6,16,5,10,1,6,4,5,2,6,5,2,0,2,1,17
2709,786228,31,2,5,1,2,1,3,0,1,0,3,3,3,0,2,0,5
2709,785385,23,1,10,1,3,0,7,0,0,0,1,2,0,1,1,0,2
2709,781046,8,1,3,1,1,0,2,0,0,0,1,0,4,0,1,0,2
2709,790837,23,1,5,1,3,0,2,0,0,1,5,4,5,2,3,0,2
2709,796391,8,1,2,0,0,1,2,0,0,0,0,0,1,0,1,0,3
2709,786297,7,1,3,1,3,0,0,1,1,3,0,0,0,0,0,0,3
2709,785384,15,3,3,3,3,0,0,2,2,1,3,1,4,0,2,0,8
2709,785382,8,1,4,0,0,1,4,0,0,0,1,0,0,0,0,1,3
2709,792180,2,0,0,0,0,0,0,0,0,0,0,0,0,0,0,0,0
2710,797050,30,3,7,1,3,2,4,1,5,2,6,2,4,0,5,0,9
2710,780394,33,6,11,3,6,3,5,0,0,0,7,2,2,0,0,0,15
2710,780391,25,3,5,3,5,0,0,4,6,1,1,1,2,1,4,0,10
2710,790871,32,4,6,2,3,2,3,0,0,1,3,5,0,0,3,0,10
2710,776473,26,2,10,1,7,1,3,0,0,0,3,1,2,0,1,0,5
2710,797048,21,3,4,3,3,0,1,0,2,2,1,2,3,1,1,0,6
2710,791573,9,0,1,0,1,0,0,2,2,0,1,3,0,0,2,0,2
2710,780392,10,3,5,2,3,1,2,0,0,1,1,2,1,0,0,1,7
2710,797049,5,0,0,0,0,0,0,0,0,0,1,1,0,0,0,0,0
2710,791570,9,2,2,2,2,0,0,0,1,0,0,0,2,0,0,0,4
2711,791981,31,6,10,6,9,0,1,1,1,2,5,0,3,1,0,0,13
2711,780342,22,2,3,1,2,1,1,2,2,0,3,2,4,0,1,0,7
2711,791982,33,5,12,3,5,2,7,2,4,0,4,3,2,2,0,0,14
2711,780333,32,7,13,1,2,6,11,2,2,0,2,4,1,0,0,0,22
2711,781493,31,4,9,2,3,2,6,0,0,0,2,5,4,1,3,0,10
2711,786756,24,2,7,1,1,1,6,0,0,0,2,2,2,2,0,1,5
2711,791984,10,1,3,1,3,0,0,2,2,2,1,0,0,0,0,0,4
2711,786755,16,2,3,1,2,1,1,5,5,1,2,1,2,0,0,0,10
2711,791985,1,0,0,0,0,0,0,0,0,0,0,0,0,0,0,0,0
2712,775664,22,4,6,1,1,3,5,2,2,0,1,0,1,0,0,0,13
2712,798117,24,3,6,2,2,1,4,3,4,1,2,5,1,5,2,0,10
2712,780913,15,3,6,1,1,2,5,0,0,1,1,2,3,1,2,0,8
2712,780594,19,2,6,1,1,1,5,1,1,1,3,2,1,1,0,0,6
2712,798119,21,2,7,1,2,1,5,0,0,0,2,1,1,1,0,0,5
2712,798123,15,4,7,4,5,0,2,2,2,1,5,3,0,6,0,1,10
2712,798127,9,2,5,0,1,2,4,0,0,0,0,0,0,0,0,0,6
2712,798124,20,2,3,1,1,1,2,0,2,0,2,7,1,3,1,1,5
2712,798118,13,1,3,0,0,1,3,0,0,0,3,0,2,0,0,0,3
2712,769332,11,1,6,1,4,0,2,1,2,1,0,0,2,1,1,1,3
2712,798121,10,1,2,0,0,1,2,0,0,0,1,1,0,0,1,0,3
2712,798120,7,1,1,0,0,1,1,0,0,0,2,0,1,0,0,0,3
2712,798126,7,0,1,0,1,0,0,0,0,0,0,0,0,0,0,0,0
2712,786398,7,0,0,0,0,0,0,0,0,0,0,0,1,1,1,1,0
2714,792277,14,6,7,6,7,0,0,1,3,1,3,0,3,0,0,0,13
2714,781464,17,1,7,0,1,1,6,0,0,1,7,2,0,0,2,0,3
2714,785282,26,3,7,1,2,2,5,1,2,1,6,4,1,1,2,0,9
2714,781501,21,4,5,4,4,0,1,1,1,2,2,3,1,1,2,0,9
2714,780259,18,6,10,5,8,1,2,1,2,3,7,3,1,2,1,0,14
2714,785913,11,2,4,2,4,0,0,3,5,0,0,0,4,0,0,0,7
2714,792274,11,1,6,1,6,0,0,0,1,2,1,0,1,0,1,1,2
2714,798058,26,8,8,6,6,2,2,2,2,0,6,9,3,1,2,0,20
2714,786516,22,3,8,1,2,2,6,0,0,0,5,1,1,2,0,0,8
2714,798051,9,1,1,1,1,0,0,0,0,0,1,0,1,0,1,0,2
2714,798056,14,2,4,0,0,2,4,1,2,0,2,1,0,0,0,1,7
2714,792275,7,1,2,0,1,1,1,0,0,0,0,1,0,1,0,0,3
2714,798038,2,2,2,2,2,0,0,1,2,1,1,0,0,0,0,0,5
2714,798048,2,0,1,0,0,0,1,0,0,0,0,1,0,0,0,0,0
2716,791401,36,9,12,9,12,0,0,4,6,5,4,2,1,0,5,1,22
2716,780125,28,4,7,3,6,1,1,2,4,2,4,1,2,1,2,1,11
2716,791400,37,7,17,5,11,2,6,0,0,0,5,1,1,2,3,0,16
2716,785931,23,1,5,1,2,0,3,2,2,0,2,1,2,1,1,0,4
2716,780118,35,0,4,0,2,0,2,2,4,1,0,3,4,1,1,0,2
2716,786837,16,1,4,0,1,1,3,0,0,0,2,0,2,0,0,0,3
2716,797125,22,2,2,0,0,2,2,0,0,0,0,3,1,2,4,0,6
2716,797130,3,1,1,0,0,1,1,0,0,0,1,0,1,0,0,0,3
2717,791917,7,0,1,0,1,0,0,0,0,0,1,0,1,0,0,0,0
2717,786526,22,4,7,4,5,0,2,1,1,0,3,1,4,0,2,0,9
2717,786525,33,5,6,2,2,3,4,0,0,0,3,3,1,2,0,1,13
2717,791914,33,4,8,1,3,3,5,0,0,0,0,4,3,1,2,0,11
2717,786030,18,6,9,5,5,1,4,4,4,0,3,1,3,2,4,0,17
2717,797550,17,1,5,1,3,0,2,0,0,0,2,2,1,1,0,0,2
2717,786856,22,4,6,4,6,0,0,5,6,4,5,0,4,0,4,0,13
2717,786524,16,1,1,1,1,0,0,0,0,0,1,0,0,1,1,0,2
2717,781109,32,3,7,3,5,0,2,1,2,0,2,2,0,3,2,0,7
2718,791193,23,5,8,5,8,0,0,2,2,1,2,0,3,1,1,6,12
2718,791191,20,5,7,5,6,0,1,1,1,1,5,5,4,0,3,0,11
2718,786738,33,8,12,6,9,2,3,1,2,3,5,6,2,3,3,0,19
2718,775694,31,1,5,1,2,0,3,2,2,0,6,3,2,1,1,1,4
2718,774827,35,8,15,4,8,4,7,2,4,0,4,4,2,2,4,0,22
2718,796863,27,5,8,3,5,2,3,0,0,1,1,4,0,1,2,0,12
2718,780384,17,2,2,2,2,0,0,1,2,1,5,0,2,1,5,2,5
2718,796865,14,2,4,0,1,2,3,0,0,1,2,0,1,1,1,0,6
2718,796866,0,0,0,0,0,0,0,0,0,0,0,0,0,0,0,0,0
2718,791189,0,0,0,0,0,0,0,0,0,0,0,0,0,0,0,0,0
2718,781090,0,0,0,0,0,0,0,0,0,0,0,0,0,0,0,0,0
2719,797779,29,5,15,2,6,3,9,2,2,5,2,3,1,1,3,0,15
2719,797769,24,1,5,1,3,0,2,0,0,0,4,1,3,0,2,0,2
2719,786256,26,6,12,6,12,0,0,3,4,2,5,1,2,0,4,0,15
2719,797768,26,4,10,2,4,2,6,0,0,0,1,2,0,0,2,0,10
2719,775106,30,5,7,4,5,1,2,2,3,1,2,1,3,1,3,0,13
2719,797776,20,0,6,0,2,0,4,0,0,0,1,2,1,1,1,0,0
2719,797773,21,2,6,1,3,1,3,1,2,0,1,1,1,1,1,0,6
2719,785568,14,1,4,1,4,0,0,0,0,2,1,1,1,0,0,0,2
2719,797774,4,1,2,1,1,0,1,0,0,1,0,0,0,0,0,0,2
2719,797781,2,0,0,0,0,0,0,0,0,1,0,0,0,0,0,0,0
2719,797780,2,2,3,0,0,2,3,1,2,0,0,0,0,1,0,0,7
2719,797775,2,0,1,0,0,0,1,0,0,0,0,1,0,0,0,0,0
2720,785374,18,3,5,3,5,0,0,2,2,4,1,1,4,1,1,0,8
2720,785372,31,5,13,5,12,0,1,2,3,1,5,3,3,1,7,0,12
2720,786384,28,7,9,4,6,3,3,10,11,0,7,2,4,0,1,0,27
2720,790825,26,2,9,1,7,1,2,0,0,0,1,7,3,0,2,0,5
2720,774905,30,3,9,1,6,2,3,0,0,2,0,2,3,0,0,0,8
2720,790827,16,2,4,1,3,1,1,0,0,1,1,2,2,0,1,0,5
2720,790828,11,2,3,2,3,0,0,0,0,0,3,0,2,0,2,0,4
2720,785375,6,0,1,0,1,0,0,0,0,0,2,0,1,0,0,0,0
2720,785371,15,2,2,1,1,1,1,0,0,0,0,5,2,0,0,0,5
2720,785373,19,1,2,1,2,0,0,0,0,1,0,1,2,0,0,0,2
2721,780358,25,3,7,3,5,0,2,2,2,0,2,0,1,0,1,1,8
2721,775011,23,5,7,4,4,1,3,2,2,0,4,2,5,2,1,1,13
2721,776004,22,3,5,1,2,2,3,3,4,2,4,5,1,0,1,0,11
2721,780357,29,4,8,3,4,1,4,2,2,0,3,4,1,2,0,0,11
2721,775018,32,7,14,3,7,4,7,11,15,0,2,2,0,2,2,0,29
2721,790930,18,2,3,2,3,0,0,0,0,0,4,1,4,0,1,1,4
2721,796480,30,3,6,3,6,0,0,1,3,0,2,2,4,1,0,1,7
2721,776270,21,0,1,0,1,0,0,2,2,1,2,2,0,0,0,0,2
2722,781439,34,9,22,6,12,3,10,4,5,1,5,0,2,0,2,0,25
2722,781322,21,1,4,1,2,0,2,0,0,0,3,0,4,1,2,2,2
2722,786571,29,4,11,2,9,2,2,5,6,0,4,1,3,3,0,0,15
2722,791690,30,3,4,3,4,0,0,0,3,3,3,1,4,0,0,1,6
2722,785989,35,7,16,6,14,1,2,2,4,1,4,3,1,2,2,0,17
2722,780563,18,0,0,0,0,0,0,0,0,1,1,0,3,0,0,0,0
2722,797299,4,0,1,0,1,0,0,1,2,0,1,0,0,0,1,0,1
2722,781419,13,0,3,0,2,0,1,0,0,0,0,1,1,0,1,0,0
2722,781207,4,0,0,0,0,0,0,0,0,0,1,0,1,0,0,0,0
2722,784248,12,1,3,0,0,1,3,0,0,0,1,0,0,0,0,0,3
2723,796309,33,5,7,5,7,0,0,3,5,3,12,0,2,0,5,2,13
2723,775667,33,3,6,1,3,2,3,2,2,0,5,6,3,0,4,0,10
2723,780012,37,6,12,3,4,3,8,2,2,1,4,4,3,1,1,0,17
2723,790824,34,9,16,7,9,2,7,0,1,1,8,2,2,0,2,0,20
2723,780011,32,2,7,1,2,1,5,2,2,0,0,4,3,3,1,0,7
2723,781524,16,5,8,4,5,1,3,2,2,2,3,0,2,0,1,0,13
2723,796383,9,0,3,0,2,0,1,0,0,0,1,0,1,2,1,0,0
2723,785370,6,0,0,0,0,0,0,0,0,0,0,0,0,0,0,0,0
2724,790839,27,1,5,0,1,1,4,2,2,2,4,2,3,0,0,0,5
2724,785388,16,4,9,4,9,0,0,2,3,3,5,2,3,0,2,0,10
2724,790840,29,7,11,4,5,3,6,0,0,0,2,1,2,1,0,0,17
2724,785386,28,6,15,4,9,2,6,2,4,0,1,1,3,0,3,0,16
2724,780373,30,1,1,0,0,1,1,2,2,0,5,3,2,1,1,0,5
2724,796393,19,2,6,2,6,0,0,2,3,3,4,0,1,0,1,2,6
2724,780370,18,0,0,0,0,0,0,0,0,0,3,1,2,0,2,1,0
2724,796395,19,4,8,2,5,2,3,1,3,1,4,4,1,1,0,0,11
2724,790841,10,1,2,0,0,1,2,0,0,0,1,2,1,0,0,0,3
2724,796396,4,0,0,0,0,0,0,0,0,0,0,0,0,0,0,0,0
2725,791585,33,5,9,3,4,2,5,3,3,1,7,1,1,1,1,0,15
2725,785228,20,2,9,0,4,2,5,0,0,0,1,1,2,0,0,0,6
2725,791581,29,2,5,2,3,0,2,0,0,0,2,0,3,1,1,0,4
2725,786395,33,5,10,3,4,2,6,1,3,1,4,3,1,1,2,0,13
2725,786394,31,5,12,3,8,2,4,2,2,1,3,3,3,2,1,1,14
2725,780062,5,0,1,0,1,0,0,0,2,0,0,0,1,0,0,0,0
2725,791582,12,0,4,0,1,0,3,3,4,1,1,0,3,0,0,1,3
2725,780404,26,4,6,3,4,1,2,1,6,0,4,4,3,0,0,0,10
2725,797041,6,1,1,1,1,0,0,0,1,0,0,0,1,0,0,1,2
2725,780403,5,1,1,0,0,1,1,0,0,1,1,2,0,0,0,0,3
2726,785635,30,5,10,4,8,1,2,7,9,3,2,0,3,0,1,4,18
2726,786720,31,2,8,1,4,1,4,2,2,2,4,5,3,1,2,0,7
2726,786440,37,2,8,1,1,1,7,4,4,2,2,4,5,0,0,0,9
2726,791628,18,1,4,1,1,0,3,0,0,2,4,1,2,0,0,0,2
2726,781199,43,9,16,3,3,6,13,6,8,0,3,8,2,0,2,0,30
2726,776462,27,8,10,0,1,8,9,2,2,2,7,1,2,0,2,1,26
2726,796974,24,2,10,2,5,0,5,4,4,0,2,3,2,0,1,0,8
2726,775642,8,0,0,0,0,0,0,0,0,0,0,0,3,2,0,0,0
2726,791626,7,1,1,1,1,0,0,0,0,0,0,0,1,0,0,0,2
2727,786176,38,3,13,1,6,2,7,6,7,4,5,2,3,2,1,0,14
2727,774828,28,3,9,2,2,1,7,0,0,0,5,3,4,0,0,0,7
2727,780028,34,1,2,0,0,1,2,0,0,0,2,6,3,1,0,0,3
2727,786173,39,7,12,2,6,5,6,4,7,0,2,2,1,0,0,0,23
2727,780027,39,11,27,10,22,1,5,9,12,11,6,1,2,2,2,1,32
2727,791379,13,1,5,1,4,0,1,3,4,3,1,0,1,0,1,0,5
2727,780029,8,1,2,1,1,0,1,0,0,1,1,0,2,0,1,0,2
2727,797175,9,1,2,1,2,0,0,0,0,1,3,0,1,1,2,0,2
2727,791380,17,1,6,1,5,0,1,5,8,1,1,3,4,0,0,0,7
2727,797178,0,0,0,0,0,0,0,0,0,0,0,0,1,0,0,0,0
2728,785681,21,3,4,3,4,0,0,0,0,2,4,1,3,1,2,0,6
2728,796789,22,5,9,4,6,1,3,3,3,1,3,2,1,2,0,2,14
2728,791126,30,3,7,3,6,0,1,3,4,1,5,4,1,1,1,1,9
2728,791124,17,3,5,3,4,0,1,2,2,0,2,1,1,1,3,0,8
2728,780050,23,7,12,5,8,2,4,1,2,1,5,2,0,0,0,0,17
2728,784479,18,4,6,3,4,1,2,4,6,2,1,1,4,2,0,0,13
2728,796786,15,0,1,0,0,0,1,0,0,0,1,0,1,0,0,0,0
2728,796787,2,1,1,0,0,1,1,0,0,0,0,0,0,0,0,0,3
2728,796784,16,3,6,2,3,1,3,1,1,0,2,4,1,0,1,0,8
2728,796783,8,0,0,0,0,0,0,0,0,0,0,2,1,1,1,0,0
2728,796782,21,2,4,0,0,2,4,3,4,0,3,3,5,0,0,0,9
2728,792709,1,0,0,0,0,0,0,0,0,0,0,0,0,0,0,0,0
2728,792711,3,0,0,0,0,0,0,0,0,0,0,0,2,0,0,0,0
2728,791125,3,0,1,0,1,0,0,0,0,0,0,0,1,0,0,0,0
2729,780686,29,0,5,0,5,0,0,0,1,4,5,2,2,0,4,0,0
2729,780683,25,3,8,3,6,0,2,1,2,6,3,0,2,0,1,3,7
2729,797681,29,4,13,3,5,1,8,8,10,0,0,2,1,1,1,1,17
2729,797679,25,3,11,2,4,1,7,0,0,1,3,1,1,0,2,0,7
2729,780688,23,4,11,2,7,2,4,3,4,4,1,1,2,0,1,0,13
2729,797683,8,3,5,1,1,2,4,0,0,1,1,0,0,0,0,0,8
2729,797682,10,1,1,1,1,0,0,7,10,2,3,0,4,0,1,1,9
2729,797680,4,0,1,0,1,0,0,0,2,0,0,0,1,0,0,0,0
2729,791942,7,0,1,0,0,0,1,0,0,0,0,3,1,0,0,0,0
2729,791941,14,2,4,1,1,1,3,0,0,1,0,0,3,0,0,0,5
2729,780772,18,1,1,1,1,0,0,0,0,0,1,1,2,1,0,0,2
2729,780689,8,0,2,0,1,0,1,1,2,0,0,0,1,0,0,0,1
2730,796754,21,1,6,1,3,0,3,0,0,1,2,0,4,1,1,0,2
2730,780315,31,2,4,1,2,1,2,0,0,0,3,2,3,1,4,1,5
2730,791099,38,5,12,4,8,1,4,1,2,1,0,1,2,0,0,0,12
2730,785470,36,4,8,4,6,0,2,5,6,1,4,1,4,0,3,0,13
2730,785586,33,1,3,1,3,0,0,5,9,4,6,2,2,1,7,0,7
2730,790846,21,1,3,1,3,0,0,0,1,3,2,0,2,0,2,1,2
2730,780298,20,2,7,2,5,0,2,9,10,0,3,0,4,1,0,0,13
2731,776286,21,0,3,0,1,0,2,0,0,1,3,0,4,0,0,0,0
2731,775557,22,2,2,2,2,0,0,4,4,0,0,0,5,0,1,2,8
2731,791445,34,6,14,2,4,4,10,3,3,0,5,1,1,1,0,0,19
2731,785357,34,2,8,0,1,2,7,3,4,0,5,2,4,3,5,0,9
2731,775560,27,2,7,1,4,1,3,5,8,0,3,5,4,1,0,0,10
2731,797010,8,0,2,0,1,0,1,0,0,0,0,0,2,1,1,0,0
2731,785287,15,2,3,2,3,0,0,0,1,1,1,0,2,1,0,0,4
2731,790516,25,4,10,4,8,0,2,4,4,1,0,0,1,2,0,0,12
2731,797012,5,0,0,0,0,0,0,1,2,0,0,1,0,0,0,0,1
2731,791444,9,0,1,0,1,0,0,0,0,2,1,0,1,0,1,0,0
2732,786526,25,4,7,4,5,0,2,2,2,1,3,2,3,1,0,0,10
2732,786525,32,9,16,6,12,3,4,2,2,0,2,3,1,3,0,0,23
2732,791914,30,6,11,4,7,2,4,0,1,0,1,5,1,1,0,0,14
2732,786030,32,2,8,1,5,1,3,2,4,0,5,3,0,0,1,2,7
2732,781109,18,1,3,1,2,0,1,0,0,1,0,1,2,0,1,2,2
2732,791917,18,1,2,1,2,0,0,0,2,0,3,4,5,0,0,1,2
2732,786856,19,4,6,4,6,0,0,0,0,2,5,3,1,0,2,0,8
2732,786524,15,1,3,1,3,0,0,0,0,0,1,3,1,1,0,0,2
2732,797550,11,0,2,0,0,0,2,3,3,0,0,0,0,1,1,0,3
2733,790873,30,6,11,6,10,0,1,3,4,2,6,2,3,1,2,1,15
2733,780054,16,3,8,3,5,0,3,0,0,1,4,3,2,0,2,0,6
2733,781140,26,5,9,5,8,0,1,4,4,2,6,0,1,0,0,0,14
2733,786851,35,1,9,0,3,1,6,4,4,0,5,4,0,1,1,0,7
2733,776357,39,3,9,3,7,0,2,0,0,2,2,5,3,0,3,0,6
2733,796433,5,1,2,1,2,0,0,1,2,1,0,0,1,0,0,0,3
2733,776245,17,4,5,1,1,3,4,0,0,0,3,0,3,0,1,0,11
2733,781139,22,3,5,3,3,0,2,0,1,1,1,0,2,0,1,0,6
2733,780343,5,0,1,0,0,0,1,0,0,0,0,1,0,1,0,0,0
2733,796432,4,1,2,1,2,0,0,0,0,2,2,1,0,0,0,0,2
2733,785429,1,0,0,0,0,0,0,0,0,0,0,0,0,0,0,0,0
2734,776174,32,8,18,8,18,0,0,1,3,4,10,1,0,0,4,1,17
2734,791958,38,8,12,8,11,0,1,2,2,4,6,1,0,1,2,1,18
2734,791960,25,2,7,2,5,0,2,0,0,0,1,1,1,2,1,1,4
2734,785861,28,2,6,1,5,1,1,0,0,3,3,0,3,1,2,0,5
2734,781332,36,4,13,2,6,2,7,2,2,0,7,5,3,2,4,0,12
2734,786059,22,5,9,4,7,1,2,0,0,1,7,1,3,2,1,0,11
2734,797704,19,0,1,0,0,0,1,0,0,0,1,1,0,1,0,0,0
2735,796656,17,3,5,3,5,0,0,0,0,1,1,0,0,0,1,1,6
2735,791321,20,1,8,1,8,0,0,0,0,0,3,1,1,0,2,0,2
2735,791323,28,2,6,1,3,1,3,0,0,1,6,3,1,3,1,0,5
2735,791320,34,6,16,5,13,1,3,0,2,0,4,1,3,2,1,0,13
2735,781511,36,4,13,3,8,1,5,2,2,0,4,4,1,1,2,1,11
2735,796650,17,1,3,1,3,0,0,0,0,0,2,1,1,2,0,0,2
2735,796657,17,3,5,3,5,0,0,1,2,0,0,0,2,0,1,0,7
2735,796651,18,0,1,0,0,0,1,0,0,0,4,0,0,1,0,1,0
2735,796653,9,2,2,1,1,1,1,0,1,2,1,0,1,0,3,2,5
2735,792257,4,1,1,1,1,0,0,0,0,0,0,0,2,0,0,0,2
2736,791295,29,4,11,4,8,0,3,2,2,6,3,2,1,1,2,1,10
2736,776345,19,2,3,2,3,0,0,1,4,2,3,1,3,0,0,1,5
2736,791293,23,2,7,2,4,0,3,1,4,0,1,1,1,1,3,0,5
2736,796579,35,6,14,1,3,5,11,2,2,0,5,4,4,1,2,0,19
2736,781373,25,3,9,2,3,1,6,2,2,0,3,3,3,4,3,0,9
2736,781379,8,1,1,1,1,0,0,1,3,1,1,0,3,0,0,0,3
2736,791292,15,4,5,4,5,0,0,0,0,4,5,0,3,1,2,0,8
2736,796580,6,0,1,0,0,0,1,0,0,0,0,0,0,0,2,0,0
2736,785794,20,3,7,3,3,0,4,0,0,1,1,4,2,1,1,0,6
2736,785792,20,0,4,0,1,0,3,0,0,0,1,1,0,1,2,0,0
2737,791781,9,0,0,0,0,0,0,0,0,1,0,0,0,0,2,0,0
2737,776285,6,1,2,1,2,0,0,0,0,0,1,0,3,0,1,0,2
2737,791777,33,5,11,5,9,0,2,2,5,1,2,3,2,2,5,0,12
2737,781025,11,0,1,0,1,0,0,2,2,0,0,0,1,0,1,0,2
2737,780488,25,4,9,3,3,1,6,4,6,1,3,0,2,3,0,0,13
2737,791778,11,1,2,1,2,0,0,0,0,1,2,0,2,1,0,0,2
2737,786476,19,1,4,1,4,0,0,5,6,0,2,0,4,0,2,1,7
2737,791780,20,1,2,0,1,1,1,0,0,0,1,1,0,0,0,0,3
2737,791776,8,0,0,0,0,0,0,0,0,0,0,0,1,0,1,0,0
2737,791829,18,5,9,3,6,2,3,2,2,0,3,0,1,1,1,0,14
2737,786474,23,1,4,1,3,0,1,0,0,0,3,1,1,3,4,0,2
2737,775503,17,3,5,0,1,3,4,2,4,0,5,1,1,0,1,0,11
2738,781497,26,1,4,1,4,0,0,1,3,2,6,1,4,2,2,2,3
2738,792414,23,3,8,2,6,1,2,1,2,1,2,1,3,0,0,0,8
2738,789020,41,7,14,1,2,6,12,8,8,0,4,2,2,0,4,0,28
2738,792091,21,4,6,3,3,1,3,0,0,1,2,2,3,0,3,0,9
2738,786787,44,7,17,5,8,2,9,2,2,0,3,3,3,1,4,0,18
2738,786795,6,0,1,0,0,0,1,2,2,1,0,0,0,0,1,1,2
2738,786792,14,1,4,1,4,0,0,0,0,2,2,0,2,0,1,0,2
2738,781456,20,0,3,0,3,0,0,1,2,0,5,1,1,0,0,1,1
2738,774954,30,2,4,2,4,0,0,0,0,0,1,4,2,3,4,0,4
2739,797529,30,4,8,4,8,0,0,2,4,3,4,2,4,1,3,1,10
2739,797527,33,7,10,6,7,1,3,3,6,5,3,1,2,3,2,0,18
2739,791936,41,7,12,7,12,0,0,2,2,6,7,0,3,2,2,0,16
2739,797532,44,1,9,1,6,0,3,6,10,0,5,12,1,1,5,0,8
2739,785688,42,3,14,1,2,2,12,0,0,0,5,2,4,1,2,0,8
2739,791931,10,4,6,4,5,0,1,0,0,1,1,0,2,0,0,0,8
2739,797531,0,0,1,0,1,0,0,0,0,1,0,0,0,0,0,0,0
2739,791932,10,0,5,0,1,0,4,0,0,0,2,0,0,1,0,0,0
2739,785988,15,3,8,0,2,3,6,0,0,1,0,0,0,0,0,0,9
2740,791534,29,3,3,3,3,0,0,2,2,2,7,1,4,0,1,0,8
2740,797127,31,2,9,2,4,0,5,1,2,1,2,2,2,2,2,0,5
2740,791528,40,5,10,2,6,3,4,4,5,1,6,4,1,1,4,0,17
2740,775045,38,7,16,6,13,1,3,5,6,0,5,2,2,0,3,0,20
2740,791529,9,1,4,0,0,1,4,0,0,0,0,0,1,0,0,0,3
2740,797124,11,0,0,0,0,0,0,0,0,1,0,0,3,0,1,2,0
2740,791531,15,2,4,1,2,1,2,0,0,1,2,0,1,1,0,0,5
2740,791533,27,2,6,2,4,0,2,0,0,1,5,0,3,1,1,0,4
2741,797222,21,2,6,2,6,0,0,3,4,4,3,0,5,2,3,3,7
2741,781526,22,0,4,0,4,0,0,1,2,0,1,0,3,0,2,1,1
2741,797217,36,3,9,2,4,1,5,0,0,0,3,3,1,2,1,0,7
2741,797218,29,3,11,3,8,0,3,5,5,5,2,1,1,1,2,0,11
2741,775697,38,6,12,2,6,4,6,3,5,2,5,2,4,2,2,0,19
2741,791846,25,5,7,5,7,0,0,0,1,1,5,0,0,0,0,0,10
2741,797223,13,1,5,1,5,0,0,2,5,3,1,0,1,0,0,1,4
2741,797219,16,0,4,0,1,0,3,0,0,0,0,0,0,0,1,0,0
2742,786122,32,7,12,4,6,3,6,1,2,1,4,1,3,0,0,0,18
2742,775206,32,4,9,3,5,1,4,3,3,2,7,3,1,1,2,0,12
2742,792261,26,6,13,6,13,0,0,0,0,4,7,1,2,1,2,0,12
2742,786124,14,5,6,5,6,0,0,0,0,4,3,2,1,0,1,0,10
2742,776284,28,1,13,1,9,0,4,0,0,1,7,4,3,1,8,0,2
2742,786331,20,5,7,5,7,0,0,0,0,1,1,0,4,0,0,0,10
2742,786113,14,1,3,1,3,0,0,5,5,0,2,2,0,0,0,0,7
2742,780308,28,2,6,1,4,1,2,0,1,0,5,2,3,0,1,0,5
2742,780877,3,1,1,1,1,0,0,0,0,1,1,0,0,0,1,0,2
2742,797980,3,0,0,0,0,0,0,0,0,0,0,0,0,0,0,0,0
2743,780629,39,8,14,7,10,1,4,6,10,3,7,4,3,1,2,0,23
2743,791161,33,5,12,1,2,4,10,2,2,0,2,1,4,0,2,0,16
2743,785346,38,5,12,1,1,4,11,0,0,1,4,5,2,0,2,0,14
2743,775888,35,5,15,4,11,1,4,1,6,1,3,2,3,2,2,0,12
2743,796815,23,1,4,1,2,0,2,0,0,0,5,2,0,0,0,0,2
2743,791159,20,2,7,0,1,2,6,0,2,0,0,0,2,1,0,0,6
2743,796819,12,0,0,0,0,0,0,0,0,0,0,1,1,1,1,0,0
2744,797142,20,0,0,0,0,0,0,0,0,1,0,0,0,2,0,0,0
2744,791522,33,9,12,9,11,0,1,4,7,2,7,6,2,0,3,0,22
2744,786351,25,5,7,3,3,2,4,3,4,1,7,2,4,1,1,0,15
2744,797147,15,0,2,0,2,0,0,1,2,0,2,2,3,1,2,1,1
2744,797146,36,10,21,8,13,2,8,7,7,1,2,2,0,0,4,1,29
2744,785479,11,1,2,1,1,0,1,1,2,1,3,0,1,1,0,0,3
2744,797144,25,2,5,2,5,0,0,4,6,1,2,4,2,2,1,0,8
2744,785816,13,0,1,0,1,0,0,0,0,2,0,0,2,1,1,0,0
2744,791520,19,3,5,3,4,0,1,0,0,1,1,0,1,0,1,0,6
2744,786348,3,1,1,1,1,0,0,0,0,0,0,0,0,0,1,0,2
2745,775563,27,3,8,3,5,0,3,1,4,1,5,2,3,0,1,0,7
2745,781011,14,2,3,2,3,0,0,1,2,2,1,0,3,0,1,1,5
2745,797601,35,4,12,2,3,2,9,2,2,3,2,4,2,1,2,0,12
2745,786466,33,5,12,1,1,4,11,0,0,0,3,5,3,3,2,0,14
2745,781012,26,3,9,2,4,1,5,0,0,0,2,2,4,2,0,1,7
2745,797602,8,3,5,2,3,1,2,0,0,1,0,0,2,0,0,0,7
2745,775119,30,4,12,4,7,0,5,0,2,0,4,2,2,1,6,1,8
2745,775188,23,8,9,8,9,0,0,4,4,6,3,2,2,2,1,1,20
2745,797604,2,0,0,0,0,0,0,0,0,0,0,0,1,0,0,0,0
2745,776157,2,0,0,0,0,0,0,0,0,0,0,0,0,0,0,0,0
2746,780096,32,0,5,0,1,0,4,4,5,0,6,1,2,2,1,0,4
2746,785906,36,11,17,7,12,4,5,4,5,0,2,5,2,0,2,0,30
2746,791416,29,6,12,6,12,0,0,3,4,4,11,1,2,0,2,2,15
2746,797096,18,0,4,0,0,0,4,0,0,0,0,0,1,0,2,0,0
2746,780100,28,2,3,0,0,2,3,2,2,1,3,1,1,0,1,0,8
2746,781614,9,0,4,0,2,0,2,0,0,0,2,0,1,0,0,0,0
2746,797093,30,2,6,2,5,0,1,1,2,1,5,5,0,3,2,0,5
2746,785907,18,3,3,2,2,1,1,0,0,1,2,2,0,0,1,0,7
2747,780118,28,4,12,3,7,1,5,0,0,1,2,3,3,0,0,0,9
2747,791400,32,8,12,3,6,5,6,2,4,0,2,0,2,2,3,0,23
2747,797125,32,2,4,2,2,0,2,0,0,0,4,2,2,0,0,0,4
2747,791401,30,3,13,3,13,0,0,5,5,0,8,1,3,2,3,3,11
2747,780125,30,2,5,2,4,0,1,0,0,1,4,1,1,1,0,0,4
2747,797130,6,0,1,0,0,0,1,0,0,0,0,0,2,0,0,0,0
2747,797132,5,0,0,0,0,0,0,0,0,0,0,0,0,0,0,0,0
2747,786837,16,1,5,1,5,0,0,0,0,0,4,1,0,0,0,0,2
2747,785931,17,2,5,2,3,0,2,0,0,0,0,1,1,1,1,1,4
2747,797126,4,1,1,0,0,1,1,0,0,0,0,0,1,0,0,0,3
2748,786759,33,7,14,6,11,1,3,4,4,0,2,4,1,0,6,0,19
2748,797865,29,1,2,0,1,1,1,0,2,0,2,4,2,0,3,0,3
2748,775510,33,3,11,3,7,0,4,4,4,1,4,1,1,1,1,0,10
2748,774976,13,4,5,3,4,1,1,0,0,4,2,0,4,0,2,3,9
2748,792291,16,2,5,0,1,2,4,0,0,0,0,0,3,1,0,0,6
2748,786614,27,5,7,1,1,4,6,1,2,0,3,2,1,1,1,0,15
2748,792293,18,3,6,3,3,0,3,2,2,0,1,0,2,0,2,0,8
2748,792292,10,0,1,0,1,0,0,0,0,2,2,2,2,1,0,0,0
2748,792294,8,1,2,0,0,1,2,2,2,0,2,0,0,0,0,0,5
2748,797864,8,0,1,0,0,0,1,0,0,0,0,0,4,0,0,1,0
2748,786761,5,0,0,0,0,0,0,0,0,0,0,1,0,0,0,0,0
2749,796355,29,3,7,3,6,0,1,2,2,2,5,6,2,4,1,0,8
2749,790798,28,9,15,9,14,0,1,11,13,3,5,3,2,1,1,1,29
2749,780137,35,3,6,2,2,1,4,1,2,0,4,2,2,0,0,0,8
2749,790799,16,3,4,3,4,0,0,0,1,1,1,3,2,0,0,1,6
2749,780140,30,11,15,2,2,9,13,1,2,0,1,3,3,0,1,0,32
2749,785245,30,3,3,3,3,0,0,1,1,0,4,8,1,1,2,0,7
2749,775553,13,2,3,2,3,0,0,2,2,1,1,1,4,1,1,0,6
2749,790796,6,1,3,1,3,0,0,0,0,0,0,0,0,0,1,0,2
2749,796359,6,0,0,0,0,0,0,0,0,1,1,0,0,1,0,0,0
2749,796354,5,0,1,0,0,0,1,0,0,0,0,0,0,0,0,0,0
2749,790800,2,0,1,0,1,0,0,0,0,0,0,0,1,0,0,0,0
2750,780521,26,1,7,0,3,1,4,5,6,3,1,0,4,0,0,1,8
2750,775163,20,6,7,6,7,0,0,0,0,2,3,4,2,0,1,0,12
2750,791370,28,5,12,4,8,1,4,3,6,1,3,2,1,0,1,1,14
2750,786199,33,8,12,6,6,2,6,4,4,0,3,2,2,2,3,1,22
2750,780991,26,3,6,3,5,0,1,4,4,0,3,4,4,0,2,0,10
2750,797269,4,2,2,2,2,0,0,0,0,1,0,0,1,1,0,0,4
2750,781611,14,2,3,2,3,0,0,2,5,4,0,0,1,0,0,0,6
2750,797271,23,3,9,1,2,2,7,0,0,0,2,2,1,1,3,1,8
2750,743593,8,0,1,0,1,0,0,0,2,0,0,0,1,0,0,0,0
2750,791371,18,1,3,1,3,0,0,2,2,0,1,1,2,0,0,0,4
2751,785481,24,6,8,6,7,0,1,1,3,2,1,0,3,1,1,0,13
2751,791827,32,11,18,11,17,0,1,6,7,2,6,1,3,1,4,0,28
2751,797391,20,6,6,1,1,5,5,0,0,0,0,0,5,0,1,0,17
2751,786625,35,3,10,1,3,2,7,2,6,0,1,9,2,0,1,1,10
2751,780625,33,5,9,0,1,5,8,2,2,1,2,9,4,1,2,0,17
2751,797397,10,2,3,2,3,0,0,0,0,0,2,0,2,1,0,1,4
2751,797394,15,2,6,2,6,0,0,0,0,3,0,1,4,0,2,0,4
2751,791828,4,0,0,0,0,0,0,0,0,0,0,1,1,0,0,0,0
2751,786630,25,4,5,3,3,1,2,0,0,1,2,2,1,0,1,0,9
2751,791830,2,0,0,0,0,0,0,0,0,0,0,0,0,0,0,0,0
2752,785838,28,8,9,5,6,3,3,2,3,1,3,1,4,0,1,0,21
2752,791707,21,2,5,2,4,0,1,0,0,0,3,1,2,0,3,0,4
2752,775872,17,0,3,0,2,0,1,4,6,1,2,0,0,1,1,0,4
2752,785836,35,5,8,4,5,1,3,2,3,2,6,1,1,0,2,0,13
2752,785833,36,6,10,4,6,2,4,5,6,1,4,2,2,2,5,0,19
2752,791704,28,1,7,1,6,0,1,0,5,1,5,2,2,2,4,1,2
2752,785332,21,4,6,3,4,1,2,1,3,2,5,2,2,0,0,3,10
2752,785892,14,2,5,2,4,0,1,0,0,0,1,1,1,0,1,0,4
2753,786861,28,1,8,1,2,0,6,0,0,1,2,1,3,0,3,0,2
2753,796870,15,0,1,0,1,0,0,0,0,0,2,1,2,0,1,0,0
2753,780387,28,4,7,2,4,2,3,0,0,0,6,3,4,1,2,0,10
2753,767033,34,7,11,3,6,4,5,3,4,0,2,1,3,5,2,0,21
2753,792415,28,4,10,1,3,3,7,0,0,0,2,2,4,1,4,0,11
2753,792416,13,0,1,0,1,0,0,0,0,0,1,1,0,1,0,0,0
2753,792417,26,4,8,2,6,2,2,2,6,3,2,3,3,1,1,2,12
2753,786867,22,3,5,2,2,1,3,0,0,0,1,0,2,0,0,0,7
2753,786866,6,2,6,0,0,2,6,0,0,0,1,0,1,0,0,0,6
2754,791126,27,11,12,11,12,0,0,1,2,2,3,2,3,1,2,0,23
2754,785681,34,2,4,2,4,0,0,1,2,2,8,0,3,0,1,2,5
2754,796789,28,6,11,5,6,1,5,1,3,1,4,2,0,4,1,2,14
2754,796786,4,1,3,1,2,0,1,0,0,0,0,0,0,0,0,0,2
2754,796784,14,0,1,0,0,0,1,0,0,0,0,2,0,2,2,0,0
2754,775813,3,0,0,0,0,0,0,0,0,0,0,0,0,0,0,0,0
2754,780050,28,7,13,5,8,2,5,3,6,3,3,1,1,2,2,0,19
2754,796785,5,2,3,2,3,0,0,0,0,0,0,0,1,0,1,0,4
2754,791124,26,3,6,2,4,1,2,1,1,0,1,1,1,0,0,0,8
2754,796782,24,1,3,0,0,1,3,3,3,0,1,3,3,0,1,0,6
2754,796783,4,0,2,0,2,0,0,0,0,1,0,0,3,0,0,0,0
2754,784479,3,0,1,0,0,0,1,0,0,0,0,0,0,0,0,0,0
2755,780688,36,8,17,5,12,3,5,5,5,3,4,2,3,1,3,0,24
2755,797679,37,5,9,1,2,4,7,0,0,2,4,0,0,1,2,1,14
2755,797681,31,2,4,0,2,2,2,5,8,1,3,4,5,1,2,0,11
2755,780686,35,6,12,6,12,0,0,1,2,1,6,5,0,0,3,0,13
2755,791941,3,0,1,0,0,0,1,0,0,0,0,0,1,0,0,0,0
2755,780772,9,1,3,1,2,0,1,0,0,1,0,1,0,0,2,0,2
2755,791942,4,0,0,0,0,0,0,0,0,0,0,1,1,0,0,0,0
2755,797682,4,0,0,0,0,0,0,0,0,0,1,0,1,0,2,1,0
2755,780683,26,1,9,1,4,0,5,1,2,5,2,0,3,0,0,0,3
2755,797683,14,3,4,2,2,1,2,0,2,2,0,2,1,0,0,0,7
2755,780689,1,0,0,0,0,0,0,0,0,0,0,0,1,0,1,0,0
2756,791237,28,9,15,2,3,7,12,0,0,1,4,2,0,5,0,0,25
2756,776209,25,3,5,3,5,0,0,2,4,3,3,3,0,1,3,0,8
2756,791236,17,4,7,3,4,1,3,1,2,1,1,2,0,3,1,0,10
2756,781227,18,0,5,0,1,0,4,0,0,1,1,0,3,2,2,0,0
2756,796938,25,4,11,2,4,2,7,7,7,1,1,4,2,4,0,0,17
2756,791240,12,3,8,2,6,1,2,4,4,1,3,0,2,2,0,0,11
2756,796939,12,0,4,0,2,0,2,0,0,0,1,1,1,0,0,0,0
2756,791235,20,2,6,1,4,1,2,1,2,1,6,0,1,2,2,0,6
2756,774875,17,3,4,3,4,0,0,0,0,5,2,1,0,0,2,0,6
2756,791351,26,4,11,2,4,2,7,1,2,0,0,4,1,3,0,0,11
2758,785674,26,5,10,1,3,4,7,2,2,3,1,0,4,1,2,0,16
2758,780527,22,3,8,2,4,1,4,4,4,0,4,1,2,1,0,0,11
2758,780049,22,3,6,3,5,0,1,3,6,1,5,4,2,1,2,0,9
2758,789059,30,4,8,3,6,1,2,0,0,1,2,1,3,0,0,0,9
2758,797784,33,5,13,4,7,1,6,2,2,1,3,7,3,0,3,0,13
2758,780980,15,0,0,0,0,0,0,0,0,0,1,0,2,1,1,0,0
2758,797782,13,2,5,2,4,0,1,1,2,1,2,2,1,0,0,1,5
2758,792173,10,0,0,0,0,0,0,0,0,0,0,0,2,0,0,0,0
2758,792174,1,0,0,0,0,0,0,0,0,0,0,0,0,0,0,0,0
2758,792171,10,1,2,1,2,0,0,1,2,0,2,2,4,0,2,0,3
2758,797783,18,3,4,3,3,0,1,1,3,0,4,0,0,2,0,0,7
2759,786406,25,1,2,0,1,1,1,0,0,0,7,3,1,0,1,0,3
2759,780414,37,11,16,9,11,2,5,6,11,2,1,2,0,1,3,0,30
2759,786410,30,1,4,0,2,1,2,3,4,0,3,0,3,0,3,0,6
2759,775095,13,4,8,4,8,0,0,0,0,1,3,1,1,0,1,2,8
2759,791606,26,0,4,0,2,0,2,3,4,1,2,0,3,1,0,1,3
2759,791603,19,0,4,0,0,0,4,0,0,0,0,2,0,1,1,0,0
2759,797020,19,0,1,0,1,0,0,0,1,0,4,1,5,1,1,1,0
2759,792392,9,2,3,2,3,0,0,0,2,0,0,0,3,0,2,1,4
2759,797021,3,0,0,0,0,0,0,0,0,0,0,0,0,0,0,0,0
2759,791605,9,1,2,1,2,0,0,0,0,0,1,0,1,0,0,0,2
2759,791843,10,0,3,0,3,0,0,2,2,2,3,2,0,0,2,0,2
2760,792329,25,4,6,2,2,2,4,0,0,0,6,2,2,0,1,0,10
2760,786752,22,10,15,8,12,2,3,0,2,1,4,1,3,0,0,0,22
2760,781384,27,3,5,3,5,0,0,2,2,1,2,1,2,0,1,1,8
2760,781616,29,7,13,2,4,5,9,8,9,1,6,3,2,0,1,0,27
2760,776350,26,1,2,1,1,0,1,3,4,0,3,6,2,0,2,0,5
2760,797880,2,1,3,1,3,0,0,0,0,0,1,0,0,0,0,1,2
2760,792330,8,3,4,1,1,2,3,0,0,0,0,0,5,1,2,0,8
2760,785435,4,0,0,0,0,0,0,0,0,0,0,0,0,0,0,0,0
2760,781075,6,3,6,2,5,1,1,0,0,0,2,0,1,0,2,0,7
2760,781615,17,1,1,1,1,0,0,0,0,0,1,1,1,1,1,0,2
2760,792331,3,0,2,0,1,0,1,1,2,2,0,0,1,0,2,0,1
2760,792601,8,0,1,0,0,0,1,0,0,0,1,1,2,0,1,0,0
2760,786749,23,0,1,0,1,0,0,0,0,0,3,6,3,0,1,2,0
2761,785845,29,2,7,2,7,0,0,0,0,2,4,2,2,0,4,0,4
2761,780578,22,4,7,2,4,2,3,2,4,0,2,0,2,0,0,0,12
2761,785293,22,2,5,2,4,0,1,1,2,0,1,1,4,1,0,0,5
2761,785847,28,1,5,0,0,1,5,5,5,2,2,3,0,1,1,0,8
2761,780579,39,7,18,4,9,3,9,7,8,2,10,1,3,5,2,0,24
2761,797536,17,3,7,3,6,0,1,5,7,2,0,0,3,0,1,0,11
2761,791712,1,0,0,0,0,0,0,2,2,0,0,0,0,0,0,0,2
2761,785843,7,1,2,1,1,0,1,0,0,1,2,0,1,0,1,2,2
2761,797537,8,0,1,0,1,0,0,0,0,2,0,1,3,0,0,0,0
2761,797538,27,2,9,2,4,0,5,6,8,0,2,2,2,1,1,0,10
2762,792306,27,4,6,4,5,0,1,0,3,0,7,1,0,0,2,0,8
2762,797904,8,0,1,0,0,0,1,0,0,1,2,2,2,0,2,0,0
2762,792303,32,11,18,6,9,5,9,3,5,0,1,4,2,2,4,1,30
2762,790813,18,0,3,0,1,0,2,0,0,0,1,4,2,2,0,0,0
2762,780456,22,4,6,2,2,2,4,0,0,0,4,1,3,0,1,1,10
2762,792300,19,4,5,2,2,2,3,1,2,1,1,4,2,2,2,0,11
2762,797914,20,2,3,1,1,1,2,0,0,1,3,2,2,1,2,0,5
2762,797912,19,4,7,0,1,4,6,4,5,1,4,0,0,0,2,0,16
2762,786618,15,1,3,1,3,0,0,1,3,5,1,2,1,0,1,2,3
2762,781603,16,2,4,2,2,0,2,0,0,0,2,1,0,0,0,1,4
2762,797907,4,0,0,0,0,0,0,0,0,0,0,0,1,0,1,0,0
2763,790951,22,3,4,3,4,0,0,1,1,2,2,1,4,1,2,1,7
2763,775037,9,0,0,0,0,0,0,0,0,0,0,0,0,0,0,0,0
2763,796545,31,4,7,4,7,0,0,0,1,1,2,3,3,1,5,0,8
2763,786309,33,2,11,1,5,1,6,4,4,2,2,0,4,1,3,1,9
2763,786089,20,2,10,2,7,0,3,0,0,1,2,1,1,0,1,0,4
2763,790952,18,2,4,2,3,0,1,1,2,1,1,0,3,1,1,0,5
2763,796540,26,6,13,6,11,0,2,0,0,5,7,0,5,2,0,1,12
2763,781410,29,5,14,3,6,2,8,2,2,0,1,1,0,1,1,0,14
2763,796543,10,0,2,0,1,0,1,0,0,0,0,0,0,1,1,0,0
2763,796544,1,0,0,0,0,0,0,0,0,0,0,1,0,0,1,0,0
2763,798697,1,0,0,0,0,0,0,0,0,0,0,0,0,0,0,0,0
2764,775897,18,4,4,3,3,1,1,0,0,0,3,2,0,0,0,0,9
2764,780324,20,7,9,7,9,0,0,1,1,2,3,3,2,0,2,2,15
2764,784246,17,1,6,1,1,0,5,0,0,2,2,3,3,0,1,0,2
2764,786530,19,2,3,0,0,2,3,0,0,0,3,4,1,1,0,0,6
2764,780317,19,6,9,2,2,4,7,2,3,0,6,4,2,2,1,0,18
2764,791546,11,4,6,2,3,2,3,0,0,1,1,1,2,0,1,0,10
2764,786362,3,0,0,0,0,0,0,0,0,0,1,0,0,0,0,0,0
2764,785932,7,0,0,0,0,0,0,0,0,0,0,1,0,0,1,0,0
2764,797092,12,0,1,0,1,0,0,2,2,0,3,0,2,0,1,0,2
2764,791543,17,2,4,2,2,0,2,2,2,0,0,1,0,2,0,0,6
2764,791544,1,0,0,0,0,0,0,0,0,0,0,0,0,0,0,0,0
2764,797091,14,2,2,2,2,0,0,2,4,0,1,1,1,0,2,0,6
2764,791547,10,2,4,1,3,1,1,0,0,1,2,1,0,0,1,0,5
2764,791545,17,3,5,2,4,1,1,1,1,2,2,0,0,1,1,1,8
2764,786360,12,1,4,0,1,1,3,0,0,0,0,0,0,1,1,0,3
2764,775437,3,0,0,0,0,0,0,0,0,0,0,0,1,0,1,0,0
2765,797103,24,1,7,1,7,0,0,2,4,1,7,1,0,0,1,0,4
2765,791414,21,2,3,1,1,1,2,0,0,0,1,0,1,0,3,0,5
2765,797100,20,2,5,2,5,0,0,0,0,0,2,2,2,0,4,1,4
2765,791413,18,1,4,1,2,0,2,2,3,0,0,1,1,0,2,0,4
2765,785776,28,2,8,1,5,1,3,0,0,0,2,1,1,0,2,0,5
2765,797099,12,0,2,0,2,0,0,0,0,1,0,1,4,0,1,0,0
2765,786403,9,0,2,0,1,0,1,1,2,0,0,1,2,1,0,0,1
2765,797101,3,0,0,0,0,0,0,0,0,0,0,0,0,0,0,0,0
2765,797104,1,0,0,0,0,0,0,0,0,0,0,0,0,0,0,0,0
2765,797105,16,0,0,0,0,0,0,2,4,3,1,2,0,1,0,0,2
2765,791411,26,7,12,4,6,3,6,1,1,0,2,2,3,0,1,0,18
2765,781209,22,7,9,4,4,3,5,0,0,0,1,0,2,2,2,0,17
2766,792068,36,5,14,5,10,0,4,4,7,0,7,4,3,2,1,0,14
2766,784640,18,2,4,2,3,0,1,3,4,1,3,0,1,0,0,0,7
2766,792072,37,2,3,2,2,0,1,3,3,0,3,1,3,1,1,0,7
2766,792069,30,5,12,4,9,1,3,8,10,0,3,1,5,1,5,0,19
2766,785572,15,1,5,1,3,0,2,0,0,0,4,1,2,1,1,0,2
2766,797655,18,2,3,2,3,0,0,1,1,2,2,1,0,0,0,1,5
2766,797657,19,1,4,0,2,1,2,0,0,0,2,0,2,0,0,0,3
2766,797652,27,2,3,2,3,0,0,2,4,1,2,0,2,0,1,0,6
2767,781249,31,1,6,0,0,1,6,0,0,0,4,2,4,0,1,1,3
2767,775165,28,2,3,0,0,2,3,0,1,0,8,2,3,1,0,0,6
2767,785514,32,5,12,3,5,2,7,2,3,0,3,2,4,3,3,2,14
2767,785515,26,4,7,2,5,2,2,1,4,3,2,3,3,1,0,0,11
2767,781253,31,3,12,1,5,2,7,4,4,1,2,2,0,0,1,0,12
2767,796953,9,1,2,1,2,0,0,0,0,0,1,0,1,0,2,0,2
2767,796951,5,0,0,0,0,0,0,0,0,1,0,0,1,0,0,0,0
2767,796952,7,1,1,1,1,0,0,0,0,1,0,0,1,0,0,0,2
2767,791252,15,0,0,0,0,0,0,0,0,0,2,1,1,0,1,1,0
2767,791687,16,2,6,1,2,1,4,2,2,0,1,1,5,0,3,1,7
2768,786199,34,9,11,5,6,4,5,5,6,0,10,5,0,5,3,0,27
2768,780521,31,4,8,0,1,4,7,1,2,1,3,1,3,0,5,0,13
2768,775163,20,6,6,6,6,0,0,0,1,0,3,3,2,0,3,0,12
2768,780991,30,2,6,1,5,1,1,0,0,0,1,8,3,1,2,0,5
2768,791370,25,1,3,1,2,0,1,1,2,1,3,0,4,0,6,0,3
2768,797271,18,5,7,3,4,2,3,0,0,1,1,1,0,1,1,1,12
2768,781611,18,4,5,4,5,0,0,1,1,2,1,0,2,0,0,0,9
2768,743593,8,2,3,2,3,0,0,0,1,0,0,0,0,0,0,0,4
2768,791371,15,1,2,1,2,0,0,0,0,0,2,3,0,0,1,0,2
2768,797269,1,0,2,0,2,0,0,0,0,2,0,0,0,0,0,0,0
2769,791827,33,9,16,9,16,0,0,5,7,4,4,1,2,1,4,0,23
2769,780625,35,5,10,1,2,4,8,2,3,0,2,5,1,1,0,0,16
2769,785481,17,5,7,4,5,1,2,1,2,1,2,2,0,1,1,1,12
2769,797391,20,3,7,1,1,2,6,0,0,0,0,1,2,0,1,0,8
2769,786625,34,2,9,2,5,0,4,0,0,1,2,8,3,0,2,0,4
2769,786630,26,4,6,4,5,0,1,1,3,4,3,0,2,0,1,1,9
2769,797395,12,3,6,1,3,2,3,0,0,0,0,1,0,1,3,0,8
2769,797394,19,1,3,1,2,0,1,0,0,1,1,0,4,1,0,0,2
2769,797397,4,0,0,0,0,0,0,0,0,0,0,0,1,0,2,0,0
2770,786034,36,3,7,0,0,3,7,0,0,0,4,2,2,0,1,0,9
2770,781283,33,2,7,1,3,1,4,1,2,0,1,4,4,4,2,0,6
2770,786419,30,3,7,2,6,1,1,1,3,0,6,4,0,0,2,0,8
2770,781652,32,6,9,2,5,4,4,4,6,4,5,2,2,1,0,0,20
2770,781653,22,2,8,2,8,0,0,0,0,1,5,2,0,1,2,0,4
2770,791615,23,7,13,5,9,2,4,2,2,2,3,2,4,1,2,1,18
2770,791614,8,1,2,0,0,1,2,0,0,0,1,0,0,1,0,0,3
2770,781158,12,2,5,2,5,0,0,2,4,2,0,0,1,1,0,0,6
2770,796993,4,0,1,0,0,0,1,0,0,0,0,0,2,0,0,0,0
2771,796631,17,1,7,0,2,1,5,0,0,0,4,0,2,1,2,0,3
2771,790996,33,6,11,2,6,4,5,1,2,1,2,2,2,0,2,0,17
2771,796632,6,1,4,1,3,0,1,0,0,0,1,0,1,0,1,0,2
2771,790998,39,5,11,3,6,2,5,2,4,3,9,2,3,0,4,1,14
2771,786375,18,1,2,1,2,0,0,1,2,1,3,1,2,0,1,2,3
2771,790995,10,0,2,0,1,0,1,1,2,0,0,2,1,1,1,0,1
2771,781520,21,2,5,0,2,2,3,2,2,2,3,1,1,1,1,0,8
2771,790997,20,1,2,0,0,1,2,0,0,0,3,0,0,1,0,0,3
2771,796633,8,0,0,0,0,0,0,0,0,0,0,0,1,0,1,0,0
2771,785621,28,5,9,3,6,2,3,4,4,0,3,1,2,0,0,0,16
2772,791391,34,6,10,6,10,0,0,1,2,0,4,0,1,1,2,1,13
2772,797156,22,0,5,0,3,0,2,2,2,0,0,1,3,0,2,0,2
2772,780130,31,3,7,2,3,1,4,3,3,0,1,0,2,0,0,1,10
2772,791390,34,3,10,3,8,0,2,3,5,3,9,3,1,1,3,2,9
2772,780133,31,4,9,0,1,4,8,1,2,0,3,1,3,0,0,0,13
2772,776446,17,3,5,1,1,2,4,2,2,0,1,0,0,0,3,0,10
2772,791388,7,0,0,0,0,0,0,0,0,0,1,1,1,0,0,0,0
2772,797158,5,0,0,0,0,0,0,2,2,0,1,0,0,0,0,0,2
2772,775743,17,0,3,0,2,0,1,4,4,0,0,1,1,1,2,0,4
2772,791389,2,0,0,0,0,0,0,0,0,0,1,0,1,0,0,0,0
2772,797157,0,0,0,0,0,0,0,0,0,0,0,0,0,0,0,0,0
2773,785630,32,8,12,3,5,5,7,1,2,1,1,0,2,0,1,0,22
2773,780777,25,4,7,4,6,0,1,2,2,1,2,7,4,0,3,0,10
2773,785631,29,4,8,2,2,2,6,0,1,0,3,2,3,0,3,0,10
2773,785863,25,8,15,8,15,0,0,0,0,0,5,0,3,1,1,0,16
2773,786248,27,3,6,3,6,0,0,0,0,1,7,2,3,0,1,0,6
2773,791200,15,4,5,3,4,1,1,0,0,0,1,4,1,1,0,0,9
2773,791196,2,0,0,0,0,0,0,0,0,0,0,0,0,0,0,0,0
2773,791199,3,0,1,0,1,0,0,0,0,0,0,0,0,0,0,0,0
2773,791198,9,1,2,0,0,1,2,0,0,0,0,1,0,0,0,0,3
2773,791197,10,1,2,1,2,0,0,0,0,0,2,0,0,1,2,0,2
2773,785632,23,0,3,0,2,0,1,3,4,2,4,0,3,1,0,0,3
2774,780494,16,3,5,2,3,1,2,0,0,0,0,2,2,0,2,0,7
2774,780495,25,8,12,7,9,1,3,4,6,1,4,2,0,0,4,1,21
2774,780496,24,3,8,2,2,1,6,0,0,0,4,0,1,1,0,0,7
2774,785693,19,4,6,4,6,0,0,2,2,2,2,0,3,0,0,0,10
2774,785692,20,1,3,1,2,0,1,0,0,0,2,4,4,0,2,0,2
2774,797274,11,4,5,4,5,0,0,0,0,1,0,1,0,0,0,0,8
2774,791643,13,2,3,2,2,0,1,3,4,1,0,1,2,1,1,0,7
2774,785644,16,3,9,2,5,1,4,0,0,0,3,2,2,0,0,0,7
2774,780497,22,3,4,3,4,0,0,2,2,0,7,0,1,1,1,1,8
2774,797275,7,0,0,0,0,0,0,0,0,0,2,0,0,0,0,0,0
2774,797276,13,1,2,1,2,0,0,0,0,0,2,3,2,0,4,0,2
2774,797277,9,1,3,0,1,1,2,2,2,0,1,0,2,0,0,1,5
2774,799889,2,0,0,0,0,0,0,0,0,0,0,0,0,0,0,0,0
2774,791645,3,0,1,0,1,0,0,0,0,0,2,0,1,0,1,0,0
2775,791065,10,0,1,0,0,0,1,0,0,0,1,0,0,1,1,0,0
2775,796743,32,2,9,1,2,1,7,4,4,1,1,2,0,0,1,0,9
2775,785551,21,3,9,1,4,2,5,0,0,0,1,3,3,1,2,0,8
2775,780751,13,2,5,2,3,0,2,1,2,1,1,0,4,0,0,2,5
2775,791067,14,0,0,0,0,0,0,1,2,1,2,1,3,1,2,0,1
2775,780512,25,2,5,2,3,0,2,2,4,2,3,2,0,0,1,0,6
2775,796744,6,1,2,1,1,0,1,0,0,0,2,0,1,0,1,0,2
2775,791068,15,3,8,1,4,2,4,1,4,1,4,0,2,1,0,1,9
2775,796745,8,1,2,1,2,0,0,0,1,2,0,2,1,1,2,0,2
2775,791066,27,5,17,3,9,2,8,0,1,0,3,1,0,2,1,0,12
2775,780756,18,3,6,2,4,1,2,3,3,0,2,0,1,0,2,0,10
2775,785642,5,0,0,0,0,0,0,2,2,2,2,0,2,0,1,0,2
2775,796746,6,0,1,0,1,0,0,0,0,0,0,1,2,0,0,0,0
2776,781332,32,7,9,5,5,2,4,6,8,0,2,3,0,2,3,0,22
2776,791960,36,4,12,2,6,2,6,3,3,0,3,6,0,2,4,0,13
2776,776174,27,6,11,6,11,0,0,3,5,1,8,1,5,2,1,0,15
2776,791958,37,6,9,6,9,0,0,7,8,3,5,3,2,2,0,0,19
2776,785861,33,3,9,1,4,2,5,3,4,1,1,1,3,0,2,0,11
2776,786059,19,4,7,4,7,0,0,2,2,3,3,0,2,0,1,2,10
2776,781334,1,0,1,0,1,0,0,0,0,0,0,0,0,0,0,0,0
2776,797704,15,0,1,0,0,0,1,0,0,0,1,1,0,1,0,0,0
2777,791320,37,14,24,13,21,1,3,6,7,0,4,1,3,0,1,0,35
2777,796651,28,3,6,2,2,1,4,0,0,1,4,1,2,1,0,0,7
2777,781511,24,4,7,2,4,2,3,0,0,0,2,1,1,1,4,0,10
2777,796657,26,2,5,2,3,0,2,1,2,2,4,1,4,1,2,2,5
2777,791323,28,2,7,2,4,0,3,0,0,1,2,5,3,0,2,0,4
2777,796653,7,1,4,0,1,1,3,0,0,0,1,1,3,0,1,0,3
2777,796656,11,3,4,3,4,0,0,1,2,2,2,0,1,0,2,0,7
2777,796654,4,0,0,0,0,0,0,0,0,0,0,1,0,0,0,0,0
2777,796650,12,2,6,2,5,0,1,0,0,4,1,0,3,0,3,1,4
2777,791321,18,0,1,0,1,0,0,0,0,0,1,1,1,0,0,0,0
2777,792257,5,1,3,1,3,0,0,0,0,2,1,0,0,0,1,0,2
2778,791352,14,3,4,3,4,0,0,0,0,0,1,1,0,1,1,0,6
2778,780455,11,2,5,2,5,0,0,2,2,1,3,1,0,0,1,0,6
2778,797251,11,3,5,1,1,2,4,0,2,0,2,1,0,1,2,1,8
2778,797247,16,4,5,3,4,1,1,1,1,0,3,4,0,0,1,0,10
2778,776297,20,7,10,0,0,7,10,0,0,0,4,4,0,1,1,0,21
2778,797252,13,1,4,0,1,1,3,0,0,0,0,0,2,0,1,0,3
2778,791355,17,2,5,2,2,0,3,2,2,2,4,0,0,0,0,0,6
2778,791354,19,2,2,2,2,0,0,0,2,3,5,2,0,1,0,2,4
2778,785837,18,4,9,2,7,2,2,3,5,3,1,2,0,1,1,0,13
2778,786227,6,1,2,1,2,0,0,0,0,2,0,0,1,0,0,0,2
2778,797255,17,2,3,2,3,0,0,1,2,1,1,3,0,1,2,0,5
2778,797249,20,6,7,5,5,1,2,2,3,0,2,3,0,0,0,1,15
2778,797248,18,2,7,1,3,1,4,0,0,1,0,3,1,1,0,0,5
2780,792414,28,7,12,4,6,3,6,2,3,3,0,3,1,2,2,0,19
2780,786787,37,6,13,2,5,4,8,2,2,0,2,3,3,0,3,0,18
2780,789020,39,6,13,5,7,1,6,1,2,2,5,4,2,3,2,0,14
2780,774954,12,3,4,3,4,0,0,0,1,1,1,2,0,0,1,0,6
2780,781497,21,1,2,1,2,0,0,0,0,1,2,0,2,1,0,0,2
2780,786792,12,3,3,3,3,0,0,1,2,1,2,0,2,1,1,1,7
2780,781456,23,2,4,1,2,1,2,1,3,1,4,3,2,1,2,0,6
2780,792091,17,3,6,3,4,0,2,0,0,0,4,3,2,0,1,0,6
2780,786795,11,1,2,1,2,0,0,0,0,1,2,0,0,0,0,1,2
2781,797532,36,9,12,6,8,3,4,2,2,0,3,7,3,3,4,0,23
2781,785688,31,6,14,1,1,5,13,1,2,0,0,1,1,0,1,0,18
2781,797527,23,2,3,2,3,0,0,3,3,2,3,2,2,0,2,0,7
2781,791936,37,3,6,3,6,0,0,0,0,1,6,2,2,2,3,0,6
2781,797529,20,2,6,2,5,0,1,0,0,0,2,1,1,1,0,4,4
2781,785988,32,6,11,2,2,4,9,3,3,2,4,2,3,0,2,0,19
2781,791932,18,2,6,0,2,2,4,0,0,1,1,2,3,1,0,0,6
2781,791931,3,0,1,0,1,0,0,0,0,0,0,0,0,0,0,0,0
2781,797530,0,0,0,0,0,0,0,0,0,0,0,0,0,0,0,0,0
2782,781103,25,3,7,3,6,0,1,1,4,2,6,3,2,0,3,1,7
2782,797568,25,1,10,0,5,1,5,4,4,2,1,4,0,2,2,0,7
2782,797566,24,1,7,1,4,0,3,2,2,1,2,0,1,1,1,1,4
2782,781191,34,8,16,6,11,2,5,0,0,1,2,0,1,0,1,1,18
2782,781102,26,2,5,2,5,0,0,1,2,1,2,1,3,2,2,1,5
2782,797570,1,0,0,0,0,0,0,0,0,0,0,0,0,0,0,0,0
2782,791909,1,0,1,0,1,0,0,0,0,0,0,0,0,0,0,0,0
2782,791907,4,0,2,0,2,0,0,0,0,0,1,0,0,0,0,0,0
2782,791905,18,2,6,2,4,0,2,0,0,1,4,0,0,1,0,0,4
2782,791904,12,3,7,3,6,0,1,2,2,1,0,0,2,0,0,0,8
2782,781364,12,1,1,1,1,0,0,1,2,2,2,1,2,0,0,1,3
2782,791906,18,1,5,0,2,1,3,0,0,0,1,1,1,0,1,0,3
2783,790870,29,8,16,8,16,0,0,0,0,5,4,3,2,2,1,7,16
2783,790869,22,12,15,10,12,2,3,0,0,0,5,4,3,0,1,1,26
2783,780493,34,4,6,1,1,3,5,0,0,0,4,0,2,0,0,0,11
2783,780116,20,2,5,0,2,2,3,0,0,0,7,0,0,0,1,0,6
2783,790866,36,4,9,1,1,3,8,2,2,0,4,1,2,2,4,0,13
2783,796426,1,0,0,0,0,0,0,0,0,0,0,0,2,0,0,0,0
2783,785878,7,0,2,0,2,0,0,0,0,0,2,1,0,0,0,1,0
2783,780492,3,0,0,0,0,0,0,0,0,0,0,0,1,0,0,0,0
2783,796427,30,2,8,1,2,1,6,0,0,2,4,3,2,2,1,0,5
2783,796421,18,1,3,1,3,0,0,0,0,0,2,3,1,0,6,0,2
2784,781046,20,4,6,3,5,1,1,1,1,4,3,1,1,1,0,0,10
2784,780025,43,6,14,6,14,0,0,6,8,4,10,0,3,1,2,0,18
2784,786228,36,2,8,2,5,0,3,2,6,0,4,4,1,3,3,0,6
2784,785385,40,6,13,2,3,4,10,6,7,1,4,2,2,3,0,0,22
2784,785383,49,8,17,7,13,1,4,7,8,0,5,6,2,1,2,2,24
2784,796391,6,1,2,1,2,0,0,0,0,0,0,0,0,1,1,0,2
2784,786297,7,1,1,1,1,0,0,0,0,0,1,0,4,0,2,0,2
2784,790837,33,2,8,2,6,0,2,0,0,3,1,4,1,1,0,0,4
2784,785384,16,3,9,3,6,0,3,1,1,0,3,0,1,0,1,0,7
2785,791193,19,1,1,1,1,0,0,1,2,0,5,0,4,0,1,1,3
2785,791191,18,4,7,4,6,0,1,1,2,1,1,2,1,0,0,0,9
2785,786738,41,5,16,4,12,1,4,2,2,2,2,5,3,1,2,0,13
2785,775694,14,0,4,0,2,0,2,0,0,0,2,1,1,0,1,0,0
2785,774827,46,7,20,4,11,3,9,2,2,2,3,8,3,1,6,0,19
2785,791194,34,8,10,3,4,5,6,0,0,1,6,1,3,2,3,0,21
2785,780384,28,5,8,5,8,0,0,0,0,1,3,0,5,2,2,2,10
2785,796863,25,4,5,3,4,1,1,0,0,0,1,1,0,0,0,0,9
2785,796865,4,0,1,0,0,0,1,0,0,0,0,0,1,0,0,0,0
2785,780159,21,3,4,3,4,0,0,0,0,0,8,0,1,0,1,0,6
2786,786296,20,3,6,3,6,0,0,3,4,0,1,0,0,2,1,0,9
2786,781530,29,5,13,4,11,1,2,0,0,0,8,2,4,1,3,0,11
2786,776423,21,6,8,6,8,0,0,2,2,4,8,1,4,1,2,0,14
2786,798096,20,4,5,3,4,1,1,0,0,0,1,0,3,0,2,0,9
2786,792319,22,2,3,2,3,0,0,4,4,0,0,4,1,2,1,0,8
2786,792314,17,3,6,3,6,0,0,1,2,1,2,0,2,0,1,0,7
2786,792320,10,1,1,1,1,0,0,0,0,0,0,0,1,0,0,1,2
2786,798106,17,2,3,2,3,0,0,0,0,0,4,1,0,0,2,0,4
2786,798104,10,1,5,1,3,0,2,0,0,0,0,0,2,0,0,0,2
2786,792307,19,1,3,1,3,0,0,0,0,1,2,2,2,1,1,0,2
2786,792309,13,3,4,2,2,1,2,0,1,0,1,4,1,0,1,0,7
2786,792321,2,0,1,0,1,0,0,0,0,0,0,0,0,0,0,0,0
2787,786704,25,2,5,2,2,0,3,3,4,2,6,0,0,0,0,1,7
2787,785395,27,2,8,1,2,1,6,1,2,0,4,1,1,0,1,0,6
2787,775840,27,0,4,0,0,0,4,3,4,2,3,4,4,2,3,0,3
2787,775955,30,4,10,3,6,1,4,0,0,1,0,2,2,1,0,0,9
2787,775811,15,2,3,2,3,0,0,0,0,0,2,0,3,0,0,0,4
2787,786706,16,0,1,0,1,0,0,3,6,1,1,0,1,0,0,0,3
2787,786703,3,0,1,0,0,0,1,2,3,0,0,0,0,0,0,0,2
2787,775287,10,0,1,0,0,0,1,0,1,0,0,0,1,0,0,0,0
2787,786702,3,0,1,0,1,0,0,1,2,1,0,0,0,0,1,0,1
2787,790921,16,2,8,2,6,0,2,2,2,0,0,0,1,3,1,0,6
2787,786551,28,6,14,5,10,1,4,2,2,0,5,0,1,1,3,0,15
2790,785836,39,7,10,4,6,3,4,2,3,5,8,1,4,1,2,0,19
2790,785833,20,0,3,0,1,0,2,6,6,0,6,2,4,0,3,0,6
2790,775872,26,1,2,1,1,0,1,0,0,1,3,1,3,0,1,0,2
2790,791707,22,1,7,1,4,0,3,0,0,0,0,0,2,1,2,0,2
2790,785838,22,0,8,0,5,0,3,0,1,0,3,2,4,1,0,0,0
2790,785332,24,4,11,4,10,0,1,0,0,3,6,0,3,0,1,1,8
2790,791704,28,4,8,3,6,1,2,0,3,0,2,3,3,1,3,0,9
2790,785892,19,2,6,1,5,1,1,2,4,1,1,1,2,1,1,0,7
2791,796870,17,0,1,0,1,0,0,2,4,2,4,0,1,0,0,0,2
2791,786861,28,2,8,0,2,2,6,2,2,1,1,1,0,0,1,0,8
2791,792415,31,1,5,1,3,0,2,6,8,1,5,0,3,2,5,0,8
2791,780387,33,3,6,1,3,2,3,8,8,0,5,1,3,0,4,2,16
2791,767033,36,1,8,1,4,0,4,1,2,0,3,3,2,1,2,0,3
2791,792417,21,3,8,3,7,0,1,3,7,1,6,1,5,0,0,0,9
2791,792416,6,0,3,0,3,0,0,2,2,2,0,1,2,0,0,0,2
2791,786867,24,1,5,0,1,1,4,0,0,0,2,0,0,2,0,0,3
2791,786866,4,0,0,0,0,0,0,0,0,0,0,0,2,0,1,0,0
2792,792329,38,2,5,1,3,1,2,0,0,2,5,1,1,0,0,0,5
2792,786752,32,11,14,10,12,1,2,4,4,1,3,2,4,1,2,0,27
2792,781384,38,1,5,1,4,0,1,0,1,1,3,1,1,3,1,0,2
2792,781616,41,4,11,3,6,1,5,2,4,0,1,3,1,1,4,0,11
2792,776350,42,5,9,5,6,0,3,6,6,1,5,6,3,0,2,0,16
2792,792330,14,4,9,3,3,1,6,0,0,0,1,2,1,0,0,0,9
2792,785435,2,0,2,0,2,0,0,0,0,1,0,0,0,0,0,1,0
2792,781075,8,2,3,1,2,1,1,0,0,0,0,0,1,0,0,0,5
2792,781615,15,1,1,1,1,0,0,0,0,0,4,0,3,0,0,1,2
2792,792601,11,0,1,0,0,0,1,1,2,1,1,3,0,0,1,0,1
2792,786749,9,1,6,1,6,0,0,0,0,1,2,1,0,0,0,1,2
2793,785845,48,8,10,8,10,0,0,4,6,1,11,0,1,4,3,1,20
2793,780578,46,6,15,5,12,1,3,1,1,2,2,1,2,0,2,0,14
2793,785293,31,0,3,0,2,0,1,1,2,1,5,3,5,1,4,0,1
2793,785847,20,1,4,1,1,0,3,0,0,0,1,0,4,0,0,0,2
2793,780579,50,7,15,5,9,2,6,0,0,0,4,3,4,1,0,0,16
2793,785843,6,0,1,0,1,0,0,0,0,0,0,0,0,0,0,0,0
2793,797537,9,1,2,1,2,0,0,0,0,0,2,0,0,0,1,0,2
2793,797538,40,11,16,8,11,3,5,1,1,1,2,2,3,1,2,1,26
2794,792078,26,0,4,0,4,0,0,1,2,3,7,0,2,1,0,0,1
2794,786067,24,4,9,4,9,0,0,1,2,3,5,1,2,0,0,0,9
2794,797661,25,4,9,4,7,0,2,0,0,0,0,2,0,2,3,0,8
2794,785591,26,2,7,1,5,1,2,6,6,0,1,6,1,1,1,0,11
2794,780258,22,8,13,3,5,5,8,0,0,0,4,2,2,1,0,0,21
2794,797662,15,3,5,2,2,1,3,0,0,0,1,0,2,0,2,0,7
2794,792082,19,5,10,4,6,1,4,0,1,1,4,2,1,0,2,0,11
2794,791952,11,0,0,0,0,0,0,0,0,0,4,0,4,0,2,1,0
2794,797664,2,0,1,0,0,0,1,0,0,0,1,0,1,0,1,0,0
2794,797663,2,0,0,0,0,0,0,0,0,1,0,0,0,0,0,0,0
2794,792083,17,2,5,2,3,0,2,0,0,0,1,2,0,0,1,0,4
2794,792079,7,1,1,1,1,0,0,0,0,0,0,0,0,0,1,0,2
2794,774898,4,0,1,0,0,0,1,0,0,0,0,0,0,0,0,0,0
2796,791391,34,1,6,1,6,0,0,0,0,1,7,0,1,1,4,1,2
2796,797156,20,0,3,0,2,0,1,0,0,1,1,1,5,0,5,0,0
2796,791390,19,8,11,8,11,0,0,4,5,2,1,0,5,1,2,0,20
2796,780133,25,7,9,3,4,4,5,0,0,0,4,0,4,0,2,0,18
2796,780130,37,2,3,1,2,1,1,6,7,0,2,2,3,3,2,2,11
2796,797158,4,0,0,0,0,0,0,0,0,0,1,0,0,0,1,0,0
2796,791388,18,2,3,2,3,0,0,0,0,0,2,2,3,0,0,1,4
2796,775743,19,2,8,2,7,0,1,0,0,1,2,2,1,0,1,0,4
2796,776446,24,3,7,2,4,1,3,0,0,0,0,1,2,0,0,0,7
2797,785863,28,3,8,3,8,0,0,6,8,0,3,1,4,0,0,0,12
2797,785631,19,2,6,2,4,0,2,0,0,1,3,0,0,1,0,0,4
2797,786248,26,5,6,5,6,0,0,0,0,3,5,0,3,1,1,0,10
2797,785630,32,1,6,0,3,1,3,2,2,1,0,1,2,0,3,0,5
2797,780777,34,9,12,8,8,1,4,2,4,1,3,6,4,1,3,0,21
2797,791199,5,1,1,1,1,0,0,0,0,0,0,0,0,1,0,0,2
2797,791197,8,0,0,0,0,0,0,0,0,0,1,1,2,1,0,0,0
2797,791198,5,0,0,0,0,0,0,2,2,0,1,0,0,0,0,0,2
2797,791200,24,3,9,1,4,2,5,5,8,0,1,1,1,1,2,0,13
2797,785632,19,1,5,1,3,0,2,2,4,2,2,1,2,2,0,0,4
2798,775897,24,3,3,2,2,1,1,1,1,0,3,2,3,1,2,0,8
2798,780324,28,11,15,11,15,0,0,0,0,4,5,7,0,1,0,1,22
2798,784246,29,5,9,4,6,1,3,5,6,0,5,4,0,0,2,0,16
2798,786530,31,2,7,1,3,1,4,0,0,0,2,1,3,1,1,0,5
2798,780317,27,2,4,0,1,2,3,0,0,0,3,5,0,0,1,0,6
2798,791546,12,3,5,3,5,0,0,0,0,0,0,0,0,1,0,1,6
2798,797092,2,2,2,2,2,0,0,0,0,1,0,0,0,0,0,0,4
2798,791543,18,1,4,0,1,1,3,2,2,0,0,1,1,0,0,0,5
2798,797091,2,0,0,0,0,0,0,0,0,0,1,1,0,0,0,0,0
2798,791547,3,0,1,0,0,0,1,3,3,0,0,0,1,0,0,0,3
2798,791545,18,3,5,1,2,2,3,3,4,2,4,2,0,1,1,0,11
2798,786360,6,0,1,0,0,0,1,0,0,0,1,1,0,0,1,0,0
2799,797099,9,0,0,0,0,0,0,0,0,0,1,0,2,1,1,1,0
2799,791414,16,2,3,2,2,0,1,0,0,1,3,1,1,1,1,0,4
2799,797100,24,3,5,3,4,0,1,1,1,2,2,3,4,0,2,1,7
2799,791411,32,6,17,3,10,3,7,0,0,0,6,3,3,0,4,0,15
2799,785776,32,8,15,3,8,5,7,0,0,0,0,3,1,0,2,0,21
2799,797102,12,0,1,0,0,0,1,0,0,1,0,0,1,0,1,1,0
2799,797103,22,2,4,2,4,0,0,0,0,1,4,0,2,1,2,0,4
2799,797105,11,0,2,0,0,0,2,0,0,2,1,3,0,0,1,0,0
2799,791413,25,0,3,0,2,0,1,2,2,0,1,0,1,0,1,0,2
2799,781209,15,1,5,1,2,0,3,0,0,0,0,0,1,0,1,0,2
2799,797101,2,0,0,0,0,0,0,0,0,0,0,0,0,0,0,0,0
2800,776004,22,2,8,2,6,0,2,0,0,2,3,1,0,1,0,1,4
2800,780358,25,4,10,4,8,0,2,0,0,1,5,0,1,0,0,0,8
2800,775011,32,4,8,2,3,2,5,0,0,2,4,0,3,0,0,0,10
2800,780357,34,2,8,1,5,1,3,0,2,0,3,4,4,0,1,0,5
2800,775018,34,8,14,5,8,3,6,6,7,0,4,3,2,0,3,0,25
2800,790930,22,0,2,0,2,0,0,2,6,1,0,3,2,2,0,0,2
2800,796480,18,2,3,2,2,0,1,0,0,1,2,0,3,0,1,0,4
2800,776270,13,2,2,0,0,2,2,0,0,0,0,1,0,0,1,0,6
2801,791585,33,5,9,5,8,0,1,2,2,1,3,2,0,0,0,0,12
2801,780062,11,1,3,1,3,0,0,0,1,1,1,0,0,0,0,0,2
2801,786395,34,5,11,3,6,2,5,5,5,0,4,2,3,1,2,0,17
2801,786394,34,6,13,6,9,0,4,3,3,2,7,1,2,2,1,1,15
2801,780404,36,3,6,2,4,1,2,1,2,0,5,2,2,0,3,3,8
2801,785228,15,3,4,1,2,2,2,1,2,0,4,1,4,0,2,0,9
2801,791582,3,1,1,1,1,0,0,0,0,0,1,0,2,0,0,1,2
2801,791581,24,2,3,1,1,1,2,0,0,0,2,2,2,0,0,0,5
2801,797041,8,0,2,0,1,0,1,0,0,0,0,1,1,0,0,0,0
2801,780403,2,0,0,0,0,0,0,0,0,0,0,0,1,0,1,0,0
2802,791147,13,1,4,1,3,0,1,1,2,0,1,0,3,0,2,0,3
2802,785782,30,1,1,0,0,1,1,5,5,1,3,0,2,3,0,0,8
2802,791145,31,7,14,4,8,3,6,2,3,1,12,1,3,1,3,1,19
2802,791146,35,4,8,1,4,3,4,5,5,1,3,9,3,2,4,0,16
2802,785777,31,5,13,2,3,3,10,1,2,1,0,3,2,2,2,0,14
2802,791144,16,3,5,3,3,0,2,0,2,2,3,3,5,0,0,2,6
2802,796804,16,2,2,1,1,1,1,1,2,0,2,0,0,0,1,0,6
2802,791148,22,1,3,0,0,1,3,0,0,0,0,1,0,0,0,0,3
2802,786748,6,0,0,0,0,0,0,0,0,0,0,0,2,0,1,0,0
2802,796803,0,0,0,0,0,0,0,0,0,0,0,0,0,0,0,0,0
2802,798159,0,0,0,0,0,0,0,0,0,0,0,0,0,0,0,0,0
2803,791281,34,5,8,5,7,0,1,4,9,2,8,1,2,2,4,0,14
2803,785764,18,1,2,1,2,0,0,0,1,2,1,2,3,0,3,0,2
2803,791278,32,1,3,0,0,1,3,0,1,4,4,0,4,0,1,0,3
2803,785507,27,1,11,1,3,0,8,1,2,0,1,1,0,1,3,0,3
2803,775814,29,4,6,4,5,0,1,1,2,0,3,0,4,1,3,0,9
2803,796534,3,0,1,0,1,0,0,0,0,0,0,0,0,0,1,0,0
2803,796536,7,1,1,1,1,0,0,0,0,0,1,0,0,0,0,1,2
2803,796537,8,1,1,1,1,0,0,0,0,0,1,0,1,0,1,0,2
2803,796535,3,0,1,0,0,0,1,0,0,0,0,1,0,0,0,0,0
2803,792276,18,4,6,2,3,2,3,0,0,0,2,2,4,0,4,0,10
2803,786026,15,2,8,1,3,1,5,1,2,1,1,0,1,2,2,0,6
2803,785398,5,0,1,0,0,0,1,2,2,0,1,0,0,0,0,0,2
2803,785763,1,0,0,0,0,0,0,0,0,0,0,0,0,0,0,0,0
2804,781103,23,9,12,8,9,1,3,2,7,1,5,1,3,1,2,0,21
2804,797568,35,3,5,0,1,3,4,2,2,0,5,3,0,0,1,0,11
2804,797566,32,4,8,4,5,0,3,7,8,1,5,3,4,2,1,1,15
2804,781191,35,5,10,3,6,2,4,0,1,1,5,4,3,1,1,0,12
2804,781102,9,2,4,2,3,0,1,0,0,0,2,0,3,0,0,0,4
2804,791907,11,1,3,1,3,0,0,1,2,1,0,2,5,0,2,0,3
2804,791905,27,4,10,3,4,1,6,4,4,2,5,1,3,0,0,0,13
2804,791904,6,1,2,1,2,0,0,0,0,0,0,0,2,0,0,0,2
2804,781364,14,1,3,1,3,0,0,0,0,0,3,1,4,0,1,1,2
2804,791906,6,1,2,1,1,0,1,0,1,0,1,1,0,3,1,0,2
2804,797570,1,0,0,0,0,0,0,0,0,0,0,0,0,0,0,0,0
2804,791909,1,0,0,0,0,0,0,0,0,0,0,0,0,0,0,0,0
2805,790870,36,8,12,8,12,0,0,4,8,5,4,2,3,0,3,1,20
2805,790869,38,4,12,3,5,1,7,11,13,1,5,5,3,1,2,0,20
2805,780493,27,0,4,0,1,0,3,0,0,0,3,0,0,0,2,0,0
2805,780116,22,1,3,0,0,1,3,2,2,1,5,0,3,0,0,0,5
2805,790866,33,6,12,1,1,5,11,0,0,0,2,0,4,1,2,0,17
2805,796426,1,0,0,0,0,0,0,0,0,0,1,0,0,0,0,0,0
2805,785878,3,0,0,0,0,0,0,1,2,0,0,0,1,0,0,0,1
2805,796427,12,1,3,0,0,1,3,3,7,0,2,0,5,1,0,0,6
2805,796421,26,1,8,1,5,0,3,4,6,0,2,2,2,0,0,0,6
2805,796424,0,0,0,0,0,0,0,0,0,0,0,0,0,0,0,0,0
2805,783997,0,0,0,0,0,0,0,0,0,0,0,0,0,0,0,0,0
2805,780492,1,0,0,0,0,0,0,0,0,0,0,0,0,0,0,0,0
2805,796428,1,0,0,0,0,0,0,0,0,0,0,0,0,0,0,0,0
2806,796334,25,3,8,3,7,0,1,3,5,2,4,0,3,0,1,1,9
2806,785827,17,4,6,4,6,0,0,2,4,1,1,0,2,0,0,1,10
2806,796332,26,2,3,1,1,1,2,0,0,0,6,2,2,1,2,0,5
2806,785813,36,5,11,0,4,5,7,7,8,0,2,8,2,2,2,0,22
2806,786289,30,4,11,3,7,1,4,5,7,1,1,3,2,0,1,0,14
2806,790776,18,5,7,5,7,0,0,0,0,4,4,0,2,0,1,0,10
2806,796330,12,0,3,0,1,0,2,0,0,0,0,0,2,1,0,0,0
2806,796337,21,4,5,3,4,1,1,3,3,0,1,7,2,0,0,0,12
2806,779975,15,3,3,3,3,0,0,0,0,0,2,0,0,0,1,0,6
2807,775640,19,1,3,1,2,0,1,3,4,1,3,2,2,2,0,2,5
2807,780919,21,5,8,4,6,1,2,7,8,2,0,0,4,0,1,0,18
2807,785803,26,1,3,0,1,1,2,2,2,1,0,2,4,2,0,0,5
2807,780920,33,4,12,4,9,0,3,2,3,2,3,4,2,1,4,0,10
2807,780914,26,3,10,0,5,3,5,0,0,0,4,0,4,0,2,0,9
2807,791142,18,4,6,0,0,4,6,0,0,0,2,1,3,0,2,0,12
2807,796797,14,3,4,1,1,2,3,0,0,1,1,1,1,0,0,0,8
2807,775816,26,3,6,2,3,1,3,0,0,1,7,1,1,0,3,0,7
2807,791141,17,0,3,0,2,0,1,0,0,0,0,3,1,0,1,0,0
2808,785674,28,1,6,1,3,0,3,0,1,0,3,3,1,3,1,1,2
2808,780049,25,5,8,5,7,0,1,1,3,0,1,0,2,0,2,0,11
2808,780527,28,2,5,1,3,1,2,2,4,2,4,1,2,1,0,0,7
2808,797784,32,7,18,4,12,3,6,4,7,2,3,4,1,2,3,0,21
2808,789059,30,4,6,3,3,1,3,1,2,1,3,0,4,1,1,0,10
2808,797782,3,0,2,0,2,0,0,0,0,0,0,0,0,0,0,0,0
2808,797783,13,1,2,1,2,0,0,0,0,1,1,1,4,0,1,0,2
2808,792171,19,3,5,3,5,0,0,3,4,3,2,2,3,1,2,3,9
2808,780980,22,2,2,2,2,0,0,5,7,0,5,1,2,2,1,0,9
2809,791606,23,2,4,2,2,0,2,1,2,0,4,1,5,0,3,0,5
2809,786410,21,1,2,1,2,0,0,0,0,0,0,0,1,0,1,0,2
2809,775095,9,1,1,1,1,0,0,0,0,1,2,0,1,0,0,1,2
2809,786406,34,1,6,0,0,1,6,0,0,2,6,2,3,1,3,0,3
2809,780414,38,6,18,4,10,2,8,15,16,1,2,4,4,2,3,0,29
2809,797020,12,3,4,3,3,0,1,0,0,0,1,0,4,2,2,0,6
2809,792392,27,5,11,5,11,0,0,2,3,4,9,0,2,2,2,0,12
2809,791603,29,2,8,1,4,1,4,0,0,3,2,1,3,1,3,1,5
2809,791843,7,0,1,0,1,0,0,0,0,0,0,0,0,1,0,0,0
2810,781653,31,2,3,2,3,0,0,2,5,1,3,1,4,1,2,1,6
2810,786034,34,4,11,1,4,3,7,0,0,0,2,2,2,3,0,0,11
2810,791615,31,6,10,5,7,1,3,2,2,0,5,2,3,0,2,0,15
2810,786419,28,6,13,6,11,0,2,7,8,0,4,0,1,1,3,0,19
2810,781283,30,2,6,0,3,2,3,1,2,0,0,1,1,1,2,0,7
2810,791614,5,1,1,1,1,0,0,0,0,1,0,0,1,0,0,0,2
2810,785419,3,0,0,0,0,0,0,0,0,0,0,0,1,0,0,0,0
2810,781158,14,2,5,2,5,0,0,0,0,0,2,0,2,2,2,0,4
2810,796993,5,0,1,0,1,0,0,0,0,0,0,1,0,0,0,0,0
2810,785277,19,2,5,1,2,1,3,0,0,0,3,2,0,0,0,0,5
2811,796631,31,6,11,2,4,4,7,4,4,4,6,0,3,1,2,1,20
2811,790998,34,2,10,2,5,0,5,2,2,5,6,5,4,1,2,0,6
2811,790997,35,5,8,1,3,4,5,0,0,2,4,2,1,1,0,0,14
2811,790996,36,8,15,4,7,4,8,2,3,2,4,3,2,0,3,0,22
2811,781520,9,0,0,0,0,0,0,0,0,0,1,1,2,0,1,0,0
2811,796633,8,0,1,0,1,0,0,2,2,2,0,0,2,0,0,0,2
2811,796632,2,0,1,0,0,0,1,0,0,0,1,0,0,0,0,0,0
2811,790995,6,0,1,0,1,0,0,0,0,0,2,0,2,0,1,0,0
2811,786375,4,0,1,0,0,0,1,0,0,0,0,0,1,0,2,1,0
2811,785621,35,4,14,1,5,3,9,0,0,0,2,3,1,1,4,0,11
2812,785693,13,1,1,1,1,0,0,2,6,2,1,0,1,1,1,0,4
2812,780494,19,4,7,3,5,1,2,0,0,1,4,1,2,0,1,2,9
2812,785692,15,1,2,1,2,0,0,0,0,0,2,5,3,0,0,0,2
2812,780496,17,3,8,1,3,2,5,0,0,0,2,1,2,3,0,0,8
2812,780495,17,6,10,2,6,4,4,0,0,1,5,2,2,2,3,1,16
2812,797277,17,5,6,5,5,0,1,0,1,2,4,2,4,0,2,1,10
2812,797274,10,2,4,2,4,0,0,0,0,0,5,0,0,0,0,0,4
2812,797276,25,3,4,2,3,1,1,0,0,0,2,4,1,1,2,0,7
2812,797275,14,1,1,0,0,1,1,0,0,0,1,2,0,0,1,0,3
2812,791643,17,2,4,1,2,1,2,2,2,0,2,1,2,0,2,0,7
2812,785644,18,4,10,2,5,2,5,6,6,0,2,1,1,1,1,0,16
2812,780497,8,5,5,4,4,1,1,0,1,0,0,0,0,0,0,0,11
2812,799889,2,0,0,0,0,0,0,0,0,0,0,0,0,0,0,0,0
2812,791645,8,0,1,0,1,0,0,0,0,0,0,0,4,0,0,0,0
2813,791067,13,1,1,1,1,0,0,1,1,2,5,2,1,0,2,1,3
2813,780751,13,0,1,0,1,0,0,0,2,0,3,2,2,0,3,0,0
2813,796743,25,2,6,1,2,1,4,2,2,0,3,3,3,0,3,0,7
2813,791068,17,1,4,1,3,0,1,2,4,2,1,0,0,1,3,0,4
2813,785551,10,1,2,1,1,0,1,0,1,0,0,0,3,1,0,0,2
2813,785642,15,2,5,2,4,0,1,0,0,0,1,0,1,0,1,0,4
2813,780512,15,2,6,2,4,0,2,6,8,2,5,1,4,0,1,1,10
2813,780756,2,0,0,0,0,0,0,0,0,0,0,0,1,0,1,0,0
2813,796745,18,0,3,0,1,0,2,0,0,1,1,5,0,2,1,0,0
2813,796744,18,4,10,2,4,2,6,0,0,0,1,2,3,1,0,1,10
2813,791066,23,4,15,2,5,2,10,0,0,0,2,1,0,0,1,0,10
2813,791065,16,1,2,0,0,1,2,6,6,0,0,0,1,1,1,0,9
2813,796746,15,4,6,4,5,0,1,2,2,3,1,0,0,1,1,0,10
2814,796838,12,0,2,0,2,0,0,0,0,1,2,0,4,0,0,0,0
2814,796837,18,4,7,1,3,3,4,0,0,1,6,0,3,0,2,0,11
2814,785706,18,0,6,0,1,0,5,0,0,0,1,0,2,1,0,0,0
2814,785700,37,4,11,2,6,2,5,2,2,3,6,4,2,2,2,0,12
2814,780269,32,6,20,5,11,1,9,5,8,1,5,4,3,0,1,0,18
2814,791171,20,2,5,2,5,0,0,2,3,2,4,1,2,1,0,1,6
2814,780194,24,2,4,2,4,0,0,2,2,3,4,2,1,1,2,2,6
2814,796834,11,1,4,1,4,0,0,0,0,0,0,0,1,0,1,0,2
2814,786721,28,3,7,3,3,0,4,5,5,0,6,2,3,2,2,0,11
2815,786456,31,1,4,1,4,0,0,1,2,1,5,0,2,0,3,0,3
2815,781577,34,4,14,4,12,0,2,2,4,3,14,3,3,1,2,1,10
2815,775910,28,6,13,1,3,5,10,2,2,0,8,2,5,0,0,1,19
2815,780020,27,2,8,1,5,1,3,0,0,1,2,1,4,1,2,0,5
2815,781387,34,2,13,1,4,1,9,8,9,0,1,1,1,2,1,0,13
2815,791763,14,3,6,3,4,0,2,1,3,1,2,0,0,0,1,0,7
2815,780268,3,0,1,0,1,0,0,2,2,1,1,0,1,0,1,0,2
2815,797554,8,1,2,1,2,0,0,0,0,0,1,0,5,0,0,0,2
2815,797561,21,1,2,1,2,0,0,0,0,0,0,2,0,0,2,0,2
2815,793065,0,0,0,0,0,0,0,0,0,0,0,0,0,0,0,0,0
2816,792068,37,9,13,4,5,5,8,2,2,0,3,7,3,0,4,0,25
2816,784640,12,1,5,1,2,0,3,1,2,0,0,0,4,0,0,1,3
2816,792072,32,4,7,1,2,3,5,0,0,1,2,0,1,2,0,0,11
2816,792069,29,2,11,1,7,1,4,3,3,0,2,0,2,2,1,0,8
2816,785572,18,2,5,2,4,0,1,2,2,1,3,3,1,1,0,0,6
2816,786025,11,3,4,3,4,0,0,0,0,0,0,1,1,0,0,1,6
2816,797655,10,2,3,2,3,0,0,1,3,0,1,0,0,0,2,0,5
2816,797657,20,1,1,1,1,0,0,0,0,1,0,1,2,0,2,0,2
2816,797652,31,2,4,1,3,1,1,1,2,0,4,5,4,1,0,1,6
2817,781249,32,1,5,0,2,1,3,2,2,0,1,4,2,0,1,0,5
2817,775165,30,1,1,0,0,1,1,0,0,2,8,3,2,1,1,2,3
2817,785514,31,2,8,0,3,2,5,0,0,0,2,3,4,1,2,0,6
2817,785515,31,5,9,3,5,2,4,5,5,0,5,3,1,1,5,0,17
2817,781253,33,6,9,2,2,4,7,2,3,0,2,2,1,0,0,0,18
2817,796953,9,2,2,1,1,1,1,1,2,1,2,0,2,0,1,1,6
2817,796952,4,0,0,0,0,0,0,0,0,0,0,1,0,0,1,0,0
2817,791687,30,9,13,3,5,6,8,5,5,0,4,1,1,1,1,0,29
2818,786296,12,0,2,0,1,0,1,0,0,2,0,0,3,0,0,0,0
2818,781530,28,7,14,7,13,0,1,2,3,1,8,3,1,1,2,1,16
2818,776423,25,4,5,4,5,0,0,2,2,2,6,2,5,0,0,1,10
2818,798096,29,5,10,1,3,4,7,0,1,1,0,1,2,1,3,0,14
2818,792319,20,2,3,2,3,0,0,5,5,0,0,0,1,1,3,0,9
2818,792314,18,0,1,0,1,0,0,2,2,0,0,0,0,1,3,1,2
2818,792320,8,0,0,0,0,0,0,0,0,0,1,0,1,0,0,0,0
2818,798106,9,1,2,1,1,0,1,1,1,0,2,1,0,1,0,0,3
2818,798104,16,1,4,0,1,1,3,6,6,0,1,1,1,0,1,0,9
2818,792307,24,1,4,0,2,1,2,0,0,1,1,0,3,0,2,0,3
2818,792309,9,3,8,2,6,1,2,0,0,0,1,0,3,0,0,0,7
2818,792321,2,0,1,0,1,0,0,0,0,0,0,0,0,0,0,0,0
2819,786706,16,0,2,0,2,0,0,0,0,2,2,0,2,0,0,1,0
2819,786704,26,0,6,0,6,0,0,4,4,2,3,1,4,0,2,0,4
2819,775840,34,2,9,1,4,1,5,1,1,1,2,3,2,1,0,0,6
2819,775955,38,5,12,5,9,0,3,12,12,2,1,5,3,2,4,0,22
2819,775811,8,0,0,0,0,0,0,0,0,0,1,0,1,0,0,0,0
2819,785395,35,7,13,5,7,2,6,0,0,0,3,0,0,1,0,0,16
2819,775287,3,1,2,0,0,1,2,0,0,0,0,0,1,0,1,0,3
2819,790921,10,0,2,0,2,0,0,0,0,0,2,1,4,0,1,0,0
2819,786551,30,6,7,2,3,4,4,2,2,0,2,0,1,1,2,0,18
2820,792265,20,5,6,4,4,1,2,5,6,6,11,2,1,1,1,1,16
2820,797998,11,1,3,1,2,0,1,1,2,0,3,1,1,0,0,0,3
2820,786152,19,5,6,5,5,0,1,5,6,2,4,3,0,1,0,0,15
2820,798003,14,3,5,3,3,0,2,0,0,0,1,2,1,0,0,0,6
2820,798006,29,2,7,2,3,0,4,1,2,0,2,1,0,0,2,0,5
2820,798007,17,3,4,3,4,0,0,0,0,1,4,0,1,0,0,1,6
2820,798002,10,1,1,1,1,0,0,0,0,1,1,0,1,0,2,0,2
2820,798005,14,3,3,3,3,0,0,0,0,2,6,0,1,0,0,0,6
2820,798004,3,1,2,0,1,1,1,0,2,0,1,0,0,0,0,0,3
2820,797999,4,0,1,0,0,0,1,0,0,0,0,1,0,1,1,0,0
2820,798009,24,6,11,6,10,0,1,1,2,0,3,1,1,2,1,0,13
2820,797997,11,2,7,1,3,1,4,0,0,0,0,1,1,2,0,0,5
2820,792267,24,3,10,2,7,1,3,1,2,0,2,3,1,1,0,0,8
2822,776462,28,4,7,3,3,1,4,0,0,2,5,2,2,1,2,1,9
2822,785635,25,7,11,6,8,1,3,3,3,0,9,2,3,1,1,3,18
2822,786440,23,3,10,2,4,1,6,1,1,1,4,1,2,0,2,0,8
2822,786720,20,2,7,2,5,0,2,2,4,1,8,3,0,1,3,0,6
2822,781199,33,7,13,4,7,3,6,2,2,2,2,5,0,0,2,0,19
2822,791628,9,0,2,0,1,0,1,0,0,1,3,0,2,1,1,0,0
2822,775642,12,1,1,1,1,0,0,4,4,1,3,1,0,0,0,0,6
2822,791629,17,3,6,3,4,0,2,0,0,1,2,4,2,0,0,0,6
2822,796974,23,1,4,1,3,0,1,3,3,0,2,0,1,1,1,0,5
2822,796973,3,1,1,1,1,0,0,0,0,0,2,0,0,0,1,0,2
2822,791626,3,1,1,1,1,0,0,0,0,0,0,0,0,0,0,0,2
2822,780459,1,0,0,0,0,0,0,0,0,0,0,0,0,0,0,0,0
2822,796972,3,0,0,0,0,0,0,0,0,0,0,0,1,0,0,0,0
2823,785374,21,2,4,2,4,0,0,1,1,4,3,1,0,0,0,0,5
2823,786384,21,1,8,1,3,0,5,4,6,0,4,0,3,0,1,0,6
2823,790825,23,1,9,1,6,0,3,0,0,0,0,2,2,0,0,0,2
2823,785371,18,2,6,0,2,2,4,2,2,0,1,1,0,0,1,0,8
2823,774905,21,2,10,1,7,1,3,0,0,2,2,1,0,0,0,1,5
2823,790827,20,2,6,0,3,2,3,2,2,2,3,1,1,0,1,0,8
2823,790828,4,1,1,1,1,0,0,0,0,0,0,0,1,0,1,0,2
2823,785373,13,0,5,0,2,0,3,0,0,1,1,0,0,1,0,1,0
2823,785372,28,3,10,2,9,1,1,4,4,1,3,3,2,1,2,0,11
2823,796387,12,0,1,0,1,0,0,0,2,1,5,0,2,0,0,0,0
2823,796385,15,4,9,4,7,0,2,1,1,0,1,1,3,2,0,0,9
2823,785375,2,0,0,0,0,0,0,0,0,0,0,0,1,0,0,0,0
2823,780007,2,0,1,0,0,0,1,0,0,0,0,0,0,0,0,0,0
2824,790799,29,3,4,3,3,0,1,3,3,1,2,1,2,1,1,1,9
2824,790798,20,7,10,7,9,0,1,0,0,1,5,1,3,1,1,2,14
2824,780140,23,3,8,3,6,0,2,2,2,3,5,1,0,0,1,1,8
2824,785245,30,4,7,2,2,2,5,0,0,0,3,7,2,2,0,0,10
2824,780137,20,6,8,2,3,4,5,1,3,3,7,2,0,1,1,0,17
2824,790796,12,2,2,2,2,0,0,1,4,1,0,0,4,0,1,0,5
2824,796359,17,3,7,3,4,0,3,6,9,2,0,2,3,0,0,0,12
2824,796354,21,0,4,0,1,0,3,2,4,2,3,0,1,1,0,0,2
2824,775553,16,3,8,2,3,1,5,0,0,0,2,1,2,1,2,0,7
2824,790800,6,1,4,1,3,0,1,0,0,2,0,0,0,0,0,0,2
2824,794905,3,0,2,0,0,0,2,2,2,1,0,0,1,1,0,0,2
2824,790795,3,0,0,0,0,0,0,0,0,0,0,0,0,0,0,0,0
2825,797587,25,3,8,3,8,0,0,0,0,3,3,1,4,1,1,0,6
2825,791894,6,0,2,0,2,0,0,0,0,0,1,0,0,1,0,0,0
2825,786502,37,7,18,4,11,3,7,3,3,0,9,1,3,1,4,0,20
2825,781561,25,5,9,4,6,1,3,1,1,1,2,0,1,0,5,0,12
2825,781080,27,2,5,1,3,1,2,3,5,0,1,1,4,0,0,0,8
2825,791891,4,0,1,0,1,0,0,0,0,0,0,0,1,0,0,0,0
2825,786501,13,0,3,0,1,0,2,2,2,0,2,1,1,0,0,0,2
2825,781078,17,0,2,0,0,0,2,3,4,1,4,0,3,1,1,0,3
2825,797584,25,2,5,2,5,0,0,0,0,0,0,0,2,0,0,0,4
2825,791895,18,1,4,1,3,0,1,0,1,2,0,2,2,0,1,0,2
2825,797586,1,0,0,0,0,0,0,1,2,0,0,0,0,0,1,0,1
2825,791892,1,0,0,0,0,0,0,0,0,0,0,0,0,0,0,0,0
2825,797583,1,0,0,0,0,0,0,0,0,0,0,0,0,0,0,0,0
2830,na,21,6,9,6,9,0,0,0,0,7,8,0,2,0,1,0,12
2830,785972,23,4,6,3,4,1,2,4,4,1,4,2,1,0,4,1,13
2830,785967,24,8,11,8,11,0,0,2,3,0,4,0,3,2,0,0,18
2830,791977,27,2,8,2,5,0,3,0,0,0,0,1,0,1,0,0,4
2830,791978,29,4,10,4,8,0,2,1,1,0,1,5,1,1,1,1,9
2830,780160,7,0,0,0,0,0,0,0,0,2,1,1,3,1,1,0,0
2830,797799,5,0,0,0,0,0,0,0,0,0,1,1,0,0,0,0,0
2830,785973,14,0,5,0,1,0,4,0,0,2,1,3,2,2,0,0,0
2830,791976,12,2,11,2,6,0,5,2,2,0,1,0,0,1,0,0,6
2830,791980,17,3,4,3,3,0,1,0,0,2,3,0,2,0,0,0,6
2830,797800,9,2,4,1,3,1,1,0,1,0,0,0,1,3,0,0,5
2830,797803,7,0,4,0,1,0,3,0,0,0,3,2,3,1,1,0,0
2830,797801,3,0,0,0,0,0,0,0,0,0,0,0,0,0,0,0,0
2830,791979,1,0,0,0,0,0,0,0,0,0,0,0,0,0,0,0,0
2830,799649,1,0,0,0,0,0,0,0,0,0,0,0,0,0,0,0,0
2831,797591,22,2,6,0,1,2,5,0,0,0,3,1,0,1,1,0,6
2831,781071,19,2,5,0,2,2,3,0,0,0,5,2,3,0,0,1,6
2831,780098,25,1,3,1,3,0,0,1,2,1,0,1,4,1,1,0,3
2831,780719,34,3,7,3,6,0,1,1,3,0,6,2,3,0,2,0,7
2831,791890,30,4,10,2,7,2,3,0,0,1,1,3,0,0,5,0,10
2831,797590,15,1,1,1,1,0,0,0,0,2,5,0,3,1,3,1,2
2831,797589,18,1,6,1,3,0,3,1,1,1,1,0,0,0,0,0,3
2831,791889,19,3,7,2,3,1,4,6,6,2,1,0,2,0,1,0,13
2831,791888,12,0,5,0,1,0,4,1,2,0,2,1,0,0,4,0,1
2831,797588,6,0,1,0,0,0,1,0,0,0,1,0,0,0,0,0,0
2832,781342,32,9,16,8,12,1,4,7,10,3,3,4,2,1,1,3,26
2832,781593,34,5,11,2,6,3,5,2,5,3,6,2,2,3,3,0,15
2832,790901,24,2,7,1,5,1,2,2,2,1,0,1,1,2,2,0,7
2832,785452,34,6,9,6,8,0,1,1,1,1,8,1,2,1,0,0,13
2832,781620,26,1,3,0,1,1,2,1,3,0,1,2,3,2,3,0,4
2832,790903,15,5,10,3,3,2,7,0,0,0,0,2,0,1,0,0,12
2832,790902,18,1,4,0,2,1,2,0,0,0,0,1,0,2,1,0,3
2832,774835,9,0,0,0,0,0,0,0,0,0,1,0,1,0,1,0,0
2832,796450,2,0,0,0,0,0,0,0,0,0,0,1,0,0,0,0,0
2832,796452,6,0,2,0,2,0,0,0,0,0,0,0,0,0,0,1,0
2833,790821,12,1,3,1,2,0,1,0,0,0,0,2,2,0,3,0,2
2833,775585,21,5,5,5,5,0,0,0,0,2,4,1,2,0,2,1,10
2833,790822,35,4,11,1,2,3,9,5,6,1,4,3,4,1,2,0,16
2833,790820,30,6,13,4,9,2,4,0,0,1,8,6,3,2,5,0,14
2833,780982,34,4,8,3,4,1,4,2,2,0,3,2,1,0,1,0,11
2833,780445,15,4,4,4,4,0,0,0,0,0,3,0,2,1,0,1,8
2833,796380,25,0,4,0,3,0,1,1,2,0,4,5,3,1,2,0,1
2833,796381,26,6,8,2,2,4,6,0,0,0,2,1,2,2,4,0,16
2833,785365,2,0,0,0,0,0,0,0,0,0,0,0,0,0,0,0,0
2834,780634,30,2,6,2,6,0,0,1,3,2,6,1,2,1,1,1,5
2834,791826,35,4,6,1,1,3,5,0,0,1,1,2,3,0,0,1,11
2834,786784,28,9,15,4,10,5,5,2,2,0,5,1,3,0,1,0,25
2834,780633,37,7,15,6,10,1,5,4,4,0,6,4,3,2,0,1,19
2834,776009,35,3,9,2,6,1,3,6,6,0,0,4,2,2,3,0,13
2834,797387,7,1,2,0,0,1,2,0,0,0,1,0,0,1,0,0,3
2834,780635,10,1,1,1,1,0,0,0,0,1,2,0,3,1,0,0,2
2834,797390,16,1,2,1,1,0,1,1,2,0,2,0,1,0,0,0,3
2834,797388,2,0,0,0,0,0,0,0,0,0,0,0,0,0,0,0,0
2835,790839,31,0,3,0,0,0,3,0,0,2,2,3,2,0,1,0,0
2835,785388,29,10,12,10,12,0,0,1,1,4,8,1,1,0,2,1,21
2835,790840,20,2,7,2,4,0,3,0,0,1,1,3,0,0,2,0,4
2835,785386,21,2,8,0,3,2,5,3,3,0,1,2,2,0,1,0,9
2835,780373,32,4,8,2,3,2,5,4,6,0,4,2,2,1,0,0,14
2835,780370,7,0,2,0,1,0,1,0,0,1,1,0,2,1,1,0,0
2835,796395,20,3,9,3,5,0,4,2,2,1,1,2,3,0,0,1,8
2835,790841,27,7,8,4,4,3,4,0,0,0,1,0,3,0,1,0,17
2835,796393,10,1,1,1,1,0,0,1,2,0,3,1,0,0,0,0,3
2835,796396,3,0,1,0,0,0,1,0,0,0,0,0,0,0,0,0,0
2836,780323,17,4,7,4,7,0,0,3,8,2,2,1,3,1,0,0,11
2836,792233,21,2,6,2,4,0,2,1,1,1,1,2,0,0,2,0,5
2836,797894,16,3,7,3,7,0,0,1,2,4,0,0,2,0,0,0,7
2836,785811,23,3,7,2,4,1,3,1,1,2,5,3,1,2,3,0,8
2836,786016,19,2,5,2,5,0,0,0,0,1,0,0,1,2,0,0,4
2836,785954,20,2,6,0,2,2,4,4,4,1,7,2,0,0,0,2,10
2836,792229,12,5,9,5,7,0,2,1,1,3,0,2,2,0,0,0,11
2836,792234,11,1,2,1,1,0,1,1,2,1,1,1,3,0,1,2,3
2836,797891,15,1,4,0,1,1,3,0,0,0,0,1,1,0,0,0,3
2836,797892,18,2,6,2,4,0,2,2,2,0,1,4,1,0,1,1,6
2836,797893,8,2,3,2,3,0,0,1,1,0,0,0,1,0,0,0,5
2836,792230,12,0,2,0,1,0,1,0,1,1,1,0,0,0,0,0,0
2836,781356,8,2,2,0,0,2,2,0,0,0,2,1,0,0,0,0,6
2837,797111,17,0,4,0,2,0,2,0,0,1,2,0,5,0,1,0,0
2837,797115,15,1,3,0,0,1,3,0,0,1,0,0,1,0,1,0,3
2837,791407,27,2,9,1,5,1,4,8,11,0,5,0,1,1,4,0,13
2837,785928,21,3,5,1,2,2,3,2,2,0,3,0,2,1,3,0,10
2837,785923,37,3,5,3,5,0,0,0,0,0,3,2,3,0,4,0,6
2837,791403,23,1,1,1,1,0,0,4,6,0,4,0,2,2,2,0,6
2837,797109,27,2,10,2,7,0,3,1,1,2,2,0,2,0,0,1,5
2837,797114,25,1,3,1,2,0,1,2,2,0,0,0,2,0,4,0,4
2837,797117,8,2,2,2,2,0,0,0,0,0,2,0,3,0,1,1,4
2838,790893,25,6,9,5,8,1,1,0,1,3,4,0,1,0,1,2,13
2838,796444,25,6,7,5,6,1,1,4,6,3,4,0,1,1,2,3,17
2838,786615,20,2,11,1,10,1,1,2,2,1,2,9,2,1,0,0,7
2838,786732,23,3,8,3,6,0,2,3,4,3,1,1,4,2,3,0,9
2838,775260,29,5,13,4,10,1,3,2,3,1,5,2,3,0,1,0,13
2838,790889,19,2,4,2,4,0,0,0,0,1,4,0,1,1,2,0,4
2838,775536,20,5,8,5,8,0,0,0,2,2,3,0,3,2,1,0,10
2838,780702,20,2,7,1,4,1,3,0,1,0,1,1,2,0,1,0,5
2838,796445,7,0,0,0,0,0,0,0,0,0,0,0,4,0,0,2,0
2838,791501,5,0,2,0,2,0,0,0,0,0,1,0,0,0,1,0,0
2838,796132,1,1,1,0,0,1,1,0,0,0,0,0,0,0,0,0,3
2838,792678,1,0,0,0,0,0,0,0,0,0,1,0,0,0,0,0,0
2838,799891,5,2,3,1,1,1,2,0,0,1,0,0,1,0,1,0,5
2839,786203,22,1,8,0,2,1,6,0,0,1,3,0,3,1,1,0,3
2839,786197,23,2,7,2,7,0,0,0,0,2,3,1,1,0,3,1,4
2839,780717,24,6,11,6,9,0,2,1,2,2,4,0,1,2,2,0,13
2839,791742,26,1,9,1,5,0,4,3,4,1,2,1,2,1,0,0,5
2839,776266,20,5,8,5,6,0,2,3,4,1,0,1,1,0,2,0,13
2839,776328,16,2,3,2,3,0,0,0,1,0,3,1,3,0,1,0,4
2839,791740,15,1,1,1,1,0,0,1,2,0,3,3,0,0,1,0,3
2839,791741,18,3,8,2,5,1,3,2,2,0,3,1,3,1,2,2,9
2839,791738,14,2,4,2,4,0,0,0,2,1,2,0,2,0,1,2,4
2839,797334,15,0,1,0,1,0,0,3,5,1,1,2,2,0,3,0,3
2839,786200,4,0,0,0,0,0,0,0,0,2,2,0,0,1,2,0,0
2839,797337,3,0,1,0,1,0,0,2,2,0,0,0,0,0,0,0,2
2840,796938,39,4,14,4,8,0,6,7,9,0,1,3,3,1,1,0,15
2840,776209,32,7,10,6,8,1,2,0,0,4,9,2,5,4,1,2,15
2840,791236,22,3,8,0,0,3,8,0,0,0,0,2,0,0,2,0,9
2840,791237,34,3,11,2,6,1,5,1,2,3,0,2,3,2,5,0,8
2840,774875,10,0,0,0,0,0,0,0,0,1,4,0,2,0,3,0,0
2840,791351,22,2,6,0,2,2,4,0,0,0,1,0,2,0,1,0,6
2840,791238,19,2,3,0,1,2,2,0,0,0,0,0,5,0,4,0,6
2840,781227,17,0,1,0,0,0,1,1,2,0,4,0,1,0,0,1,1
2840,791235,5,0,2,0,2,0,0,0,0,0,0,0,0,1,0,0,0
2841,791101,24,7,9,5,5,2,4,5,9,0,3,2,3,2,1,0,21
2841,796758,33,8,14,8,13,0,1,2,4,3,4,3,2,1,4,0,18
2841,780794,37,4,10,0,0,4,10,1,2,0,4,3,0,1,1,0,13
2841,796759,19,4,4,4,4,0,0,1,1,2,1,1,1,0,1,0,9
2841,791105,35,1,4,0,1,1,3,0,0,0,4,3,0,0,2,0,3
2841,796761,17,3,5,3,5,0,0,3,7,2,5,0,2,0,1,1,9
2841,796757,16,3,7,3,5,0,2,2,3,0,1,2,5,0,0,0,8
2841,780109,12,1,1,0,0,1,1,0,0,0,4,0,2,1,3,0,3
2841,785597,5,1,1,0,0,1,1,0,0,0,0,0,0,0,0,0,3
2841,791104,1,0,0,0,0,0,0,0,0,0,0,0,0,0,0,0,0
2841,796760,1,0,0,0,0,0,0,0,0,0,0,0,0,0,0,0,0
2842,791610,23,7,9,7,9,0,0,1,3,3,3,1,2,2,0,0,15
2842,796996,20,5,11,5,11,0,0,3,4,4,5,0,1,0,0,0,13
2842,791608,28,3,6,0,1,3,5,2,2,0,3,1,0,0,1,0,11
2842,776011,27,4,10,3,6,1,4,2,5,2,4,6,2,0,2,1,11
2842,796994,22,3,5,2,3,1,2,0,0,0,1,4,3,3,0,0,7
2842,786413,20,7,10,7,10,0,0,2,2,3,4,0,0,2,1,0,16
2842,791613,26,7,12,7,12,0,0,1,2,1,6,5,1,3,1,0,15
2842,786353,16,1,5,0,2,1,3,1,2,0,1,2,1,0,1,0,4
2842,791611,7,1,4,1,3,0,1,0,2,2,0,2,1,1,2,0,2
2842,791612,7,0,1,0,0,0,1,0,0,1,1,0,1,0,0,0,0
2842,780417,4,0,0,0,0,0,0,0,0,0,0,0,0,0,0,0,0
2844,796372,22,3,5,3,5,0,0,1,2,4,6,0,3,1,3,1,7
2844,796377,36,3,14,0,6,3,8,2,3,0,2,2,2,1,1,1,11
2844,796379,25,4,11,3,5,1,6,0,0,1,1,1,0,2,1,0,9
2844,790815,32,3,5,3,3,0,2,0,0,2,8,5,4,3,3,0,6
2844,780176,39,5,13,3,4,2,9,1,3,0,4,6,2,1,2,0,13
2844,796376,13,3,3,2,2,1,1,0,0,1,2,0,1,1,0,0,7
2844,796378,25,3,11,2,6,1,5,0,0,0,3,2,2,1,0,1,7
2844,796375,8,0,0,0,0,0,0,0,0,1,0,0,2,1,2,0,0
2845,780570,28,0,7,0,7,0,0,2,2,3,6,1,4,0,1,0,2
2845,780569,30,2,7,2,7,0,0,1,2,1,4,2,1,0,2,0,5
2845,797438,29,4,10,1,2,3,8,1,2,0,4,1,1,1,0,0,12
2845,791697,17,2,4,1,1,1,3,1,2,0,1,2,1,0,3,0,6
2845,780565,30,7,9,4,5,3,4,2,2,1,2,2,2,1,3,0,19
2845,791695,22,1,4,1,4,0,0,1,2,0,8,0,2,0,0,1,3
2845,781556,21,3,6,3,4,0,2,0,1,0,2,1,0,0,3,0,6
2845,791696,10,1,2,0,1,1,1,1,2,0,2,1,2,0,1,0,4
2845,797432,13,0,1,0,0,0,1,1,2,0,0,1,0,0,1,0,1
2846,786805,16,5,8,4,6,1,2,4,7,6,2,1,0,1,1,0,15
2846,774936,18,3,7,3,6,0,1,2,3,1,3,1,0,1,0,1,8
2846,790932,15,3,4,2,2,1,2,3,4,0,0,1,0,2,0,1,10
2846,781345,18,3,4,3,3,0,1,0,1,0,3,4,1,2,1,0,6
2846,786803,16,2,5,2,2,0,3,0,0,0,1,1,1,2,1,0,4
2846,796490,9,1,1,1,1,0,0,0,0,0,1,1,4,0,0,1,2
2846,796488,16,3,5,3,3,0,2,0,0,1,6,1,2,0,2,1,6
2846,790934,10,0,0,0,0,0,0,0,0,0,1,2,2,2,1,0,0
2846,786804,6,2,2,1,1,1,1,2,2,0,4,0,1,0,1,0,7
2846,796489,6,0,1,0,0,0,1,0,0,0,0,0,0,0,1,0,0
2846,796487,18,1,8,0,1,1,7,0,2,0,2,0,2,0,1,1,3
2846,790931,17,3,5,3,4,0,1,2,3,1,2,2,1,1,1,0,8
2846,790933,12,3,4,2,2,1,2,1,1,0,2,1,1,0,3,0,8
2846,780033,11,1,3,1,1,0,2,0,0,1,4,3,1,1,0,0,2
2846,780030,12,1,4,0,0,1,4,0,0,0,0,0,0,0,0,0,3
2848,776110,19,2,5,1,1,1,4,0,0,1,4,0,4,1,2,2,5
2848,780059,10,1,1,1,1,0,0,1,2,1,2,2,5,1,3,1,3
2848,796496,18,2,5,1,1,1,4,0,0,2,2,3,3,0,2,0,5
2848,796494,24,2,8,2,6,0,2,2,2,2,4,1,2,0,0,0,6
2848,790944,33,3,10,2,3,1,7,2,5,2,5,4,0,0,0,0,9
2848,786754,32,8,14,5,9,3,5,5,10,2,3,0,1,1,4,0,24
2848,780061,27,5,11,2,4,3,7,0,0,1,5,1,4,0,3,1,13
2848,790941,3,0,0,0,0,0,0,0,0,0,0,0,2,1,0,0,0
2848,780058,19,3,8,1,1,2,7,2,2,1,3,2,1,1,0,1,10
2848,790943,9,1,2,1,2,0,0,0,1,1,2,1,4,1,1,0,2
2848,796495,1,0,0,0,0,0,0,2,2,0,0,0,0,0,0,0,2
2848,788853,1,1,1,0,0,1,1,0,0,0,0,0,1,0,0,0,3
2848,785097,1,0,0,0,0,0,0,0,0,0,1,1,0,0,0,0,0
2848,796497,2,0,0,0,0,0,0,0,0,0,0,0,0,0,0,0,0
2848,796499,1,0,0,0,0,0,0,0,0,0,0,0,0,0,0,0,0
2849,786447,24,6,10,6,10,0,0,3,3,4,4,0,5,2,3,1,15
2849,775074,31,6,12,6,12,0,0,8,13,3,8,0,3,0,3,1,20
2849,791631,10,0,2,0,2,0,0,0,2,0,2,0,2,0,0,0,0
2849,786448,32,1,7,1,4,0,3,0,2,5,3,3,4,2,1,1,2
2849,780462,27,2,11,2,7,0,4,4,6,0,0,0,1,1,3,0,8
2849,796971,29,2,8,1,4,1,4,2,3,0,5,0,1,0,2,0,7
2849,786132,11,0,1,0,1,0,0,0,2,3,1,0,2,1,2,0,0
2849,780731,26,5,11,5,10,0,1,2,2,0,3,0,4,0,2,0,12
2849,776365,6,0,2,0,1,0,1,0,0,1,1,0,0,1,0,0,0
2849,775121,2,0,0,0,0,0,0,0,2,1,0,0,0,0,0,0,0
2849,791634,1,0,1,0,1,0,0,0,0,0,0,0,0,0,0,0,0
2849,791632,1,0,0,0,0,0,0,0,0,0,0,0,1,0,0,0,0
2850,792277,3,0,0,0,0,0,0,0,0,0,1,0,0,0,1,0,0
2850,786516,22,1,5,0,1,1,4,2,2,0,2,0,3,0,1,0,5
2850,785282,26,3,9,3,5,0,4,1,2,1,3,0,2,0,3,0,7
2850,781502,25,2,7,2,3,0,4,2,2,0,4,4,4,1,0,0,6
2850,780259,28,6,10,4,7,2,3,8,8,3,5,0,4,0,1,0,22
2850,785913,20,2,5,2,5,0,0,1,2,0,3,1,3,0,3,0,5
2850,781464,21,3,5,0,1,3,4,0,0,1,4,0,5,0,1,1,9
2850,798058,21,0,3,0,3,0,0,4,6,0,0,1,1,1,1,0,4
2850,781501,34,3,4,2,3,1,1,0,0,1,3,1,2,3,3,0,7
2851,776286,22,3,4,3,4,0,0,2,3,4,2,0,2,0,1,2,8
2851,775557,24,2,2,2,2,0,0,0,4,1,4,0,5,0,0,2,4
2851,791445,38,4,15,2,5,2,10,4,6,1,1,4,2,3,1,0,14
2851,785357,37,5,17,4,10,1,7,8,8,3,4,4,1,2,2,0,19
2851,775560,26,3,4,3,4,0,0,2,2,0,5,0,3,1,2,0,8
2851,785287,3,0,0,0,0,0,0,0,0,0,0,0,1,1,0,0,0
2851,790516,23,3,8,2,7,1,1,4,4,1,2,0,3,1,4,0,11
2851,797010,11,0,4,0,3,0,1,0,2,1,2,0,1,1,0,0,0
2851,785895,3,0,1,0,0,0,1,0,0,0,0,0,0,0,0,0,0
2851,791444,6,0,0,0,0,0,0,0,2,0,0,0,1,0,0,2,0
2851,797012,7,0,1,0,0,0,1,0,0,0,0,0,0,0,0,0,0
2856,785298,14,1,1,1,1,0,0,0,0,0,6,0,0,0,0,1,2
2856,775224,20,1,7,1,5,0,2,0,0,0,1,2,3,0,0,1,2
2856,778046,22,6,11,3,6,3,5,2,2,1,2,5,0,1,2,0,17
2856,782121,24,2,3,0,1,2,2,0,0,2,4,12,1,3,4,0,6
2856,775793,26,9,13,7,8,2,5,0,0,0,3,1,0,2,1,0,20
2856,796599,8,0,3,0,2,0,1,0,0,0,2,0,0,0,0,0,0
2856,785485,21,6,6,6,6,0,0,1,2,1,10,0,0,0,1,0,13
2856,790987,7,1,3,0,1,1,2,0,0,1,2,0,1,0,0,0,3
2856,796598,22,3,8,2,3,1,5,0,0,0,0,2,0,1,1,0,7
2856,786594,16,4,7,2,2,2,5,0,0,0,0,3,2,2,1,0,10
2856,785302,14,4,6,2,3,2,3,3,4,0,1,0,2,4,0,1,13
2856,785301,3,0,3,0,3,0,0,0,0,1,0,0,0,0,0,0,0
2856,778469,3,0,3,0,3,0,0,0,0,1,1,0,0,1,0,0,0
2857,781208,16,1,1,1,1,0,0,1,2,0,1,1,1,0,3,0,3
2857,775489,26,1,9,1,8,0,1,0,0,3,3,3,1,1,2,0,2
2857,785563,25,6,11,4,5,2,6,0,2,0,5,2,3,0,4,1,14
2857,785560,30,2,8,1,3,1,5,0,0,0,2,3,2,0,3,0,5
2857,780766,32,6,13,0,4,6,9,1,1,0,7,2,1,3,3,0,19
2857,780758,15,0,3,0,3,0,0,0,0,1,0,1,1,1,2,1,0
2857,796751,8,1,2,1,2,0,0,0,0,1,2,1,0,0,0,2,2
2857,791087,11,0,2,0,1,0,1,0,0,0,3,1,0,0,0,0,0
2857,796750,8,1,2,0,1,1,1,0,0,0,0,1,0,0,2,0,3
2857,791088,28,3,9,1,6,2,3,0,0,0,4,1,2,0,5,0,8
2857,796749,1,0,0,0,0,0,0,0,0,0,0,0,0,0,0,0,0
2858,780879,28,2,5,2,4,0,1,4,5,3,8,3,2,0,3,0,8
2858,775785,24,2,7,2,5,0,2,4,7,4,3,0,0,1,2,1,8
2858,790768,25,4,8,1,2,3,6,0,0,0,2,1,2,0,3,0,11
2858,785226,24,2,7,2,6,0,1,2,2,2,5,4,2,1,3,0,6
2858,780875,23,4,10,3,7,1,3,6,8,1,5,0,1,3,1,0,15
2858,785743,21,3,10,1,5,2,5,5,7,2,2,1,2,1,0,0,13
2858,790769,22,3,8,3,5,0,3,2,2,1,1,0,1,0,0,0,8
2858,796326,12,1,2,1,2,0,0,1,2,3,1,0,2,0,0,0,3
2858,796324,16,1,4,1,3,0,1,0,0,0,3,1,1,1,0,0,2
2858,790767,5,1,2,0,0,1,2,0,0,0,0,0,1,0,0,0,3
2859,781300,22,1,8,1,3,0,5,0,0,0,3,0,4,3,4,1,2
2859,790803,20,4,6,4,6,0,0,0,1,2,7,0,3,1,0,1,8
2859,796360,22,6,10,5,7,1,3,1,2,2,2,5,4,2,3,1,14
2859,781304,33,4,10,3,4,1,6,2,2,1,2,3,1,1,2,0,11
2859,781302,27,2,7,0,3,2,4,1,2,0,3,2,4,1,3,0,7
2859,780598,25,1,5,1,2,0,3,0,0,2,6,2,2,0,1,1,2
2859,790801,21,3,4,2,2,1,2,2,2,0,2,0,2,0,2,0,9
2859,781305,15,3,5,0,0,3,5,0,0,0,2,1,2,0,0,1,9
2859,796363,10,2,6,1,2,1,4,0,0,0,0,0,0,0,0,0,5
2859,790802,3,0,1,0,1,0,0,0,0,0,0,0,1,0,0,1,0
2859,796364,2,0,0,0,0,0,0,0,0,0,0,0,1,0,1,0,0
2860,790833,23,2,6,2,5,0,1,2,2,2,1,4,0,1,2,2,6
2860,785518,24,5,12,5,11,0,1,2,2,1,1,2,4,5,4,2,12
2860,796390,25,1,3,1,3,0,0,0,0,0,4,1,1,1,3,2,2
2860,785451,23,4,8,2,4,2,4,0,0,0,2,3,1,2,2,0,10
2860,790834,27,5,7,3,3,2,4,1,3,1,2,0,1,1,1,0,13
2860,785377,20,2,3,2,3,0,0,1,1,0,2,3,2,3,2,1,5
2860,790831,11,1,2,1,2,0,0,0,0,2,1,1,1,0,0,0,2
2860,790832,18,2,6,2,4,0,2,0,0,0,1,2,1,0,1,1,4
2860,785379,14,1,5,1,2,0,3,0,2,0,0,1,1,1,0,0,2
2860,780297,10,1,1,1,1,0,0,0,0,0,1,0,0,0,0,0,2
2860,790830,5,0,0,0,0,0,0,0,0,0,2,0,0,0,0,0,0
2861,785996,32,2,4,2,3,0,1,2,2,2,8,0,1,1,0,1,6
2861,785998,12,0,2,0,1,0,1,0,0,1,1,0,0,0,0,0,0
2861,797646,29,9,18,8,16,1,2,1,2,1,3,3,1,2,7,0,20
2861,780849,36,4,5,1,2,3,3,0,0,0,2,0,2,1,4,1,11
2861,780853,36,1,6,1,6,0,0,2,2,0,2,2,3,1,3,0,4
2861,780776,4,0,0,0,0,0,0,0,0,0,0,0,1,0,0,0,0
2861,785990,19,3,10,2,7,1,3,0,0,0,1,1,1,1,3,0,7
2861,792235,8,1,2,1,2,0,0,0,0,0,1,0,0,1,0,0,2
2861,786010,20,2,4,0,2,2,2,0,0,0,3,1,3,1,0,1,6
2861,792039,4,0,1,0,0,0,1,1,2,1,0,0,0,0,0,0,1
2862,797142,19,2,2,2,2,0,0,3,3,2,5,1,1,1,1,1,7
2862,791522,33,2,9,2,6,0,3,0,0,0,5,3,1,0,3,0,4
2862,786351,25,7,13,4,7,3,6,1,1,6,4,0,3,2,0,0,18
2862,797146,34,12,21,7,10,5,11,3,3,0,3,1,2,2,1,0,32
2862,797143,34,1,8,1,3,0,5,0,0,1,2,6,0,0,2,0,2
2862,791520,19,4,7,4,6,0,1,1,1,2,2,1,1,0,1,1,9
2862,785816,19,1,2,1,2,0,0,0,0,3,3,2,3,1,0,0,2
2862,797144,7,1,2,0,1,1,1,0,0,0,0,2,2,1,0,0,3
2862,797147,10,0,0,0,0,0,0,0,1,1,0,0,2,0,1,0,0
2863,792565,34,6,7,6,7,0,0,2,5,2,6,1,4,0,2,0,14
2863,776333,16,0,0,0,0,0,0,0,0,3,2,0,3,0,1,2,0
2863,792563,33,6,10,5,6,1,4,4,4,1,0,2,2,1,3,0,17
2863,798135,9,0,2,0,0,0,2,0,2,1,1,1,1,0,0,0,0
2863,792561,31,3,9,1,5,2,4,0,0,0,1,3,1,2,2,0,8
2863,792560,14,1,1,1,1,0,0,1,2,0,2,0,1,0,0,1,3
2863,780270,28,2,14,2,4,0,10,0,0,0,1,4,0,0,2,0,4
2863,798134,16,1,6,0,5,1,1,0,0,1,2,2,2,1,3,0,3
2863,798133,18,2,6,1,1,1,5,0,0,2,5,0,1,0,0,0,5
2863,789634,1,0,0,0,0,0,0,0,0,1,0,0,0,0,0,0,0
2864,775604,39,7,12,2,4,5,8,2,3,1,5,4,0,0,2,1,21
2864,796981,31,6,14,3,8,3,6,0,0,2,4,3,2,1,4,0,15
2864,780797,37,5,11,5,7,0,4,3,4,2,3,3,3,2,3,1,13
2864,776418,22,4,10,4,10,0,0,1,4,1,4,0,1,1,1,0,9
2864,780555,39,2,10,1,5,1,5,0,0,0,3,5,1,0,1,0,5
2864,791616,15,1,1,1,1,0,0,0,0,0,3,0,1,1,1,0,2
2864,796986,9,0,3,0,0,0,3,0,0,0,1,0,1,0,0,0,0
2864,791618,8,0,2,0,1,0,1,0,0,0,0,0,2,0,0,0,0
2865,781337,36,7,18,7,12,0,6,2,2,3,2,4,2,2,3,0,16
2865,781339,35,5,9,2,4,3,5,0,0,0,3,4,1,0,1,0,13
2865,786056,34,5,8,3,4,2,4,1,3,1,8,4,1,2,3,0,13
2865,791964,25,3,11,0,2,3,9,0,0,1,6,0,3,0,0,0,9
2865,786054,25,4,7,4,7,0,0,0,0,3,2,2,3,0,0,0,8
2865,797711,17,3,7,2,3,1,4,2,2,1,1,1,1,0,2,0,9
2865,797712,11,3,3,3,3,0,0,0,1,2,2,1,2,0,1,0,6
2865,792041,17,2,5,2,3,0,2,0,0,0,2,0,3,0,1,1,4
2866,797366,22,7,8,6,7,1,1,3,3,4,2,3,0,2,1,0,18
2866,786130,19,5,13,3,9,2,4,2,4,0,2,5,2,2,1,0,14
2866,791807,20,4,11,2,4,2,7,0,0,0,2,0,1,0,1,0,10
2866,797369,17,3,4,3,3,0,1,3,3,0,1,3,3,2,0,0,9
2866,797367,17,1,1,1,1,0,0,2,6,2,4,1,1,1,1,3,4
2866,797365,23,5,9,1,1,4,8,2,2,1,3,0,3,2,0,0,16
2866,797363,25,6,8,4,4,2,4,1,1,1,1,3,3,1,2,0,15
2866,786127,14,3,5,3,5,0,0,1,2,2,3,0,2,1,0,0,7
2866,791808,22,3,5,3,4,0,1,0,0,1,1,1,0,0,1,1,6
2866,791805,7,0,1,0,1,0,0,2,2,0,0,0,0,0,0,0,2
2866,797364,9,0,0,0,0,0,0,0,0,0,2,1,2,3,0,1,0
2866,797370,5,0,4,0,3,0,1,0,1,0,0,0,1,0,0,0,0
2868,791483,22,10,12,7,9,3,3,2,2,1,3,3,1,1,1,1,25
2868,795572,22,6,9,2,5,4,4,0,0,0,1,1,0,2,2,0,16
2868,791485,19,5,7,1,1,4,6,0,0,0,0,1,0,0,0,0,14
2868,780229,23,1,2,1,2,0,0,0,0,0,9,5,2,0,6,0,2
2868,781592,11,1,3,1,2,0,1,0,0,4,3,4,0,0,1,0,2
2868,791488,13,4,5,2,2,2,3,0,0,0,1,1,1,0,0,0,10
2868,797195,12,4,6,2,3,2,3,0,0,0,1,1,1,0,2,0,10
2868,786322,23,3,6,1,1,2,5,0,0,0,3,0,0,1,1,0,8
2868,797194,8,1,2,0,0,1,2,0,0,0,0,0,1,0,0,0,3
2868,791484,8,1,3,1,2,0,1,0,0,0,2,1,1,0,0,0,2
2868,791487,12,0,0,0,0,0,0,1,2,0,1,0,0,1,0,0,1
2868,797193,14,0,2,0,1,0,1,0,0,1,3,3,1,1,1,0,0
2868,786323,9,0,2,0,1,0,1,0,0,0,0,2,0,0,0,0,0
2868,791489,4,0,1,0,0,0,1,0,0,0,0,0,0,0,0,0,0
2870,780201,38,5,11,5,11,0,0,6,6,2,8,1,3,1,1,3,16
2870,791469,4,0,0,0,0,0,0,0,0,0,1,0,1,0,1,1,0
2870,797210,34,5,10,5,10,0,0,2,3,0,1,5,1,2,1,0,12
2870,797208,30,2,4,1,3,1,1,2,3,1,6,5,4,3,3,1,7
2870,786311,38,8,22,4,10,4,12,1,1,0,4,1,2,0,1,0,21
2870,791470,20,1,5,0,2,1,3,2,2,2,4,0,3,0,0,3,5
2870,791467,25,4,7,2,3,2,4,1,1,0,4,2,2,1,2,0,11
2870,775516,11,0,1,0,1,0,0,2,2,1,1,4,1,1,0,0,2
2871,786825,26,3,6,3,6,0,0,0,0,2,5,3,2,3,1,2,6
2871,786338,28,6,13,6,11,0,2,5,7,4,5,2,4,0,3,0,17
2871,775476,24,3,9,0,1,3,8,0,0,0,4,0,2,0,1,0,9
2871,797647,19,1,4,1,2,0,2,2,2,0,2,2,2,2,1,0,4
2871,785347,35,7,15,6,10,1,5,3,5,1,1,4,2,0,5,0,18
2871,791512,11,2,3,2,3,0,0,0,0,1,0,0,2,0,1,0,4
2871,797648,24,2,5,1,3,1,2,1,2,1,5,1,2,0,0,0,6
2871,792047,16,0,3,0,1,0,2,0,0,0,3,0,2,1,1,2,0
2871,792051,9,0,1,0,1,0,0,0,0,0,3,0,1,0,2,1,0
2871,780862,8,0,2,0,1,0,1,0,0,0,1,1,0,0,0,0,0
2872,790799,24,4,8,4,6,0,2,0,0,1,4,4,3,1,0,0,8
2872,790798,19,4,7,4,7,0,0,1,2,1,2,2,3,2,0,0,9
2872,780140,23,10,16,6,10,4,6,1,1,1,2,2,2,1,0,0,25
2872,785245,27,3,8,2,4,1,4,2,2,0,1,5,3,0,0,0,9
2872,780137,27,8,9,5,5,3,4,2,2,3,8,6,2,2,3,0,21
2872,775553,11,2,3,2,2,0,1,0,0,0,2,3,1,1,2,0,4
2872,790796,12,6,6,6,6,0,0,5,9,1,4,1,1,2,1,0,17
2872,796359,20,3,8,3,4,0,4,2,4,1,4,3,1,1,0,0,8
2872,796354,17,3,5,3,3,0,2,2,2,0,2,0,1,0,0,0,8
2872,790795,7,0,1,0,1,0,0,1,2,0,0,0,1,1,0,0,1
2872,790800,5,1,1,1,1,0,0,0,0,0,0,0,0,0,1,0,2
2872,799892,4,0,1,0,1,0,0,0,0,0,0,0,1,0,0,0,0
2872,794905,4,0,0,0,0,0,0,0,0,0,0,0,0,0,0,0,0
2873,796892,23,5,8,5,8,0,0,0,0,1,2,0,5,0,1,0,10
2873,796891,25,3,7,3,6,0,1,2,5,0,3,1,5,0,3,0,8
2873,796886,34,3,8,3,7,0,1,5,7,3,4,3,3,1,2,0,11
2873,796882,36,5,12,2,7,3,5,7,8,0,3,2,4,0,6,0,20
2873,790447,4,0,2,0,2,0,0,0,0,0,0,1,0,0,0,0,0
2873,796890,18,5,8,5,6,0,2,0,0,0,1,0,3,0,1,0,10
2873,796881,29,0,2,0,1,0,1,0,0,0,3,9,0,1,4,0,0
2873,796889,18,1,5,0,1,1,4,1,2,1,0,1,1,0,1,0,4
2873,796894,13,2,4,2,3,0,1,0,0,0,4,0,0,2,1,0,4
2874,780027,34,6,14,6,11,0,3,6,6,2,4,1,1,0,1,1,18
2874,786176,27,3,8,2,5,1,3,3,4,0,5,0,1,3,1,0,10
2874,786173,34,6,10,3,4,3,6,4,6,1,2,1,0,0,0,0,19
2874,780028,24,0,3,0,1,0,2,1,2,0,5,5,3,0,1,0,1
2874,774828,36,7,11,1,2,6,9,4,4,1,4,5,2,0,2,0,24
2874,780029,8,0,2,0,2,0,0,2,2,1,1,3,0,0,0,0,2
2874,791379,12,2,3,2,2,0,1,0,0,2,2,2,1,0,2,1,4
2874,791380,4,0,2,0,2,0,0,0,0,0,0,0,1,1,1,0,0
2874,797175,21,4,5,3,3,1,2,0,1,0,2,0,3,2,1,0,9
2875,791917,20,1,6,1,5,0,1,2,2,1,3,1,1,0,1,0,4
2875,786526,29,9,15,6,11,3,4,0,0,0,4,0,3,1,1,1,21
2875,786525,34,4,7,1,2,3,5,0,1,1,1,2,1,0,2,0,11
2875,791914,28,1,8,1,4,0,4,0,0,0,6,8,1,1,2,0,2
2875,786030,28,4,9,0,2,4,7,2,4,1,1,2,5,0,1,0,14
2875,786856,13,4,5,4,5,0,0,2,2,3,1,1,1,2,1,1,10
2875,786524,17,1,4,1,3,0,1,1,1,0,0,0,0,0,1,0,3
2875,797550,9,1,3,0,0,1,3,0,0,0,1,0,3,0,0,0,3
2875,781109,22,1,2,1,2,0,0,2,2,2,5,1,2,1,2,0,4
2884,791276,24,4,7,4,7,0,0,4,7,6,6,0,1,1,2,4,12
2884,785748,21,2,10,2,7,0,3,3,3,0,3,0,0,2,1,0,7
2884,785746,18,1,5,1,3,0,2,0,0,1,0,0,1,0,0,0,2
2884,785741,28,1,10,1,6,0,4,2,2,0,2,3,4,3,0,1,4
2884,785755,15,2,6,2,6,0,0,1,2,1,0,0,2,0,0,0,5
2884,781316,8,1,1,0,0,1,1,0,0,0,0,0,0,0,0,0,3
2884,796526,17,0,2,0,2,0,0,0,0,1,1,0,1,0,1,0,0
2884,796527,12,0,4,0,4,0,0,0,2,0,0,2,0,0,1,0,0
2884,791275,17,0,3,0,2,0,1,0,0,0,1,0,3,0,1,0,0
2884,785753,1,0,0,0,0,0,0,0,0,0,1,0,0,0,0,0,0
2884,785751,12,0,0,0,0,0,0,0,0,0,0,0,1,0,0,1,0
2884,796529,27,5,10,4,7,1,3,3,4,0,1,1,2,0,1,0,14
2885,791299,19,0,2,0,1,0,1,0,0,0,6,0,4,0,1,1,0
2885,791296,37,9,16,8,12,1,4,5,9,1,3,1,3,0,5,0,24
2885,775871,23,2,3,2,2,0,1,2,2,3,5,0,4,2,1,0,6
2885,796590,28,1,3,0,2,1,1,0,0,0,8,4,1,0,0,0,3
2885,791519,34,8,14,4,9,4,5,3,4,0,4,5,2,0,5,0,23
2885,792084,16,0,2,0,2,0,0,0,0,1,3,2,4,2,0,2,0
2885,786276,19,4,7,1,1,3,6,0,0,0,1,1,1,0,0,0,11
2885,796593,6,0,0,0,0,0,0,0,0,0,1,0,0,0,0,1,0
2885,796591,17,1,2,1,1,0,1,2,4,1,3,5,2,0,2,0,4
2885,780529,1,0,1,0,1,0,0,0,0,0,0,0,0,0,0,0,0
2886,790494,21,1,4,1,3,0,1,0,0,1,1,0,1,1,0,2,2
2886,788866,14,1,5,1,4,0,1,0,0,1,0,0,4,1,1,0,2
2886,781005,24,4,9,3,7,1,2,2,4,0,6,0,4,0,1,4,11
2886,782162,24,6,12,6,11,0,1,0,1,1,5,2,3,0,2,0,12
2886,796851,39,3,12,2,7,1,5,2,3,0,3,7,0,2,2,0,9
2886,796855,5,0,0,0,0,0,0,0,0,0,0,0,1,0,1,0,0
2886,788865,4,1,1,1,1,0,0,0,0,0,1,0,0,0,0,0,2
2886,781659,24,3,8,2,5,1,3,0,0,1,2,1,3,0,0,1,7
2886,796853,21,3,9,3,6,0,3,0,1,2,3,0,5,0,1,0,6
2886,780610,24,3,6,3,3,0,3,2,3,1,2,1,4,0,3,0,8
2887,780378,24,4,8,4,8,0,0,2,6,3,8,1,1,0,3,4,10
2887,797061,38,2,4,2,3,0,1,1,2,4,5,0,2,0,0,1,5
2887,786374,34,5,14,4,9,1,5,5,8,2,5,2,4,2,2,0,16
2887,786253,30,3,10,2,7,1,3,7,7,1,3,1,2,0,3,0,14
2887,785798,16,3,10,3,6,0,4,0,1,0,4,0,1,1,1,0,6
2887,780382,16,1,3,1,3,0,0,0,0,2,0,0,1,1,0,0,2
2887,797065,4,0,2,0,0,0,2,0,0,0,1,1,1,0,0,0,0
2887,791562,19,0,4,0,2,0,2,2,2,0,1,3,2,0,1,0,2
2887,780381,0,0,0,0,0,0,0,1,2,0,0,0,0,0,0,0,1
2887,780121,19,3,6,0,0,3,6,0,0,1,2,1,3,0,1,0,9
2888,780023,13,0,1,0,1,0,0,0,0,0,6,0,5,0,1,4,0
2888,792490,22,2,5,2,3,0,2,4,5,1,1,0,4,1,1,1,8
2888,792493,34,8,10,2,3,6,7,0,0,2,4,0,3,0,1,0,22
2888,792495,38,11,20,9,15,2,5,7,8,1,5,2,3,2,5,1,31
2888,792491,36,1,7,1,7,0,0,2,4,1,3,14,3,2,2,0,4
2888,798960,8,0,4,0,4,0,0,0,0,2,3,0,1,0,0,0,0
2888,788128,20,4,9,2,2,2,7,0,0,0,4,1,1,0,1,0,10
2888,786832,5,0,2,0,2,0,0,0,0,1,1,0,1,0,0,0,0
2888,781144,22,2,4,2,3,0,1,1,2,1,5,0,0,0,1,0,5
2888,793441,2,0,0,0,0,0,0,0,0,0,0,0,0,0,0,0,0
2889,791289,15,1,4,1,4,0,0,0,2,1,5,0,0,0,1,0,2
2889,785786,28,3,5,3,3,0,2,1,2,1,3,0,4,0,1,3,7
2889,796571,21,2,8,2,5,0,3,0,0,1,4,2,1,1,2,0,4
2889,791291,29,7,11,4,6,3,5,9,9,1,2,1,3,2,0,1,26
2889,781346,27,3,15,2,6,1,9,2,2,1,4,3,0,0,1,0,9
2889,796576,22,1,10,0,3,1,7,4,5,1,3,2,1,0,1,0,7
2889,796574,18,1,4,0,2,1,2,3,4,0,4,4,4,2,2,0,6
2889,791290,26,2,7,2,4,0,3,3,4,2,4,0,3,1,0,0,7
2889,791288,4,0,0,0,0,0,0,1,2,0,0,0,2,1,2,0,1
2889,796572,10,0,2,0,2,0,0,0,0,3,0,0,4,0,1,0,0
2890,785459,13,3,4,3,4,0,0,1,2,1,2,0,4,1,0,0,7
2890,789101,23,3,4,3,3,0,1,5,5,0,3,0,5,0,1,0,11
2890,789102,34,3,10,2,7,1,3,10,15,1,7,5,3,2,5,0,17
2890,781371,17,1,3,0,1,1,2,0,0,2,2,1,1,0,3,0,3
2890,781367,25,3,9,1,2,2,7,8,10,5,1,0,2,0,1,0,16
2890,797731,8,1,2,1,2,0,0,0,0,2,0,0,4,0,1,0,2
2890,792066,22,1,3,1,3,0,0,2,2,2,1,1,1,2,1,2,4
2890,792064,11,1,4,0,0,1,4,0,0,0,0,0,1,1,1,0,3
2890,792063,14,1,2,1,1,0,1,1,2,1,1,1,0,1,2,0,3
2890,792061,17,2,7,2,4,0,3,2,4,2,4,0,3,2,4,2,6
2890,788037,16,2,7,2,6,0,1,8,10,3,4,1,1,2,3,0,12
2891,791063,3,1,2,1,2,0,0,0,0,0,0,0,0,0,1,0,2
2891,791060,25,6,7,6,7,0,0,4,9,0,2,5,4,2,1,0,16
2891,791062,19,5,7,4,6,1,1,1,2,0,2,2,5,2,4,2,12
2891,785542,34,2,6,2,5,0,1,1,3,0,3,0,5,3,0,0,5
2891,780743,38,7,14,5,9,2,5,1,1,0,3,2,2,1,5,0,17
2891,785548,21,3,3,2,2,1,1,1,3,0,0,1,5,0,5,0,8
2891,796735,12,0,1,0,0,0,1,0,0,0,3,0,5,0,2,0,0
2891,796737,1,1,1,1,1,0,0,0,0,0,0,0,4,0,0,0,2
2891,791064,19,2,4,1,2,1,2,0,0,0,1,1,5,1,1,0,5
2891,780055,27,4,5,1,2,3,3,5,7,0,5,1,3,2,1,0,16
2891,796741,0,0,0,0,0,0,0,0,0,0,0,0,0,0,0,0,0
2891,796742,0,0,0,0,0,0,0,0,0,0,0,0,0,0,0,0,0
2891,796736,1,0,0,0,0,0,0,0,0,0,0,0,0,0,0,0,0
2892,785298,16,2,3,2,3,0,0,4,5,2,4,0,3,0,0,1,8
2892,778046,21,6,8,3,4,3,4,2,2,0,0,3,2,1,1,0,17
2892,782121,28,3,5,2,3,1,2,3,3,1,2,10,3,3,3,2,10
2892,775793,20,4,9,2,2,2,7,8,8,2,0,3,0,1,0,0,18
2892,775224,17,2,5,2,4,0,1,1,2,1,0,2,2,2,0,0,5
2892,786594,22,2,6,1,4,1,2,0,0,2,1,0,1,1,1,0,5
2892,785485,18,3,5,3,5,0,0,0,1,3,5,0,0,0,1,0,6
2892,796598,18,0,6,0,1,0,5,2,4,1,0,2,1,1,4,0,2
2892,785302,16,5,7,3,4,2,3,2,2,3,2,1,1,1,0,0,14
2892,796599,10,4,4,4,4,0,0,2,2,0,1,0,4,0,1,2,10
2892,790987,8,3,4,0,1,3,3,1,2,1,2,1,5,0,0,0,10
2892,778469,2,0,0,0,0,0,0,0,0,0,1,0,1,0,1,0,0
2892,785301,4,0,1,0,0,0,1,0,0,0,1,1,0,0,0,0,0
2893,796540,31,9,15,7,12,2,3,4,4,5,2,0,4,4,1,0,24
2893,790951,13,1,1,1,1,0,0,0,0,0,3,1,5,0,1,1,2
2893,790952,11,1,2,1,2,0,0,0,0,1,0,0,0,0,0,0,2
2893,781410,15,0,2,0,1,0,1,0,0,0,0,0,0,0,5,0,0
2893,776136,3,1,2,1,2,0,0,0,0,0,0,0,0,0,0,0,2
2893,796545,33,5,14,4,12,1,2,1,7,2,3,8,4,1,6,0,12
2893,775037,16,1,1,1,1,0,0,1,1,1,2,1,2,2,0,0,3
2893,786089,31,3,9,3,3,0,6,7,8,0,1,0,3,1,1,0,13
2893,786309,21,1,3,0,1,1,2,6,6,3,0,0,1,1,1,0,9
2893,796543,10,0,1,0,1,0,0,1,2,0,0,0,2,0,0,0,1
2893,796544,16,2,3,0,0,2,3,2,5,1,1,0,0,0,1,0,8
2894,781407,27,5,10,4,7,1,3,0,0,3,7,2,1,0,4,1,11
2894,791583,14,3,6,3,5,0,1,0,5,1,1,1,4,2,3,1,6
2894,785623,14,2,3,2,3,0,0,2,2,4,1,0,2,0,1,1,6
2894,780580,31,2,9,1,4,1,5,4,4,0,0,5,1,2,6,0,9
2894,776150,27,5,7,3,3,2,4,5,6,0,1,2,1,3,3,0,17
2894,797448,5,0,2,0,1,0,1,0,0,0,1,0,0,0,0,0,0
2894,786608,27,3,3,3,3,0,0,2,2,3,7,1,3,1,2,1,8
2894,797445,15,1,1,1,1,0,0,1,2,1,1,0,2,1,2,0,3
2894,786110,14,0,2,0,0,0,2,1,2,1,0,0,1,1,1,0,1
2894,786659,26,1,3,1,3,0,0,0,2,0,6,3,2,0,2,0,2
2895,786123,27,4,12,4,12,0,0,0,3,2,2,1,5,4,2,4,8
2895,780437,35,5,9,5,9,0,0,2,4,3,3,3,3,0,0,0,12
2895,797673,1,0,1,0,1,0,0,0,0,0,0,0,0,0,0,0,0
2895,786118,32,2,9,0,2,2,7,0,0,2,5,3,5,0,6,0,6
2895,786117,39,6,12,6,10,0,2,1,1,1,1,1,4,4,6,0,13
2895,797675,13,2,2,2,2,0,0,0,0,1,2,1,2,2,1,0,4
2895,786264,28,3,10,2,8,1,2,1,2,2,0,4,4,1,3,0,8
2895,797672,8,0,2,0,1,0,1,0,0,1,1,0,2,0,0,0,0
2895,792093,17,2,4,0,1,2,3,0,0,0,0,1,0,1,1,0,6
2896,785384,14,2,3,2,3,0,0,1,1,1,1,1,3,1,2,1,5
2896,780025,36,9,12,9,12,0,0,0,0,2,4,1,2,0,2,1,18
2896,786228,36,3,8,3,6,0,2,6,6,0,0,6,2,1,1,0,12
2896,785385,37,4,8,0,3,4,5,0,0,0,5,0,2,0,1,0,12
2896,785383,39,9,11,7,7,2,4,2,3,0,13,8,3,2,3,0,22
2896,790837,26,1,3,1,1,0,2,0,2,1,2,2,2,0,1,1,2
2896,786297,5,0,1,0,1,0,0,0,0,0,1,0,0,1,1,0,0
2896,781046,7,0,2,0,2,0,0,0,0,0,0,0,0,0,0,0,0
2897,785498,24,3,10,3,8,0,2,0,0,3,3,1,3,0,1,1,6
2897,776469,33,5,11,5,9,0,2,0,2,1,5,0,2,0,2,1,10
2897,796705,35,3,11,2,6,1,5,3,4,2,1,3,2,1,2,0,10
2897,796708,33,3,9,1,3,2,6,0,0,0,2,4,4,2,1,0,8
2897,776322,34,4,13,0,4,4,9,3,4,1,2,1,0,1,1,0,15
2897,796709,18,3,4,3,4,0,0,0,0,1,2,1,0,0,0,2,6
2897,796706,17,0,2,0,0,0,2,0,0,4,1,0,0,0,0,0,0
2897,785500,4,0,1,0,1,0,0,0,0,0,0,0,1,0,0,0,0
2897,791036,2,0,0,0,0,0,0,0,0,0,0,0,0,0,1,0,0
2898,797028,43,3,5,1,3,2,2,1,3,1,7,2,4,0,2,0,9
2898,791598,42,6,12,5,7,1,5,10,13,3,5,2,3,2,5,1,23
2898,797025,12,2,2,1,1,1,1,1,2,0,1,4,5,1,3,1,6
2898,792116,46,5,15,3,8,2,7,7,11,0,8,5,3,1,2,2,19
2898,780410,46,5,14,2,8,3,6,6,8,2,5,1,2,2,0,0,19
2898,785687,10,0,1,0,1,0,0,2,2,0,1,0,4,0,0,0,2
2898,775047,8,0,2,0,2,0,0,0,0,0,2,0,0,0,1,0,0
2898,797027,10,0,2,0,2,0,0,0,0,2,0,1,4,0,0,0,0
2898,791600,29,4,12,3,3,1,9,5,5,0,3,1,3,1,3,0,14
2898,797026,4,0,0,0,0,0,0,0,0,0,0,0,0,0,0,0,0
2899,791295,25,4,9,4,8,0,1,0,2,0,2,4,5,1,0,2,8
2899,776345,27,3,7,3,6,0,1,3,4,1,5,2,5,1,1,4,9
2899,791293,30,1,6,1,3,0,3,2,5,0,7,4,5,3,3,0,4
2899,796579,43,6,9,3,4,3,5,4,4,0,3,1,2,1,3,1,19
2899,781373,5,0,1,0,1,0,0,0,0,0,0,0,2,0,1,0,0
2899,781379,19,0,1,0,1,0,0,0,0,1,5,1,5,0,3,0,0
2899,791292,21,4,7,4,7,0,0,0,2,1,4,0,5,4,1,1,8
2899,796580,8,0,0,0,0,0,0,0,0,0,0,1,0,0,2,0,0
2899,785794,41,8,18,8,17,0,1,10,15,4,4,5,4,1,1,0,26
2899,785792,31,6,10,2,5,4,5,3,4,0,4,1,1,0,1,0,19
2900,790873,19,3,5,2,4,1,1,1,2,1,3,2,2,1,2,2,8
2900,780054,24,5,8,4,4,1,4,1,1,2,4,2,3,1,0,0,12
2900,781140,19,3,4,3,4,0,0,0,1,0,4,2,2,0,1,0,6
2900,786851,23,5,11,2,4,3,7,0,0,0,2,3,2,0,2,0,13
2900,776357,21,1,5,1,4,0,1,2,2,0,2,3,1,0,0,0,4
2900,796433,14,5,5,5,5,0,0,4,6,1,3,0,2,0,1,1,14
2900,780343,14,0,2,0,0,0,2,2,2,1,2,1,0,0,0,0,2
2900,785429,20,6,10,0,1,6,9,0,0,0,2,0,0,1,1,0,18
2900,796432,22,0,5,0,2,0,3,0,0,2,4,0,1,0,0,2,0
2900,776245,15,2,5,1,1,1,4,6,6,0,2,3,3,0,1,0,11
2900,790527,5,1,2,1,1,0,1,0,0,1,2,0,2,0,1,0,2
2900,799139,4,0,1,0,1,0,0,0,0,0,1,0,0,0,1,0,0
2901,791690,21,1,3,1,3,0,0,2,4,3,2,0,1,0,1,1,4
2901,781322,21,2,8,1,2,1,6,2,2,1,1,0,1,0,1,0,7
2901,785989,26,3,11,3,7,0,4,0,0,1,7,0,1,1,2,1,6
2901,786571,26,2,5,1,3,1,2,1,2,1,0,0,1,1,3,0,6
2901,781439,22,3,9,1,4,2,5,5,6,0,3,2,4,0,2,0,13
2901,797299,7,1,1,1,1,0,0,1,1,1,1,0,4,0,1,0,3
2901,781419,21,1,8,1,3,0,5,0,0,0,2,1,2,0,1,0,2
2901,781207,14,1,5,1,2,0,3,4,6,0,0,0,1,0,2,1,6
2901,780563,24,1,3,1,1,0,2,0,0,0,5,0,4,2,2,0,2
2901,784248,14,2,5,1,1,1,4,0,0,1,1,0,1,1,0,0,5
2901,797300,4,0,2,0,0,0,2,0,0,0,0,0,0,1,0,0,0
2902,775833,16,2,4,2,4,0,0,0,0,3,2,1,4,0,2,0,4
2902,781036,40,6,10,4,5,2,5,5,5,2,4,2,2,0,1,0,19
2902,775571,34,1,6,1,4,0,2,2,4,0,2,7,0,1,4,0,4
2902,774894,36,3,10,3,7,0,3,3,3,0,2,1,3,0,1,0,9
2902,796847,4,0,1,0,0,0,1,0,0,0,0,1,0,0,0,0,0
2902,791178,19,1,3,1,3,0,0,2,2,2,5,1,2,0,1,0,4
2902,796845,15,1,2,0,0,1,2,0,0,0,0,1,0,0,1,0,3
2902,799906,36,9,14,8,10,1,4,3,4,2,5,0,2,0,3,0,22
2903,780122,32,3,4,2,2,1,2,2,2,4,6,1,3,0,4,0,9
2903,797215,23,3,4,0,0,3,4,2,2,1,1,3,0,0,2,0,11
2903,797214,19,2,7,2,7,0,0,0,0,2,1,1,2,1,0,0,4
2903,786295,22,5,11,3,4,2,7,0,0,0,2,0,3,1,1,1,12
2903,780792,4,0,2,0,0,0,2,0,0,0,1,0,2,0,1,0,0
2903,791461,32,4,7,4,5,0,2,0,1,2,4,2,3,3,1,0,8
2903,791459,21,4,4,3,3,1,1,0,0,0,1,5,3,0,0,0,9
2903,791460,31,5,13,3,7,2,6,2,6,2,0,1,2,2,4,0,14
2903,775598,16,0,4,0,2,0,2,0,0,1,3,0,0,1,0,0,0
2904,791220,31,2,5,2,4,0,1,4,7,3,2,1,2,0,1,0,8
2904,791219,27,4,12,1,3,3,9,2,3,0,4,2,2,0,3,0,13
2904,776217,31,6,11,6,11,0,0,0,2,5,3,4,0,1,1,1,12
2904,786396,26,1,6,1,4,0,2,6,6,1,2,3,3,3,1,0,8
2904,780730,31,9,13,6,7,3,6,0,1,0,7,4,5,7,2,0,21
2904,786824,29,9,11,5,6,4,5,2,5,1,2,1,2,2,2,1,24
2904,796923,9,0,2,0,2,0,0,0,0,1,1,0,1,0,0,0,0
2904,796921,9,0,1,0,0,0,1,0,0,0,0,2,1,0,2,0,0
2904,796920,4,0,1,0,0,0,1,0,0,0,0,0,1,0,0,0,0
2904,791221,3,0,0,0,0,0,0,0,0,0,0,0,1,0,0,0,0
2905,792140,32,5,8,5,7,0,1,2,2,1,6,4,1,1,1,1,12
2905,786596,24,5,9,5,6,0,3,4,5,2,6,1,4,2,6,0,14
2905,792144,30,3,8,2,5,1,3,1,1,2,3,2,5,2,3,0,8
2905,781429,35,5,8,0,0,5,8,4,7,0,2,1,3,0,3,0,19
2905,776092,36,4,11,1,2,3,9,2,2,0,3,2,5,0,4,0,13
2905,792146,8,2,3,2,3,0,0,0,0,1,1,0,3,0,0,0,4
2905,797786,9,0,2,0,0,0,2,0,0,0,1,0,0,0,0,0,0
2905,792148,26,3,5,2,4,1,1,1,1,0,4,6,2,1,1,0,8
2905,797789,0,0,0,0,0,0,0,0,0,0,0,0,0,0,0,0,0
2906,791302,30,4,13,3,9,1,4,2,4,4,7,0,4,2,2,1,11
2906,781622,29,7,13,2,3,5,10,2,2,1,0,0,3,0,1,0,21
2906,791309,39,2,10,2,7,0,3,2,2,1,3,8,3,0,5,0,6
2906,785835,23,4,6,2,3,2,3,0,2,0,4,1,0,0,0,0,10
2906,776334,27,2,8,2,6,0,2,0,0,1,2,5,1,1,3,0,4
2906,796603,4,0,0,0,0,0,0,0,0,0,1,0,1,0,0,1,0
2906,796602,8,1,3,1,3,0,0,1,2,0,2,0,2,0,0,0,3
2906,791301,14,3,5,2,3,1,2,3,4,0,3,0,0,0,0,0,10
2906,775862,22,3,7,3,6,0,1,2,2,4,5,2,2,1,4,0,8
2906,791304,4,0,0,0,0,0,0,0,0,0,0,0,1,0,0,0,0
2907,785999,36,3,7,3,7,0,0,1,1,1,5,3,3,2,3,1,7
2907,775171,31,3,11,0,2,3,9,3,4,1,4,0,1,0,0,0,12
2907,775654,32,1,3,1,3,0,0,3,5,4,4,2,4,2,2,3,5
2907,791639,26,8,14,4,8,4,6,4,4,0,3,3,3,0,3,0,24
2907,785389,35,8,20,6,13,2,7,0,1,2,5,2,1,0,1,0,18
2907,791640,3,0,0,0,0,0,0,0,0,0,0,0,0,0,0,2,0
2907,785255,9,1,1,1,1,0,0,0,0,2,2,1,3,0,1,0,2
2907,796399,20,4,8,1,4,3,4,2,3,0,3,3,1,2,2,1,13
2907,796398,8,1,2,1,1,0,1,0,0,1,1,1,1,2,0,0,2
2908,786029,15,3,5,3,5,0,0,2,3,1,3,0,2,1,0,1,8
2908,797740,14,3,7,2,6,1,1,1,2,1,3,2,0,0,2,0,8
2908,792114,21,2,9,2,7,0,2,1,3,1,5,5,1,0,4,0,5
2908,786018,20,5,9,3,5,2,4,1,1,0,3,2,2,2,0,1,13
2908,775678,19,2,5,1,1,1,4,0,0,0,3,0,0,2,1,0,5
2908,797746,14,3,4,2,3,1,1,0,0,1,7,1,2,0,2,1,7
2908,786022,13,4,5,2,2,2,3,1,2,0,1,0,0,0,0,0,11
2908,797744,13,4,6,4,5,0,1,0,0,0,1,2,1,3,2,0,8
2908,797743,18,3,6,3,4,0,2,0,0,1,0,2,0,0,1,0,6
2908,797737,9,0,1,0,1,0,0,0,0,0,2,3,2,0,0,0,0
2908,781398,17,2,6,2,5,0,1,0,0,1,5,4,1,0,1,1,4
2908,797745,17,1,2,0,0,1,2,0,0,1,2,0,2,1,1,0,3
2908,780354,3,1,1,1,1,0,0,1,2,0,1,0,0,0,0,0,3
2908,780352,4,0,0,0,0,0,0,0,0,0,1,0,0,0,2,0,0
2908,797741,3,0,1,0,0,0,1,0,0,0,0,0,0,0,0,0,0
2910,781462,39,3,10,3,8,0,2,2,3,1,5,1,4,5,2,1,8
2910,780876,31,6,13,4,8,2,5,0,1,0,1,2,4,0,1,0,14
2910,785353,37,7,11,3,4,4,7,2,4,0,2,4,0,0,5,0,20
2910,781673,27,3,4,0,0,3,4,0,1,0,4,3,3,2,1,0,9
2910,781457,36,8,10,7,7,1,3,3,5,0,7,7,2,3,3,0,20
2910,785355,21,0,1,0,0,0,1,1,2,0,3,1,3,1,1,1,1
2910,791305,8,0,2,0,2,0,0,0,0,0,0,0,1,0,0,0,0
2910,790895,1,0,0,0,0,0,0,0,0,0,0,0,0,0,0,0,0
2911,796410,19,3,6,3,6,0,0,1,4,3,4,1,0,2,1,0,7
2911,790856,23,5,8,5,8,0,0,4,6,0,5,0,3,2,3,0,14
2911,796413,22,3,4,0,0,3,4,0,0,1,1,4,1,1,1,0,9
2911,796409,24,1,7,0,4,1,3,2,2,0,3,3,2,0,3,0,5
2911,780450,15,1,5,0,0,1,5,0,0,0,1,1,3,0,2,0,3
2911,780452,29,4,7,3,6,1,1,0,0,3,8,1,3,0,1,1,9
2911,796407,29,5,7,5,5,0,2,0,0,1,2,2,2,1,3,1,10
2911,796408,25,3,10,1,5,2,5,0,0,0,2,4,2,1,4,0,8
2911,796411,8,0,2,0,2,0,0,0,0,1,1,0,2,0,0,0,0
2911,796412,6,0,0,0,0,0,0,2,2,0,0,1,1,0,0,0,2
2912,791226,11,1,1,1,1,0,0,0,3,1,0,0,2,0,1,5,2
2912,796935,3,0,1,0,0,0,1,0,0,0,1,0,1,0,0,0,0
2912,796933,14,3,5,2,4,1,1,0,0,0,2,0,1,1,0,0,7
2912,791227,23,3,5,1,1,2,4,0,0,0,0,1,1,1,3,0,8
2912,781198,11,0,1,0,1,0,0,0,0,0,2,4,1,0,2,0,0
2912,791230,22,1,5,0,1,1,4,0,0,0,4,0,0,1,5,0,3
2912,785557,29,9,17,9,16,0,1,4,7,4,8,1,2,2,1,1,22
2912,791228,30,2,3,2,2,0,1,5,8,2,4,2,3,4,3,0,9
2912,796932,29,4,13,4,10,0,3,1,3,1,2,3,2,5,3,1,9
2912,785624,28,3,8,2,3,1,5,2,2,1,2,1,3,2,0,0,9
2913,775324,17,2,6,2,6,0,0,3,3,3,5,0,1,0,2,0,7
2913,791223,36,4,15,4,15,0,0,4,6,8,7,2,1,2,5,1,12
2913,791224,18,4,9,3,8,1,1,0,0,1,4,3,5,1,6,1,9
2913,786436,28,3,5,2,2,1,3,0,0,1,2,0,3,0,4,0,7
2913,781181,19,3,8,1,2,2,6,0,0,0,1,1,2,2,2,0,8
2913,791225,25,3,6,3,6,0,0,1,1,2,2,3,3,3,2,2,7
2913,796929,23,3,7,1,1,2,6,1,2,0,2,0,1,1,1,0,9
2913,791222,13,0,3,0,1,0,2,0,0,1,2,5,3,2,1,0,0
2913,785564,20,0,7,0,5,0,2,2,2,1,2,1,1,1,1,0,2
2913,791811,1,0,0,0,0,0,0,0,0,0,1,0,0,0,0,0,0
2914,775747,22,3,11,3,10,0,1,2,2,4,4,3,1,0,2,1,8
2914,786578,25,1,5,1,4,0,1,0,0,1,5,0,1,0,1,0,2
2914,797358,29,5,11,4,6,1,5,4,4,1,5,3,3,1,1,1,15
2914,785669,24,4,7,1,3,3,4,1,2,0,6,3,2,1,0,0,12
2914,775195,20,3,6,1,1,2,5,0,0,0,1,2,1,0,2,0,8
2914,786140,2,1,2,1,2,0,0,0,0,0,1,0,0,0,0,0,2
2914,786136,16,3,6,3,5,0,1,0,0,1,5,2,1,1,1,0,6
2914,797357,19,1,1,1,1,0,0,0,0,0,1,4,0,1,3,0,2
2914,786138,25,5,13,4,10,1,3,3,4,1,2,2,2,1,1,0,14
2914,776236,18,5,7,2,3,3,4,2,2,2,2,2,3,1,1,0,15
2915,786765,33,2,7,1,3,1,4,0,0,0,8,4,1,1,0,5,5
2915,792379,20,2,5,1,1,1,4,1,1,0,2,0,4,0,5,0,6
2915,792380,36,6,13,3,3,3,10,2,2,0,1,5,2,1,1,0,17
2915,781672,21,3,7,3,6,0,1,1,2,1,4,1,3,0,0,0,7
2915,781669,36,7,19,3,6,4,13,0,0,2,5,4,3,1,3,0,18
2915,786764,1,0,0,0,0,0,0,0,0,0,0,1,1,0,1,0,0
2915,781668,3,0,0,0,0,0,0,0,0,1,0,1,1,0,0,0,0
2915,797860,2,0,0,0,0,0,0,0,0,0,0,0,0,0,0,1,0
2915,797854,17,0,1,0,0,0,1,0,0,1,2,0,2,0,1,0,0
2915,797852,25,4,10,1,4,3,6,4,4,0,1,1,1,3,1,1,15
2915,781671,6,1,1,1,1,0,0,1,3,0,0,0,0,1,0,0,3
2916,791352,15,1,2,0,0,1,2,1,2,1,4,1,4,0,0,0,4
2916,780455,11,3,6,3,6,0,0,0,0,1,1,0,1,1,0,1,6
2916,797251,29,2,7,1,3,1,4,2,2,1,6,2,5,2,1,1,7
2916,797247,35,6,13,6,11,0,2,6,6,1,1,4,0,1,1,0,18
2916,776297,37,5,12,1,6,4,6,2,2,1,3,3,2,1,3,0,16
2916,791355,6,0,2,0,0,0,2,0,0,1,0,0,0,0,2,0,0
2916,791354,26,3,4,3,4,0,0,1,2,0,3,2,4,1,1,0,7
2916,785837,21,6,9,4,5,2,4,6,7,1,7,1,1,0,1,1,20
2916,797249,7,0,0,0,0,0,0,0,0,0,1,1,0,0,1,0,0
2916,797248,11,1,2,1,1,0,1,0,0,0,1,2,0,0,0,0,2
2916,797250,1,0,0,0,0,0,0,0,0,0,0,0,0,0,0,0,0
2916,786227,1,0,0,0,0,0,0,0,0,0,0,0,0,0,0,0,0
2917,797842,29,8,19,8,18,0,1,7,13,5,6,1,4,0,0,0,23
2917,779986,11,3,5,3,5,0,0,0,0,0,1,0,2,0,0,0,6
2917,786079,26,0,4,0,3,0,1,0,0,0,2,8,1,1,1,0,0
2917,797835,20,2,5,0,0,2,5,0,0,0,3,0,1,0,2,0,6
2917,797843,35,2,10,2,8,0,2,0,0,3,4,4,2,2,1,0,4
2917,797848,16,3,4,1,2,2,2,2,2,0,1,0,0,0,0,1,10
2917,797849,19,2,5,1,2,1,3,0,0,0,1,1,2,0,1,0,5
2917,781537,16,0,0,0,0,0,0,1,2,2,3,0,3,1,2,0,1
2917,792201,5,0,2,0,2,0,0,0,0,0,1,0,0,0,0,0,0
2917,797847,5,0,2,0,1,0,1,0,0,0,0,0,0,1,0,0,0
2917,797846,18,6,10,3,4,3,6,0,0,2,2,1,1,0,1,0,15
2918,790863,16,2,8,2,4,0,4,0,0,1,4,0,3,0,4,2,4
2918,780021,27,3,5,3,5,0,0,3,6,1,3,0,3,1,2,1,9
2918,785412,22,2,7,1,3,1,4,6,9,0,0,0,2,0,2,0,11
2918,776214,28,2,6,2,4,0,2,2,2,0,3,2,3,3,5,0,6
2918,780099,27,2,2,2,2,0,0,2,3,0,1,0,2,1,3,0,6
2918,775686,16,1,5,0,2,1,3,1,2,4,2,0,2,0,2,0,4
2918,785413,16,1,4,1,4,0,0,2,4,1,3,0,4,0,1,0,4
2918,785417,8,2,3,2,2,0,1,2,4,0,2,0,1,0,0,1,6
2918,776221,16,0,2,0,2,0,0,0,0,0,1,2,1,1,0,0,0
2918,796420,9,0,0,0,0,0,0,0,0,0,3,1,3,0,1,0,0
2918,785411,15,1,2,0,0,1,2,0,0,0,1,0,0,0,0,0,3
2919,775954,29,4,9,4,9,0,0,3,4,3,3,1,4,0,1,0,11
2919,796194,26,5,7,2,3,3,4,2,2,0,3,1,2,0,3,0,15
2919,790917,23,1,3,1,3,0,0,0,0,3,0,4,4,3,2,1,2
2919,781157,22,4,6,3,4,1,2,0,0,0,1,1,2,0,3,0,9
2919,781006,30,5,9,5,9,0,0,3,4,1,5,0,2,2,0,4,13
2919,796464,18,3,6,3,6,0,0,0,1,0,3,1,2,0,3,0,6
2919,796459,25,4,7,3,6,1,1,4,5,0,4,1,1,3,2,0,13
2919,780648,14,0,3,0,3,0,0,0,2,1,2,0,4,0,0,0,0
2919,790918,4,0,1,0,1,0,0,0,0,0,1,0,2,0,0,0,0
2919,785238,3,0,1,0,1,0,0,1,2,0,0,0,0,0,0,0,1
2919,790919,3,0,1,0,1,0,0,0,0,0,0,0,0,0,0,0,0
2919,790916,3,1,1,1,1,0,0,1,4,1,0,0,1,0,0,0,3
2920,797325,33,2,3,2,3,0,0,0,2,2,9,3,4,0,2,0,4
2920,797329,32,2,6,1,4,1,2,2,3,3,4,0,4,0,1,2,7
2920,797323,39,9,19,8,15,1,4,6,8,1,2,13,3,1,2,1,25
2920,786236,39,8,16,4,7,4,9,2,3,2,8,4,2,1,6,1,22
2920,780759,21,1,5,0,1,1,4,0,0,0,2,1,5,1,2,0,3
2920,781002,23,9,12,9,12,0,0,0,0,2,8,1,0,0,0,4,18
2920,797324,5,0,2,0,1,0,1,0,0,0,0,0,0,0,0,0,0
2920,786239,8,2,5,1,2,1,3,0,0,0,1,0,0,0,0,0,5
2920,786246,0,0,0,0,0,0,0,0,0,0,0,0,0,0,0,0,0
2921,797482,36,3,9,2,7,1,2,0,1,0,8,2,2,3,1,1,7
2921,797485,26,2,7,1,5,1,2,2,2,3,2,1,4,1,2,0,7
2921,797481,29,5,12,3,7,2,5,5,6,0,4,0,4,0,1,0,17
2921,797480,28,5,14,4,12,1,2,1,1,2,3,1,3,0,2,0,12
2921,785944,32,5,12,3,6,2,6,7,8,1,2,4,2,2,2,0,19
2921,797483,14,1,1,1,1,0,0,1,3,0,1,0,1,1,1,4,3
2921,791873,8,0,3,0,1,0,2,0,0,0,1,0,3,0,1,0,0
2921,781217,12,0,3,0,1,0,2,0,0,0,4,0,1,0,0,0,0
2921,797479,2,0,0,0,0,0,0,0,0,0,0,0,0,0,0,0,0
2921,797478,13,1,3,1,2,0,1,1,2,0,0,1,0,1,0,0,3
2922,796812,7,1,3,1,3,0,0,0,0,1,3,0,0,0,1,0,2
2922,780952,15,1,4,1,4,0,0,0,0,1,3,0,5,0,3,0,2
2922,791155,33,6,13,6,9,0,4,8,9,2,2,3,1,2,3,1,20
2922,786609,31,9,15,7,12,2,3,2,2,5,5,3,2,0,0,0,22
2922,796810,29,3,7,2,3,1,4,1,2,1,1,6,2,0,2,0,8
2922,780945,26,5,8,5,8,0,0,1,2,2,8,0,3,0,2,1,11
2922,780950,15,2,6,1,3,1,3,0,0,2,1,0,2,1,0,0,5
2922,791156,19,1,3,0,2,1,1,0,0,0,2,1,1,1,2,0,3
2922,785752,21,2,2,0,0,2,2,2,4,0,1,1,1,1,1,1,8
2922,791158,2,0,0,0,0,0,0,1,2,0,1,0,0,0,0,0,1
2922,796813,1,0,0,0,0,0,0,0,0,0,0,0,0,0,0,0,0
2922,796811,1,0,0,0,0,0,0,0,0,0,0,0,0,0,0,0,0
2923,791194,33,3,8,3,6,0,2,0,0,0,1,2,3,0,4,0,6
2923,791193,26,4,6,4,6,0,0,5,7,6,2,0,2,0,2,1,13
2923,786738,32,4,13,3,9,1,4,0,0,1,4,1,1,1,0,1,9
2923,775694,14,1,5,1,3,0,2,0,0,2,1,2,2,1,2,0,2
2923,774827,31,4,12,4,10,0,2,0,1,1,1,4,2,1,2,0,8
2923,780384,14,1,4,1,4,0,0,0,1,2,0,0,4,0,0,3,2
2923,780159,22,5,8,4,6,1,2,3,3,2,6,1,3,1,2,0,14
2923,796863,18,2,4,0,1,2,3,0,0,0,0,1,1,0,3,0,6
2923,796865,10,0,3,0,1,0,2,1,2,0,1,0,1,0,0,0,1
2930,780937,25,4,9,3,4,1,5,1,2,0,6,1,3,0,0,0,10
2930,780938,19,0,1,0,1,0,0,0,0,0,2,4,2,0,2,0,0
2930,791950,23,6,13,2,5,4,8,4,4,0,2,0,1,0,3,0,20
2930,792113,27,2,8,1,4,1,4,2,2,5,3,2,3,0,2,0,7
2930,785350,25,1,7,1,3,0,4,1,3,0,4,0,4,0,6,0,3
2930,797715,27,1,4,1,4,0,0,0,0,0,2,7,3,0,3,0,2
2930,797716,6,1,1,1,1,0,0,0,0,1,0,0,2,0,1,0,2
2930,791149,15,2,3,2,2,0,1,0,0,0,2,1,2,2,2,0,4
2930,797717,15,1,1,0,0,1,1,6,6,0,1,0,1,0,2,0,9
2930,792115,13,1,3,1,2,0,1,1,4,2,1,1,0,0,3,1,3
2930,780779,5,0,0,0,0,0,0,4,4,0,0,0,0,0,0,0,4
2931,786746,31,6,11,5,6,1,5,4,4,3,4,3,1,2,3,0,17
2931,780178,15,3,5,3,5,0,0,4,7,1,1,0,1,3,0,1,10
2931,775075,19,0,3,0,3,0,0,2,2,1,1,1,3,0,0,1,2
2931,792376,32,2,9,1,5,1,4,2,3,0,2,0,2,1,1,0,7
2931,797883,26,4,7,2,5,2,2,2,3,2,2,1,0,4,3,0,12
2931,797890,14,3,5,1,1,2,4,2,4,1,3,0,3,0,3,0,10
2931,792378,17,2,5,2,4,0,1,0,0,0,2,0,1,1,1,1,4
2931,797888,9,0,1,0,1,0,0,2,4,2,2,1,2,0,1,0,2
2931,785744,2,0,0,0,0,0,0,1,2,0,0,0,1,0,0,0,1
2931,792374,18,2,2,1,1,1,1,0,0,1,1,1,4,0,2,1,5
2931,786747,14,4,7,3,6,1,1,1,2,0,2,1,3,2,1,0,10
2931,797885,3,0,1,0,0,0,1,0,0,0,0,0,0,0,0,0,0
2932,780890,24,1,3,0,2,1,1,4,4,1,0,2,1,0,2,2,7
2932,775757,19,3,5,3,5,0,0,2,2,1,3,1,2,0,0,0,8
2932,791123,37,3,5,0,0,3,5,0,0,0,0,2,1,0,1,0,9
2932,786066,32,3,12,1,8,2,4,0,1,3,7,3,0,1,5,0,8
2932,785636,36,2,5,0,0,2,5,0,0,0,3,5,3,1,1,1,6
2932,791119,2,0,0,0,0,0,0,0,0,0,1,0,1,0,0,0,0
2932,786646,24,7,10,4,5,3,5,0,0,0,3,0,3,1,0,0,17
2932,775574,26,7,15,5,9,2,6,2,2,0,3,3,1,0,1,0,18
2933,785775,31,4,8,3,6,1,2,7,8,2,1,1,2,0,1,1,16
2933,781335,21,5,9,5,8,0,1,3,4,2,3,3,5,0,1,0,13
2933,776351,36,4,11,4,7,0,4,0,0,3,6,1,1,1,0,1,8
2933,785770,34,9,15,9,15,0,0,4,6,0,7,2,2,0,1,1,22
2933,781341,33,3,7,0,0,3,7,0,0,0,1,1,1,1,1,0,9
2933,796542,22,4,5,4,5,0,0,1,2,0,2,0,0,1,0,0,9
2933,791285,3,0,0,0,0,0,0,0,0,0,1,0,0,0,0,0,0
2933,791284,14,0,0,0,0,0,0,0,0,0,1,0,0,0,0,0,0
2933,791283,5,0,1,0,1,0,0,0,0,0,1,0,2,0,3,0,0
2933,796538,1,0,0,0,0,0,0,0,0,0,0,0,0,0,0,0,0
2934,792197,30,6,12,2,2,4,10,0,0,2,1,2,2,1,0,1,16
2934,781132,37,3,11,0,4,3,7,4,6,5,6,5,4,1,1,1,13
2934,797517,33,9,14,9,13,0,1,2,2,1,5,0,3,0,1,0,20
2934,797518,33,3,9,2,5,1,4,2,2,1,5,9,5,1,2,0,9
2934,791940,34,4,10,1,4,3,6,0,0,0,1,1,3,1,2,0,11
2934,797522,7,1,4,1,3,0,1,0,0,1,1,0,2,0,0,0,2
2934,786539,3,1,1,0,0,1,1,0,0,0,0,0,2,0,0,0,3
2934,791938,22,0,5,0,2,0,3,1,2,0,1,3,2,1,1,0,1
2934,797516,1,0,0,0,0,0,0,0,0,0,0,0,0,0,0,0,0
2935,780291,29,1,5,1,4,0,1,9,10,3,3,3,3,0,2,0,11
2935,785607,26,4,6,4,6,0,0,6,6,1,3,0,4,0,1,1,14
2935,796665,33,4,8,2,4,2,4,6,7,3,5,0,1,0,1,0,16
2935,785333,15,0,1,0,0,0,1,0,0,0,3,1,0,0,0,0,0
2935,775305,36,3,11,3,5,0,6,9,9,0,5,6,0,0,4,0,15
2935,796663,11,2,3,2,3,0,0,0,0,0,0,0,2,0,0,0,4
2935,791004,26,5,10,1,2,4,8,6,6,1,6,0,3,2,1,0,20
2935,796666,4,0,0,0,0,0,0,0,0,0,0,0,2,0,0,0,0
2935,796664,20,1,4,0,2,1,2,0,0,0,3,2,2,0,1,0,3
2936,790920,21,5,8,4,5,1,3,4,5,1,3,1,5,0,2,0,15
2936,780995,31,2,12,1,6,1,6,3,4,2,7,3,3,0,0,0,8
2936,785930,23,3,9,3,9,0,0,1,2,6,6,1,4,0,3,1,7
2936,780996,26,4,11,3,4,1,7,0,0,2,2,0,1,2,1,1,9
2936,796468,32,5,12,4,9,1,3,2,3,0,2,2,2,2,2,0,13
2936,785492,22,0,3,0,2,0,1,2,4,0,1,0,1,1,1,0,2
2936,785461,7,0,1,0,1,0,0,0,0,1,0,1,0,0,0,0,0
2936,775709,34,6,11,1,1,5,10,0,0,1,3,2,2,0,0,0,17
2936,796467,4,0,1,0,0,0,1,0,0,0,0,0,0,0,0,0,0
2936,796466,0,0,0,0,0,0,0,0,0,0,0,0,0,0,0,0,0
2937,786041,26,4,8,4,6,0,2,0,3,1,6,0,2,0,2,1,8
2937,786686,33,6,9,6,8,0,1,1,3,0,7,5,0,0,1,0,13
2937,792075,35,3,7,0,1,3,6,4,4,2,3,3,2,3,0,0,13
2937,780275,17,1,4,1,4,0,0,0,0,0,1,2,1,0,0,0,2
2937,780881,26,2,10,2,7,0,3,0,2,2,7,4,4,0,4,1,4
2937,780052,27,6,10,3,5,3,5,2,3,0,4,2,3,0,0,0,17
2937,785437,22,6,8,6,7,0,1,2,2,1,1,0,3,0,2,5,14
2937,792074,14,3,4,1,2,2,2,0,1,0,0,0,2,0,0,0,8
2938,797174,27,1,5,1,5,0,0,0,0,0,1,2,1,1,3,0,2
2938,791510,17,5,7,3,4,2,3,3,4,2,3,2,0,0,0,0,15
2938,786699,26,4,6,4,6,0,0,1,1,2,5,0,5,1,0,1,9
2938,797168,25,3,10,3,8,0,2,0,0,1,5,1,2,1,2,0,6
2938,775357,32,2,6,2,5,0,1,3,4,0,2,2,1,1,2,0,7
2938,791509,14,2,2,2,2,0,0,2,4,1,1,0,2,0,0,0,6
2938,797169,11,0,2,0,1,0,1,0,0,1,1,0,2,1,1,0,0
2938,791504,21,2,6,2,5,0,1,5,7,2,4,0,0,0,0,0,9
2938,785593,27,6,12,3,4,3,8,4,4,0,4,1,1,0,1,0,19
2939,785791,17,1,6,1,1,0,5,1,1,2,3,0,2,0,2,0,3
2939,775606,27,6,7,6,7,0,0,0,1,2,7,1,4,0,1,0,12
2939,780552,32,8,14,3,4,5,10,2,2,1,1,1,1,1,0,0,23
2939,780550,32,6,9,4,4,2,5,4,6,0,4,5,3,0,1,0,18
2939,780538,29,4,8,3,6,1,2,0,0,0,3,8,2,0,2,1,9
2939,797424,4,1,1,1,1,0,0,0,0,1,0,0,1,0,0,0,2
2939,785793,11,2,8,1,1,1,7,0,0,0,2,0,1,0,0,3,5
2939,797423,2,0,0,0,0,0,0,0,0,0,1,0,1,0,0,0,0
2939,791672,18,2,2,2,2,0,0,1,3,0,0,0,1,1,0,1,5
2939,791674,28,1,7,0,2,1,5,0,0,1,2,1,1,1,2,0,3
2940,791147,9,1,2,0,1,1,1,1,2,0,1,0,5,0,1,0,4
2940,785782,31,2,6,2,2,0,4,5,5,0,4,1,1,1,0,2,9
2940,791145,26,4,8,3,5,1,3,8,10,0,11,3,1,1,2,0,17
2940,791146,28,4,7,4,7,0,0,1,2,0,4,6,1,0,2,0,9
2940,785777,13,0,1,0,0,0,1,2,2,0,1,2,3,0,2,0,2
2940,791144,27,3,5,2,3,1,2,0,0,0,6,2,2,1,3,1,7
2940,796804,24,4,5,1,1,3,4,0,2,0,6,3,0,2,3,0,11
2940,796803,2,0,0,0,0,0,0,0,0,0,0,0,0,0,1,0,0
2940,791148,18,3,7,2,3,1,4,1,1,0,0,0,1,0,2,0,8
2940,786748,21,2,3,0,0,2,3,8,8,1,1,0,1,0,2,0,14
2940,798159,1,0,0,0,0,0,0,0,0,0,0,0,0,0,0,0,0
2941,791281,29,6,15,5,13,1,2,6,8,9,6,2,4,0,3,0,19
2941,785764,11,0,1,0,1,0,0,0,0,0,3,0,3,0,0,0,0
2941,792276,28,3,10,2,6,1,4,0,0,1,1,4,3,1,3,0,7
2941,791278,26,0,5,0,1,0,4,0,0,1,1,0,2,0,0,0,0
2941,785507,18,1,7,1,2,0,5,0,2,0,1,0,0,1,0,0,2
2941,796534,6,1,1,1,1,0,0,0,0,0,0,0,1,1,0,0,2
2941,796536,11,1,1,1,1,0,0,0,0,0,2,0,0,0,0,2,2
2941,796537,9,2,6,0,0,2,6,0,0,0,0,0,3,0,0,0,6
2941,796535,15,2,6,1,3,1,3,0,0,0,2,1,2,1,1,0,5
2941,786026,16,7,10,6,8,1,2,1,2,1,1,0,5,0,2,0,16
2941,785398,8,0,1,0,0,0,1,0,2,0,1,1,2,1,1,0,0
2941,775814,23,0,4,0,1,0,3,0,0,0,2,3,1,0,4,0,0
2942,791858,34,5,11,1,6,4,5,0,0,3,4,1,4,0,0,2,14
2942,797469,21,1,4,1,2,0,2,0,0,0,2,1,3,0,2,0,2
2942,797463,36,4,13,2,10,2,3,2,2,2,4,3,2,3,1,0,12
2942,791109,37,7,12,6,8,1,4,9,11,1,2,2,3,3,2,0,24
2942,785625,27,2,4,1,2,1,2,0,0,1,0,1,1,1,3,0,5
2942,797468,6,0,1,0,0,0,1,0,0,0,0,1,1,0,0,0,0
2942,797464,13,2,3,1,2,1,1,1,2,1,0,0,4,0,2,0,6
2942,797465,4,0,0,0,0,0,0,0,0,0,0,1,1,1,0,0,0
2942,791854,22,1,6,1,4,0,2,0,0,0,1,1,1,1,0,0,2
2943,785622,28,4,7,4,5,0,2,3,4,1,3,3,2,0,2,0,11
2943,780327,32,7,7,7,7,0,0,2,5,3,4,0,2,1,1,1,16
2943,797451,27,1,7,1,6,0,1,2,3,1,0,3,3,2,5,0,4
2943,791849,34,6,8,3,3,3,5,3,3,0,1,3,2,1,2,0,18
2943,786607,12,1,1,0,0,1,1,0,0,0,2,2,0,1,2,0,3
2943,791848,7,0,0,0,0,0,0,0,0,0,1,1,0,0,0,0,0
2943,797455,6,1,2,1,2,0,0,0,0,0,1,0,2,0,2,0,2
2943,781058,26,4,4,4,4,0,0,2,4,2,3,0,4,0,1,0,10
2943,797458,19,2,6,1,4,1,2,2,2,0,4,1,1,0,2,0,7
2943,797453,9,0,1,0,1,0,0,0,0,0,3,0,2,1,0,0,0
2944,797877,28,4,7,4,4,0,3,3,4,0,7,1,1,1,1,2,11
2944,781599,23,1,4,1,3,0,1,4,4,3,4,2,2,0,1,4,6
2944,797872,33,3,5,3,5,0,0,7,9,0,1,4,1,3,3,0,13
2944,791338,27,1,2,1,2,0,0,1,4,0,5,1,0,0,2,0,3
2944,781595,32,5,10,2,5,3,5,4,4,0,2,0,2,0,1,0,17
2944,797873,4,0,2,0,1,0,1,0,0,0,0,0,4,0,0,0,0
2944,791335,25,2,3,0,0,2,3,1,2,0,3,3,0,0,1,0,7
2944,797875,8,1,3,1,3,0,0,1,3,0,0,0,2,0,0,0,3
2944,797874,19,1,3,0,0,1,3,0,0,0,2,1,2,0,1,0,3
2944,785882,1,0,0,0,0,0,0,0,0,0,0,0,0,0,0,0,0
2945,785948,35,8,12,8,12,0,0,5,8,5,7,1,3,1,3,1,21
2945,785946,30,0,2,0,1,0,1,0,0,3,1,0,5,0,2,0,0
2945,792020,30,3,8,2,6,1,2,0,0,1,0,3,3,2,1,0,7
2945,785941,27,1,7,0,2,1,5,0,0,2,5,0,2,3,1,1,3
2945,785938,26,4,8,2,3,2,5,0,0,0,0,2,2,0,0,1,10
2945,792025,10,1,2,1,2,0,0,0,0,0,1,0,1,0,1,1,2
2945,792023,15,0,3,0,2,0,1,0,0,0,4,2,2,0,1,0,0
2945,785939,22,3,12,3,9,0,3,3,5,1,1,1,3,0,1,0,9
2945,792026,5,0,0,0,0,0,0,0,0,0,0,0,0,0,0,0,0
2946,785423,37,8,11,4,4,4,7,8,10,1,5,1,2,1,0,0,28
2946,786210,10,0,2,0,2,0,0,1,2,0,2,1,0,0,0,0,1
2946,786298,28,0,4,0,1,0,3,0,0,2,2,0,3,1,2,0,0
2946,785425,34,2,8,1,5,1,3,0,0,0,7,1,0,0,0,0,5
2946,785422,39,1,8,1,2,0,6,2,2,0,2,8,2,1,3,0,4
2946,775676,31,7,11,7,11,0,0,5,7,0,5,1,3,0,2,1,19
2946,774957,21,0,1,0,0,0,1,0,0,0,4,1,1,0,0,0,0
2947,775510,38,5,13,2,5,3,8,0,0,2,8,4,1,0,1,0,13
2947,774976,24,7,9,6,6,1,3,0,0,0,5,1,4,0,2,1,15
2947,792293,27,2,9,1,6,1,3,1,2,0,2,1,3,2,0,1,6
2947,786614,32,2,5,1,1,1,4,0,0,1,3,1,1,0,0,1,5
2947,786759,38,7,12,5,8,2,4,3,6,0,3,5,0,0,0,0,19
2947,792294,11,3,5,3,4,0,1,0,0,3,3,1,4,0,0,0,6
2947,797865,13,0,2,0,1,0,1,0,0,0,1,0,1,1,1,0,0
2947,792291,14,0,2,0,0,0,2,0,0,0,1,1,1,0,0,0,0
2947,792292,3,1,1,1,1,0,0,0,0,0,1,0,0,0,1,0,2
2948,796699,19,1,4,1,2,0,2,3,6,2,1,2,1,0,0,2,5
2948,790983,30,5,8,3,6,2,2,1,4,1,1,2,2,0,5,0,13
2948,790978,21,5,6,0,0,5,6,0,0,0,4,0,3,1,0,0,15
2948,790979,29,6,11,3,4,3,7,4,5,3,7,3,3,0,5,0,19
2948,796700,32,1,8,1,5,0,3,2,3,2,4,9,2,2,7,0,4
2948,790976,12,1,1,1,1,0,0,0,0,0,1,0,3,0,0,3,2
2948,788820,23,7,11,2,4,5,7,2,2,0,1,0,3,3,0,0,21
2948,796698,15,0,1,0,0,0,1,2,2,1,1,0,1,0,0,0,2
2948,796701,16,2,3,2,3,0,0,0,0,1,3,0,2,0,1,0,4
2948,790980,3,0,1,0,0,0,1,0,2,0,0,2,0,0,0,0,0
2949,785536,26,5,11,4,5,1,6,6,6,3,2,0,3,1,0,1,17
2949,780119,12,2,3,2,3,0,0,0,2,1,3,1,1,0,1,0,4
2949,796559,39,4,11,2,5,2,6,6,6,2,4,1,2,2,2,0,16
2949,785280,35,8,15,4,8,4,7,3,6,4,2,2,0,2,2,1,23
2949,776097,29,5,8,5,7,0,1,2,2,0,3,4,4,2,2,0,12
2949,780149,27,6,12,4,6,2,6,7,9,0,3,2,1,4,2,2,21
2949,796561,2,0,0,0,0,0,0,0,0,0,0,0,1,0,0,0,0
2949,775679,12,0,2,0,0,0,2,0,0,0,2,1,1,0,0,0,0
2949,796558,13,2,3,2,3,0,0,0,0,1,0,1,0,2,0,0,4
2949,796560,4,0,0,0,0,0,0,0,0,1,1,1,2,0,0,0,0
2949,785285,1,0,0,0,0,0,0,0,0,0,0,0,1,0,0,0,0
2950,796347,32,6,13,6,10,0,3,1,2,1,5,0,3,0,2,0,13
2950,785243,34,5,10,4,6,1,4,3,5,6,8,4,4,0,3,0,14
2950,790788,28,6,9,4,6,2,3,3,3,1,1,2,0,0,2,0,17
2950,781028,38,2,11,1,5,1,6,2,2,2,0,0,0,1,1,0,7
2950,781026,30,5,11,3,5,2,6,0,2,0,3,5,1,2,1,1,12
2950,785242,8,0,1,0,0,0,1,0,0,0,0,1,0,1,0,1,0
2950,781027,6,0,0,0,0,0,0,0,0,0,2,0,1,2,1,0,0
2950,796348,9,1,1,1,1,0,0,0,0,0,1,0,0,0,0,0,2
2950,796349,15,4,5,3,3,1,2,0,0,1,1,0,1,0,0,0,9
2951,791837,38,7,9,4,5,3,4,1,2,0,11,0,1,3,0,2,18
2951,780613,34,6,9,6,9,0,0,3,4,0,3,1,3,1,2,2,15
2951,775097,32,9,13,6,10,3,3,1,1,1,2,4,2,0,1,1,22
2951,780609,37,2,6,1,2,1,4,2,2,0,1,5,0,1,2,0,7
2951,776395,38,6,12,5,8,1,4,3,3,0,1,5,3,0,2,0,16
2951,786621,4,0,1,0,0,0,1,0,0,0,0,0,1,0,0,0,0
2951,786619,13,1,3,1,3,0,0,0,0,0,1,0,0,1,0,0,2
2951,797437,4,0,1,0,1,0,0,0,0,0,1,0,1,0,2,0,0
2952,785305,20,0,2,0,2,0,0,2,2,1,3,1,1,1,0,0,2
2952,785123,34,5,12,5,11,0,1,2,2,1,5,4,1,0,1,3,12
2952,790990,33,9,15,8,11,1,4,2,2,2,2,2,1,0,0,0,21
2952,789219,35,3,9,2,5,1,4,2,3,0,3,6,0,2,1,0,9
2952,785059,30,7,13,6,9,1,4,0,0,2,5,4,0,3,2,0,15
2952,796622,6,1,1,1,1,0,0,0,0,0,2,0,1,0,0,1,2
2952,796623,21,0,3,0,1,0,2,1,2,0,3,0,1,0,1,0,1
2952,785122,18,2,5,0,0,2,5,0,0,1,1,0,1,0,2,0,6
2952,785303,3,0,0,0,0,0,0,0,0,0,0,0,0,0,0,0,0
2953,791669,35,1,6,1,6,0,0,2,2,1,5,0,2,0,3,2,4
2953,785762,25,5,9,5,7,0,2,1,2,2,5,0,2,1,6,1,11
2953,797409,27,4,10,3,6,1,4,0,0,0,0,2,1,1,0,0,9
2953,780535,30,5,9,2,3,3,6,2,3,0,2,0,1,0,1,1,15
2953,780531,37,2,8,2,5,0,3,2,2,0,7,5,0,1,0,0,6
2953,780534,20,3,3,3,3,0,0,0,0,1,3,1,1,1,1,0,6
2953,791666,16,1,4,0,1,1,3,1,2,0,0,1,2,0,3,0,4
2953,785760,10,0,0,0,0,0,0,0,0,0,1,2,0,0,1,0,0
2954,791949,35,8,16,6,11,2,5,2,2,4,5,3,2,2,0,1,20
2954,776014,20,5,9,4,4,1,5,1,2,3,4,0,3,0,1,1,12
2954,797690,28,1,5,1,2,0,3,0,0,1,3,4,0,0,0,0,2
2954,780747,30,3,9,3,7,0,2,0,0,0,0,8,2,1,2,0,6
2954,776363,19,0,5,0,2,0,3,0,0,0,1,1,2,1,1,0,0
2954,781539,12,5,7,5,7,0,0,2,3,0,0,0,1,0,1,0,12
2954,791946,15,1,5,0,2,1,3,0,0,0,2,0,0,0,2,0,3
2954,785304,14,0,1,0,0,0,1,0,0,0,2,0,1,1,1,1,0
2954,784336,6,2,3,2,3,0,0,2,4,1,1,0,3,0,0,0,6
2954,797691,15,2,3,2,3,0,0,0,0,0,1,5,0,0,0,0,4
2954,797689,6,1,2,0,0,1,2,0,0,0,0,1,0,0,0,0,3
2955,780765,32,5,12,4,8,1,4,7,7,2,5,2,1,3,6,1,18
2955,781301,22,3,3,3,3,0,0,1,1,3,2,1,1,0,0,2,7
2955,786255,34,5,9,3,5,2,4,2,2,2,6,2,0,0,0,0,14
2955,780762,22,4,10,4,6,0,4,2,2,0,3,2,1,0,1,0,10
2955,780768,20,1,2,0,1,1,1,0,0,0,3,6,2,0,1,0,3
2955,791729,23,4,7,2,4,2,3,0,0,2,4,1,4,0,0,0,10
2955,780755,20,5,7,5,6,0,1,0,0,0,3,2,2,0,1,0,10
2955,776241,19,4,6,3,3,1,3,2,2,0,4,3,3,0,1,0,11
2955,790864,3,1,2,1,1,0,1,0,0,0,1,0,0,0,0,0,2
2955,797319,2,0,2,0,0,0,2,0,0,0,0,0,1,0,0,0,0
2955,798260,1,0,1,0,1,0,0,0,0,0,0,0,0,0,0,0,0
2955,797320,2,0,0,0,0,0,0,0,0,0,0,0,0,0,0,0,0
2956,796996,27,9,12,9,12,0,0,1,2,5,4,1,1,1,0,1,19
2956,791610,31,3,6,3,6,0,0,0,0,1,5,5,1,1,1,0,6
2956,796994,29,2,3,1,1,1,2,0,2,0,1,1,0,1,1,0,5
2956,791613,25,5,14,4,10,1,4,4,5,4,2,4,1,2,1,0,15
2956,776011,30,9,15,6,10,3,5,3,4,0,1,6,3,1,2,0,24
2956,786413,17,4,6,4,6,0,0,1,1,2,3,3,2,0,1,1,9
2956,791608,23,4,10,1,2,3,8,0,0,0,2,3,1,1,2,0,11
2956,786353,18,1,2,1,2,0,0,0,0,1,2,3,0,1,1,0,2
2958,785409,7,2,2,2,2,0,0,0,0,0,0,0,1,0,0,1,4
2958,785408,35,5,8,4,6,1,2,9,11,0,6,2,2,0,0,0,20
2958,780539,16,0,4,0,0,0,4,0,0,0,1,0,5,0,0,0,0
2958,780560,28,3,6,1,1,2,5,0,0,2,4,3,0,2,1,0,8
2958,776484,38,4,12,3,7,1,5,3,5,0,3,7,2,3,3,0,12
2958,785407,30,8,10,8,9,0,1,5,6,3,2,0,4,1,4,0,21
2958,796416,10,0,3,0,1,0,2,0,0,2,1,2,1,1,3,0,0
2958,796415,26,5,8,4,5,1,3,1,2,0,2,2,2,4,4,0,12
2958,796417,1,0,0,0,0,0,0,0,0,0,0,0,0,0,1,0,0
2958,790861,9,1,1,1,1,0,0,0,2,2,1,0,0,0,0,0,2
2959,790771,17,0,2,0,1,0,1,1,2,0,4,0,5,0,3,0,1
2959,780271,30,5,8,5,5,0,3,2,3,7,5,3,4,0,3,0,12
2959,790772,31,7,16,4,10,3,6,0,0,0,1,0,3,1,2,0,17
2959,785230,34,5,9,1,3,4,6,4,6,0,1,2,3,0,4,0,18
2959,780022,28,4,8,4,5,0,3,3,3,1,4,4,4,1,2,0,11
2959,780375,18,3,5,1,2,2,3,0,0,0,1,1,1,0,1,0,8
2959,780218,24,2,4,1,2,1,2,2,2,0,1,0,3,2,1,1,7
2959,796328,18,1,5,1,4,0,1,0,0,2,0,1,1,1,1,0,2
2960,792186,28,2,3,2,3,0,0,1,3,2,0,1,4,0,2,1,5
2960,781447,12,2,3,2,3,0,0,1,1,2,3,0,4,0,1,0,5
2960,797816,33,5,15,3,5,2,10,1,2,1,2,1,1,0,1,0,13
2960,792183,35,0,7,0,4,0,3,8,9,0,1,3,2,3,5,0,8
2960,786675,24,3,6,2,4,1,2,2,3,1,3,2,2,0,0,0,9
2960,797820,5,0,2,0,2,0,0,0,0,0,0,0,0,0,0,0,0
2960,780433,15,0,1,0,1,0,0,2,2,1,1,1,2,1,1,0,2
2960,781490,17,1,5,0,3,1,2,0,2,1,2,0,1,1,1,0,3
2960,792188,14,2,4,1,1,1,3,0,1,0,3,0,1,1,0,0,5
2960,792187,2,0,0,0,0,0,0,0,0,0,0,0,0,0,1,0,0
2960,792185,15,3,7,0,2,3,5,0,1,0,5,1,3,1,0,0,9
2961,791306,22,4,7,3,5,1,2,1,2,0,1,1,3,0,3,1,10
2961,780210,37,4,7,4,6,0,1,3,5,3,9,1,3,1,1,1,11
2961,796594,28,4,13,3,6,1,7,0,0,2,3,0,3,0,0,0,9
2961,792432,28,2,4,1,2,1,2,0,0,0,2,3,4,0,2,0,5
2961,775005,34,7,13,5,8,2,5,4,6,0,6,0,2,0,4,0,20
2961,796592,10,1,2,1,2,0,0,0,2,0,2,0,0,0,2,0,2
2961,790880,10,2,4,2,4,0,0,0,0,0,2,0,2,0,2,0,4
2961,792433,13,2,5,2,2,0,3,2,2,1,3,0,2,0,0,0,6
2961,786422,18,0,2,0,1,0,1,1,3,2,1,3,3,1,2,0,1
2962,785638,29,5,9,4,5,1,4,3,4,0,2,3,1,0,2,0,14
2962,781326,28,6,9,6,9,0,0,0,2,7,7,0,3,2,1,2,12
2962,792215,20,2,7,2,3,0,4,0,2,0,2,1,1,0,2,0,4
2962,797870,37,4,18,2,12,2,6,8,9,0,9,6,3,1,2,1,18
2962,792210,29,3,6,2,4,1,2,2,4,1,2,2,3,0,5,0,9
2962,792209,33,1,4,0,0,1,4,0,1,0,2,3,1,3,0,0,3
2962,780874,10,0,3,0,3,0,0,2,4,1,3,1,0,1,2,1,2
2962,785430,12,1,2,1,2,0,0,2,4,2,3,0,0,0,0,0,4
2962,792213,2,0,0,0,0,0,0,0,0,0,0,0,0,0,0,0,0
2963,781081,36,3,9,3,7,0,2,0,0,2,6,1,4,0,3,3,6
2963,791864,26,3,7,3,6,0,1,2,3,0,2,0,3,0,3,0,8
2963,797472,31,1,7,0,2,1,5,2,2,0,2,3,1,3,1,1,5
2963,780965,32,6,18,4,9,2,9,2,3,1,3,3,4,2,3,1,16
2963,776447,19,1,3,1,2,0,1,0,0,1,1,2,1,1,2,0,2
2963,797470,21,6,16,5,10,1,6,1,2,3,2,1,5,2,1,0,14
2963,786307,18,3,4,1,2,2,2,0,0,1,6,0,3,1,1,0,8
2963,780195,2,0,0,0,0,0,0,0,0,0,1,0,0,0,0,0,0
2963,797473,15,1,2,1,2,0,0,0,2,3,5,0,4,1,1,3,2
2964,791401,37,8,13,8,13,0,0,5,6,1,5,2,2,0,2,0,21
2964,780125,33,2,4,2,4,0,0,3,6,2,4,1,2,0,0,4,7
2964,797125,37,4,5,4,4,0,1,2,2,1,3,5,2,0,1,0,10
2964,791400,32,5,9,4,5,1,4,5,5,0,3,1,3,2,4,1,16
2964,780118,36,6,12,2,4,4,8,2,2,0,2,4,3,1,2,0,18
2964,786837,16,2,4,2,2,0,2,0,0,0,1,1,2,0,0,0,4
2964,797130,3,0,0,0,0,0,0,0,0,0,1,0,2,1,0,0,0
2964,785931,29,5,9,4,5,1,4,0,0,0,2,1,2,1,3,3,11
2964,797126,2,0,0,0,0,0,0,0,0,0,0,0,0,0,0,0,0
2965,792005,20,4,8,2,5,2,3,0,0,1,1,0,3,0,0,1,10
2965,781175,28,2,4,2,4,0,0,5,6,5,5,1,2,0,5,0,9
2965,786553,35,6,9,2,3,4,6,4,5,0,4,1,1,1,0,0,20
2965,780895,29,6,14,4,12,2,2,1,1,1,1,2,2,2,2,0,15
2965,781172,30,2,7,2,3,0,4,1,2,1,3,2,3,1,2,0,5
2965,781177,19,1,1,1,1,0,0,0,0,0,2,1,3,0,1,1,2
2965,786555,30,3,9,2,2,1,7,0,0,0,3,3,5,1,1,0,7
2965,785312,31,7,13,4,7,3,6,0,1,0,1,3,1,2,3,0,17
2965,797503,3,0,0,0,0,0,0,0,0,0,0,0,0,0,0,0,0
2966,797912,31,4,7,1,3,3,4,0,0,0,3,0,0,1,2,1,11
2966,792306,34,4,9,4,9,0,0,6,7,3,5,3,4,0,3,0,14
2966,797914,24,4,6,0,1,4,5,0,0,0,1,1,3,0,0,0,12
2966,792303,35,6,16,6,12,0,4,6,8,1,2,6,4,3,3,2,18
2966,780456,25,1,10,1,7,0,3,2,2,1,3,1,1,0,1,0,4
2966,786618,12,3,3,3,3,0,0,0,0,2,0,1,2,0,2,0,6
2966,792300,13,2,5,1,3,1,2,0,1,0,2,0,2,1,2,1,5
2966,790813,6,0,1,0,0,0,1,0,0,0,2,0,1,0,0,0,0
2966,781603,16,0,1,0,0,0,1,2,2,0,0,0,2,1,1,0,2
2966,797904,4,0,0,0,0,0,0,0,0,1,0,0,0,0,0,0,0
2967,785368,30,11,13,11,13,0,0,1,4,3,2,1,3,0,0,2,23
2967,780281,27,4,5,3,4,1,1,2,2,1,4,0,4,2,1,3,11
2967,790793,33,3,10,2,6,1,4,2,4,1,9,4,4,0,6,0,9
2967,790792,32,5,8,3,4,2,4,4,4,0,5,4,4,1,1,2,16
2967,785246,29,4,6,2,3,2,3,0,1,0,2,1,2,1,2,2,10
2967,780886,27,4,8,3,5,1,3,4,4,1,3,3,3,2,0,0,13
2967,790794,10,1,1,1,1,0,0,2,4,1,0,0,1,0,1,0,4
2967,790789,4,2,3,2,2,0,1,0,0,0,1,0,2,2,2,0,4
2967,796353,8,0,1,0,0,0,1,1,2,0,1,1,0,1,0,0,1
2968,797830,15,1,4,1,1,0,3,0,0,0,3,0,1,0,1,1,2
2968,792192,26,6,8,6,8,0,0,1,3,3,4,1,0,0,1,0,13
2968,797824,21,1,5,0,0,1,5,1,2,1,0,1,2,2,2,1,4
2968,792190,29,4,8,4,5,0,3,1,2,0,1,4,2,1,2,0,9
2968,786664,35,5,10,4,6,1,4,11,14,0,4,4,2,4,1,0,22
2968,775116,15,2,4,0,0,2,4,0,0,0,1,0,3,1,1,0,6
2968,797822,30,4,7,3,5,1,2,2,4,2,6,1,2,2,4,0,11
2968,792193,9,1,2,1,2,0,0,0,0,0,1,0,2,0,2,1,2
2968,792191,13,1,2,0,1,1,1,0,0,0,4,2,3,1,2,0,3
2968,791928,7,0,2,0,1,0,1,0,0,1,0,3,1,1,0,1,0
2969,775913,15,4,5,4,5,0,0,0,0,0,2,0,3,1,1,0,8
2969,797331,32,5,9,3,4,2,5,2,4,2,0,1,3,0,1,0,14
2969,791737,31,3,8,3,7,0,1,2,4,1,3,8,2,1,4,0,8
2969,783524,24,3,9,1,5,2,4,3,4,0,3,2,2,0,3,0,11
2969,780561,33,3,13,1,5,2,8,0,0,1,8,2,3,0,3,0,8
2969,791734,3,0,1,0,1,0,0,0,0,0,0,0,0,0,0,0,0
2969,781516,19,2,2,2,2,0,0,0,0,0,1,1,4,0,2,0,4
2969,797333,11,1,1,1,1,0,0,0,0,0,0,1,1,0,2,1,2
2969,786223,16,2,5,1,3,1,2,0,0,0,1,0,1,1,1,0,5
2969,786220,13,1,1,1,1,0,0,1,2,0,3,1,0,2,2,0,3
2969,797332,3,0,0,0,0,0,0,0,0,0,0,0,0,0,0,0,0
2970,786257,29,6,8,6,8,0,0,4,5,3,3,1,3,1,3,0,16
2970,786263,15,2,4,1,1,1,3,2,2,1,3,0,3,0,0,0,7
2970,797724,31,3,6,2,3,1,3,3,4,1,8,1,3,1,3,0,10
2970,785661,30,3,5,3,5,0,0,0,0,0,4,1,2,1,4,0,6
2970,775825,38,3,11,2,7,1,4,10,11,2,4,7,1,3,1,0,17
2970,797721,7,1,1,0,0,1,1,0,0,0,0,1,0,0,0,0,3
2970,792121,23,0,2,0,1,0,1,0,0,5,5,1,3,0,5,0,0
2970,797725,9,1,3,1,3,0,0,0,0,1,2,0,1,0,0,0,2
2970,792356,3,1,1,1,1,0,0,0,0,0,0,0,0,0,0,0,2
2970,786249,15,0,4,0,1,0,3,0,0,0,1,0,2,0,0,0,0
2971,798157,18,1,1,1,1,0,0,1,1,1,1,0,4,1,0,1,3
2971,786635,35,6,11,6,8,0,3,4,5,1,4,2,4,0,3,0,16
2971,781543,25,0,4,0,4,0,0,2,3,0,1,1,2,2,3,0,2
2971,780642,28,4,11,4,11,0,0,2,2,0,0,0,2,2,2,0,10
2971,776449,33,1,12,1,9,0,3,0,0,1,2,1,4,1,2,0,2
2971,797383,3,0,0,0,0,0,0,0,0,0,0,0,1,0,0,0,0
2971,791823,15,1,2,0,1,1,1,1,2,1,0,0,2,1,0,0,4
2971,797385,3,0,0,0,0,0,0,0,0,0,1,0,0,0,0,0,0
2971,797384,8,0,2,0,1,0,1,0,1,0,2,0,0,0,0,0,0
2971,786632,7,0,1,0,1,0,0,0,0,0,0,0,0,0,0,0,0
2971,781388,25,2,3,0,1,2,2,2,3,0,0,0,3,1,1,0,8
2976,789101,25,3,5,2,3,1,2,0,0,0,3,1,3,0,1,0,7
2976,789102,31,3,7,3,7,0,0,4,8,0,13,10,3,1,3,0,10
2976,781371,25,4,7,2,3,2,4,0,1,3,0,1,2,1,1,0,10
2976,781367,10,4,5,1,1,3,4,0,0,0,1,0,5,0,1,2,11
2976,797731,9,2,2,2,2,0,0,1,1,1,0,0,3,0,0,0,5
2976,792066,22,6,8,6,8,0,0,2,3,5,3,1,3,0,3,0,14
2976,792064,12,2,5,1,2,1,3,0,0,0,1,0,0,0,0,0,5
2976,792063,17,0,2,0,1,0,1,0,0,1,2,0,2,3,2,0,0
2976,792061,12,1,3,1,1,0,2,0,0,0,2,0,1,0,1,0,2
2976,788037,23,5,9,3,5,2,4,3,4,0,2,5,3,1,5,0,15
2976,785459,14,7,10,7,10,0,0,1,1,1,1,1,2,0,1,0,15
2977,791062,37,4,12,3,7,1,5,6,8,0,4,1,3,1,3,1,15
2977,791060,33,6,13,6,12,0,1,0,0,1,4,5,5,2,6,0,12
2977,785542,31,1,2,1,2,0,0,2,4,0,1,1,2,1,1,1,4
2977,780743,37,5,14,2,7,3,7,7,9,0,2,2,2,1,2,0,20
2977,780055,29,4,4,4,4,0,0,4,5,0,2,0,0,0,0,0,12
2977,785548,13,1,3,1,3,0,0,2,2,2,1,0,1,0,1,0,4
2977,791064,20,2,4,1,2,1,2,4,5,0,1,1,4,0,0,0,9
2978,797463,32,4,8,4,7,0,1,5,5,2,3,2,2,2,2,0,13
2978,791109,30,4,14,4,12,0,2,4,6,5,4,3,2,2,2,0,12
2978,785625,28,4,13,1,6,3,7,1,1,1,4,1,3,1,0,0,12
2978,797469,36,4,7,3,4,1,3,1,2,0,2,2,2,1,2,1,10
2978,791858,21,0,4,0,0,0,4,3,4,0,3,0,4,0,1,0,3
2978,797464,20,3,7,1,4,2,3,0,0,1,3,0,3,1,2,0,8
2978,797467,13,3,3,2,2,1,1,0,0,1,0,0,0,0,0,0,7
2978,791854,11,0,0,0,0,0,0,0,0,0,0,1,1,1,0,0,0
2978,797468,7,0,1,0,1,0,0,0,0,1,0,0,2,0,0,0,0
2978,797465,2,0,0,0,0,0,0,0,0,0,1,0,1,0,1,0,0
2979,785622,29,4,6,2,2,2,4,6,6,2,2,1,2,0,2,0,16
2979,780327,28,5,11,5,11,0,0,3,4,6,5,0,1,2,1,0,13
2979,797451,26,4,11,4,9,0,2,4,4,0,2,0,0,0,4,0,12
2979,781058,27,2,5,2,5,0,0,3,5,3,3,1,4,1,1,0,7
2979,791849,33,2,7,0,1,2,6,0,0,1,3,3,4,0,1,0,6
2979,797458,21,1,5,0,1,1,4,0,0,0,2,3,4,0,3,0,3
2979,786607,14,0,3,0,0,0,3,3,3,0,1,1,3,0,1,0,3
2979,797455,9,1,1,1,1,0,0,1,2,0,2,0,1,0,0,0,3
2979,797453,6,0,2,0,2,0,0,0,0,0,0,0,1,0,1,0,0
2979,791848,6,0,1,0,0,0,1,0,0,0,3,0,1,1,0,0,0
2979,797452,1,0,0,0,0,0,0,0,0,0,0,0,0,0,0,0,0
2980,790897,17,2,5,1,1,1,4,0,0,0,3,0,1,0,2,0,5
2980,785442,24,3,8,3,3,0,5,5,7,2,5,0,3,1,2,0,11
2980,790898,20,3,7,3,6,0,1,4,4,0,4,2,5,3,2,0,10
2980,785579,37,4,9,2,5,2,4,5,7,0,7,4,2,2,1,0,15
2980,775959,29,3,6,1,1,2,5,0,0,0,2,2,2,0,1,1,8
2980,790899,19,2,5,2,5,0,0,3,4,3,2,1,2,1,3,0,7
2980,785447,3,0,0,0,0,0,0,0,0,0,0,1,1,0,0,0,0
2980,785448,26,1,3,1,1,0,2,1,1,0,5,0,4,0,3,0,3
2980,799907,25,4,8,3,6,1,2,2,2,0,1,4,3,0,2,0,11
2982,776004,26,8,15,7,12,1,3,1,2,3,8,2,1,0,2,0,18
2982,780358,19,3,7,3,7,0,0,1,2,3,3,0,2,0,1,1,7
2982,775011,28,6,10,4,5,2,5,0,0,0,3,2,1,0,1,2,14
2982,780357,28,2,7,1,4,1,3,0,0,2,4,2,3,0,1,0,5
2982,775018,33,6,11,4,8,2,3,0,0,0,5,5,3,2,2,0,14
2982,796480,30,4,7,4,6,0,1,0,1,0,3,0,2,1,1,0,8
2982,776270,16,1,2,1,2,0,0,0,0,0,1,0,2,0,1,0,2
2982,790930,17,0,0,0,0,0,0,3,3,0,0,1,1,0,0,0,3
2982,796485,1,0,0,0,0,0,0,0,0,0,0,0,0,0,0,0,0
2982,796486,1,0,0,0,0,0,0,0,0,0,0,0,0,0,0,0,0
2982,785496,1,0,0,0,0,0,0,0,0,0,0,0,0,0,0,0,0
2983,776462,29,5,10,5,8,0,2,2,2,4,5,0,1,0,0,3,12
2983,785635,31,4,11,4,9,0,2,4,5,4,5,0,4,0,2,3,12
2983,786440,36,4,12,1,2,3,10,4,5,4,3,2,0,0,3,0,15
2983,786720,20,2,4,1,1,1,3,0,0,0,0,2,2,1,2,0,5
2983,781199,37,3,13,1,5,2,8,2,2,2,3,7,4,0,2,0,10
2983,791628,11,0,1,0,0,0,1,0,0,0,1,0,1,0,0,0,0
2983,796974,20,1,7,0,4,1,3,0,0,0,4,0,1,0,1,0,3
2983,791629,7,0,4,0,2,0,2,0,0,0,2,0,1,0,0,0,0
2983,775642,9,1,2,1,2,0,0,0,0,1,0,1,1,0,0,0,2
2984,797877,29,5,14,5,13,0,1,2,2,1,12,2,3,1,2,1,12
2984,781599,31,1,5,1,5,0,0,0,0,2,1,1,1,0,0,1,2
2984,797872,29,4,8,4,6,0,2,0,1,1,3,2,4,1,2,0,8
2984,791338,29,2,4,2,3,0,1,1,2,0,2,2,4,1,1,2,5
2984,781595,22,0,7,0,2,0,5,0,0,0,0,3,0,1,1,0,0
2984,797873,6,0,1,0,1,0,0,0,0,0,0,0,0,0,0,0,0
2984,791335,14,0,4,0,2,0,2,0,0,0,1,0,5,0,0,0,0
2984,797875,11,3,4,2,2,1,2,0,0,0,3,3,1,0,7,0,7
2984,797874,29,6,9,1,2,5,7,0,1,0,2,0,0,1,0,0,17
2985,785948,36,2,5,2,5,0,0,0,0,1,7,0,2,1,0,0,4
2985,792020,36,3,9,3,7,0,2,6,6,2,2,4,3,0,3,0,12
2985,785941,34,3,10,1,4,2,6,3,4,0,14,0,2,0,3,2,11
2985,785939,35,5,14,5,11,0,3,8,8,3,3,2,2,2,4,0,18
2985,785938,29,3,7,3,4,0,3,0,0,0,1,0,1,2,0,0,6
2985,792025,2,0,0,0,0,0,0,0,0,0,0,0,0,0,0,0,0
2985,792023,20,2,6,2,4,0,2,0,0,0,2,1,2,0,2,0,4
2985,785946,8,2,2,1,1,1,1,0,0,0,0,0,2,0,1,0,5
2986,786769,20,2,4,2,4,0,0,0,0,1,1,0,0,1,1,1,4
2986,786024,24,1,8,1,6,0,2,0,0,1,2,2,1,0,1,1,2
2986,780002,37,8,21,5,8,3,13,4,6,0,2,2,1,3,1,0,23
2986,786772,25,0,3,0,3,0,0,0,0,4,4,0,4,0,0,0,0
2986,781484,22,2,10,2,2,0,8,0,0,0,4,1,4,1,2,0,4
2986,791970,14,1,8,0,4,1,4,0,0,0,2,0,2,1,1,1,3
2986,785441,22,2,3,2,2,0,1,1,2,0,5,0,1,1,1,0,5
2986,797840,25,2,4,1,2,1,2,2,3,1,1,1,1,0,3,0,7
2986,786773,7,1,2,1,2,0,0,0,0,1,0,0,1,0,0,0,2
2986,776046,1,1,1,0,0,1,1,0,0,0,0,0,0,0,0,0,3
2986,789095,1,0,0,0,0,0,0,0,0,0,0,0,0,1,0,0,0
2986,797837,1,0,0,0,0,0,0,0,0,0,0,1,0,0,0,0,0
2986,789094,1,0,0,0,0,0,0,0,0,0,0,0,0,0,0,0,0
2987,786289,26,3,8,0,1,3,7,0,0,0,3,1,3,0,1,3,9
2987,796332,21,1,5,1,4,0,1,2,2,1,3,4,0,1,1,1,4
2987,785813,31,3,7,1,3,2,4,0,0,0,3,4,1,2,3,0,8
2987,796334,18,3,9,3,9,0,0,4,6,3,4,3,4,0,2,0,10
2987,779975,14,3,5,3,5,0,0,0,2,1,2,1,3,0,1,1,6
2987,790776,15,2,6,2,6,0,0,4,8,2,4,0,1,0,1,1,8
2987,796330,25,4,9,3,6,1,3,4,4,2,4,0,2,2,0,0,13
2987,785827,20,5,12,5,12,0,0,2,4,4,3,0,1,0,0,0,12
2987,796337,22,5,6,5,6,0,0,0,0,0,5,1,1,1,0,1,10
2987,796333,5,0,2,0,0,0,2,0,0,0,1,0,0,0,1,0,0
2987,796335,1,0,0,0,0,0,0,0,0,0,0,0,0,0,0,0,0
2987,779973,1,0,0,0,0,0,0,0,0,0,0,0,0,0,0,0,0
2987,796338,1,0,0,0,0,0,0,0,0,0,0,0,0,0,0,0,0
2988,791585,39,7,10,2,5,5,5,0,0,1,5,2,1,0,2,1,19
2988,780062,10,1,2,1,2,0,0,0,0,0,2,0,2,0,1,1,2
2988,786395,36,6,13,3,7,3,6,1,2,0,1,3,1,1,1,0,16
2988,786394,28,2,11,1,8,1,3,0,0,0,2,6,4,0,3,0,5
2988,780404,16,2,3,2,3,0,0,0,0,1,2,1,1,1,1,0,4
2988,791582,6,0,1,0,1,0,0,0,0,0,0,0,0,0,0,0,0
2988,785228,26,5,9,2,4,3,5,2,2,1,1,2,1,1,0,0,15
2988,791581,25,3,6,2,4,1,2,1,2,1,2,0,1,1,1,0,8
2988,797041,6,1,2,1,1,0,1,0,0,0,0,0,1,0,0,0,2
2988,780403,7,1,1,1,1,0,0,0,0,2,0,0,1,0,1,0,2
2988,797037,1,0,0,0,0,0,0,0,0,0,0,0,0,0,0,0,0
2989,780011,36,3,8,3,4,0,4,4,4,0,3,4,0,2,2,1,10
2989,780012,26,1,5,0,2,1,3,4,4,0,3,0,0,0,1,1,7
2989,796309,32,10,11,10,11,0,0,6,7,4,7,1,3,0,3,1,26
2989,790824,37,8,14,5,7,3,7,0,0,0,2,4,2,3,0,1,19
2989,775667,38,5,7,3,5,2,2,4,5,0,6,6,2,0,2,0,16
2989,781524,21,0,3,0,0,0,3,0,0,0,3,0,1,0,2,1,0
2989,785370,10,3,3,3,3,0,0,0,0,1,0,0,2,0,2,1,6
2990,797546,20,1,4,1,4,0,0,3,7,5,3,0,3,1,3,0,5
2990,780351,29,3,10,3,10,0,0,8,14,5,6,4,4,1,5,1,14
2990,797549,29,3,9,3,8,0,1,2,5,2,3,4,2,3,1,1,8
2990,790857,26,0,5,0,2,0,3,0,0,1,4,2,2,0,3,0,0
2990,780586,25,6,14,4,8,2,6,1,7,1,2,1,3,0,2,0,15
2990,797544,12,2,6,2,6,0,0,0,0,1,1,0,1,0,1,0,4
2990,797545,7,1,1,1,1,0,0,0,0,0,2,0,2,0,0,0,2
2990,797540,7,0,1,0,0,0,1,1,2,1,0,0,0,0,0,0,1
2990,791716,14,1,3,1,3,0,0,0,0,1,1,1,3,0,1,0,2
2990,791715,19,0,4,0,2,0,2,0,0,0,2,1,2,1,0,1,0
2990,785855,12,1,1,0,0,1,1,0,0,0,1,0,1,0,0,0,3
2991,791699,30,1,8,1,5,0,3,1,2,2,8,0,2,1,2,0,3
2991,797523,26,0,1,0,0,0,1,8,8,0,4,1,4,2,2,0,8
2991,785402,18,3,4,3,4,0,0,4,7,2,4,0,5,0,3,1,10
2991,792118,38,7,15,6,12,1,3,5,6,1,3,2,1,2,2,0,20
2991,782593,35,8,18,5,9,3,9,5,6,1,2,0,3,1,2,1,24
2991,785828,15,1,3,1,2,0,1,0,0,0,2,0,5,0,1,2,2
2991,791702,7,0,1,0,1,0,0,0,0,1,1,1,2,0,2,0,0
2991,797525,11,0,0,0,0,0,0,1,2,0,2,1,3,0,0,0,1
2991,791700,20,0,2,0,1,0,1,0,0,0,3,0,3,1,1,0,0
2992,790893,26,4,7,3,6,1,1,0,0,1,4,1,4,0,4,1,9
2992,796444,38,5,14,5,12,0,2,2,5,2,5,0,2,0,5,2,12
2992,786615,25,2,7,2,5,0,2,0,0,0,3,4,2,1,2,0,4
2992,786732,17,1,3,1,3,0,0,0,0,1,3,0,0,2,0,0,2
2992,775260,33,5,11,1,2,4,9,2,2,0,3,5,2,1,1,0,16
2992,790889,28,2,7,0,1,2,6,0,0,1,3,1,2,0,2,0,6
2992,775536,16,2,8,2,7,0,1,3,3,5,1,1,2,2,0,0,7
2992,780702,17,2,3,0,0,2,3,0,0,0,0,1,2,1,1,0,6
2993,780919,34,5,10,5,10,0,0,1,1,2,3,2,2,0,3,1,11
2993,775816,27,3,10,1,6,2,4,2,2,2,3,0,2,1,3,0,10
2993,785803,22,0,2,0,1,0,1,0,0,1,2,1,3,1,1,0,0
2993,780920,34,7,13,6,11,1,2,4,5,0,4,4,3,3,1,0,19
2993,780914,32,3,9,2,4,1,5,6,6,2,8,1,3,0,1,0,13
2993,791142,17,2,6,0,1,2,5,0,0,1,1,2,1,0,0,0,6
2993,796799,6,0,2,0,0,0,2,1,2,0,0,0,1,0,0,0,1
2993,791141,13,2,4,1,3,1,1,0,0,0,1,1,0,0,1,0,5
2993,796797,15,3,4,2,2,1,2,0,0,1,4,1,1,1,1,1,7
2996,780023,37,4,5,4,5,0,0,4,6,2,9,1,1,0,0,7,12
2996,792490,31,4,9,1,5,3,4,0,0,0,3,0,1,1,0,1,11
2996,792493,22,0,2,0,0,0,2,0,0,1,1,1,2,0,2,0,0
2996,792495,31,9,17,6,9,3,8,2,5,2,3,5,4,0,3,1,23
2996,792491,34,4,9,4,9,0,0,0,2,0,1,4,3,1,6,0,8
2996,793441,6,1,1,0,0,1,1,0,0,0,1,0,1,0,0,0,3
2996,788128,4,0,1,0,1,0,0,0,0,0,2,0,0,0,1,1,0
2996,786832,3,0,0,0,0,0,0,0,0,0,0,0,0,0,0,0,0
2996,781144,32,5,12,3,5,2,7,0,0,1,5,0,0,1,1,1,12
2997,791289,16,6,7,6,7,0,0,1,1,1,2,0,3,0,1,0,13
2997,785786,27,1,4,1,2,0,2,0,0,1,0,1,2,0,1,3,2
2997,796571,34,7,15,4,9,3,6,5,5,1,6,1,1,2,0,0,22
2997,791290,27,2,3,2,2,0,1,0,2,0,1,1,1,0,0,1,4
2997,781346,31,5,14,0,5,5,9,2,2,0,2,6,1,1,1,0,17
2997,791287,3,0,0,0,0,0,0,0,0,0,0,0,0,0,0,0,0
2997,796576,26,3,10,0,2,3,8,0,0,0,8,4,1,2,1,0,9
2997,796574,14,1,3,0,1,1,2,0,0,0,1,1,1,0,2,0,3
2997,791288,8,1,2,1,1,0,1,0,0,0,0,2,2,0,0,0,2
2997,796572,14,3,5,2,4,1,1,1,2,1,3,2,1,1,1,0,8
2998,797109,28,4,8,4,7,0,1,2,2,1,4,1,4,1,1,0,10
2998,791403,13,1,3,1,3,0,0,0,0,1,2,0,4,0,3,1,2
2998,791407,34,10,21,8,14,2,7,12,12,0,9,4,1,2,2,0,34
2998,785928,39,5,9,3,7,2,2,3,5,1,3,2,2,2,0,0,15
2998,785923,33,4,6,4,6,0,0,3,4,1,5,7,1,2,2,1,11
2998,797113,2,1,1,1,1,0,0,0,0,0,0,0,0,0,0,0,2
2998,797111,9,0,0,0,0,0,0,0,1,1,2,1,2,1,1,1,0
2998,797117,1,0,0,0,0,0,0,1,2,1,0,0,1,0,0,0,1
2998,797110,17,4,9,2,2,2,7,0,0,0,2,0,2,1,0,0,10
2998,797115,8,0,1,0,1,0,0,0,0,0,0,1,1,0,1,0,0
2998,797114,16,3,4,3,4,0,0,1,1,0,1,2,5,1,5,0,7
3000,797174,27,4,11,2,8,2,3,2,3,0,7,1,3,0,2,0,12
3000,786699,22,2,4,2,4,0,0,4,4,2,3,0,3,1,1,1,8
3000,785593,30,2,8,2,5,0,3,1,2,0,3,0,1,1,2,0,5
3000,775357,27,2,6,1,4,1,2,0,0,1,2,3,4,1,3,0,5
3000,791510,24,2,4,1,2,1,2,0,0,0,4,0,1,0,0,0,5
3000,791504,21,5,9,5,8,0,1,4,4,0,1,1,1,2,0,1,14
3000,797168,26,3,8,3,7,0,1,2,2,0,8,2,0,1,1,0,8
3000,791509,17,4,5,4,5,0,0,0,1,2,1,0,2,1,1,1,8
3000,797169,6,0,0,0,0,0,0,0,0,0,1,0,1,1,0,0,0
3001,780552,35,7,17,2,5,5,12,0,0,0,3,0,2,0,0,0,19
3001,780550,30,4,10,3,7,1,3,1,2,3,2,6,1,1,5,0,10
3001,780538,24,2,9,2,6,0,3,2,6,1,3,5,2,1,3,0,6
3001,785791,17,1,6,0,1,1,5,0,0,0,3,0,1,0,0,0,3
3001,775606,29,1,4,1,4,0,0,0,0,4,9,1,3,0,2,3,2
3001,791672,20,3,4,3,4,0,0,2,2,2,0,0,0,1,1,0,8
3001,791674,30,2,5,1,2,1,3,1,2,0,1,0,2,3,3,0,6
3001,797423,3,0,0,0,0,0,0,1,2,0,0,0,0,0,0,0,1
3001,797424,7,0,1,0,1,0,0,0,0,0,1,0,1,0,0,0,0
3001,785793,5,0,2,0,0,0,2,0,0,0,1,0,3,0,1,1,0
3002,792473,23,5,8,5,7,0,1,1,2,1,3,3,3,0,4,0,11
3002,780043,28,2,3,1,1,1,2,1,2,0,1,1,2,0,7,1,6
3002,799276,32,1,2,0,0,1,2,2,2,0,2,1,0,2,1,0,5
3002,785249,31,1,5,0,2,1,3,1,1,2,3,3,1,0,3,0,4
3002,780035,27,3,6,3,4,0,2,0,1,0,0,3,1,0,4,0,6
3002,792471,3,0,0,0,0,0,0,0,0,0,0,0,1,0,1,0,0
3002,785251,12,2,5,0,0,2,5,0,0,1,2,0,0,0,0,1,6
3002,799281,13,0,2,0,0,0,2,2,4,1,0,1,1,1,1,0,2
3002,792477,11,0,1,0,0,0,1,0,0,0,1,0,0,0,1,0,0
3002,792476,2,0,0,0,0,0,0,0,0,0,1,0,0,0,0,0,0
3002,780036,18,3,4,3,3,0,1,2,2,0,1,0,2,0,2,0,8
3003,781579,21,6,10,4,7,2,3,1,2,4,0,5,2,3,0,0,15
3003,786731,23,5,7,5,7,0,0,0,0,3,2,5,0,2,0,1,10
3003,798023,25,1,4,1,1,0,3,2,2,3,2,3,3,1,1,0,4
3003,781584,23,5,10,1,1,4,9,0,0,0,1,2,2,2,1,0,14
3003,798021,1,0,0,0,0,0,0,0,0,0,0,0,1,0,1,0,0
3003,775696,14,1,6,0,2,1,4,0,0,0,2,0,2,0,0,0,3
3003,798026,4,0,1,0,1,0,0,0,0,2,0,0,2,0,0,0,0
3003,776481,12,2,2,2,2,0,0,0,0,1,1,0,4,1,3,0,4
3003,798019,5,0,2,0,0,0,2,0,0,0,1,0,0,0,1,0,0
3003,798017,8,1,4,1,3,0,1,0,0,1,2,0,0,1,0,0,2
3003,798008,20,4,6,2,2,2,4,0,0,0,0,2,1,1,0,0,10
3003,792358,16,4,8,3,6,1,2,0,1,0,4,1,2,0,1,0,9
3003,780347,25,5,5,3,3,2,2,0,1,1,1,6,2,0,0,0,12
3003,798018,2,0,0,0,0,0,0,0,0,0,0,0,0,0,0,0,0
3003,792360,1,0,0,0,0,0,0,0,0,0,0,0,0,0,0,0,0
3004,791750,30,3,6,1,4,2,2,1,2,0,8,1,1,1,2,0,9
3004,786177,31,2,9,1,3,1,6,3,4,3,5,1,2,0,1,0,8
3004,780244,28,3,7,1,2,2,5,0,0,0,1,0,4,2,1,1,8
3004,786179,34,2,9,2,7,0,2,3,4,0,5,3,2,2,3,0,7
3004,780238,37,8,16,7,12,1,4,7,10,0,7,5,1,0,2,1,24
3004,791752,19,3,4,3,4,0,0,2,2,3,1,1,3,0,0,0,8
3004,790773,13,1,3,1,2,0,1,2,2,0,1,0,2,0,1,0,4
3004,781500,5,1,2,1,2,0,0,0,0,0,0,0,1,0,1,0,2
3004,785909,3,0,0,0,0,0,0,0,0,0,0,0,0,0,0,0,0
3005,782643,25,5,6,5,6,0,0,2,4,0,5,0,2,0,4,0,12
3005,776037,30,6,11,6,10,0,1,3,6,2,6,2,4,1,2,0,15
3005,786147,28,1,5,1,2,0,3,2,2,0,3,3,5,1,1,1,4
3005,780667,34,6,12,5,9,1,3,1,1,0,3,1,1,1,3,0,14
3005,775680,33,3,10,1,3,2,7,1,2,0,4,2,4,0,1,0,9
3005,785987,22,1,4,0,2,1,2,0,0,0,1,1,3,0,1,0,3
3005,781647,14,1,3,0,1,1,2,0,0,0,3,0,1,0,1,0,3
3005,780588,14,1,2,1,2,0,0,0,0,0,2,0,1,1,1,0,2
3006,780283,20,1,6,1,6,0,0,0,0,3,2,1,1,0,1,0,2
3006,790925,34,3,9,1,6,2,3,2,4,3,2,1,2,1,0,0,10
3006,791456,24,5,8,3,4,2,4,1,1,0,1,1,1,0,1,1,13
3006,785476,37,4,9,3,7,1,2,0,0,0,4,10,1,2,4,0,9
3006,780285,22,7,9,5,7,2,2,0,0,1,3,2,4,0,2,0,16
3006,785474,26,5,10,3,5,2,5,1,1,1,2,1,2,1,0,1,13
3006,780292,20,0,0,0,0,0,0,6,8,1,4,0,1,1,0,1,6
3006,790926,10,1,5,0,1,1,4,0,0,0,0,0,1,0,0,0,3
3006,785480,7,0,0,0,0,0,0,0,0,0,0,0,0,0,0,0,0
3006,796470,0,0,0,0,0,0,0,0,0,0,1,0,0,0,0,0,0
3007,792351,34,5,7,4,5,1,2,0,0,1,4,1,5,0,2,0,11
3007,786723,35,8,14,8,12,0,2,2,3,2,4,3,0,1,2,0,18
3007,792349,15,1,2,1,2,0,0,0,0,0,0,1,2,0,0,2,2
3007,792355,35,7,16,3,5,4,11,4,5,1,5,0,1,0,0,0,22
3007,792352,25,2,3,0,1,2,2,0,0,0,2,4,5,1,2,0,6
3007,786724,24,1,5,0,2,1,3,2,2,1,3,1,2,0,0,0,5
3007,798061,8,1,2,1,2,0,0,1,2,0,1,0,0,0,0,0,3
3007,798060,18,1,3,0,1,1,2,0,0,0,0,0,2,0,3,0,3
3007,786726,3,0,0,0,0,0,0,0,0,0,1,0,0,0,0,0,0
3007,792348,3,0,0,0,0,0,0,0,0,0,0,0,0,0,0,0,0
3008,781650,15,3,5,3,5,0,0,3,5,1,1,0,3,0,2,0,9
3008,797070,25,3,8,2,3,1,5,0,0,1,2,1,1,0,3,0,7
3008,797068,17,0,2,0,0,0,2,0,0,0,4,3,3,0,2,0,0
3008,791432,27,5,8,3,4,2,4,0,0,0,1,2,2,0,2,0,12
3008,777865,29,3,10,2,5,1,5,4,4,1,2,3,4,0,2,0,11
3008,797066,18,3,4,3,4,0,0,0,2,2,4,1,4,0,1,0,6
3008,780180,22,1,2,0,1,1,1,0,3,2,3,1,1,0,0,1,3
3008,797067,9,1,2,1,2,0,0,0,0,2,2,0,2,0,0,1,2
3008,791429,24,2,9,2,7,0,2,1,1,0,5,4,0,0,0,0,5
3008,781203,14,3,4,1,1,2,3,2,3,0,2,0,1,0,1,0,10
3009,797587,15,3,8,3,8,0,0,1,1,4,2,0,5,0,1,1,7
3009,791894,3,0,0,0,0,0,0,0,0,0,1,1,0,0,0,0,0
3009,786502,37,7,16,6,14,1,2,9,11,0,7,7,2,1,2,0,24
3009,781561,21,4,10,4,8,0,2,0,0,1,2,2,1,0,1,0,8
3009,781080,34,6,9,2,3,4,6,1,1,0,4,0,3,2,1,0,17
3009,791891,17,4,6,4,5,0,1,0,1,1,2,0,3,0,0,0,8
3009,786501,22,3,9,0,3,3,6,0,0,0,3,0,0,0,0,0,9
3009,781078,18,2,4,1,1,1,3,0,0,1,2,0,5,0,0,1,5
3009,797584,31,0,1,0,0,0,1,0,2,1,3,3,1,0,1,0,0
3009,791895,2,0,0,0,0,0,0,0,0,0,0,0,0,0,0,0,0
3010,791743,25,3,8,3,8,0,0,7,8,1,3,0,1,0,1,0,13
3010,797342,6,1,1,1,1,0,0,0,0,1,1,0,2,0,1,0,2
3010,791747,26,3,12,3,9,0,3,3,5,2,1,1,3,2,3,0,9
3010,791746,23,1,4,1,3,0,1,1,1,0,5,1,4,0,2,0,3
3010,786193,27,1,10,0,3,1,7,4,5,0,3,1,0,1,0,0,7
3010,797345,14,2,5,2,5,0,0,1,2,0,1,0,3,0,1,0,5
3010,797343,26,2,7,1,3,1,4,1,2,0,3,0,2,0,1,0,6
3010,791744,7,1,2,1,2,0,0,0,0,2,1,2,2,0,1,0,2
3010,797341,21,0,7,0,3,0,4,0,0,1,4,3,4,1,3,1,0
3010,780711,25,1,7,0,0,1,7,4,4,0,3,0,2,1,2,0,7
3011,781174,20,0,2,0,2,0,0,6,6,1,5,1,2,0,0,1,6
3011,781159,28,4,8,3,4,1,4,3,3,3,11,1,2,0,3,0,12
3011,791001,28,5,8,4,6,1,2,2,2,0,6,3,1,0,1,0,13
3011,779972,20,5,11,2,5,3,6,0,0,0,3,2,2,0,1,1,13
3011,796643,10,1,1,1,1,0,0,0,0,1,2,2,4,0,0,0,2
3011,796640,3,1,1,1,1,0,0,0,0,0,0,0,0,0,0,0,2
3011,796644,6,1,2,1,2,0,0,2,2,2,0,0,3,0,0,0,4
3011,796641,7,1,3,1,1,0,2,0,0,0,2,0,0,0,1,0,2
3011,791601,2,0,1,0,1,0,0,0,0,0,0,1,0,1,0,0,0
3011,796639,3,0,2,0,1,0,1,0,0,1,0,0,0,0,0,0,0
3011,785320,21,4,9,3,6,1,3,2,2,1,3,3,0,0,1,0,11
3011,781215,23,6,11,4,6,2,5,4,4,1,6,2,4,1,1,0,18
3011,775255,29,7,14,4,5,3,9,6,6,0,1,2,1,2,1,0,23
3012,780094,31,4,10,2,5,2,5,3,4,2,4,1,2,0,1,1,13
3012,775142,36,10,14,9,10,1,4,5,9,2,4,0,1,5,1,0,26
3012,790843,31,6,13,1,3,5,10,2,2,2,1,1,2,1,2,0,19
3012,786212,31,4,14,2,10,2,4,1,2,0,5,2,3,1,0,1,11
3012,781563,26,1,3,1,3,0,0,2,2,0,0,5,5,1,2,0,4
3012,790844,14,1,1,1,1,0,0,1,1,2,3,1,2,1,2,1,3
3012,792125,21,2,6,1,3,1,3,1,1,0,4,1,3,0,1,0,6
3012,790847,10,0,0,0,0,0,0,0,0,1,1,0,1,0,0,0,0
3012,781161,0,0,0,0,0,0,0,0,0,0,0,0,0,0,0,0,0
3013,791058,18,2,4,2,4,0,0,1,2,3,4,0,5,0,2,0,5
3013,785532,32,4,6,4,6,0,0,0,1,0,7,1,2,1,1,0,8
3013,791055,18,1,3,1,3,0,0,3,4,0,0,4,2,0,2,0,5
3013,785530,33,6,10,2,3,4,7,5,5,0,3,3,3,1,5,0,21
3013,775926,34,2,11,1,4,1,7,0,0,0,5,1,2,0,2,0,5
3013,791057,13,0,1,0,1,0,0,4,4,0,2,0,4,0,1,0,4
3013,775573,25,4,9,0,0,4,9,2,2,1,1,0,0,0,1,0,14
3013,791059,13,1,1,1,1,0,0,1,2,0,3,1,3,0,1,0,3
3013,791280,8,1,2,0,0,1,2,1,2,0,1,0,0,0,1,0,4
3013,796733,5,0,0,0,0,0,0,0,0,0,0,0,0,0,0,0,0
3013,791056,1,0,0,0,0,0,0,0,0,0,0,0,0,0,0,0,0
3013,796734,0,0,0,0,0,0,0,0,0,0,0,0,0,0,0,0,0
3022,797109,24,4,5,2,3,2,2,1,2,1,3,1,4,0,4,1,11
3022,791403,24,9,12,9,11,0,1,2,2,4,9,0,4,1,4,1,20
3022,791407,35,6,14,5,9,1,5,6,7,0,4,6,2,3,1,0,19
3022,785928,33,2,7,2,3,0,4,2,6,4,1,3,2,0,2,0,6
3022,785923,33,1,2,1,1,0,1,1,2,0,5,4,1,1,1,0,3
3022,797113,2,0,0,0,0,0,0,0,1,0,0,0,1,0,0,0,0
3022,797111,3,1,1,1,1,0,0,0,0,0,0,0,0,0,0,0,2
3022,797117,6,2,3,2,3,0,0,1,2,2,3,0,1,0,1,1,5
3022,797110,20,5,10,3,4,2,6,1,2,1,2,1,0,0,1,1,13
3022,797114,20,1,5,1,3,0,2,0,0,0,2,0,1,2,1,0,2
3024,791839,33,5,6,5,6,0,0,2,2,2,9,8,2,3,2,1,12
3024,785322,34,2,8,1,2,1,6,0,1,1,3,0,1,1,1,0,5
3024,792381,35,13,19,5,6,8,13,2,3,0,2,4,1,1,2,0,36
3024,791842,29,6,12,2,4,4,8,5,6,1,6,0,2,1,1,0,21
3024,786616,30,6,10,6,7,0,3,2,5,1,4,4,1,1,2,0,14
3024,797443,2,0,0,0,0,0,0,0,0,0,0,1,1,0,0,0,0
3024,797444,6,0,2,0,2,0,0,0,0,0,2,0,1,0,0,1,0
3024,786613,5,1,1,1,1,0,0,0,0,0,0,1,1,1,2,0,2
3024,776341,5,0,0,0,0,0,0,0,0,0,0,0,0,0,0,0,0
3024,786736,21,2,5,1,2,1,3,0,0,0,0,6,0,1,1,0,5
3025,781624,25,5,11,2,3,3,8,2,2,3,1,1,0,1,1,0,15
3025,792246,21,8,12,8,12,0,0,1,1,1,2,0,0,1,1,0,17
3025,791701,19,3,8,3,4,0,4,0,0,1,0,6,3,0,1,0,6
3025,781420,34,8,11,3,3,5,8,0,0,0,8,5,3,0,1,0,21
3025,781405,34,6,11,2,4,4,7,2,2,0,4,3,4,4,4,0,18
3025,797924,13,1,3,1,3,0,0,0,0,0,5,1,0,0,1,0,2
3025,792244,19,1,6,0,2,1,4,0,0,2,4,0,3,0,2,0,3
3025,797925,12,1,6,1,5,0,1,0,1,2,0,1,1,0,1,0,2
3025,792245,21,1,2,1,1,0,1,0,0,0,1,3,1,0,2,0,2
3026,780686,34,12,15,12,15,0,0,8,14,2,10,4,2,0,1,0,32
3026,780683,13,0,5,0,1,0,4,0,0,2,1,1,3,0,1,0,0
3026,797681,34,4,7,1,2,3,5,0,0,0,1,3,2,0,1,0,11
3026,786112,35,4,9,4,6,0,3,4,8,0,4,2,3,2,3,0,12
3026,780688,26,3,6,2,3,1,3,6,7,3,1,1,4,0,2,0,13
3026,797683,6,0,1,0,0,0,1,0,0,0,1,0,0,0,0,0,0
3026,797682,7,0,0,0,0,0,0,0,0,1,3,0,1,0,1,1,0
3026,797680,14,3,6,2,2,1,4,1,2,3,3,0,2,0,0,0,8
3026,797679,11,0,1,0,1,0,0,0,0,0,1,0,2,0,1,1,0
3026,780689,20,2,5,0,2,2,3,2,2,3,2,0,5,0,1,1,8
3027,796657,21,2,5,2,5,0,0,0,0,1,2,0,4,0,0,0,4
3027,796651,19,2,3,1,1,1,2,1,2,0,2,2,5,0,1,0,6
3027,796650,17,2,5,2,5,0,0,1,2,2,1,1,4,0,2,0,5
3027,791323,30,1,4,0,0,1,4,0,0,0,2,4,4,0,1,1,3
3027,781511,35,6,14,1,4,5,10,4,4,0,7,1,2,0,0,1,21
3027,796656,17,3,4,3,4,0,0,0,0,0,2,0,1,0,1,0,6
3027,796653,7,0,1,0,1,0,0,0,0,0,0,1,1,0,0,0,0
3027,792257,12,3,5,3,4,0,1,1,2,2,1,1,0,0,1,0,7
3027,796654,2,0,2,0,2,0,0,0,0,1,0,0,0,0,0,0,0
3027,791321,9,1,2,1,2,0,0,0,1,2,1,0,0,0,0,0,2
3027,791320,19,4,11,4,7,0,4,10,12,0,1,2,4,1,0,0,18
3027,785912,12,1,4,0,3,1,1,2,2,0,0,0,0,0,0,0,5
3028,780824,28,2,3,2,3,0,0,0,0,1,4,1,2,1,3,0,4
3028,791117,35,8,9,6,6,2,3,3,4,1,6,0,3,2,0,0,21
3028,791118,39,6,15,3,8,3,7,8,12,1,5,3,1,3,0,0,23
3028,785676,20,0,4,0,1,0,3,0,0,1,2,1,5,0,4,0,0
3028,774974,33,3,10,2,7,1,3,3,3,0,3,3,2,1,4,0,10
3028,796771,2,0,1,0,0,0,1,3,4,0,0,0,0,0,0,1,3
3028,791115,10,0,0,0,0,0,0,0,0,0,1,0,5,0,1,0,0
3028,796769,25,1,4,1,1,0,3,0,0,0,1,1,1,0,1,0,2
3028,796768,2,0,0,0,0,0,0,0,0,0,0,0,0,0,0,0,0
3028,791116,6,0,1,0,1,0,0,0,0,1,0,0,0,0,1,0,0
3029,776100,30,3,6,3,5,0,1,0,0,0,1,0,3,1,0,0,6
3029,785991,25,5,6,5,6,0,0,0,0,3,9,1,1,0,3,1,10
3029,781406,31,3,8,3,8,0,0,8,10,0,3,0,3,3,3,0,14
3029,781401,24,4,4,3,3,1,1,0,0,0,1,0,3,3,2,0,9
3029,775317,13,0,2,0,1,0,1,0,0,0,1,5,2,1,2,0,0
3029,797760,9,2,2,1,1,1,1,0,0,1,1,0,1,0,1,0,5
3029,792133,27,1,8,1,5,0,3,0,0,0,3,1,2,1,1,0,2
3029,797762,26,4,9,4,7,0,2,4,4,0,4,6,4,2,2,0,12
3029,781029,15,3,5,0,0,3,5,0,0,0,2,1,1,0,1,0,9
3030,791493,38,7,8,7,8,0,0,9,11,3,5,6,2,1,2,2,23
3030,789036,29,6,11,6,11,0,0,3,4,0,3,3,3,0,4,4,15
3030,797191,13,1,1,1,1,0,0,0,0,0,4,3,1,0,1,0,2
3030,791495,19,1,3,1,1,0,2,0,0,0,3,2,2,0,2,1,2
3030,776494,38,10,13,5,6,5,7,2,2,0,7,2,2,3,3,0,27
3030,781307,12,4,5,4,5,0,0,0,0,0,2,3,2,1,0,1,8
3030,797192,1,0,0,0,0,0,0,0,0,0,0,1,1,0,0,0,0
3030,791492,23,2,3,0,1,2,2,6,6,0,1,1,0,0,2,0,12
3030,791494,27,4,6,2,3,2,3,3,4,0,2,3,4,1,7,0,13
3031,797895,21,4,9,4,8,0,1,9,10,3,1,1,4,3,1,0,17
3031,785286,18,0,2,0,1,0,1,6,6,0,1,2,1,1,0,0,6
3031,797898,34,6,17,3,8,3,9,1,1,1,1,5,3,2,2,0,16
3031,792236,24,1,2,1,2,0,0,0,0,0,3,2,1,1,5,0,2
3031,781374,11,2,5,2,4,0,1,0,0,0,3,1,0,0,0,0,4
3031,787239,4,0,1,0,1,0,0,0,0,0,0,0,0,0,0,0,0
3031,789058,7,1,1,1,1,0,0,0,0,0,1,0,2,0,0,0,2
3031,785818,11,2,3,0,0,2,3,0,0,0,1,0,5,0,1,0,6
3031,776337,13,2,4,2,4,0,0,0,0,0,1,0,1,4,1,0,4
3031,797897,1,0,0,0,0,0,0,0,0,0,0,0,0,0,0,0,0
3031,792240,19,4,5,3,4,1,1,2,2,4,1,1,0,2,1,0,11
3031,792359,8,0,0,0,0,0,0,0,0,0,0,1,3,0,0,0,0
3031,792237,29,10,19,6,11,4,8,1,1,0,0,1,2,1,0,0,25
3032,797239,34,4,7,2,4,2,3,3,4,0,4,3,2,0,1,0,13
3032,797234,28,4,7,1,3,3,4,0,0,0,7,0,3,2,2,0,11
3032,791367,32,4,8,4,6,0,2,2,5,0,3,5,5,2,4,0,10
3032,797232,36,3,11,0,3,3,8,0,0,0,6,0,0,1,0,1,9
3032,797235,33,4,10,4,9,0,1,1,2,2,1,1,3,0,1,0,9
3032,791368,8,2,2,1,1,1,1,0,0,2,1,0,4,0,4,0,5
3032,785446,16,0,3,0,1,0,2,0,0,0,0,0,1,1,3,0,0
3032,797233,6,0,0,0,0,0,0,0,0,0,0,0,0,0,1,0,0
3032,786535,5,0,2,0,0,0,2,0,0,0,1,0,0,0,0,0,0
3032,797237,2,0,0,0,0,0,0,0,0,0,0,0,0,0,2,0,0
3033,780663,34,12,20,9,11,3,9,5,8,0,3,0,1,2,3,0,32
3033,786218,33,3,10,1,5,2,5,2,4,0,7,0,1,0,3,0,10
3033,786216,25,4,6,4,6,0,0,1,4,2,6,0,4,1,4,0,9
3033,791348,27,1,9,1,8,0,1,0,0,3,4,1,1,3,1,0,2
3033,780150,15,0,2,0,0,0,2,0,0,1,3,2,1,0,1,0,0
3033,781645,11,2,3,2,2,0,1,0,0,0,0,0,1,0,0,0,4
3033,791350,31,1,5,0,1,1,4,0,0,2,0,1,1,1,1,0,3
3033,797258,9,1,1,1,1,0,0,0,0,1,2,1,2,0,0,0,2
3033,780156,10,0,1,0,0,0,1,0,0,1,1,0,1,1,0,0,0
3033,797257,5,0,1,0,1,0,0,0,0,0,1,0,3,0,0,0,0
3034,791312,8,1,1,1,1,0,0,1,2,1,1,1,2,0,1,0,3
3034,785664,12,1,2,1,2,0,0,0,2,2,0,0,3,1,0,0,2
3034,785841,28,5,8,1,1,4,7,0,0,2,0,0,1,2,1,0,14
3034,796609,25,3,7,1,2,2,5,0,2,0,1,2,2,3,2,0,8
3034,781504,34,4,9,2,3,2,6,2,4,0,0,3,3,2,2,0,12
3034,796613,18,3,4,2,2,1,2,0,0,0,2,0,2,0,3,0,7
3034,792232,5,0,1,0,0,0,1,0,0,0,0,0,2,0,0,0,0
3034,785840,4,0,2,0,0,0,2,0,0,0,0,0,0,0,0,0,0
3034,796611,15,1,4,1,1,0,3,2,2,0,0,0,0,0,0,0,4
3034,792869,17,1,6,0,0,1,6,0,0,0,2,2,1,0,1,0,3
3034,786685,20,2,6,2,3,0,3,2,3,0,1,3,2,1,3,2,6
3034,766623,14,0,2,0,0,0,2,0,0,0,2,1,2,1,0,0,0
3035,790907,30,4,8,4,8,0,0,4,5,4,5,0,2,2,4,1,12
3035,787175,37,5,10,1,1,4,9,1,2,0,10,0,2,0,0,0,15
3035,782126,36,4,9,3,7,1,2,0,0,2,2,3,2,0,1,0,9
3035,781393,37,7,12,2,4,5,8,7,10,1,3,5,2,1,7,0,26
3035,775351,38,6,8,6,8,0,0,5,5,2,1,3,2,2,2,0,17
3035,796456,2,1,1,1,1,0,0,0,0,0,0,0,0,0,0,0,2
3035,796455,15,1,1,1,1,0,0,5,6,0,5,1,2,0,1,0,7
3035,796454,3,0,0,0,0,0,0,0,0,0,0,1,0,0,0,0,0
3035,790910,2,0,0,0,0,0,0,0,0,0,0,0,0,0,0,0,0
3036,797558,19,1,5,1,3,0,2,4,6,2,3,1,2,1,5,1,6
3036,786519,20,0,2,0,2,0,0,0,0,2,3,1,3,1,1,0,0
3036,797556,31,8,14,6,8,2,6,4,4,2,2,0,2,3,0,0,22
3036,791913,30,5,8,4,5,1,3,4,5,1,0,3,4,1,5,0,15
3036,786520,37,7,12,5,7,2,5,5,6,2,4,1,2,3,3,0,21
3036,791912,20,1,1,1,1,0,0,2,3,0,1,0,2,0,2,0,4
3036,797557,19,2,5,1,1,1,4,0,0,1,4,1,3,3,2,1,5
3036,797555,19,1,4,1,2,0,2,0,0,0,1,0,0,1,2,0,2
3036,797559,5,0,0,0,0,0,0,0,0,0,0,0,0,0,0,0,0
3037,780521,25,1,2,1,1,0,1,0,0,0,4,1,2,1,1,0,2
3037,775163,24,1,3,1,3,0,0,1,3,1,1,4,4,2,0,0,3
3037,791370,34,8,10,2,2,6,8,0,0,2,1,0,3,0,2,0,22
3037,786199,23,2,7,2,5,0,2,0,0,0,2,1,4,2,5,0,4
3037,780991,29,5,7,5,6,0,1,3,3,0,0,2,2,4,4,0,13
3037,797269,2,0,0,0,0,0,0,0,0,0,1,0,1,0,1,0,0
3037,781611,14,0,2,0,2,0,0,1,2,2,0,0,0,0,2,0,1
3037,797271,29,5,12,2,3,3,9,3,4,0,1,3,3,3,3,1,16
3037,743593,11,2,2,2,2,0,0,1,2,0,0,0,1,0,1,1,5
3037,791371,9,1,2,1,2,0,0,0,0,0,1,0,0,0,4,0,2
3038,797140,15,0,4,0,1,0,3,0,2,2,4,0,1,0,1,0,0
3038,775110,38,4,7,4,7,0,0,4,5,3,9,1,3,1,4,0,12
3038,791392,13,0,1,0,1,0,0,0,0,0,0,5,2,1,0,0,0
3038,780128,28,4,13,2,6,2,7,0,0,2,1,3,4,2,5,0,10
3038,775458,37,8,15,7,9,1,6,1,2,0,2,2,2,2,1,2,18
3038,797134,7,1,1,1,1,0,0,0,0,0,0,0,1,0,2,0,2
3038,791394,3,0,1,0,1,0,0,0,0,0,1,1,0,0,0,0,0
3038,786062,1,0,0,0,0,0,0,0,0,0,0,0,0,0,0,0,0
3038,781353,2,0,0,0,0,0,0,0,0,0,0,1,0,0,0,0,0
3038,797138,27,3,8,3,7,0,1,3,4,3,2,6,4,1,3,0,9
3038,797135,5,1,1,0,0,1,1,0,2,0,0,0,0,0,1,0,3
3038,785264,14,4,8,4,6,0,2,0,0,0,1,0,1,0,0,0,8
3038,785936,10,0,1,0,0,0,1,0,0,0,0,1,0,0,1,0,0
3039,785681,34,3,4,3,4,0,0,0,2,2,6,1,1,0,2,2,6
3039,796789,30,6,12,4,6,2,6,3,6,0,3,1,3,1,4,0,17
3039,791126,28,2,11,2,11,0,0,0,1,3,4,2,2,0,6,0,4
3039,791124,27,5,6,4,4,1,2,1,2,0,3,3,2,3,4,0,12
3039,780050,28,5,11,4,7,1,4,3,6,4,5,3,1,0,2,0,14
3039,784479,2,0,1,0,1,0,0,0,0,0,0,0,1,0,0,0,0
3039,796786,12,0,0,0,0,0,0,2,5,0,1,0,0,0,0,0,2
3039,796788,3,0,0,0,0,0,0,0,0,0,0,0,0,0,0,0,0
3039,775813,10,0,3,0,3,0,0,2,2,2,3,2,4,2,1,0,2
3039,796784,13,2,3,2,2,0,1,1,2,0,0,1,1,1,1,0,5
3039,796783,2,0,1,0,0,0,1,0,0,0,0,0,0,0,0,0,0
3039,796782,11,1,2,0,0,1,2,0,0,0,0,0,1,0,0,0,3
3040,775340,39,9,23,2,9,7,14,6,6,0,2,6,1,1,3,0,31
3040,792442,20,2,4,2,4,0,0,6,6,2,7,2,4,1,1,2,10
3040,780933,32,1,8,0,1,1,7,1,2,1,0,0,3,1,0,0,4
3040,790935,26,1,4,0,0,1,4,1,2,1,3,1,2,0,4,0,4
3040,774826,26,0,5,0,3,0,2,2,4,1,4,0,4,1,1,0,2
3040,790937,19,3,3,3,3,0,0,0,1,2,5,1,2,0,3,1,6
3040,796190,16,2,3,0,0,2,3,0,0,0,4,1,1,0,0,0,6
3040,796492,4,1,5,1,3,0,2,1,1,1,1,0,0,0,0,0,3
3040,796491,14,0,3,0,1,0,2,0,0,0,2,2,2,0,0,0,0
3040,785445,4,0,1,0,1,0,0,0,0,0,0,0,0,0,0,0,0
3041,797224,36,8,15,6,11,2,4,1,2,2,6,1,2,1,3,0,19
3041,775248,32,4,12,2,4,2,8,6,8,2,7,0,3,2,2,0,16
3041,797225,33,2,9,2,7,0,2,2,4,1,0,2,3,2,3,0,6
3041,780993,28,3,8,3,8,0,0,0,3,3,3,0,2,0,5,4,6
3041,791452,36,2,7,1,1,1,6,0,0,0,6,6,3,1,0,0,5
3041,781558,18,4,5,4,5,0,0,0,0,3,2,0,3,0,0,0,8
3041,797231,11,1,4,1,2,0,2,0,0,1,2,0,0,1,0,0,2
3041,791449,4,0,2,0,1,0,1,0,0,0,1,0,0,0,0,0,0
3041,797230,2,0,1,0,1,0,0,0,0,0,0,0,2,0,0,0,0
3042,786637,30,7,8,5,5,2,3,1,1,0,4,3,2,2,6,0,17
3042,778442,24,4,11,1,6,3,5,6,6,1,3,3,1,1,0,0,17
3042,791514,16,2,4,1,2,1,2,0,0,0,2,1,1,0,0,0,5
3042,791511,19,1,3,1,3,0,0,2,2,1,1,1,2,0,1,2,4
3042,797151,14,0,6,0,4,0,2,2,2,3,1,0,0,0,1,0,2
3042,797154,11,4,5,1,2,3,3,0,0,1,0,0,0,0,0,1,11
3042,791513,22,5,9,5,8,0,1,0,0,0,1,4,3,2,1,0,10
3042,780946,24,3,5,1,2,2,3,1,1,0,1,3,2,5,2,0,9
3042,791515,20,4,5,3,3,1,2,0,0,3,2,2,2,1,0,1,9
3042,797149,10,0,3,0,2,0,1,0,0,0,0,0,2,0,3,0,0
3042,797152,10,0,3,0,3,0,0,0,0,0,1,1,2,0,1,0,0
3043,796563,24,7,11,2,3,5,8,3,5,0,2,2,2,0,0,0,22
3043,780166,34,5,11,4,7,1,4,8,9,2,3,4,3,2,2,0,19
3043,796566,28,3,8,3,7,0,1,0,0,3,7,1,2,2,4,2,6
3043,790971,24,3,4,3,4,0,0,0,0,2,1,0,0,1,0,1,6
3043,790969,25,1,6,0,2,1,4,1,3,0,1,3,2,0,7,0,4
3043,796568,20,2,7,2,7,0,0,2,4,0,1,2,1,2,3,0,6
3043,781380,9,1,1,1,1,0,0,2,2,1,1,0,0,0,1,1,4
3043,790968,9,1,1,1,1,0,0,1,2,0,1,1,1,0,0,0,3
3043,796569,16,1,2,1,2,0,0,0,0,1,1,1,1,0,0,0,2
3043,790967,11,0,2,0,0,0,2,0,0,1,1,0,1,0,0,0,0
3044,786575,35,3,5,3,5,0,0,4,6,5,3,2,2,0,2,6,10
3044,785531,19,2,6,2,4,0,2,2,2,1,2,0,1,0,2,0,6
3044,798094,25,1,5,1,3,0,2,0,0,0,3,4,1,2,3,0,2
3044,792338,39,9,14,9,12,0,2,3,3,5,6,2,4,4,3,3,21
3044,781666,34,3,11,2,6,1,5,7,8,0,4,2,3,0,4,0,14
3044,798097,10,0,0,0,0,0,0,0,1,0,0,0,0,0,0,0,0
3044,798095,4,1,1,1,1,0,0,0,0,0,1,1,0,0,0,0,2
3044,798100,6,0,1,0,1,0,0,1,2,0,0,2,1,0,0,0,1
3044,799842,23,2,3,1,2,1,1,0,0,0,1,2,1,0,2,0,5
3044,791636,30,7,16,1,4,6,12,2,3,0,2,0,1,0,2,0,22
3045,792227,33,11,15,9,12,2,3,0,2,1,3,0,4,1,2,1,24
3045,781352,29,3,11,3,10,0,1,0,0,1,4,3,3,1,1,1,6
3045,792223,30,4,9,1,5,3,4,0,0,1,1,2,2,2,3,1,11
3045,781340,31,6,8,5,6,1,2,0,2,2,3,0,4,1,3,0,13
3045,776128,39,0,5,0,5,0,0,0,0,0,6,11,4,4,4,0,0
3045,797881,9,3,3,3,3,0,0,0,0,1,1,0,1,0,0,0,6
3045,797889,7,2,3,2,3,0,0,0,0,0,0,0,0,0,0,0,4
3045,781351,11,1,2,1,1,0,1,0,1,0,0,1,2,0,1,0,2
3045,785935,33,3,10,2,6,1,4,4,5,2,3,3,2,0,3,0,11
3045,786453,3,0,1,0,1,0,0,0,0,1,0,1,1,0,1,0,0
3046,792078,19,1,3,1,3,0,0,0,0,0,1,2,0,0,1,0,2
3046,786067,38,8,15,8,15,0,0,10,13,5,5,0,3,1,2,0,26
3046,797661,41,6,12,5,10,1,2,2,2,1,5,3,2,2,1,0,15
3046,785591,39,4,8,3,6,1,2,2,2,0,1,1,4,2,2,1,11
3046,780258,40,3,8,3,8,0,0,0,0,1,10,3,1,1,3,0,6
3046,797662,30,4,9,4,7,0,2,3,4,1,9,1,1,0,1,0,11
3046,792082,6,0,1,0,1,0,0,2,2,0,1,0,1,0,0,0,2
3046,797659,3,0,0,0,0,0,0,0,0,0,0,1,0,1,0,0,0
3046,797660,5,0,2,0,2,0,0,1,2,0,0,0,0,0,1,0,1
3046,792083,4,0,1,0,1,0,0,0,0,0,0,0,2,0,1,0,0
3047,780095,21,0,1,0,1,0,0,0,0,1,3,1,5,1,1,0,0
3047,776321,40,2,9,2,7,0,2,3,4,4,5,0,5,0,2,1,7
3047,786081,30,2,10,1,6,1,4,0,0,3,6,3,1,0,3,0,5
3047,785431,43,9,15,9,12,0,3,0,4,1,3,7,3,1,3,1,18
3047,780232,45,5,17,3,9,2,8,7,8,1,5,1,1,2,2,0,19
3047,786020,8,2,3,2,3,0,0,0,0,0,2,0,2,0,0,0,4
3047,785356,21,4,7,2,2,2,5,0,0,0,0,0,2,0,0,0,10
3047,789040,17,1,7,1,6,0,1,1,3,1,1,1,1,3,0,0,3
3054,791067,38,5,9,5,9,0,0,4,5,2,8,4,3,1,1,3,14
3054,780751,17,4,7,3,5,1,2,0,0,1,4,2,2,0,5,0,9
3054,796743,20,1,7,0,3,1,4,1,2,0,1,1,2,0,1,0,4
3054,791068,23,3,10,2,6,1,4,0,1,2,5,1,1,1,0,1,7
3054,785551,37,3,8,0,3,3,5,5,6,0,1,2,1,0,1,0,14
3054,785642,2,0,2,0,1,0,1,0,0,0,0,0,1,0,1,0,0
3054,780512,18,3,4,3,4,0,0,2,2,1,4,2,1,1,2,0,8
3054,780756,3,0,0,0,0,0,0,0,0,0,0,1,0,0,0,0,0
3054,796744,20,2,4,1,2,1,2,0,0,0,0,0,2,1,0,0,5
3054,791066,19,4,5,3,3,1,2,0,0,0,3,2,1,2,2,0,9
3054,791065,3,0,0,0,0,0,0,0,0,0,1,1,1,0,0,0,0
3055,792131,22,2,7,2,5,0,2,0,0,1,1,0,4,0,1,1,4
3055,792128,20,2,3,2,2,0,1,0,0,1,5,0,4,3,1,1,4
3055,792132,24,2,11,2,7,0,4,1,2,1,2,0,0,0,3,0,5
3055,792127,26,4,12,3,6,1,6,2,4,0,5,6,1,1,1,0,11
3055,792126,32,6,10,4,6,2,4,1,2,0,4,0,2,2,1,0,15
3055,799273,1,0,1,0,1,0,0,0,0,0,0,0,0,0,0,0,0
3055,786838,23,7,10,7,10,0,0,3,3,1,6,2,4,1,1,5,17
3055,797736,24,1,2,1,1,0,1,0,0,0,0,1,1,0,0,0,2
3055,797739,6,0,0,0,0,0,0,0,0,0,1,1,0,0,1,0,0
3055,791668,8,0,1,0,1,0,0,0,0,0,0,0,0,0,2,0,0
3055,799908,14,0,2,0,2,0,0,0,0,1,1,0,0,0,0,0,0
3056,775549,22,3,3,3,3,0,0,3,4,3,6,0,3,1,3,2,9
3056,797056,32,5,15,1,7,4,8,2,2,0,7,0,2,0,0,0,16
3056,797054,30,4,9,1,3,3,6,1,3,0,2,7,3,3,2,0,12
3056,791568,11,0,0,0,0,0,0,0,0,0,2,1,1,1,3,0,0
3056,786381,29,2,5,0,0,2,5,0,0,1,2,2,4,0,3,0,6
3056,797058,10,0,4,0,2,0,2,0,0,0,1,1,1,0,1,0,0
3056,791564,27,4,6,1,1,3,5,0,0,0,5,1,0,0,1,1,11
3056,780425,19,2,3,2,3,0,0,0,0,2,3,0,1,1,0,0,4
3056,797055,20,2,7,1,2,1,5,0,0,0,1,1,0,0,1,0,5
3057,790232,34,5,13,4,10,1,3,0,1,1,3,3,1,1,3,0,11
3057,780614,23,1,2,0,0,1,2,1,2,0,2,1,1,0,1,0,4
3057,780093,18,4,7,4,7,0,0,3,5,2,2,1,2,0,0,0,11
3057,789066,33,7,14,4,8,3,6,0,0,0,4,1,2,1,2,0,17
3057,776278,28,2,6,0,0,2,6,2,2,0,2,3,3,1,2,0,8
3057,780255,14,0,2,0,2,0,0,0,0,1,3,0,1,0,2,1,0
3057,792411,9,0,1,0,0,0,1,0,0,0,3,0,0,0,0,0,0
3057,786463,25,4,11,4,9,0,2,2,2,1,3,0,1,3,0,0,10
3057,785806,16,0,2,0,0,0,2,0,0,0,2,1,1,0,0,0,0
3058,781592,29,2,2,2,2,0,0,4,9,1,9,0,2,0,1,0,8
3058,780229,31,11,14,11,14,0,0,2,3,1,4,2,3,0,1,0,24
3058,795572,28,3,11,3,7,0,4,4,5,0,7,2,2,1,0,0,10
3058,791483,32,5,11,4,9,1,2,6,8,1,2,1,1,0,0,0,17
3058,791485,12,1,3,0,1,1,2,0,0,0,1,0,0,0,0,0,3
3058,791488,15,0,1,0,0,0,1,0,0,0,0,1,0,0,0,0,0
3058,786322,24,1,3,1,3,0,0,0,0,0,5,2,3,1,2,0,2
3058,780228,29,4,11,1,3,3,8,2,2,1,4,2,2,0,0,0,13
3059,791482,22,2,5,2,3,0,2,0,0,1,1,2,5,0,2,0,4
3059,786319,27,5,9,5,9,0,0,2,3,2,9,0,1,1,2,1,12
3059,786318,35,6,15,4,6,2,9,2,2,1,1,4,1,0,1,0,16
3059,784268,24,4,9,4,7,0,2,4,4,1,2,2,4,0,1,0,12
3059,780223,33,4,11,2,4,2,7,0,0,0,3,0,3,1,1,0,10
3059,797198,9,1,4,1,2,0,2,0,0,0,3,0,1,0,0,0,2
3059,791481,20,1,4,1,2,0,2,2,2,1,4,1,1,0,0,1,4
3059,780225,22,2,5,0,2,2,3,1,1,0,4,3,4,0,1,0,7
3059,797200,4,1,2,0,0,1,2,0,0,0,1,0,0,0,0,0,3
3059,797199,4,0,0,0,0,0,0,0,0,0,0,1,1,0,0,0,0
3060,791652,15,8,10,8,10,0,0,3,4,0,1,0,3,0,3,0,19
3060,786495,12,2,4,1,3,1,1,1,1,1,7,2,0,0,1,0,6
3060,797285,20,2,4,1,2,1,2,0,0,1,1,1,1,0,0,0,5
3060,791650,23,8,13,7,11,1,2,0,1,7,5,4,2,2,0,1,17
3060,776384,28,5,11,5,8,0,3,2,3,0,1,4,2,0,1,0,12
3060,797284,9,1,5,1,3,0,2,0,0,0,0,1,1,1,0,0,2
3060,791653,18,4,7,3,5,1,2,0,0,1,1,0,0,0,0,0,9
3060,791654,7,0,0,0,0,0,0,2,2,0,1,0,3,0,0,0,2
3060,775705,14,0,1,0,1,0,0,0,0,3,3,0,0,0,1,1,0
3060,797289,13,3,7,2,6,1,1,1,1,1,1,5,1,0,0,0,8
3060,797286,15,2,8,1,4,1,4,0,0,0,2,3,1,0,1,0,5
3060,797283,26,4,10,1,2,3,8,0,0,0,4,1,2,0,0,0,11
3062,796955,6,0,2,0,2,0,0,0,0,0,0,0,3,0,1,0,0
3062,791838,17,1,2,0,1,1,1,0,0,0,1,0,2,0,0,0,3
3062,786620,33,4,13,2,4,2,9,5,6,0,0,1,2,0,0,0,15
3062,781606,30,3,8,3,5,0,3,0,0,0,1,2,1,0,1,0,6
3062,781257,34,7,15,3,6,4,9,4,4,2,7,3,1,1,1,0,22
3062,791255,3,0,0,0,0,0,0,0,0,0,0,0,0,0,1,0,0
3062,791257,29,4,6,4,6,0,0,1,4,5,6,1,3,0,3,0,9
3062,780900,5,0,0,0,0,0,0,0,0,0,1,0,1,0,1,0,0
3062,796954,20,1,8,1,4,0,4,2,3,0,4,1,2,1,1,0,4
3062,781263,23,1,4,1,3,0,1,1,2,1,1,4,5,3,1,0,3
3063,786623,18,3,4,3,4,0,0,3,4,2,0,0,5,1,2,2,9
3063,797405,30,3,5,3,5,0,0,2,2,2,0,5,3,1,1,0,8
3063,791833,29,6,9,6,9,0,0,0,2,0,4,0,4,2,2,0,12
3063,785920,37,6,10,6,9,0,1,8,8,0,5,4,0,1,2,0,20
3063,785698,26,3,11,2,6,1,5,1,1,0,3,0,3,0,2,0,8
3063,797413,2,0,0,0,0,0,0,0,0,0,0,0,0,0,0,0,0
3063,786624,22,1,1,1,1,0,0,2,2,0,4,1,2,0,2,2,4
3063,791834,18,1,5,1,4,0,1,1,1,0,1,0,1,0,0,0,3
3063,784077,18,2,5,2,3,0,2,2,2,0,4,0,1,0,0,0,6
3064,786090,36,7,16,6,10,1,6,9,12,4,10,6,4,5,2,0,24
3064,796790,36,8,20,4,9,4,11,2,2,0,3,3,3,1,2,0,22
3064,786088,36,6,9,5,6,1,3,2,3,0,2,4,1,1,1,0,15
3064,791135,32,6,12,6,12,0,0,3,7,7,9,1,2,1,7,1,15
3064,786097,16,0,1,0,1,0,0,2,2,2,5,1,2,0,2,1,2
3064,791134,13,1,2,1,2,0,0,0,0,1,0,1,4,0,0,1,2
3064,786092,4,0,0,0,0,0,0,1,2,0,1,1,0,0,0,0,1
3064,791131,16,0,2,0,1,0,1,0,0,1,4,1,4,0,0,0,0
3064,791132,9,0,2,0,0,0,2,0,2,0,0,2,0,0,0,0,0
3064,791521,2,0,1,0,1,0,0,0,0,1,0,0,1,0,3,0,0
3065,781079,32,6,12,5,8,1,4,1,2,1,4,1,1,2,2,0,14
3065,781443,31,3,11,3,8,0,3,6,6,0,2,1,4,0,1,1,12
3065,775822,22,2,3,2,2,0,1,6,6,0,4,2,3,0,2,1,10
3065,785380,28,3,7,1,1,2,6,1,2,1,3,0,5,0,0,1,9
3065,791316,25,3,10,3,9,0,1,1,2,3,3,0,5,2,2,3,7
3065,796625,25,2,9,0,2,2,7,2,2,0,4,1,2,1,1,1,8
3065,796621,20,1,8,1,5,0,3,2,3,0,2,5,3,0,2,0,4
3065,796626,10,1,1,1,1,0,0,1,3,2,2,0,2,0,1,0,3
3065,791314,7,1,1,1,1,0,0,0,0,0,0,0,0,0,1,0,2
3065,796202,0,0,0,0,0,0,0,0,0,0,0,0,0,0,0,0,0
3066,785481,25,2,3,2,2,0,1,0,1,3,2,1,3,1,3,2,4
3066,797395,28,4,10,2,7,2,3,0,1,0,2,1,3,0,2,0,10
3066,797394,24,5,13,4,8,1,5,2,3,4,3,2,3,3,1,0,13
3066,797391,27,2,6,1,1,1,5,2,2,0,2,1,3,1,5,0,7
3066,786630,32,2,9,2,9,0,0,6,7,3,6,0,3,1,1,0,10
3066,797397,10,0,1,0,1,0,0,0,0,0,1,0,1,0,0,0,0
3066,791830,13,1,5,1,5,0,0,1,2,4,1,0,0,0,0,1,3
3066,791828,5,0,0,0,0,0,0,0,0,0,1,0,1,0,0,0,0
3066,791827,36,8,13,8,13,0,0,4,4,2,12,2,1,1,3,1,20
3067,797728,28,5,10,0,1,5,9,1,2,0,3,1,3,1,2,0,16
3067,792036,22,1,3,1,3,0,0,2,2,2,3,0,5,0,2,1,4
3067,786266,32,5,11,1,3,4,8,2,4,0,3,0,0,1,2,0,16
3067,792040,34,3,11,3,6,0,5,4,5,2,3,3,1,0,0,0,10
3067,775028,28,1,9,0,3,1,6,5,6,0,2,6,3,0,2,0,8
3067,797726,15,0,3,0,3,0,0,0,0,2,2,0,1,1,0,0,0
3067,786039,13,0,0,0,0,0,0,0,0,1,1,0,1,1,2,0,0
3067,797719,13,2,5,1,1,1,4,0,0,0,4,2,0,0,0,0,5
3067,797718,15,2,4,1,1,1,3,0,0,0,0,2,2,0,3,0,5
3068,780832,30,6,6,6,6,0,0,4,6,1,3,1,2,0,2,2,16
3068,790961,36,6,12,6,12,0,0,0,3,3,5,3,3,2,0,1,12
3068,785278,31,4,10,1,3,3,7,0,0,2,2,0,2,2,1,0,11
3068,780146,35,3,13,3,9,0,4,2,2,2,3,3,2,3,5,0,8
3068,786240,21,0,2,0,2,0,0,0,0,0,2,1,2,0,2,0,0
3068,775860,33,3,9,0,1,3,8,0,0,0,3,2,3,1,2,1,9
3068,796554,12,0,2,0,1,0,1,0,0,0,1,0,1,0,0,0,0
3068,796555,2,0,1,0,0,0,1,0,0,0,1,0,0,0,0,0,0
3069,792265,33,7,10,6,8,1,2,2,2,1,6,1,1,1,2,1,17
3069,792266,30,6,8,5,5,1,3,4,4,0,3,0,1,1,1,2,17
3069,798003,26,2,6,2,4,0,2,1,1,1,3,4,3,2,3,0,5
3069,786152,25,2,3,2,2,0,1,1,4,0,8,4,3,0,1,0,5
3069,798006,21,1,6,0,0,1,6,0,0,0,1,1,1,0,1,0,3
3069,792267,28,3,5,1,2,2,3,0,0,0,2,1,2,0,1,0,8
3069,798007,12,3,7,2,6,1,1,1,1,3,3,0,3,2,2,0,8
3069,798009,15,1,3,0,1,1,2,0,0,1,0,1,0,0,1,0,3
3069,798002,10,1,2,1,2,0,0,1,2,0,2,1,1,0,0,0,3
3070,797529,15,1,3,1,3,0,0,0,0,1,0,0,4,2,0,1,2
3070,797527,18,1,6,1,5,0,1,0,0,0,3,0,1,1,3,1,2
3070,791936,25,3,5,3,5,0,0,0,3,5,5,0,2,0,3,0,6
3070,797532,28,5,15,5,12,0,3,4,8,1,4,4,2,1,2,0,14
3070,785688,19,0,9,0,2,0,7,0,0,0,1,1,1,0,1,0,0
3070,797530,7,0,1,0,1,0,0,0,0,0,0,0,1,0,0,0,0
3070,797528,10,1,2,1,1,0,1,0,0,0,1,1,2,2,0,1,2
3070,791931,9,0,0,0,0,0,0,1,2,3,2,2,3,0,2,1,1
3070,797531,12,1,3,1,3,0,0,1,1,1,0,0,1,0,0,0,3
3070,791932,11,2,7,0,1,2,6,0,0,0,1,3,1,1,2,0,6
3070,791933,12,1,3,0,0,1,3,0,0,0,0,0,1,0,1,0,3
3070,791935,8,0,1,0,1,0,0,2,2,0,0,0,0,2,0,0,2
3070,785988,26,3,12,1,4,2,8,2,2,0,4,1,2,0,1,0,10
3071,776174,21,6,10,6,10,0,0,0,2,4,7,1,0,2,1,2,12
3071,791958,27,9,15,8,11,1,4,5,6,4,4,3,1,1,2,0,24
3071,791960,16,0,4,0,0,0,4,0,0,0,2,1,4,1,0,0,0
3071,785861,31,5,13,2,5,3,8,3,3,2,9,5,1,2,3,1,16
3071,781332,22,3,7,2,3,1,4,0,0,0,2,5,4,1,5,0,7
3071,786059,23,3,5,2,3,1,2,2,4,2,7,3,2,0,2,3,9
3071,786063,3,0,0,0,0,0,0,0,0,0,0,0,1,0,0,0,0
3071,781334,13,2,3,2,2,0,1,3,4,3,2,2,2,0,0,0,7
3071,797706,15,0,4,0,1,0,3,1,2,3,2,2,1,0,2,0,1
3071,797704,18,3,6,0,0,3,6,0,0,0,2,1,2,0,1,0,9
3071,791957,3,1,1,0,0,1,1,0,0,0,0,0,0,0,0,0,3
3071,791959,8,1,3,1,2,0,1,0,0,1,2,2,0,0,1,0,2
3072,785685,31,7,13,6,10,1,3,1,1,0,3,5,1,3,4,0,16
3072,791265,30,4,4,0,0,4,4,1,2,1,1,5,1,0,2,0,13
3072,785977,23,4,10,2,4,2,6,1,2,2,2,0,2,1,3,0,11
3072,791269,23,3,7,0,0,3,7,1,1,0,2,1,0,1,0,0,10
3072,791266,19,4,7,4,7,0,0,1,3,1,6,1,1,1,0,5,9
3072,796524,18,4,6,4,6,0,0,1,2,1,1,0,2,0,0,3,9
3072,796522,15,2,5,0,0,2,5,0,0,0,1,0,0,0,1,0,6
3072,796523,19,1,4,1,2,0,2,3,4,0,2,2,1,0,0,0,5
3072,791270,2,1,2,0,0,1,2,0,0,0,1,0,1,0,0,0,3
3072,781313,12,0,1,0,0,0,1,0,0,0,0,1,0,0,0,0,0
3072,796525,5,0,2,0,0,0,2,0,0,0,0,1,0,1,0,0,0
3072,791271,3,0,0,0,0,0,0,0,0,0,1,0,3,0,0,0,0
3073,792015,32,7,15,6,12,1,3,0,0,2,6,6,0,0,2,0,15
3073,786540,18,6,9,6,9,0,0,1,2,3,6,0,4,0,5,1,13
3073,792019,33,4,11,1,1,3,10,0,0,0,2,0,4,0,0,0,11
3073,786542,24,4,8,4,7,0,1,0,0,3,4,1,2,0,3,3,8
3073,775995,20,2,6,1,4,1,2,0,0,1,0,0,4,0,2,0,5
3073,791845,18,2,5,2,4,0,1,2,3,2,1,2,2,1,0,0,6
3073,785364,24,2,6,2,6,0,0,1,4,4,6,1,0,1,0,0,5
3073,797515,7,0,1,0,0,0,1,2,2,0,1,0,0,1,2,0,2
3073,797513,1,0,0,0,0,0,0,2,2,0,0,0,0,0,0,0,2
3073,792016,21,0,3,0,1,0,2,0,0,0,0,0,2,1,2,0,0
3073,797514,1,0,0,0,0,0,0,0,0,0,0,0,0,0,0,0,0
3073,781147,1,0,0,0,0,0,0,0,0,0,0,0,0,0,0,0,0
3074,796617,17,4,5,4,5,0,0,0,0,2,1,0,2,2,1,0,8
3074,775131,21,2,5,0,0,2,5,0,0,3,6,4,3,1,0,1,6
3074,796616,21,5,5,2,2,3,3,2,2,0,1,3,1,1,0,0,15
3074,796612,21,4,4,4,4,0,0,0,0,0,0,4,0,1,0,1,8
3074,785562,18,8,9,7,7,1,2,3,3,2,6,3,0,3,1,0,20
3074,796615,6,2,3,2,3,0,0,0,0,0,0,1,0,0,0,0,4
3074,792429,11,1,4,1,1,0,3,2,2,0,2,1,0,0,0,0,4
3074,796618,10,2,2,1,1,1,1,0,0,2,3,0,0,0,2,1,5
3074,799543,5,0,0,0,0,0,0,0,0,0,0,0,1,0,1,0,0
3074,796619,10,1,5,1,3,0,2,1,2,1,2,0,2,2,1,0,3
3074,796614,15,1,4,1,2,0,2,3,4,1,3,1,2,0,3,0,5
3074,796608,6,0,1,0,1,0,0,0,2,0,2,1,0,0,0,0,0
3074,796607,16,3,3,3,3,0,0,0,0,1,1,1,1,1,1,0,6
3074,796606,23,3,5,3,3,0,2,0,2,0,3,3,1,3,2,0,6
3076,781486,36,7,9,3,3,4,6,7,15,0,2,4,3,1,4,1,25
3076,780461,42,4,10,1,4,3,6,7,9,1,5,3,3,2,6,0,18
3076,797180,38,6,12,2,4,4,8,0,0,1,1,0,5,1,0,0,16
3076,774812,31,6,9,6,8,0,1,3,4,0,3,3,5,0,3,3,15
3076,791498,16,1,2,1,2,0,0,2,3,1,1,0,5,0,3,0,4
3076,791499,15,3,4,2,2,1,2,2,2,0,1,2,2,0,1,0,9
3076,791503,17,1,3,1,3,0,0,1,1,0,2,1,2,0,1,0,3
3076,790517,22,0,0,0,0,0,0,0,0,0,2,2,3,0,1,0,0
3076,791502,8,0,2,0,0,0,2,0,0,0,0,0,0,0,0,0,0
3077,785524,37,4,12,1,5,3,7,4,4,4,4,1,2,0,1,0,15
3077,775094,26,4,7,2,2,2,5,0,0,2,4,1,2,1,1,0,10
3077,775456,16,3,9,3,6,0,3,4,5,3,2,0,5,1,2,0,10
3077,781115,25,1,6,1,5,0,1,5,6,1,2,1,5,1,3,0,7
3077,791051,13,1,5,1,5,0,0,0,0,0,0,1,3,0,3,1,2
3077,790819,25,6,13,5,6,1,7,6,8,0,3,2,3,1,1,0,19
3077,791053,31,2,9,2,9,0,0,9,11,7,4,1,3,1,0,0,13
3077,780739,26,5,8,5,8,0,0,1,2,5,1,1,3,1,1,1,11
3077,786310,12,0,4,0,2,0,2,2,2,1,0,1,1,2,1,0,2
3077,796730,8,0,0,0,0,0,0,0,0,0,1,0,0,0,2,1,0
3077,796731,6,0,1,0,1,0,0,0,0,0,1,0,1,0,0,0,0
3078,797139,18,5,7,5,7,0,0,5,8,1,6,0,1,0,0,0,15
3078,775394,34,4,7,2,4,2,3,0,0,0,5,2,2,0,1,0,10
3078,791526,32,4,7,3,5,1,2,1,2,2,3,3,2,2,2,0,10
3078,780272,30,3,9,3,6,0,3,3,4,0,4,2,1,1,2,1,9
3078,775592,25,0,8,0,4,0,4,1,4,1,5,0,1,0,1,0,1
3078,791524,25,6,11,4,6,2,5,1,4,3,3,2,1,1,0,0,15
3078,786354,1,0,0,0,0,0,0,0,0,0,0,0,0,0,0,0,0
3078,785970,10,2,4,2,4,0,0,0,0,0,1,0,2,0,1,1,4
3078,780273,25,3,5,1,1,2,4,3,4,0,3,0,3,1,1,1,11
3079,797047,10,0,4,0,2,0,2,0,0,0,3,0,3,0,3,1,0
3079,775515,22,2,7,1,2,1,5,1,2,0,5,0,3,1,0,1,6
3079,791579,38,3,7,2,4,1,3,0,0,0,6,3,2,0,1,0,7
3079,786387,40,6,11,3,6,3,5,6,8,2,3,6,0,0,1,0,21
3079,780399,35,3,10,1,3,2,7,0,0,0,1,6,3,3,2,0,8
3079,786846,17,3,8,2,2,1,6,2,4,0,2,0,4,1,1,0,9
3079,780400,17,3,6,3,4,0,2,1,1,3,1,0,2,0,0,0,7
3079,791575,18,5,10,5,10,0,0,0,0,2,4,0,2,0,0,1,10
3079,797046,3,0,1,0,0,0,1,0,0,0,1,0,0,0,0,0,0
3080,786704,17,6,8,6,8,0,0,0,0,1,5,0,3,1,4,0,12
3080,785395,26,6,9,5,7,1,2,0,1,1,2,3,1,1,2,3,13
3080,775840,28,2,8,2,4,0,4,0,0,0,3,2,1,1,0,0,4
3080,775955,27,5,12,4,10,1,2,2,3,1,0,6,1,2,0,0,13
3080,775811,19,2,4,2,3,0,1,0,0,1,3,2,4,0,2,0,4
3080,792327,6,0,1,0,1,0,0,0,0,0,1,0,2,0,0,0,0
3080,786706,12,1,1,1,1,0,0,5,5,4,5,1,3,0,1,1,7
3080,775287,19,2,7,1,4,1,3,0,0,1,0,0,0,1,0,0,5
3080,786702,19,2,3,2,3,0,0,0,4,2,3,3,1,2,1,0,4
3080,786551,25,8,11,5,8,3,3,0,0,1,3,5,0,1,1,0,19
3080,786703,1,0,0,0,0,0,0,0,0,0,0,0,0,0,0,0,0
3080,798110,1,0,0,0,0,0,0,0,0,0,0,0,0,0,0,0,0
3081,785829,23,5,9,5,9,0,0,0,0,1,3,0,1,0,4,1,10
3081,796729,27,3,8,3,5,0,3,0,0,0,2,1,1,1,1,0,6
3081,796724,20,0,2,0,2,0,0,1,2,0,1,2,1,1,5,0,1
3081,791048,13,1,3,1,2,0,1,0,1,0,1,0,1,0,1,0,2
3081,786531,35,11,16,6,8,5,8,0,2,0,1,2,2,0,2,0,27
3081,796728,9,0,1,0,1,0,0,0,0,0,1,0,2,0,0,0,0
3081,780723,11,1,2,1,1,0,1,0,0,1,1,0,1,0,0,0,2
3081,775838,25,3,7,3,6,0,1,2,2,1,9,1,1,0,2,0,8
3081,796727,16,0,1,0,0,0,1,2,2,0,0,1,2,1,0,0,2
3081,796726,21,2,6,2,5,0,1,1,1,0,0,3,4,1,2,0,5
3118,790771,29,0,4,0,0,0,4,2,2,2,5,1,1,2,3,1,2
3118,780271,33,3,7,3,4,0,3,3,5,1,5,0,3,2,1,0,9
3118,790772,32,5,10,1,4,4,6,6,7,0,1,2,3,0,1,0,20
3118,785230,28,4,9,1,1,3,8,4,4,0,3,0,4,0,5,0,15
3118,780022,23,3,7,2,3,1,4,6,8,0,2,1,5,2,1,0,13
3118,780218,15,0,4,0,2,0,2,0,0,0,3,1,0,0,1,2,0
3118,796328,21,0,4,0,2,0,2,1,2,2,2,1,4,3,1,0,1
3118,780375,19,2,6,2,2,0,4,0,0,1,2,0,1,0,0,0,4
3119,791534,22,2,3,2,3,0,0,1,1,1,6,0,5,0,3,0,5
3119,797127,25,5,5,4,4,1,1,0,0,1,2,1,4,1,2,0,11
3119,791533,20,5,10,4,8,1,2,1,1,1,2,1,5,1,2,0,12
3119,791528,37,7,16,3,10,4,6,2,2,0,8,3,3,0,1,1,20
3119,775045,38,3,13,3,10,0,3,9,11,4,5,6,2,1,3,0,15
3119,791531,26,2,4,1,2,1,2,3,4,1,5,2,4,1,2,0,8
3119,797124,10,0,3,0,3,0,0,0,0,1,1,0,0,0,0,0,0
3119,797129,8,1,2,1,2,0,0,0,0,2,1,0,0,0,0,0,2
3119,791529,14,1,4,0,1,1,3,0,0,1,0,0,3,0,0,0,3
3120,790810,34,6,13,4,7,2,6,6,8,2,5,0,1,2,2,0,20
3120,785362,14,0,4,0,4,0,0,8,8,3,2,0,2,0,0,0,8
3120,790808,28,2,10,2,5,0,5,0,0,2,4,0,2,2,4,0,4
3120,785361,32,5,14,4,8,1,6,0,0,1,4,1,1,0,1,1,11
3120,779997,32,3,9,3,8,0,1,0,0,0,2,4,1,3,1,0,6
3120,796368,10,2,5,2,3,0,2,1,4,2,1,0,2,0,1,1,5
3120,790811,16,2,6,2,5,0,1,1,2,2,3,0,0,1,1,1,5
3120,790809,13,0,3,0,2,0,1,0,0,0,0,1,2,0,1,0,0
3120,774854,14,0,0,0,0,0,0,0,0,0,0,0,3,0,0,2,0
3120,796371,4,0,0,0,0,0,0,0,0,0,0,0,2,0,0,0,0
3120,796369,3,0,1,0,0,0,1,0,0,0,0,0,0,0,0,0,0
3121,796469,16,2,6,1,3,1,3,0,0,0,5,0,3,2,4,0,5
3121,779981,27,5,6,5,6,0,0,1,2,4,8,1,2,0,2,1,11
3121,785463,33,7,11,4,6,3,5,1,1,0,4,2,2,2,4,0,18
3121,779978,33,4,7,3,5,1,2,4,4,1,5,6,2,1,1,0,13
3121,776003,32,5,14,3,8,2,6,2,2,1,6,3,1,0,2,0,14
3121,790923,23,4,7,2,4,2,3,2,3,1,4,0,3,1,0,0,12
3121,785466,18,1,1,0,0,1,1,0,0,0,2,0,2,1,1,0,3
3121,790924,18,2,9,0,3,2,6,2,2,1,1,0,3,0,2,1,8
3122,791299,25,1,5,1,5,0,0,1,3,4,3,0,2,0,1,2,3
3122,791296,38,7,13,5,7,2,6,1,1,0,4,0,1,1,1,1,17
3122,775871,32,5,7,5,7,0,0,4,7,2,9,0,2,0,4,0,14
3122,796590,25,1,4,1,3,0,1,0,1,1,0,0,1,0,0,0,2
3122,791519,37,8,19,7,14,1,5,4,6,0,1,3,2,0,1,0,21
3122,792084,14,2,3,2,3,0,0,2,8,4,1,1,3,0,0,1,6
3122,786276,12,0,2,0,0,0,2,0,0,0,1,0,0,0,0,1,0
3122,796591,17,0,2,0,0,0,2,0,0,0,1,0,3,0,1,0,0
3122,780529,0,0,0,0,0,0,0,0,0,0,0,0,0,0,0,0,0
3123,775626,25,6,9,6,8,0,1,2,2,0,5,1,5,1,1,0,14
3123,774964,26,3,9,2,7,1,2,5,6,1,4,5,5,0,0,3,12
3123,791203,18,0,0,0,0,0,0,0,0,3,3,1,1,0,0,1,0
3123,785610,28,1,7,0,4,1,3,0,1,1,1,2,2,2,2,0,3
3123,785604,18,1,7,0,3,1,4,0,0,1,1,2,0,1,0,0,3
3123,796910,2,0,0,0,0,0,0,0,0,0,0,0,2,0,0,0,0
3123,785609,7,2,2,2,2,0,0,0,0,0,1,0,0,0,0,0,4
3123,785606,16,6,7,5,6,1,1,0,0,3,2,0,3,0,1,0,13
3123,796907,22,6,6,4,4,2,2,0,0,0,2,0,2,1,3,0,14
3123,796906,6,0,1,0,0,0,1,0,0,0,1,0,0,0,0,0,0
3123,774962,27,3,10,1,2,2,8,4,6,0,3,5,1,1,0,0,12
3123,775566,5,0,0,0,0,0,0,0,0,0,2,1,0,0,0,0,0
3124,790914,16,1,3,1,3,0,0,3,4,4,1,0,4,0,0,0,5
3124,780798,33,3,8,2,4,1,4,3,4,4,6,2,2,0,3,1,10
3124,785455,36,6,17,4,9,2,8,1,3,2,4,5,1,4,1,0,15
3124,785453,34,9,16,6,7,3,9,4,4,1,4,0,3,2,2,1,25
3124,774940,28,4,9,4,7,0,2,0,1,0,4,4,3,1,2,0,8
3124,790911,19,2,4,2,3,0,1,0,0,1,2,1,3,0,1,0,4
3124,790913,19,2,9,1,7,1,2,0,0,0,3,2,2,1,2,0,5
3124,796458,15,2,4,1,3,1,1,1,4,2,2,2,0,0,0,0,6
3125,781656,17,4,6,4,6,0,0,2,3,1,2,0,4,0,1,0,10
3125,781658,21,1,2,1,2,0,0,2,3,0,4,0,3,0,0,1,4
3125,796962,33,7,12,4,7,3,5,4,5,0,3,2,2,2,2,0,21
3125,786798,38,4,12,4,12,0,0,2,5,0,4,3,3,2,3,0,10
3125,780129,26,4,9,3,6,1,3,2,2,0,2,3,4,0,4,0,11
3125,798206,25,2,4,0,0,2,4,0,0,0,7,1,2,0,1,1,6
3125,791263,19,2,6,2,6,0,0,1,1,2,2,1,1,0,3,0,5
3125,796964,14,2,5,2,3,0,2,0,0,0,4,1,1,1,2,0,4
3125,796967,7,0,1,0,0,0,1,0,0,0,0,0,0,0,0,0,0
3126,786765,33,8,15,4,9,4,6,5,7,0,9,0,1,1,2,3,25
3126,792379,33,1,5,0,1,1,4,2,2,1,6,1,4,0,1,0,5
3126,792380,35,6,8,4,5,2,3,3,3,0,3,5,0,0,1,0,17
3126,781672,25,4,9,4,9,0,0,1,1,1,3,1,3,0,4,1,9
3126,781669,30,8,15,5,11,3,4,6,8,0,5,4,4,0,2,0,25
3126,781668,6,0,0,0,0,0,0,0,0,0,2,0,0,0,1,1,0
3126,797860,2,0,0,0,0,0,0,0,0,0,1,0,1,0,0,0,0
3126,797854,10,0,0,0,0,0,0,0,0,0,1,0,0,0,1,0,0
3126,797852,13,1,3,1,3,0,0,0,0,1,2,1,1,1,0,0,2
3126,781671,13,0,0,0,0,0,0,1,2,0,0,1,3,0,0,0,1
3127,780890,33,8,13,8,9,0,4,3,4,0,8,5,2,1,1,2,19
3127,775757,18,2,3,2,3,0,0,0,1,0,1,1,5,0,1,0,4
3127,791123,39,2,8,2,6,0,2,0,0,0,2,1,2,0,0,0,4
3127,786066,40,6,15,4,10,2,5,3,4,1,9,2,3,0,0,0,17
3127,785636,35,2,8,0,3,2,5,0,0,0,1,3,1,0,1,0,6
3127,791119,7,0,0,0,0,0,0,0,0,0,1,0,1,0,1,0,0
3127,775574,28,10,18,6,7,4,11,5,5,2,1,1,3,2,1,0,29
3128,796372,30,6,10,6,10,0,0,2,2,4,5,0,4,0,2,0,14
3128,796377,28,0,6,0,3,0,3,0,0,0,2,2,4,0,1,0,0
3128,796379,33,5,11,3,6,2,5,0,0,0,0,2,4,2,0,0,12
3128,780176,37,5,17,2,9,3,8,0,0,2,2,6,3,1,4,0,13
3128,790815,36,7,13,5,7,2,6,2,3,3,4,3,2,3,2,0,18
3128,796376,8,0,4,0,3,0,1,1,2,1,2,1,1,0,0,1,1
3128,796378,21,1,4,1,2,0,2,0,0,0,3,1,0,0,0,0,2
3128,790816,7,0,0,0,0,0,0,0,0,1,0,0,0,0,0,0,0
3129,785638,29,2,6,2,4,0,2,8,9,2,3,2,0,0,0,0,12
3129,781326,25,2,3,2,3,0,0,0,2,4,6,1,0,2,2,2,4
3129,797870,31,5,12,5,9,0,3,1,1,1,5,5,2,0,3,0,11
3129,792210,17,0,0,0,0,0,0,0,0,0,1,0,4,1,4,0,0
3129,781323,35,8,16,7,11,1,5,4,4,0,3,1,0,2,2,0,21
3129,785430,15,2,5,2,5,0,0,5,6,3,1,0,1,0,0,0,9
3129,792215,14,0,0,0,0,0,0,0,0,0,1,2,1,1,0,0,0
3129,792209,23,3,5,1,3,2,2,0,0,0,5,0,1,1,0,0,8
3129,780874,11,1,4,1,3,0,1,0,0,1,1,0,0,1,0,0,2
3130,781425,32,6,12,6,12,0,0,3,6,6,8,1,3,0,2,1,15
3130,775746,36,4,10,3,5,1,5,4,5,1,1,1,2,2,1,3,13
3130,791343,36,4,12,3,10,1,2,0,0,3,4,7,1,0,0,0,9
3130,781602,38,2,11,2,7,0,4,3,4,1,8,3,0,1,3,1,7
3130,797000,14,2,6,2,2,0,4,0,0,0,3,1,1,1,1,0,4
3130,791344,24,4,8,4,6,0,2,1,3,1,4,1,3,2,1,1,9
3130,797001,12,1,3,1,2,0,1,0,1,0,0,0,0,0,1,0,2
3130,781601,8,1,2,1,2,0,0,0,0,2,1,0,3,0,0,1,2
3131,781386,39,10,19,6,10,4,9,3,4,0,5,4,2,1,1,0,27
3131,786031,33,5,13,4,9,1,4,2,2,3,6,1,4,0,1,0,13
3131,797735,29,1,12,1,8,0,4,1,2,0,1,2,2,1,2,0,3
3131,797734,16,1,5,0,1,1,4,0,0,0,2,1,5,1,4,0,3
3131,786033,33,0,1,0,1,0,0,1,2,7,9,3,2,1,1,4,1
3131,792105,15,2,7,0,0,2,7,0,0,0,1,2,2,0,2,0,6
3131,797733,11,1,3,1,2,0,1,0,0,1,2,2,1,0,1,0,2
3131,792109,18,0,2,0,1,0,1,1,2,2,2,1,2,1,1,1,1
3131,792107,6,0,0,0,0,0,0,0,0,0,0,0,0,0,0,0,0
3132,792417,28,5,10,5,9,0,1,0,2,5,4,1,3,0,3,2,10
3132,786861,32,3,6,3,5,0,1,3,4,0,9,0,1,0,2,0,9
3132,786867,29,5,7,1,1,4,6,3,3,1,0,1,2,1,1,0,17
3132,780387,22,5,8,5,6,0,2,2,4,0,2,2,4,0,3,0,12
3132,767033,33,4,5,2,3,2,2,2,3,0,2,3,2,4,3,0,12
3132,796870,3,1,2,1,2,0,0,0,0,0,0,0,0,0,0,0,2
3132,796869,4,0,0,0,0,0,0,0,0,0,1,0,1,0,0,0,0
3132,796864,4,0,2,0,2,0,0,0,0,0,1,0,0,0,0,0,0
3132,796867,4,1,2,1,1,0,1,0,0,0,0,0,0,0,0,0,2
3132,796868,4,1,1,1,1,0,0,0,0,0,0,0,1,0,0,0,2
3132,792416,19,2,4,2,4,0,0,0,0,0,4,4,0,2,1,0,4
3132,786866,15,2,6,0,1,2,5,0,0,0,5,0,2,0,0,1,6
3132,786865,3,0,0,0,0,0,0,0,0,0,0,0,0,0,0,0,0
3133,796631,28,3,10,1,3,2,7,1,1,4,5,1,4,1,4,0,9
3133,790998,31,0,8,0,6,0,2,2,2,2,3,1,2,0,3,1,2
3133,790997,35,3,8,1,2,2,6,0,0,3,1,2,3,3,2,0,8
3133,790996,30,4,12,3,8,1,4,1,2,1,0,2,0,0,1,0,10
3133,785621,33,6,15,2,4,4,11,0,1,0,1,1,1,2,0,0,16
3133,796633,3,0,0,0,0,0,0,0,0,0,1,0,0,0,0,0,0
3133,790992,4,1,1,1,1,0,0,0,1,0,1,0,0,0,0,0,2
3133,796632,10,1,5,1,4,0,1,0,0,0,2,1,0,0,0,0,2
3133,790995,7,1,1,1,1,0,0,1,2,1,2,1,1,0,1,0,3
3133,786375,9,1,1,1,1,0,0,0,0,0,3,1,0,0,0,0,2
3133,781520,10,0,0,0,0,0,0,2,2,0,0,1,1,0,0,0,2
3134,797058,29,5,8,1,2,4,6,1,2,0,4,2,4,0,1,0,15
3134,775549,25,8,9,8,9,0,0,1,2,1,5,4,5,0,2,4,17
3134,797056,32,6,11,2,4,4,7,3,4,0,1,4,4,1,2,0,19
3134,797054,31,2,6,2,5,0,1,0,0,0,3,5,1,0,1,0,4
3134,786381,19,1,3,0,0,1,3,0,2,1,1,0,3,0,0,0,3
3134,791564,16,3,7,1,2,2,5,0,0,0,4,0,1,0,1,1,8
3134,791566,6,0,0,0,0,0,0,0,0,0,1,0,0,0,0,0,0
3134,780425,15,2,2,2,2,0,0,0,1,2,2,0,0,0,3,1,4
3134,791568,6,0,0,0,0,0,0,0,0,0,0,0,1,0,0,0,0
3134,797055,21,0,5,0,1,0,4,2,2,0,3,1,0,0,0,0,2
3135,790232,37,2,10,1,7,1,3,8,8,2,2,3,2,2,1,0,13
3135,780614,6,0,3,0,2,0,1,0,0,0,0,0,0,0,0,0,0
3135,780093,16,0,1,0,1,0,0,0,0,0,1,0,4,0,1,0,0
3135,789066,28,7,13,2,4,5,9,4,4,0,6,2,1,0,0,0,23
3135,776278,30,1,8,0,1,1,7,8,9,0,5,3,1,0,0,0,11
3135,780255,23,4,6,4,6,0,0,0,0,3,1,0,2,1,0,0,8
3135,792411,16,5,8,0,1,5,7,0,0,1,2,0,1,0,0,0,15
3135,786463,29,4,8,2,4,2,4,4,4,1,6,1,4,0,1,0,14
3135,785806,15,1,3,1,3,0,0,0,0,0,0,1,0,2,0,0,2
3136,785368,19,7,10,7,10,0,0,7,7,3,3,0,3,0,1,1,21
3136,780281,34,6,12,4,7,2,5,2,2,6,1,1,3,0,3,0,16
3136,790793,35,7,12,4,6,3,6,2,2,0,5,1,4,1,2,0,19
3136,790792,38,5,10,5,7,0,3,7,9,2,3,2,1,2,0,0,17
3136,785246,26,3,9,3,4,0,5,0,1,0,3,0,2,2,1,0,6
3136,790794,18,0,1,0,1,0,0,2,2,1,3,0,4,0,0,1,2
3136,780886,23,1,3,1,1,0,2,0,0,0,3,5,2,0,5,0,2
3136,796351,2,0,0,0,0,0,0,0,0,0,1,0,0,0,0,0,0
3136,796353,5,0,1,0,1,0,0,0,0,0,0,0,1,0,0,0,0
3137,797142,23,1,2,1,2,0,0,2,2,4,1,2,3,0,1,1,4
3137,791522,39,7,19,5,16,2,3,5,7,6,2,3,3,1,1,1,21
3137,786351,21,1,5,1,4,0,1,0,1,1,2,0,4,0,2,0,2
3137,797146,35,7,19,4,9,3,10,11,11,1,2,1,1,3,2,0,28
3137,797143,36,7,12,5,8,2,4,4,4,1,5,2,2,1,3,0,20
3137,791520,16,1,3,1,3,0,0,0,0,0,1,0,1,0,0,0,2
3137,797147,16,1,1,1,1,0,0,0,0,0,2,1,0,2,3,0,2
3137,785816,12,0,0,0,0,0,0,0,0,0,0,0,5,1,0,0,0
3137,797144,2,0,0,0,0,0,0,0,0,0,0,0,1,0,0,0,0
3138,792486,13,0,4,0,1,0,3,0,0,0,0,3,1,0,0,0,0
3138,785772,25,4,5,4,5,0,0,5,6,2,5,1,4,2,0,0,13
3138,785778,25,3,9,2,5,1,4,1,2,1,10,2,1,0,2,0,8
3138,785766,21,0,8,0,5,0,3,0,0,0,4,0,1,0,1,0,0
3138,780543,37,9,16,8,13,1,3,7,7,0,4,3,1,1,4,0,26
3138,792481,15,5,7,5,7,0,0,0,0,2,1,0,4,1,2,0,10
3138,792488,14,2,4,2,3,0,1,1,1,0,0,0,0,0,0,0,5
3138,780546,14,2,3,0,0,2,3,0,0,0,2,0,2,0,0,0,6
3138,797419,19,2,2,2,2,0,0,2,2,0,1,3,3,2,1,0,6
3138,792482,17,2,2,2,2,0,0,0,0,1,5,1,2,0,2,0,4
3139,791032,29,2,5,1,2,1,3,1,2,2,3,4,3,0,0,0,6
3139,796689,21,4,7,4,7,0,0,0,1,2,2,0,4,1,1,1,8
3139,791030,32,3,12,1,6,2,6,5,6,0,2,5,4,1,2,0,13
3139,785477,38,4,13,1,4,3,9,5,6,0,5,3,1,1,4,1,16
3139,785475,28,4,8,1,3,3,5,0,0,0,5,0,4,1,3,0,11
3139,791029,9,1,2,1,1,0,1,1,1,0,0,0,1,0,1,0,3
3139,791031,17,2,5,2,4,0,1,1,2,0,2,0,2,0,0,0,5
3139,780338,3,0,0,0,0,0,0,0,0,0,0,0,1,0,0,0,0
3139,796687,23,2,6,1,3,1,3,2,2,0,5,2,0,0,0,0,7
3140,791686,24,1,6,1,5,0,1,2,2,1,6,1,3,1,4,0,4
3140,798028,19,2,3,1,2,1,1,2,2,0,3,0,3,1,3,0,7
3140,790940,36,5,11,2,6,3,5,7,9,1,2,0,1,5,1,1,20
3140,786060,29,5,11,3,4,2,7,1,2,0,4,2,1,0,1,1,13
3140,780770,34,1,8,1,5,0,3,8,8,0,3,2,2,3,2,0,10
3140,792271,19,3,4,3,4,0,0,0,0,1,3,2,1,0,1,0,6
3140,792269,16,0,1,0,1,0,0,0,0,0,3,0,1,1,0,2,0
3140,798022,7,0,3,0,1,0,2,0,0,0,0,0,1,1,0,0,0
3140,792270,16,0,0,0,0,0,0,0,0,0,1,1,0,1,0,0,0
3141,785589,36,1,5,0,3,1,2,2,2,0,7,0,3,0,4,0,5
3141,791216,26,5,12,1,7,4,5,0,1,2,6,3,1,1,5,0,14
3141,791215,22,2,4,2,3,0,1,0,0,1,3,4,3,0,2,0,4
3141,791213,35,5,15,4,7,1,8,0,0,1,2,0,1,0,4,0,11
3141,776313,33,3,8,0,2,3,6,0,0,1,2,1,2,1,3,2,9
3141,791209,4,0,1,0,1,0,0,0,0,0,1,0,0,0,0,0,0
3141,796917,18,2,4,1,2,1,2,0,0,0,2,2,5,1,0,0,5
3141,776364,23,1,4,1,2,0,2,4,4,0,3,5,2,1,3,0,6
3141,791207,3,1,1,1,1,0,0,0,0,0,0,0,0,0,0,0,2
3142,785366,33,4,12,3,6,1,6,0,0,0,2,4,2,0,1,0,9
3142,780863,34,4,14,3,11,1,3,9,14,2,2,1,2,2,0,1,18
3142,791974,24,1,7,1,4,0,3,3,3,1,1,1,0,0,1,0,5
3142,796778,22,2,10,2,9,0,1,2,2,3,4,2,1,1,1,0,6
3142,781107,20,1,2,1,2,0,0,2,4,1,2,0,4,0,0,1,4
3142,791972,27,6,9,3,5,3,4,1,1,3,4,0,2,1,2,0,16
3142,796777,11,0,0,0,0,0,0,0,0,0,0,2,1,0,1,0,0
3142,780867,10,0,1,0,1,0,0,0,0,1,0,1,4,0,0,1,0
3142,791971,19,3,6,2,4,1,2,1,3,0,1,0,3,1,0,0,8
3143,780259,38,8,11,5,6,3,5,6,7,0,13,3,4,1,5,3,25
3143,785282,19,2,5,0,1,2,4,2,2,0,0,2,1,0,1,0,8
3143,781502,30,2,4,2,3,0,1,3,4,0,4,4,3,0,1,1,7
3143,786516,15,1,4,1,1,0,3,0,0,0,0,0,1,0,0,0,2
3143,792277,6,0,1,0,1,0,0,0,0,0,1,0,3,0,0,0,0
3143,785913,24,7,8,7,8,0,0,2,4,2,2,1,3,0,2,1,16
3143,781464,32,1,5,1,2,0,3,2,2,0,2,3,3,1,2,0,4
3143,781501,28,4,4,4,4,0,0,0,0,0,3,2,2,1,1,1,8
3143,798058,8,0,2,0,0,0,2,0,0,0,0,1,0,0,0,0,0
3144,792232,27,4,9,3,3,1,6,0,0,4,3,0,0,1,0,4,9
3144,785841,33,4,8,2,4,2,4,2,2,4,6,2,1,2,2,2,12
3144,796609,29,4,12,2,5,2,7,1,3,0,4,1,1,2,1,0,11
3144,786685,32,2,6,2,5,0,1,2,4,1,4,2,3,2,4,0,6
3144,781504,36,4,11,3,6,1,5,3,3,0,3,2,4,2,2,1,12
3144,796613,10,2,4,2,2,0,2,0,2,0,0,1,2,1,3,0,4
3144,791312,4,0,0,0,0,0,0,0,0,1,0,1,1,0,1,0,0
3144,785664,5,1,1,1,1,0,0,0,1,2,1,0,0,0,0,0,2
3144,796611,3,0,2,0,1,0,1,0,0,0,0,0,0,0,0,0,0
3144,792869,14,1,3,1,1,0,2,0,0,1,1,1,0,0,0,0,2
3144,766623,7,1,1,1,1,0,0,2,2,1,1,0,0,0,0,0,4
3145,790907,25,2,8,2,8,0,0,1,1,0,1,0,5,0,1,1,5
3145,787175,33,3,7,1,3,2,4,0,0,3,3,0,2,1,2,0,8
3145,782126,30,1,7,1,3,0,4,0,0,0,3,2,2,0,3,1,2
3145,781393,40,5,15,1,4,4,11,4,4,0,5,1,2,0,4,0,18
3145,775351,40,6,13,6,13,0,0,2,2,2,2,0,2,1,2,0,14
3145,796455,32,1,3,1,3,0,0,0,0,4,8,1,4,1,6,1,2
3145,790910,0,0,0,0,0,0,0,0,0,0,0,0,0,0,0,0,0
3146,786371,34,5,8,5,8,0,0,6,11,2,8,2,2,1,0,1,16
3146,786369,20,4,5,1,2,3,3,1,2,0,3,1,3,0,1,0,12
3146,797074,14,0,3,0,0,0,3,0,0,0,3,1,1,0,1,0,0
3146,797072,35,3,8,3,5,0,3,2,3,0,4,3,3,0,2,0,8
3146,791559,25,0,4,0,2,0,2,0,0,0,1,2,2,1,0,0,0
3146,791558,17,2,2,1,1,1,1,0,0,0,2,2,1,0,1,0,5
3146,791555,7,1,4,0,3,1,1,0,0,0,0,0,0,0,1,1,3
3146,786372,8,2,4,2,4,0,0,0,0,1,1,0,2,0,3,0,4
3146,791554,5,0,2,0,0,0,2,0,0,0,1,1,1,0,0,0,0
3146,791556,15,1,1,1,1,0,0,0,0,0,0,1,1,1,0,0,2
3146,786373,20,3,5,2,3,1,2,2,2,0,1,0,0,0,1,1,9
3147,785836,37,3,7,3,6,0,1,1,2,0,7,2,4,2,3,0,7
3147,775872,25,2,9,1,4,1,5,0,0,0,1,0,1,0,2,0,5
3147,785332,22,4,8,4,7,0,1,0,0,1,2,0,3,0,0,0,8
3147,791707,36,1,6,1,2,0,4,1,2,2,4,6,3,0,3,0,3
3147,785838,33,6,9,4,6,2,3,3,3,1,0,2,4,2,1,0,17
3147,791705,15,2,4,2,3,0,1,0,0,0,1,0,1,0,0,0,4
3147,797533,7,1,1,1,1,0,0,5,5,0,0,0,0,0,0,0,7
3147,785892,17,0,5,0,3,0,2,2,2,0,6,0,1,1,1,0,2
3147,791704,8,1,1,0,0,1,1,0,0,0,0,0,2,0,1,0,3
3147,797534,0,0,0,0,0,0,0,0,0,0,0,0,0,0,0,0,0
3148,791266,10,2,2,2,2,0,0,0,0,4,0,0,5,0,2,1,4
3148,785977,34,6,12,3,5,3,7,3,3,3,7,4,4,1,1,0,18
3148,791265,26,2,8,1,3,1,5,0,0,0,0,4,5,1,2,0,5
3148,791269,33,4,11,2,3,2,8,1,2,0,1,3,2,0,2,0,11
3148,785685,36,2,9,2,6,0,3,4,4,0,4,4,1,5,8,0,8
3148,796524,19,3,4,3,4,0,0,3,4,2,4,0,3,1,1,0,9
3148,796523,11,0,1,0,1,0,0,0,0,0,2,0,0,0,2,1,0
3148,796522,5,1,5,0,0,1,5,0,0,0,0,0,0,1,2,0,3
3148,796525,2,0,1,0,0,0,1,0,0,0,0,0,1,0,1,0,0
3148,791270,7,1,1,0,0,1,1,0,0,0,0,0,1,0,0,0,3
3148,791271,11,2,3,2,3,0,0,1,2,3,2,0,2,0,0,0,5
3148,781313,6,0,1,0,0,0,1,0,0,0,0,0,1,0,1,0,0
3149,786542,22,0,1,0,1,0,0,2,3,2,2,1,1,2,2,1,2
3149,786540,29,1,6,1,4,0,2,4,6,1,5,1,4,1,1,1,6
3149,792019,36,4,5,2,2,2,3,4,4,0,4,0,2,0,1,0,14
3149,792015,35,9,17,6,11,3,6,6,7,0,2,2,3,5,8,0,27
3149,775995,37,1,5,1,3,0,2,1,2,0,5,3,3,2,5,0,3
3149,785364,16,1,3,1,3,0,0,2,4,4,1,2,3,1,1,0,4
3149,792016,11,2,4,2,3,0,1,3,3,0,2,0,0,0,2,0,7
3149,791845,14,3,6,1,3,2,3,0,0,1,0,0,2,0,0,0,8
3150,791839,27,8,8,8,8,0,0,2,4,2,2,4,3,2,4,2,18
3150,785322,30,3,7,1,2,2,5,0,0,0,8,4,1,0,1,0,8
3150,792381,30,4,8,2,3,2,5,0,0,0,1,4,4,0,3,0,10
3150,791842,32,5,12,2,3,3,9,2,3,0,8,2,1,1,1,0,15
3150,786616,32,7,10,4,5,3,5,3,6,2,4,3,2,2,3,0,20
3150,797443,4,1,1,1,1,0,0,0,0,1,1,0,0,0,1,0,2
3150,797444,7,0,1,0,1,0,0,1,2,0,0,0,3,0,0,0,1
3150,797442,4,0,2,0,0,0,2,0,0,0,0,0,2,0,1,0,0
3150,786613,12,2,4,1,2,1,2,3,4,1,1,0,2,0,0,1,8
3150,776341,6,0,0,0,0,0,0,0,0,0,0,0,1,0,0,0,0
3150,786736,16,1,2,1,2,0,0,0,0,0,2,2,1,1,1,0,2
3151,792246,23,4,11,4,11,0,0,3,3,4,2,0,1,0,0,0,11
3151,791701,26,3,8,2,7,1,1,0,1,2,1,7,0,0,4,1,7
3151,792245,31,0,3,0,1,0,2,2,2,0,1,0,2,0,1,0,2
3151,781420,30,6,16,4,8,2,8,1,1,1,3,1,5,0,3,0,15
3151,781405,27,4,8,3,4,1,4,1,2,0,4,1,4,1,3,2,10
3151,797924,20,3,5,3,4,0,1,2,2,2,4,0,2,1,2,0,8
3151,792244,7,0,2,0,0,0,2,0,0,0,0,0,2,0,0,0,0
3151,781417,7,0,0,0,0,0,0,0,0,0,2,2,0,0,1,0,0
3151,780615,8,0,1,0,1,0,0,1,2,1,2,2,3,0,0,0,1
3151,797925,20,5,14,4,11,1,3,4,5,5,1,1,1,3,0,0,15
3151,797933,1,0,0,0,0,0,0,0,0,0,0,0,0,0,0,0,0
3152,780832,18,6,7,6,7,0,0,1,3,3,0,0,2,0,0,0,13
3152,790961,26,7,12,7,11,0,1,1,1,3,2,0,1,1,0,0,15
3152,786240,23,1,5,0,3,1,2,0,4,0,1,3,0,1,1,0,3
3152,785278,29,5,7,1,1,4,6,0,0,0,5,2,3,2,1,0,14
3152,780146,27,6,10,0,3,6,7,3,3,0,4,2,1,3,3,0,21
3152,796556,15,2,3,0,0,2,3,0,0,0,2,1,2,0,0,0,6
3152,796554,17,1,5,1,4,0,1,1,2,1,3,0,1,0,1,1,3
3152,790965,1,0,0,0,0,0,0,0,0,0,1,1,0,0,0,0,0
3152,796557,2,0,0,0,0,0,0,0,0,0,1,0,0,0,0,0,0
3152,796555,11,1,5,1,3,0,2,0,0,0,2,1,1,0,0,0,2
3152,790960,1,0,0,0,0,0,0,0,0,0,0,0,1,0,0,0,0
3152,790963,1,0,0,0,0,0,0,0,0,0,0,0,0,0,0,0,0
3152,796553,2,0,0,0,0,0,0,0,0,0,0,0,0,0,0,0,0
3152,780363,1,1,1,1,1,0,0,0,0,0,0,0,0,0,0,0,2
3152,775860,26,4,7,2,3,2,4,1,1,0,5,10,1,1,2,0,11
3153,792265,29,8,14,6,9,2,5,1,1,1,5,1,1,0,1,0,19
3153,792266,18,2,4,1,1,1,3,0,0,1,2,0,2,0,4,1,5
3153,786152,17,1,5,1,5,0,0,2,2,0,3,3,2,0,1,1,4
3153,798003,22,1,1,1,1,0,0,0,0,0,2,3,2,1,6,1,2
3153,798006,23,1,5,0,0,1,5,0,0,0,4,1,1,0,1,0,3
3153,798007,17,2,3,1,1,1,2,0,1,1,2,2,0,0,2,0,5
3153,798002,13,1,1,1,1,0,0,0,0,0,2,1,2,2,1,0,2
3153,798005,5,1,3,1,3,0,0,0,1,0,2,0,0,0,0,0,2
3153,798009,29,4,9,2,3,2,6,4,4,0,2,2,1,1,0,0,14
3153,792267,27,1,4,0,0,1,4,0,0,0,0,2,2,1,1,0,3
3154,796410,29,9,19,9,19,0,0,7,9,7,2,1,2,1,2,0,25
3154,790856,17,1,7,1,7,0,0,2,4,5,5,1,2,1,1,0,4
3154,796413,27,4,8,0,0,4,8,0,0,0,1,3,0,0,1,0,12
3154,796408,15,2,7,1,4,1,3,0,0,0,0,0,1,0,1,0,5
3154,796407,31,3,7,2,5,1,2,1,1,3,1,3,2,0,0,0,8
3154,780452,29,2,7,1,6,1,1,0,0,3,5,4,2,1,0,0,5
3154,796409,23,1,6,0,0,1,6,0,0,0,3,2,0,0,2,0,3
3154,796412,9,1,2,1,1,0,1,0,0,1,1,0,0,1,0,1,2
3154,796411,5,1,4,1,4,0,0,0,0,1,1,0,1,0,1,1,2
3154,780450,15,0,2,0,0,0,2,0,0,0,5,1,0,0,0,0,0
3155,785423,36,9,14,2,3,7,11,0,1,0,9,0,3,0,1,1,25
3155,775676,17,4,6,4,6,0,0,0,3,0,2,3,3,0,1,1,8
3155,786298,38,2,8,1,2,1,6,0,0,0,3,5,2,1,1,0,5
3155,785425,30,2,9,0,4,2,5,0,0,1,3,1,0,2,3,0,6
3155,785422,37,7,12,7,7,0,5,0,0,0,1,5,0,1,3,0,14
3155,774957,18,2,4,1,3,1,1,0,0,0,0,2,1,1,0,0,5
3155,796431,18,0,1,0,0,0,1,0,0,2,4,1,1,1,0,1,0
3155,793801,5,0,1,0,0,0,1,2,2,0,0,0,1,0,0,0,2
3155,796429,1,0,0,0,0,0,0,0,0,0,0,0,0,0,0,0,0
3156,781249,32,7,14,3,3,4,11,3,3,0,2,4,1,3,2,2,21
3156,775165,35,1,3,0,0,1,3,0,0,0,8,1,2,1,0,0,3
3156,785514,22,4,7,4,6,0,1,1,1,0,1,2,5,0,1,1,9
3156,785515,33,1,5,0,2,1,3,4,4,0,2,6,2,3,2,0,7
3156,781253,35,3,7,1,3,2,4,1,4,0,4,0,1,1,1,1,9
3156,796953,8,1,2,1,2,0,0,0,0,0,0,0,0,0,0,0,2
3156,796951,3,0,1,0,0,0,1,0,0,0,0,0,0,0,0,0,0
3156,791252,2,0,2,0,2,0,0,0,0,0,1,0,0,0,0,0,0
3156,791687,30,5,14,2,4,3,10,1,1,1,3,1,3,2,3,1,14
3157,781103,29,8,11,8,11,0,0,1,3,2,8,1,1,0,3,1,17
3157,797568,34,3,6,3,4,0,2,6,6,2,3,1,3,1,1,0,12
3157,797566,32,1,5,1,3,0,2,2,2,0,1,0,0,1,2,0,4
3157,781191,38,2,13,2,8,0,5,6,6,1,9,10,3,3,2,0,10
3157,781102,25,3,3,3,3,0,0,0,0,0,7,0,3,1,4,0,6
3157,791907,2,0,1,0,1,0,0,0,0,0,1,0,0,0,0,0,0
3157,791905,8,2,4,2,3,0,1,0,0,0,3,0,1,1,0,1,4
3157,791904,6,1,4,1,3,0,1,0,0,0,1,0,0,0,1,0,2
3157,781364,16,1,1,1,1,0,0,0,0,0,0,0,4,0,3,0,2
3157,791906,10,2,3,2,3,0,0,0,0,0,0,0,2,0,0,0,4
3158,790879,9,0,0,0,0,0,0,2,2,0,2,0,1,0,2,0,2
3158,779985,26,3,9,2,4,1,5,0,0,3,3,3,2,0,0,0,7
3158,790882,14,2,5,2,3,0,2,0,0,0,3,0,2,1,2,0,4
3158,790876,29,4,11,3,7,1,4,1,2,0,3,4,1,2,3,0,10
3158,774987,30,5,14,4,5,1,9,2,2,0,4,3,4,1,1,0,13
3158,785432,23,2,6,2,6,0,0,2,2,4,5,1,0,0,1,3,6
3158,785699,15,1,3,1,1,0,2,0,0,0,1,2,1,2,2,1,2
3158,781062,30,10,14,2,3,8,11,1,3,0,5,2,1,2,1,0,29
3158,790877,22,0,0,0,0,0,0,2,3,1,2,2,3,1,1,0,2
3158,796434,2,0,2,0,0,0,2,0,0,0,0,0,1,0,0,0,0
3159,791980,27,7,9,2,3,5,6,0,2,2,1,1,1,2,1,0,19
3159,785972,28,3,8,1,4,2,4,3,4,0,4,2,3,0,1,0,11
3159,785967,22,1,4,1,4,0,0,0,2,1,5,1,3,2,7,1,2
3159,791977,22,1,7,0,4,1,3,2,2,0,3,0,0,0,0,0,5
3159,791978,38,5,10,3,6,2,4,3,4,0,3,4,1,3,3,0,15
3159,780160,26,0,4,0,4,0,0,0,0,1,3,2,3,1,0,0,0
3159,791976,21,7,16,3,10,4,6,1,1,2,0,1,3,0,1,0,19
3159,785973,12,0,2,0,1,0,1,0,0,0,4,2,0,0,0,0,0
3159,797800,3,0,0,0,0,0,0,0,0,0,1,0,0,0,1,0,0
3159,797801,1,0,0,0,0,0,0,0,0,0,0,0,0,0,0,0,0
3160,786805,19,1,7,1,7,0,0,0,0,5,0,4,2,1,2,0,2
3160,774936,27,6,13,6,11,0,2,3,4,3,4,4,4,0,1,1,15
3160,790932,28,6,11,3,7,3,4,6,9,1,2,2,1,0,0,0,21
3160,781345,29,2,3,1,2,1,1,2,3,1,3,4,3,4,3,0,7
3160,786803,23,3,5,2,4,1,1,0,0,0,3,3,2,3,1,0,7
3160,796490,1,0,0,0,0,0,0,0,0,0,0,0,1,0,1,0,0
3160,796488,2,0,0,0,0,0,0,0,0,0,1,0,0,0,0,0,0
3160,790934,18,3,9,3,8,0,1,0,0,3,3,0,3,1,0,1,6
3160,786804,9,1,3,0,0,1,3,2,4,0,3,0,4,0,3,1,5
3160,796487,6,1,4,0,0,1,4,0,0,0,0,0,0,0,1,0,3
3160,790931,17,2,7,1,5,1,2,1,1,2,3,3,1,1,0,0,6
3160,790933,16,5,7,4,5,1,2,0,0,0,1,0,2,1,1,0,11
3160,780033,4,0,0,0,0,0,0,0,0,0,0,1,0,0,0,0,0
3160,780030,1,0,0,0,0,0,0,0,0,0,0,0,0,0,0,0,0
3161,780201,30,4,4,4,4,0,0,3,3,1,6,2,5,0,1,2,11
3161,797210,36,5,9,4,8,1,1,4,6,0,1,4,2,0,3,0,15
3161,791467,32,2,12,2,7,0,5,4,5,0,7,0,3,1,2,1,8
3161,786311,35,6,18,4,6,2,12,2,2,0,1,1,0,1,3,0,16
3161,775516,20,0,0,0,0,0,0,4,6,0,3,3,3,1,3,0,4
3161,798344,14,2,2,1,1,1,1,2,2,1,2,0,3,0,2,1,7
3161,797209,21,0,2,0,1,0,1,0,0,3,1,1,2,0,3,2,0
3161,791470,10,2,4,2,4,0,0,0,0,1,0,0,1,0,0,0,4
3161,791471,2,0,0,0,0,0,0,0,0,1,1,0,1,0,1,0,0
3162,780686,34,11,17,11,17,0,0,1,6,2,5,0,4,0,1,0,23
3162,780683,18,1,2,0,0,1,2,2,2,1,2,0,4,0,1,1,5
3162,797681,20,3,3,1,1,2,2,0,0,0,0,0,5,1,3,0,8
3162,786112,37,5,13,5,8,0,5,4,7,1,1,7,4,0,3,1,14
3162,780688,38,1,7,1,5,0,2,3,4,3,3,1,1,1,2,0,5
3162,797682,11,3,3,3,3,0,0,0,0,1,3,0,2,0,0,0,6
3162,797680,21,2,5,1,1,1,4,0,0,0,0,0,1,1,0,0,5
3162,797679,3,0,1,0,0,0,1,0,0,0,0,0,0,0,1,0,0
3162,780772,2,0,1,0,0,0,1,0,0,0,0,0,1,0,0,0,0
3162,780689,16,1,1,0,0,1,1,0,0,0,1,0,0,1,0,0,3
3163,796657,21,3,7,2,4,1,3,4,4,3,1,0,1,0,0,1,11
3163,796651,21,1,2,0,0,1,2,0,0,0,2,3,3,1,0,0,3
3163,791323,30,2,4,2,3,0,1,2,3,0,4,2,0,0,3,0,6
3163,791320,38,6,19,6,18,0,1,1,2,1,2,2,2,1,3,0,13
3163,781511,29,7,11,1,4,6,7,10,10,0,2,5,4,0,0,0,30
3163,796650,17,2,6,2,4,0,2,1,3,3,2,0,2,0,3,1,5
3163,796656,19,1,1,1,1,0,0,0,0,0,5,2,4,0,0,0,2
3163,792257,10,1,1,1,1,0,0,2,2,0,1,1,2,0,2,0,4
3163,796654,10,1,1,0,0,1,1,1,2,1,2,0,0,0,0,0,4
3163,791321,5,0,0,0,0,0,0,1,2,0,0,0,0,0,0,0,1
3164,780765,38,8,14,6,7,2,7,6,7,0,9,6,3,0,5,1,24
3164,781301,19,1,3,1,3,0,0,0,0,4,2,0,1,0,0,4,2
3164,786255,37,7,11,5,8,2,3,3,4,1,6,0,2,1,3,0,19
3164,780762,31,2,6,1,3,1,3,2,3,1,4,1,1,2,0,0,7
3164,780768,27,2,5,0,0,2,5,4,4,1,0,3,3,1,0,0,10
3164,791729,22,2,6,2,3,0,3,0,0,1,2,1,4,1,1,3,4
3164,780755,12,0,1,0,0,0,1,0,0,0,1,0,3,0,2,0,0
3164,776241,14,0,2,0,0,0,2,2,2,0,0,1,2,1,1,0,2
3165,785498,35,4,9,4,8,0,1,1,2,0,3,1,4,1,4,1,9
3165,776469,28,2,7,2,6,0,1,1,3,0,6,3,2,0,1,0,5
3165,796705,35,4,8,1,4,3,4,0,0,0,4,2,2,0,2,0,11
3165,796708,32,8,14,3,6,5,8,1,2,0,2,5,4,0,1,0,22
3165,776322,33,3,6,1,1,2,5,2,2,0,0,0,3,0,2,0,10
3165,796706,20,1,3,0,2,1,1,0,0,4,0,0,2,3,0,0,3
3165,785500,17,0,2,0,0,0,2,0,0,0,1,1,1,0,0,0,0
3166,797779,22,1,4,0,2,1,2,2,6,3,2,1,3,2,0,2,5
3166,797769,33,6,16,4,11,2,5,2,2,0,9,0,0,2,0,0,16
3166,786256,27,4,10,4,9,0,1,1,1,0,4,0,3,0,1,0,9
3166,797768,22,0,6,0,5,0,1,0,0,1,1,4,2,2,2,0,0
3166,775106,28,2,5,2,4,0,1,5,6,0,2,1,2,1,2,0,9
3166,797770,5,0,0,0,0,0,0,0,0,0,1,0,0,1,0,0,0
3166,785568,12,1,3,1,3,0,0,0,0,0,1,1,3,0,2,0,2
3166,797778,10,1,6,0,3,1,3,2,2,1,0,0,0,0,1,0,5
3166,797780,30,1,1,1,1,0,0,2,2,0,0,0,1,1,1,0,4
3166,797774,11,0,3,0,0,0,3,0,0,0,1,1,1,1,0,0,0
3167,781044,26,6,11,2,4,4,7,1,4,1,5,0,2,0,1,0,17
3167,791795,26,5,6,5,6,0,0,6,6,3,2,1,1,0,1,0,16
3167,786489,19,0,4,0,1,0,3,0,2,0,3,1,4,1,1,0,0
3167,786488,26,4,10,2,8,2,2,1,2,2,10,1,4,0,2,0,11
3167,781038,28,5,8,3,5,2,3,1,1,1,4,4,2,0,3,0,13
3167,797620,19,1,4,1,3,0,1,0,2,1,1,0,3,0,2,0,2
3167,786490,2,0,0,0,0,0,0,0,0,0,0,0,2,0,0,0,0
3167,797621,25,2,4,1,1,1,3,0,0,0,3,0,0,0,2,0,5
3167,797619,25,2,6,2,6,0,0,0,0,1,5,4,2,1,3,0,4
3167,786487,4,0,0,0,0,0,0,0,0,0,1,0,0,0,2,0,0
3168,791257,21,2,4,2,4,0,0,0,0,3,7,0,2,0,1,1,4
3168,791838,20,4,9,1,4,3,5,0,0,0,1,1,2,0,0,0,11
3168,786620,30,5,9,3,6,2,3,1,1,0,3,1,3,1,1,0,13
3168,781606,32,3,7,2,4,1,3,0,0,0,3,5,2,1,0,0,7
3168,781257,34,3,8,1,1,2,7,2,2,0,4,2,1,1,2,0,10
3168,796955,9,2,4,2,4,0,0,2,5,2,1,0,1,0,0,0,6
3168,780900,14,3,7,2,6,1,1,0,2,3,2,1,1,0,1,0,7
3168,796954,19,2,5,1,2,1,3,0,0,0,2,1,0,0,1,0,5
3168,781263,21,4,8,4,8,0,0,1,1,1,0,4,0,0,0,0,9
3169,786623,27,5,6,5,6,0,0,0,0,3,6,0,4,0,1,1,10
3169,797405,29,5,8,5,8,0,0,2,2,2,3,0,2,1,2,0,12
3169,791833,19,1,3,1,2,0,1,2,3,0,0,2,1,0,3,0,4
3169,785920,36,3,10,2,6,1,4,0,0,0,6,2,0,1,4,0,7
3169,785698,19,3,8,3,3,0,5,1,1,0,2,1,0,0,0,0,7
3169,797413,2,0,1,0,0,0,1,0,0,0,0,0,1,0,0,0,0
3169,786624,10,2,2,2,2,0,0,0,0,1,3,0,1,0,1,1,4
3169,797406,1,0,0,0,0,0,0,0,0,0,0,0,0,0,0,0,0
3169,797404,1,0,0,0,0,0,0,0,0,0,0,0,0,0,0,0,0
3169,797403,1,0,0,0,0,0,0,0,0,0,0,0,0,1,0,0,0
3169,791834,30,2,6,1,5,1,1,0,0,0,0,1,2,0,1,0,5
3169,784077,25,3,9,2,5,1,4,0,0,0,4,1,3,1,0,0,7
3170,792029,23,5,6,2,3,3,3,0,0,0,4,2,2,0,1,0,13
3170,761149,21,1,3,1,1,0,2,2,2,0,2,1,3,1,0,0,4
3170,792032,22,9,13,4,7,5,6,8,9,2,4,3,3,0,0,0,31
3170,792031,26,2,4,1,2,1,2,0,0,0,3,3,2,2,0,0,5
3170,780828,27,6,15,3,9,3,6,2,2,1,7,5,2,1,4,0,17
3170,797640,15,1,1,1,1,0,0,1,2,1,1,1,2,0,2,0,3
3170,797637,21,3,6,2,3,1,3,0,0,0,2,4,0,0,0,0,7
3170,792027,14,3,7,3,5,0,2,0,0,0,1,2,1,0,0,0,6
3170,797641,11,2,4,2,4,0,0,0,0,2,2,0,3,0,1,1,4
3170,797642,7,0,1,0,1,0,0,0,0,0,0,1,0,0,0,0,0
3170,797638,4,1,2,0,0,1,2,0,0,0,1,0,0,0,0,0,3
3170,792030,5,0,1,0,1,0,0,0,0,0,0,0,1,0,0,0,0
3170,797639,4,0,0,0,0,0,0,0,0,0,0,0,0,0,0,0,0
3171,796860,16,2,4,2,3,0,1,2,2,1,4,0,4,0,4,1,6
3171,791185,30,4,12,1,4,3,8,0,0,1,6,0,2,0,6,0,11
3171,775208,19,1,2,1,2,0,0,0,0,0,0,0,0,0,0,0,2
3171,785650,15,2,5,1,3,1,2,0,0,0,3,0,3,0,0,0,5
3171,785649,19,2,5,0,1,2,4,1,1,0,1,0,2,0,4,0,7
3171,791183,17,1,1,1,1,0,0,2,2,2,0,0,0,2,0,0,4
3171,796861,19,4,7,3,3,1,4,0,0,0,0,1,1,1,1,0,9
3171,796857,16,0,2,0,1,0,1,0,0,1,2,1,2,0,1,0,0
3171,796856,14,1,7,1,5,0,2,1,1,0,1,1,0,0,2,0,3
3171,791184,17,0,5,0,3,0,2,0,1,1,2,3,3,1,1,0,0
3171,796859,9,1,2,1,1,0,1,0,1,1,0,0,1,0,0,0,2
3171,796862,4,1,1,0,0,1,1,2,2,0,0,1,0,0,0,0,5
3171,793803,3,0,0,0,0,0,0,0,0,0,1,0,0,0,0,0,0
3171,798160,2,0,0,0,0,0,0,0,0,0,0,0,0,0,0,0,0
3172,797529,37,6,10,6,10,0,0,0,0,5,4,2,1,3,0,0,12
3172,797527,21,3,5,2,3,1,2,1,1,2,3,0,3,2,1,2,8
3172,791936,34,5,8,5,8,0,0,1,1,2,4,2,1,0,2,0,11
3172,797532,40,6,19,4,11,2,8,10,10,0,2,12,0,4,2,0,24
3172,785688,22,7,14,3,6,4,8,0,0,0,0,1,5,1,3,0,18
3172,785988,11,0,4,0,4,0,0,0,0,1,0,1,0,0,0,0,0
3172,797528,6,0,0,0,0,0,0,0,0,0,1,0,3,0,0,0,0
3172,791932,15,1,1,0,0,1,1,0,0,0,1,3,0,3,0,0,3
3172,791933,14,1,3,0,0,1,3,2,2,0,0,1,1,1,0,0,5
3173,776174,31,7,8,7,8,0,0,3,4,5,4,2,2,0,4,2,17
3173,791958,39,6,14,6,13,0,1,4,4,7,4,3,2,0,2,0,16
3173,791960,35,4,14,0,2,4,12,4,4,1,2,8,2,3,3,0,16
3173,785861,38,2,5,1,1,1,4,0,1,0,4,4,2,1,4,0,5
3173,781332,33,4,11,2,6,2,5,0,0,0,2,3,5,1,6,0,10
3173,786059,18,3,5,3,4,0,1,1,3,5,4,0,2,0,0,0,7
3173,797704,6,0,2,0,0,0,2,0,0,0,0,0,0,0,0,0,0
3174,796996,17,0,3,0,3,0,0,0,0,1,1,0,4,0,2,0,0
3174,791610,18,1,3,1,3,0,0,3,6,2,1,1,2,1,3,0,5
3174,796994,29,3,8,1,1,2,7,4,4,0,5,4,3,1,0,0,12
3174,791608,37,6,13,0,2,6,11,4,4,0,1,2,2,1,4,0,22
3174,776011,35,4,15,3,13,1,2,3,8,4,7,2,5,1,4,0,12
3174,786413,26,2,6,2,5,0,1,5,7,2,3,3,2,0,0,1,9
3174,791613,26,2,6,2,5,0,1,1,2,0,1,1,3,2,0,0,5
3174,786353,12,0,2,0,1,0,1,2,2,0,0,0,0,1,0,0,2
3175,781208,14,1,2,1,2,0,0,1,2,0,6,0,5,0,2,0,3
3175,775489,14,6,9,6,8,0,1,1,1,3,2,0,5,0,2,0,13
3175,785561,25,6,10,6,10,0,0,1,3,5,1,0,4,2,3,1,13
3175,780313,29,6,11,5,8,1,3,5,6,1,3,0,2,2,1,0,18
3175,780766,36,3,7,2,5,1,2,7,9,0,9,3,2,3,6,0,14
3175,796751,19,2,5,2,5,0,0,0,0,1,6,0,3,0,0,3,4
3175,791088,15,1,2,0,0,1,2,2,2,0,2,1,1,0,1,0,5
3175,785560,24,3,10,0,2,3,8,0,0,0,2,4,2,0,2,0,9
3175,785563,23,1,3,1,2,0,1,0,0,1,2,5,2,0,1,0,2
3175,791087,1,0,0,0,0,0,0,0,0,0,0,0,0,0,0,0,0
3176,775324,18,4,6,4,6,0,0,1,2,2,1,1,1,0,0,0,9
3176,791223,26,4,9,4,8,0,1,0,2,2,4,0,5,3,2,0,8
3176,791224,33,7,14,6,11,1,3,4,4,0,6,10,3,3,5,1,19
3176,785571,36,6,12,5,8,1,4,6,6,0,4,3,0,0,3,0,19
3176,786436,9,0,0,0,0,0,0,2,4,0,1,1,0,0,0,1,2
3176,791225,20,3,5,3,5,0,0,1,5,3,6,1,1,0,1,1,7
3176,791811,8,1,1,1,1,0,0,2,2,0,0,0,3,0,1,0,4
3176,796929,14,1,1,0,0,1,1,0,0,0,0,0,3,1,0,0,3
3176,791222,8,0,1,0,0,0,1,0,0,0,0,1,2,1,2,0,0
3176,785564,28,6,6,2,2,4,4,0,0,0,4,0,1,1,1,0,16
3177,792192,20,0,2,0,2,0,0,0,0,2,3,0,4,1,1,0,0
3177,797824,20,1,3,1,2,0,1,2,4,1,0,0,3,0,2,0,4
3177,792190,34,3,9,1,3,2,6,4,4,0,1,6,2,1,2,0,12
3177,786664,37,6,13,3,7,3,6,4,4,1,1,3,4,1,1,0,19
3177,781266,9,1,3,1,1,0,2,0,0,0,0,0,0,0,1,0,2
3177,775116,29,4,8,1,2,3,6,2,2,1,5,2,1,2,3,2,13
3177,797822,33,10,16,6,9,4,7,1,2,0,4,1,3,2,2,0,25
3177,792193,16,2,4,2,4,0,0,2,7,2,1,1,3,0,0,0,6
3177,791928,2,0,0,0,0,0,0,0,0,0,1,0,0,0,1,0,0
3178,780210,38,6,14,6,11,0,3,4,4,4,4,2,1,0,2,1,16
3178,792432,36,3,9,1,4,2,5,4,4,1,5,4,3,1,3,0,12
3178,775005,36,4,16,4,10,0,6,2,2,1,4,2,1,3,2,0,10
3178,791306,15,2,3,2,3,0,0,0,0,1,4,0,3,0,1,1,4
3178,796594,11,1,5,0,2,1,3,0,0,1,0,1,1,0,0,0,3
3178,792433,24,4,10,3,6,1,4,8,9,1,2,1,4,2,2,0,17
3178,796592,23,6,7,6,6,0,1,1,2,3,2,3,4,0,2,0,13
3178,786422,13,0,3,0,3,0,0,0,0,0,1,2,3,0,2,0,0
3178,790880,4,0,1,0,1,0,0,0,0,1,0,0,0,0,0,0,0
3179,796932,33,9,18,4,11,5,7,7,8,0,5,0,2,0,1,0,30
3179,785557,35,5,8,4,7,1,1,2,4,2,5,0,5,1,2,0,13
3179,791230,34,3,4,1,1,2,3,0,0,3,8,1,1,4,2,0,8
3179,791228,28,2,6,2,5,0,1,3,5,2,5,2,3,2,3,0,7
3179,785624,13,0,6,0,3,0,3,0,0,1,0,0,2,0,1,1,0
3179,781444,21,3,7,1,3,2,4,7,10,1,0,2,1,1,5,0,15
3179,791227,21,1,4,0,1,1,3,0,0,0,1,4,1,0,1,0,3
3179,796933,6,1,1,1,1,0,0,0,0,1,0,1,1,0,2,0,2
3179,781198,4,1,1,1,1,0,0,0,0,0,1,0,2,0,0,0,2
3179,791226,5,0,0,0,0,0,0,0,0,0,3,0,3,0,0,1,0
3180,781592,28,0,4,0,4,0,0,5,6,0,4,1,1,0,0,0,5
3180,780229,19,5,7,5,7,0,0,5,7,0,7,1,3,1,4,2,15
3180,795572,29,5,14,4,12,1,2,0,0,0,3,0,2,2,2,0,11
3180,791483,27,4,7,3,5,1,2,2,2,1,1,0,1,0,3,0,11
3180,780228,28,0,4,0,0,0,4,0,0,1,0,0,1,1,0,0,0
3180,791484,2,1,2,0,1,1,1,0,0,0,0,1,0,0,0,0,3
3180,791487,4,0,1,0,1,0,0,0,0,0,0,0,0,0,0,0,0
3180,797195,12,0,1,0,0,0,1,2,2,0,1,0,0,0,0,0,2
3180,791488,12,0,2,0,1,0,1,0,0,0,1,0,0,1,1,0,0
3180,797194,2,1,1,0,0,1,1,0,0,0,0,0,0,0,0,0,3
3180,797193,8,0,1,0,0,0,1,0,0,0,1,1,1,0,1,0,0
3180,791485,8,0,0,0,0,0,0,0,0,0,1,0,0,0,0,0,0
3180,786323,6,0,0,0,0,0,0,0,0,0,2,0,0,0,0,0,0
3180,786322,15,0,2,0,2,0,0,0,0,0,1,0,2,1,3,0,0
3181,791482,26,5,7,3,3,2,4,0,0,2,1,0,1,2,1,0,12
3181,786319,23,2,4,2,4,0,0,0,0,1,8,0,3,1,1,1,4
3181,786318,34,8,17,4,7,4,10,0,0,1,6,3,2,2,3,0,20
3181,784268,34,2,7,0,4,2,3,2,2,0,1,5,0,1,4,0,8
3181,780223,29,3,9,2,4,1,5,0,0,2,2,1,3,2,0,0,7
3181,797198,9,1,3,0,1,1,2,0,0,0,2,2,2,0,0,1,3
3181,791481,16,1,3,1,2,0,1,0,0,0,0,0,1,0,1,1,2
3181,780225,13,2,4,1,3,1,1,0,0,1,1,1,1,0,1,0,5
3181,797200,5,0,1,0,0,0,1,0,0,0,0,0,0,0,1,0,0
3181,797199,8,2,2,1,1,1,1,0,0,0,2,1,1,0,1,0,5
3181,797201,3,0,0,0,0,0,0,0,0,0,2,0,1,0,0,0,0
3182,792078,18,2,3,2,3,0,0,5,5,1,3,0,1,0,3,0,9
3182,786067,37,4,10,4,10,0,0,2,3,0,4,2,0,0,3,0,10
3182,797661,30,5,7,3,3,2,4,3,4,1,2,1,2,0,4,0,15
3182,785591,29,1,3,1,2,0,1,2,2,0,1,1,3,0,3,0,4
3182,780258,22,3,5,3,5,0,0,1,2,1,2,0,4,0,0,0,7
3182,797662,22,1,3,1,2,0,1,2,4,1,7,0,0,0,2,0,4
3182,792082,18,3,4,2,3,1,1,2,2,1,3,1,2,0,3,0,9
3182,791952,3,0,1,0,1,0,0,0,0,0,1,0,0,0,0,0,0
3182,797660,11,1,1,1,1,0,0,0,0,0,0,1,2,0,0,1,2
3182,792083,10,1,2,1,2,0,0,0,0,0,0,2,2,0,0,0,2
3183,780095,32,5,6,5,6,0,0,1,3,0,2,1,3,2,2,0,11
3183,776321,30,4,7,4,6,0,1,2,2,1,2,0,3,1,0,0,10
3183,786081,20,1,7,1,3,0,4,0,0,0,0,1,1,1,1,0,2
3183,785431,37,7,11,3,6,4,5,2,2,1,2,7,3,1,0,1,20
3183,780232,37,4,10,1,5,3,5,6,8,0,1,4,2,2,0,0,17
3183,785356,18,3,4,0,0,3,4,0,0,0,4,0,1,0,0,0,9
3183,789040,26,3,8,3,5,0,3,2,2,1,2,2,3,2,0,0,8
3184,785800,28,3,9,1,3,2,6,0,0,0,4,0,1,1,1,0,8
3184,785799,24,1,4,1,4,0,0,2,2,3,4,1,1,0,0,0,4
3184,780760,19,1,3,1,2,0,1,2,2,1,1,0,4,2,0,4,4
3184,780553,34,9,19,7,16,2,3,4,6,0,5,3,0,1,5,1,24
3184,791678,6,0,1,0,1,0,0,0,0,1,0,1,0,0,0,0,0
3184,791679,7,0,2,0,2,0,0,4,6,3,0,0,1,0,0,0,4
3184,785807,19,0,5,0,3,0,2,0,0,1,2,0,3,0,1,1,0
3184,797427,12,1,3,0,0,1,3,0,0,0,1,0,1,0,1,0,3
3184,780554,26,2,7,1,5,1,2,0,0,0,1,1,0,2,1,0,5
3184,791676,25,2,5,1,1,1,4,4,4,0,1,3,4,3,0,0,9
3185,791220,22,3,5,2,4,1,1,0,1,3,0,2,4,0,1,0,7
3185,791219,25,3,8,3,5,0,3,0,0,1,4,1,3,0,2,0,6
3185,776217,31,2,6,2,6,0,0,5,8,6,5,1,3,0,0,0,9
3185,786396,34,5,8,2,4,3,4,3,4,0,4,0,2,1,3,0,16
3185,780730,31,8,18,6,13,2,5,0,0,3,8,3,3,2,6,1,18
3185,786824,20,0,1,0,0,0,1,3,4,0,3,0,0,0,2,0,3
3185,791221,2,0,0,0,0,0,0,0,0,0,0,0,0,0,0,0,0
3185,796923,7,1,2,1,2,0,0,0,0,2,2,0,2,0,1,0,2
3185,796924,1,0,0,0,0,0,0,0,0,0,0,0,0,0,0,0,0
3185,796920,4,1,1,0,0,1,1,0,0,0,0,0,0,0,0,0,3
3185,790818,23,2,7,2,7,0,0,3,3,0,1,1,2,1,3,0,7
3186,796516,24,1,2,1,2,0,0,1,2,2,5,0,3,0,3,4,3
3186,792318,30,3,9,3,9,0,0,0,0,3,7,1,2,2,2,0,6
3186,796517,27,2,9,2,6,0,3,4,6,1,2,0,2,1,3,0,8
3186,786717,32,4,14,4,9,0,5,1,4,4,4,0,1,3,2,0,9
3186,780753,31,4,11,3,7,1,4,0,0,2,2,3,2,4,5,0,9
3186,796520,12,1,2,1,1,0,1,2,2,0,0,0,0,0,4,0,4
3186,796518,16,2,5,2,4,0,1,0,0,0,3,1,1,0,0,0,4
3186,792315,5,0,1,0,0,0,1,0,0,0,0,1,0,1,0,0,0
3186,775329,14,1,5,0,0,1,5,2,2,0,2,1,3,0,1,0,5
3186,796519,9,0,1,0,1,0,0,1,2,0,1,0,0,1,0,0,1
3187,799915,9,1,4,1,4,0,0,0,0,1,1,0,1,0,1,0,2
3187,792632,32,3,6,3,6,0,0,1,1,2,4,1,2,3,3,1,7
3187,792626,15,1,4,1,3,0,1,0,0,1,4,4,1,0,1,0,2
3187,781491,18,1,5,0,2,1,3,0,1,0,3,1,1,0,3,2,3
3187,780250,36,8,13,5,7,3,6,5,6,2,6,2,3,1,2,3,24
3187,796634,16,2,5,2,5,0,0,0,0,1,2,1,3,1,1,0,4
3187,796638,8,0,3,0,2,0,1,0,0,0,4,0,0,0,2,0,0
3187,796645,18,5,11,4,10,1,1,1,1,1,0,1,1,1,0,0,12
3187,792627,14,0,2,0,1,0,1,2,2,0,2,0,1,0,3,0,2
3187,792629,25,2,3,2,3,0,0,0,1,0,4,7,3,7,4,0,4
3187,792631,9,2,3,0,0,2,3,0,0,0,0,0,0,0,0,0,6
3188,775913,22,4,6,4,6,0,0,6,11,2,1,0,4,1,1,0,14
3188,797331,42,5,8,3,5,2,3,1,1,1,0,1,0,3,3,0,13
3188,791737,44,2,10,2,6,0,4,17,19,0,7,5,4,3,5,0,21
3188,783524,43,4,18,1,8,3,10,6,7,0,1,1,4,1,1,2,17
3188,780561,37,1,5,1,1,0,4,4,4,0,6,0,3,2,3,0,6
3188,791734,5,0,0,0,0,0,0,1,2,1,1,0,0,1,2,0,1
3188,781516,11,1,1,1,1,0,0,3,4,1,2,1,3,0,0,2,5
3188,797332,7,1,1,1,1,0,0,0,0,1,0,0,0,1,0,0,2
3188,797333,22,0,1,0,1,0,0,0,0,1,1,2,5,1,1,0,0
3188,786223,5,0,0,0,0,0,0,0,0,0,0,0,3,1,1,0,0
3188,786220,12,1,3,1,3,0,0,2,3,1,1,0,0,0,0,1,4
3189,792186,15,4,5,4,5,0,0,0,0,0,3,0,5,0,0,0,8
3189,781447,11,2,3,2,3,0,0,4,4,1,0,0,5,0,2,0,8
3189,797816,46,7,14,3,6,4,8,0,0,0,2,3,4,0,4,0,18
3189,792183,26,2,6,2,4,0,2,3,4,0,5,7,5,1,7,1,7
3189,786675,29,2,4,1,2,1,2,0,1,0,3,3,1,0,1,0,5
3189,797821,29,1,6,1,3,0,3,3,6,2,7,1,4,1,3,0,5
3189,797820,9,0,0,0,0,0,0,0,0,0,2,0,1,1,1,0,0
3189,780433,25,3,5,3,5,0,0,4,4,0,1,0,5,0,1,1,10
3189,781490,12,0,1,0,1,0,0,0,0,0,1,1,0,1,4,1,0
3189,792188,38,4,7,2,4,2,3,8,9,3,4,1,4,1,2,1,18
3189,792185,10,0,3,0,3,0,0,0,0,1,1,0,2,0,0,0,0
3190,775954,26,2,5,2,5,0,0,3,8,2,3,1,1,0,1,0,7
3190,781006,21,1,6,0,4,1,2,3,4,0,2,0,4,0,0,5,6
3190,796194,34,5,15,2,7,3,8,0,0,1,3,1,4,0,1,0,13
3190,790917,32,1,6,1,3,0,3,0,0,2,6,1,3,2,2,2,2
3190,781157,34,4,14,4,9,0,5,8,9,5,2,2,2,0,1,0,16
3190,780648,10,1,1,1,1,0,0,0,0,2,1,0,1,0,0,0,2
3190,796464,30,5,12,5,9,0,3,2,3,3,5,2,0,1,2,0,12
3190,796459,5,1,3,1,3,0,0,1,2,0,1,0,1,0,1,0,3
3190,790916,1,0,1,0,1,0,0,0,0,0,0,0,0,0,0,0,0
3190,790919,3,0,2,0,2,0,0,0,0,1,0,0,0,0,1,0,0
3190,790918,4,1,1,1,1,0,0,0,0,1,1,0,0,0,0,0,2
3191,776110,25,3,5,3,4,0,1,2,5,1,5,0,3,0,1,3,8
3191,780059,33,4,13,3,12,1,1,2,4,3,5,1,3,1,3,2,11
3191,796494,25,4,8,1,3,3,5,0,0,4,1,1,2,0,4,0,11
3191,790944,25,3,5,2,3,1,2,2,4,0,1,2,4,2,0,0,9
3191,780061,31,6,7,2,3,4,4,1,2,0,6,2,0,1,0,0,17
3191,790943,9,0,3,0,2,0,1,0,0,0,3,0,1,0,2,0,0
3191,780058,14,0,4,0,1,0,3,0,0,1,3,0,1,0,0,0,0
3191,796496,11,1,3,0,2,1,1,0,0,1,2,0,1,0,0,0,3
3191,786754,27,5,14,5,12,0,2,2,2,1,1,5,3,0,2,0,12
3191,796499,0,0,0,0,0,0,0,0,0,0,1,0,0,0,0,0,0
3191,790941,0,0,0,0,0,0,0,0,0,0,0,0,0,0,0,0,0
3192,792473,19,2,6,2,4,0,2,4,4,1,4,2,4,1,3,2,8
3192,780043,35,2,2,2,2,0,0,0,0,0,2,2,1,0,2,1,4
3192,799276,32,1,5,1,3,0,2,0,0,0,2,0,0,2,2,0,2
3192,785249,38,8,13,5,9,3,4,0,0,1,4,1,1,3,3,0,19
3192,780035,36,3,13,3,11,0,2,5,6,2,1,1,1,2,2,0,11
3192,792471,2,0,1,0,1,0,0,0,0,0,0,0,0,1,0,0,0
3192,785251,11,1,3,1,1,0,2,0,0,0,1,1,3,0,2,0,2
3192,799281,2,0,0,0,0,0,0,0,0,0,0,0,0,0,0,0,0
3192,792477,9,0,1,0,1,0,0,1,2,0,0,0,0,0,0,0,1
3192,780036,15,2,3,0,1,2,2,0,0,0,1,1,5,0,2,0,6
3192,799916,1,0,0,0,0,0,0,0,0,0,0,0,0,0,0,0,0
3193,781579,33,5,8,5,7,0,1,2,4,3,4,2,0,2,0,0,12
3193,786731,34,7,10,7,10,0,0,1,2,4,7,6,2,2,1,4,15
3193,798023,34,5,9,2,4,3,5,0,0,0,3,2,2,0,7,1,13
3193,781584,31,5,13,2,4,3,9,0,0,0,0,0,3,1,1,0,13
3193,780347,30,4,6,4,6,0,0,1,2,1,6,4,3,0,5,2,9
3193,775696,7,2,3,2,3,0,0,1,2,1,1,1,0,1,0,0,5
3193,798026,1,0,0,0,0,0,0,0,0,0,0,0,0,0,1,0,0
3193,776481,5,0,1,0,1,0,0,0,0,3,1,0,2,0,1,0,0
3193,798008,17,2,4,1,1,1,3,0,0,0,1,0,3,1,1,0,5
3193,792358,8,0,1,0,0,0,1,0,0,0,1,0,0,0,1,0,0
3194,796406,33,3,5,3,5,0,0,3,5,4,7,1,2,0,0,1,9
3194,796404,25,3,11,3,8,0,3,0,0,1,5,1,3,2,0,1,6
3194,785434,18,5,9,2,3,3,6,1,2,0,3,0,4,0,1,0,14
3194,781164,17,1,4,1,4,0,0,6,6,2,1,2,2,0,3,0,8
3194,781163,39,6,10,4,6,2,4,2,4,1,1,5,2,2,3,1,16
3194,790849,25,2,7,1,4,1,3,2,2,0,1,6,1,2,2,0,7
3194,790850,25,3,6,0,2,3,4,2,2,0,0,1,0,1,0,0,11
3194,790854,7,0,0,0,0,0,0,0,0,1,0,0,4,0,0,0,0
3194,796405,5,1,2,1,2,0,0,0,0,0,0,1,4,1,0,0,2
3194,790852,1,0,0,0,0,0,0,0,0,0,0,0,0,0,0,0,0
3194,781223,5,0,0,0,0,0,0,0,0,0,0,0,0,0,0,0,0
3195,791058,26,2,3,2,3,0,0,3,11,3,6,0,4,0,3,1,7
3195,785532,29,5,6,5,6,0,0,2,3,0,4,1,4,1,1,0,12
3195,791055,27,3,7,3,5,0,2,0,1,1,1,5,3,2,3,0,6
3195,785530,13,2,3,2,2,0,1,1,2,1,2,0,1,0,2,0,5
3195,775926,31,2,4,0,0,2,4,2,2,0,1,1,1,1,2,0,8
3195,796733,11,0,3,0,1,0,2,0,0,0,0,0,2,0,0,0,0
3195,791057,18,1,3,1,1,0,2,0,0,0,2,0,1,0,0,0,2
3195,775573,25,3,7,1,4,2,3,4,4,1,1,3,3,1,2,0,12
3195,791280,16,4,7,2,4,2,3,2,5,0,4,2,3,0,0,0,12
3195,791059,3,0,0,0,0,0,0,0,0,0,0,0,0,0,0,0,0
3195,791056,1,0,0,0,0,0,0,0,0,0,0,0,0,0,0,0,0
3196,786447,35,6,13,5,11,1,2,5,6,4,2,2,3,2,0,0,18
3196,775074,27,5,6,5,6,0,0,1,3,2,5,2,4,0,1,1,11
3196,786448,26,4,8,3,5,1,3,4,7,3,0,4,5,4,0,0,13
3196,780731,26,3,11,3,7,0,4,2,2,0,2,0,3,0,2,0,8
3196,780462,39,7,19,1,7,6,12,0,0,1,2,4,0,3,1,0,20
3196,791631,12,0,2,0,0,0,2,0,0,0,2,3,2,0,1,0,0
3196,796971,14,3,5,2,3,1,2,0,0,0,0,0,4,0,2,0,7
3196,786132,10,0,2,0,1,0,1,2,2,1,0,2,0,0,0,0,2
3196,776365,8,0,0,0,0,0,0,0,0,1,1,0,2,0,1,0,0
3196,775121,3,0,0,0,0,0,0,0,0,0,0,0,1,0,0,0,0
3197,786029,22,3,3,3,3,0,0,3,3,0,0,0,4,0,2,0,9
3197,781398,31,3,6,2,3,1,3,2,2,2,8,5,3,0,1,0,9
3197,792114,39,8,15,3,5,5,10,8,9,0,3,2,1,1,0,0,29
3197,786018,13,4,5,3,3,1,2,1,2,0,1,0,4,0,4,0,10
3197,775678,32,4,10,3,7,1,3,5,5,0,3,4,2,0,3,0,14
3197,797746,8,1,1,1,1,0,0,0,0,1,0,0,3,0,2,0,2
3197,786022,15,1,3,1,2,0,1,2,3,1,1,1,2,0,2,0,4
3197,797740,21,0,4,0,4,0,0,0,0,0,7,1,2,0,1,0,0
3197,797737,16,2,3,1,2,1,1,1,2,1,2,1,1,1,1,0,6
3197,792112,3,0,0,0,0,0,0,0,0,0,0,0,0,0,0,1,0
3198,792329,29,5,7,3,4,2,3,1,1,3,3,3,0,1,1,0,13
3198,786752,31,9,16,6,10,3,6,0,1,2,9,2,4,1,2,1,21
3198,781384,30,1,4,1,2,0,2,2,2,1,1,1,3,0,2,2,4
3198,781616,35,2,9,1,4,1,5,0,0,1,1,4,2,0,3,1,5
3198,776350,27,3,11,2,6,1,5,3,4,1,6,2,2,0,2,0,10
3198,792330,9,1,2,0,0,1,2,0,0,0,0,0,1,1,2,0,3
3198,785435,5,1,1,0,0,1,1,0,1,0,1,0,3,0,1,0,3
3198,781615,5,1,2,0,0,1,2,0,0,0,2,1,0,0,0,0,3
3198,792601,16,0,2,0,1,0,1,0,0,0,0,1,0,0,0,0,0
3198,786749,13,0,4,0,2,0,2,0,0,1,1,0,3,0,1,0,0
3199,781134,26,5,6,5,6,0,0,0,0,1,2,1,5,0,5,0,10
3199,774874,29,3,5,3,5,0,0,1,5,1,4,1,3,3,2,0,7
3199,786475,37,8,17,5,7,3,10,8,9,1,2,4,4,1,1,0,27
3199,785270,31,3,7,3,4,0,3,1,2,0,4,0,1,0,2,2,7
3199,776038,8,0,2,0,0,0,2,0,0,0,1,0,1,0,0,0,0
3199,780083,6,0,0,0,0,0,0,0,0,0,0,0,1,0,1,0,0
3199,796531,32,3,7,1,4,2,3,0,2,1,8,2,1,1,1,1,8
3199,790946,10,0,2,0,2,0,0,0,0,0,1,0,0,1,0,0,0
3199,786037,8,0,0,0,0,0,0,0,0,1,1,0,1,0,0,0,0
3199,775468,13,1,3,1,3,0,0,2,2,0,2,1,0,1,1,0,4
3200,791903,13,0,2,0,0,0,2,2,4,2,2,0,2,0,1,0,2
3200,797575,26,1,3,1,3,0,0,0,0,3,3,0,2,1,2,0,2
3200,791899,23,5,11,4,10,1,1,0,0,2,5,0,1,2,1,1,11
3200,786512,29,2,12,2,7,0,5,0,0,0,4,3,3,2,3,0,4
3200,786032,35,5,14,4,13,1,1,2,6,2,3,1,3,1,3,0,13
3200,797574,18,2,5,2,3,0,2,0,0,2,1,0,1,0,0,1,4
3200,797573,11,0,2,0,2,0,0,0,0,1,1,0,2,0,2,0,0
3200,786513,4,0,0,0,0,0,0,0,2,0,0,0,1,1,1,0,0
3200,797571,20,2,2,2,2,0,0,0,0,0,1,1,2,0,3,1,4
3200,791901,3,0,0,0,0,0,0,0,0,0,0,0,0,0,0,0,0
3200,786435,18,1,3,1,3,0,0,0,0,0,2,0,1,0,2,0,2
3201,780291,36,4,8,3,5,1,3,3,3,3,6,2,2,2,3,1,12
3201,785607,16,0,2,0,1,0,1,0,0,0,2,0,4,1,1,0,0
3201,796665,24,1,7,1,3,0,4,0,0,0,4,3,1,1,2,0,2
3201,785333,32,4,9,4,6,0,3,2,4,1,4,1,1,2,1,0,10
3201,775305,28,9,14,7,10,2,4,0,1,1,0,3,0,0,2,0,20
3201,796663,1,0,0,0,0,0,0,0,0,0,0,0,0,0,0,0,0
3201,791004,22,4,7,1,3,3,4,0,0,1,3,2,0,2,2,0,11
3201,791006,8,1,1,1,1,0,0,0,0,0,1,0,1,0,0,0,2
3201,796667,1,0,0,0,0,0,0,0,0,0,0,0,0,0,0,0,0
3201,796666,15,2,5,2,2,0,3,1,2,1,0,0,3,0,1,0,5
3201,796664,16,3,4,3,3,0,1,0,0,0,2,1,1,1,1,0,6
3201,791005,1,0,0,0,0,0,0,0,0,0,0,0,0,0,0,0,0
3202,791281,28,7,13,7,12,0,1,1,3,1,4,3,5,1,5,2,15
3202,792276,39,5,11,4,7,1,4,6,6,0,0,3,3,1,2,0,17
3202,791278,33,1,2,0,1,1,1,0,0,3,6,0,1,3,1,3,3
3202,785507,25,1,5,1,2,0,3,0,0,2,3,1,3,0,1,0,2
3202,775814,35,5,9,3,5,2,4,0,0,0,3,3,4,2,3,0,12
3202,796536,10,2,2,2,2,0,0,2,3,1,2,0,2,0,0,0,6
3202,796537,1,0,0,0,0,0,0,0,0,0,1,0,0,0,0,0,0
3202,796535,3,0,0,0,0,0,0,0,0,0,0,0,1,1,1,0,0
3202,786026,26,6,13,5,10,1,3,6,10,1,4,1,4,0,3,0,19
3203,797698,29,3,7,2,4,1,3,4,4,1,3,3,3,0,0,0,11
3203,780844,22,7,8,0,0,7,8,1,1,0,3,1,5,1,0,2,22
3203,797699,33,4,12,4,7,0,5,5,6,0,3,2,1,1,3,0,13
3203,791956,23,2,7,1,3,1,4,0,0,1,5,0,1,2,1,0,5
3203,780846,37,2,7,1,3,1,4,8,9,2,2,5,5,2,8,0,13
3203,797694,27,1,4,0,0,1,4,0,0,0,2,1,2,1,0,0,3
3203,797692,8,1,1,0,0,1,1,0,0,0,0,0,2,0,0,0,3
3203,791954,21,2,5,2,4,0,1,4,6,0,5,2,4,2,1,0,8
3204,774812,24,4,11,4,9,0,2,6,7,2,3,2,4,2,1,1,14
3204,791498,20,5,8,5,8,0,0,4,4,2,3,0,1,0,0,1,14
3204,797180,25,1,3,0,1,1,2,0,0,0,1,1,5,0,1,0,3
3204,781486,37,3,10,3,4,0,6,1,2,1,2,2,2,1,3,0,7
3204,780461,39,6,12,5,9,1,3,5,6,0,1,3,1,1,1,0,18
3204,790517,11,0,2,0,2,0,0,0,0,1,2,0,2,0,0,1,0
3204,791499,13,2,4,0,1,2,3,0,0,0,0,2,1,0,2,0,6
3204,791503,23,4,6,1,2,3,4,0,0,1,5,2,5,1,1,0,11
3204,791502,8,1,1,1,1,0,0,1,2,0,0,0,0,0,0,0,3
3205,791053,18,3,5,3,5,0,0,4,7,4,2,2,3,0,1,0,10
3205,780739,27,6,8,5,7,1,1,0,1,1,7,1,1,0,1,2,13
3205,785524,34,5,13,3,5,2,8,3,4,3,3,1,3,1,1,0,15
3205,781115,29,3,10,3,10,0,0,5,6,0,0,4,0,0,1,0,11
3205,775094,25,2,7,1,4,1,3,5,6,2,2,1,0,0,2,0,10
3205,796731,2,0,2,0,2,0,0,0,0,2,0,1,1,0,0,0,0
3205,796730,10,1,3,0,0,1,3,0,0,0,2,0,1,1,1,0,3
3205,791051,20,4,5,4,5,0,0,0,0,5,3,0,3,0,0,0,8
3205,790819,17,3,8,2,6,1,2,1,2,1,2,2,4,0,0,0,8
3205,775456,18,4,6,4,6,0,0,3,4,0,4,0,2,2,2,0,11
3206,786054,13,0,0,0,0,0,0,0,0,1,1,1,5,0,1,0,0
3206,791964,19,5,6,1,1,4,5,0,1,0,1,0,4,0,1,0,14
3206,786056,27,3,6,2,3,1,3,0,0,0,6,4,3,2,3,0,7
3206,781339,36,5,9,1,2,4,7,1,1,0,3,3,3,0,5,0,15
3206,781337,37,5,10,0,1,5,9,8,8,0,1,11,1,1,4,0,23
3206,797712,23,4,4,4,4,0,0,5,8,1,2,0,1,0,4,1,13
3206,792041,21,6,9,5,7,1,2,2,2,3,3,0,1,2,1,0,15
3206,797711,21,3,5,2,3,1,2,0,0,1,2,2,0,2,0,0,7
3206,797710,3,0,0,0,0,0,0,0,0,0,0,0,1,0,0,0,0
3207,775747,14,1,3,0,2,1,1,1,3,3,0,2,2,0,2,0,4
3207,786578,24,9,12,9,12,0,0,1,3,3,4,1,3,1,1,0,19
3207,797358,29,5,11,3,6,2,5,1,2,0,1,3,4,2,0,0,13
3207,785669,28,2,6,1,3,1,3,3,4,1,2,3,3,3,3,0,8
3207,775195,19,1,6,1,2,0,4,0,0,0,0,3,2,0,0,1,2
3207,786140,4,0,0,0,0,0,0,0,0,1,0,1,1,0,0,0,0
3207,786136,17,3,5,3,5,0,0,0,0,0,0,2,1,2,0,0,6
3207,797357,14,1,1,0,0,1,1,0,0,0,1,0,1,1,2,0,3
3207,786138,27,6,8,5,7,1,1,3,3,1,2,0,5,1,1,0,16
3207,776236,24,4,10,2,5,2,5,3,4,0,1,2,1,2,3,0,13
3208,797305,2,0,0,0,0,0,0,0,0,0,1,0,1,1,1,0,0
3208,781403,28,2,7,2,3,0,4,0,0,0,2,0,3,3,2,0,4
3208,792654,32,6,12,6,12,0,0,1,2,3,7,0,3,0,2,3,13
3208,797301,32,3,9,3,7,0,2,0,0,2,5,5,3,0,5,0,6
3208,780524,32,2,8,1,4,1,4,0,0,0,4,2,0,2,3,0,5
3208,781400,37,6,16,4,7,2,9,6,7,1,3,3,1,0,2,0,20
3208,792653,8,1,2,1,2,0,0,0,0,2,1,0,3,0,0,0,2
3208,786857,12,1,4,0,1,1,3,0,0,0,3,0,1,0,1,1,3
3208,797302,8,3,4,2,3,1,1,0,0,2,1,0,0,0,1,0,7
3208,797303,9,0,1,0,0,0,1,0,0,0,0,1,0,1,0,0,0
3209,797050,34,3,6,3,5,0,1,3,4,4,9,0,0,1,1,0,9
3209,780394,35,10,15,6,10,4,5,1,1,2,4,0,0,1,1,1,25
3209,780391,18,1,3,1,3,0,0,0,0,0,2,1,3,2,1,1,2
3209,790871,24,3,11,3,8,0,3,1,3,1,2,4,1,2,2,1,7
3209,776473,25,2,6,2,3,0,3,2,4,0,1,3,4,1,4,1,6
3209,797048,28,5,18,5,12,0,6,0,3,2,5,0,1,0,1,1,10
3209,780392,25,1,3,0,1,1,2,2,2,1,0,0,1,4,2,0,5
3209,791573,11,0,2,0,0,0,2,0,0,0,3,1,0,0,1,0,0
3210,780283,19,4,6,4,6,0,0,2,2,2,3,2,4,0,2,0,10
3210,790925,38,6,12,5,9,1,3,1,1,1,4,0,2,1,1,1,14
3210,791456,36,3,10,3,7,0,3,4,4,0,0,2,3,0,2,0,10
3210,785476,33,5,11,4,7,1,4,0,0,2,2,7,2,3,2,0,11
3210,785474,36,4,7,3,5,1,2,3,4,2,5,1,1,0,1,0,12
3210,780292,21,3,3,3,3,0,0,2,3,2,4,1,0,0,2,0,8
3210,785480,9,0,1,0,0,0,1,0,0,0,3,0,1,0,0,0,0
3210,790926,6,0,2,0,1,0,1,0,0,0,0,0,0,0,2,0,0
3210,796470,2,0,1,0,0,0,1,0,0,0,0,0,0,0,0,0,0
3211,780919,27,3,7,3,6,0,1,1,2,3,3,0,3,0,2,0,7
3211,775816,30,3,9,1,3,2,6,2,2,0,3,0,1,0,1,0,10
3211,785803,31,4,5,4,5,0,0,2,2,1,2,1,1,1,1,0,10
3211,780920,29,5,10,4,6,1,4,1,1,1,2,3,1,0,1,1,12
3211,780914,32,2,7,1,5,1,2,0,2,1,3,1,1,2,3,0,5
3211,796797,9,0,0,0,0,0,0,0,0,0,1,0,4,1,1,0,0
3211,791142,25,3,8,1,1,2,7,4,4,0,4,2,2,1,1,0,12
3211,791141,14,3,6,3,4,0,2,0,0,1,1,2,0,0,0,0,6
3211,796799,3,0,1,0,0,0,1,0,0,0,0,0,1,0,1,0,0
3212,781629,15,0,2,0,1,0,1,0,0,0,1,2,1,0,0,0,0
3212,791440,19,1,5,1,5,0,0,5,6,2,0,0,3,0,2,0,7
3212,791441,26,3,7,2,4,1,3,0,2,2,2,2,2,1,2,1,7
3212,781378,29,7,10,5,7,2,3,3,3,5,6,3,4,1,3,0,19
3212,775267,37,5,11,1,2,4,9,2,2,1,3,2,1,2,0,0,16
3212,791443,13,1,4,0,1,1,3,1,2,0,2,0,1,0,1,0,4
3212,775739,4,0,1,0,1,0,0,0,0,0,2,1,0,0,0,0,0
3212,797015,28,9,14,7,10,2,4,10,11,2,8,3,2,1,1,1,30
3212,797013,30,5,11,3,6,2,5,1,2,1,4,1,3,1,2,0,13
3212,797019,13,0,1,0,1,0,0,0,0,1,2,6,2,0,1,0,0
3212,797016,4,0,1,0,0,0,1,0,0,0,1,0,0,0,0,0,0
3212,774959,7,1,5,1,2,0,3,1,2,0,0,0,0,0,2,0,3
3213,791923,19,2,2,2,2,0,0,0,1,1,1,1,4,0,0,1,4
3213,781122,23,8,10,8,10,0,0,8,8,0,4,1,3,0,2,1,24
3213,791925,40,9,16,8,12,1,4,3,3,2,5,4,2,2,0,0,22
3213,791926,27,3,13,0,1,3,12,0,0,1,3,2,4,0,2,1,9
3213,781112,13,0,3,0,1,0,2,0,0,0,0,2,1,0,0,0,0
3213,791922,2,0,0,0,0,0,0,0,0,0,0,0,2,0,1,0,0
3213,786529,5,0,0,0,0,0,0,1,2,0,2,1,1,1,0,0,1
3213,797541,17,2,5,2,5,0,0,0,0,4,2,0,3,1,1,4,4
3213,797542,20,2,6,2,3,0,3,4,5,0,3,3,1,0,3,0,8
3213,791927,14,2,7,2,3,0,4,0,0,1,3,0,2,1,2,0,4
3213,786858,32,2,7,1,4,1,3,4,5,0,3,3,3,1,2,0,9
3213,786527,12,3,4,1,1,2,3,0,0,0,2,0,0,0,0,0,8
3213,797543,1,0,0,0,0,0,0,0,0,0,0,0,0,0,0,0,0
3214,785395,26,3,6,3,5,0,1,1,2,1,3,2,0,1,1,0,7
3214,786704,27,2,10,2,9,0,1,4,5,1,6,0,2,0,3,2,8
3214,775955,34,4,10,3,7,1,3,10,12,1,2,10,3,5,1,0,19
3214,775840,38,2,8,0,1,2,7,2,2,0,3,2,2,4,1,1,8
3214,775811,13,2,6,2,3,0,3,0,0,0,2,0,2,0,0,0,4
3214,786702,12,2,2,2,2,0,0,2,2,0,2,0,4,1,0,0,6
3214,786551,23,2,8,2,6,0,2,3,4,1,0,2,3,1,0,0,7
3214,775287,14,2,4,2,2,0,2,0,0,0,2,0,1,1,2,1,4
3214,786706,13,1,3,1,3,0,0,0,0,3,1,0,0,1,0,0,2
3215,785829,25,3,9,3,9,0,0,1,1,3,3,0,3,0,2,0,7
3215,775838,26,2,8,1,5,1,3,0,0,0,9,1,2,2,2,0,5
3215,786531,38,4,10,2,5,2,5,2,2,0,2,1,4,0,8,0,12
3215,796726,22,1,6,0,5,1,1,6,6,0,3,1,0,0,3,0,9
3215,796729,39,5,8,1,3,4,5,5,5,1,2,3,3,0,4,0,19
3215,796724,18,2,4,2,4,0,0,5,5,0,0,1,4,1,1,0,9
3215,796727,3,0,0,0,0,0,0,0,0,0,0,0,1,0,0,0,0
3215,796728,17,0,0,0,0,0,0,0,0,0,5,2,3,0,1,1,0
3215,780723,12,0,0,0,0,0,0,0,0,0,0,0,2,0,1,0,0
3216,780586,35,6,12,5,7,1,5,0,0,2,4,5,3,1,6,0,13
3216,797549,30,2,5,2,4,0,1,6,10,0,2,1,1,1,0,0,10
3216,790857,19,1,6,0,3,1,3,7,8,0,3,2,2,1,0,0,10
3216,780351,22,2,4,2,4,0,0,5,8,2,1,2,4,0,0,0,9
3216,797546,24,3,4,3,4,0,0,1,2,2,1,1,1,0,0,0,7
3216,785855,17,5,11,1,1,4,10,0,0,0,1,0,2,1,1,0,14
3216,797544,12,2,4,1,3,1,1,0,0,0,1,0,2,0,0,0,5
3216,797545,24,1,4,0,2,1,2,0,0,3,1,4,3,0,0,0,3
3216,791715,8,1,1,0,0,1,1,0,1,1,0,0,4,0,1,0,3
3216,791716,6,0,0,0,0,0,0,0,0,0,0,1,0,0,0,0,0
3216,797540,3,0,0,0,0,0,0,0,0,0,1,0,1,0,0,0,0
3217,792118,39,6,13,1,5,5,8,11,12,0,4,8,1,1,3,0,28
3217,782593,34,5,17,2,8,3,9,2,2,1,5,4,4,2,0,0,15
3217,785402,27,4,6,4,6,0,0,2,4,2,4,0,5,1,0,1,10
3217,791699,24,3,4,2,2,1,2,3,4,3,1,1,2,0,3,0,10
3217,797523,13,2,3,2,2,0,1,1,1,1,1,0,4,0,0,0,5
3217,791700,23,4,5,0,1,4,4,2,2,0,1,0,3,1,0,0,14
3217,785828,17,1,1,1,1,0,0,0,0,1,3,2,5,0,2,0,2
3217,797526,13,0,1,0,0,0,1,0,0,0,1,2,1,0,0,0,0
3217,797525,10,0,1,0,1,0,0,0,0,0,1,0,1,0,0,0,0
3218,797823,29,2,7,2,5,0,2,8,9,2,6,0,5,2,2,3,12
3218,780505,47,10,23,7,12,3,11,2,5,0,4,3,0,2,2,0,25
3218,797829,16,3,5,3,5,0,0,1,3,2,4,0,5,0,0,0,7
3218,797831,42,5,9,1,3,4,6,1,2,4,4,1,4,0,1,0,15
3218,792280,43,7,14,7,9,0,5,2,6,0,2,1,2,1,2,0,16
3218,785950,13,0,2,0,1,0,1,0,0,2,3,1,1,0,2,0,0
3218,785701,25,0,6,0,4,0,2,4,8,2,3,2,4,1,2,1,4
3218,799468,17,0,2,0,1,0,1,1,2,0,2,2,0,0,1,0,1
3218,797826,11,1,1,1,1,0,0,0,0,1,2,1,1,0,2,0,2
3218,797833,7,0,0,0,0,0,0,0,2,0,2,0,0,0,0,0,0
3219,786289,39,1,14,1,5,0,9,4,4,0,7,2,1,1,0,0,6
3219,796332,16,0,0,0,0,0,0,1,2,1,2,1,2,0,0,0,1
3219,796334,32,5,11,5,11,0,0,2,4,5,4,0,4,1,1,0,12
3219,785813,44,7,18,6,12,1,6,3,4,2,3,6,4,3,2,0,18
3219,785827,18,1,5,1,5,0,0,3,4,0,3,1,4,1,1,1,5
3219,796330,38,8,12,6,9,2,3,6,7,2,9,0,3,1,2,0,24
3219,779975,9,1,1,1,1,0,0,1,1,1,2,0,5,0,2,1,3
3219,796337,38,5,13,3,9,2,4,3,4,1,3,2,1,1,2,0,15
3219,790776,16,0,1,0,1,0,0,2,2,1,3,0,5,0,1,2,2
3254,785384,20,3,6,3,4,0,2,0,0,2,3,0,0,1,0,0,6
3254,780025,29,4,11,4,11,0,0,5,7,4,4,0,4,1,2,1,13
3254,786228,9,0,1,0,1,0,0,0,0,0,1,2,1,1,0,0,0
3254,785385,36,3,10,1,3,2,7,2,2,1,3,2,0,0,1,0,10
3254,785383,40,5,19,2,12,3,7,0,0,0,6,4,2,1,3,0,13
3254,781046,16,3,7,1,4,2,3,4,4,1,3,0,2,0,0,1,12
3254,786297,10,1,4,1,4,0,0,0,2,2,0,0,1,1,1,0,2
3254,790837,27,3,5,1,3,2,2,1,2,1,4,1,3,0,4,1,9
3254,792180,4,0,2,0,0,0,2,0,0,1,0,1,0,0,1,0,0
3254,796391,9,0,0,0,0,0,0,0,0,0,2,0,0,1,1,0,0
3255,785714,24,2,5,2,5,0,0,1,2,0,3,0,3,1,0,1,5
3255,775894,31,9,13,9,13,0,0,0,0,5,3,3,4,6,3,1,18
3255,785711,37,7,13,1,2,6,11,0,0,0,7,4,1,0,2,0,20
3255,780985,37,5,11,1,2,4,9,0,0,0,2,1,2,0,3,0,14
3255,775266,33,2,12,2,5,0,7,0,2,0,1,3,2,1,3,0,4
3255,796829,16,1,2,1,2,0,0,2,4,1,5,0,1,0,0,4,4
3255,785378,9,0,1,0,1,0,0,2,2,1,1,1,1,0,0,0,2
3255,779994,3,0,2,0,1,0,1,0,0,0,2,0,0,0,0,0,0
3255,791167,10,0,2,0,1,0,1,0,0,0,0,2,1,0,0,0,0
3256,785536,20,0,11,0,6,0,5,4,4,2,5,2,3,2,0,2,4
3256,776097,30,3,5,2,2,1,3,1,2,0,1,1,5,0,1,0,8
3256,796558,20,2,6,2,6,0,0,0,2,3,1,0,4,3,1,0,4
3256,796559,38,4,15,0,7,4,8,6,10,4,6,1,4,2,1,1,18
3256,785280,37,1,10,1,6,0,4,4,6,1,3,2,3,3,0,0,6
3256,796560,17,3,6,2,2,1,4,1,1,1,2,0,2,1,0,2,8
3256,780149,31,6,18,5,14,1,4,6,7,1,2,1,4,2,4,0,19
3256,796561,2,0,0,0,0,0,0,0,0,0,0,0,1,0,0,0,0
3256,785285,3,0,0,0,0,0,0,1,2,0,0,0,0,0,0,0,1
3256,775679,2,0,0,0,0,0,0,0,0,0,0,0,0,0,0,0,0
3257,790863,14,3,4,3,4,0,0,0,0,1,5,0,4,0,0,0,6
3257,780021,28,9,13,9,13,0,0,7,10,3,8,0,3,0,1,0,25
3257,785412,33,5,11,4,7,1,4,12,15,1,4,4,3,0,2,0,23
3257,780099,34,3,7,1,1,2,6,3,5,1,8,0,4,1,8,0,11
3257,776214,27,2,4,0,2,2,2,0,0,0,3,1,4,2,6,1,6
3257,775686,21,0,3,0,1,0,2,2,2,0,3,1,4,0,0,0,2
3257,785413,24,2,6,2,3,0,3,1,1,0,3,4,4,0,2,0,5
3257,776221,13,0,1,0,1,0,0,3,4,0,4,4,3,0,2,0,3
3257,785411,6,0,2,0,0,0,2,0,2,1,1,0,0,0,0,0,0
3258,781071,31,2,6,1,3,1,3,1,1,0,8,1,2,1,1,1,6
3258,791890,34,6,15,5,10,1,5,5,7,0,5,6,2,2,3,0,18
3258,780098,13,2,4,2,4,0,0,1,2,0,1,0,2,1,2,0,5
3258,797591,27,5,6,3,3,2,3,3,6,1,4,0,2,2,1,1,15
3258,780719,33,2,4,1,2,1,2,1,2,0,8,3,3,1,1,1,6
3258,791888,6,1,2,1,1,0,1,0,0,0,0,1,1,1,0,0,2
3258,797589,31,7,13,5,9,2,4,4,5,0,1,1,1,2,1,0,20
3258,791889,20,1,1,0,0,1,1,0,0,2,2,0,0,0,2,0,3
3258,797588,3,0,0,0,0,0,0,0,0,0,0,0,1,0,0,0,0
3258,797590,2,0,0,0,0,0,0,0,0,0,0,0,0,0,0,0,0
3259,791249,33,6,16,4,8,2,8,2,2,0,2,2,1,1,2,0,16
3259,785522,31,2,4,1,2,1,2,0,0,1,3,2,1,2,2,0,5
3259,785521,26,3,8,1,2,2,6,0,0,0,1,1,2,0,1,0,8
3259,775358,24,1,8,1,5,0,3,4,4,0,4,2,4,0,1,0,6
3259,791250,24,1,4,1,3,0,1,2,3,0,8,0,4,0,2,0,4
3259,796944,17,0,4,0,0,0,4,0,0,0,1,0,1,0,1,0,0
3259,796947,18,2,3,2,3,0,0,4,4,0,1,0,1,0,1,0,8
3259,796949,3,0,0,0,0,0,0,0,0,0,0,0,1,0,0,0,0
3259,781247,20,2,4,1,2,1,2,0,0,1,3,0,2,1,2,0,5
3259,796945,2,0,0,0,0,0,0,0,0,0,0,0,1,0,1,0,0
3259,791247,2,0,0,0,0,0,0,0,0,0,0,0,0,1,0,0,0
3260,791067,23,1,2,1,2,0,0,0,0,5,2,3,4,1,1,1,2
3260,780751,23,2,6,2,3,0,3,0,1,1,1,1,5,0,0,0,4
3260,796743,33,3,7,1,2,2,5,9,10,0,2,4,1,2,3,0,17
3260,791068,21,0,3,0,2,0,1,3,4,1,2,0,2,0,1,1,3
3260,785551,24,2,6,0,3,2,3,2,2,0,4,3,0,0,1,0,8
3260,780512,17,5,13,4,10,1,3,0,0,3,2,0,2,1,1,1,11
3260,780756,16,2,7,0,3,2,4,1,2,1,0,0,0,0,2,1,7
3260,796744,26,1,2,0,0,1,2,1,2,1,3,2,0,0,2,0,4
3260,791066,17,3,7,2,4,1,3,0,0,0,4,1,1,0,0,0,7
3260,785642,0,0,0,0,0,0,0,0,0,0,0,0,0,0,0,0,0
3261,792128,15,1,3,0,1,1,2,0,0,0,2,0,3,0,0,0,3
3261,786838,36,6,13,6,12,0,1,3,6,1,5,3,2,1,6,4,15
3261,792132,31,2,6,0,0,2,6,4,4,0,1,3,2,0,1,0,10
3261,792127,36,4,13,2,5,2,8,2,3,0,6,1,4,1,3,0,12
3261,792126,34,4,8,2,3,2,5,0,0,2,2,0,3,1,1,0,10
3261,792131,29,4,8,4,7,0,1,0,0,7,3,1,3,1,1,0,8
3261,797736,10,0,1,0,0,0,1,2,2,1,0,0,1,0,1,0,2
3261,797739,1,0,0,0,0,0,0,0,0,0,0,0,1,0,0,0,0
3261,791668,8,0,2,0,2,0,0,0,0,0,1,2,0,0,0,0,0
3262,781480,32,7,10,4,5,3,5,0,0,0,3,0,4,2,6,1,17
3262,774846,29,6,11,6,11,0,0,3,4,1,3,1,5,1,4,0,15
3262,797182,7,0,0,0,0,0,0,0,0,0,1,0,2,0,1,0,0
3262,786558,39,5,14,5,12,0,2,4,4,1,7,6,3,4,5,0,14
3262,766611,38,5,11,3,6,2,5,0,0,1,4,0,4,1,1,0,12
3262,791376,36,1,3,0,0,1,3,0,1,0,2,2,2,2,1,0,3
3262,786185,11,1,3,1,3,0,0,0,2,0,2,0,4,0,2,2,2
3262,797272,4,0,0,0,0,0,0,0,0,0,0,0,1,1,0,0,0
3262,797273,4,1,2,1,2,0,0,0,0,1,0,0,1,0,1,0,2
3263,785298,13,3,3,3,3,0,0,4,5,1,3,0,3,0,0,0,10
3263,778046,35,7,15,4,6,3,9,4,5,0,1,5,2,4,7,1,21
3263,782121,28,6,13,6,9,0,4,1,1,1,2,2,4,4,2,0,13
3263,775793,36,3,11,2,8,1,3,6,8,1,3,0,0,3,1,1,13
3263,775224,22,3,5,3,5,0,0,0,3,1,4,2,4,0,1,2,6
3263,786594,26,0,3,0,0,0,3,0,0,0,0,1,1,0,1,0,0
3263,785485,26,2,2,2,2,0,0,3,3,2,8,0,1,0,3,2,7
3263,785302,14,2,3,2,3,0,0,2,4,0,4,0,0,2,1,0,6
3264,781335,35,7,15,5,9,2,6,7,8,0,4,3,2,3,5,1,23
3264,776351,37,10,17,5,8,5,9,2,3,0,6,0,1,2,0,2,27
3264,785770,36,7,10,6,8,1,2,0,2,2,3,5,1,6,2,0,15
3264,781341,32,3,7,1,2,2,5,0,0,1,3,3,4,1,0,0,8
3264,796542,11,1,3,1,2,0,1,0,0,0,0,1,3,0,1,0,2
3264,791285,1,0,1,0,0,0,1,0,0,0,0,0,0,0,0,0,0
3264,791284,7,0,0,0,0,0,0,0,0,0,0,1,1,0,0,0,0
3264,791283,14,1,1,1,1,0,0,0,0,0,1,2,0,1,1,0,2
3264,785775,27,2,4,2,4,0,0,2,2,1,0,2,5,1,2,1,6
3265,780797,37,5,12,5,9,0,3,1,3,2,5,6,3,0,5,0,11
3265,776418,28,5,7,5,7,0,0,4,6,2,6,2,2,2,2,1,14
3265,791618,23,2,3,2,3,0,0,2,5,0,4,2,3,1,1,0,6
3265,780555,35,3,5,1,2,2,3,0,0,0,1,5,2,1,2,2,8
3265,775604,38,6,14,2,3,4,11,6,6,1,3,3,1,1,2,1,22
3265,791616,15,6,9,5,8,1,1,0,0,3,3,0,1,0,0,0,13
3265,796986,7,1,1,1,1,0,0,0,0,0,2,0,0,0,0,0,2
3265,796981,17,2,3,2,3,0,0,0,0,1,2,1,1,3,6,0,4
3266,781054,38,2,11,2,6,0,5,5,6,0,4,5,4,0,1,0,9
3266,781053,2,0,1,0,0,0,1,0,0,0,1,0,0,0,1,0,0
3266,774969,33,5,8,5,8,0,0,6,7,2,4,2,3,1,1,1,16
3266,791181,36,2,3,2,3,0,0,0,0,0,2,2,3,2,1,0,4
3266,796850,37,5,9,2,3,3,6,2,3,3,2,1,3,0,3,0,15
3266,796848,31,8,13,5,7,3,6,2,3,0,2,0,2,1,4,0,21
3266,791179,14,1,4,1,2,0,2,1,1,1,2,1,4,0,0,1,3
3266,780981,9,1,2,1,2,0,0,0,0,1,6,0,2,0,1,0,2
3267,776425,38,6,11,3,5,3,6,6,6,0,6,1,4,1,2,0,21
3267,791110,27,1,8,1,7,0,1,3,4,0,0,1,2,0,2,0,5
3267,785603,34,5,12,3,7,2,5,1,1,0,1,4,0,1,2,0,13
3267,775820,14,0,0,0,0,0,0,1,2,0,1,0,3,0,1,0,1
3267,775538,26,3,5,3,5,0,0,2,4,4,5,0,3,0,1,0,8
3267,796762,10,0,1,0,1,0,0,0,0,0,0,0,3,0,2,0,0
3267,791106,24,1,3,0,0,1,3,6,6,0,5,2,2,1,0,1,9
3267,791107,14,1,2,1,1,0,1,2,3,0,5,0,4,0,0,0,4
3267,786494,2,0,0,0,0,0,0,0,0,0,0,0,0,0,0,0,0
3267,796763,11,2,3,0,0,2,3,0,0,0,0,0,0,0,1,0,6
3268,775455,26,3,8,2,5,1,3,4,5,5,10,4,1,0,3,0,11
3268,792124,25,6,8,6,8,0,0,3,4,1,4,2,3,0,4,1,15
3268,792123,35,7,16,5,7,2,9,1,2,0,4,1,5,1,2,0,17
3268,786002,10,0,1,0,0,0,1,0,0,0,0,0,0,0,1,0,0
3268,781397,21,1,5,1,3,0,2,0,0,2,1,1,0,0,1,0,2
3268,792119,6,0,0,0,0,0,0,0,0,0,0,0,1,0,0,0,0
3268,786003,23,4,6,3,3,1,3,0,0,2,2,2,2,2,1,2,9
3268,797749,18,0,4,0,1,0,3,0,0,0,1,0,2,0,1,0,0
3268,797747,0,0,0,0,0,0,0,0,0,0,0,0,0,0,0,0,0
3268,792120,20,0,7,0,3,0,4,0,0,0,1,0,1,0,2,0,0
3268,786005,16,2,3,1,1,1,2,0,0,0,2,0,2,0,0,0,5
3269,797972,31,6,9,6,8,0,1,4,4,5,4,2,2,1,1,0,16
3269,797967,32,3,10,2,6,1,4,0,0,0,6,0,1,0,1,0,7
3269,797970,32,7,14,4,7,3,7,3,5,1,3,1,3,2,2,0,20
3269,781453,36,2,13,1,5,1,8,5,6,0,3,4,3,2,4,1,10
3269,774869,32,4,11,1,3,3,8,0,0,1,3,2,3,1,1,0,11
3269,792254,15,2,4,2,3,0,1,0,0,3,1,0,3,0,0,0,4
3269,797962,5,0,0,0,0,0,0,0,0,0,3,0,0,0,0,0,0
3269,786098,17,1,4,1,2,0,2,0,0,0,2,3,4,0,0,0,2
3270,781650,28,10,14,10,14,0,0,3,5,2,3,0,5,1,1,1,23
3270,797070,22,0,3,0,1,0,2,0,0,0,3,2,2,1,0,0,0
3270,791432,36,6,10,2,4,4,6,2,2,0,3,1,2,0,4,0,18
3270,777865,39,7,15,4,7,3,8,0,0,2,3,6,2,1,4,1,17
3270,791429,34,3,6,2,3,1,3,1,2,0,4,4,2,2,2,0,8
3270,797066,11,1,2,1,2,0,0,0,0,0,3,0,1,0,1,0,2
3270,780180,29,1,3,1,3,0,0,6,6,0,2,3,0,1,1,0,8
3270,797067,12,1,3,1,2,0,1,0,0,0,2,0,0,0,2,1,2
3270,781203,14,0,1,0,0,0,1,0,0,0,3,0,3,0,0,0,0
3271,797587,21,2,4,2,4,0,0,0,1,0,2,0,5,0,3,0,4
3271,791894,9,2,2,2,2,0,0,0,0,0,2,1,0,1,1,0,4
3271,786502,43,10,22,9,18,1,4,9,11,4,2,7,1,3,2,0,30
3271,781561,14,1,4,1,3,0,1,0,0,0,1,1,1,1,2,1,2
3271,781080,37,2,5,1,1,1,4,3,3,0,1,1,5,2,4,0,8
3271,791891,21,1,4,1,3,0,1,0,0,1,2,0,1,0,0,1,2
3271,786501,28,5,8,0,0,5,8,0,0,1,2,0,1,1,1,0,15
3271,781078,31,5,10,2,3,3,7,3,3,1,9,2,0,3,0,0,16
3271,797584,21,1,3,1,3,0,0,0,0,0,3,1,2,0,0,0,2
3272,796381,31,3,4,0,0,3,4,0,0,0,4,7,3,0,2,1,9
3272,775585,15,1,3,1,3,0,0,0,1,1,5,0,2,1,0,0,2
3272,790822,36,3,8,2,4,1,4,6,6,1,4,4,1,1,1,0,13
3272,790820,26,4,8,2,5,2,3,0,1,0,3,3,1,2,3,0,10
3272,780982,25,3,7,3,5,0,2,4,5,2,2,2,1,0,1,0,10
3272,790821,9,0,4,0,2,0,2,1,2,0,0,0,2,0,0,0,1
3272,796380,26,5,8,4,7,1,1,0,2,3,5,1,3,1,5,2,11
3272,774980,28,4,7,4,6,0,1,1,1,0,1,0,0,1,3,0,9
3272,780445,4,0,0,0,0,0,0,0,0,0,0,0,0,1,0,0,0
3273,780879,33,10,14,8,12,2,2,3,4,4,3,4,3,0,2,4,25
3273,775785,24,3,6,2,5,1,1,0,0,1,5,1,2,0,2,0,7
3273,790767,16,3,6,1,2,2,4,0,0,0,0,0,2,0,0,1,8
3273,790768,37,2,7,2,4,0,3,0,0,1,4,2,2,2,1,0,4
3273,780875,35,2,9,1,7,1,2,0,0,0,5,5,2,0,1,0,5
3273,796324,5,0,3,0,2,0,1,0,0,0,0,0,1,0,0,0,0
3273,790769,14,1,3,0,1,1,2,0,0,0,1,1,4,0,2,0,3
3273,785743,25,2,7,1,2,1,5,2,3,0,0,5,3,4,2,0,7
3273,796326,11,3,4,2,3,1,1,0,0,0,1,0,0,0,1,0,7
3274,786314,28,3,5,3,5,0,0,1,2,1,6,4,1,0,1,0,7
3274,786316,31,7,15,7,15,0,0,8,10,4,4,1,1,0,0,1,22
3274,791475,15,0,3,0,3,0,0,0,0,0,0,1,2,0,1,0,0
3274,791476,28,2,7,1,6,1,1,1,2,0,5,2,2,0,0,0,6
3274,780220,37,11,20,8,15,3,5,3,6,0,1,0,2,0,3,1,28
3274,797206,14,3,3,3,3,0,0,2,2,1,3,0,3,0,0,0,8
3274,797205,4,0,0,0,0,0,0,0,1,0,0,0,1,0,1,0,0
3274,791473,32,6,7,6,7,0,0,1,3,1,10,2,2,1,3,0,13
3274,797202,10,1,2,1,1,0,1,0,3,0,0,1,3,1,1,0,2
3274,791477,26,2,7,2,6,0,1,0,0,0,7,3,5,0,0,0,4
3275,791465,26,5,14,5,14,0,0,2,3,1,1,6,3,0,0,0,12
3275,791464,27,2,4,1,1,1,3,0,0,0,0,1,3,1,0,0,5
3275,780200,19,0,1,0,1,0,0,1,4,1,6,2,2,0,1,0,1
3275,786304,32,0,7,0,3,0,4,2,2,1,2,2,1,0,0,0,2
3275,780197,42,12,19,9,13,3,6,10,11,1,7,4,3,3,3,0,37
3275,798342,18,1,3,1,2,0,1,0,0,0,4,0,2,0,0,0,2
3275,786303,12,0,0,0,0,0,0,0,0,0,0,2,5,0,0,0,0
3275,798343,10,0,4,0,0,0,4,0,0,0,0,0,2,0,0,0,0
3275,780196,39,11,20,9,18,2,2,6,7,0,8,1,2,1,3,0,30
3276,791718,32,5,9,1,4,4,5,3,6,2,2,3,2,0,1,0,17
3276,791717,20,5,9,4,7,1,2,0,0,3,2,0,3,1,0,0,11
3276,798963,23,5,9,4,6,1,3,1,3,1,1,5,0,0,0,0,12
3276,787996,8,5,7,5,7,0,0,1,1,0,2,0,1,0,0,0,11
3276,798962,20,3,4,3,4,0,0,4,6,0,1,1,3,0,2,0,10
3276,798965,22,3,5,2,2,1,3,0,0,1,1,0,4,0,2,0,7
3276,781446,19,2,2,1,1,1,1,0,0,0,2,2,0,0,2,0,5
3276,798961,17,3,6,1,2,2,4,0,0,0,0,1,2,0,0,0,8
3276,798968,18,1,5,0,3,1,2,0,0,0,0,0,1,0,1,1,3
3276,798966,17,1,3,1,3,0,0,0,0,0,1,1,3,0,1,0,2
3276,791719,4,0,1,0,0,0,1,0,0,0,0,0,1,0,0,0,0
3276,798969,0,0,0,0,0,0,0,0,0,0,0,0,0,0,0,0,0
3276,798964,0,0,0,0,0,0,0,0,0,0,0,0,0,0,0,0,0
3277,780328,31,9,13,9,13,0,0,2,4,1,1,0,0,0,0,0,20
3277,787524,30,4,7,4,5,0,2,6,10,2,4,1,1,0,1,0,14
3277,787522,17,6,7,6,7,0,0,1,3,1,3,0,3,0,0,1,13
3277,781019,31,4,7,2,4,2,3,3,5,1,3,9,2,0,0,0,13
3277,775961,20,1,5,1,3,0,2,1,1,0,2,3,2,0,1,0,3
3277,780017,20,6,9,6,8,0,1,6,7,0,2,1,0,1,2,0,18
3277,797611,9,3,3,3,3,0,0,0,0,2,1,1,0,1,1,0,6
3277,783269,8,1,4,0,0,1,4,0,0,2,0,0,5,0,1,0,3
3277,791772,19,1,4,1,1,0,3,2,2,1,0,2,1,1,0,0,4
3277,775541,14,1,2,1,1,0,1,1,2,2,1,0,1,0,1,0,3
3277,791774,1,0,0,0,0,0,0,0,0,1,0,0,0,0,0,0,0
3278,780634,29,6,10,6,10,0,0,1,4,5,5,1,3,2,3,1,13
3278,786785,33,5,15,2,7,3,8,0,3,2,4,2,2,2,1,1,13
3278,786784,30,5,12,3,8,2,4,1,2,3,2,5,3,1,1,1,13
3278,780633,32,6,10,5,6,1,4,0,0,0,4,5,1,2,1,2,13
3278,776009,34,7,12,5,9,2,3,1,2,1,2,4,2,3,2,0,17
3278,780635,1,0,1,0,1,0,0,0,0,1,0,0,0,0,0,0,0
3278,791826,20,2,5,1,3,1,2,1,1,1,2,0,4,0,1,1,6
3278,786783,11,0,5,0,4,0,1,0,0,1,1,1,2,0,1,0,0
3278,797390,10,0,1,0,0,0,1,0,0,1,1,1,4,1,0,2,0
3279,780027,35,9,11,8,9,1,2,6,7,2,2,1,1,0,2,2,25
3279,786176,25,2,9,2,5,0,4,4,7,1,6,0,3,1,3,0,8
3279,786173,25,3,9,2,6,1,3,0,0,0,0,2,3,0,0,1,7
3279,780028,3,0,0,0,0,0,0,0,0,0,0,0,0,0,1,0,0
3279,774828,33,5,7,2,2,3,5,0,0,0,4,4,1,2,4,0,13
3279,780029,19,1,3,0,1,1,2,2,2,1,6,1,2,1,3,3,5
3279,797175,23,4,8,3,6,1,2,5,5,4,5,1,2,3,0,3,14
3279,791379,10,1,4,1,4,0,0,0,0,0,3,0,1,0,0,0,2
3279,791380,7,0,2,0,2,0,0,0,0,0,0,0,0,1,1,0,0
3279,797178,6,0,1,0,1,0,0,1,2,0,0,0,0,0,1,0,1
3279,797179,14,1,2,1,2,0,0,0,0,1,2,4,0,0,0,0,2
3280,791140,17,6,6,6,6,0,0,0,0,2,10,0,3,0,1,0,12
3280,791138,20,2,2,1,1,1,1,0,0,1,1,0,2,0,0,0,5
3280,786084,22,5,5,3,3,2,2,1,1,0,5,6,3,0,4,0,13
3280,780910,23,7,13,4,8,3,5,3,3,0,1,8,1,2,3,0,20
3280,780288,24,9,13,5,7,4,6,2,2,1,3,1,1,0,2,0,24
3280,796794,18,2,3,2,2,0,1,1,2,0,3,3,2,0,2,1,5
3280,792142,4,2,3,2,3,0,0,0,0,0,1,0,1,0,0,0,4
3280,796795,15,3,5,3,5,0,0,0,0,2,6,2,1,0,0,0,6
3280,796793,4,0,1,0,0,0,1,0,0,0,0,0,0,0,1,0,0
3280,786082,4,0,1,0,0,0,1,0,0,0,1,0,1,0,0,0,0
3280,780912,13,0,2,0,0,0,2,0,0,0,0,1,0,1,1,0,0
3280,780911,20,4,7,2,2,2,5,0,0,0,1,1,2,0,1,0,10
3280,781635,16,1,2,1,1,0,1,0,0,0,4,2,2,1,0,0,2
3281,796585,12,2,2,2,2,0,0,3,4,0,1,0,0,0,1,0,7
3281,780192,24,2,6,2,3,0,3,2,4,0,2,2,2,0,2,0,6
3281,798139,20,3,13,3,10,0,3,0,0,0,1,1,2,0,3,0,6
3281,786818,19,1,5,1,4,0,1,1,2,2,0,1,2,2,1,0,3
3281,780182,24,3,5,0,1,3,4,0,0,0,3,2,1,1,1,0,9
3281,796587,10,1,3,1,3,0,0,0,0,0,0,0,1,0,1,0,2
3281,790974,4,1,1,1,1,0,0,1,2,0,2,0,0,0,0,0,3
3281,786821,3,1,2,1,2,0,0,0,0,0,1,0,0,0,0,0,2
3281,780186,16,2,6,2,6,0,0,0,0,2,0,1,0,1,1,0,4
3281,798138,15,1,3,0,0,1,3,0,2,1,1,0,1,0,0,0,3
3281,796584,8,0,3,0,1,0,2,0,0,0,1,0,1,0,0,0,0
3281,786819,8,0,1,0,1,0,0,0,1,0,2,3,1,0,0,0,0
3281,786820,14,2,6,1,1,1,5,0,0,0,0,3,0,0,0,0,5
3281,780188,7,0,0,0,0,0,0,0,1,0,1,0,0,0,0,0,0
3281,780184,16,2,4,1,3,1,1,2,2,0,1,0,0,0,1,0,7
3282,786410,14,0,2,0,1,0,1,0,0,0,0,1,4,0,1,0,0
3282,775095,13,1,2,1,2,0,0,3,3,1,4,0,4,1,1,1,5
3282,791603,16,0,3,0,2,0,1,1,2,0,1,0,2,0,4,0,1
3282,786406,24,2,7,1,6,1,1,0,0,0,2,3,1,1,2,1,5
3282,780414,38,9,16,8,12,1,4,7,9,0,5,1,3,1,5,0,26
3282,797020,15,1,4,1,4,0,0,2,4,2,1,0,5,0,1,2,4
3282,792392,25,4,6,4,6,0,0,3,5,1,5,1,4,0,0,0,11
3282,797021,26,2,5,0,2,2,3,1,2,1,3,1,3,0,1,0,7
3282,791605,11,1,1,1,1,0,0,0,0,0,0,0,1,0,1,0,2
3282,791843,18,3,6,3,6,0,0,0,1,3,2,1,3,1,3,0,6
3283,785845,28,2,4,2,4,0,0,4,7,3,4,2,4,0,3,1,8
3283,780578,29,8,14,6,11,2,3,7,8,2,6,2,4,1,3,0,25
3283,797538,39,5,10,2,6,3,4,2,3,0,4,0,4,1,3,0,15
3283,785293,22,3,6,3,5,0,1,1,2,0,0,2,3,2,1,0,7
3283,780579,39,2,10,1,7,1,3,5,6,1,2,3,2,1,4,0,10
3283,791712,1,0,0,0,0,0,0,0,0,0,0,0,0,0,0,0,0
3283,791709,4,0,2,0,2,0,0,1,2,1,2,0,2,0,0,0,1
3283,785843,17,0,1,0,0,0,1,3,4,1,1,1,5,0,1,1,3
3283,797537,5,0,1,0,0,0,1,2,2,0,0,0,1,0,0,0,2
3283,785847,16,0,1,0,0,0,1,2,2,1,1,0,1,0,2,0,2
3284,780406,32,7,9,4,5,3,4,0,0,3,5,4,1,1,4,0,17
3284,775087,24,4,7,3,6,1,1,1,2,2,2,0,3,2,3,0,10
3284,790984,30,3,9,3,4,0,5,0,0,0,1,5,1,1,0,0,6
3284,780212,36,5,11,1,2,4,9,4,4,0,4,4,2,0,2,0,18
3284,767245,31,3,9,3,9,0,0,2,3,1,2,4,1,1,0,0,8
3284,780214,17,3,7,2,2,1,5,0,0,0,3,0,4,0,0,1,7
3284,790985,7,1,1,1,1,0,0,0,0,0,0,0,1,0,0,0,2
3284,796596,4,0,1,0,0,0,1,0,0,0,0,0,0,0,1,0,0
3284,791168,12,0,1,0,1,0,0,0,0,0,0,0,0,0,1,0,0
3284,785297,7,0,1,0,1,0,0,0,0,0,0,1,1,0,0,0,0
3285,792197,29,7,12,1,3,6,9,0,0,0,1,0,3,1,0,1,20
3285,781132,36,6,14,5,8,1,6,1,2,0,3,2,2,2,3,0,14
3285,797517,29,6,6,6,6,0,0,2,3,2,4,0,3,0,1,1,14
3285,797518,35,7,12,7,11,0,1,4,6,2,4,8,1,3,2,0,18
3285,791940,36,4,8,4,8,0,0,2,2,2,1,3,2,2,2,0,10
3285,797522,9,0,1,0,1,0,0,0,0,0,2,0,2,0,0,0,0
3285,786539,4,0,0,0,0,0,0,0,0,0,0,0,0,0,0,0,0
3285,791938,22,1,3,1,1,0,2,0,0,1,5,0,0,0,3,1,2
3286,786097,9,0,0,0,0,0,0,0,0,0,3,0,0,0,0,0,0
3286,791135,23,1,2,1,2,0,0,2,4,1,4,0,3,0,1,1,4
3286,796790,29,4,15,2,7,2,8,0,0,1,4,2,2,0,1,0,10
3286,786090,32,7,14,4,7,3,7,5,6,0,7,3,2,5,4,0,22
3286,786088,35,2,6,1,3,1,3,0,0,0,1,5,3,1,6,0,5
3286,791134,12,1,3,1,3,0,0,0,1,2,3,1,1,0,0,0,2
3286,791131,17,3,6,2,4,1,2,1,3,4,1,0,3,0,2,1,8
3286,791521,7,0,0,0,0,0,0,0,0,0,0,0,0,0,0,0,0
3286,791132,24,3,6,0,1,3,5,0,0,0,3,0,4,1,3,0,9
3286,786092,12,0,1,0,1,0,0,2,2,0,0,0,1,0,0,1,2
3287,791316,31,5,8,5,8,0,0,0,1,3,6,2,5,2,2,1,10
3287,781079,32,2,7,2,4,0,3,2,3,0,2,1,1,5,0,0,6
3287,785380,27,2,4,1,3,1,1,0,0,1,3,0,4,0,2,0,5
3287,781443,34,5,13,4,9,1,4,8,9,0,3,6,1,2,3,0,19
3287,775822,27,8,14,3,4,5,10,1,2,0,6,2,3,1,2,0,22
3287,796626,14,3,3,3,3,0,0,1,5,1,1,0,2,0,0,0,7
3287,796625,16,0,1,0,0,0,1,1,3,0,2,4,1,0,1,0,1
3287,796621,15,0,1,0,1,0,0,0,0,0,1,1,1,0,1,0,0
3287,791314,4,0,1,0,1,0,0,0,0,0,1,0,2,0,0,0,0
3288,792565,24,8,16,8,14,0,2,0,0,2,3,1,1,2,3,1,16
3288,776333,20,1,1,1,1,0,0,0,0,0,6,2,4,0,1,0,2
3288,798133,20,2,5,0,0,2,5,0,0,0,1,0,1,1,1,0,6
3288,792563,21,3,5,1,2,2,3,1,2,1,1,2,3,1,2,0,9
3288,792561,24,4,8,2,4,2,4,0,0,1,3,3,0,1,3,1,10
3288,780266,21,3,7,2,3,1,4,3,3,0,1,1,1,1,2,0,10
3288,792560,17,0,0,0,0,0,0,0,0,2,3,0,2,0,1,0,0
3288,798132,15,2,4,1,1,1,3,1,2,0,1,0,1,0,1,0,6
3288,780270,18,1,6,0,2,1,4,2,2,0,1,1,0,0,3,0,5
3288,798135,1,0,0,0,0,0,0,0,0,0,0,0,0,1,0,0,0
3288,798134,16,1,4,1,1,0,3,2,2,2,0,1,0,0,2,0,4
3288,789634,3,0,0,0,0,0,0,0,0,0,0,0,0,0,0,0,0
3289,796699,28,5,8,5,7,0,1,0,0,2,3,1,2,1,2,0,10
3289,790983,20,1,3,0,0,1,3,0,0,1,1,7,3,2,2,0,3
3289,790978,27,3,8,2,3,1,5,2,2,0,6,2,3,1,2,0,9
3289,790979,36,6,11,2,4,4,7,0,0,0,3,4,1,2,6,0,16
3289,796700,21,0,5,0,2,0,3,2,2,1,3,2,0,2,1,0,2
3289,796698,11,0,1,0,1,0,0,0,0,0,0,0,1,0,0,0,0
3289,790976,13,2,2,2,2,0,0,0,2,1,0,0,0,0,1,1,4
3289,788820,25,6,16,1,2,5,14,3,3,0,0,0,1,1,1,1,20
3289,796701,11,1,1,1,1,0,0,0,0,3,3,0,3,0,1,0,2
3289,790980,8,0,2,0,2,0,0,0,0,0,1,0,0,0,0,1,0
3290,780676,35,5,14,4,10,1,4,3,3,2,5,3,2,1,5,0,14
3290,786157,24,1,3,1,3,0,0,2,4,1,3,2,1,0,0,1,4
3290,780673,26,4,6,0,0,4,6,0,0,0,2,4,3,0,2,0,12
3290,780677,29,4,11,0,2,4,9,0,0,0,5,1,5,2,1,0,12
3290,791756,34,0,4,0,3,0,1,2,3,0,5,6,4,1,1,0,2
3290,780992,30,7,15,2,6,5,9,0,0,0,2,2,0,4,0,0,19
3290,791754,5,0,1,0,0,0,1,0,2,0,1,0,0,0,1,1,0
3290,775533,15,2,3,2,3,0,0,0,0,0,3,0,2,1,0,1,4
3290,797348,2,0,0,0,0,0,0,0,0,0,0,0,0,0,0,0,0
3291,791147,7,0,1,0,1,0,0,0,0,0,1,0,1,0,0,0,0
3291,785782,34,5,9,1,2,4,7,1,2,0,3,1,1,0,1,0,15
3291,785777,34,4,8,1,3,3,5,2,2,2,3,3,3,2,3,0,13
3291,791146,40,3,13,2,7,1,6,4,4,0,4,9,2,1,5,0,11
3291,791145,34,7,11,6,9,1,2,0,0,1,11,3,3,1,1,1,15
3291,791144,17,2,6,2,5,0,1,1,2,3,3,0,2,0,0,0,5
3291,786748,2,0,1,0,0,0,1,0,0,0,0,0,0,0,0,0,0
3291,796804,12,0,2,0,0,0,2,0,0,0,2,0,1,0,1,0,0
3291,791148,20,3,6,1,3,2,3,3,3,1,1,0,2,0,1,0,11
3292,790893,31,1,3,1,2,0,1,0,0,1,4,4,1,0,3,2,2
3292,796444,31,0,0,0,0,0,0,3,6,0,5,2,2,0,3,3,3
3292,786615,34,5,7,3,4,2,3,1,2,3,8,2,1,1,3,2,13
3292,786732,20,5,7,4,5,1,2,1,3,1,4,1,5,1,0,1,12
3292,775260,36,7,16,5,9,2,7,2,2,0,5,5,1,0,3,0,18
3292,790889,11,1,5,0,0,1,5,0,0,0,2,0,0,0,0,0,3
3292,775536,18,5,7,5,7,0,0,1,1,1,4,1,4,0,1,1,11
3292,791501,1,0,0,0,0,0,0,0,0,0,0,0,1,0,0,0,0
3292,780702,18,1,2,1,1,0,1,0,0,0,0,1,0,1,2,0,2
3293,792351,33,4,9,4,8,0,1,0,0,0,1,0,2,1,2,0,8
3293,786723,35,2,14,2,11,0,3,1,2,3,5,2,1,2,1,0,5
3293,792349,15,1,5,1,5,0,0,0,0,1,2,0,3,0,0,0,2
3293,792355,22,3,11,2,4,1,7,0,0,0,2,1,1,1,1,0,7
3293,792352,29,1,3,1,1,0,2,3,4,2,2,3,3,2,0,0,5
3293,786724,20,1,6,1,3,0,3,2,2,3,1,2,0,0,0,0,4
3293,786726,1,0,0,0,0,0,0,0,0,0,0,0,1,0,0,0,0
3293,798060,28,2,6,1,3,1,3,0,0,1,3,3,2,1,2,0,5
3293,798061,17,3,7,2,4,1,3,3,4,0,1,0,4,1,0,0,10
3294,780323,24,2,4,2,4,0,0,3,4,3,2,0,3,0,1,4,7
3294,792233,37,4,5,3,3,1,2,4,5,3,4,1,1,1,3,0,13
3294,792229,34,2,11,2,10,0,1,5,7,2,2,2,4,2,1,1,9
3294,785811,37,7,15,4,8,3,7,4,7,0,3,0,5,0,3,0,21
3294,786016,14,0,2,0,1,0,1,0,0,0,1,2,0,0,1,0,0
3294,797894,9,0,3,0,3,0,0,0,0,1,0,0,1,0,1,0,0
3294,785954,36,5,11,1,2,4,9,4,6,0,7,3,3,0,4,0,18
3294,792234,8,2,2,2,2,0,0,0,1,0,3,0,1,0,0,1,4
3294,797892,22,0,2,0,0,0,2,5,5,0,1,1,1,0,0,2,5
3294,781356,4,0,0,0,0,0,0,0,0,0,2,1,2,0,0,0,0
3295,796439,16,2,7,2,7,0,0,0,0,0,0,1,4,1,2,0,4
3295,791635,36,5,9,2,4,3,5,2,2,2,2,3,2,2,1,0,15
3295,790883,40,6,7,5,6,1,1,4,4,0,6,1,3,2,1,0,17
3295,796436,38,3,12,2,9,1,3,6,7,0,7,4,5,4,2,0,13
3295,785436,39,7,14,6,12,1,2,2,4,3,4,3,3,3,2,0,17
3295,790884,14,1,2,1,2,0,0,3,6,1,5,0,5,0,3,0,5
3295,796438,27,2,7,0,1,2,6,0,0,1,1,1,2,0,2,0,6
3295,790885,13,2,5,2,3,0,2,1,1,1,1,1,2,0,0,0,5
3295,781262,2,0,0,0,0,0,0,0,0,0,0,0,0,0,0,0,0
3296,780824,27,5,7,5,7,0,0,2,2,3,4,0,3,2,2,0,12
3296,791117,41,2,8,1,4,1,4,2,2,0,1,1,4,0,0,0,7
3296,791118,42,6,12,3,7,3,5,9,11,1,6,7,1,1,3,0,24
3296,785676,36,5,8,5,6,0,2,0,0,0,2,2,3,4,1,0,10
3296,774974,36,5,10,4,8,1,2,4,6,0,2,5,2,2,5,0,15
3296,796771,6,0,1,0,1,0,0,0,0,0,0,1,2,1,2,0,0
3296,791115,12,1,1,1,1,0,0,0,2,0,1,0,3,0,1,0,2
3296,796769,23,2,5,1,3,1,2,0,1,0,0,1,0,0,0,0,5
3296,796768,2,0,0,0,0,0,0,0,0,0,0,0,0,0,0,0,0
3297,776100,27,1,2,1,2,0,0,0,0,1,3,1,2,1,5,0,2
3297,785991,33,4,9,4,8,0,1,3,3,1,7,1,3,0,2,2,11
3297,781406,37,6,12,6,11,0,1,11,11,0,6,3,2,0,3,1,23
3297,781401,28,3,6,3,4,0,2,4,4,1,1,1,5,2,1,1,10
3297,775317,15,1,1,1,1,0,0,0,0,0,1,1,1,0,3,1,2
3297,797760,2,0,0,0,0,0,0,0,0,0,0,0,3,0,1,0,0
3297,792133,26,4,9,2,5,2,4,0,0,0,3,2,3,0,3,0,10
3297,797762,30,2,3,2,3,0,0,1,2,0,5,3,2,1,2,0,5
3297,781029,27,3,5,1,1,2,4,0,0,0,1,0,2,0,1,0,8
3298,797235,25,7,9,7,9,0,0,1,3,3,4,0,2,0,5,0,15
3298,797232,33,4,11,1,4,3,7,0,1,1,2,0,2,1,1,0,11
3298,791367,25,3,3,3,3,0,0,1,2,0,2,3,1,2,1,0,7
3298,797234,18,0,5,0,3,0,2,0,0,0,5,1,2,0,1,0,0
3298,797239,33,5,14,3,8,2,6,6,6,0,2,3,2,1,2,0,18
3298,797233,7,0,2,0,1,0,1,4,4,3,0,1,1,1,0,0,4
3298,791368,18,1,2,1,2,0,0,2,2,3,1,1,1,0,0,1,4
3298,786535,13,1,2,0,0,1,2,0,0,0,1,0,1,0,2,1,3
3298,797237,12,1,3,1,2,0,1,0,1,0,2,2,0,1,0,0,2
3298,785446,16,0,3,0,2,0,1,2,2,0,0,0,2,0,2,0,2
3299,786216,40,7,11,7,11,0,0,4,4,3,8,3,3,0,4,0,18
3299,791348,27,9,11,7,8,2,3,2,3,0,1,1,4,1,3,0,22
3299,786218,35,2,9,2,5,0,4,0,0,0,2,2,3,1,1,1,4
3299,780663,36,9,14,6,9,3,5,2,3,0,5,5,2,1,3,0,23
3299,780150,22,0,1,0,0,0,1,0,0,0,2,0,4,3,0,0,0
3299,791350,28,1,3,0,0,1,3,2,2,0,3,0,1,2,1,0,5
3299,781645,9,0,1,0,0,0,1,0,0,0,0,2,3,0,3,0,0
3299,780156,3,0,0,0,0,0,0,0,0,0,0,0,1,0,0,0,0
3300,783072,21,3,9,2,4,1,5,3,3,2,7,0,4,0,3,1,10
3300,774879,18,3,6,3,4,0,2,3,4,0,5,0,4,1,1,0,9
3300,791540,35,5,8,3,4,2,4,2,2,0,1,3,3,0,4,0,14
3300,787782,33,3,7,2,4,1,3,2,3,0,4,1,2,3,4,0,9
3300,776068,25,2,6,1,3,1,3,7,8,0,3,1,4,0,2,0,12
3300,797817,19,1,3,0,1,1,2,1,2,1,2,0,1,1,1,0,4
3300,785647,9,2,5,1,2,1,3,0,1,2,2,0,1,0,0,0,5
3300,781463,24,3,7,2,2,1,5,0,0,0,1,3,1,0,0,3,7
3300,792153,16,0,1,0,0,0,1,0,0,0,1,0,1,0,1,0,0
3301,781454,12,0,2,0,1,0,1,0,0,0,1,0,3,0,2,1,0
3301,786424,36,7,14,7,14,0,0,4,12,7,13,0,4,1,4,3,18
3301,792366,37,7,17,7,15,0,2,5,8,0,2,2,4,0,3,0,19
3301,792279,10,0,3,0,1,0,2,0,0,0,2,0,3,0,1,0,0
3301,785483,36,1,5,0,2,1,3,0,0,1,3,3,2,4,2,2,3
3301,785959,14,1,2,1,2,0,0,0,0,1,1,1,1,2,0,0,2
3301,797988,13,4,6,2,3,2,3,0,0,1,0,0,1,0,1,0,10
3301,797979,17,2,4,2,2,0,2,0,0,1,0,1,1,0,0,0,4
3301,791015,18,1,2,0,0,1,2,3,7,0,2,0,2,1,1,0,6
3301,775335,7,0,1,0,0,0,1,0,0,0,1,0,1,0,1,0,0
3302,791793,16,0,1,0,0,0,1,0,0,0,0,0,2,0,2,0,0
3302,786481,36,7,15,7,13,0,2,2,4,1,4,0,1,0,5,0,16
3302,797626,34,3,5,2,4,1,1,2,4,1,7,5,1,3,3,0,9
3302,797624,18,0,1,0,0,0,1,1,2,0,3,0,3,1,1,0,1
3302,785965,16,0,4,0,2,0,2,2,2,0,2,0,0,0,1,0,2
3302,797628,27,0,2,0,2,0,0,11,12,1,6,0,2,0,3,0,11
3302,791791,12,0,1,0,0,0,1,0,0,0,1,0,3,0,0,0,0
3302,791790,11,1,5,1,3,0,2,0,1,0,1,0,0,0,1,0,2
3302,781032,30,3,5,2,3,1,2,4,4,0,3,2,2,1,1,0,11
3303,792340,39,6,11,6,10,0,1,2,4,3,8,0,5,0,5,1,14
3303,792345,21,2,6,2,4,0,2,0,0,0,4,0,2,1,3,0,4
3303,792341,22,0,0,0,0,0,0,0,0,0,2,0,5,1,3,0,0
3303,792346,22,1,3,1,3,0,0,0,1,1,2,0,4,2,3,0,2
3303,781553,29,5,9,3,6,2,3,1,2,0,5,0,5,3,2,0,13
3303,798080,5,0,2,0,1,0,1,0,0,0,0,0,0,0,0,0,0
3303,792342,26,0,4,0,1,0,3,0,0,0,1,2,3,2,0,0,0
3303,781552,36,4,16,4,14,0,2,4,7,2,2,3,2,3,0,0,12
3304,799906,35,6,13,3,7,3,6,0,0,2,4,4,1,3,1,0,15
3304,775833,20,3,4,3,4,0,0,2,2,0,4,0,3,0,1,0,8
3304,796845,20,0,2,0,0,0,2,0,0,0,2,1,3,0,2,0,0
3304,781036,40,9,14,6,7,3,7,5,6,0,3,7,1,0,3,0,26
3304,774894,40,6,9,2,4,4,5,0,1,0,5,0,0,0,3,0,16
3304,796847,25,2,7,0,2,2,5,1,2,1,5,2,2,0,1,0,7
3304,791178,20,1,1,1,1,0,0,0,0,1,2,0,3,0,1,0,2
3305,791295,27,2,6,2,6,0,0,0,2,3,4,0,1,0,0,0,4
3305,776345,25,6,12,5,10,1,2,0,0,1,1,1,3,0,1,2,13
3305,791293,16,0,1,0,0,0,1,0,0,0,1,3,3,0,1,0,0
3305,796579,29,6,11,2,2,4,9,0,0,0,2,3,1,1,1,0,16
3305,785794,35,4,9,2,5,2,4,5,6,0,5,2,1,1,4,0,15
3305,781379,1,0,0,0,0,0,0,0,0,0,0,0,0,0,0,0,0
3305,791292,5,0,0,0,0,0,0,0,0,0,0,0,0,0,1,0,0
3305,796580,17,1,2,1,2,0,0,0,0,0,0,3,1,0,0,0,2
3305,785792,18,1,3,1,2,0,1,0,0,0,1,1,0,0,0,0,2
3305,781373,27,4,8,1,2,3,6,2,3,0,6,1,3,0,2,0,13
3306,791837,24,3,9,1,3,2,6,0,0,1,6,1,5,0,0,1,8
3306,780613,39,3,6,3,6,0,0,6,7,6,4,0,1,1,1,0,12
3306,775097,34,3,8,3,6,0,2,1,4,0,5,6,2,0,2,2,7
3306,780609,38,5,13,4,7,1,6,2,3,0,1,4,3,3,2,0,13
3306,776395,37,7,15,4,5,3,10,4,5,0,1,3,2,2,2,0,21
3306,786621,6,1,1,1,1,0,0,0,0,0,0,0,1,0,0,0,2
3306,797437,4,0,0,0,0,0,0,0,0,1,0,0,1,0,1,0,0
3306,786619,18,1,2,1,2,0,0,1,2,0,2,0,1,0,1,0,3
3307,786123,37,2,5,2,5,0,0,3,4,2,11,1,2,0,0,1,7
3307,780437,25,3,4,3,4,0,0,1,1,2,3,1,1,0,0,0,7
3307,797673,31,7,12,5,8,2,4,1,1,1,2,2,3,1,4,1,17
3307,786118,28,5,12,4,6,1,6,0,0,3,6,1,4,0,1,0,11
3307,786117,37,5,9,4,6,1,3,5,6,0,1,3,4,1,3,0,16
3307,797672,8,0,0,0,0,0,0,0,0,1,1,1,0,0,0,0,0
3307,792093,12,2,7,1,4,1,3,0,0,0,0,0,1,0,0,0,5
3307,797675,3,0,0,0,0,0,0,0,0,0,0,0,2,0,1,1,0
3307,786264,19,2,8,2,6,0,2,2,2,2,1,0,1,1,3,1,6
3308,780570,20,2,7,2,7,0,0,0,0,0,1,1,3,1,2,0,4
3308,780569,29,8,10,8,10,0,0,1,3,2,6,2,3,0,2,1,17
3308,797438,29,1,5,0,4,1,1,0,0,1,3,1,1,0,0,0,3
3308,791697,32,8,11,5,7,3,4,5,6,0,1,4,2,1,2,0,24
3308,780565,32,4,6,2,2,2,4,0,0,0,2,3,4,1,2,0,10
3308,797434,11,4,5,4,5,0,0,0,0,0,3,1,0,0,0,0,8
3308,797432,10,1,2,1,1,0,1,0,0,0,1,2,3,1,1,0,2
3308,791696,18,1,6,1,4,0,2,4,4,0,3,2,2,0,2,0,6
3308,791695,10,3,5,3,5,0,0,1,2,0,2,1,0,0,1,1,7
3308,785824,6,0,0,0,0,0,0,2,2,1,0,0,2,0,2,0,2
3308,781556,3,0,0,0,0,0,0,0,0,0,0,0,0,1,0,0,0
3309,786547,23,1,2,0,1,1,1,1,4,1,2,3,5,1,1,1,4
3309,786544,37,16,23,10,12,6,11,1,1,5,5,1,1,1,0,0,39
3309,797507,35,4,13,2,6,2,7,0,2,1,3,4,2,1,3,0,10
3309,792012,40,9,16,5,6,4,10,3,4,0,3,5,1,3,1,0,25
3309,775084,28,5,10,3,6,2,4,2,2,1,3,4,0,1,1,0,14
3309,786860,18,1,3,1,2,0,1,0,0,1,3,1,3,0,1,0,2
3309,797509,5,0,0,0,0,0,0,1,2,0,1,0,3,0,1,0,1
3309,786546,14,0,0,0,0,0,0,0,0,0,0,2,0,0,1,0,0
3310,797140,16,0,4,0,2,0,2,0,0,0,1,3,0,1,1,1,0
3310,775110,38,4,5,4,5,0,0,1,2,3,7,1,1,3,0,0,9
3310,797135,23,2,8,1,2,1,6,0,0,0,2,0,1,1,1,0,5
3310,791392,13,0,2,0,0,0,2,0,0,0,1,2,1,2,3,0,0
3310,775458,33,5,12,4,6,1,6,4,4,0,2,0,4,3,6,0,15
3310,797134,7,0,0,0,0,0,0,0,0,0,0,0,0,0,2,0,0
3310,781353,2,1,2,1,2,0,0,0,0,0,0,0,1,0,0,1,2
3310,797138,21,1,4,0,3,1,1,1,2,0,3,4,4,3,2,0,4
3310,785264,18,6,9,4,5,2,4,0,0,1,2,0,2,0,3,0,14
3310,785936,6,0,1,0,0,0,1,0,0,1,2,1,0,1,1,0,0
3310,780128,23,0,5,0,3,0,2,0,0,0,2,2,1,1,2,0,0
3311,785681,24,1,2,1,2,0,0,1,2,1,7,3,1,1,1,1,3
3311,796789,26,2,4,2,2,0,2,1,2,0,4,2,1,5,7,0,5
3311,791126,26,8,13,7,10,1,3,1,2,0,4,0,2,1,2,0,18
3311,791124,29,2,7,2,6,0,1,4,4,0,1,3,4,1,2,0,8
3311,780050,31,5,10,3,5,2,5,0,2,2,4,1,1,3,3,0,12
3311,796786,15,2,4,1,1,1,3,2,2,0,2,1,0,0,0,0,7
3311,775813,20,2,8,2,7,0,1,0,0,4,1,1,1,2,3,1,4
3311,796784,11,1,2,1,1,0,1,0,0,0,1,1,1,0,3,0,2
3311,796783,2,0,0,0,0,0,0,0,0,0,0,0,2,0,0,0,0
3311,796782,16,0,2,0,0,0,2,0,0,0,0,0,1,1,0,0,0
3312,785762,23,3,6,3,5,0,1,2,2,3,7,2,5,0,2,0,8
3312,797409,32,1,6,1,4,0,2,1,2,0,4,3,4,1,4,1,3
3312,797415,11,1,1,0,0,1,1,1,2,0,2,0,2,0,0,0,4
3312,780535,28,3,8,0,1,3,7,0,4,0,3,1,0,1,1,0,9
3312,780531,36,6,19,5,13,1,6,4,4,1,4,3,4,1,3,1,17
3312,791669,27,2,4,2,4,0,0,4,7,4,5,2,4,2,1,3,8
3312,780534,19,1,1,1,1,0,0,3,6,1,1,0,2,0,2,1,5
3312,791666,19,1,5,1,3,0,2,0,0,0,0,0,1,0,2,0,2
3312,785760,5,0,1,0,0,0,1,0,0,0,0,0,1,0,1,0,0
3313,791658,28,5,8,5,8,0,0,0,3,5,1,0,5,1,1,1,10
3313,780509,25,2,8,1,5,1,3,2,2,1,6,0,3,0,3,1,7
3313,797290,35,7,14,7,12,0,2,5,6,0,6,1,1,0,3,0,19
3313,797291,23,1,4,1,3,0,1,0,0,0,2,0,0,0,5,0,2
3313,786064,22,1,4,0,1,1,3,3,3,1,2,0,4,0,1,0,6
3313,791663,12,0,0,0,0,0,0,0,0,0,1,0,2,1,0,3,0
3313,785658,14,2,5,2,3,0,2,1,3,2,1,0,2,2,0,1,5
3313,797293,11,0,2,0,1,0,1,0,0,0,4,1,0,0,0,0,0
3313,791660,30,4,9,4,7,0,2,4,7,0,4,2,3,1,1,0,12
3314,797842,30,6,12,6,10,0,2,4,6,4,3,2,2,0,4,1,16
3314,797849,27,4,8,3,6,1,2,2,2,3,2,1,4,1,4,0,11
3314,779986,12,2,5,2,5,0,0,3,4,1,0,0,4,0,0,0,7
3314,786079,28,1,5,1,3,0,2,2,3,0,4,7,1,3,2,0,4
3314,797835,8,0,1,0,0,0,1,0,0,0,0,0,0,0,1,0,0
3314,797848,14,0,2,0,2,0,0,5,6,3,2,0,1,3,1,1,5
3314,781537,17,3,8,2,5,1,3,3,4,1,4,0,1,0,0,0,10
3314,792201,1,0,0,0,0,0,0,0,0,0,0,0,0,0,0,0,0
3314,797847,5,0,0,0,0,0,0,0,0,0,0,0,1,0,0,0,0
3314,797838,1,0,0,0,0,0,0,0,0,0,0,0,0,0,0,0,0
3314,797846,27,0,7,0,4,0,3,3,4,1,2,0,1,0,2,0,3
3314,797843,30,4,8,2,4,2,4,3,3,0,1,4,1,2,1,0,13
3315,785305,8,1,1,1,1,0,0,0,0,0,0,1,3,1,5,0,2
3315,785123,19,5,9,5,9,0,0,3,3,1,5,1,1,0,1,1,13
3315,790990,25,9,14,6,7,3,7,0,0,1,6,1,3,6,2,0,21
3315,789219,23,3,7,1,1,2,6,0,0,0,1,0,1,2,0,0,8
3315,785059,20,0,1,0,0,0,1,0,0,2,5,6,1,1,2,0,0
3315,796624,18,3,4,3,4,0,0,0,0,0,2,1,3,1,1,0,6
3315,796622,18,4,4,4,4,0,0,1,2,1,4,1,4,1,1,0,9
3315,796623,18,4,7,2,4,2,3,7,8,1,1,3,2,1,4,0,17
3315,790988,17,3,4,1,1,2,3,0,0,0,1,6,1,0,0,0,8
3315,785303,19,0,2,0,0,0,2,0,0,0,2,3,2,0,0,0,0
3315,785122,15,2,4,0,1,2,3,0,0,1,0,4,2,0,2,0,6
3316,791511,24,3,6,3,6,0,0,0,0,1,2,0,4,1,4,0,6
3316,778442,25,5,8,3,4,2,4,1,1,0,4,4,5,2,3,0,13
3316,791514,17,0,2,0,0,0,2,0,0,0,0,1,1,0,1,0,0
3316,786637,40,5,11,2,5,3,6,0,1,0,8,2,2,2,3,1,13
3316,791513,32,3,7,0,3,3,4,2,2,0,3,0,0,1,0,1,11
3316,797151,11,1,1,1,1,0,0,0,0,0,1,0,3,0,0,0,2
3316,791515,13,0,2,0,1,0,1,5,6,1,2,2,1,0,0,0,5
3316,797154,7,1,3,0,0,1,3,3,4,0,0,0,1,0,0,0,6
3316,797152,7,0,3,0,2,0,1,0,0,0,1,1,1,0,0,0,0
3316,780946,23,1,4,1,3,0,1,4,4,0,0,2,3,3,1,0,6
3316,797153,1,0,0,0,0,0,0,0,0,0,0,0,0,0,0,0,0
3317,796566,30,3,12,3,11,0,1,3,4,4,6,0,2,0,3,3,9
3317,796563,27,2,6,1,2,1,4,0,0,0,3,1,4,0,2,0,5
3317,790969,39,5,14,3,9,2,5,4,7,0,3,2,1,1,5,0,16
3317,790968,17,1,4,1,2,0,2,0,0,0,0,0,4,1,0,0,2
3317,780166,38,0,8,0,4,0,4,4,6,0,6,2,1,2,2,0,4
3317,796568,17,2,3,2,3,0,0,3,3,1,3,0,4,0,2,0,7
3317,790971,22,1,1,1,1,0,0,8,9,5,3,0,0,0,1,1,10
3317,796569,10,1,4,1,2,0,2,0,0,1,1,0,3,0,0,0,2
3318,792338,37,4,10,3,7,1,3,5,5,0,2,3,4,2,2,0,14
3318,781666,36,4,13,2,6,2,7,1,1,0,3,2,3,0,1,0,11
3318,786575,26,2,3,2,3,0,0,5,5,5,4,0,3,1,4,1,9
3318,785531,14,2,4,1,1,1,3,0,0,0,1,0,1,1,3,0,5
3318,798094,13,1,2,0,1,1,1,0,0,0,1,0,2,1,3,0,3
3318,798095,15,3,4,2,2,1,2,0,0,0,0,0,2,1,0,0,7
3318,798097,13,1,2,1,2,0,0,2,2,2,1,1,0,1,0,1,4
3318,798100,12,1,3,1,3,0,0,2,2,0,0,1,2,0,1,0,4
3318,791636,20,0,7,0,2,0,5,2,2,0,1,1,0,1,1,0,2
3318,799842,12,0,3,0,3,0,0,0,0,0,0,0,1,0,1,0,0
3318,792336,2,0,1,0,1,0,0,0,0,0,0,0,0,0,0,0,0
3319,792227,28,8,9,7,8,1,1,1,2,0,4,1,1,0,1,1,18
3319,792223,26,4,7,2,3,2,4,2,2,0,0,4,4,0,2,0,12
3319,785935,38,4,9,3,5,1,4,1,2,0,4,2,0,4,3,0,10
3319,781340,22,0,0,0,0,0,0,3,4,0,5,2,3,0,6,0,3
3319,781352,14,1,2,1,2,0,0,0,0,0,0,2,5,0,2,0,2
3319,781351,12,4,6,4,6,0,0,2,2,2,1,0,0,1,0,0,10
3319,776128,30,3,5,1,2,2,3,0,0,0,4,7,1,0,2,0,8
3319,797881,13,2,4,2,4,0,0,2,2,1,2,0,3,1,1,1,6
3319,797889,13,1,2,1,2,0,0,0,0,2,2,1,1,0,1,0,2
3319,786453,4,0,1,0,0,0,1,0,0,0,0,1,0,0,0,0,0
3320,796617,11,5,5,5,5,0,0,0,0,1,0,0,1,0,1,0,10
3320,775131,21,2,3,2,3,0,0,2,2,1,2,5,1,2,0,0,6
3320,796616,19,1,4,1,1,0,3,1,2,0,1,3,0,0,0,0,3
3320,796612,22,3,6,2,4,1,2,0,0,0,3,2,1,1,0,1,7
3320,785562,21,3,6,3,5,0,1,6,8,2,3,1,0,1,0,0,12
3320,796615,6,1,2,1,2,0,0,0,0,0,1,0,0,0,0,0,2
3320,792429,14,8,10,6,8,2,2,0,0,1,2,0,1,0,0,0,18
3320,796618,12,0,0,0,0,0,0,0,0,1,2,3,1,0,1,1,0
3320,799543,1,1,1,0,0,1,1,0,0,0,0,0,0,0,0,0,3
3320,796619,10,2,4,0,1,2,3,0,0,0,0,1,0,2,1,0,6
3320,796614,18,3,5,2,3,1,2,2,4,0,4,2,2,1,0,0,9
3320,796608,7,2,2,2,2,0,0,0,0,1,0,0,0,0,0,0,4
3320,796607,17,1,3,1,3,0,0,2,2,1,4,1,1,0,1,0,4
3320,796606,21,3,4,3,4,0,0,0,0,0,3,2,2,3,0,0,6
3322,791493,38,5,6,5,6,0,0,8,10,2,13,1,2,0,2,1,18
3322,789036,38,5,8,5,8,0,0,2,2,1,7,6,3,0,7,1,12
3322,797191,28,4,5,3,4,1,1,4,4,0,2,3,2,1,2,0,13
3322,791495,11,0,1,0,0,0,1,0,0,0,2,2,1,0,1,0,0
3322,776494,38,7,9,1,1,6,8,6,8,1,5,1,2,0,3,0,26
3322,781307,4,0,0,0,0,0,0,0,1,0,0,0,2,0,2,0,0
3322,791492,24,1,5,1,2,0,3,1,2,1,4,1,1,0,1,0,3
3322,791494,19,1,7,1,6,0,1,1,1,1,2,2,2,0,3,0,3
3323,797895,16,1,2,1,2,0,0,2,5,3,1,1,3,0,0,0,4
3323,789058,9,1,2,1,2,0,0,0,0,1,1,0,3,1,2,0,2
3323,797898,35,7,20,1,8,6,12,2,4,1,6,2,1,3,1,1,22
3323,792240,29,1,7,0,4,1,3,0,0,2,0,0,4,3,0,0,3
3323,792237,34,6,15,2,7,4,8,2,3,0,1,3,1,0,1,0,18
3323,785818,9,0,3,0,0,0,3,0,0,0,0,0,4,0,1,0,0
3323,785286,20,3,6,2,5,1,1,2,4,1,2,0,0,1,3,2,9
3323,776337,9,0,2,0,2,0,0,0,0,0,0,0,1,0,0,0,0
3323,792236,17,2,4,2,3,0,1,0,0,1,0,2,2,0,0,1,4
3323,792359,10,0,4,0,0,0,4,0,0,0,1,0,5,0,0,0,0
3323,792238,8,0,0,0,0,0,0,0,0,0,0,0,1,0,0,0,0
3323,797897,2,0,1,0,0,0,1,0,0,0,0,0,0,0,0,0,0
3323,785986,2,0,0,0,0,0,0,0,0,0,0,1,0,0,0,0,0
3324,792158,17,1,2,1,2,0,0,0,2,0,1,0,3,2,2,2,2
3324,780138,31,4,6,4,6,0,0,7,8,1,7,1,4,0,4,0,15
3324,792154,29,3,6,3,5,0,1,3,6,2,1,0,3,1,3,0,9
3324,792152,36,8,14,6,11,2,3,2,2,0,2,3,1,3,2,0,20
3324,780581,19,2,6,2,3,0,3,0,0,2,0,2,1,1,3,0,4
3324,797755,16,3,4,3,4,0,0,4,4,2,1,1,3,0,4,0,10
3324,792157,14,2,3,2,3,0,0,1,2,2,2,0,4,0,1,0,5
3324,797756,20,3,5,3,5,0,0,4,5,0,2,4,2,0,1,0,10
3324,786014,18,0,0,0,0,0,0,3,4,0,3,1,5,0,0,0,3
3325,786071,21,1,2,1,2,0,0,3,6,2,3,0,1,1,3,1,5
3325,786460,9,1,1,1,1,0,0,0,0,0,1,0,5,0,0,0,2
3325,780604,32,7,11,7,11,0,0,5,7,2,2,2,4,2,4,0,19
3325,780603,28,1,5,1,4,0,1,0,1,0,1,3,5,1,3,0,2
3325,780602,40,9,13,9,12,0,1,4,4,0,6,2,2,4,4,0,22
3325,791768,11,1,2,1,2,0,0,0,0,0,1,0,0,0,2,0,2
3325,797564,2,0,0,0,0,0,0,0,0,0,0,0,0,0,2,0,0
3325,791766,29,2,8,1,4,1,4,4,6,2,1,0,1,3,1,0,9
3325,791767,9,0,1,0,0,0,1,4,4,0,0,0,3,0,0,0,4
3325,786230,18,0,2,0,1,0,1,2,2,0,1,3,4,0,2,0,2
3325,780605,1,0,0,0,0,0,0,0,0,0,0,0,0,0,0,0,0
3326,785999,34,2,11,2,11,0,0,3,5,6,6,3,3,0,4,3,7
3326,775654,35,2,3,2,3,0,0,1,1,1,4,1,3,3,2,4,5
3326,775171,38,4,6,1,1,3,5,3,4,1,1,1,1,1,0,0,14
3326,791639,44,8,21,7,18,1,3,0,0,1,4,5,2,1,4,0,17
3326,785389,47,5,16,4,11,1,5,8,10,0,5,3,1,1,3,0,19
3326,791640,5,1,2,1,2,0,0,0,0,2,0,0,1,0,1,0,2
3326,785255,26,2,5,2,4,0,1,1,2,2,5,2,1,1,2,0,5
3326,796399,9,1,3,1,2,0,1,0,0,0,0,0,1,1,0,0,2
3326,796398,12,1,2,1,2,0,0,0,1,2,2,1,1,2,0,0,2
3327,797222,20,1,4,1,4,0,0,0,1,1,1,2,2,3,1,4,2
3327,781526,37,6,16,4,14,2,2,0,0,6,6,1,2,1,3,2,14
3327,797217,43,5,10,4,7,1,3,0,0,2,2,6,2,2,3,0,11
3327,797218,31,4,13,4,12,0,1,3,5,0,2,1,2,2,1,1,11
3327,775697,41,3,10,2,6,1,4,0,2,0,4,5,1,1,5,1,7
3327,791846,11,3,7,3,7,0,0,0,0,2,2,0,1,0,0,0,6
3327,797223,35,2,4,2,4,0,0,0,0,4,8,2,2,1,3,1,4
3327,791453,32,8,13,1,2,7,11,0,0,1,4,0,3,0,0,1,23
3328,791416,29,7,9,7,9,0,0,0,6,1,9,0,2,0,2,2,14
3328,797096,20,2,6,0,0,2,6,4,7,1,2,0,3,0,0,0,10
3328,785906,35,5,13,5,11,0,2,2,2,1,4,3,3,0,2,1,12
3328,780100,33,3,6,0,1,3,5,3,5,0,10,1,0,1,0,1,12
3328,780096,37,2,5,1,1,1,4,0,0,0,3,3,1,3,2,0,5
3328,797094,5,2,2,1,1,1,1,0,1,1,1,1,0,0,0,1,5
3328,785907,12,0,3,0,2,0,1,0,0,1,1,3,3,1,2,1,0
3328,797093,29,4,8,4,7,0,1,0,1,0,1,6,3,1,3,0,8
3329,790839,14,1,3,1,1,0,2,0,0,0,0,0,3,0,1,0,2
3329,785388,27,7,14,7,14,0,0,0,3,2,6,2,3,1,2,1,14
3329,790840,29,5,11,4,9,1,2,3,3,1,4,0,2,0,5,0,14
3329,785386,25,0,6,0,5,0,1,0,0,0,4,4,3,2,3,0,0
3329,780373,30,3,6,0,1,3,5,0,0,0,3,0,4,0,1,0,9
3329,780370,18,2,3,0,0,2,3,0,0,1,3,2,1,0,0,0,6
3329,796393,12,3,6,3,6,0,0,1,2,0,4,0,1,0,1,3,7
3329,796395,15,0,4,0,3,0,1,0,0,0,2,0,0,0,0,0,0
3329,796396,8,0,0,0,0,0,0,0,0,0,0,1,2,0,0,0,0
3329,790841,22,1,3,0,1,1,2,3,4,1,1,2,1,0,1,0,6
3330,790870,31,10,15,10,15,0,0,2,3,2,9,5,2,1,4,0,22
3330,790869,29,7,10,4,6,3,4,6,6,0,6,2,3,2,2,0,23
3330,780493,24,2,6,1,1,1,5,0,0,0,4,2,1,1,1,0,5
3330,780116,30,4,6,1,3,3,3,4,4,1,2,0,3,0,5,0,15
3330,790866,34,2,8,1,1,1,7,0,0,0,5,0,2,1,2,0,5
3330,796426,6,2,2,2,2,0,0,0,0,0,1,0,0,1,1,0,4
3330,796427,12,0,1,0,0,0,1,0,2,0,1,3,3,0,2,0,0
3330,796421,31,5,7,5,5,0,2,0,0,1,1,4,3,1,0,2,10
3330,785878,3,0,0,0,0,0,0,0,0,0,1,0,0,0,1,0,0
3331,791391,24,3,6,2,5,1,1,2,2,4,2,1,4,1,1,2,9
3331,797156,9,0,4,0,2,0,2,0,0,0,0,1,2,0,0,0,0
3331,791390,27,3,5,2,4,1,1,0,0,1,1,1,5,1,3,0,7
3331,780133,33,6,12,3,7,3,5,4,4,0,5,0,0,3,4,0,19
3331,780130,33,8,19,6,14,2,5,3,4,1,6,3,1,1,1,0,21
3331,797158,12,1,2,1,2,0,0,0,0,3,2,0,3,0,0,0,2
3331,791388,15,0,1,0,1,0,0,2,2,1,2,2,1,0,1,0,2
3331,791389,4,1,1,0,0,1,1,0,0,0,0,0,1,0,0,0,3
3331,775743,17,3,7,2,3,1,4,2,2,0,0,0,0,0,2,0,9
3331,776446,26,0,9,0,5,0,4,2,4,0,1,2,0,1,2,0,2
3332,792418,23,5,8,4,6,1,2,3,6,0,5,5,2,0,1,2,14
3332,782654,23,4,7,4,7,0,0,2,2,1,3,0,3,1,2,1,10
3332,796693,32,3,6,2,2,1,4,1,1,1,3,5,0,3,3,0,8
3332,792422,26,6,9,6,9,0,0,6,6,2,3,2,2,2,1,1,18
3332,789484,30,6,15,4,9,2,6,9,11,5,8,2,1,1,1,1,23
3332,796695,6,0,3,0,3,0,0,0,0,0,3,0,2,0,1,0,0
3332,796692,5,0,0,0,0,0,0,0,0,0,1,0,0,0,0,0,0
3332,792424,7,1,1,1,1,0,0,0,2,0,4,1,3,0,0,1,2
3332,792419,2,0,2,0,0,0,2,0,0,0,0,0,2,0,0,0,0
3332,799739,4,0,1,0,0,0,1,2,2,0,1,0,0,1,1,0,2
3332,792421,14,3,5,2,3,1,2,1,2,0,4,3,1,1,1,0,8
3332,796694,4,0,0,0,0,0,0,1,2,0,0,0,1,0,1,0,1
3332,796691,20,2,4,0,0,2,4,0,0,1,1,4,0,0,0,0,6
3332,792423,4,0,0,0,0,0,0,0,0,0,0,0,0,1,1,0,0
3333,799136,10,0,0,0,0,0,0,0,0,0,3,0,5,0,1,0,0
3333,799129,32,1,12,1,8,0,4,4,4,4,3,2,0,0,3,0,6
3333,799132,28,4,11,1,6,3,5,3,6,2,3,2,4,1,0,0,14
3333,799134,34,2,8,0,3,2,5,1,2,0,4,1,3,3,1,1,7
3333,792634,26,2,13,2,9,0,4,3,6,1,3,2,4,1,1,0,7
3333,799131,7,1,1,1,1,0,0,0,1,0,0,0,1,0,2,0,2
3333,799135,22,6,7,6,7,0,0,0,1,3,2,0,2,0,2,1,12
3333,799128,15,0,2,0,2,0,0,0,0,0,1,0,1,1,4,0,0
3333,799133,26,2,7,2,4,0,3,0,1,0,4,2,3,0,4,1,4
3334,775563,19,3,4,3,3,0,1,3,4,1,6,1,5,0,2,0,9
3334,781011,18,1,4,1,4,0,0,0,0,0,7,0,4,0,2,2,2
3334,786466,35,5,12,2,4,3,8,2,3,2,2,1,1,2,2,1,15
3334,781012,38,6,16,1,2,5,14,0,0,0,3,5,1,2,2,1,17
3334,775119,33,5,9,5,8,0,1,1,1,0,2,6,3,1,4,1,11
3334,797602,1,1,1,1,1,0,0,0,0,0,0,0,1,0,0,0,2
3334,775806,8,2,5,1,3,1,2,0,0,1,1,0,1,0,0,0,5
3334,775188,16,2,4,2,4,0,0,1,2,3,3,0,2,1,0,0,5
3334,797601,29,5,9,2,2,3,7,2,2,0,0,1,0,1,1,0,15
3334,781424,1,0,0,0,0,0,0,0,0,0,0,0,0,0,1,0,0
3334,776157,2,0,0,0,0,0,0,0,0,0,0,0,0,0,0,0,0
3335,797367,24,5,9,5,9,0,0,0,0,4,4,1,2,2,2,0,10
3335,797369,35,3,6,3,5,0,1,2,4,1,6,4,3,2,5,0,8
3335,797366,16,1,2,1,2,0,0,0,2,1,4,0,4,2,0,0,2
3335,791807,40,10,16,3,6,7,10,0,0,2,6,0,1,0,0,0,27
3335,786130,32,3,11,3,8,0,3,0,0,0,5,1,0,1,6,0,6
3335,797364,14,2,7,1,6,1,1,2,3,2,1,0,3,0,1,0,7
3335,797363,17,2,6,2,4,0,2,4,5,0,0,4,2,0,2,0,8
3335,797365,22,5,8,1,1,4,7,2,2,0,2,3,1,0,0,0,16
3336,797558,15,3,8,1,2,2,6,0,0,0,1,0,3,0,2,0,8
3336,786519,22,2,5,2,5,0,0,0,0,1,7,1,2,1,2,1,4
3336,797556,33,10,17,8,11,2,6,0,0,0,1,2,2,1,2,0,22
3336,791913,31,2,8,2,5,0,3,2,2,0,2,4,2,2,3,0,6
3336,786520,36,5,13,4,7,1,6,0,0,4,4,2,2,0,3,0,11
3336,791912,16,1,1,1,1,0,0,0,0,1,2,0,4,1,2,0,2
3336,797560,2,0,0,0,0,0,0,0,0,0,0,0,0,0,0,0,0
3336,797559,7,0,0,0,0,0,0,0,0,0,0,1,1,0,0,0,0
3336,797557,15,0,2,0,0,0,2,0,0,0,3,0,2,0,1,0,0
3336,797555,23,5,7,3,4,2,3,5,5,3,4,3,1,1,1,1,17
3337,780521,18,4,8,1,2,3,6,2,2,0,2,0,0,0,4,0,13
3337,775163,24,3,4,3,4,0,0,1,4,5,1,3,2,2,1,2,7
3337,791370,22,1,2,1,1,0,1,4,5,1,1,0,4,1,0,0,6
3337,786199,35,4,11,4,5,0,6,2,4,0,6,3,2,2,4,1,10
3337,780991,34,7,12,7,12,0,0,2,2,0,3,3,1,1,5,0,16
3337,780145,4,0,1,0,1,0,0,0,0,2,0,0,0,0,0,0,0
3337,781611,13,1,1,1,1,0,0,0,0,1,1,0,2,2,0,0,2
3337,797271,29,3,8,1,3,2,5,2,2,0,4,2,1,1,2,0,10
3337,743593,9,2,4,2,4,0,0,0,1,1,1,1,2,0,1,0,4
3337,791371,12,0,2,0,2,0,0,0,2,1,1,1,0,2,0,1,0
3338,780122,26,4,9,3,4,1,5,0,0,1,3,1,1,0,2,1,9
3338,797215,26,1,2,1,1,0,1,0,0,0,2,10,0,3,2,0,2
3338,797214,19,1,3,1,3,0,0,0,0,0,2,5,3,1,1,1,2
3338,786295,23,6,9,4,5,2,4,1,1,0,4,0,4,0,0,0,15
3338,780792,19,6,11,4,7,2,4,0,0,1,5,1,2,2,1,0,14
3338,797216,5,0,0,0,0,0,0,0,0,0,2,0,1,0,0,1,0
3338,786299,5,0,0,0,0,0,0,0,0,0,2,0,0,0,1,0,0
3338,797213,4,0,1,0,0,0,1,0,0,0,1,0,0,0,0,0,0
3338,791463,2,1,1,0,0,1,1,0,0,0,0,0,0,0,0,0,3
3338,791461,9,0,0,0,0,0,0,0,0,0,3,0,1,2,1,0,0
3338,791459,20,3,4,1,2,2,2,2,2,0,1,4,1,3,2,0,10
3338,791460,24,6,9,2,2,4,7,2,4,0,0,3,3,0,1,0,18
3338,789034,2,0,1,0,0,0,1,0,0,0,0,0,1,0,0,0,0
3338,775598,16,5,7,1,1,4,6,2,2,0,3,0,0,0,1,0,16
3339,791276,29,5,7,5,7,0,0,6,8,8,5,1,3,1,2,0,16
3339,796529,24,2,9,1,3,1,6,0,0,2,0,2,0,2,5,1,5
3339,785748,27,2,11,2,4,0,7,3,4,0,2,0,0,0,2,0,7
3339,785746,21,2,7,1,2,1,5,2,2,0,2,1,1,1,2,0,7
3339,785741,34,2,5,1,2,1,3,0,0,0,3,3,1,1,3,0,5
3339,785755,11,3,3,3,3,0,0,3,3,1,0,0,0,0,1,0,9
3339,781316,20,0,6,0,3,0,3,0,0,0,2,1,0,2,1,0,0
3339,796526,6,0,2,0,1,0,1,0,0,0,0,0,0,0,1,0,0
3339,796527,2,0,0,0,0,0,0,0,0,0,0,0,0,1,0,0,0
3339,791275,24,1,3,0,1,1,2,0,3,0,5,1,4,2,2,0,3
3339,785751,2,0,0,0,0,0,0,0,0,0,0,0,0,0,0,0,0
3340,780858,25,4,12,2,6,2,6,0,0,2,4,0,2,0,0,1,10
3340,785996,26,4,7,4,7,0,0,1,2,3,8,0,2,0,0,1,9
3340,780849,30,2,4,1,1,1,3,0,0,1,0,1,0,0,1,0,5
3340,780853,35,6,14,6,12,0,2,7,15,2,6,7,2,2,3,1,19
3340,797646,19,3,7,3,5,0,2,1,1,0,1,1,1,1,4,1,7
3340,785990,25,3,5,0,2,3,3,0,0,0,2,2,2,1,2,0,9
3340,792235,13,3,5,3,5,0,0,0,0,1,0,0,2,0,1,1,6
3340,786010,5,0,1,0,0,0,1,0,0,0,0,0,2,0,0,0,0
3340,792039,12,0,2,0,2,0,0,0,0,0,1,0,2,1,0,0,0
3340,785998,10,1,3,0,1,1,2,0,0,1,1,2,0,0,0,0,3
3341,780315,21,2,4,1,2,1,2,0,0,0,4,1,2,0,2,1,5
3341,785586,30,3,10,2,6,1,4,1,2,2,6,2,1,0,1,1,8
3341,791099,38,5,10,3,5,2,5,2,2,1,2,3,3,1,2,0,14
3341,785470,32,1,3,1,3,0,0,0,0,0,3,2,5,2,3,0,2
3341,780298,40,9,16,6,10,3,6,2,3,0,2,6,1,0,3,0,23
3341,790846,28,2,6,2,4,0,2,1,3,1,5,0,1,2,1,2,5
3341,796755,11,2,4,2,4,0,0,0,0,1,2,0,1,0,1,1,4
3342,797281,16,2,6,2,5,0,1,1,2,0,4,1,4,1,1,1,5
3342,791648,34,1,6,1,6,0,0,8,8,2,3,0,4,0,0,2,10
3342,786195,15,2,7,2,7,0,0,2,2,0,1,0,2,0,4,1,6
3342,791649,28,2,5,2,4,0,1,2,2,1,2,0,0,0,0,0,6
3342,797280,28,5,7,5,7,0,0,0,0,0,0,1,2,0,1,1,10
3342,791647,20,2,6,2,5,0,1,0,0,1,3,1,0,0,2,2,4
3342,785694,5,0,0,0,0,0,0,0,0,0,1,0,3,0,2,0,0
3342,797279,27,2,5,1,4,1,1,7,7,0,5,0,1,1,0,0,12
3342,786640,18,2,5,2,4,0,1,0,0,0,2,2,0,1,0,0,4
3342,785697,9,2,2,2,2,0,0,1,1,0,3,0,0,1,0,0,5
3343,786509,14,4,8,4,8,0,0,0,0,2,2,2,4,0,0,0,8
3343,786508,25,5,6,3,3,2,3,2,6,1,3,0,3,1,2,1,14
3343,786507,15,1,4,1,3,0,1,0,1,0,2,1,1,0,2,0,2
3343,785796,36,6,14,4,9,2,5,0,0,0,3,3,4,0,4,0,14
3343,797576,32,1,5,1,3,0,2,0,0,0,2,3,1,1,0,0,2
3343,797579,9,0,0,0,0,0,0,0,0,0,2,0,2,0,1,0,0
3343,797577,21,0,0,0,0,0,0,2,4,0,4,0,3,0,1,1,2
3343,797580,7,1,2,0,0,1,2,0,0,1,1,0,0,0,0,0,3
3343,791897,9,0,2,0,1,0,1,0,2,1,0,1,2,0,0,0,0
3343,786505,24,5,9,2,4,3,5,3,4,1,3,2,1,0,1,0,16
3343,781325,8,1,2,0,1,1,1,0,0,0,3,1,0,0,0,0,3
3344,797139,18,4,7,4,7,0,0,0,2,2,3,1,3,0,4,0,8
3344,775394,22,0,6,0,4,0,2,0,0,1,2,1,4,0,1,0,0
3344,791526,36,4,10,3,5,1,5,8,11,1,6,2,2,2,1,0,17
3344,780272,36,4,12,1,6,3,6,0,0,0,2,1,1,2,2,0,11
3344,775592,27,4,13,4,10,0,3,2,2,2,3,0,2,0,0,0,10
3344,791524,28,5,8,5,5,0,3,8,11,2,5,0,2,1,2,0,18
3344,785970,13,3,3,3,3,0,0,3,4,1,4,0,2,0,0,0,9
3344,780273,20,0,1,0,1,0,0,0,0,0,1,0,3,0,0,0,0
3344,797136,0,0,0,0,0,0,0,0,0,0,0,0,0,0,0,0,0
3345,775515,28,3,7,3,3,0,4,0,0,2,5,0,4,0,1,0,6
3345,791575,18,5,6,5,5,0,1,0,1,1,1,0,3,3,2,0,10
3345,791579,38,4,10,1,3,3,7,2,2,2,8,9,2,0,2,0,13
3345,786387,40,5,10,4,9,1,1,9,9,2,6,5,0,1,1,0,20
3345,780399,33,5,11,2,4,3,7,0,0,0,3,4,4,0,3,0,13
3345,797047,10,0,2,0,1,0,1,0,4,0,1,0,3,0,0,1,0
3345,786846,21,6,12,3,6,3,6,2,3,2,3,1,3,1,0,0,17
3345,780400,5,0,3,0,1,0,2,1,2,1,0,0,0,0,0,0,1
3345,797046,4,0,2,0,1,0,1,0,0,0,0,0,0,0,0,0,0
3345,791577,3,0,0,0,0,0,0,0,0,0,0,0,1,0,1,0,0
3346,775897,31,8,12,6,9,2,3,8,11,4,3,2,2,1,1,0,26
3346,780324,33,6,11,6,11,0,0,0,0,3,3,0,0,1,2,0,12
3346,784246,20,2,11,2,4,0,7,1,2,0,0,2,0,0,1,0,5
3346,786530,27,0,1,0,0,0,1,0,0,0,1,2,3,0,1,1,0
3346,780317,27,0,4,0,3,0,1,4,4,0,3,2,2,3,1,0,4
3346,791546,7,1,1,1,1,0,0,0,0,0,2,0,2,1,0,0,2
3346,791543,10,0,0,0,0,0,0,0,0,0,1,0,0,1,3,0,0
3346,791545,25,1,5,1,4,0,1,0,0,1,4,3,3,4,2,0,2
3346,786360,20,2,3,0,1,2,2,0,0,0,1,1,0,0,2,0,6
3347,791883,23,3,6,3,4,0,2,0,0,1,4,0,5,1,3,3,6
3347,781066,34,3,6,3,4,0,2,0,0,1,4,1,2,1,4,1,6
3347,797594,26,1,3,1,2,0,1,2,2,0,3,2,0,1,0,1,4
3347,791884,36,5,17,4,14,1,3,3,3,1,2,3,1,0,4,0,14
3347,780695,35,5,8,2,2,3,6,0,0,0,5,1,4,2,4,0,13
3347,797600,11,1,1,1,1,0,0,0,0,1,2,1,1,0,0,0,2
3347,797596,25,2,3,2,2,0,1,0,1,0,0,0,1,1,3,0,4
3347,786496,10,0,1,0,1,0,0,0,0,0,1,0,1,1,0,0,0
3348,781439,26,10,18,7,11,3,7,0,0,2,4,1,3,1,3,0,23
3348,781322,15,3,5,1,2,2,3,0,0,0,3,0,5,1,1,1,8
3348,786571,33,6,10,4,8,2,2,6,7,0,5,2,4,1,3,0,20
3348,791690,26,3,5,3,5,0,0,0,2,3,1,0,0,1,2,0,6
3348,785989,33,1,3,1,2,0,1,5,6,1,0,7,3,0,4,0,7
3348,781419,34,3,9,1,4,2,5,2,2,0,2,0,2,0,0,0,10
3348,797299,2,0,0,0,0,0,0,0,0,0,1,0,0,0,1,0,0
3348,780563,23,1,4,1,3,0,1,1,2,0,2,2,3,0,0,0,3
3348,781207,5,0,1,0,1,0,0,0,0,0,1,0,1,0,1,0,0
3348,784248,3,0,0,0,0,0,0,0,0,0,1,0,0,0,0,0,0
3349,785372,33,10,16,7,11,3,5,4,5,2,2,1,1,1,2,1,27
3349,774905,29,5,12,4,7,1,5,4,4,1,0,2,2,2,0,0,15
3349,796385,24,2,3,2,3,0,0,0,1,0,3,5,2,0,1,2,4
3349,785374,23,3,3,3,3,0,0,1,2,3,1,1,4,1,1,0,7
3349,786384,20,1,4,1,2,0,2,3,4,0,6,1,2,0,3,0,5
3349,785371,11,1,4,1,1,0,3,1,2,0,1,2,1,0,1,0,3
3349,790828,1,0,0,0,0,0,0,1,2,0,0,0,2,0,1,0,1
3349,785373,16,4,6,2,2,2,4,0,0,0,1,0,1,2,2,0,10
3349,790827,19,0,0,0,0,0,0,3,4,3,5,0,2,0,0,0,3
3349,790825,15,3,8,2,4,1,4,2,2,0,0,0,3,0,0,0,9
3349,796387,7,0,0,0,0,0,0,0,0,0,0,0,1,0,0,2,0
3349,785375,2,0,0,0,0,0,0,0,0,0,0,0,0,0,1,0,0
3350,790798,31,4,10,3,9,1,1,1,1,2,9,2,2,1,1,1,10
3350,780140,35,9,11,8,8,1,3,7,8,0,3,3,1,0,3,0,26
3350,780137,33,6,8,5,6,1,2,3,5,2,8,1,1,1,1,1,16
3350,790799,21,2,4,2,2,0,2,4,5,2,2,3,1,0,3,2,8
3350,796355,22,3,7,3,5,0,2,1,1,0,3,2,5,1,2,0,7
3350,785245,29,5,10,3,6,2,4,2,2,0,3,4,1,1,1,0,14
3350,790796,6,0,0,0,0,0,0,0,0,1,0,0,1,0,2,0,0
3350,796359,10,0,4,0,3,0,1,1,2,0,0,0,0,0,0,0,1
3350,796354,6,1,3,1,3,0,0,1,2,1,1,0,0,0,1,0,3
3350,790800,3,0,0,0,0,0,0,0,0,0,1,0,1,0,1,0,0
3350,790795,4,0,0,0,0,0,0,0,0,2,0,0,0,0,0,0,0
3351,786179,29,2,10,1,5,1,5,2,4,1,6,3,2,1,2,0,7
3351,791750,25,1,2,1,2,0,0,0,0,0,5,1,3,0,3,0,2
3351,786177,28,3,8,1,2,2,6,3,4,0,3,0,2,1,1,1,11
3351,780244,18,0,3,0,1,0,2,0,0,0,1,1,4,0,0,0,0
3351,780238,34,8,14,6,10,2,4,0,0,1,0,2,3,1,2,0,18
3351,790773,13,1,3,0,1,1,2,2,2,0,0,0,3,1,3,0,5
3351,791752,21,2,7,2,7,0,0,0,0,2,0,1,2,1,1,0,4
3351,781500,16,1,3,0,1,1,2,2,2,0,0,1,2,1,1,0,5
3351,785909,9,2,2,2,2,0,0,1,2,1,2,0,0,0,1,0,5
3351,791749,3,0,1,0,0,0,1,0,0,0,0,0,1,0,0,0,0
3351,797346,4,1,1,0,0,1,1,2,2,0,1,0,0,0,0,0,5
3352,791747,37,9,17,2,6,7,11,1,2,1,2,2,1,0,1,0,26
3352,791743,29,4,5,4,5,0,0,4,7,0,5,2,5,0,3,0,12
3352,797343,23,3,5,1,2,2,3,3,4,2,5,0,4,0,4,0,11
3352,791746,29,3,7,2,6,1,1,0,0,0,1,8,1,1,2,2,7
3352,786193,32,2,7,1,2,1,5,0,1,0,2,1,3,0,0,0,5
3352,797340,24,7,11,4,5,3,6,6,6,0,3,1,3,0,0,0,23
3352,780711,12,1,2,1,2,0,0,0,0,0,3,0,4,0,2,0,2
3352,797345,10,0,1,0,1,0,0,0,0,0,4,0,3,0,0,0,0
3352,797341,4,0,2,0,1,0,1,0,0,0,0,0,0,0,1,0,0
3353,775255,38,5,11,4,7,1,4,9,11,1,9,3,4,1,0,0,20
3353,781159,27,4,9,4,7,0,2,5,6,2,5,3,2,1,1,1,13
3353,791001,26,3,7,1,3,2,4,4,4,0,2,0,4,2,2,0,12
3353,781174,29,3,8,3,8,0,0,4,7,6,4,0,3,0,2,0,10
3353,779972,25,2,9,2,4,0,5,2,2,0,2,2,4,1,0,0,6
3353,781215,31,5,11,3,7,2,4,3,4,3,3,2,4,3,1,0,15
3353,785320,24,4,7,1,2,3,5,0,0,0,2,2,0,0,1,0,11
3353,796643,0,0,0,0,0,0,0,0,0,0,0,0,0,0,0,0,0
3354,780094,29,4,13,1,5,3,8,1,2,2,4,1,4,2,3,1,12
3354,775142,31,5,11,2,5,3,6,2,2,1,3,5,4,1,4,0,15
3354,790843,36,9,17,5,8,4,9,1,1,0,6,0,2,4,0,2,23
3354,786212,36,6,14,5,9,1,5,0,0,2,10,1,2,2,1,1,13
3354,781563,34,2,7,1,4,1,3,0,0,0,1,7,2,1,1,0,5
3354,790844,17,0,0,0,0,0,0,0,2,1,2,0,3,0,0,0,0
3354,792125,17,2,4,1,2,1,2,0,0,0,1,1,1,1,2,0,5
3355,792143,35,5,11,3,5,2,6,0,2,0,6,0,2,2,2,1,12
3355,797753,34,3,12,2,7,1,5,3,4,0,5,2,2,2,3,0,10
3355,786293,25,2,7,2,6,0,1,3,4,0,7,0,0,0,4,1,7
3355,780953,32,4,7,4,6,0,1,3,5,0,6,1,3,0,1,0,11
3355,786287,36,5,9,5,7,0,2,2,2,0,4,6,3,1,3,1,12
3355,797751,12,0,0,0,0,0,0,0,0,0,1,0,2,1,1,0,0
3355,797750,3,0,0,0,0,0,0,0,0,0,0,0,0,0,1,0,0
3355,797742,14,1,5,1,2,0,3,0,0,1,1,1,1,1,1,0,2
3355,786302,5,1,1,1,1,0,0,0,0,0,2,0,0,0,1,1,2
3355,797748,2,0,0,0,0,0,0,0,0,0,0,0,0,0,0,0,0
3355,792147,2,0,0,0,0,0,0,0,0,0,0,0,0,0,0,0,0
3362,797591,26,2,4,0,0,2,4,0,0,0,2,1,4,0,1,1,6
3362,781071,37,7,13,5,7,2,6,1,2,0,7,0,2,1,0,0,17
3362,780719,38,5,10,3,5,2,5,3,4,0,5,1,2,0,3,0,15
3362,797589,33,4,12,4,7,0,5,2,2,0,3,3,2,3,3,0,10
3362,791890,32,7,15,6,11,1,4,2,4,0,5,5,3,1,2,0,17
3362,797590,3,0,0,0,0,0,0,0,0,0,0,0,1,0,0,1,0
3362,791889,26,0,2,0,1,0,1,1,2,1,3,0,1,0,0,0,1
3362,791888,5,0,0,0,0,0,0,0,0,0,1,0,0,0,0,0,0
3363,785522,23,2,3,1,2,1,1,0,1,1,1,4,4,0,0,1,5
3363,791250,33,3,6,2,2,1,4,3,4,2,7,0,0,1,2,1,10
3363,791249,31,6,13,5,8,1,5,4,5,1,4,2,3,0,1,0,17
3363,785521,34,3,10,2,3,1,7,0,0,0,2,0,0,0,2,0,7
3363,775358,36,4,11,3,9,1,2,1,2,0,8,0,3,0,3,0,10
3363,785523,16,2,8,2,8,0,0,1,2,1,6,0,2,0,1,0,5
3363,781247,12,0,1,0,0,0,1,2,2,0,1,1,0,1,0,0,2
3363,796947,7,1,1,1,1,0,0,0,0,0,2,0,4,0,1,0,2
3363,796944,8,0,2,0,2,0,0,0,2,0,2,0,2,0,1,0,0
3364,786371,34,4,8,4,8,0,0,2,6,6,11,2,3,1,1,4,10
3364,786369,18,1,4,1,3,0,1,1,2,1,0,2,3,0,2,0,3
3364,797072,37,3,9,2,5,1,4,0,1,0,2,2,1,1,3,0,7
3364,791556,18,2,4,0,0,2,4,0,0,0,0,3,2,0,1,0,6
3364,791559,17,5,6,3,3,2,3,0,0,1,0,1,4,0,0,0,12
3364,791558,13,1,2,1,1,0,1,0,0,0,0,1,3,2,3,0,2
3364,791555,3,0,1,0,1,0,0,0,0,0,0,0,0,0,0,0,0
3364,786372,12,0,4,0,3,0,1,1,2,2,0,0,1,1,0,0,1
3364,797074,24,1,5,1,2,0,3,0,0,1,4,3,4,0,1,0,2
3364,791554,4,1,1,0,0,1,1,2,4,0,0,0,1,0,1,0,5
3364,786373,20,3,4,0,0,3,4,1,2,0,0,0,4,0,3,0,10
3365,785836,38,9,16,7,10,2,6,3,5,3,4,0,1,1,0,0,23
3365,785332,18,3,7,3,7,0,0,0,0,0,3,0,3,2,0,2,6
3365,791707,24,1,6,1,6,0,0,5,5,2,1,4,2,1,1,0,7
3365,791704,19,1,1,1,1,0,0,3,3,0,1,0,2,0,1,1,5
3365,785838,39,2,6,2,4,0,2,2,5,0,1,3,1,1,4,0,6
3365,791705,1,0,0,0,0,0,0,0,0,0,0,0,0,0,0,0,0
3365,775872,23,1,3,1,2,0,1,2,2,1,0,1,2,0,0,0,4
3365,797533,11,0,1,0,1,0,0,0,0,0,2,0,3,1,1,0,0
3365,785892,27,3,8,3,6,0,2,5,8,3,2,0,3,0,1,0,11
3366,781602,40,7,15,6,10,1,5,6,6,0,3,3,1,4,0,1,21
3366,791343,34,5,11,3,4,2,7,3,5,0,0,8,2,2,4,0,15
3366,781425,36,4,5,4,5,0,0,5,9,2,12,2,4,0,4,0,13
3366,775746,36,1,3,0,0,1,3,9,9,0,7,0,2,3,0,0,12
3366,797000,14,2,6,1,3,1,3,3,6,1,5,0,5,1,1,0,8
3366,797001,20,4,8,3,3,1,5,2,2,0,0,1,3,0,3,0,11
3366,791344,16,0,1,0,0,0,1,0,0,1,2,1,4,0,1,1,0
3366,781601,4,0,0,0,0,0,0,0,0,0,1,0,4,0,2,0,0
3367,781386,38,8,16,6,10,2,6,6,8,0,3,6,3,3,0,0,24
3367,786031,25,4,15,4,13,0,2,9,9,3,3,1,2,1,2,0,17
3367,797735,34,7,15,5,6,2,9,0,0,0,7,1,3,1,0,0,16
3367,786033,24,2,4,2,4,0,0,0,0,2,3,0,3,0,3,0,4
3367,797734,22,0,2,0,0,0,2,0,0,0,1,1,3,0,3,0,0
3367,792105,21,2,7,0,0,2,7,0,1,0,0,0,0,2,1,0,6
3367,792109,15,1,3,1,3,0,0,2,4,3,2,3,4,0,1,0,4
3367,797733,6,1,1,1,1,0,0,0,0,0,1,1,2,1,1,0,2
3367,792110,15,0,1,0,1,0,0,0,0,1,4,3,5,0,1,0,0
3368,791296,38,10,19,4,6,6,13,3,4,0,7,0,3,2,1,0,29
3368,791519,38,6,15,5,12,1,3,3,4,0,1,7,2,1,4,0,16
3368,775871,35,5,10,5,8,0,2,4,4,6,9,1,4,1,3,0,14
3368,791299,12,0,1,0,1,0,0,3,4,0,0,0,2,0,2,0,3
3368,796590,17,0,1,0,1,0,0,0,0,0,1,2,2,2,0,0,0
3368,796591,23,2,3,1,1,1,2,1,2,0,3,2,1,0,0,0,6
3368,792084,26,2,3,2,2,0,1,0,0,0,3,0,5,1,0,2,4
3368,786276,9,1,4,0,0,1,4,0,0,0,0,2,0,1,0,0,3
3368,796593,2,0,0,0,0,0,0,0,0,1,0,0,1,0,1,0,0
3369,775626,33,8,13,8,12,0,1,3,10,7,5,1,2,1,1,0,19
3369,791203,23,4,6,1,2,3,4,0,0,0,3,2,2,0,0,0,11
3369,785610,30,2,9,1,4,1,5,3,6,2,6,8,1,3,4,0,8
3369,785604,20,2,5,1,1,1,4,0,0,1,1,1,1,0,1,0,5
3369,774964,7,1,4,1,3,0,1,0,0,1,1,1,5,0,3,0,2
3369,774962,24,3,9,2,5,1,4,3,3,1,4,1,2,1,1,0,10
3369,785609,20,4,5,4,5,0,0,1,2,1,1,0,0,0,0,0,9
3369,796912,11,2,4,1,3,1,1,0,0,0,0,0,0,0,0,0,5
3369,796907,11,1,3,1,2,0,1,0,0,0,2,0,2,0,0,1,2
3369,796906,4,1,1,1,1,0,0,0,0,0,1,0,0,0,0,0,2
3369,785606,11,0,1,0,1,0,0,0,0,0,0,0,1,1,3,0,0
3369,775566,4,0,0,0,0,0,0,0,0,0,1,1,1,1,1,0,0
3369,796910,2,0,0,0,0,0,0,0,2,0,0,0,0,0,1,0,0
3370,780910,34,5,16,3,10,2,6,7,8,0,3,4,3,3,3,1,19
3370,786084,37,4,10,1,1,3,9,2,2,0,5,7,4,1,1,1,13
3370,780288,31,4,7,3,3,1,4,2,2,0,1,1,3,0,3,1,11
3370,791140,27,4,7,4,7,0,0,0,0,0,12,1,3,0,0,1,8
3370,791138,11,1,3,0,1,1,2,0,0,0,0,0,0,0,0,0,3
3370,796795,13,4,4,4,4,0,0,1,1,1,3,2,3,2,1,1,9
3370,780911,26,3,7,2,3,1,4,1,1,0,5,0,0,0,1,1,8
3370,796794,5,1,3,1,2,0,1,0,0,1,0,0,1,0,0,0,2
3370,781635,12,0,1,0,0,0,1,0,0,0,0,0,3,1,1,0,0
3370,780912,4,0,1,0,1,0,0,0,0,0,2,0,2,0,1,0,0
3371,780182,34,5,15,2,3,3,12,0,0,0,8,3,1,2,0,0,13
3371,798139,24,4,10,2,4,2,6,1,3,0,3,7,2,0,4,0,11
3371,786818,30,3,12,2,9,1,3,2,4,5,4,1,1,2,0,0,9
3371,780192,24,3,7,2,3,1,4,1,3,1,2,1,2,0,1,1,8
3371,796585,11,0,1,0,1,0,0,1,2,0,0,1,4,2,2,0,1
3371,780184,14,4,7,0,1,4,6,0,0,0,1,1,1,0,0,0,12
3371,786820,16,3,6,2,4,1,2,2,3,0,3,2,2,0,1,0,9
3371,780186,27,3,3,3,3,0,0,2,4,4,7,2,1,1,2,0,8
3371,798138,18,1,2,0,0,1,2,0,0,0,0,0,1,0,0,0,3
3371,796587,2,0,0,0,0,0,0,1,2,0,0,0,2,0,0,0,1
3372,791464,27,3,11,0,2,3,9,5,5,0,2,2,1,1,0,1,14
3372,786303,25,2,3,2,3,0,0,2,2,2,4,4,4,0,4,4,6
3372,786304,34,5,7,3,4,2,3,0,0,0,4,2,3,0,2,0,12
3372,780197,28,10,20,5,10,5,10,3,3,1,2,2,1,1,0,0,28
3372,780196,40,3,10,3,6,0,4,6,6,0,3,3,1,2,2,0,12
3372,798342,13,1,2,0,0,1,2,0,0,1,1,0,2,1,2,1,3
3372,780200,23,2,2,2,2,0,0,0,0,4,5,4,1,1,1,0,4
3372,798343,8,1,2,0,1,1,1,0,0,0,1,1,1,0,1,1,3
3372,798341,2,0,0,0,0,0,0,0,0,0,0,0,0,0,0,0,0
3372,798340,0,0,0,0,0,0,0,0,0,0,0,0,0,0,0,0,0
3372,786840,0,0,0,0,0,0,0,0,0,0,0,0,0,0,0,0,0
3372,786841,0,0,0,0,0,0,0,0,0,0,0,0,0,0,0,0,0
3373,786314,27,3,6,2,3,1,3,0,0,0,2,1,2,0,2,0,7
3373,786316,29,10,16,10,16,0,0,0,1,2,6,1,3,0,1,0,20
3373,791475,19,2,4,0,0,2,4,2,2,0,1,2,1,0,1,0,8
3373,791476,24,1,4,1,3,0,1,0,0,0,2,5,1,0,1,0,2
3373,780220,35,8,13,8,13,0,0,2,2,0,1,2,3,5,3,0,18
3373,797206,11,0,2,0,2,0,0,6,6,1,0,0,0,0,0,0,6
3373,797205,3,0,1,0,1,0,0,0,0,0,0,0,1,0,0,0,0
3373,791473,19,0,3,0,3,0,0,0,2,3,3,1,1,1,1,0,0
3373,797202,13,1,4,1,3,0,1,2,2,0,0,1,1,0,1,0,4
3373,791477,20,2,6,1,4,1,2,0,0,1,6,2,3,0,1,0,5
3373,797204,0,0,0,0,0,0,0,0,0,0,0,0,0,0,0,0,0
3373,791474,0,0,0,0,0,0,0,0,0,0,0,0,0,0,0,0,0
3374,798963,30,4,8,3,6,1,2,3,4,1,2,4,2,0,5,0,12
3374,798962,13,0,4,0,4,0,0,2,2,3,5,0,4,0,3,0,2
3374,791718,28,3,7,1,3,2,4,0,0,2,2,1,3,0,3,0,8
3374,798966,4,1,1,1,1,0,0,0,2,1,0,0,3,0,5,0,2
3374,791717,24,4,9,1,4,3,5,1,2,2,2,0,5,1,3,0,12
3374,781446,7,1,1,1,1,0,0,0,0,0,0,0,2,0,0,0,2
3374,791720,0,0,1,0,1,0,0,0,0,0,0,0,0,0,0,0,0
3374,798965,33,4,9,3,5,1,4,3,4,2,9,1,4,0,4,2,12
3374,768880,11,2,2,0,0,2,2,0,0,1,2,1,0,1,3,0,6
3374,798961,13,0,3,0,2,0,1,3,3,1,0,0,0,0,1,0,3
3374,798968,12,1,4,0,3,1,1,0,0,0,1,0,0,1,1,0,3
3374,791719,0,0,0,0,0,0,0,0,0,0,0,0,0,0,0,0,0
3374,787996,23,1,5,1,4,0,1,2,2,1,3,0,3,0,2,1,4
3374,798964,2,0,0,0,0,0,0,0,0,0,0,0,1,0,0,0,0
3374,798969,0,0,0,0,0,0,0,0,0,0,0,0,0,0,0,0,0
3375,780328,17,1,3,1,3,0,0,0,0,1,2,2,2,2,2,0,2
3375,775961,23,4,9,3,5,1,4,0,1,0,1,0,4,1,3,1,9
3375,781019,24,2,6,1,4,1,2,5,6,0,4,1,1,4,4,1,10
3375,787522,10,0,1,0,1,0,0,0,0,1,1,1,4,0,1,0,0
3375,787524,33,2,9,2,7,0,2,2,4,2,5,2,1,1,0,0,6
3375,797611,3,2,3,1,2,1,1,2,2,1,0,0,0,0,0,0,7
3375,791772,18,1,6,1,3,0,3,3,4,1,2,1,2,1,0,0,5
3375,775541,19,3,5,3,4,0,1,2,2,1,3,0,0,1,2,0,8
3375,783269,9,2,4,2,2,0,2,0,0,1,0,0,1,0,0,0,4
3375,791774,11,1,1,1,1,0,0,0,0,0,0,0,1,0,1,0,2
3375,791722,12,1,3,1,3,0,0,1,2,1,0,0,0,0,1,0,3
3375,780017,21,3,5,2,3,1,2,10,12,1,3,0,1,2,1,0,17
3376,781249,29,5,9,1,3,4,6,0,0,0,5,0,1,1,0,1,14
3376,775165,35,1,7,0,1,1,6,0,0,1,1,1,1,1,0,0,3
3376,785514,35,5,7,4,4,1,3,0,0,2,4,5,2,1,0,0,11
3376,785515,29,6,9,3,5,3,4,7,8,0,2,3,4,0,3,0,22
3376,781253,33,2,9,0,1,2,8,1,2,1,2,1,0,1,0,0,7
3376,796953,13,2,3,2,3,0,0,0,0,2,1,1,1,0,0,0,4
3376,791687,26,3,8,2,3,1,5,2,4,0,6,1,1,0,2,0,9
3377,781103,32,9,14,9,14,0,0,1,3,3,7,3,3,0,2,1,19
3377,797568,27,2,8,0,2,2,6,1,2,1,3,1,0,1,0,0,7
3377,797566,35,4,6,3,4,1,2,0,0,0,3,1,2,0,3,0,9
3377,781191,25,4,12,1,7,3,5,0,0,2,5,0,3,1,4,0,11
3377,781102,31,2,5,2,5,0,0,5,5,1,3,2,2,1,0,1,9
3377,791907,2,0,0,0,0,0,0,0,0,0,1,0,0,0,0,0,0
3377,791905,29,3,8,2,4,1,4,0,0,1,2,0,0,0,0,0,7
3377,791904,6,0,2,0,1,0,1,0,0,0,0,0,0,0,0,0,0
3377,781364,8,1,2,1,2,0,0,0,0,2,0,0,0,0,0,0,2
3377,791906,5,0,0,0,0,0,0,0,0,0,0,0,0,0,0,0,0
3378,797779,40,6,13,5,6,1,7,1,2,1,4,0,1,0,0,0,14
3378,797769,39,4,10,3,6,1,4,5,5,1,4,1,3,0,0,0,14
3378,786256,30,7,13,7,13,0,0,3,3,2,3,1,2,0,2,0,17
3378,797768,34,2,9,0,3,2,6,0,0,0,4,4,2,0,1,0,6
3378,775106,15,1,4,1,3,0,1,2,3,1,0,3,5,0,2,0,4
3378,797770,14,4,7,3,5,1,2,0,0,0,3,0,5,0,0,1,9
3378,797778,8,0,1,0,0,0,1,0,1,0,0,0,0,0,0,0,0
3378,797780,19,1,2,0,0,1,2,0,0,0,2,0,1,0,0,0,3
3378,797774,1,0,0,0,0,0,0,0,0,0,0,0,0,0,0,0,0
3379,781044,28,3,8,3,4,0,4,4,4,1,3,1,3,0,1,0,10
3379,786489,31,5,11,1,5,4,6,0,0,0,3,3,4,0,1,0,14
3379,786488,37,3,7,2,5,1,2,3,6,1,4,7,1,0,0,1,10
3379,781038,35,7,9,6,7,1,2,1,3,1,7,2,1,0,2,0,16
3379,797620,20,5,6,4,4,1,2,2,2,0,4,1,1,0,2,2,13
3379,786490,0,0,0,0,0,0,0,0,0,1,0,0,0,0,0,0,0
3379,797621,9,1,1,1,1,0,0,0,0,0,2,1,3,0,0,0,2
3379,797619,11,0,3,0,1,0,2,2,2,0,0,1,0,0,0,0,2
3379,791795,29,4,8,4,5,0,3,3,4,3,4,0,3,0,1,0,11
3380,780570,22,6,12,6,12,0,0,2,3,0,4,1,3,1,1,0,14
3380,780569,27,5,9,5,9,0,0,0,0,3,6,1,3,1,1,0,10
3380,797438,32,4,11,4,11,0,0,2,2,3,2,1,1,0,1,0,10
3380,791697,30,9,18,8,14,1,4,2,4,3,2,2,3,1,0,0,21
3380,780565,25,1,3,1,1,0,2,0,0,1,1,3,3,1,1,0,2
3380,797434,13,1,5,1,5,0,0,0,0,0,2,0,1,0,0,0,2
3380,797432,19,0,4,0,1,0,3,0,0,0,2,2,2,2,2,0,0
3380,791696,21,5,8,5,6,0,2,6,9,3,4,0,2,2,2,1,16
3380,791695,11,0,3,0,2,0,1,0,0,0,1,0,1,0,0,0,0
3381,786547,19,0,0,0,0,0,0,0,0,0,4,1,4,0,2,0,0
3381,786544,39,8,14,5,9,3,5,8,10,3,9,2,1,0,3,0,27
3381,797507,24,2,6,1,4,1,2,0,0,1,4,1,1,0,0,0,5
3381,792012,40,13,20,6,9,7,11,4,5,0,1,3,3,2,1,0,37
3381,775084,32,2,5,2,3,0,2,6,6,0,5,4,1,3,2,0,10
3381,786860,17,0,1,0,0,0,1,0,0,0,2,0,4,0,1,2,0
3381,797509,1,0,1,0,1,0,0,0,0,1,0,0,0,0,2,0,0
3381,786546,28,3,10,2,5,1,5,0,0,1,3,0,3,0,1,1,7
3382,776462,22,1,3,1,2,0,1,0,0,0,4,2,3,0,1,0,2
3382,785635,36,7,13,6,9,1,4,12,17,6,8,4,2,2,3,5,27
3382,786440,35,5,9,2,3,3,6,0,0,2,3,3,2,1,0,0,13
3382,786720,25,4,10,2,5,2,5,0,0,0,2,0,3,0,0,0,10
3382,775642,13,0,1,0,1,0,0,0,0,0,1,1,2,1,0,0,0
3382,796974,11,4,5,2,3,2,2,0,0,0,2,0,2,0,2,0,10
3382,791628,9,0,1,0,0,0,1,0,0,0,2,2,2,0,0,1,0
3382,781199,38,3,12,2,9,1,3,8,11,0,6,3,1,1,1,0,15
3382,791629,10,0,1,0,1,0,0,0,1,1,1,0,2,0,1,0,0
3382,791626,1,0,0,0,0,0,0,0,0,0,0,0,1,0,0,0,0
3382,796972,0,0,0,0,0,0,0,0,0,0,0,0,0,0,0,0,0
3382,780459,0,0,0,0,0,0,0,0,0,0,0,0,0,0,0,0,0
3383,790873,34,3,11,3,8,0,3,4,6,2,5,1,3,1,1,1,10
3383,780054,24,2,6,2,3,0,3,2,2,2,3,3,3,0,1,0,6
3383,781140,25,1,5,0,4,1,1,2,2,2,1,2,4,0,0,1,5
3383,776357,23,0,5,0,5,0,0,2,2,0,1,2,1,0,0,0,2
3383,796432,16,2,5,2,2,0,3,1,2,1,3,1,0,0,2,0,5
3383,785429,21,1,4,0,0,1,4,1,2,1,6,0,1,0,1,0,4
3383,796433,13,2,5,2,5,0,0,0,1,1,0,0,4,0,0,0,4
3383,776245,3,0,3,0,1,0,2,1,2,1,1,0,0,0,0,0,1
3383,786851,26,7,12,2,5,5,7,2,2,0,1,1,1,0,3,0,21
3383,780343,9,0,2,0,0,0,2,0,0,0,0,1,2,0,2,1,0
3383,781139,6,1,3,1,1,0,2,0,0,0,1,0,0,0,0,0,2
3384,791032,22,3,5,2,2,1,3,0,0,1,1,1,0,1,3,0,7
3384,796689,20,5,9,5,8,0,1,1,2,1,6,0,5,0,1,1,11
3384,791030,32,1,5,1,4,0,1,2,2,1,4,3,2,0,1,0,4
3384,785477,34,1,5,0,2,1,3,6,6,0,3,2,2,0,3,0,9
3384,785475,34,1,10,1,5,0,5,3,3,1,6,1,3,3,1,1,5
3384,791029,6,1,1,1,1,0,0,0,0,0,2,0,2,0,0,0,2
3384,791031,6,0,3,0,2,0,1,0,0,1,1,1,1,0,0,0,0
3384,780338,16,2,2,2,2,0,0,3,4,1,4,1,4,0,1,2,7
3384,796687,30,3,13,3,8,0,5,9,9,1,2,1,0,3,4,1,15
3385,792486,16,2,6,2,5,0,1,1,3,2,1,1,1,0,1,1,5
3385,785772,23,3,5,3,5,0,0,0,0,0,1,0,3,0,0,0,6
3385,785778,22,2,8,2,6,0,2,0,0,2,5,1,2,1,2,0,4
3385,785766,22,4,12,2,4,2,8,0,0,0,6,1,4,0,1,0,10
3385,780543,33,5,11,4,7,1,4,7,9,0,2,3,3,1,2,1,18
3385,792481,18,3,9,3,8,0,1,0,2,3,0,0,1,0,1,0,6
3385,792488,16,2,7,0,3,2,4,0,0,1,3,1,4,1,1,1,6
3385,797419,23,1,3,0,2,1,1,1,2,1,4,1,2,1,1,0,4
3385,792482,24,1,3,1,2,0,1,2,4,2,4,3,1,1,1,1,4
3385,780546,3,0,0,0,0,0,0,0,0,1,0,0,0,0,0,0,0
3386,797241,34,4,7,4,7,0,0,4,6,4,6,1,1,1,2,1,12
3386,791366,22,3,11,1,4,2,7,1,2,3,3,1,3,1,4,0,9
3386,797244,25,3,5,2,3,1,2,0,0,0,1,5,1,2,3,0,7
3386,786340,21,3,6,1,1,2,5,0,1,0,2,0,3,3,1,0,8
3386,780163,37,7,16,6,9,1,7,6,9,1,3,4,3,0,3,0,21
3386,791361,19,3,6,2,2,1,4,1,1,1,5,0,3,1,0,0,8
3386,786155,2,0,0,0,0,0,0,0,0,0,1,0,1,0,0,1,0
3386,780170,3,1,1,1,1,0,0,0,1,0,0,0,0,0,1,0,2
3386,797243,20,2,3,2,3,0,0,1,2,1,5,2,4,0,2,0,5
3386,791363,7,0,0,0,0,0,0,0,0,0,1,1,1,0,0,0,0
3386,785742,10,0,1,0,0,0,1,1,2,0,0,0,1,0,2,0,1
3387,788113,22,0,2,0,0,0,2,1,2,0,3,1,4,0,2,0,1
3387,785731,22,3,5,3,4,0,1,2,2,3,4,1,4,3,0,0,8
3387,785729,20,4,6,2,4,2,2,0,0,2,0,2,1,0,3,0,10
3387,780864,22,3,11,0,1,3,10,2,4,2,2,3,3,2,1,0,11
3387,799881,2,0,0,0,0,0,0,0,0,0,1,1,0,0,0,0,0
3387,792405,5,0,0,0,0,0,0,0,0,0,0,2,2,0,1,0,0
3387,792402,14,1,6,0,3,1,3,2,2,0,1,0,1,0,1,1,5
3387,796211,19,3,8,3,6,0,2,0,0,2,3,1,1,3,1,0,6
3387,786231,21,7,17,4,8,3,9,1,2,2,2,0,1,1,1,0,18
3387,785443,16,1,3,1,1,0,2,1,2,2,3,3,0,0,1,1,3
3387,776497,25,4,11,3,7,1,4,6,7,0,5,1,3,0,3,1,15
3387,797296,12,1,1,0,0,1,1,0,0,1,0,1,2,0,1,0,3
3388,796309,27,8,12,8,12,0,0,3,5,1,2,1,0,0,1,1,19
3388,775667,32,2,4,1,2,1,2,0,2,1,2,6,1,1,3,0,5
3388,780012,25,4,9,2,3,2,6,0,0,0,5,3,3,0,3,1,10
3388,790824,29,4,10,2,5,2,5,4,4,2,8,5,1,2,1,5,14
3388,780011,30,5,9,1,4,4,5,0,0,1,4,5,1,0,1,1,14
3388,781524,16,5,9,3,4,2,5,2,2,2,1,1,0,1,0,0,14
3388,785370,9,2,2,1,1,1,1,0,0,2,1,0,3,0,1,0,5
3388,796383,13,0,1,0,0,0,1,0,0,0,6,0,2,0,0,0,0
3388,796382,4,1,1,1,1,0,0,0,0,0,0,0,0,0,0,0,2
3388,796384,4,1,3,1,2,0,1,0,1,0,0,0,1,0,0,0,2
3388,785367,4,0,1,0,1,0,0,0,0,1,0,0,0,0,0,0,0
3388,783865,3,0,1,0,0,0,1,0,0,0,0,1,1,0,0,0,0
3388,780941,4,0,2,0,2,0,0,0,0,2,0,0,2,0,1,0,0
3389,791914,25,0,6,0,4,0,2,0,0,0,1,4,2,0,1,0,0
3389,786030,32,3,11,1,6,2,5,1,2,1,2,3,3,1,0,0,9
3389,786525,33,6,14,6,12,0,2,1,1,0,4,0,0,0,2,0,13
3389,786526,26,5,7,5,6,0,1,0,0,0,3,1,1,0,3,1,10
3389,791917,20,6,10,4,5,2,5,0,0,0,2,1,5,0,1,0,14
3389,786856,17,4,7,4,7,0,0,1,1,3,4,0,0,0,0,0,9
3389,797550,14,1,5,1,4,0,1,3,4,0,2,1,1,0,0,0,5
3389,781109,19,0,1,0,1,0,0,3,4,1,2,2,2,0,1,0,3
3389,786524,11,1,2,0,0,1,2,0,0,0,1,0,0,0,0,0,3
3389,797551,3,0,0,0,0,0,0,0,0,0,0,0,0,0,0,0,0
3396,786410,36,3,11,2,6,1,5,0,0,3,2,2,4,0,1,0,7
3396,775095,21,8,10,8,9,0,1,2,5,2,12,0,3,0,1,1,18
3396,791843,30,7,11,6,9,1,2,3,5,2,1,0,3,0,0,1,18
3396,786406,30,5,8,4,5,1,3,0,1,3,3,1,3,0,1,0,11
3396,780414,40,3,12,2,9,1,3,3,6,0,9,8,1,0,5,1,10
3396,797020,8,1,4,1,4,0,0,0,0,0,1,1,2,0,0,0,2
3396,792392,11,0,1,0,1,0,0,1,2,0,2,1,3,0,2,0,1
3396,797022,2,0,0,0,0,0,0,0,0,0,0,0,1,0,1,0,0
3396,797021,17,3,5,2,3,1,2,0,0,1,1,2,4,0,0,0,7
3396,791605,5,0,0,0,0,0,0,0,0,0,0,0,0,0,0,0,0
3397,785845,38,5,11,5,11,0,0,3,6,3,5,2,2,1,0,3,13
3397,780578,15,1,6,1,6,0,0,0,1,0,2,0,5,1,0,0,2
3397,797538,27,4,10,3,7,1,3,1,2,0,3,1,2,0,2,0,10
3397,785293,32,2,9,1,5,1,4,10,12,1,3,1,3,3,2,0,15
3397,780579,30,4,10,4,9,0,1,4,4,0,1,1,2,1,1,0,12
3397,791712,1,0,0,0,0,0,0,0,0,0,0,0,0,0,0,0,0
3397,791709,17,1,1,1,1,0,0,0,1,1,2,1,2,0,0,0,2
3397,785843,6,0,0,0,0,0,0,1,2,1,1,0,1,0,1,0,1
3397,797537,5,0,0,0,0,0,0,0,0,0,0,0,0,0,0,1,0
3397,797535,1,0,1,0,0,0,1,0,0,0,0,0,0,0,0,0,0
3397,785847,28,1,7,0,1,1,6,2,2,2,2,0,1,0,0,0,5
3398,780387,34,6,11,5,8,1,3,3,4,1,1,4,3,2,3,0,16
3398,767033,40,5,13,1,5,4,8,1,2,0,2,8,2,6,3,1,15
3398,792417,19,4,7,4,7,0,0,4,4,1,2,0,0,0,1,0,12
3398,786867,40,4,8,1,3,3,5,0,0,1,3,3,3,1,1,0,11
3398,786861,31,4,6,2,4,2,2,0,0,3,1,1,0,1,0,0,10
3398,792416,32,4,7,1,3,3,4,2,2,0,4,1,2,0,2,0,13
3398,786866,4,0,0,0,0,0,0,0,0,0,0,0,1,0,0,1,0
3399,790996,34,9,13,8,11,1,2,2,2,0,3,2,1,0,4,1,21
3399,785621,35,6,12,2,6,4,6,3,3,0,1,2,1,3,2,0,19
3399,790998,37,5,10,5,9,0,1,0,0,1,2,3,2,0,3,0,10
3399,790997,40,2,3,0,0,2,3,2,2,0,9,0,4,1,4,0,8
3399,796631,34,2,5,1,2,1,3,0,0,1,3,1,3,2,1,0,5
3399,790995,11,4,4,3,3,1,1,0,1,0,0,0,0,0,0,0,9
3399,796633,6,1,2,1,2,0,0,0,0,2,0,0,0,0,0,0,2
3399,790999,3,0,0,0,0,0,0,0,0,0,0,0,2,0,1,0,0
3400,781054,37,6,10,2,2,4,8,1,3,0,4,0,3,0,4,0,17
3400,774969,24,5,6,5,6,0,0,5,9,1,7,2,4,0,2,0,15
3400,791179,31,2,4,0,1,2,3,1,2,0,3,1,3,2,1,1,7
3400,796850,31,1,6,1,3,0,3,4,4,0,3,2,2,0,1,0,6
3400,791181,36,0,4,0,0,0,4,5,6,1,6,1,5,0,2,0,5
3400,796848,30,2,9,1,5,1,4,2,2,1,0,3,2,0,2,0,7
3400,780981,11,1,2,1,2,0,0,0,1,2,4,0,0,0,0,0,2
3401,776425,33,6,13,3,8,3,5,2,3,0,3,3,1,0,1,0,17
3401,785603,28,5,11,5,8,0,3,3,4,2,2,3,1,1,1,0,13
3401,775820,18,3,4,1,2,2,2,0,0,0,4,1,4,1,0,1,8
3401,791110,18,1,4,1,4,0,0,1,2,1,0,1,0,0,0,0,3
3401,775538,18,1,2,1,2,0,0,0,0,2,1,0,5,0,1,1,2
3401,786494,20,4,6,2,3,2,3,0,0,0,5,0,0,0,1,1,10
3401,791107,10,2,5,2,5,0,0,2,5,1,1,1,4,1,1,0,6
3401,796762,18,1,3,0,2,1,1,0,0,0,0,3,3,0,1,0,3
3401,796763,14,1,3,0,0,1,3,0,2,0,2,0,2,0,0,0,3
3401,791106,23,0,2,0,2,0,0,1,2,0,3,0,1,0,0,0,1
3402,786635,35,10,18,10,15,0,3,2,2,3,10,0,1,1,1,0,22
3402,791823,22,6,7,5,6,1,1,3,4,5,2,1,2,0,0,0,16
3402,781543,25,1,3,0,0,1,3,0,1,0,2,7,2,4,4,0,3
3402,780642,29,0,6,0,2,0,4,2,2,0,2,10,1,2,1,0,2
3402,776449,31,12,16,10,13,2,3,0,0,3,2,2,2,3,1,0,26
3402,797383,19,4,7,3,4,1,3,3,4,5,7,2,4,0,1,0,12
3402,797384,20,1,4,1,2,0,2,0,0,1,2,1,1,0,0,1,2
3402,781388,19,0,5,0,1,0,4,2,2,0,0,2,3,0,1,0,2
3404,791728,21,5,7,5,7,0,0,5,7,2,8,0,4,3,3,1,15
3404,791726,32,1,9,1,3,0,6,0,0,0,2,3,1,0,0,0,2
3404,786273,39,8,16,4,8,4,8,0,0,1,5,6,1,1,1,1,20
3404,780773,36,3,16,3,15,0,1,6,8,3,5,5,4,1,5,1,12
3404,775228,37,5,10,1,3,4,7,0,0,0,2,2,2,2,0,0,14
3404,797315,12,0,0,0,0,0,0,1,2,0,1,0,1,0,0,1,1
3404,786569,16,5,6,5,6,0,0,1,1,0,2,1,2,2,0,0,11
3404,780274,6,1,1,0,0,1,1,0,0,0,0,0,3,0,1,0,3
3404,786272,1,0,0,0,0,0,0,0,0,0,0,0,0,0,0,0,0
3405,785693,20,2,5,2,5,0,0,0,0,2,5,2,3,0,2,1,4
3405,780494,22,1,5,1,3,0,2,3,3,1,3,1,2,1,0,0,5
3405,785692,23,0,3,0,2,0,1,0,0,0,1,3,1,0,1,0,0
3405,780496,24,5,9,2,2,3,7,2,2,1,2,2,1,1,0,0,15
3405,780495,27,7,13,5,8,2,5,4,11,1,4,3,0,1,1,1,20
3405,797277,6,0,1,0,1,0,0,0,0,0,2,0,0,0,0,0,0
3405,797274,7,3,5,3,5,0,0,0,0,0,2,0,0,0,2,0,6
3405,797276,12,3,4,2,3,1,1,0,0,1,2,0,0,0,3,0,7
3405,791643,15,3,4,3,4,0,0,2,2,0,2,1,2,1,1,0,8
3405,785644,22,1,5,0,3,1,2,0,2,0,0,0,1,2,4,0,3
3405,780497,22,4,7,3,6,1,1,0,0,3,5,0,3,0,1,0,9
3406,792329,23,1,3,1,2,0,1,1,1,2,7,4,1,0,3,0,3
3406,786752,31,7,14,6,11,1,3,4,4,3,2,4,3,0,1,1,19
3406,781384,18,3,4,0,1,3,3,2,4,2,2,0,3,1,2,0,11
3406,781616,28,0,6,0,4,0,2,4,4,0,2,1,2,0,0,0,4
3406,776350,31,7,10,5,7,2,3,5,5,0,2,2,2,1,4,0,21
3406,797880,1,0,0,0,0,0,0,0,0,0,0,0,0,0,0,0,0
3406,792330,2,0,1,0,0,0,1,0,0,0,0,0,1,0,1,0,0
3406,785435,17,3,4,2,2,1,2,0,0,0,0,0,1,0,1,0,7
3406,781615,17,3,5,2,2,1,3,0,0,1,2,1,2,2,1,2,7
3406,792601,15,0,4,0,2,0,2,0,0,0,2,0,2,0,1,0,0
3406,786749,17,0,1,0,0,0,1,2,4,2,4,3,1,0,1,0,2
3407,781134,22,2,6,2,6,0,0,4,4,4,1,1,4,1,0,1,8
3407,774874,36,2,6,2,6,0,0,0,0,0,4,4,3,1,5,0,4
3407,785270,34,7,12,1,2,6,10,1,2,0,0,0,2,1,1,0,21
3407,776038,18,2,6,1,1,1,5,0,0,0,1,0,2,0,1,0,5
3407,780083,1,0,0,0,0,0,0,0,0,0,0,0,0,0,0,0,0
3407,796531,23,2,5,2,4,0,1,0,1,0,4,3,2,0,3,0,4
3407,790946,11,0,1,0,0,0,1,0,0,0,1,0,1,0,0,0,0
3407,786475,29,5,12,2,6,3,6,1,2,0,5,4,5,1,2,0,14
3407,786037,9,0,0,0,0,0,0,0,2,0,1,0,0,0,0,0,0
3407,775468,17,4,5,4,5,0,0,2,2,0,1,0,1,0,1,0,10
3408,790870,26,3,4,3,4,0,0,4,4,2,5,2,4,1,4,1,10
3408,790869,38,8,16,7,14,1,2,12,14,1,4,1,0,1,5,0,29
3408,780493,28,1,5,0,0,1,5,0,0,0,1,1,2,0,1,0,3
3408,780116,23,4,6,3,5,1,1,2,5,2,4,0,2,0,0,0,11
3408,790866,36,3,12,1,2,2,10,0,0,0,3,4,1,4,1,0,8
3408,796426,3,0,0,0,0,0,0,0,0,1,0,0,1,0,1,0,0
3408,780492,4,0,0,0,0,0,0,0,0,0,0,0,2,0,0,1,0
3408,796427,19,2,3,1,1,1,2,2,2,0,2,0,3,0,1,0,7
3408,796421,23,0,2,0,1,0,1,2,2,0,4,2,1,1,4,0,2
3409,791391,28,3,5,3,5,0,0,4,5,3,3,0,5,1,3,3,10
3409,797156,12,0,1,0,1,0,0,0,0,0,1,1,2,0,0,0,0
3409,791390,21,1,7,1,7,0,0,2,4,1,4,2,3,0,1,1,4
3409,780133,33,4,7,4,5,0,2,0,0,0,1,0,2,3,2,0,8
3409,780130,34,4,11,3,9,1,2,4,4,1,9,4,1,0,3,0,13
3409,797158,3,1,1,1,1,0,0,0,0,1,0,0,0,1,1,0,2
3409,791388,17,3,6,3,4,0,2,0,0,0,2,1,4,0,1,0,6
3409,791389,3,0,0,0,0,0,0,0,0,0,0,0,0,0,0,0,0
3409,775743,23,5,10,3,6,2,4,5,6,0,2,0,3,2,1,0,17
3409,776446,26,2,4,0,2,2,2,0,0,0,0,0,1,0,2,0,6
3410,791793,13,1,4,1,2,0,2,0,1,1,1,0,1,0,1,0,2
3410,786481,34,6,10,6,9,0,1,2,7,3,5,2,4,0,0,2,14
3410,797626,33,1,6,1,4,0,2,1,2,1,2,2,3,2,3,0,3
3410,797624,18,3,4,1,1,2,3,0,0,0,1,1,2,0,0,0,8
3410,785965,24,1,6,0,2,1,4,0,0,0,0,0,1,2,1,0,3
3410,797628,28,2,6,1,4,1,2,0,0,2,3,1,2,0,2,1,5
3410,791791,7,0,1,0,0,0,1,1,2,0,0,0,2,0,0,0,1
3410,791790,21,3,6,3,5,0,1,7,9,0,2,0,0,0,1,0,13
3410,781032,22,1,6,1,3,0,3,2,3,0,1,2,1,2,2,0,4
3411,792340,32,10,15,9,13,1,2,2,2,1,5,0,4,0,1,0,23
3411,792345,34,6,9,6,9,0,0,3,3,1,4,0,1,1,2,0,15
3411,792346,38,5,7,5,6,0,1,0,0,1,1,5,3,1,1,0,10
3411,781553,35,3,8,3,7,0,1,2,2,1,6,2,4,2,2,2,8
3411,781552,29,7,10,7,8,0,2,3,3,0,8,3,2,1,0,1,17
3411,792344,3,0,0,0,0,0,0,0,0,0,0,0,1,0,0,0,0
3411,792341,7,0,0,0,0,0,0,0,0,0,1,0,4,0,1,0,0
3411,792342,22,1,3,0,2,1,1,1,4,0,1,2,5,0,1,0,4
3412,781407,17,4,4,4,4,0,0,0,0,1,5,2,1,0,1,1,8
3412,791583,26,7,10,7,10,0,0,1,2,3,5,0,0,0,3,1,15
3412,785623,19,3,9,3,5,0,4,1,1,2,6,1,0,1,0,0,7
3412,780580,38,5,14,5,11,0,3,10,10,0,8,8,3,5,3,0,20
3412,776150,28,2,8,1,3,1,5,0,0,0,0,3,0,2,3,0,5
3412,797448,29,4,7,1,1,3,6,0,0,1,2,0,2,1,2,0,11
3412,786608,16,1,4,1,4,0,0,1,2,2,1,0,2,1,1,0,3
3412,797445,12,0,1,0,0,0,1,1,2,1,2,1,3,0,2,0,1
3412,786110,17,3,9,1,4,2,5,1,2,0,3,1,3,0,0,0,9
3412,786659,23,3,9,3,8,0,1,0,0,2,3,0,2,0,1,2,6
3413,797715,32,1,6,1,3,0,3,2,2,1,7,8,1,0,2,0,4
3413,780937,40,11,21,6,10,5,11,2,4,3,4,2,2,0,3,1,29
3413,791149,30,3,13,2,6,1,7,0,0,0,4,1,0,1,0,0,7
3413,791950,36,1,6,0,0,1,6,1,2,0,1,0,0,2,3,0,4
3413,792113,38,8,15,4,7,4,8,1,2,1,4,1,2,2,2,1,21
3413,797716,2,0,0,0,0,0,0,0,0,0,1,0,0,0,0,0,0
3413,797717,10,1,2,0,0,1,2,0,0,0,4,1,2,1,1,0,3
3413,792115,18,1,4,1,3,0,1,0,0,0,1,2,2,1,1,0,2
3413,780779,16,3,6,2,4,1,2,0,1,1,3,3,5,0,0,0,7
3413,780938,3,0,0,0,0,0,0,0,0,0,0,0,0,0,1,0,0
3414,792029,29,3,7,3,5,0,2,1,2,2,6,1,2,0,1,1,7
3414,761149,24,2,4,2,3,0,1,2,2,2,3,2,1,0,2,0,6
3414,792032,28,6,11,4,6,2,5,5,5,0,4,5,3,0,5,0,19
3414,792031,25,1,5,0,2,1,3,2,3,0,4,1,1,1,0,0,5
3414,780828,32,10,14,6,7,4,7,3,3,0,11,2,1,0,2,0,27
3414,797641,5,0,0,0,0,0,0,0,0,0,3,2,2,0,0,1,0
3414,797639,3,0,0,0,0,0,0,0,0,0,0,0,0,0,0,0,0
3414,797642,2,1,1,1,1,0,0,0,0,0,0,0,0,0,0,0,2
3414,797640,9,0,0,0,0,0,0,0,0,1,0,0,4,0,2,0,0
3414,797638,2,0,1,0,1,0,0,0,0,2,0,0,0,0,0,0,0
3414,797637,24,3,7,2,3,1,4,0,0,0,0,0,2,4,1,0,7
3414,792030,3,0,0,0,0,0,0,0,0,0,1,0,0,0,0,0,0
3414,792027,14,2,4,2,3,0,1,2,4,0,3,0,3,0,1,0,6
3415,796860,25,4,11,4,8,0,3,6,8,0,4,2,3,0,1,1,14
3415,791185,24,1,3,0,0,1,3,0,0,0,4,1,2,0,1,1,3
3415,775208,19,2,5,2,5,0,0,2,3,0,3,0,1,1,2,0,6
3415,785650,24,1,4,0,2,1,2,0,0,1,0,2,2,2,1,0,3
3415,785649,27,2,11,2,7,0,4,4,5,1,3,0,3,1,1,0,8
3415,796859,2,0,1,0,0,0,1,0,0,0,0,0,0,0,0,0,0
3415,791183,22,1,2,1,2,0,0,2,2,0,1,0,3,1,3,0,4
3415,796861,14,1,2,0,0,1,2,0,0,0,0,0,0,0,2,0,3
3415,796857,9,0,1,0,1,0,0,0,0,0,0,1,1,0,0,0,0
3415,796862,2,1,1,1,1,0,0,0,0,1,0,0,0,0,0,0,2
3415,796856,12,1,6,0,4,1,2,5,5,0,2,0,1,0,0,0,8
3415,793803,2,0,0,0,0,0,0,0,0,0,1,0,0,0,0,0,0
3415,791184,18,2,7,0,3,2,4,0,0,0,3,5,3,1,0,0,6
3416,781462,32,4,7,4,6,0,1,0,1,2,4,5,2,3,2,0,8
3416,780876,31,0,3,0,0,0,3,1,2,0,8,5,3,1,4,4,1
3416,785353,33,6,14,2,4,4,10,1,2,0,4,1,1,2,4,0,17
3416,781673,30,3,6,1,1,2,5,0,0,1,2,3,4,2,2,0,8
3416,781457,36,9,14,7,10,2,4,5,5,0,4,2,0,1,0,0,25
3416,785355,19,1,2,1,1,0,1,2,4,0,3,1,1,1,1,0,4
3416,790895,11,3,5,2,3,1,2,0,0,0,1,0,1,1,1,0,7
3416,791305,4,0,1,0,1,0,0,0,0,0,1,0,1,0,0,0,0
3416,796365,3,0,0,0,0,0,0,0,0,0,1,0,0,0,0,0,0
3416,790806,1,0,0,0,0,0,0,0,0,0,0,0,0,0,0,0,0
3417,790899,29,5,7,5,7,0,0,2,3,1,4,1,0,2,0,0,12
3417,785442,29,9,16,8,12,1,4,2,4,3,2,0,1,0,0,0,21
3417,790898,26,2,5,1,3,1,2,2,2,0,2,2,5,2,6,0,7
3417,785579,30,2,7,1,3,1,4,1,2,0,2,4,0,1,4,0,6
3417,775959,12,0,1,0,0,0,1,0,0,1,2,0,1,0,4,0,0
3417,790897,18,1,3,1,1,0,2,0,0,0,3,0,0,1,1,0,2
3417,799907,23,3,9,3,7,0,2,0,0,0,5,2,1,1,2,0,6
3417,775737,23,0,5,0,0,0,5,0,0,0,3,1,2,1,1,0,0
3417,785448,10,0,0,0,0,0,0,0,0,0,0,0,0,1,0,0,0
3418,785863,32,8,12,8,12,0,0,1,2,0,7,3,0,5,1,1,17
3418,785631,25,1,3,1,1,0,2,0,0,0,4,1,1,1,0,0,2
3418,786248,24,4,5,4,5,0,0,2,2,1,7,2,3,0,2,0,10
3418,785630,33,4,10,0,2,4,8,2,2,0,3,1,0,0,1,2,14
3418,780777,28,3,7,1,3,2,4,3,4,0,3,5,2,0,2,0,11
3418,791197,16,3,4,3,4,0,0,0,0,1,0,0,3,1,0,1,6
3418,791198,7,0,1,0,0,0,1,0,0,0,0,0,0,0,0,0,0
3418,791200,16,4,9,2,5,2,4,0,0,0,0,0,2,0,1,0,10
3418,785632,19,1,4,0,3,1,1,0,0,1,1,0,1,1,0,0,3
3419,792068,32,2,9,1,6,1,3,0,0,0,3,3,0,1,2,1,5
3419,784640,19,1,3,1,1,0,2,0,0,0,3,0,0,0,1,1,2
3419,792072,24,1,3,0,1,1,2,0,0,0,0,0,0,0,2,0,3
3419,792069,34,4,11,1,6,3,5,7,8,1,3,3,1,0,2,0,18
3419,785572,33,7,12,6,11,1,1,0,0,1,3,0,2,2,1,0,15
3419,786025,5,1,1,1,1,0,0,0,0,0,2,0,0,0,0,0,2
3419,797655,19,2,4,2,4,0,0,0,2,0,2,1,1,0,1,1,4
3419,797657,11,0,2,0,2,0,0,0,0,0,4,1,1,0,2,0,0
3419,797652,20,1,3,1,2,0,1,2,2,1,2,0,2,0,1,0,4
3419,797653,3,1,1,1,1,0,0,0,0,0,0,0,0,0,0,0,2
3420,786041,35,5,11,5,11,0,0,2,4,7,5,0,0,2,0,3,12
3420,786686,37,8,12,6,9,2,3,5,7,1,7,4,2,1,4,1,23
3420,792075,31,1,9,1,3,0,6,0,0,0,4,3,2,1,2,1,2
3420,780275,9,1,3,1,3,0,0,0,2,0,0,0,2,0,2,1,2
3420,780881,32,4,10,2,4,2,6,0,0,1,3,4,2,2,3,1,10
3420,785437,13,1,3,1,3,0,0,1,2,1,0,0,4,0,2,1,3
3420,780052,26,2,6,1,3,1,3,0,0,0,2,1,4,1,1,0,5
3420,792074,17,1,3,0,0,1,3,0,0,0,0,0,2,1,0,0,3
3421,791445,31,6,17,3,8,3,9,2,2,1,1,1,3,0,0,0,17
3421,775560,36,5,10,4,9,1,1,4,4,2,6,5,3,2,3,0,15
3421,776286,38,3,7,2,6,1,1,4,6,9,10,2,1,1,2,0,11
3421,785357,28,3,11,2,6,1,5,4,4,1,4,1,2,0,2,0,11
3421,775557,22,3,5,3,5,0,0,0,0,0,2,2,4,0,1,4,6
3421,785287,18,2,5,2,5,0,0,1,2,3,1,0,3,2,2,0,5
3421,797010,15,2,6,1,3,1,3,0,0,0,1,0,0,2,2,0,5
3421,797012,10,1,3,1,2,0,1,2,2,0,1,0,1,1,0,0,4
3421,791444,2,0,0,0,0,0,0,0,0,0,0,0,0,0,0,0,0
3430,781612,27,5,12,4,10,1,2,2,3,1,4,0,4,2,1,2,13
3430,786459,35,7,16,7,16,0,0,5,8,6,2,1,4,0,2,1,19
3430,797005,14,0,3,0,1,0,2,0,2,0,1,0,3,1,0,0,0
3430,797004,32,1,4,0,2,1,2,0,0,0,1,5,5,1,2,0,3
3430,781609,35,11,18,9,15,2,3,0,5,3,5,1,1,4,3,0,24
3430,797007,3,0,1,0,1,0,0,0,0,0,0,1,1,0,2,0,0
3430,797008,8,0,0,0,0,0,0,0,0,0,0,1,2,0,0,0,0
3430,797006,15,3,5,3,4,0,1,0,0,2,1,1,0,2,1,1,6
3430,791360,23,3,6,1,2,2,4,0,0,0,1,2,0,1,3,0,8
3430,797003,8,1,2,1,1,0,1,1,2,0,2,0,2,0,1,0,3
3431,780282,25,4,5,4,5,0,0,2,5,2,5,2,3,1,0,1,10
3431,785330,26,2,7,2,5,0,2,1,2,1,2,2,2,1,2,0,5
3431,780279,17,0,2,0,2,0,0,2,2,0,1,0,3,0,1,0,2
3431,791002,17,1,2,0,0,1,2,0,0,0,2,0,2,1,4,0,3
3431,785327,29,3,6,3,5,0,1,0,0,0,1,2,3,1,3,0,6
3431,785329,18,5,10,3,7,2,3,0,0,2,3,0,2,1,2,1,12
3431,791003,24,9,10,5,5,4,5,4,8,1,9,1,1,4,3,0,26
3431,796661,11,1,4,1,1,0,3,0,0,1,0,2,0,1,0,1,2
3431,785326,3,0,0,0,0,0,0,0,0,0,0,0,1,0,2,0,0
3431,780280,30,7,13,7,11,0,2,3,3,1,5,3,3,0,2,2,17
3432,791113,30,4,8,1,2,3,6,2,4,0,3,1,0,0,1,2,13
3432,780813,35,3,7,3,6,0,1,2,2,0,3,0,2,2,4,1,8
3432,791111,15,1,5,1,3,0,2,2,2,1,2,2,2,0,2,0,4
3432,785618,24,2,7,1,1,1,6,2,4,0,3,0,0,3,1,0,7
3432,780812,27,5,13,3,7,2,6,0,0,0,4,1,4,2,2,2,12
3432,796766,19,0,1,0,0,0,1,0,0,0,2,0,4,0,1,0,0
3432,796767,21,4,8,2,6,2,2,0,0,0,2,0,1,0,1,1,10
3432,796765,29,6,7,3,4,3,3,0,1,0,3,4,5,2,2,0,15
3433,785459,13,2,6,2,6,0,0,0,2,1,1,0,2,1,1,0,4
3433,789102,29,3,5,3,4,0,1,2,4,0,8,8,2,0,4,0,8
3433,789101,26,2,5,2,3,0,2,2,2,1,7,0,0,2,2,1,6
3433,781371,21,3,7,1,2,2,5,0,0,0,2,1,2,0,1,0,8
3433,781367,20,5,9,2,3,3,6,1,1,2,1,1,1,0,1,0,14
3433,797731,12,2,4,2,4,0,0,1,2,2,1,1,1,2,1,0,5
3433,792066,16,1,2,1,2,0,0,0,2,1,1,0,3,2,0,1,2
3433,797730,6,2,4,0,0,2,4,0,0,0,0,0,0,0,0,0,6
3433,792064,10,2,6,0,1,2,5,0,0,0,1,0,0,0,0,0,6
3433,792063,17,2,6,1,3,1,3,2,2,0,2,1,2,0,0,0,7
3433,792061,11,4,4,3,3,1,1,0,0,2,2,1,2,0,1,0,9
3433,788037,19,4,11,3,6,1,5,1,3,3,4,2,0,1,4,0,10
3434,791728,14,3,4,3,4,0,0,1,3,0,4,0,5,1,1,3,7
3434,791726,38,5,13,4,6,1,7,4,4,0,1,2,1,1,0,0,15
3434,786273,38,5,14,3,7,2,7,6,7,1,13,1,1,0,3,1,18
3434,780773,40,6,12,6,11,0,1,2,9,4,8,5,1,2,1,0,14
3434,775228,37,3,7,1,1,2,6,3,3,1,1,2,1,1,0,0,11
3434,797315,6,1,2,1,1,0,1,0,0,1,1,0,2,0,0,0,2
3434,786569,17,0,2,0,2,0,0,5,7,3,1,0,4,0,1,0,5
3434,780274,10,2,4,2,4,0,0,0,1,2,2,0,5,0,2,0,4
3434,786272,0,0,0,0,0,0,0,0,0,0,0,0,0,0,0,0,0
3435,785693,12,0,3,0,3,0,0,2,4,2,1,1,3,0,0,0,2
3435,780494,19,1,6,1,4,0,2,1,1,0,3,0,4,0,2,0,3
3435,785692,14,2,4,2,4,0,0,0,0,0,2,1,1,0,0,0,4
3435,780496,28,6,10,4,6,2,4,2,2,2,3,3,2,1,1,0,16
3435,780495,30,3,10,2,7,1,3,5,5,1,1,1,5,1,3,0,12
3435,797277,17,2,6,2,4,0,2,1,2,0,5,0,2,2,0,0,5
3435,797274,6,1,1,1,1,0,0,1,3,0,0,0,3,0,2,1,3
3435,797276,15,2,3,2,3,0,0,0,0,0,5,0,2,0,0,0,4
3435,797275,9,0,0,0,0,0,0,0,0,0,2,0,2,0,2,0,0
3435,791643,14,1,5,0,3,1,2,0,0,0,0,1,2,0,0,0,3
3435,785644,10,3,7,3,4,0,3,0,1,0,0,0,1,0,0,0,6
3435,780497,26,2,6,2,5,0,1,0,0,2,7,1,1,1,0,0,4
3436,785622,34,6,12,3,6,3,6,2,4,3,7,2,0,1,2,1,17
3436,781058,21,2,7,2,7,0,0,0,4,2,2,1,1,2,3,0,4
3436,780327,28,7,9,7,9,0,0,2,4,3,2,2,1,1,0,1,16
3436,797458,26,2,4,1,1,1,3,0,0,0,5,0,2,1,3,0,5
3436,797451,34,5,10,3,5,2,5,4,4,1,3,8,1,2,3,0,16
3436,791848,5,0,1,0,0,0,1,0,0,0,2,0,1,0,1,0,0
3436,797455,9,1,1,1,1,0,0,1,4,1,3,0,0,0,0,0,3
3436,797456,11,2,4,0,0,2,4,2,2,1,0,1,1,0,1,0,8
3436,797453,6,1,1,1,1,0,0,0,0,2,0,0,0,0,1,0,2
3436,797452,8,1,3,0,0,1,3,0,0,1,1,1,1,0,1,0,3
3436,786607,18,1,5,1,2,0,3,3,3,1,2,0,1,1,0,0,5
3437,780023,24,2,6,2,6,0,0,1,2,3,5,0,4,0,3,4,5
3437,792490,24,1,2,0,1,1,1,0,0,1,1,0,3,2,0,0,3
3437,792493,37,4,9,0,3,4,6,0,0,0,3,0,1,2,0,0,12
3437,792495,27,5,14,3,9,2,5,0,0,0,2,1,3,0,4,0,12
3437,792491,40,8,16,8,15,0,1,6,6,0,4,9,2,1,4,0,22
3437,798960,11,2,2,2,2,0,0,0,0,0,2,0,1,0,0,1,4
3437,788128,11,0,4,0,0,0,4,0,0,1,2,0,1,0,0,0,0
3437,781144,26,3,7,1,2,2,5,0,0,1,2,0,1,1,1,0,8
3438,797683,26,8,13,6,8,2,5,3,4,2,2,1,0,0,1,1,21
3438,797682,26,2,5,2,5,0,0,4,4,1,12,1,2,1,1,2,8
3438,797680,19,4,8,1,3,3,5,0,0,0,0,1,1,2,1,0,11
3438,797679,21,5,11,1,4,4,7,0,0,0,3,4,1,0,0,0,14
3438,791942,24,2,4,2,4,0,0,1,2,2,4,2,2,0,1,0,5
3438,780683,14,5,6,5,6,0,0,6,6,4,5,1,0,0,0,0,16
3438,797678,15,2,8,1,4,1,4,0,0,1,2,2,0,0,1,0,5
3438,791941,22,5,11,5,6,0,5,1,2,1,2,1,2,2,1,0,11
3438,780772,19,4,4,4,4,0,0,4,6,0,3,6,2,1,0,1,12
3438,780689,14,3,6,3,4,0,2,0,0,2,4,0,2,0,0,0,6
3440,791401,34,9,18,9,18,0,0,4,6,4,11,1,0,2,1,0,22
3440,780125,35,4,7,4,6,0,1,5,5,4,7,1,1,1,2,2,13
3440,797125,21,1,6,1,2,0,4,0,0,1,1,0,2,0,0,0,2
3440,791400,7,1,2,1,2,0,0,0,0,0,0,0,0,0,1,0,2
3440,780118,34,3,11,2,5,1,6,6,7,0,2,3,3,0,1,0,13
3440,785931,31,2,7,1,3,1,4,0,0,0,2,3,4,0,1,1,5
3440,786837,19,2,6,0,1,2,5,0,0,1,2,2,3,0,0,0,6
3440,797130,2,0,0,0,0,0,0,0,0,0,0,0,0,0,1,0,0
3440,797132,12,0,1,0,0,0,1,0,0,0,0,0,0,1,0,0,0
3440,797126,5,0,1,0,0,0,1,0,0,0,2,0,0,0,2,0,0
3441,791585,34,3,6,3,5,0,1,1,2,4,8,3,3,1,2,0,7
3441,780062,17,1,2,1,2,0,0,1,2,1,2,0,5,0,3,1,3
3441,791581,32,3,8,1,3,2,5,2,3,0,2,1,3,1,1,0,10
3441,786395,39,4,12,3,5,1,7,0,0,0,0,0,2,0,1,0,9
3441,786394,36,8,15,4,8,4,7,2,3,1,9,2,3,1,1,1,22
3441,785228,26,1,8,1,4,0,4,2,4,0,3,1,1,1,1,0,4
3441,799920,4,0,1,0,0,0,1,0,0,0,1,0,0,0,1,0,0
3441,780403,11,0,0,0,0,0,0,0,1,0,1,1,1,0,0,0,0
3441,791582,1,0,0,0,0,0,0,0,0,0,0,0,0,0,0,0,0
3442,791281,38,12,16,11,15,1,1,8,11,5,8,1,2,2,1,2,33
3442,792276,35,2,5,1,1,1,4,0,0,0,5,3,1,0,3,1,5
3442,791278,28,0,4,0,0,0,4,0,0,0,4,2,3,0,0,1,0
3442,785507,12,0,1,0,0,0,1,0,0,0,0,1,1,0,1,0,0
3442,775814,8,0,0,0,0,0,0,0,0,0,1,1,2,0,1,0,0
3442,785764,26,7,9,7,9,0,0,3,3,3,6,1,3,0,2,1,17
3442,796537,5,0,0,0,0,0,0,0,0,0,1,0,1,0,0,0,0
3442,796535,18,3,6,2,2,1,4,0,0,0,1,0,3,2,2,1,7
3442,786026,13,4,9,3,8,1,1,2,2,3,2,0,4,0,1,0,11
3442,785398,15,3,6,1,3,2,3,0,0,1,2,0,1,1,0,1,8
3442,796536,2,0,0,0,0,0,0,0,0,0,0,0,0,0,0,0,0
3443,797698,20,1,7,1,5,0,2,2,2,0,2,0,4,0,1,0,4
3443,780844,27,1,4,1,2,0,2,0,0,0,4,0,3,0,2,0,2
3443,797699,33,6,16,3,11,3,5,5,9,1,6,3,1,1,1,0,20
3443,791956,19,1,3,1,2,0,1,2,3,1,2,0,2,0,0,0,4
3443,780846,39,4,11,4,9,0,2,3,3,2,0,2,4,1,2,0,11
3443,797694,28,2,6,0,1,2,5,0,0,0,1,1,0,1,0,0,6
3443,797692,3,0,0,0,0,0,0,0,0,0,0,0,0,0,1,0,0
3443,791954,31,7,10,7,10,0,0,0,1,3,1,0,1,1,0,0,14
3444,786717,35,1,8,1,7,0,1,9,11,3,6,2,3,0,3,0,11
3444,780753,34,2,7,1,5,1,2,1,3,0,3,1,2,3,4,0,6
3444,792318,18,3,7,3,7,0,0,0,0,2,2,0,4,0,4,0,6
3444,796516,31,1,5,1,5,0,0,1,2,2,1,0,2,0,1,3,3
3444,775329,18,0,3,0,1,0,2,0,0,0,1,0,3,0,2,0,0
3444,796517,30,2,6,2,5,0,1,4,4,0,2,2,1,0,3,0,8
3444,796518,15,3,4,1,1,2,3,0,0,1,5,1,0,1,0,0,8
3444,796520,13,1,6,1,5,0,1,0,0,0,2,0,1,0,1,0,2
3444,792315,3,0,1,0,1,0,0,0,0,0,2,0,0,0,0,0,0
3444,792308,3,0,0,0,0,0,0,0,0,0,1,0,0,0,0,0,0
3445,780181,36,8,16,5,6,3,10,6,6,0,3,0,3,4,2,0,25
3445,776089,35,5,7,1,1,4,6,0,0,1,1,1,2,0,0,1,14
3445,791340,28,3,9,2,6,1,3,1,2,0,4,3,2,0,3,0,8
3445,789177,36,2,5,2,5,0,0,3,4,2,11,0,3,3,4,3,7
3445,791336,39,2,8,2,7,0,1,1,2,1,3,2,3,0,2,0,5
3445,797264,2,0,2,0,1,0,1,1,2,1,0,0,0,0,0,0,1
3445,789178,12,0,2,0,0,0,2,0,0,0,1,1,0,0,0,0,0
3445,797262,8,0,1,0,0,0,1,0,0,0,1,0,1,0,1,0,0
3445,797260,2,0,1,0,1,0,0,0,0,0,1,0,2,0,0,0,0
3445,792189,2,0,0,0,0,0,0,0,0,0,0,0,0,0,1,0,0
3446,797343,24,2,4,2,4,0,0,0,0,1,2,1,0,0,0,2,4
3446,791743,20,8,10,8,10,0,0,2,3,2,7,0,1,0,0,0,18
3446,791747,31,8,19,7,11,1,8,0,1,1,9,3,2,0,3,0,17
3446,791746,19,5,10,4,6,1,4,0,0,1,8,2,3,0,2,1,11
3446,786193,17,0,5,0,1,0,4,1,2,0,0,1,1,1,0,0,1
3446,797345,11,1,3,1,3,0,0,0,0,2,1,0,4,0,1,0,2
3446,797342,9,0,2,0,2,0,0,0,0,1,0,0,1,0,1,0,0
3446,791744,7,0,0,0,0,0,0,2,2,1,3,0,2,1,0,0,2
3446,797341,23,1,9,0,5,1,4,1,2,1,3,3,1,1,0,0,4
3446,797340,28,7,11,3,6,4,5,0,0,0,2,3,1,0,1,0,18
3446,780711,11,1,4,0,1,1,3,0,0,2,0,1,0,1,0,0,3
3454,797281,22,5,17,5,14,0,3,1,1,3,4,0,4,0,1,0,11
3454,791648,22,1,10,1,9,0,1,4,4,5,3,1,1,0,1,0,6
3454,786195,32,9,17,9,17,0,0,1,1,2,8,0,4,0,1,2,19
3454,791649,24,1,3,0,2,1,1,0,0,0,2,2,0,1,1,0,3
3454,797280,33,4,6,4,5,0,1,1,3,0,0,4,1,2,1,0,9
3454,791647,6,0,1,0,1,0,0,1,2,0,0,0,0,1,1,1,1
3454,797279,26,0,5,0,2,0,3,2,2,0,2,3,0,2,0,0,2
3454,786640,22,2,3,1,2,1,1,0,0,0,2,3,3,0,5,0,5
3454,785697,12,0,0,0,0,0,0,0,0,0,2,0,2,0,0,0,0
3454,785694,1,0,0,0,0,0,0,0,0,0,0,0,0,0,0,0,0
3455,786509,16,3,6,3,6,0,0,2,2,1,3,1,5,1,1,0,8
3455,786508,33,7,13,4,6,3,7,0,0,1,10,2,2,2,7,3,17
3455,786507,20,1,1,1,1,0,0,1,2,0,1,1,0,0,0,0,3
3455,785796,29,2,9,2,7,0,2,0,0,0,3,1,1,0,1,1,4
3455,797576,35,3,7,2,5,1,2,3,4,1,1,3,0,2,0,0,10
3455,797579,5,0,0,0,0,0,0,0,0,1,1,0,0,0,1,0,0
3455,797577,22,4,6,4,6,0,0,0,0,1,5,0,4,1,1,0,8
3455,797580,2,0,1,0,1,0,0,0,0,1,0,0,1,0,0,0,0
3455,791897,13,0,2,0,1,0,1,0,0,0,3,0,0,0,1,0,0
3455,786505,20,1,3,1,1,0,2,2,2,0,1,1,1,0,2,0,4
3455,781325,5,0,2,0,1,0,1,0,0,0,1,0,0,0,0,0,0
3456,796406,9,1,3,1,3,0,0,0,0,2,1,0,1,0,1,0,2
3456,796404,27,4,9,4,9,0,0,0,0,6,4,2,3,1,0,5,8
3456,785434,28,1,9,0,2,1,7,0,0,0,3,3,4,0,2,0,3
3456,781164,19,2,8,1,4,1,4,1,2,1,3,2,3,1,0,0,6
3456,781163,38,3,12,3,6,0,6,4,4,1,1,7,3,1,3,1,10
3456,790854,15,1,2,1,2,0,0,1,2,0,2,0,3,1,0,1,3
3456,790849,29,6,11,2,5,4,6,1,2,0,3,1,2,1,1,0,17
3456,790850,28,5,11,0,1,5,10,7,7,0,1,0,1,0,0,0,22
3456,790848,7,0,1,0,0,0,1,0,0,0,0,0,4,0,0,0,0
3457,792143,34,1,3,0,1,1,2,0,1,0,1,1,4,0,0,0,3
3457,797753,25,2,7,0,2,2,5,0,0,0,4,3,4,0,2,0,6
3457,786293,28,6,11,6,9,0,2,7,9,2,7,0,3,2,2,0,19
3457,780953,35,11,16,11,14,0,2,9,12,3,7,4,2,0,2,1,31
3457,786287,4,1,1,1,1,0,0,1,1,0,0,0,0,1,1,0,3
3457,797750,30,4,7,4,6,0,1,4,5,2,5,8,2,0,0,1,12
3457,786302,5,0,2,0,2,0,0,0,0,1,1,0,0,0,0,0,0
3457,797751,16,1,4,1,3,0,1,0,0,0,1,0,0,0,1,0,2
3457,797742,14,2,2,2,2,0,0,0,0,0,2,0,1,0,1,0,4
3457,792147,9,0,1,0,1,0,0,1,2,1,1,0,0,0,1,0,1
3458,785786,26,2,6,2,5,0,1,0,0,1,4,1,0,0,0,4,4
3458,796576,25,4,8,3,3,1,5,3,3,0,4,3,2,1,4,0,12
3458,796571,35,7,10,5,6,2,4,2,2,0,6,1,3,0,2,0,18
3458,791290,32,6,11,2,2,4,9,0,0,1,4,1,3,0,1,1,16
3458,781346,32,3,8,2,3,1,5,0,0,0,1,3,2,1,2,0,7
3458,791289,13,1,2,1,2,0,0,0,0,0,4,1,3,0,2,1,2
3458,796574,15,0,3,0,0,0,3,0,0,0,2,1,1,0,1,0,0
3458,791288,13,0,1,0,1,0,0,0,0,0,1,1,0,0,0,0,0
3458,796572,9,1,3,1,3,0,0,0,0,0,1,0,2,0,0,0,2
3459,791062,36,4,8,4,7,0,1,0,0,0,3,2,2,3,3,1,8
3459,791060,32,3,10,2,7,1,3,0,0,1,4,6,1,1,1,0,7
3459,791064,26,5,11,0,3,5,8,0,0,1,3,1,2,1,0,0,15
3459,780743,33,2,9,2,5,0,4,6,6,1,5,4,1,0,1,0,10
3459,780055,30,4,6,2,2,2,4,0,1,0,4,2,0,0,0,0,10
3459,785548,13,3,4,2,3,1,1,2,2,0,2,0,1,0,1,0,9
3459,796737,3,0,1,0,1,0,0,0,0,0,0,0,0,0,0,0,0
3459,785542,27,5,6,4,5,1,1,0,1,0,3,1,2,0,1,0,11
3460,785948,26,3,3,3,3,0,0,1,2,4,2,2,1,0,3,1,7
3460,792020,38,7,11,4,4,3,7,2,5,0,3,5,2,1,1,0,19
3460,785941,21,1,7,0,4,1,3,1,2,1,2,0,2,0,2,2,4
3460,785939,31,5,12,2,5,3,7,1,2,0,4,5,3,2,1,2,14
3460,785938,31,5,9,0,2,5,7,2,4,1,3,3,3,0,0,0,17
3460,792025,12,5,7,5,7,0,0,0,0,0,4,0,2,0,2,1,10
3460,792023,19,0,4,0,1,0,3,0,0,1,1,2,1,0,0,0,0
3460,785946,22,0,2,0,0,0,2,0,0,1,5,1,2,0,0,0,0
3461,797174,29,2,4,1,3,1,1,0,0,0,3,1,2,0,2,0,5
3461,791510,24,1,5,1,2,0,3,0,1,0,0,1,0,1,0,0,2
3461,786699,24,4,4,4,4,0,0,0,0,1,4,0,4,0,0,0,8
3461,785593,30,4,12,2,7,2,5,1,2,2,5,2,1,1,1,0,11
3461,775357,32,3,11,1,5,2,6,2,2,0,2,2,1,1,3,0,10
3461,791509,16,5,6,5,6,0,0,0,1,2,1,1,4,0,0,1,10
3461,797168,22,4,6,4,5,0,1,3,4,0,6,6,1,0,1,0,11
3461,791504,21,4,6,4,6,0,0,4,4,0,2,0,1,2,1,0,12
3461,791505,2,0,0,0,0,0,0,0,0,0,1,0,0,0,0,0,0
3462,785863,25,5,9,5,9,0,0,2,2,3,4,1,1,0,2,0,12
3462,785631,21,3,4,2,3,1,1,0,1,0,0,0,0,1,2,1,7
3462,786248,21,3,7,3,7,0,0,0,0,4,3,1,2,0,3,0,6
3462,785630,23,2,4,0,1,2,3,0,0,0,2,1,2,1,0,0,6
3462,780777,17,3,7,2,6,1,1,1,1,0,1,3,3,0,1,0,8
3462,796899,4,1,1,1,1,0,0,0,0,0,0,1,0,0,0,1,2
3462,791199,9,2,2,2,2,0,0,0,0,1,1,0,1,2,1,0,4
3462,791197,8,0,1,0,1,0,0,2,2,1,2,0,3,0,2,2,2
3462,796900,1,0,0,0,0,0,0,0,0,0,0,0,0,0,1,0,0
3462,796898,5,0,1,0,0,0,1,0,0,0,1,0,1,1,1,0,0
3462,791198,15,0,1,0,0,0,1,0,0,0,1,1,0,1,1,0,0
3462,791196,6,3,3,0,0,3,3,0,0,0,0,1,0,0,0,0,9
3462,791200,19,6,10,4,5,2,5,2,2,0,4,2,1,0,2,0,16
3462,785632,22,6,7,6,7,0,0,2,2,3,6,2,0,2,1,1,14
3462,781129,2,0,0,0,0,0,0,0,0,0,0,0,0,0,0,0,0
3462,791195,2,0,0,0,0,0,0,0,0,0,0,0,0,0,0,0,0
3463,792068,29,6,11,5,6,1,5,0,0,1,1,0,2,0,2,0,13
3463,784640,18,1,6,0,2,1,4,0,0,1,2,0,1,2,1,0,3
3463,792072,26,1,3,1,1,0,2,0,0,0,0,1,1,2,2,0,2
3463,792069,32,2,9,0,4,2,5,4,6,0,1,5,0,2,3,0,10
3463,785572,23,3,6,2,3,1,3,3,5,0,3,0,3,0,3,0,10
3463,786025,11,1,1,1,1,0,0,0,0,1,0,1,1,0,1,0,2
3463,797655,16,1,3,1,3,0,0,1,2,2,1,1,3,0,0,0,3
3463,797654,1,0,0,0,0,0,0,0,0,0,0,0,0,0,0,0,0
3463,797657,11,2,5,1,2,1,3,0,0,1,0,1,0,0,0,0,5
3463,797652,24,2,6,1,3,1,3,2,2,0,2,1,0,2,1,0,7
3463,797653,9,0,2,0,2,0,0,0,0,1,0,0,1,0,1,0,0
3464,780833,19,7,8,7,8,0,0,7,8,2,6,1,0,1,1,2,21
3464,792034,28,4,7,2,2,2,5,2,3,2,12,3,1,0,1,0,12
3464,791688,33,4,9,3,5,1,4,0,0,2,6,2,1,2,3,0,9
3464,785381,20,7,12,5,6,2,6,0,0,1,2,1,0,1,1,0,16
3464,780830,30,4,8,4,7,0,1,0,0,1,2,4,2,0,1,0,8
3464,797645,19,6,9,6,9,0,0,4,5,2,4,0,3,0,2,0,16
3464,785982,10,1,1,1,1,0,0,0,2,1,0,1,3,0,0,0,2
3464,797644,14,3,5,3,5,0,0,0,0,0,1,2,0,1,0,0,6
3464,785980,27,1,4,1,2,0,2,1,2,0,2,0,1,1,0,0,3
3466,791161,21,1,5,0,0,1,5,1,2,0,3,0,3,0,4,0,4
3466,780629,36,5,16,5,11,0,5,0,4,1,3,1,1,2,3,0,10
3466,785346,38,5,7,0,0,5,7,0,0,2,3,1,1,0,1,0,15
3466,774845,39,8,17,6,9,2,8,14,15,0,5,6,3,0,2,0,32
3466,775888,35,4,9,3,7,1,2,5,8,3,5,1,3,4,2,4,14
3466,796816,28,1,3,1,1,0,2,9,13,1,7,2,4,5,3,0,11
3466,796815,3,0,0,0,0,0,0,0,0,0,0,0,0,0,0,0,0
3467,781005,20,2,11,1,6,1,5,1,2,1,3,0,5,1,2,0,6
3467,790494,29,8,10,6,6,2,4,1,2,2,4,0,1,0,2,0,19
3467,788866,18,1,3,1,3,0,0,1,1,1,6,2,5,0,2,0,3
3467,782162,26,6,12,3,6,3,6,0,0,4,6,3,4,1,2,0,15
3467,796851,38,3,10,1,3,2,7,5,6,0,2,4,1,2,3,0,13
3467,781659,15,2,5,2,4,0,1,0,0,1,3,1,2,1,1,0,4
3467,796853,14,1,3,1,3,0,0,0,0,1,4,0,4,0,4,1,2
3467,796854,22,3,7,3,7,0,0,0,0,0,3,3,3,1,3,0,6
3467,792683,8,2,6,1,3,1,3,0,0,0,0,0,1,1,0,0,5
3467,780610,10,2,3,1,1,1,2,0,0,0,2,0,4,0,0,0,5
3468,790884,15,2,2,2,2,0,0,0,0,1,3,0,5,0,0,0,4
3468,791635,34,4,12,3,7,1,5,2,3,2,3,3,2,0,1,1,11
3468,790883,22,0,4,0,2,0,2,4,6,1,3,2,4,1,1,1,4
3468,796436,32,10,16,7,8,3,8,2,2,3,6,3,5,2,5,1,25
3468,785436,38,9,14,9,14,0,0,4,7,3,4,4,3,1,4,0,22
3468,790885,15,2,6,2,3,0,3,0,1,4,1,4,3,1,0,0,4
3468,796438,30,3,9,1,3,2,6,4,6,0,2,0,0,1,0,0,12
3468,781262,5,0,1,0,0,0,1,0,0,0,0,0,0,0,0,0,0
3468,796442,8,1,1,1,1,0,0,0,0,0,2,0,1,0,0,0,2
3468,796437,1,0,1,0,1,0,0,0,0,0,0,0,0,0,0,0,0
3469,791980,12,1,5,0,3,1,2,2,2,2,1,0,4,0,0,0,5
3469,785972,24,3,9,3,7,0,2,0,0,1,0,1,2,2,1,1,6
3469,785967,36,10,19,10,19,0,0,2,6,7,12,0,1,0,2,2,22
3469,791977,24,1,3,0,0,1,3,1,2,0,4,2,1,0,1,0,4
3469,791978,30,6,14,3,9,3,5,6,6,2,2,5,2,1,3,0,21
3469,791976,28,6,16,3,7,3,9,5,7,2,2,1,0,1,0,0,20
3469,780160,13,0,0,0,0,0,0,0,0,0,1,0,4,1,2,0,0
3469,785973,8,0,1,0,0,0,1,0,0,0,0,2,1,0,1,0,0
3469,797800,25,2,3,1,1,1,2,4,6,2,1,5,4,0,1,1,9
3470,780676,33,4,5,2,2,2,3,2,3,0,5,2,4,1,2,0,12
3470,786157,24,5,6,5,6,0,0,1,4,3,5,0,4,0,2,3,11
3470,775533,16,1,2,0,1,1,1,1,2,2,1,1,3,1,2,1,4
3470,786150,6,1,2,1,2,0,0,0,0,0,0,0,3,1,2,0,2
3470,780673,20,0,6,0,1,0,5,0,0,0,0,2,2,1,1,0,0
3470,780677,29,9,12,1,1,8,11,2,2,0,9,3,4,2,2,0,28
3470,780992,30,5,9,2,3,3,6,0,0,0,1,4,1,1,4,0,13
3470,797348,13,2,5,2,4,0,1,0,0,0,1,1,4,1,1,0,4
3470,791756,29,2,5,2,5,0,0,0,0,1,2,5,0,0,1,0,4
3471,791144,22,4,7,4,6,0,1,1,2,0,2,0,2,0,2,0,9
3471,791147,8,0,0,0,0,0,0,0,1,0,1,1,0,1,0,0,0
3471,785782,26,1,8,1,2,0,6,3,3,0,0,0,3,0,0,0,5
3471,796804,19,1,4,0,2,1,2,0,0,1,1,1,3,1,2,0,3
3471,786748,21,2,4,0,0,2,4,1,1,0,0,2,1,1,2,0,7
3471,791146,40,4,10,3,7,1,3,2,2,0,9,10,1,3,4,0,11
3471,791148,26,4,7,1,3,3,4,4,4,1,1,0,2,0,2,0,15
3471,791145,38,4,7,4,7,0,0,7,12,3,2,1,4,1,3,1,15
3482,780993,23,2,8,2,8,0,0,2,4,7,4,3,2,0,0,2,6
3482,775248,35,12,23,6,10,6,13,4,4,6,10,2,2,0,2,4,34
3482,797225,26,1,5,1,4,0,1,1,2,0,3,5,3,1,2,2,3
3482,791452,36,3,7,0,2,3,5,0,0,0,1,5,1,0,3,0,9
3482,797224,38,7,16,3,6,4,10,0,0,2,3,2,1,0,1,0,18
3482,797230,14,1,2,1,2,0,0,0,0,0,2,0,2,0,3,0,2
3482,791446,2,0,0,0,0,0,0,0,0,0,0,0,1,0,0,0,0
3482,781558,16,2,5,2,4,0,1,4,4,4,2,0,1,1,2,0,8
3482,791449,10,1,2,1,1,0,1,0,0,1,0,0,1,1,1,0,2
3483,797972,19,2,5,2,5,0,0,3,3,1,1,0,0,0,0,0,7
3483,797967,33,4,10,4,7,0,3,2,4,1,2,3,2,0,1,0,10
3483,797970,33,5,15,4,10,1,5,2,5,0,6,4,1,0,2,0,13
3483,781453,35,7,17,3,8,4,9,4,4,1,2,5,2,3,1,0,22
3483,774869,36,9,11,1,1,8,10,0,0,1,2,0,2,2,0,1,26
3483,792254,23,2,5,2,4,0,1,0,0,1,3,2,1,2,1,0,4
3483,786098,16,1,1,1,1,0,0,0,0,1,0,1,3,0,1,0,2
3483,797962,5,0,0,0,0,0,0,0,0,0,0,0,0,0,0,0,0
3484,791113,33,2,5,2,4,0,1,0,0,2,4,1,2,0,1,0,4
3484,780813,34,7,13,7,12,0,1,2,2,3,4,1,4,2,1,1,16
3484,791111,12,0,0,0,0,0,0,3,3,0,0,0,0,0,1,0,3
3484,785618,30,0,4,0,1,0,3,1,2,0,1,1,4,0,3,0,1
3484,780812,33,12,20,7,11,5,9,4,4,0,7,3,5,4,5,0,33
3484,796766,22,2,6,0,1,2,5,0,0,1,2,0,4,1,1,2,6
3484,796765,36,5,11,2,5,3,6,0,2,1,4,4,1,2,5,0,13
3485,785459,9,2,5,2,5,0,0,1,1,0,1,0,2,0,1,1,5
3485,789102,34,3,11,2,8,1,3,4,4,1,4,7,1,1,5,1,11
3485,789101,27,2,5,1,3,1,2,0,0,1,2,3,4,1,1,1,5
3485,781371,17,1,3,0,0,1,3,0,0,0,0,2,0,0,2,0,3
3485,781367,27,6,14,3,6,3,8,2,3,1,1,1,1,0,1,0,17
3485,797731,21,6,8,6,8,0,0,0,1,4,4,0,0,0,0,1,12
3485,792066,17,0,1,0,1,0,0,3,4,3,2,1,4,0,1,0,3
3485,797730,4,2,2,1,1,1,1,0,0,0,1,0,1,0,0,0,5
3485,792064,10,2,6,0,0,2,6,0,0,0,0,0,0,0,0,0,6
3485,792063,14,1,4,1,2,0,2,2,2,2,2,1,1,3,2,0,4
3485,792061,13,1,5,1,2,0,3,1,2,1,0,1,1,2,0,2,3
3485,788037,7,2,6,2,4,0,2,0,0,2,3,0,1,0,2,0,4
3486,797241,21,7,7,7,7,0,0,3,5,0,3,0,3,1,0,0,17
3486,791361,16,0,4,0,1,0,3,0,0,0,0,0,2,0,0,0,0
3486,797244,33,1,3,1,3,0,0,2,2,0,1,1,3,1,4,0,4
3486,797243,19,2,3,1,2,1,1,2,4,1,6,2,2,0,0,0,7
3486,780163,35,6,10,5,6,1,4,6,8,0,5,5,2,3,2,0,19
3486,791366,19,3,5,2,4,1,1,5,7,2,0,3,3,0,0,0,12
3486,786155,2,0,1,0,1,0,0,2,2,0,0,0,0,0,0,0,2
3486,780170,17,3,7,3,6,0,1,0,1,1,2,1,3,2,0,0,6
3486,791363,2,0,1,0,0,0,1,0,0,0,0,0,0,0,0,0,0
3486,785742,26,2,5,1,1,1,4,5,8,0,4,2,2,1,3,0,10
3486,786340,10,1,2,1,2,0,0,0,0,0,4,0,2,1,0,0,2
3487,776253,31,6,13,2,8,4,5,4,4,0,8,3,1,1,1,0,20
3487,775651,18,2,6,2,3,0,3,0,0,0,0,0,4,2,0,0,4
3487,796504,15,1,4,1,1,0,3,0,0,1,3,1,4,0,1,1,2
3487,791627,23,0,6,0,1,0,5,0,1,1,2,1,2,1,2,0,0
3487,785665,21,3,6,1,2,2,4,2,3,0,1,0,4,0,2,0,10
3487,796505,11,3,3,3,3,0,0,1,2,1,1,2,1,0,0,0,7
3487,791071,9,2,4,2,4,0,0,0,0,1,3,0,3,0,0,0,4
3487,796502,16,1,2,1,1,0,1,0,0,1,2,1,4,1,0,0,2
3487,796501,13,1,5,1,3,0,2,1,2,0,0,1,1,0,0,0,3
3487,791070,22,3,6,2,3,1,3,7,9,1,2,1,3,1,2,0,14
3487,776178,20,1,3,1,3,0,0,2,2,2,1,2,0,1,4,0,4
3487,785660,1,0,0,0,0,0,0,0,0,0,1,0,0,0,0,0,0
3488,792197,33,5,9,3,3,2,6,1,1,0,3,2,2,0,0,0,13
3488,781132,38,2,9,1,6,1,3,6,6,0,5,7,0,3,1,1,11
3488,797517,31,12,14,12,14,0,0,1,3,4,4,2,1,0,0,1,25
3488,797518,38,4,8,3,7,1,1,1,3,1,1,7,1,2,3,0,10
3488,791940,31,3,8,1,4,2,4,3,4,0,1,2,2,0,0,0,11
3488,797519,4,0,0,0,0,0,0,0,0,0,1,0,2,0,0,0,0
3488,797522,3,0,1,0,1,0,0,0,0,0,2,0,1,1,2,0,0
3488,786539,2,0,1,0,1,0,0,0,0,0,1,0,1,0,0,0,0
3488,791938,16,2,5,0,0,2,5,0,0,0,1,1,2,0,0,1,6
3488,797521,4,0,2,0,2,0,0,0,0,0,0,0,3,0,1,0,0
3489,791903,4,0,0,0,0,0,0,0,0,0,0,2,1,0,0,0,0
3489,797575,18,0,2,0,2,0,0,1,4,1,2,0,4,0,1,0,1
3489,786512,30,4,12,2,7,2,5,2,2,1,3,3,4,1,4,0,12
3489,786435,31,6,11,5,10,1,1,0,0,2,7,2,3,0,0,0,13
3489,786032,39,5,14,5,9,0,5,6,8,1,3,3,2,0,1,1,16
3489,797574,31,8,13,2,4,6,9,0,0,2,5,0,3,1,1,1,22
3489,797573,15,1,3,1,3,0,0,0,0,0,1,2,0,0,0,0,2
3489,786513,13,2,2,2,2,0,0,0,0,1,0,0,1,0,1,0,4
3489,797571,19,1,2,0,1,1,1,0,0,1,4,1,0,1,3,0,3
3490,781058,30,5,7,4,6,1,1,2,3,4,10,3,2,0,3,0,13
3490,780327,28,4,8,4,8,0,0,3,5,1,1,0,1,0,2,1,11
3490,797458,25,3,7,0,2,3,5,4,4,0,2,2,2,1,1,0,13
3490,797451,33,4,9,3,6,1,3,2,2,1,5,4,1,0,3,0,11
3490,786607,23,5,5,3,3,2,2,4,5,0,1,0,1,1,1,0,16
3490,791848,2,0,0,0,0,0,0,0,0,0,0,0,2,0,1,0,0
3490,797455,9,1,3,1,3,0,0,1,2,1,1,0,2,1,1,0,3
3490,785622,25,2,4,1,2,1,2,2,2,3,3,0,1,0,1,0,7
3490,797456,12,0,2,0,0,0,2,0,0,0,1,1,0,0,0,0,0
3490,797453,4,0,2,0,1,0,1,0,0,0,0,0,0,0,1,0,0
3490,797452,9,1,4,1,2,0,2,0,1,1,2,1,2,0,0,0,2
3491,780023,21,2,5,2,5,0,0,4,6,3,2,0,4,1,0,1,8
3491,792493,31,2,4,0,0,2,4,1,1,1,3,0,3,1,1,0,7
3491,792495,40,9,19,8,13,1,6,4,5,1,6,1,3,3,2,0,23
3491,792491,40,7,14,7,14,0,0,3,4,0,2,3,3,0,3,0,17
3491,781144,39,4,12,2,4,2,8,0,0,0,3,1,4,2,1,0,10
3491,798960,8,0,3,0,3,0,0,0,0,3,1,0,3,0,0,2,0
3491,792490,11,0,2,0,1,0,1,0,0,2,0,0,1,0,0,0,0
3491,788128,10,0,3,0,0,0,3,0,0,0,0,0,0,0,0,1,0
3492,775626,30,4,13,3,11,1,2,3,3,2,3,2,1,1,3,1,12
3492,774964,33,2,4,1,1,1,3,4,6,0,6,0,1,1,1,3,9
3492,791203,21,0,4,0,3,0,1,3,5,1,5,0,1,0,2,0,3
3492,785610,23,3,7,2,4,1,3,0,4,3,2,2,2,2,2,0,7
3492,774962,23,2,8,1,3,1,5,2,3,0,3,1,1,0,4,0,7
3492,785609,11,0,2,0,1,0,1,0,0,0,0,0,0,0,0,1,0
3492,785606,8,1,3,1,2,0,1,0,0,0,1,0,1,0,0,0,2
3492,796907,18,0,2,0,2,0,0,0,0,1,2,0,1,0,1,1,0
3492,796906,17,1,3,0,2,1,1,0,0,0,2,1,0,0,0,0,3
3492,775566,16,2,6,1,2,1,4,0,0,0,3,3,0,0,0,0,5
3493,796347,26,2,10,1,5,1,5,1,2,1,6,2,2,0,2,0,6
3493,785243,32,1,4,0,2,1,2,2,4,3,3,0,1,2,2,1,5
3493,790788,27,5,10,3,4,2,6,0,0,1,3,2,5,1,2,0,12
3493,781028,30,5,14,4,9,1,5,2,2,1,4,3,0,0,1,1,13
3493,781026,27,5,10,3,6,2,4,1,2,2,5,3,0,2,0,0,13
3493,790787,2,0,1,0,0,0,1,0,0,0,0,0,0,0,0,0,0
3493,785242,13,0,0,0,0,0,0,0,0,0,2,2,0,0,0,1,0
3493,781027,8,0,3,0,2,0,1,0,0,0,2,0,0,0,0,0,0
3493,796348,19,3,4,2,2,1,2,0,0,1,3,3,1,2,1,0,7
3493,796349,16,2,4,1,2,1,2,0,0,1,2,1,1,1,0,0,5
3494,780059,22,6,16,5,14,1,2,3,4,3,2,1,3,2,2,1,16
3494,776110,21,3,4,3,4,0,0,0,0,5,2,4,2,3,1,1,6
3494,796494,20,0,4,0,1,0,3,0,0,0,2,2,1,1,4,0,0
3494,790944,32,5,12,3,5,2,7,4,4,0,3,0,1,0,2,0,16
3494,780061,31,5,8,4,6,1,2,1,1,0,2,2,2,1,1,0,12
3494,790943,24,5,8,5,8,0,0,5,9,2,5,1,2,1,2,0,15
3494,780058,14,2,4,1,2,1,2,0,0,1,2,0,3,0,0,3,5
3494,796496,24,5,6,2,3,3,3,3,3,0,8,2,1,2,1,1,16
3494,790941,3,0,2,0,2,0,0,0,0,1,1,0,0,0,0,0,0
3494,796497,3,0,0,0,0,0,0,0,0,0,0,0,2,0,0,0,0
3494,798130,2,0,1,0,1,0,0,0,0,0,1,0,1,0,0,0,0
3494,788853,2,0,1,0,0,0,1,0,0,0,0,0,0,0,0,0,0
3494,796499,1,0,1,0,1,0,0,0,0,0,0,0,0,0,0,0,0
3494,785097,1,0,0,0,0,0,0,0,0,0,0,0,0,0,0,0,0
3495,785368,26,6,11,6,11,0,0,1,3,4,4,1,3,0,2,0,13
3495,780281,30,3,11,2,8,1,3,1,2,3,3,1,1,2,1,0,8
3495,790793,35,4,11,2,7,2,4,1,2,2,4,6,2,3,2,0,11
3495,790792,20,1,6,1,5,0,1,0,0,0,1,0,4,1,3,2,2
3495,785246,30,4,11,1,5,3,6,0,1,1,1,0,2,0,1,0,11
3495,780886,30,6,12,4,8,2,4,4,4,1,4,3,1,2,3,1,18
3495,790794,10,1,1,1,1,0,0,0,0,0,1,0,3,1,1,1,2
3495,796351,6,1,1,1,1,0,0,1,2,0,0,1,2,0,0,0,3
3495,790789,7,0,3,0,2,0,1,0,0,1,1,1,1,0,1,0,0
3495,796350,2,1,1,0,0,1,1,0,0,0,0,0,0,0,0,0,3
3495,796353,2,0,0,0,0,0,0,0,0,0,0,1,0,0,0,0,0
3495,790791,1,0,0,0,0,0,0,0,0,0,0,0,0,0,0,0,0
3495,796352,1,0,0,0,0,0,0,0,0,0,0,0,0,0,0,0,0
3496,780879,33,3,11,3,5,0,6,2,2,4,3,4,4,2,1,0,8
3496,775785,28,3,6,3,5,0,1,1,1,3,3,1,5,0,2,0,7
3496,790767,21,3,7,2,2,1,5,0,0,0,4,0,1,0,1,0,7
3496,790768,27,2,9,1,5,1,4,0,0,0,2,2,1,0,0,0,5
3496,796324,16,2,4,1,3,1,1,0,0,1,0,0,1,1,1,0,5
3496,796326,13,4,7,4,4,0,3,0,0,0,2,0,2,0,0,0,8
3496,790769,8,1,1,1,1,0,0,0,2,1,0,0,1,0,1,0,2
3496,780875,33,5,10,4,6,1,4,0,3,0,7,0,2,0,2,0,11
3496,785743,33,8,11,3,5,5,6,0,1,0,3,3,3,1,0,0,21
3496,785226,13,0,3,0,3,0,0,0,0,0,1,1,2,0,1,0,0
3497,785409,35,3,5,3,5,0,0,1,2,0,4,0,4,1,0,1,7
3497,785408,28,3,8,2,4,1,4,1,1,1,5,0,5,0,2,0,8
3497,796416,24,3,6,2,4,1,2,1,2,0,2,1,2,0,3,0,8
3497,780560,27,1,4,1,1,0,3,0,2,0,1,2,3,2,1,0,2
3497,776484,45,6,17,4,12,2,5,4,6,0,10,2,0,1,3,0,18
3497,796415,32,2,6,0,2,2,4,1,2,2,8,3,1,0,2,2,7
3497,790861,7,0,0,0,0,0,0,0,0,0,0,0,1,0,1,0,0
3497,785407,27,5,8,4,7,1,1,9,9,4,3,0,0,1,1,0,20
3498,796469,22,6,10,3,6,3,4,0,0,1,7,0,3,1,2,1,15
3498,779981,26,4,5,4,5,0,0,2,3,4,4,0,1,1,1,1,10
3498,785463,23,2,10,0,5,2,5,4,6,1,0,1,3,0,2,0,10
3498,779978,35,6,10,6,7,0,3,1,2,1,4,4,2,1,2,0,13
3498,776003,37,10,20,7,11,3,9,0,0,0,6,4,1,1,1,0,23
3498,790923,28,2,5,2,4,0,1,3,4,4,5,1,1,0,0,1,7
3498,790924,10,0,4,0,2,0,2,0,0,0,1,1,1,0,0,1,0
3498,785466,19,0,3,0,1,0,2,0,0,0,1,0,2,2,0,0,0
3499,781480,37,9,17,7,11,2,6,1,1,1,4,3,0,0,1,1,21
3499,774846,29,6,10,6,10,0,0,1,2,2,6,2,3,0,0,2,13
3499,791376,30,2,6,0,0,2,6,0,0,0,1,1,1,0,0,0,6
3499,786558,29,3,11,3,9,0,2,4,4,0,2,3,4,1,5,0,10
3499,766611,39,4,11,3,6,1,5,1,1,1,3,0,3,1,0,0,10
3499,797273,9,0,1,0,1,0,0,2,2,0,1,0,0,0,0,0,2
3499,786185,6,0,0,0,0,0,0,0,0,0,3,0,2,0,1,1,0
3499,797272,17,3,5,1,2,2,3,0,0,0,1,0,3,1,1,0,8
3499,797183,4,1,1,1,1,0,0,0,0,0,1,1,0,0,0,0,2
3500,785374,18,1,1,1,1,0,0,0,0,3,4,1,2,1,1,0,2
3500,785372,35,8,13,6,9,2,4,2,2,1,7,1,0,2,4,4,20
3500,786384,25,3,7,2,4,1,3,2,2,2,12,2,4,0,2,0,9
3500,796385,25,1,4,1,4,0,0,1,2,1,2,6,2,2,2,1,3
3500,774905,25,4,9,3,7,1,2,2,2,0,1,2,2,0,1,0,11
3500,796387,4,0,1,0,1,0,0,0,0,0,2,0,1,0,0,2,0
3500,785371,5,0,0,0,0,0,0,0,0,0,0,2,0,0,1,0,0
3500,785373,16,1,4,0,1,1,3,1,2,0,2,0,0,0,2,0,4
3500,790825,15,3,8,2,6,1,2,4,4,0,1,1,2,0,1,0,11
3500,790827,27,2,2,2,2,0,0,1,1,1,3,1,2,0,0,0,5
3500,785375,2,0,0,0,0,0,0,3,4,0,1,0,0,0,1,1,3
3500,796386,1,0,0,0,0,0,0,0,0,0,0,0,0,0,0,0,0
3500,790826,1,0,0,0,0,0,0,0,0,0,0,0,0,0,0,0,0
3500,780007,1,0,0,0,0,0,0,0,0,0,0,0,0,0,0,0,0
3501,780634,29,1,3,1,3,0,0,0,7,2,5,0,2,2,0,3,2
3501,786785,33,5,12,4,8,1,4,2,2,1,1,1,4,2,0,0,13
3501,786784,24,1,4,0,3,1,1,0,2,0,1,0,3,0,2,0,3
3501,780633,24,2,7,1,3,1,4,0,0,1,2,2,2,1,1,0,5
3501,776009,25,5,18,5,17,0,1,1,2,1,2,1,1,2,2,0,11
3501,791826,28,2,8,2,7,0,1,0,1,0,2,5,1,2,0,0,4
3501,786783,22,0,4,0,3,0,1,2,2,1,2,1,2,3,1,0,2
3501,797390,9,0,1,0,1,0,0,0,0,0,0,0,0,1,0,1,0
3501,780635,1,1,1,1,1,0,0,1,1,0,0,0,1,0,0,0,3
3501,797388,1,1,1,1,1,0,0,0,0,0,0,0,0,0,0,0,2
3501,797387,4,0,0,0,0,0,0,0,0,0,0,0,0,0,0,0,0
3502,797050,36,7,12,5,9,2,3,4,4,6,5,0,3,0,2,0,20
3502,780394,31,2,8,2,6,0,2,0,0,0,3,1,3,0,1,0,4
3502,780391,30,4,8,4,8,0,0,1,3,2,2,0,3,0,2,0,9
3502,790871,32,4,12,4,8,0,4,0,0,0,4,5,2,1,1,2,8
3502,776473,25,2,7,1,5,1,2,0,0,0,1,5,4,2,0,0,5
3502,797048,15,1,5,1,3,0,2,0,0,0,1,0,0,2,1,0,2
3502,791573,10,1,2,0,0,1,2,0,0,0,0,1,1,0,1,0,3
3502,780392,21,1,3,0,0,1,3,0,0,0,2,1,1,0,0,0,3
3503,796812,15,2,4,2,4,0,0,0,0,1,4,0,4,0,0,1,4
3503,780952,33,7,10,6,9,1,1,0,0,6,7,3,2,1,1,2,15
3503,791155,28,3,12,3,11,0,1,0,0,2,3,1,2,1,3,0,6
3503,786609,20,0,5,0,5,0,0,0,2,4,3,0,1,0,2,0,0
3503,796810,30,1,6,0,3,1,3,2,2,0,3,5,0,0,2,0,5
3503,780945,15,2,4,2,4,0,0,0,0,1,2,1,4,0,0,0,4
3503,791156,13,0,1,0,0,0,1,4,4,0,0,1,0,0,2,0,4
3503,780950,24,8,12,3,4,5,8,2,3,0,4,1,1,0,0,0,23
3503,785752,22,1,4,0,2,1,2,1,2,0,1,2,0,0,0,0,4
3514,780282,25,5,10,5,9,0,1,0,1,0,5,1,3,0,0,2,10
3514,785330,20,0,5,0,2,0,3,3,5,2,3,0,3,0,1,1,3
3514,785327,29,3,7,2,5,1,2,2,2,0,3,0,1,0,0,0,9
3514,780280,29,5,12,4,8,1,4,4,5,0,6,1,1,0,2,0,15
3514,780279,21,1,7,1,1,0,6,0,0,3,1,0,2,0,2,0,2
3514,785329,20,6,10,4,7,2,3,2,2,4,2,1,1,0,1,0,16
3514,796662,7,1,1,0,0,1,1,0,0,1,1,0,0,0,0,0,3
3514,791003,24,1,7,0,4,1,3,0,0,3,5,3,2,1,2,0,3
3514,796661,9,0,1,0,1,0,0,0,0,0,0,1,0,0,0,0,0
3514,791002,16,2,5,1,2,1,3,0,0,0,1,3,0,0,2,0,5
3515,786459,29,7,16,7,16,0,0,5,7,4,3,0,2,1,1,0,19
3515,781612,23,6,12,5,8,1,4,0,0,2,4,1,3,0,2,2,13
3515,797005,28,6,8,4,4,2,4,2,3,0,2,1,3,1,0,1,16
3515,797004,30,0,2,0,2,0,0,0,0,0,5,3,2,1,0,0,0
3515,781609,34,7,10,4,5,3,5,1,2,0,7,0,1,2,1,1,18
3515,797008,7,0,4,0,3,0,1,0,0,1,0,0,1,0,0,0,0
3515,797006,16,1,4,1,3,0,1,0,0,0,0,1,1,0,1,1,2
3515,791360,22,0,3,0,0,0,3,0,0,0,4,4,1,0,0,0,0
3515,797003,11,0,0,0,0,0,0,0,2,0,0,0,0,1,1,0,0
3516,791287,6,0,0,0,0,0,0,0,0,0,1,0,1,0,0,1,0
3516,796574,23,2,4,2,3,0,1,2,3,0,4,3,2,0,1,1,6
3516,796571,32,6,10,5,6,1,4,4,6,1,3,3,3,0,2,1,17
3516,796572,29,5,9,5,8,0,1,4,5,3,5,3,4,1,1,0,14
3516,781346,36,4,10,2,6,2,4,3,4,1,1,2,2,1,0,0,13
3516,791289,17,5,8,5,8,0,0,1,2,4,2,1,3,0,0,1,11
3516,785786,15,1,1,1,1,0,0,0,0,0,1,1,1,0,0,1,2
3516,796576,22,4,7,2,3,2,4,4,4,0,6,1,1,0,1,1,14
3516,791290,12,3,6,1,2,2,4,0,0,1,1,1,1,0,1,1,8
3516,791288,8,0,2,0,2,0,0,0,0,0,2,0,2,0,1,0,0
3517,791062,30,3,7,3,5,0,2,3,5,1,2,1,2,0,2,2,9
3517,791060,31,5,10,5,9,0,1,3,3,2,8,3,3,0,3,0,13
3517,791064,33,7,12,3,5,4,7,0,0,0,1,1,5,0,0,0,18
3517,780743,34,3,8,2,6,1,2,4,4,0,1,5,4,1,2,0,11
3517,780055,7,0,0,0,0,0,0,0,0,0,0,0,0,0,0,0,0
3517,791063,3,0,1,0,0,0,1,0,0,0,0,0,1,0,2,0,0
3517,785548,10,2,3,1,2,1,1,0,0,0,2,0,2,0,1,0,5
3517,796735,15,2,3,1,1,1,2,1,1,0,0,0,0,0,0,0,6
3517,796742,7,0,2,0,1,0,1,1,2,1,1,1,2,1,0,0,1
3517,785542,30,1,4,1,3,0,1,5,10,1,3,2,1,0,0,0,7
3517,796737,0,0,0,0,0,0,0,0,0,0,0,0,0,0,0,0,0
3518,780291,25,5,8,5,7,0,1,0,1,0,5,4,2,1,1,3,10
3518,785607,15,3,4,3,4,0,0,0,0,1,2,0,0,0,0,1,6
3518,796665,25,4,11,2,4,2,7,0,0,1,6,3,2,1,2,0,10
3518,785333,29,5,8,2,4,3,4,0,0,0,5,2,3,0,1,0,13
3518,775305,34,7,20,7,18,0,2,3,3,1,1,7,0,1,0,0,17
3518,796663,13,1,1,1,1,0,0,0,0,2,1,0,1,0,1,0,2
3518,791004,15,4,8,3,6,1,2,0,0,2,1,1,2,1,1,0,9
3518,791006,6,0,1,0,0,0,1,0,0,0,3,0,0,0,1,0,0
3518,796666,16,5,7,4,5,1,2,1,1,3,2,1,3,1,0,1,12
3518,796664,20,3,4,2,3,1,1,4,4,0,2,1,3,1,1,0,11
3518,796667,1,0,0,0,0,0,0,0,0,0,0,0,0,0,0,0,0
3518,791005,1,0,0,0,0,0,0,0,2,0,1,0,0,0,0,0,0
3519,796761,22,0,4,0,4,0,0,0,2,3,7,1,4,0,2,2,0
3519,796758,33,7,9,7,9,0,0,2,3,0,3,1,1,2,3,0,16
3519,791101,23,6,10,5,8,1,2,0,1,0,4,0,0,1,2,0,13
3519,791105,26,4,9,3,7,1,2,1,2,1,1,2,0,2,1,0,10
3519,780794,23,2,5,0,0,2,5,0,0,0,1,0,0,0,0,2,6
3519,791103,11,2,3,1,2,1,1,0,4,1,1,0,2,0,0,0,5
3519,780109,18,1,6,1,3,0,3,0,0,2,2,2,3,0,2,0,2
3519,796757,25,6,12,5,8,1,4,0,0,0,5,2,2,1,3,1,13
3519,785597,12,0,0,0,0,0,0,0,2,0,1,1,1,0,0,0,0
3519,791104,2,0,0,0,0,0,0,0,0,0,1,0,0,0,1,0,0
3519,796760,5,2,3,2,3,0,0,0,1,0,0,0,0,1,1,0,4
3520,785948,19,2,2,2,2,0,0,5,6,4,3,1,5,0,4,3,9
3520,792020,36,5,10,3,5,2,5,6,6,0,4,2,2,1,4,0,18
3520,785941,33,1,8,0,1,1,7,0,0,0,4,1,3,1,1,1,3
3520,785939,35,4,11,3,5,1,6,0,0,0,2,4,1,0,4,0,9
3520,785938,33,8,12,4,5,4,7,0,0,0,4,3,3,4,0,0,20
3520,792026,6,1,1,1,1,0,0,2,2,0,0,0,1,0,0,0,4
3520,792025,12,0,0,0,0,0,0,0,0,0,2,1,3,0,2,1,0
3520,797634,6,0,1,0,0,0,1,0,0,0,0,0,0,0,0,0,0
3520,785946,20,1,2,1,1,0,1,0,0,2,3,0,2,1,1,0,2
3521,797174,29,3,6,1,3,2,3,2,3,0,1,2,2,3,3,0,10
3521,791510,23,2,4,0,0,2,4,0,0,0,2,0,1,1,2,0,6
3521,786699,28,2,3,2,3,0,0,1,4,3,3,0,3,0,0,0,5
3521,785593,28,5,11,4,7,1,4,2,3,1,4,2,2,1,3,0,13
3521,775357,28,3,7,2,3,1,4,4,4,0,3,3,0,1,2,0,11
3521,791509,12,1,2,1,2,0,0,0,0,0,0,0,5,0,1,0,2
3521,797168,26,0,6,0,5,0,1,3,4,1,1,2,0,0,3,0,3
3521,791504,23,3,7,3,7,0,0,0,0,2,2,2,3,1,1,0,6
3521,791505,3,1,2,0,0,1,2,0,0,0,0,0,0,0,1,0,3
3522,791276,18,3,4,3,4,0,0,0,0,0,3,0,5,0,3,0,6
3522,796529,35,3,12,2,9,1,3,2,2,0,1,3,4,1,0,0,9
3522,791275,38,4,7,1,3,3,4,0,0,0,5,3,1,1,3,0,11
3522,785746,37,6,10,1,1,5,9,3,3,0,3,0,1,0,3,0,20
3522,785741,39,1,7,1,5,0,2,1,1,1,1,7,2,2,3,0,3
3522,785755,22,3,5,3,5,0,0,0,0,0,1,0,2,2,1,0,6
3522,781316,10,0,0,0,0,0,0,0,0,0,1,1,1,0,0,0,0
3522,796526,1,0,0,0,0,0,0,0,0,0,0,0,0,0,0,0,0
3523,799906,29,4,7,2,2,2,5,0,1,1,0,1,1,3,3,0,10
3523,775833,33,0,0,0,0,0,0,5,6,6,10,1,1,2,3,1,5
3523,796845,15,1,5,0,1,1,4,2,2,0,1,1,1,0,1,0,5
3523,781036,38,5,10,5,7,0,3,4,6,0,3,3,3,1,4,0,14
3523,774894,34,3,8,3,4,0,4,1,2,0,0,2,3,0,2,0,7
3523,796847,25,3,6,2,2,1,4,2,2,1,2,0,1,0,0,0,9
3523,791178,8,0,0,0,0,0,0,0,0,0,2,0,3,0,1,0,0
3523,785439,18,2,6,2,3,0,3,0,0,2,1,0,1,1,1,0,4
3524,797223,15,0,0,0,0,0,0,1,2,1,0,0,3,0,1,2,1
3524,781526,28,5,10,5,9,0,1,14,17,1,6,2,5,1,0,2,24
3524,797217,23,4,12,3,10,1,2,2,3,0,0,3,3,3,0,1,11
3524,797218,27,3,9,3,9,0,0,0,0,0,2,1,3,1,0,0,6
3524,775697,35,3,8,1,3,2,5,3,4,0,3,2,2,0,0,0,11
3524,791846,24,3,4,3,4,0,0,0,0,1,5,0,0,1,0,1,6
3524,797222,16,1,2,1,2,0,0,2,2,2,3,0,2,0,0,2,4
3524,791453,32,4,10,2,5,2,5,4,4,0,5,0,1,0,1,1,14
3525,797912,31,4,10,0,1,4,9,4,4,2,4,1,4,0,0,0,16
3525,792306,33,7,17,4,11,3,6,1,1,4,6,0,5,0,3,2,18
3525,792303,35,8,16,8,13,0,3,2,4,1,7,8,4,0,3,0,18
3525,781603,26,0,1,0,0,0,1,0,0,0,3,1,0,0,0,0,0
3525,780456,10,0,4,0,2,0,2,0,0,0,2,1,2,0,1,0,0
3525,797907,1,0,0,0,0,0,0,0,1,0,0,0,1,0,0,0,0
3525,786618,12,2,2,2,2,0,0,0,0,0,0,0,4,0,0,0,4
3525,781605,3,0,0,0,0,0,0,0,0,0,0,0,2,0,0,0,0
3525,797914,21,0,4,0,1,0,3,0,0,1,3,3,2,0,1,0,0
3525,792300,28,6,10,3,7,3,3,3,4,4,4,0,2,1,1,0,18
3526,780323,32,5,9,5,9,0,0,4,6,2,0,2,1,3,1,0,14
3526,797894,24,3,4,3,4,0,0,3,4,2,1,2,2,0,0,0,9
3526,792229,27,2,6,2,3,0,3,2,2,1,6,1,3,2,2,2,6
3526,785954,33,3,9,2,4,1,5,2,2,1,4,2,0,1,0,0,9
3526,785811,27,6,11,4,5,2,6,2,4,0,4,3,2,0,1,0,16
3526,786016,15,0,3,0,2,0,1,4,4,0,2,1,1,0,0,0,4
3526,792233,27,5,9,4,7,1,2,11,12,3,3,0,0,3,3,0,22
3526,797892,6,0,2,0,1,0,1,2,2,1,1,0,1,0,1,0,2
3526,792234,6,0,0,0,0,0,0,0,0,0,0,0,0,0,0,1,0
3526,797891,3,0,0,0,0,0,0,0,0,0,0,0,0,0,0,0,0
3527,796372,19,4,4,4,4,0,0,2,2,2,3,0,4,0,3,2,10
3527,796377,30,6,12,4,8,2,4,3,3,0,2,6,5,1,4,1,17
3527,796379,38,7,11,4,4,3,7,0,0,1,0,2,2,1,1,0,17
3527,790815,32,3,8,2,4,1,4,0,0,1,3,1,4,1,2,0,7
3527,780176,39,3,12,1,5,2,7,2,2,1,7,5,2,1,1,0,10
3527,796376,9,1,3,1,2,0,1,0,0,1,0,0,2,0,2,1,2
3527,796378,20,1,3,1,2,0,1,2,2,0,3,1,3,0,1,0,4
3527,796375,13,2,2,2,2,0,0,0,0,1,1,0,2,0,0,0,4
3528,791161,32,4,11,0,1,4,10,0,0,0,6,0,4,0,3,1,12
3528,780629,34,7,13,7,11,0,2,4,7,2,8,1,4,0,2,0,18
3528,785346,33,5,11,2,2,3,9,0,0,0,2,0,3,2,0,0,13
3528,774845,38,4,10,3,5,1,5,9,13,0,5,6,3,3,3,0,18
3528,775888,34,6,11,6,8,0,3,1,4,0,11,8,4,6,7,5,13
3528,796817,4,0,0,0,0,0,0,0,0,0,0,1,0,1,1,0,0
3528,796816,21,2,4,2,3,0,1,3,6,2,3,2,2,0,1,0,7
3528,796815,4,0,1,0,1,0,0,0,0,1,0,0,0,0,2,0,0
3529,781005,25,5,13,3,9,2,4,1,2,2,4,0,1,1,3,2,13
3529,790494,13,2,4,1,2,1,2,0,0,0,0,1,2,1,3,0,5
3529,788866,7,0,0,0,0,0,0,1,3,2,2,0,3,0,1,0,1
3529,782162,30,7,12,6,10,1,2,0,0,1,4,2,5,1,3,1,15
3529,796851,35,2,14,1,7,1,7,4,4,1,6,4,2,3,4,0,9
3529,781659,10,0,5,0,3,0,2,0,0,3,2,0,2,1,0,1,0
3529,781411,4,0,0,0,0,0,0,0,1,1,3,0,0,0,0,0,0
3529,796853,4,0,1,0,0,0,1,1,2,0,1,0,1,0,1,1,1
3529,796854,29,3,6,1,4,2,2,1,2,1,4,6,2,0,5,0,9
3529,792683,20,4,9,1,2,3,7,0,0,0,4,1,2,1,0,1,11
3529,780610,23,5,11,2,3,3,8,0,0,0,3,1,2,2,0,0,13
3530,796381,28,2,4,0,0,2,4,0,0,0,3,2,3,2,2,1,6
3530,775585,21,5,8,5,8,0,0,0,0,2,4,0,5,2,1,2,10
3530,796380,37,3,13,3,10,0,3,6,7,2,3,5,3,5,5,2,12
3530,790822,30,3,8,3,7,0,1,2,2,1,3,0,2,0,1,0,8
3530,790820,34,3,14,3,10,0,4,3,5,0,2,2,1,2,3,0,9
3530,780445,17,0,2,0,2,0,0,0,1,2,3,0,1,1,1,1,0
3530,780982,19,3,6,2,4,1,2,4,4,2,1,0,1,1,0,0,11
3530,790821,14,3,8,3,6,0,2,3,3,0,3,0,1,1,1,1,9
3531,796410,27,4,12,4,12,0,0,4,5,7,9,0,3,2,3,1,12
3531,790856,21,1,3,1,3,0,0,5,5,0,2,0,3,0,1,0,7
3531,796413,21,4,8,1,1,3,7,2,2,0,1,4,2,1,3,1,13
3531,796409,14,1,5,1,3,0,2,0,0,0,0,0,2,0,3,0,2
3531,796407,34,6,9,2,5,4,4,0,2,2,7,3,3,2,2,1,16
3531,780452,26,1,7,1,7,0,0,4,6,3,4,1,4,2,2,3,6
3531,796408,28,1,9,0,6,1,3,0,0,0,4,4,3,1,4,0,3
3531,780450,21,3,6,2,3,1,3,0,0,1,0,1,2,1,1,0,7
3531,796411,5,0,1,0,1,0,0,1,2,0,2,0,1,0,1,0,1
3531,796412,3,0,1,0,0,0,1,0,0,0,1,0,0,0,0,0,0
3532,785999,32,5,7,5,7,0,0,5,6,4,5,1,2,1,1,1,15
3532,775654,33,1,4,1,4,0,0,4,4,2,5,1,1,0,0,3,6
3532,775171,22,1,2,0,0,1,2,0,0,1,1,0,0,0,0,0,3
3532,791639,34,7,16,6,15,1,1,5,5,0,3,2,1,0,2,0,20
3532,785389,37,10,14,10,13,0,1,4,4,0,3,4,0,3,4,0,24
3532,791640,6,0,2,0,1,0,1,0,0,0,1,0,3,0,2,0,0
3532,796399,24,2,7,1,6,1,1,1,2,0,4,3,2,2,0,0,6
3532,796398,12,2,2,2,2,0,0,0,0,1,2,0,1,0,0,1,4
3533,790863,17,2,6,1,3,1,3,0,0,1,1,0,2,0,0,0,5
3533,780021,29,8,10,8,10,0,0,0,0,3,3,0,4,1,1,0,16
3533,785412,28,4,13,3,10,1,3,4,4,0,3,8,3,0,2,0,13
3533,780099,33,2,7,1,2,1,5,2,2,0,0,2,2,1,0,0,7
3533,776214,37,5,9,4,7,1,2,0,0,0,2,3,3,1,2,0,11
3533,775686,22,2,7,2,3,0,4,0,0,0,3,0,2,2,1,1,4
3533,785413,15,3,5,2,4,1,1,0,0,0,1,0,2,0,1,1,7
3533,776221,10,0,1,0,1,0,0,0,0,0,1,2,0,1,0,0,0
3533,785417,9,0,0,0,0,0,0,0,0,0,0,0,1,0,0,1,0
3534,797870,28,0,8,0,5,0,3,0,0,0,1,1,1,0,1,0,0
3534,792210,23,1,4,1,4,0,0,3,4,1,0,3,1,1,0,0,5
3534,781326,18,4,5,4,5,0,0,0,0,0,0,0,4,0,0,0,8
3534,781323,34,6,12,5,9,1,3,1,1,0,2,6,1,1,5,0,14
3534,785638,22,1,3,0,1,1,2,0,0,2,1,1,0,0,0,0,3
3534,780874,16,6,9,2,3,4,6,2,3,1,5,0,2,0,2,0,18
3534,785430,20,2,5,2,5,0,0,0,0,1,1,0,2,0,0,0,4
3534,792215,11,1,4,0,2,1,2,0,2,0,1,0,1,0,1,0,3
3534,792209,19,2,3,1,1,1,2,0,0,0,0,3,1,0,1,0,5
3534,792213,5,1,1,1,1,0,0,0,0,0,0,1,0,0,0,0,2
3534,797868,2,0,1,0,0,0,1,0,0,0,1,0,0,0,0,0,0
3534,797869,2,0,1,0,1,0,0,0,0,0,1,0,0,0,0,0,0
3535,790808,32,4,7,2,3,2,4,0,0,0,2,3,3,2,1,0,10
3535,790809,28,3,5,3,5,0,0,1,1,1,1,7,2,0,1,0,7
3535,790810,35,5,10,4,7,1,3,5,8,2,6,6,1,1,1,0,16
3535,785361,31,7,12,4,6,3,6,2,2,0,3,3,0,1,0,1,19
3535,785362,23,7,9,7,9,0,0,6,6,3,5,1,1,0,0,2,20
3535,774854,17,2,6,2,5,0,1,0,1,4,1,0,1,1,2,1,4
3535,796368,9,2,4,2,2,0,2,1,2,0,1,0,1,0,0,0,5
3535,790811,16,5,8,3,5,2,3,0,0,3,4,1,1,0,3,0,12
3535,796371,3,0,0,0,0,0,0,0,0,0,1,0,1,0,0,0,0
3535,796369,3,0,1,0,0,0,1,0,0,0,0,0,1,0,0,0,0
3535,779999,3,0,0,0,0,0,0,0,0,1,2,0,0,0,0,0,0
3546,797673,37,14,22,6,10,8,12,2,5,2,8,3,2,1,2,0,38
3546,780437,26,11,12,11,12,0,0,2,2,2,5,4,1,1,0,0,24
3546,786118,24,3,7,1,3,2,4,0,0,1,2,3,1,3,1,1,8
3546,786123,33,3,10,3,10,0,0,1,2,3,9,1,1,1,0,3,7
3546,786117,40,0,7,0,4,0,3,4,4,1,7,11,0,1,2,0,4
3546,786264,17,1,5,1,3,0,2,0,0,1,2,4,3,0,0,0,2
3546,792093,13,0,5,0,3,0,2,0,0,0,1,1,1,0,1,0,0
3546,797675,6,0,0,0,0,0,0,0,0,0,1,0,2,0,0,1,0
3546,786119,2,0,0,0,0,0,0,0,0,0,0,0,0,0,1,0,0
3546,797672,2,0,0,0,0,0,0,0,0,0,0,0,0,0,0,0,0
3547,780937,26,5,10,4,6,1,4,2,2,0,5,2,2,1,2,0,13
3547,797715,32,3,6,0,1,3,5,0,0,1,9,5,3,1,2,0,9
3547,791149,27,3,11,1,2,2,9,0,0,0,3,2,1,1,1,0,8
3547,780779,15,3,6,2,3,1,3,0,2,0,1,1,1,1,1,0,7
3547,797717,13,0,2,0,1,0,1,0,0,1,1,0,1,0,1,1,0
3547,792113,27,5,14,3,7,2,7,1,2,0,1,1,0,0,0,0,13
3547,791950,24,2,6,1,2,1,4,0,1,0,2,2,1,0,2,0,5
3547,780938,12,1,2,1,2,0,0,0,0,1,5,0,0,0,0,0,2
3547,792115,20,0,2,0,1,0,1,0,0,0,1,1,2,0,2,0,0
3547,797716,4,0,0,0,0,0,0,0,0,0,0,0,1,0,0,0,0
3548,791837,32,4,10,3,7,1,3,2,2,2,4,1,2,0,0,0,11
3548,780613,35,5,12,5,11,0,1,4,5,3,2,1,3,0,2,1,14
3548,775097,34,8,15,8,15,0,0,1,2,1,8,5,4,1,0,0,17
3548,780609,37,6,10,0,2,6,8,4,4,0,0,4,0,5,2,0,22
3548,776395,36,6,14,5,9,1,5,2,2,0,1,4,3,1,1,0,15
3548,786621,6,0,0,0,0,0,0,0,0,0,1,0,0,0,0,0,0
3548,786619,13,0,1,0,1,0,0,1,2,0,3,1,1,0,1,1,1
3548,797437,7,0,2,0,1,0,1,0,0,1,1,0,3,0,0,0,0
3549,781407,21,6,7,6,7,0,0,0,0,3,5,0,3,0,4,1,12
3549,791583,24,3,8,3,8,0,0,0,2,2,3,0,3,0,2,1,6
3549,785623,18,1,1,0,0,1,1,2,2,0,2,0,2,0,0,0,5
3549,780580,34,7,17,7,12,0,5,4,7,1,5,4,2,2,3,0,18
3549,776150,21,4,6,1,1,3,5,0,0,0,1,1,1,0,4,0,11
3549,797448,12,1,2,0,0,1,2,1,3,0,1,0,1,0,1,0,4
3549,786608,24,2,4,2,4,0,0,0,0,0,6,0,0,0,0,1,4
3549,797445,14,0,0,0,0,0,0,2,2,0,1,2,1,0,1,0,2
3549,786110,18,1,2,0,1,1,1,0,0,0,0,1,2,1,1,0,3
3549,786659,14,4,8,4,7,0,1,0,0,1,4,2,1,0,3,0,8
3550,785498,26,3,7,3,6,0,1,4,4,0,4,3,3,1,1,0,10
3550,776469,26,4,11,3,7,1,4,1,2,2,3,1,4,0,1,0,10
3550,796705,32,7,15,3,7,4,8,0,0,1,2,5,2,2,0,0,18
3550,780701,30,4,8,4,8,0,0,0,2,1,3,2,2,2,2,0,8
3550,776322,36,4,10,2,6,2,4,3,5,0,6,2,0,0,0,0,13
3550,785500,18,1,5,1,2,0,3,2,2,3,4,0,0,2,0,0,4
3550,796708,19,0,4,0,2,0,2,0,0,0,2,0,1,0,1,0,0
3550,796706,4,0,0,0,0,0,0,0,0,0,0,0,1,0,0,0,0
3550,791036,9,0,0,0,0,0,0,0,0,0,0,0,0,0,0,0,0
3551,781403,31,4,13,2,8,2,5,2,2,4,7,4,4,0,3,0,12
3551,792654,33,4,8,4,8,0,0,1,1,3,9,0,3,2,0,2,9
3551,797301,38,3,9,1,6,2,3,0,0,0,1,2,1,0,3,0,8
3551,780524,32,2,8,1,5,1,3,1,2,0,3,3,2,0,1,0,6
3551,781400,38,4,16,1,8,3,8,0,0,1,7,2,0,1,2,0,11
3551,786857,12,2,4,1,2,1,2,2,3,2,1,0,3,0,3,0,7
3551,792653,7,1,1,1,1,0,0,0,0,1,1,0,1,0,1,0,2
3551,797305,4,0,0,0,0,0,0,0,0,0,0,1,0,0,0,0,0
3551,797302,4,0,0,0,0,0,0,0,0,0,1,0,1,0,1,0,0
3551,797303,1,0,0,0,0,0,0,0,0,0,0,0,0,0,1,0,0
3552,775954,33,6,11,6,11,0,0,4,6,0,8,3,0,0,0,3,16
3552,781006,33,3,6,3,4,0,2,0,0,2,1,1,0,0,0,4,6
3552,796194,24,1,7,1,3,0,4,2,2,0,2,3,3,3,2,0,4
3552,796464,24,4,8,4,7,0,1,6,6,0,2,1,0,1,1,0,14
3552,790917,36,6,12,4,6,2,6,3,5,1,8,1,3,3,0,1,17
3552,780648,4,0,0,0,0,0,0,0,0,0,0,1,1,0,0,0,0
3552,796459,21,2,7,1,5,1,2,0,1,0,0,3,2,2,1,0,5
3552,781157,23,5,9,3,6,2,3,5,6,0,1,0,3,1,0,1,17
3552,785238,2,0,0,0,0,0,0,0,0,0,0,0,0,0,0,0,0
3553,796560,14,3,3,3,3,0,0,0,0,0,2,0,2,0,4,1,6
3553,785536,27,5,9,4,6,1,3,1,1,2,5,0,4,0,0,1,12
3553,776097,30,7,11,6,9,1,2,0,1,0,5,6,4,1,6,0,15
3553,796559,37,1,8,0,4,1,4,3,3,0,2,1,4,0,0,0,6
3553,785280,18,0,1,0,0,0,1,0,0,2,0,0,2,0,3,0,0
3553,785285,3,0,0,0,0,0,0,0,0,0,0,0,0,0,1,0,0
3553,775679,33,5,10,2,4,3,6,1,2,0,9,1,2,0,0,0,14
3553,796561,5,0,0,0,0,0,0,0,0,0,2,1,2,0,1,0,0
3553,796558,5,1,2,1,2,0,0,0,0,0,0,0,1,1,1,0,2
3553,780149,28,7,11,5,7,2,4,3,3,0,4,3,1,0,4,0,19
3554,786054,24,4,6,4,5,0,1,2,4,6,1,3,2,0,2,4,10
3554,791964,31,3,10,0,3,3,7,0,0,0,2,0,3,0,1,0,9
3554,786056,32,1,3,0,0,1,3,4,4,0,4,2,0,1,2,0,7
3554,781339,22,1,5,0,0,1,5,2,3,0,4,2,4,0,2,0,5
3554,781337,34,8,12,3,4,5,8,4,5,1,3,4,1,1,7,0,25
3554,797712,14,1,3,1,3,0,0,0,1,1,0,0,2,1,0,2,2
3554,792041,12,2,5,2,4,0,1,2,2,0,2,1,1,0,1,0,6
3554,797711,23,3,7,3,4,0,3,3,3,1,2,1,3,2,1,0,9
3554,797710,8,1,4,1,1,0,3,0,0,0,1,0,0,0,0,0,2
3555,785800,30,5,9,1,1,4,8,5,7,1,1,0,1,0,0,0,19
3555,785799,17,2,4,2,4,0,0,3,5,2,2,0,3,0,2,0,7
3555,791676,33,3,8,0,1,3,7,0,0,0,3,4,3,2,2,0,9
3555,780554,31,3,9,3,7,0,2,1,1,4,4,0,2,1,3,0,7
3555,780553,34,6,16,6,14,0,2,3,5,4,9,8,4,4,2,1,15
3555,797426,2,1,1,1,1,0,0,0,0,0,1,0,0,0,0,0,2
3555,791679,7,3,3,3,3,0,0,0,0,0,0,0,3,1,2,0,6
3555,785807,16,1,5,0,2,1,3,0,0,2,0,0,1,0,0,0,3
3555,780760,17,4,4,3,3,1,1,1,1,1,1,1,2,0,0,2,10
3555,797427,11,2,5,0,1,2,4,0,0,0,0,0,2,2,0,0,6
3555,791678,2,0,0,0,0,0,0,0,0,0,0,0,0,0,0,0,0
3556,791923,21,2,5,2,5,0,0,3,8,4,7,0,4,1,0,0,7
3556,781122,11,1,6,1,6,0,0,0,0,1,1,0,1,2,3,0,2
3556,791925,35,7,13,6,9,1,4,2,4,3,6,4,3,4,2,1,17
3556,791926,26,5,12,2,2,3,10,1,3,1,2,0,2,0,1,0,14
3556,781112,7,0,0,0,0,0,0,0,0,0,0,0,2,0,0,0,0
3556,791922,6,0,1,0,0,0,1,2,2,1,1,0,1,0,1,0,2
3556,786529,3,0,0,0,0,0,0,0,0,0,0,0,0,0,0,0,0
3556,797541,16,4,5,4,5,0,0,0,0,4,6,0,2,0,1,0,8
3556,797542,11,0,3,0,0,0,3,0,0,1,0,1,1,1,2,0,0
3556,791927,23,2,7,1,3,1,4,4,4,1,2,2,4,1,2,0,9
3556,786858,27,2,7,0,2,2,5,0,0,0,2,0,3,0,1,0,6
3556,786527,14,0,4,0,1,0,3,2,2,1,0,0,1,0,1,0,2
3557,797109,15,0,2,0,0,0,2,1,3,1,1,0,2,0,1,0,1
3557,791403,22,3,4,3,4,0,0,3,5,1,9,1,4,0,1,0,9
3557,791407,38,8,19,7,13,1,6,5,5,1,1,6,2,1,2,0,22
3557,785928,34,4,8,1,4,3,4,3,4,1,3,1,4,0,2,0,14
3557,785923,26,1,4,1,4,0,0,2,2,0,3,3,1,0,2,1,4
3557,797111,11,0,1,0,1,0,0,2,3,1,0,0,2,0,1,0,2
3557,797117,9,1,1,1,1,0,0,0,1,0,5,0,3,0,2,0,2
3557,797110,23,4,7,1,2,3,5,0,1,1,1,0,2,0,0,0,11
3557,791404,22,3,4,0,0,3,4,1,2,0,2,3,1,1,3,0,10
3558,792047,30,5,9,5,7,0,2,3,3,5,7,1,1,1,1,3,13
3558,786338,36,0,4,0,1,0,3,5,6,2,8,0,2,0,7,0,5
3558,792052,28,2,5,1,1,1,4,2,2,2,1,1,0,2,1,0,7
3558,785347,32,3,12,3,9,0,3,2,2,0,6,2,0,2,5,0,8
3558,775601,28,6,14,4,8,2,6,2,5,1,1,1,4,0,3,1,16
3558,791512,1,0,0,0,0,0,0,0,0,0,0,0,1,0,0,0,0
3558,786825,8,0,1,0,1,0,0,0,0,1,1,0,0,0,0,1,0
3558,792045,2,0,0,0,0,0,0,0,0,1,0,0,1,0,0,0,0
3558,797648,13,1,1,1,1,0,0,0,2,1,1,1,1,1,0,1,2
3558,797647,5,0,2,0,1,0,1,0,1,0,0,0,0,0,0,0,0
3558,792051,12,0,1,0,1,0,0,1,2,0,3,0,1,0,0,0,1
3558,780862,5,0,0,0,0,0,0,0,0,0,1,0,0,0,0,0,0
3559,797367,22,2,4,2,4,0,0,1,2,2,2,2,3,1,1,2,5
3559,797369,33,2,5,0,1,2,4,0,0,1,1,3,2,0,2,0,6
3559,797366,16,1,2,1,1,0,1,1,1,2,2,3,0,0,1,0,3
3559,791807,31,8,14,3,4,5,10,0,0,1,6,1,3,2,0,0,21
3559,786130,31,5,17,0,7,5,10,2,2,1,4,2,1,1,4,0,17
3559,797364,18,4,7,4,6,0,1,0,0,2,2,1,4,2,2,0,8
3559,797365,15,0,5,0,1,0,4,0,2,0,1,2,2,0,0,0,0
3559,797363,24,4,11,2,6,2,5,0,1,0,2,4,4,0,1,0,10
3559,791808,10,0,1,0,1,0,0,0,0,1,2,1,0,0,0,0,0
3560,775806,18,1,5,1,3,0,2,1,2,0,1,0,0,0,1,0,3
3560,775563,30,9,15,9,14,0,1,1,2,1,7,0,1,1,1,0,19
3560,781011,20,1,3,1,3,0,0,1,2,2,5,0,4,0,1,2,3
3560,781012,36,4,7,4,4,0,3,0,1,1,2,3,2,1,1,0,8
3560,775119,32,6,15,6,13,0,2,1,2,3,6,1,2,2,2,1,13
3560,797602,8,4,4,4,4,0,0,0,0,2,2,0,2,0,0,0,8
3560,775188,1,0,0,0,0,0,0,0,0,0,0,0,1,0,0,0,0
3560,797604,24,3,6,0,0,3,6,0,2,2,8,2,3,0,1,3,9
3560,797601,29,4,9,1,1,3,8,2,3,0,2,3,0,0,0,0,13
3560,786466,2,0,1,0,1,0,0,0,0,0,0,0,0,0,0,0,0
3561,780201,34,6,9,6,9,0,0,2,2,3,7,0,4,0,0,0,14
3561,797210,36,4,10,4,10,0,0,5,7,1,2,4,2,1,1,1,13
3561,791467,34,6,18,4,14,2,4,1,1,3,7,1,3,0,1,0,15
3561,786311,35,4,14,1,3,3,11,0,0,0,3,1,2,0,1,0,11
3561,775516,20,1,3,1,2,0,1,0,0,0,2,2,0,2,0,0,2
3561,798344,2,2,4,2,4,0,0,0,0,0,0,0,1,0,0,0,4
3561,797209,7,0,2,0,1,0,1,0,0,1,0,0,0,0,0,0,0
3561,791470,3,0,1,0,1,0,0,0,0,0,0,0,0,0,0,0,0
3561,791469,1,0,0,0,0,0,0,0,0,0,0,0,0,0,0,0,0
3561,797208,28,4,10,4,9,0,1,2,2,2,2,0,1,1,1,0,10
3562,776286,37,5,7,3,4,2,3,2,2,6,4,1,2,0,0,1,14
3562,775557,25,3,5,3,5,0,0,0,2,3,4,0,4,0,1,1,6
3562,791445,33,3,12,2,5,1,7,5,6,0,3,3,2,1,3,0,12
3562,785357,35,6,17,2,9,4,8,6,7,2,7,0,4,1,1,0,22
3562,775560,33,5,15,5,12,0,3,3,5,2,8,5,4,0,4,0,13
3562,785287,9,1,2,1,2,0,0,0,0,1,0,0,4,0,0,1,2
3562,797010,17,0,2,0,1,0,1,1,2,0,0,0,1,1,0,0,1
3562,797012,2,0,0,0,0,0,0,0,0,0,0,0,0,0,1,0,0
3562,791444,9,0,0,0,0,0,0,0,0,1,2,0,0,0,0,1,0
3563,786029,18,0,2,0,2,0,0,0,0,0,3,0,4,1,0,1,0
3563,792114,35,7,20,3,11,4,9,7,8,2,6,0,2,1,2,0,25
3563,786018,30,5,9,3,4,2,5,6,7,2,3,0,5,1,3,0,18
3563,775678,33,2,12,2,7,0,5,0,1,0,3,4,0,2,3,0,4
3563,781398,29,2,6,1,2,1,4,0,2,2,3,1,1,0,1,0,5
3563,797740,12,2,3,1,2,1,1,0,0,1,1,0,1,0,1,0,5
3563,797746,9,0,2,0,1,0,1,1,2,1,1,0,2,0,0,0,1
3563,786022,18,2,4,2,3,0,1,1,2,2,5,0,2,0,0,1,5
3563,797737,12,0,1,0,1,0,0,0,0,0,1,0,1,0,1,0,0
3563,792112,4,0,0,0,0,0,0,0,0,1,0,1,0,1,0,0,0
3564,780012,29,6,11,5,6,1,5,1,1,0,7,3,1,2,2,0,14
3564,796309,32,12,15,12,15,0,0,4,4,2,6,0,0,0,1,0,28
3564,790824,30,4,7,2,4,2,3,2,2,0,5,4,1,0,0,2,12
3564,780011,21,1,3,1,1,0,2,0,0,0,2,3,1,1,1,0,2
3564,775667,27,3,5,2,4,1,1,0,0,0,2,6,2,1,6,0,7
3564,785370,13,3,3,3,3,0,0,1,2,2,2,0,2,0,0,2,7
3564,781524,21,2,6,2,6,0,0,1,2,1,0,0,0,0,0,0,5
3564,796383,7,0,0,0,0,0,0,2,2,2,1,0,3,0,1,0,2
3564,796382,8,1,3,1,1,0,2,0,0,1,1,1,0,0,2,0,2
3564,785367,4,1,2,1,2,0,0,0,0,0,0,0,0,0,0,0,2
3564,796384,4,0,1,0,1,0,0,1,2,0,0,0,0,0,0,0,1
3564,780941,4,0,2,0,2,0,0,0,0,1,0,0,0,0,0,0,0
3565,776462,20,0,3,0,1,0,2,2,2,1,5,1,4,0,1,0,2
3565,785635,24,2,9,1,6,1,3,0,0,2,2,0,3,1,1,1,5
3565,786440,33,4,11,3,6,1,5,0,0,2,0,0,0,1,1,0,9
3565,786720,23,1,4,1,2,0,2,0,0,1,2,2,1,2,1,0,2
3565,781199,33,5,16,3,9,2,7,2,2,1,0,2,2,1,2,0,14
3565,791628,20,2,5,1,1,1,4,0,0,1,1,0,1,0,0,1,5
3565,796974,15,2,6,2,4,0,2,0,0,0,1,1,0,1,2,0,4
3565,775642,5,1,4,1,4,0,0,0,0,1,1,0,0,1,1,0,2
3565,791629,11,3,6,2,4,1,2,0,0,1,2,0,2,0,2,0,7
3565,791626,12,1,3,1,3,0,0,2,2,3,1,0,2,0,0,0,4
3565,796972,4,1,1,0,0,1,1,0,0,0,0,0,0,0,0,0,3
3566,775510,36,7,13,6,7,1,6,1,2,1,10,3,0,1,0,0,16
3566,774976,24,4,7,3,4,1,3,2,2,1,2,0,2,1,1,1,11
3566,797865,37,4,8,3,5,1,3,3,4,0,1,3,0,5,2,0,12
3566,786614,38,4,8,1,2,3,6,2,2,0,1,2,2,1,0,0,13
3566,786759,40,5,8,5,7,0,1,0,0,0,1,3,2,2,3,0,10
3566,792294,14,3,4,3,4,0,0,0,0,2,3,0,2,0,0,0,6
3566,792292,3,1,2,1,2,0,0,0,0,0,0,0,0,0,0,0,2
3566,792291,8,0,2,0,1,0,1,0,0,0,2,0,0,0,0,0,0
3567,790899,24,4,7,4,7,0,0,0,2,1,3,1,3,0,0,0,8
3567,785442,35,5,12,4,9,1,3,3,3,2,5,0,0,0,3,1,14
3567,799907,21,0,2,0,1,0,1,1,2,0,2,2,2,0,2,0,1
3567,785448,15,1,1,0,0,1,1,0,0,0,3,3,1,1,1,0,3
3567,775737,30,5,8,1,1,4,7,0,0,0,4,0,2,2,2,0,14
3567,790897,19,4,7,0,1,4,6,1,4,0,3,1,1,0,2,0,13
3567,790898,13,0,0,0,0,0,0,0,0,0,0,1,1,0,2,0,0
3567,785579,32,4,8,4,7,0,1,0,0,0,1,4,2,1,1,0,8
3567,775959,11,0,0,0,0,0,0,0,0,0,0,0,0,0,0,0,0
3568,786447,26,3,7,3,6,0,1,1,1,1,2,0,4,1,1,1,7
3568,775074,28,5,8,5,8,0,0,2,4,2,1,0,2,0,2,1,12
3568,796971,20,0,6,0,2,0,4,0,0,0,4,2,0,1,0,0,0
3568,786448,19,5,8,3,4,2,4,0,0,2,5,1,5,2,2,0,12
3568,780462,35,3,10,2,4,1,6,0,0,1,2,10,0,2,2,1,7
3568,776365,12,5,6,2,3,3,3,0,0,0,2,0,1,0,1,1,13
3568,791631,28,4,6,4,5,0,1,0,0,2,8,1,1,4,1,0,8
3568,780731,18,1,6,0,3,1,3,6,6,0,0,3,2,1,1,0,9
3568,786132,12,1,2,1,1,0,1,2,2,0,1,0,0,0,0,1,4
3568,791632,2,0,0,0,0,0,0,0,0,0,0,0,0,0,0,0,0
3569,796699,24,3,9,2,7,1,2,2,3,2,3,1,2,1,1,0,9
3569,790983,30,7,14,1,4,6,10,4,4,1,3,4,3,2,3,0,24
3569,790978,32,2,10,2,5,0,5,0,0,2,3,1,2,1,2,0,4
3569,790979,35,2,8,2,4,0,4,0,0,1,5,5,1,2,8,1,4
3569,788820,34,4,14,1,5,3,9,0,0,1,3,1,2,1,0,0,11
3569,796701,16,2,2,2,2,0,0,1,2,1,4,0,1,0,1,0,5
3569,790976,7,0,0,0,0,0,0,0,0,0,0,0,3,0,1,1,0
3569,796698,15,2,2,2,2,0,0,0,0,0,1,1,0,0,0,0,4
3569,790980,2,0,1,0,1,0,0,0,0,0,0,0,0,0,0,0,0
3569,790977,5,0,1,0,1,0,0,0,0,0,0,0,0,0,0,0,0
3570,797546,22,0,1,0,1,0,0,1,2,1,3,0,2,0,1,1,1
3570,780351,23,1,5,1,5,0,0,3,4,1,2,1,1,2,2,1,5
3570,797549,19,3,8,3,8,0,0,3,4,1,1,0,3,1,2,0,9
3570,797545,16,0,6,0,5,0,1,0,0,1,3,1,3,0,3,0,0
3570,780586,26,3,7,2,6,1,1,0,0,1,4,0,0,2,3,0,7
3570,797544,15,0,6,0,3,0,3,0,0,0,2,0,2,0,1,3,0
3570,791799,5,0,3,0,1,0,2,0,0,0,1,0,0,1,0,0,0
3570,785850,2,0,0,0,0,0,0,0,0,1,0,0,0,0,0,0,0
3570,797539,6,0,1,0,0,0,1,0,0,0,0,0,0,0,0,0,0
3570,797540,9,0,3,0,1,0,2,2,2,1,0,0,2,0,0,0,2
3570,791715,12,1,3,0,0,1,3,0,0,0,2,0,2,0,1,0,3
3570,790857,18,3,5,2,3,1,2,1,2,0,1,2,0,0,2,0,8
3570,789065,3,0,1,0,0,0,1,0,0,0,0,0,0,1,0,0,0
3570,785855,20,4,7,2,2,2,5,0,0,1,1,1,2,0,1,0,10
3570,791716,4,0,0,0,0,0,0,0,0,0,0,0,0,0,0,0,0
3571,781579,26,2,5,2,5,0,0,1,1,1,0,4,1,0,1,3,5
3571,786731,30,9,10,9,10,0,0,0,2,1,5,1,3,1,4,5,18
3571,798023,20,1,2,1,1,0,1,0,0,2,4,1,2,1,3,0,2
3571,781584,21,1,5,0,0,1,5,3,3,0,0,1,2,2,1,0,6
3571,780347,35,6,11,5,10,1,1,2,2,1,4,3,0,0,1,0,15
3571,798021,1,0,0,0,0,0,0,0,1,0,1,0,0,0,0,0,0
3571,775696,13,4,7,3,6,1,1,5,6,2,3,1,2,0,1,1,14
3571,776481,10,2,3,2,3,0,0,0,0,2,4,2,1,1,0,1,4
3571,798019,3,0,1,0,0,0,1,0,0,0,1,0,0,0,1,0,0
3571,798017,4,0,1,0,0,0,1,0,0,1,0,0,1,0,1,0,0
3571,798008,20,0,6,0,3,0,3,4,4,0,3,2,0,1,0,0,4
3571,792358,15,3,6,2,3,1,3,2,2,0,3,1,0,1,0,0,9
3571,798018,1,0,0,0,0,0,0,0,0,0,0,0,0,0,0,0,0
3571,798026,1,0,0,0,0,0,0,0,0,0,0,0,0,0,0,0,0
3580,785996,21,0,4,0,4,0,0,4,4,4,7,0,0,0,0,1,4
3580,780858,27,2,5,2,4,0,1,0,0,3,5,1,2,1,4,1,4
3580,797646,29,5,10,5,9,0,1,2,2,0,4,4,1,2,2,0,12
3580,780849,27,0,10,0,1,0,9,0,0,3,1,1,0,1,0,0,0
3580,780853,19,0,1,0,1,0,0,0,0,0,2,1,4,1,3,0,0
3580,792039,26,6,9,5,7,1,2,3,6,1,1,2,1,0,2,0,16
3580,785990,18,4,10,2,5,2,5,2,2,0,0,1,1,1,2,0,12
3580,792235,11,0,1,0,1,0,0,0,0,0,1,0,1,0,1,0,0
3580,785998,11,0,3,0,0,0,3,0,0,1,0,0,0,0,0,0,0
3580,791374,6,1,1,1,1,0,0,1,2,0,1,0,0,0,0,0,3
3580,786010,5,0,1,0,0,0,1,0,0,0,0,0,1,0,0,0,0
3581,792277,14,0,1,0,1,0,0,0,0,3,0,1,1,0,1,0,0
3581,786516,24,5,9,2,2,3,7,0,0,0,2,0,1,1,0,1,13
3581,785282,25,1,6,1,4,0,2,0,0,0,2,0,0,1,2,0,2
3581,781502,32,4,9,1,5,3,4,2,2,0,7,6,2,0,4,0,13
3581,780259,26,6,12,5,9,1,3,2,2,2,4,3,4,4,2,1,15
3581,781501,26,4,5,4,5,0,0,2,2,1,3,3,1,2,2,0,10
3581,785913,24,4,10,4,10,0,0,0,0,1,4,2,2,1,2,0,8
3581,798058,6,0,1,0,1,0,0,0,0,0,0,0,0,0,0,0,0
3581,781464,23,0,3,0,1,0,2,0,0,1,3,3,3,1,1,0,0
3582,792181,17,1,2,0,0,1,2,0,0,0,5,0,4,0,2,1,3
3582,780986,40,3,5,3,5,0,0,3,3,2,4,4,2,2,2,0,9
3582,785902,37,6,16,3,7,3,9,0,0,2,6,4,2,3,3,2,15
3582,792179,32,3,11,1,3,2,8,0,0,0,4,6,4,2,4,0,8
3582,786662,32,3,12,1,2,2,10,0,0,2,0,3,1,2,0,0,8
3582,797796,19,2,7,2,3,0,4,1,2,1,2,1,2,2,1,0,5
3582,786661,20,4,7,0,2,4,5,0,0,0,1,0,2,1,0,1,12
3582,797794,3,0,0,0,0,0,0,0,0,0,0,0,1,0,0,1,0
3583,791877,22,2,4,2,4,0,0,1,1,2,1,0,1,0,2,0,5
3583,797491,27,1,6,1,4,0,2,0,0,4,4,1,1,0,0,0,2
3583,785667,37,5,15,1,4,4,11,0,0,0,2,1,3,0,3,0,14
3583,786572,38,4,8,3,5,1,3,3,6,4,10,3,3,0,6,0,12
3583,786570,25,3,14,1,7,2,7,4,5,1,3,7,2,3,1,0,12
3583,781205,21,4,6,4,6,0,0,0,0,1,3,0,1,0,2,0,8
3583,797486,27,4,10,4,6,0,4,2,4,3,4,1,1,0,2,0,10
3583,791878,3,0,2,0,1,0,1,0,0,0,0,0,0,0,0,0,0
3584,791534,29,6,12,6,11,0,1,4,4,3,9,0,4,2,1,1,16
3584,797127,32,2,5,1,2,1,3,0,0,3,5,2,0,1,2,0,5
3584,791533,14,0,4,0,3,0,1,1,2,1,2,1,2,0,2,0,1
3584,791528,34,5,10,3,6,2,4,5,6,0,5,1,4,0,3,0,17
3584,775045,38,6,13,5,11,1,2,4,4,0,3,3,2,3,3,0,17
3584,791531,26,4,5,3,3,1,2,1,3,2,2,0,3,1,0,0,10
3584,791529,16,2,4,1,1,1,3,0,0,0,1,1,1,0,0,0,5
3584,797124,11,1,2,1,2,0,0,0,1,0,0,0,1,0,1,0,2
3585,781342,35,3,10,3,7,0,3,5,8,2,3,0,3,0,3,1,11
3585,781593,27,4,9,2,4,2,5,0,1,3,5,1,4,1,1,0,10
3585,790901,28,5,8,5,6,0,2,5,5,0,1,3,3,3,3,0,15
3585,785452,30,1,4,1,1,0,3,0,0,1,3,2,1,1,0,0,2
3585,781620,28,1,5,0,1,1,4,0,0,0,3,3,3,1,1,0,3
3585,790902,15,2,3,2,2,0,1,3,3,0,2,1,0,0,1,0,7
3585,790903,29,7,14,1,2,6,12,3,3,0,3,0,2,1,1,0,23
3585,796450,6,0,1,0,1,0,0,0,0,0,3,0,1,0,0,0,0
3585,790904,1,0,0,0,0,0,0,0,0,0,0,0,1,0,0,0,0
3585,796452,1,0,0,0,0,0,0,0,0,0,0,0,0,0,0,0,0
3586,791295,33,5,9,5,9,0,0,3,4,3,6,0,0,0,1,0,13
3586,776345,24,5,14,5,13,0,1,2,2,1,5,0,1,0,1,3,12
3586,791293,23,1,3,1,3,0,0,0,0,0,2,3,2,0,2,0,2
3586,796579,33,4,9,1,1,3,8,1,2,0,1,1,1,2,2,0,12
3586,785794,30,1,6,1,6,0,0,4,4,1,2,0,4,2,5,0,6
3586,781379,4,0,0,0,0,0,0,0,0,0,0,0,0,1,2,0,0
3586,791292,6,1,3,1,3,0,0,0,2,2,1,1,0,1,0,0,2
3586,796580,9,1,2,1,2,0,0,0,0,1,1,0,1,0,2,0,2
3586,785792,15,1,4,1,3,0,1,0,0,1,0,1,0,0,0,0,2
3586,781373,23,2,6,1,1,1,5,5,6,2,5,1,4,3,1,0,10
3587,786746,27,4,9,3,6,1,3,3,4,1,2,3,2,3,0,0,12
3587,780178,19,2,6,2,6,0,0,0,0,1,2,0,3,0,1,0,4
3587,792376,35,10,23,8,14,2,9,1,2,1,9,2,1,3,4,0,23
3587,797883,29,2,4,1,2,1,2,2,2,1,1,2,3,1,3,0,7
3587,797890,15,2,3,0,0,2,3,0,0,0,1,1,2,1,0,0,6
3587,792378,19,1,3,1,3,0,0,2,3,2,2,0,3,0,3,2,4
3587,792374,13,2,4,2,4,0,0,0,0,0,1,2,0,2,1,0,4
3587,786747,18,1,1,1,1,0,0,0,1,0,3,0,2,0,2,1,2
3587,775075,25,2,5,2,5,0,0,0,0,2,3,2,2,1,0,1,4
3588,780890,30,3,12,3,6,0,6,3,3,1,4,3,0,0,0,0,9
3588,775757,23,4,7,4,7,0,0,2,2,2,2,0,3,2,1,0,10
3588,791123,32,0,2,0,0,0,2,0,0,0,1,4,1,0,2,0,0
3588,786066,39,8,15,5,9,3,6,2,2,1,4,6,2,2,5,1,21
3588,785636,38,4,8,1,3,3,5,0,1,1,9,8,1,2,2,0,11
3588,791119,4,0,0,0,0,0,0,0,1,1,1,0,1,0,1,0,0
3588,775574,34,8,16,2,8,6,8,0,0,0,3,0,2,3,2,0,22
3589,775747,12,4,6,4,6,0,0,2,2,1,0,0,0,0,2,1,10
3589,786578,21,1,3,1,2,0,1,0,0,0,3,1,3,1,2,2,2
3589,797358,23,2,7,1,3,1,4,0,0,0,3,2,2,2,2,0,5
3589,785669,23,1,7,1,2,0,5,0,0,0,5,3,2,1,0,0,2
3589,775195,23,4,7,1,1,3,6,0,0,0,0,1,0,0,3,1,11
3589,786136,16,2,4,2,3,0,1,0,0,1,3,0,3,2,2,0,4
3589,797357,9,0,0,0,0,0,0,0,0,0,1,1,1,0,1,0,0
3589,786138,31,8,15,7,10,1,5,1,3,1,3,2,1,2,1,0,18
3589,785416,30,6,12,6,10,0,2,1,1,4,9,2,2,0,2,0,13
3589,776236,12,1,1,1,1,0,0,1,1,2,0,1,2,0,1,0,3
3590,797142,31,2,3,2,3,0,0,1,2,3,2,0,3,2,0,0,5
3590,791522,40,6,9,4,7,2,2,3,10,1,6,3,4,0,9,0,17
3590,786351,33,5,12,3,7,2,5,1,3,4,7,0,1,2,0,0,13
3590,797146,35,5,17,4,9,1,8,15,16,0,3,1,3,3,2,0,26
3590,797143,39,7,13,2,3,5,10,2,2,0,5,4,2,6,4,0,21
3590,785816,16,1,3,1,3,0,0,0,0,3,0,0,1,5,0,1,2
3590,797147,8,0,5,0,3,0,2,0,0,0,0,0,0,1,0,1,0
3590,791520,9,1,1,1,1,0,0,0,0,0,0,1,3,0,0,0,2
3590,797144,6,1,2,1,1,0,1,0,0,0,0,0,1,0,1,0,2
3590,786348,8,3,5,3,3,0,2,0,0,3,0,1,0,0,0,0,6
3591,791302,33,6,11,6,8,0,3,2,5,3,7,4,4,3,4,1,14
3591,781622,39,4,12,1,1,3,11,0,0,1,6,0,4,1,1,1,11
3591,791309,41,7,15,4,7,3,8,4,6,1,2,10,2,2,6,0,21
3591,785835,28,4,12,4,11,0,1,0,0,5,4,0,3,0,6,0,8
3591,776334,41,8,14,2,3,6,11,3,3,1,5,3,3,2,1,0,25
3591,775862,25,4,6,4,5,0,1,1,1,1,2,1,5,1,3,0,9
3591,791301,11,1,1,1,1,0,0,2,3,0,1,0,0,1,1,2,4
3591,796602,3,0,0,0,0,0,0,0,0,0,0,0,2,0,0,0,0
3591,796604,4,0,0,0,0,0,0,0,0,0,0,1,0,0,0,0,0
3592,791440,8,0,1,0,1,0,0,0,0,0,2,0,3,0,0,1,0
3592,797013,36,6,19,3,9,3,10,7,9,1,2,2,1,0,1,0,22
3592,791441,22,1,1,1,1,0,0,2,2,0,1,1,1,0,1,0,4
3592,781378,33,5,9,2,5,3,4,0,0,1,9,0,1,1,2,3,13
3592,775267,25,1,6,1,3,0,3,3,3,0,0,2,3,2,1,0,5
3592,791443,16,0,3,0,1,0,2,3,5,0,2,0,3,0,1,0,3
3592,781629,3,0,0,0,0,0,0,0,0,0,0,0,0,0,0,0,0
3592,775739,14,0,1,0,1,0,0,0,0,1,3,0,3,0,3,2,0
3592,797015,25,5,9,5,9,0,0,2,3,0,3,0,3,3,4,3,12
3592,797019,18,2,2,2,2,0,0,0,0,0,1,3,2,0,2,0,4
3593,786805,33,5,15,5,14,0,1,0,0,5,8,3,1,0,0,0,10
3593,774936,16,3,4,3,4,0,0,1,1,0,6,1,1,0,2,2,7
3593,790932,33,6,13,5,9,1,4,0,0,2,2,0,3,2,4,0,13
3593,781345,24,0,2,0,0,0,2,2,2,1,1,3,3,1,1,0,2
3593,786803,32,2,7,2,4,0,3,3,3,2,1,2,2,1,1,0,7
3593,790934,6,1,1,1,1,0,0,0,0,0,1,0,4,0,0,0,2
3593,786804,23,5,9,3,4,2,5,3,4,2,6,3,2,1,2,0,15
3593,796487,8,0,3,0,1,0,2,0,0,0,0,2,1,0,0,0,0
3593,790931,10,2,3,2,3,0,0,0,0,1,1,1,2,0,1,0,4
3593,790933,14,3,8,3,3,0,5,0,1,0,1,2,1,1,2,1,6
3593,780033,1,0,0,0,0,0,0,0,0,0,0,0,0,0,0,0,0
3594,781208,18,1,3,1,3,0,0,1,2,1,2,0,2,0,3,1,3
3594,775489,22,2,3,2,3,0,0,0,0,1,5,0,4,1,1,1,4
3594,785561,29,7,8,7,8,0,0,7,9,0,3,1,3,0,1,0,21
3594,780313,35,10,18,9,14,1,4,4,6,2,3,9,3,1,4,0,25
3594,780766,0,0,0,0,0,0,0,0,0,0,0,0,0,0,0,0,0
3594,780758,16,3,6,3,6,0,0,0,0,2,5,0,0,1,0,2,6
3594,796751,4,0,1,0,1,0,0,0,0,0,1,0,1,0,1,0,0
3594,791088,21,2,4,0,1,2,3,0,0,0,1,0,0,0,1,0,6
3594,785560,23,3,7,2,2,1,5,0,0,0,1,1,2,1,0,0,7
3594,785563,32,3,4,3,4,0,0,5,5,0,3,2,2,1,2,1,11
3595,786460,30,2,4,2,4,0,0,4,4,1,3,2,2,3,2,0,8
3595,791766,20,1,3,1,2,0,1,0,0,0,3,3,5,0,1,0,2
3595,780604,32,5,15,5,13,0,2,1,3,3,3,3,5,1,3,0,11
3595,780603,27,6,12,2,2,4,10,4,5,0,3,2,2,4,1,0,20
3595,780602,40,8,19,7,16,1,3,3,4,4,6,3,2,0,0,0,20
3595,786071,6,0,0,0,0,0,0,2,2,1,0,0,0,0,0,0,2
3595,791768,4,0,0,0,0,0,0,0,0,0,0,0,2,0,0,0,0
3595,791767,10,0,4,0,1,0,3,3,4,0,1,0,1,2,0,0,3
3595,786230,24,4,11,1,6,3,5,2,2,0,0,0,1,0,1,0,13
3595,780605,7,0,0,0,0,0,0,0,0,1,0,0,0,0,0,0,0
3596,780747,31,3,7,3,6,0,1,4,4,0,4,3,3,2,3,0,10
3596,776363,17,1,7,1,5,0,2,0,0,0,0,1,0,3,3,0,2
3596,776014,36,3,7,3,6,0,1,5,10,3,13,1,3,1,4,1,11
3596,797690,28,6,10,6,8,0,2,4,6,2,2,3,3,1,3,0,16
3596,791949,21,0,6,0,5,0,1,5,6,3,7,0,2,0,3,1,5
3596,797691,28,5,10,5,10,0,0,1,3,1,4,2,2,1,1,0,11
3596,784336,15,3,5,3,5,0,0,1,3,3,5,0,2,1,1,2,7
3596,785304,14,1,5,1,2,0,3,0,0,0,0,1,2,1,0,0,2
3596,781539,8,1,4,1,4,0,0,1,2,1,3,0,1,0,1,1,3
3596,791946,2,1,3,1,1,0,2,0,0,0,0,0,1,1,0,0,2
3597,797708,17,1,5,1,4,0,1,0,0,0,2,5,3,2,1,0,2
3597,776327,11,0,0,0,0,0,0,0,0,0,3,0,3,0,1,1,0
3597,797709,14,3,5,2,4,1,1,0,0,0,0,0,3,0,3,0,7
3597,792104,34,4,14,3,10,1,4,6,6,3,6,2,5,1,3,1,15
3597,786198,32,3,12,2,9,1,3,1,3,0,3,1,2,1,1,3,8
3597,775779,29,8,15,7,12,1,3,0,2,0,2,1,1,1,3,0,17
3597,797707,23,1,5,0,1,1,4,1,2,1,2,6,5,2,3,0,4
3597,785608,19,3,6,3,5,0,1,0,0,4,5,2,4,1,0,3,6
3597,786204,18,1,5,1,4,0,1,0,2,0,5,0,2,1,0,0,2
3597,792106,3,0,0,0,0,0,0,0,0,0,2,0,0,0,1,0,0
3598,779993,37,4,10,3,7,1,3,3,4,1,2,6,3,3,1,0,12
3598,796322,6,0,2,0,2,0,0,0,2,2,1,0,1,0,0,0,0
3598,796319,32,5,15,4,9,1,6,3,4,4,4,2,2,3,4,2,14
3598,790764,32,7,15,4,9,3,6,0,3,6,5,1,4,0,2,1,17
3598,796320,32,5,8,5,7,0,1,2,4,1,1,6,3,2,4,0,12
3598,796321,18,0,2,0,0,0,2,0,0,0,1,0,1,2,1,1,0
3598,790761,30,8,13,6,10,2,3,7,8,1,3,1,1,4,0,0,25
3598,785219,12,1,2,0,1,1,1,0,0,1,0,0,2,0,1,0,3
3598,796323,1,0,0,0,0,0,0,0,0,1,0,0,0,0,0,0,0
3599,790771,27,10,13,6,7,4,6,0,2,3,1,0,4,0,2,3,24
3599,796328,34,5,7,4,6,1,1,1,2,3,5,3,3,2,3,0,12
3599,780375,23,6,9,4,6,2,3,2,2,0,3,1,5,1,1,0,16
3599,780271,35,5,9,5,7,0,2,2,3,2,3,1,1,1,3,3,12
3599,790772,38,3,9,3,7,0,2,4,4,1,4,4,0,1,7,0,10
3599,785230,25,2,8,0,6,2,2,0,0,0,1,4,3,0,4,0,6
3599,780218,18,1,2,1,2,0,0,0,0,1,6,2,2,1,1,1,2
3600,785714,18,3,5,3,5,0,0,3,4,0,3,3,2,1,0,1,9
3600,775894,30,8,12,5,7,3,5,0,0,0,2,2,0,4,3,0,19
3600,785711,20,4,6,1,2,3,4,0,0,0,3,4,2,0,1,0,11
3600,780985,24,1,2,0,0,1,2,0,0,0,1,1,2,1,0,0,3
3600,775266,28,5,9,3,5,2,4,2,2,0,3,2,1,1,3,0,14
3600,796829,15,3,3,3,3,0,0,0,0,2,5,0,2,1,1,2,6
3600,785378,12,3,7,1,3,2,4,0,0,1,1,1,1,0,0,0,8
3600,791167,15,3,3,3,3,0,0,2,2,0,2,1,2,2,2,0,8
3600,779994,13,2,4,1,3,1,1,1,2,1,2,0,0,1,0,0,6
3600,785710,6,0,0,0,0,0,0,0,0,0,0,1,0,0,2,0,0
3600,780988,6,1,1,0,0,1,1,0,0,0,3,1,0,0,0,1,3
3600,796827,5,1,2,1,1,0,1,0,0,0,1,0,2,0,0,0,2
3600,791169,4,0,2,0,1,0,1,0,0,1,0,0,2,0,1,0,0
3600,796826,4,0,1,0,0,0,1,0,0,0,0,0,0,0,0,0,0
3601,780765,29,5,12,4,9,1,3,3,3,1,4,2,0,1,1,2,14
3601,786255,29,2,7,2,5,0,2,6,6,0,2,2,2,1,3,0,10
3601,780755,25,1,7,1,4,0,3,4,8,1,2,0,0,0,2,0,6
3601,780762,32,4,11,3,8,1,3,0,0,0,0,0,1,2,1,0,9
3601,780768,25,0,3,0,1,0,2,0,2,0,1,1,1,2,5,0,0
3601,791729,17,1,1,1,1,0,0,1,4,2,0,0,4,1,1,0,3
3601,781301,23,2,3,2,3,0,0,0,2,2,1,0,2,0,1,2,4
3601,790864,8,0,2,0,0,0,2,2,2,3,0,0,0,1,2,0,2
3601,797320,8,2,4,1,2,1,2,0,0,0,1,0,0,1,1,0,5
3601,798260,3,0,1,0,0,0,1,0,0,0,0,1,0,1,0,0,0
3601,776241,1,0,0,0,0,0,0,0,0,0,0,0,0,0,0,0,0
3602,790914,21,4,5,4,5,0,0,2,3,2,4,0,4,0,3,1,10
3602,780798,30,2,6,0,1,2,5,0,0,5,3,5,1,1,0,2,6
3602,785455,34,5,15,0,4,5,11,0,2,0,6,4,0,1,1,0,15
3602,785453,33,10,22,7,13,3,9,7,8,2,3,2,1,2,2,0,30
3602,774940,26,1,5,1,3,0,2,0,0,0,2,3,2,1,6,0,2
3602,796458,5,0,2,0,1,0,1,0,0,0,1,0,1,0,0,0,0
3602,790911,9,2,3,2,2,0,1,0,0,2,0,0,1,0,0,0,4
3602,790915,18,3,4,3,4,0,0,0,0,4,5,1,4,0,0,2,6
3602,790913,20,2,7,2,6,0,1,1,2,2,3,2,2,2,3,0,5
3602,790912,2,0,0,0,0,0,0,0,0,0,0,0,0,0,0,0,0
3602,790867,2,0,0,0,0,0,0,0,0,0,0,0,0,0,0,0,0
3603,792565,34,10,15,10,15,0,0,8,9,1,5,1,0,1,1,0,28
3603,776333,7,0,0,0,0,0,0,0,0,0,2,1,4,0,1,0,0
3603,798133,16,2,5,0,0,2,5,0,0,0,2,0,1,0,0,0,6
3603,792563,28,4,10,1,3,3,7,2,2,2,1,5,3,1,5,0,13
3603,792561,29,1,10,1,4,0,6,1,2,0,2,1,0,1,3,0,3
3603,792560,9,0,0,0,0,0,0,1,2,0,1,0,3,0,2,0,1
3603,798132,16,0,1,0,0,0,1,0,0,0,5,0,2,0,0,0,0
3603,798134,11,0,3,0,2,0,1,0,0,0,0,2,1,0,4,0,0
3603,789634,4,0,0,0,0,0,0,0,0,0,0,0,2,0,0,0,0
3603,780270,19,0,1,0,0,0,1,0,0,0,3,0,0,2,2,1,0
3603,780266,20,0,5,0,1,0,4,2,2,0,0,1,0,2,1,0,2
3603,785472,2,0,0,0,0,0,0,1,2,0,1,0,1,0,0,0,1
3603,798135,5,0,0,0,0,0,0,0,0,0,0,0,2,2,0,0,0
3604,775224,16,0,3,0,3,0,0,1,2,2,6,3,0,0,1,1,1
3604,778046,29,2,10,2,6,0,4,4,4,0,4,3,1,3,2,1,8
3604,775793,34,6,11,2,5,4,6,1,2,0,4,0,3,0,1,1,17
3604,782121,32,4,10,4,6,0,4,0,0,0,1,4,3,1,2,0,8
3604,785298,13,1,2,1,2,0,0,0,0,4,2,0,3,0,0,1,2
3604,785485,24,2,3,2,3,0,0,2,2,1,3,0,2,0,2,1,6
3604,785302,21,6,10,4,6,2,4,2,2,1,5,3,2,1,1,0,16
3604,786594,22,6,8,3,3,3,5,0,0,0,0,0,3,0,3,0,15
3604,796598,9,1,1,0,0,1,1,0,0,0,2,0,0,0,0,0,3
3605,790876,23,2,8,2,6,0,2,0,0,2,1,1,1,0,0,0,4
3605,774987,34,6,14,4,5,2,9,5,5,0,7,5,1,2,4,1,19
3605,790882,21,4,5,4,4,0,1,3,3,0,2,1,2,0,3,1,11
3605,779985,29,4,10,2,5,2,5,0,0,1,2,1,3,1,0,0,10
3605,785432,27,4,9,4,9,0,0,0,1,3,2,2,1,1,0,2,8
3605,785699,15,1,5,1,3,0,2,0,0,1,1,0,1,2,2,0,2
3605,790879,13,1,2,1,2,0,0,0,0,1,0,0,4,0,0,0,2
3605,781062,23,0,7,0,3,0,4,5,5,1,1,4,2,2,1,0,5
3605,796434,4,0,1,0,0,0,1,0,0,0,0,0,0,0,0,0,0
3605,790877,11,0,0,0,0,0,0,0,0,0,0,0,0,0,0,0,0
3606,781174,24,2,4,2,4,0,0,1,2,2,7,3,3,0,2,1,5
3606,781159,25,2,3,1,1,1,2,2,2,1,2,2,2,1,4,0,7
3606,791001,25,4,7,3,4,1,3,1,1,0,3,2,0,0,1,0,10
3606,779972,24,2,6,2,5,0,1,1,2,0,2,3,1,2,1,0,5
3606,775255,30,4,12,3,5,1,7,7,7,0,7,3,2,1,1,1,16
3606,796643,1,0,1,0,1,0,0,0,0,0,1,0,0,0,0,0,0
3606,785320,23,4,6,0,1,4,5,0,0,0,0,1,2,0,2,0,12
3606,785231,18,3,6,3,5,0,1,2,2,2,1,1,3,1,0,0,8
3606,781215,26,5,9,2,6,3,3,2,2,1,2,3,2,3,3,0,15
3606,796644,3,0,0,0,0,0,0,0,0,0,0,0,0,0,0,0,0
3606,796641,1,0,0,0,0,0,0,0,0,0,0,0,0,0,0,0,0
3607,792473,26,3,7,3,5,0,2,2,4,1,4,2,4,0,4,0,8
3607,780043,36,5,8,2,3,3,5,2,2,0,6,3,3,2,3,0,15
3607,799276,26,1,2,1,1,0,1,0,0,0,0,0,1,1,1,0,2
3607,785249,38,7,12,6,7,1,5,1,2,1,2,4,2,3,4,0,16
3607,780035,32,3,9,3,7,0,2,0,0,0,2,0,2,0,2,0,6
3607,799281,13,1,2,1,1,0,1,3,4,0,1,0,1,0,0,0,5
3607,792477,9,0,1,0,0,0,1,0,0,0,1,1,1,0,0,0,0
3607,792476,2,0,1,0,0,0,1,0,0,0,0,0,0,0,0,0,0
3607,780036,15,3,7,2,4,1,3,0,0,0,1,0,1,0,0,1,7
3607,792471,2,0,0,0,0,0,0,0,0,0,0,0,0,0,0,0,0
3607,799916,1,0,0,0,0,0,0,0,0,0,0,0,0,0,0,0,0
3614,791344,37,4,7,4,6,0,1,2,3,2,8,2,1,1,1,1,10
3614,781425,33,7,10,7,10,0,0,5,5,2,6,0,3,2,4,1,19
3614,791343,39,7,10,6,8,1,2,0,2,0,1,8,3,0,5,0,15
3614,781602,45,5,19,2,9,3,10,2,3,0,6,3,3,2,3,0,15
3614,775746,42,4,9,3,4,1,5,4,4,1,2,2,1,2,1,0,13
3614,781601,12,2,3,2,3,0,0,0,0,1,1,1,1,2,0,0,4
3614,797001,10,1,2,1,1,0,1,0,0,0,2,1,0,0,0,0,2
3614,797000,7,0,3,0,2,0,1,0,0,0,1,0,1,1,1,0,0
3615,797591,21,3,8,3,4,0,4,0,1,0,1,1,0,1,0,0,6
3615,781071,26,7,10,3,5,4,5,0,0,0,6,2,4,0,2,0,18
3615,797589,36,4,12,4,6,0,6,1,3,1,5,2,1,1,3,0,9
3615,791890,43,5,12,5,7,0,5,1,2,0,1,9,2,4,5,0,11
3615,780719,43,7,10,3,5,4,5,2,2,1,6,6,5,3,3,0,20
3615,797590,0,0,0,0,0,0,0,0,0,0,0,0,0,0,0,0,0
3615,797588,12,2,2,1,1,1,1,0,0,0,1,0,0,0,0,0,5
3615,791889,36,4,7,4,5,0,2,1,1,0,8,3,4,1,0,0,9
3615,791888,8,1,1,0,0,1,1,0,0,0,0,1,0,0,1,0,3
3616,786041,28,4,7,4,6,0,1,1,2,1,9,0,2,1,3,0,9
3616,780275,20,4,5,4,5,0,0,0,0,1,2,0,2,0,1,1,8
3616,780881,29,2,11,2,7,0,4,0,0,0,4,4,3,0,0,0,4
3616,786686,34,5,12,5,10,0,2,4,5,0,3,14,1,1,4,0,14
3616,792075,23,5,7,3,4,2,3,0,1,0,2,0,2,0,0,0,12
3616,780052,31,4,10,2,3,2,7,0,0,0,6,0,2,2,1,0,10
3616,785437,18,3,5,3,5,0,0,3,6,1,1,1,1,1,0,3,9
3616,792074,17,1,5,0,1,1,4,0,0,0,1,0,2,1,2,0,3
3617,785366,34,1,7,1,4,0,3,0,0,0,9,12,1,1,3,0,2
3617,796778,25,5,10,4,8,1,2,3,4,1,4,2,2,1,1,4,14
3617,780863,33,5,14,5,13,0,1,2,4,1,3,4,3,2,2,2,12
3617,791974,30,5,6,1,1,4,5,0,0,1,3,2,3,2,2,1,14
3617,791972,31,7,13,4,5,3,8,1,1,1,9,1,1,0,1,0,18
3617,781107,8,0,1,0,1,0,0,0,0,0,0,0,2,0,1,0,0
3617,791971,18,4,7,3,4,1,3,4,5,1,2,1,2,0,2,0,13
3617,780867,12,0,1,0,1,0,0,0,0,1,2,0,2,1,0,0,0
3617,796777,6,0,1,0,1,0,0,0,0,0,0,0,1,1,3,0,0
3617,796780,3,1,1,0,0,1,1,0,0,0,0,0,0,0,0,0,3
3618,797876,10,2,2,2,2,0,0,0,0,2,2,1,3,0,2,1,4
3618,781319,22,3,7,2,6,1,1,6,9,2,4,1,1,0,1,1,13
3618,781408,20,4,6,3,4,1,2,3,4,0,2,3,5,2,2,0,12
3618,786693,24,4,9,2,5,2,4,1,3,0,2,2,1,2,1,1,11
3618,781455,24,2,3,2,2,0,1,3,3,0,1,5,1,0,2,0,7
3618,792219,10,3,5,3,5,0,0,0,0,1,2,2,1,0,1,0,6
3618,792222,18,2,5,1,1,1,4,3,3,2,1,5,1,0,1,0,8
3618,786656,12,2,2,2,2,0,0,3,6,1,4,0,4,0,1,4,7
3618,786843,13,0,3,0,3,0,0,2,2,0,2,0,3,0,0,0,2
3618,792046,24,8,11,4,5,4,6,0,0,1,3,2,3,1,6,0,20
3618,792447,3,0,1,0,1,0,0,0,0,1,0,0,0,0,1,0,0
3618,792220,20,2,3,1,2,1,1,1,2,2,4,3,4,0,1,0,6
3620,792593,43,9,16,8,14,1,2,1,4,5,7,1,4,0,4,2,20
3620,792594,34,8,11,7,9,1,2,0,0,2,7,0,4,1,4,1,17
3620,792588,35,4,8,1,1,3,7,0,0,0,0,4,2,4,0,0,11
3620,792595,42,8,15,7,12,1,3,2,2,2,3,6,0,5,1,0,19
3620,792583,22,4,7,1,1,3,6,0,0,0,2,0,3,1,1,0,11
3620,796989,2,0,0,0,0,0,0,0,0,0,0,0,0,0,0,0,0
3620,796987,26,7,13,7,10,0,3,3,5,1,0,3,2,2,1,0,17
3620,792591,21,1,2,1,1,0,1,0,1,0,2,1,1,2,1,0,2
3621,797380,36,6,9,4,5,2,4,4,5,0,3,2,1,0,0,0,18
3621,789043,16,1,4,1,4,0,0,2,2,2,3,0,2,0,2,1,4
3621,791818,44,11,24,4,8,7,16,7,8,2,4,4,0,0,3,1,36
3621,786636,40,4,8,2,2,2,6,0,0,0,0,5,4,3,5,0,10
3621,780646,35,2,8,1,3,1,5,2,2,1,3,4,3,2,6,0,7
3621,797382,9,2,4,2,4,0,0,0,0,1,2,0,1,0,2,0,4
3621,797379,29,3,5,3,5,0,0,0,2,5,9,4,1,1,2,0,6
3621,797378,3,1,1,1,1,0,0,0,0,0,0,0,1,0,2,0,2
3621,797377,13,1,1,0,0,1,1,0,0,1,1,3,2,0,0,0,3
3622,791581,29,4,9,2,3,2,6,0,0,0,2,2,0,0,0,0,10
3622,786394,28,7,14,5,6,2,8,1,2,1,4,5,0,0,2,1,17
3622,791585,31,5,15,4,9,1,6,2,4,3,5,4,0,3,2,0,13
3622,780062,15,0,2,0,2,0,0,0,0,0,2,1,1,0,1,0,0
3622,786395,29,4,8,1,1,3,7,0,0,0,5,3,1,1,2,0,11
3622,780404,17,1,4,0,2,1,2,0,0,0,1,1,1,0,6,0,3
3622,797041,10,1,1,0,0,1,1,0,0,0,0,2,4,0,0,0,3
3622,785228,16,1,2,1,1,0,1,0,0,0,0,0,2,0,0,0,2
3622,780403,4,0,0,0,0,0,0,0,0,0,0,0,1,0,1,0,0
3622,797037,9,3,3,1,1,2,2,0,0,0,1,0,0,0,0,0,8
3622,799920,11,0,2,0,0,0,2,0,0,0,4,0,0,0,1,0,0
3622,797042,1,0,0,0,0,0,0,0,0,0,0,0,0,0,1,0,0
3623,786176,17,3,6,3,4,0,2,0,1,1,3,0,0,0,0,0,6
3623,774828,33,6,10,0,1,6,9,0,0,0,4,2,0,0,1,0,18
3623,780028,26,2,6,0,2,2,4,0,0,0,5,10,2,1,0,0,6
3623,786173,18,1,3,1,2,0,1,0,0,0,1,1,1,0,0,0,2
3623,780027,29,9,14,7,10,2,4,4,4,3,4,4,3,0,4,0,24
3623,791379,19,4,6,2,4,2,2,0,0,1,2,1,0,0,0,0,10
3623,791380,15,2,6,2,5,0,1,0,0,0,2,1,1,6,2,0,4
3623,797175,21,6,9,6,8,0,1,0,1,0,5,0,0,1,1,2,12
3623,780029,17,2,6,1,4,1,2,0,0,1,5,3,3,1,3,0,5
3623,797178,1,0,0,0,0,0,0,0,0,0,0,0,0,0,0,0,0
3623,797179,2,0,0,0,0,0,0,0,0,0,0,0,0,0,0,0,0
3623,797176,2,1,1,1,1,0,0,0,0,0,0,0,0,0,0,0,2
3624,791144,16,0,1,0,1,0,0,2,6,0,0,2,1,0,2,1,2
3624,785782,31,1,5,1,2,0,3,0,0,0,6,0,2,0,0,2,2
3624,791145,32,5,12,2,5,3,7,5,5,1,4,1,1,0,0,2,18
3624,791146,36,8,15,5,9,3,6,6,7,0,6,4,1,0,3,0,25
3624,785777,31,5,9,0,1,5,8,0,0,0,2,3,4,2,3,0,15
3624,791147,15,3,5,2,4,1,1,3,4,1,5,0,3,0,1,1,10
3624,796804,6,0,1,0,1,0,0,0,0,0,1,0,1,0,0,0,0
3624,791148,18,0,5,0,0,0,5,0,0,2,2,1,1,0,1,0,0
3624,786748,15,1,2,1,2,0,0,0,0,0,2,2,1,1,0,1,2
3625,796473,19,4,4,4,4,0,0,0,0,2,5,2,5,0,2,0,8
3625,781560,30,4,7,4,7,0,0,1,2,5,7,1,2,1,0,1,9
3625,791375,34,4,10,1,2,3,8,0,1,1,1,3,2,1,1,0,11
3625,785482,36,10,26,8,16,2,10,1,2,0,6,0,3,3,0,0,23
3625,780837,33,2,11,1,7,1,4,6,9,0,5,3,1,2,2,0,11
3625,786164,16,0,1,0,1,0,0,0,0,0,3,2,3,0,1,0,0
3625,796477,17,3,7,2,4,1,3,0,0,0,3,1,5,1,3,0,7
3625,796476,15,1,1,1,1,0,0,0,0,3,2,0,3,0,1,0,2
3626,797587,16,3,4,3,4,0,0,2,2,2,3,0,5,0,3,0,8
3626,791894,4,0,0,0,0,0,0,0,0,0,0,0,0,0,0,0,0
3626,786502,40,7,19,6,15,1,4,9,10,1,5,6,3,1,3,0,24
3626,781561,13,0,2,0,1,0,1,0,0,1,0,1,2,1,0,0,0
3626,781080,1,0,0,0,0,0,0,0,0,0,0,0,0,0,0,0,0
3626,791891,22,2,5,2,5,0,0,0,0,5,2,2,4,0,1,2,4
3626,786501,36,3,9,0,2,3,7,0,0,0,1,1,3,1,1,0,9
3626,781078,30,6,14,3,9,3,5,0,0,2,3,0,1,0,0,0,15
3626,797584,20,1,3,1,3,0,0,0,0,0,2,2,3,1,0,0,2
3626,791895,18,1,1,0,0,1,1,4,5,0,1,0,4,0,0,0,7
3627,785509,35,4,8,2,4,2,4,2,2,0,6,1,2,0,2,1,12
3627,791424,16,1,5,0,3,1,2,0,2,0,2,1,3,0,2,0,3
3627,797085,29,5,9,3,4,2,5,5,6,1,5,3,3,0,2,0,17
3627,785899,36,2,6,2,2,0,4,3,3,4,1,4,2,2,2,0,7
3627,797079,1,0,0,0,0,0,0,0,0,0,0,0,0,0,0,0,0
3627,791425,23,3,3,3,3,0,0,2,2,2,2,0,3,0,0,1,8
3627,797090,5,1,2,1,2,0,0,0,0,0,0,0,1,0,0,0,2
3627,797088,7,0,3,0,1,0,2,0,0,1,0,0,0,0,1,0,0
3627,797087,12,2,4,2,3,0,1,0,0,1,1,1,1,0,0,0,4
3627,791421,36,5,10,5,7,0,3,10,11,1,5,3,4,2,2,0,20
3628,786509,28,3,3,3,3,0,0,2,3,3,3,2,3,2,5,0,8
3628,786508,36,4,15,2,6,2,9,1,7,2,9,1,3,1,2,2,11
3628,786507,23,2,5,1,1,1,4,3,4,0,2,0,2,1,1,0,8
3628,785796,33,5,16,5,12,0,4,2,2,1,3,1,3,0,2,0,12
3628,797576,34,7,10,1,4,6,6,0,0,0,1,3,4,0,2,0,20
3628,797577,7,1,1,1,1,0,0,0,0,0,1,0,2,0,1,1,2
3628,797582,4,0,0,0,0,0,0,0,0,0,0,0,0,0,0,0,0
3628,791897,10,1,1,0,0,1,1,0,0,1,0,0,0,0,1,0,3
3628,786505,17,1,5,0,1,1,4,0,1,0,1,4,2,1,3,0,3
3628,781325,8,0,2,0,0,0,2,0,0,0,0,1,1,0,0,0,0
3629,791652,35,8,14,8,13,0,1,0,0,2,5,1,2,1,3,2,16
3629,786495,19,1,4,0,2,1,2,1,2,2,4,0,2,0,1,0,4
3629,797285,19,0,1,0,0,0,1,0,0,0,0,1,1,0,0,0,0
3629,791650,33,5,14,5,12,0,2,0,0,0,4,0,3,3,2,0,10
3629,776384,40,9,13,6,9,3,4,7,8,0,7,5,2,1,3,0,28
3629,791653,19,4,5,3,3,1,2,0,0,0,2,2,0,1,2,0,9
3629,775705,5,0,0,0,0,0,0,0,0,0,0,0,2,0,0,0,0
3629,797289,1,0,0,0,0,0,0,0,0,0,0,0,1,0,0,0,0
3629,797286,3,2,2,2,2,0,0,0,0,0,0,0,0,0,0,0,4
3629,797283,26,1,3,1,2,0,1,6,6,0,2,0,4,0,0,0,8
3630,791750,30,2,6,2,4,0,2,0,0,5,4,3,3,2,2,3,4
3630,786177,25,6,10,3,3,3,7,1,2,3,3,4,2,3,0,2,16
3630,780244,29,3,5,1,1,2,4,1,2,1,1,5,4,2,2,2,9
3630,786179,30,7,18,3,7,4,11,1,1,0,4,1,2,0,2,0,19
3630,780238,33,6,9,4,4,2,5,0,0,1,4,7,2,3,4,3,14
3630,791749,12,1,4,0,1,1,3,0,0,0,2,0,2,0,2,0,3
3630,791752,3,2,2,2,2,0,0,0,0,0,0,0,0,0,1,0,4
3630,790773,12,2,4,1,1,1,3,0,0,0,4,1,0,1,1,0,5
3630,781500,18,3,6,1,1,2,5,2,2,0,2,3,1,0,0,0,10
3630,785909,6,2,2,2,2,0,0,0,0,0,3,0,1,0,2,0,4
3630,786171,2,0,0,0,0,0,0,0,0,0,0,0,2,0,0,0,0
3631,797482,33,4,10,2,6,2,4,0,0,0,2,1,2,2,3,0,10
3631,797485,27,2,4,0,0,2,4,2,2,0,3,1,2,0,2,0,8
3631,797481,25,1,6,1,3,0,3,2,3,1,5,1,2,1,1,1,4
3631,797480,30,6,13,6,12,0,1,5,6,2,2,1,1,3,2,0,17
3631,785944,24,5,9,4,7,1,2,2,3,1,1,3,1,1,3,0,13
3631,797478,15,1,3,1,2,0,1,2,2,0,1,0,1,0,2,0,4
3631,791873,25,3,6,3,6,0,0,0,0,1,2,2,2,2,2,0,6
3631,781217,15,0,3,0,2,0,1,2,4,1,2,0,0,1,2,0,2
3631,797483,2,0,2,0,2,0,0,0,1,2,1,0,0,0,0,0,0
3631,786579,2,0,0,0,0,0,0,0,0,0,0,0,0,0,0,0,0
3631,797479,2,0,0,0,0,0,0,0,0,0,0,0,0,0,0,0,0
3632,792143,33,6,9,2,3,4,6,2,2,2,3,1,4,0,2,1,18
3632,797753,35,4,9,3,6,1,3,3,4,3,9,10,1,2,7,2,12
3632,786293,24,9,14,9,13,0,1,3,3,3,6,1,3,0,5,0,21
3632,780953,31,8,16,8,16,0,0,1,4,5,5,3,5,0,4,0,17
3632,797750,37,3,7,2,5,1,2,4,4,0,3,5,1,2,0,0,11
3632,797742,13,2,3,1,1,1,2,1,1,0,0,0,3,0,1,0,6
3632,792147,1,0,1,0,1,0,0,0,0,0,1,0,0,0,0,0,0
3632,786302,5,0,2,0,2,0,0,0,0,1,3,0,0,0,1,0,0
3632,797751,12,0,3,0,0,0,3,0,0,0,0,0,1,0,1,0,0
3632,797748,9,2,2,2,2,0,0,2,2,0,2,0,0,1,1,0,6
3632,786294,0,0,0,0,0,0,0,0,0,0,0,0,0,0,0,0,0
3632,796192,0,0,0,0,0,0,0,0,0,0,0,0,0,0,0,0,0
3632,786301,0,0,0,0,0,0,0,0,0,0,0,0,0,0,0,0,0
3633,786772,27,1,1,1,1,0,0,4,4,2,5,1,3,1,1,0,6
3633,781484,14,0,3,0,0,0,3,2,2,0,4,1,4,1,2,1,2
3633,791967,33,8,21,5,13,3,8,5,6,1,4,1,2,2,2,0,24
3633,786769,33,4,10,1,3,3,7,4,6,1,2,0,1,2,2,1,15
3633,786024,5,0,1,0,1,0,0,0,0,0,0,0,0,0,0,0,0
3633,786773,9,0,1,0,1,0,0,0,0,1,1,0,2,0,2,1,0
3633,790823,23,3,8,2,4,1,4,0,0,1,0,0,1,2,1,0,7
3633,780002,36,7,20,6,14,1,6,0,0,3,1,5,3,4,4,0,15
3633,791970,6,0,2,0,0,0,2,0,0,0,0,0,0,0,2,0,0
3633,785441,14,2,3,2,3,0,0,2,3,1,1,0,2,0,0,0,6
3634,797821,10,0,1,0,0,0,1,0,0,0,2,0,2,0,4,0,0
3634,792186,23,3,5,3,5,0,0,0,0,1,3,3,2,1,1,2,6
3634,797816,29,7,10,3,4,4,6,3,4,0,1,3,4,2,2,0,21
3634,792188,24,2,7,2,4,0,3,2,2,0,4,1,2,0,2,0,6
3634,792183,38,5,8,3,5,2,3,4,7,0,4,5,2,1,1,0,16
3634,781447,13,2,4,2,4,0,0,2,2,0,0,0,1,0,3,0,6
3634,780433,17,3,3,3,3,0,0,2,4,0,2,0,3,0,0,2,8
3634,781490,28,1,3,0,0,1,3,2,4,1,4,4,2,0,1,1,5
3634,792185,3,0,1,0,1,0,0,0,0,0,0,0,0,1,1,0,0
3634,786675,15,2,4,0,1,2,3,0,2,0,2,2,1,1,1,0,6
3635,797842,35,8,17,7,11,1,6,3,6,4,4,3,4,3,1,0,20
3635,797849,25,4,8,3,7,1,1,0,0,1,2,2,1,0,3,0,9
3635,779986,10,1,3,1,3,0,0,2,2,1,0,0,2,0,0,0,4
3635,786079,30,1,4,1,3,0,1,6,6,0,3,2,4,2,1,0,8
3635,797843,31,1,6,0,2,1,4,0,0,0,2,1,3,0,2,0,3
3635,797848,5,3,3,3,3,0,0,1,2,1,1,0,3,0,2,0,7
3635,781537,27,3,5,2,3,1,2,0,0,1,5,0,3,1,3,1,7
3635,797838,13,0,1,0,1,0,0,0,0,0,2,1,2,0,2,0,0
3635,797846,24,2,7,2,4,0,3,0,0,0,0,1,1,1,2,0,4
3636,786157,26,4,7,4,7,0,0,8,10,1,6,1,4,1,2,2,16
3636,780676,34,5,12,4,9,1,3,9,10,1,9,0,2,2,4,1,20
3636,791756,31,4,9,4,7,0,2,2,2,0,3,1,1,0,0,0,10
3636,780677,33,3,6,1,2,2,4,0,0,0,5,3,2,0,0,1,8
3636,780673,22,1,2,0,0,1,2,0,0,0,2,1,0,0,2,0,3
3636,786150,8,2,3,1,1,1,2,0,0,0,1,1,0,0,0,0,5
3636,775533,14,0,3,0,3,0,0,0,0,2,1,0,3,1,0,0,0
3636,797348,9,1,2,0,1,1,1,0,0,0,1,0,1,0,1,0,3
3636,780992,23,0,5,0,3,0,2,0,0,0,0,3,1,0,1,0,0
3637,791699,29,3,4,2,2,1,2,0,0,0,4,0,5,1,2,0,7
3637,797523,30,0,5,0,2,0,3,2,2,2,1,1,2,0,0,0,2
3637,785402,24,2,4,2,4,0,0,5,7,2,2,0,4,0,2,1,9
3637,792118,34,8,19,6,13,2,6,4,4,0,5,5,3,2,2,0,22
3637,782593,29,6,13,2,7,4,6,0,0,0,5,2,3,1,3,1,16
3637,785828,15,1,4,1,4,0,0,0,0,1,3,1,1,0,0,2,2
3637,791702,12,0,1,0,1,0,0,0,0,0,4,0,0,0,0,1,0
3637,797526,1,0,0,0,0,0,0,0,0,0,0,0,0,0,0,0,0
3637,791700,26,1,7,1,4,0,3,0,0,0,0,3,1,1,0,0,2
3638,796343,25,3,4,3,4,0,0,0,1,2,3,0,5,1,2,1,6
3638,796344,41,4,11,1,3,3,8,0,1,3,8,2,3,3,1,1,11
3638,790785,45,8,22,6,15,2,7,7,8,1,6,4,3,3,2,0,25
3638,796340,44,9,24,9,18,0,6,4,4,2,9,1,3,2,4,1,22
3638,781232,42,2,7,1,3,1,4,2,2,1,0,4,1,1,1,0,7
3638,780040,15,2,3,2,3,0,0,0,0,1,0,0,5,0,1,0,4
3638,790780,3,0,1,0,0,0,1,0,0,0,0,0,1,0,0,0,0
3638,796345,10,0,0,0,0,0,0,0,0,0,1,0,1,0,0,1,0
3638,790783,0,0,0,0,0,0,0,0,0,0,0,0,0,0,0,0,0
3639,780283,32,8,11,8,11,0,0,6,8,2,11,2,2,1,3,2,22
3639,790925,43,3,8,1,3,2,5,0,1,1,4,0,2,0,2,1,8
3639,791456,23,2,8,1,5,1,3,4,4,3,2,3,4,0,1,0,9
3639,785476,43,3,13,3,11,0,2,2,6,1,3,5,2,1,4,0,8
3639,785474,30,3,8,2,4,1,4,2,5,2,8,3,1,1,4,0,9
3639,780292,13,4,4,4,4,0,0,0,0,2,1,1,2,0,3,0,8
3639,796470,4,0,2,0,1,0,1,0,0,0,0,1,1,0,0,0,0
3639,785480,30,5,7,1,1,4,6,0,0,0,0,2,2,0,1,0,14
3639,790926,7,1,3,0,1,1,2,0,0,0,0,0,1,0,0,0,3
3644,791023,18,4,6,4,6,0,0,1,2,1,10,1,1,1,1,3,9
3644,791027,25,5,8,1,1,4,7,0,0,1,1,1,0,0,1,1,14
3644,791024,23,6,13,4,8,2,5,2,2,2,0,4,2,4,1,0,16
3644,781507,29,3,3,3,3,0,0,3,4,0,5,3,0,0,1,0,9
3644,777572,30,4,12,3,10,1,2,3,4,3,10,10,1,3,3,1,12
3644,796686,5,1,4,1,3,0,1,0,0,0,1,0,0,0,0,0,2
3644,791021,2,0,2,0,0,0,2,0,0,0,1,0,0,0,0,0,0
3644,791028,17,2,3,2,2,0,1,0,0,1,1,1,1,1,5,1,4
3644,791727,4,0,2,0,2,0,0,0,2,0,1,0,0,0,0,0,0
3644,796685,25,6,8,4,5,2,3,6,6,1,1,0,2,0,3,0,20
3644,796684,10,3,6,2,2,1,4,0,0,2,0,1,0,0,2,0,7
3644,796683,10,0,2,0,1,0,1,0,0,1,0,1,1,1,1,0,0
3644,791025,2,0,0,0,0,0,0,0,0,1,0,0,0,0,0,0,0
3645,791089,16,2,2,1,1,1,1,1,2,2,2,1,2,0,0,0,6
3645,791097,17,1,7,1,6,0,1,2,2,2,1,1,4,2,1,2,4
3645,796753,30,3,13,0,4,3,9,0,0,0,1,3,0,1,1,0,9
3645,791091,33,5,9,4,6,1,3,0,0,1,1,2,3,1,2,0,11
3645,791093,31,8,17,6,11,2,6,0,0,1,4,0,3,2,4,1,18
3645,785577,19,3,6,3,6,0,0,0,0,1,4,1,3,2,1,3,6
3645,791092,7,1,3,1,3,0,0,0,0,0,1,0,0,0,2,0,2
3645,796752,29,4,9,2,4,2,5,0,0,1,5,7,1,0,4,1,10
3645,791094,18,1,5,1,2,0,3,0,0,0,2,2,2,0,3,0,2
3646,780919,34,2,6,2,6,0,0,8,8,5,5,5,4,0,3,1,12
3646,775816,33,7,14,4,5,3,9,0,0,1,5,0,0,1,0,1,17
3646,785803,32,4,6,4,4,0,2,0,1,1,2,1,3,1,2,0,8
3646,780920,36,7,14,6,11,1,3,6,6,2,8,5,3,2,2,0,21
3646,780914,33,5,11,3,6,2,5,0,0,1,4,1,2,1,2,1,12
3646,796797,13,2,5,2,3,0,2,0,0,2,2,0,4,0,2,0,4
3646,791142,14,2,7,1,1,1,6,0,0,0,0,0,0,0,0,1,5
3646,791141,4,0,0,0,0,0,0,0,0,0,0,0,1,0,2,0,0
3646,796799,1,0,0,0,0,0,0,0,0,0,0,0,0,0,0,0,0
3647,780094,34,1,8,0,3,1,5,0,2,0,4,2,2,0,2,0,3
3647,775142,37,8,17,8,14,0,3,2,2,4,4,1,4,0,3,0,18
3647,790843,39,10,17,7,11,3,6,4,5,1,4,2,1,3,2,2,27
3647,786212,27,4,7,2,4,2,3,0,0,1,1,0,3,1,3,0,10
3647,781563,27,3,7,3,7,0,0,0,0,0,1,3,2,0,2,0,6
3647,790844,19,3,4,2,3,1,1,1,1,1,2,2,0,2,1,0,8
3647,792125,16,0,1,0,0,0,1,0,0,0,2,1,4,0,0,0,0
3647,790847,1,0,0,0,0,0,0,0,0,0,0,0,0,0,1,0,0
3648,785305,18,2,3,2,3,0,0,2,5,3,2,1,0,0,3,0,6
3648,785123,23,9,14,9,14,0,0,8,11,1,1,2,4,0,0,2,26
3648,790990,36,3,10,2,5,1,5,1,2,1,3,4,1,4,2,1,8
3648,789219,33,4,10,2,4,2,6,2,2,0,7,4,0,1,1,1,12
3648,785059,31,4,8,4,7,0,1,0,0,2,7,5,0,2,2,1,8
3648,796624,3,1,2,1,2,0,0,0,0,0,1,0,1,0,0,0,2
3648,796622,6,1,1,1,1,0,0,0,0,0,1,0,0,0,1,0,2
3648,796623,15,5,8,4,5,1,3,0,1,1,2,1,1,0,1,0,11
3648,790988,7,1,2,1,1,0,1,0,0,0,0,0,0,0,0,1,2
3648,785303,6,0,1,0,0,0,1,0,0,0,1,0,0,0,0,0,0
3648,785122,22,0,3,0,0,0,3,0,0,0,2,0,1,0,0,0,0
3649,775913,9,2,6,2,6,0,0,0,0,2,3,0,4,1,1,0,4
3649,797333,18,0,1,0,0,0,1,3,3,2,2,2,0,0,1,0,3
3649,797331,31,3,9,1,4,2,5,0,0,0,0,0,1,1,2,0,8
3649,791737,24,0,7,0,4,0,3,2,2,1,1,2,0,1,3,0,2
3649,780561,35,7,17,4,6,3,11,3,4,1,10,2,3,2,1,0,20
3649,791734,4,1,1,0,0,1,1,1,2,0,0,0,2,0,1,1,4
3649,781516,19,4,6,4,6,0,0,0,0,1,3,0,4,0,1,2,8
3649,797332,7,1,2,1,2,0,0,0,2,2,1,0,3,0,1,1,2
3649,786223,27,1,5,0,3,1,2,0,0,1,5,2,1,2,1,0,3
3649,786220,26,5,8,5,7,0,1,2,2,0,4,6,0,0,1,0,12
3650,791658,19,0,0,0,0,0,0,0,1,1,1,0,0,1,2,0,0
3650,780509,28,3,9,3,7,0,2,2,2,5,5,2,2,0,2,0,8
3650,797290,32,4,14,4,8,0,6,2,3,0,6,3,0,2,2,0,10
3650,797291,25,3,5,2,3,1,2,3,3,0,3,0,2,2,2,0,10
3650,786064,29,3,6,0,0,3,6,0,0,0,1,2,3,2,2,0,9
3650,797292,4,0,2,0,2,0,0,2,2,1,0,0,0,0,1,0,2
3650,785658,17,4,6,3,4,1,2,0,0,1,1,0,0,0,0,1,9
3650,797293,8,1,2,1,1,0,1,0,0,0,0,0,3,0,1,0,2
3650,791660,27,1,7,1,4,0,3,0,0,1,4,1,0,1,2,0,2
3650,791663,11,1,2,1,2,0,0,3,4,3,1,0,2,0,1,0,5
3651,792192,24,0,2,0,2,0,0,0,0,2,0,0,3,1,1,2,0
3651,797824,19,0,3,0,2,0,1,0,0,1,3,2,2,2,2,0,0
3651,797822,33,5,13,3,4,2,9,3,4,1,8,0,3,1,0,0,15
3651,792190,38,4,8,2,3,2,5,0,0,0,3,2,1,3,1,2,10
3651,781266,5,0,1,0,0,0,1,0,0,1,0,0,0,0,0,0,0
3651,775116,17,1,4,1,1,0,3,0,0,0,2,0,3,0,1,0,2
3651,797825,4,0,0,0,0,0,0,0,0,0,1,0,0,0,0,0,0
3651,792193,18,2,5,2,4,0,1,3,4,2,3,3,3,1,2,0,7
3651,792191,2,0,1,0,1,0,0,0,0,0,0,0,0,0,1,0,0
3651,786664,36,7,14,4,7,3,7,3,4,1,3,1,4,3,7,0,20
3651,791928,4,0,0,0,0,0,0,0,0,0,0,0,0,0,0,0,0
3652,775556,31,8,15,7,8,1,7,4,6,5,4,4,1,7,4,3,21
3652,780234,28,4,9,4,8,0,1,3,7,4,7,1,2,3,2,0,11
3652,786411,26,2,8,0,0,2,8,0,0,0,0,1,1,0,1,0,6
3652,780046,29,1,9,0,1,1,8,0,0,0,6,3,2,2,3,0,3
3652,781104,29,4,11,0,2,4,9,3,4,1,2,4,1,1,4,0,15
3652,781110,20,2,3,2,3,0,0,0,0,0,2,2,3,1,2,0,4
3652,797185,11,2,3,2,2,0,1,0,0,0,1,2,3,2,0,0,4
3652,786405,26,7,11,7,10,0,1,0,0,0,2,4,3,1,1,0,14
3653,786131,35,5,15,4,10,1,5,3,3,2,12,2,4,3,2,0,14
3653,780904,32,5,9,5,9,0,0,1,1,2,10,4,5,0,3,2,11
3653,797688,32,4,7,2,3,2,4,1,2,1,3,0,2,0,0,0,11
3653,786128,27,4,10,3,7,1,3,0,1,0,1,6,4,2,4,0,9
3653,775251,12,1,3,1,3,0,0,0,0,0,2,1,1,0,2,0,2
3653,797684,6,1,1,1,1,0,0,0,0,0,2,0,2,0,0,1,2
3653,797685,33,8,11,5,6,3,5,0,0,0,1,4,0,3,6,0,19
3653,797686,17,2,2,1,1,1,1,2,2,0,0,4,1,0,7,0,7
3653,792096,6,0,1,0,0,0,1,0,0,0,1,0,0,0,2,0,0
3654,780358,35,4,12,4,12,0,0,6,6,2,4,3,4,0,2,0,14
3654,775011,19,3,6,1,3,2,3,0,0,0,4,2,2,2,1,0,8
3654,776004,24,5,7,5,6,0,1,0,0,1,3,0,2,1,1,0,10
3654,780357,42,3,8,1,4,2,4,1,2,0,4,1,4,2,1,0,9
3654,775018,47,7,15,5,8,2,7,5,6,0,3,7,0,0,1,0,21
3654,790930,31,4,6,2,4,2,2,2,4,0,2,1,1,2,1,0,12
3654,796480,41,2,11,2,9,0,2,2,2,1,7,0,1,3,0,0,6
3654,776270,11,0,1,0,1,0,0,0,0,1,1,0,0,0,0,0,0
3655,791401,49,10,16,10,16,0,0,3,5,1,11,4,1,0,3,3,23
3655,780125,21,2,5,2,5,0,0,0,0,0,5,0,4,0,1,2,4
3655,797125,12,0,1,0,1,0,0,0,0,0,0,0,0,0,1,0,0
3655,785931,48,4,10,2,4,2,6,0,0,0,1,6,3,0,2,0,10
3655,780118,49,6,12,5,9,1,3,2,3,0,4,5,3,1,4,1,15
3655,786837,26,5,8,3,4,2,4,0,0,0,7,1,4,0,1,0,12
3655,797130,4,0,3,0,2,0,1,0,0,0,0,1,0,1,0,0,0
3655,797132,35,3,6,0,0,3,6,0,0,0,1,1,4,0,1,1,9
3655,797126,6,0,1,0,0,0,1,0,0,0,1,1,0,0,0,0,0
3656,791230,34,3,9,1,3,2,6,0,0,1,3,2,1,1,0,0,8
3656,785557,34,8,19,8,15,0,4,0,0,5,5,2,5,1,0,4,16
3656,791228,35,5,11,3,8,2,3,1,2,5,3,0,2,2,1,1,13
3656,796932,37,5,16,5,10,0,6,5,7,2,4,3,1,0,1,0,15
3656,781444,27,5,17,4,9,1,8,1,2,1,4,0,0,1,4,0,12
3656,796933,8,0,1,0,1,0,0,0,0,0,0,1,0,0,0,0,0
3656,791226,11,0,2,0,2,0,0,0,0,2,2,0,1,0,1,1,0
3656,791227,13,0,4,0,1,0,3,0,0,0,0,0,1,0,0,0,0
3656,785624,26,2,4,1,2,1,2,0,1,1,4,3,3,1,0,0,5
3657,791355,17,1,6,0,1,1,5,0,0,1,2,0,0,0,0,0,3
3657,791352,13,0,2,0,1,0,1,0,0,2,4,0,1,1,1,1,0
3657,797251,34,3,8,3,6,0,2,2,2,3,4,2,3,2,1,0,8
3657,797247,39,3,12,2,9,1,3,3,4,0,5,3,3,0,3,0,10
3657,776297,37,4,17,4,9,0,8,2,2,1,3,1,1,1,6,0,10
3657,797250,2,0,0,0,0,0,0,0,0,0,0,1,1,0,0,0,0
3657,791354,28,4,7,4,7,0,0,6,6,3,7,1,1,0,3,0,14
3657,786227,0,0,0,0,0,0,0,0,0,0,0,0,0,0,0,0,0
3657,780455,25,7,16,7,16,0,0,2,5,8,8,1,2,0,1,4,16
3657,797249,6,1,1,1,1,0,0,0,0,1,2,0,0,0,1,0,2
3657,797248,24,1,3,0,0,1,3,0,0,0,2,0,4,0,1,0,3
3658,791225,17,2,4,2,4,0,0,0,0,3,0,3,2,0,4,1,4
3658,775324,14,2,5,2,5,0,0,0,0,2,0,1,3,0,1,0,4
3658,791224,34,9,18,7,12,2,6,2,2,3,2,4,1,2,4,1,22
3658,785571,33,6,11,6,9,0,2,6,6,0,10,4,2,0,1,1,18
3658,785564,24,3,6,3,3,0,3,0,0,0,2,1,0,3,1,0,6
3658,791811,10,1,4,1,4,0,0,0,0,0,1,0,2,0,1,1,2
3658,796929,13,2,3,0,0,2,3,0,2,0,1,1,0,0,0,0,6
3658,791223,20,1,2,1,2,0,0,1,2,1,1,0,1,1,1,1,3
3658,791222,11,1,3,1,3,0,0,0,0,0,1,0,0,2,1,1,2
3658,781181,24,3,6,2,2,1,4,0,0,0,1,0,2,1,0,1,7
3659,791669,35,3,6,3,6,0,0,2,2,3,5,2,3,0,5,3,8
3659,785762,19,5,7,5,7,0,0,3,4,1,5,2,4,0,3,1,13
3659,797409,22,2,7,0,2,2,5,0,0,0,2,3,2,0,3,0,6
3659,785760,28,3,8,0,3,3,5,0,0,0,0,4,3,1,2,0,9
3659,780531,34,5,13,4,5,1,8,0,0,2,5,5,0,4,6,1,11
3659,780534,24,3,5,3,5,0,0,0,0,1,1,1,1,2,1,0,6
3659,791666,19,5,9,2,6,3,3,2,2,0,2,0,3,2,3,0,15
3659,780535,18,0,2,0,1,0,1,0,0,0,2,0,0,0,0,1,0
3659,797411,1,0,0,0,0,0,0,0,0,0,0,0,0,0,0,0,0
3660,790799,23,2,5,2,5,0,0,4,6,3,5,0,3,2,0,1,8
3660,790798,22,5,8,5,8,0,0,2,2,1,1,4,2,0,1,0,12
3660,780140,35,9,16,7,11,2,5,3,4,0,3,2,2,2,1,0,23
3660,796355,30,6,12,5,9,1,3,3,4,0,5,5,2,4,3,1,16
3660,780137,33,3,7,3,5,0,2,2,2,2,2,6,4,2,1,0,8
3660,785245,29,4,9,0,2,4,7,0,0,0,3,2,2,0,0,0,12
3660,790796,11,2,2,2,2,0,0,0,0,1,3,0,3,0,1,0,4
3660,796359,8,0,3,0,1,0,2,0,0,0,0,0,1,0,0,0,0
3660,799892,2,0,1,0,0,0,1,0,0,0,0,0,1,0,1,0,0
3660,790800,2,0,0,0,0,0,0,1,2,0,0,0,0,0,0,0,1
3660,790795,2,0,1,0,1,0,0,0,0,0,0,0,0,0,0,0,0
3660,796354,3,1,1,1,1,0,0,0,0,0,0,0,0,0,0,0,2
3661,785126,14,2,4,2,4,0,0,1,3,1,3,1,2,0,0,0,5
3661,779857,22,5,6,5,6,0,0,3,3,0,1,0,2,0,4,0,13
3661,785339,17,0,2,0,1,0,1,0,0,0,3,0,2,1,1,0,0
3661,779976,30,3,11,2,7,1,4,2,2,1,4,5,3,1,6,0,9
3661,774990,26,1,5,0,3,1,2,0,0,0,0,4,2,0,2,0,3
3661,796674,24,5,7,4,5,1,2,2,3,1,4,0,2,1,0,0,13
3661,781586,16,5,7,5,7,0,0,2,2,2,2,0,2,0,0,1,12
3661,791014,5,0,2,0,0,0,2,0,0,0,0,0,0,0,0,0,0
3661,785961,23,1,7,0,3,1,4,0,0,1,6,0,2,0,1,0,3
3661,796673,20,5,10,5,9,0,1,1,1,3,2,0,2,0,2,1,11
3661,786737,3,0,0,0,0,0,0,0,0,0,0,0,0,0,0,0,0
3662,796334,34,11,16,9,12,2,4,7,9,3,5,3,3,0,3,0,31
3662,785827,19,4,7,4,7,0,0,0,1,1,2,1,4,1,0,0,8
3662,796332,17,1,4,1,4,0,0,0,0,1,1,2,2,2,1,0,2
3662,785813,32,0,9,0,4,0,5,0,0,0,1,6,2,1,3,0,0
3662,786289,27,1,7,1,5,0,2,1,2,0,3,1,3,0,3,0,3
3662,796330,23,2,5,0,0,2,5,5,6,1,0,1,3,3,0,0,11
3662,796337,24,4,8,4,8,0,0,2,2,0,3,3,1,0,0,0,10
3662,790776,7,1,3,1,3,0,0,0,1,1,1,0,1,0,0,0,2
3662,779975,16,1,3,1,3,0,0,4,5,3,6,0,1,0,0,0,6
3662,796333,1,0,0,0,0,0,0,0,0,0,0,0,0,0,0,0,0
3663,790893,14,3,5,2,4,1,1,0,0,0,3,3,5,0,1,1,7
3663,796444,37,7,13,7,13,0,0,5,6,2,9,1,1,2,0,1,19
3663,786615,32,3,6,2,5,1,1,0,0,0,8,10,3,0,1,0,7
3663,786732,30,7,10,4,5,3,5,5,6,0,5,1,2,2,1,0,22
3663,775260,34,3,7,2,5,1,2,2,4,0,1,1,0,0,4,0,9
3663,791501,2,0,0,0,0,0,0,0,0,0,0,0,1,0,1,0,0
3663,775536,20,3,4,3,4,0,0,3,4,1,1,0,5,0,2,1,9
3663,780702,16,3,6,1,1,2,5,0,0,0,0,0,1,1,2,0,8
3663,790889,15,2,2,2,2,0,0,2,3,0,2,0,2,0,1,1,6
3664,775738,31,2,6,2,4,0,2,4,5,3,6,2,2,0,2,1,8
3664,786096,26,3,9,3,5,0,4,2,4,0,4,2,1,0,0,0,8
3664,786728,26,1,4,1,4,0,0,3,6,1,1,5,4,2,4,0,5
3664,785904,20,6,13,4,5,2,8,3,4,0,1,0,2,2,0,0,17
3664,780892,29,5,13,4,9,1,4,5,7,2,2,0,2,4,0,0,16
3664,797669,9,1,1,0,0,1,1,0,0,0,1,0,0,0,0,0,3
3664,797666,13,1,4,0,1,1,3,2,3,1,0,2,1,0,0,0,5
3664,792087,3,1,1,1,1,0,0,0,0,1,1,0,1,0,0,0,2
3664,786788,14,2,2,1,1,1,1,2,2,1,1,0,2,1,0,0,7
3664,781030,29,5,7,1,1,4,6,0,0,0,2,2,2,1,0,0,14
3665,781650,12,2,2,2,2,0,0,0,0,1,2,0,3,0,2,0,4
3665,797070,20,3,5,1,2,2,3,0,0,1,4,0,2,1,3,0,8
3665,791432,32,3,6,2,3,1,3,3,3,1,1,4,2,0,1,0,10
3665,777865,32,7,17,5,13,2,4,11,11,1,2,4,5,2,0,0,27
3665,791429,33,5,8,5,7,0,1,0,2,0,4,5,2,1,3,0,10
3665,797066,15,1,1,1,1,0,0,2,2,1,2,1,3,1,1,1,4
3665,780180,18,2,3,1,1,1,2,0,0,0,2,0,1,0,1,1,5
3665,785401,12,2,5,2,5,0,0,0,0,0,4,1,2,0,1,0,4
3665,797067,16,3,3,2,2,1,1,1,2,0,3,2,2,0,2,0,8
3665,781203,10,0,1,0,1,0,0,0,0,0,1,0,1,0,0,0,0
3666,791917,24,3,6,1,2,2,4,3,4,0,5,4,1,0,1,0,11
3666,786526,25,3,12,2,6,1,6,2,2,1,2,2,1,2,2,0,9
3666,786525,33,2,7,2,5,0,2,4,5,1,0,0,2,1,2,0,8
3666,791914,15,0,6,0,5,0,1,0,0,0,0,1,4,0,2,0,0
3666,786030,19,1,7,1,5,0,2,2,4,0,3,1,2,2,2,0,4
3666,786856,15,3,5,2,4,1,1,2,2,2,3,2,2,2,2,0,9
3666,786524,25,1,3,1,3,0,0,0,0,0,3,1,0,0,1,0,2
3666,781109,26,3,5,2,3,1,2,1,1,2,2,1,2,0,1,0,8
3666,797550,17,2,4,1,2,1,2,0,0,0,1,1,1,3,0,0,5
3666,797551,1,0,0,0,0,0,0,0,0,0,0,0,1,0,0,0,0
3667,791416,28,8,9,8,9,0,0,2,4,5,7,0,3,0,1,2,18
3667,797096,33,5,12,1,1,4,11,0,0,0,4,0,2,0,0,0,14
3667,785906,30,5,11,4,9,1,2,4,4,0,5,6,2,0,4,0,15
3667,780100,23,2,5,0,1,2,4,0,0,2,4,1,1,0,2,0,6
3667,780096,34,3,9,0,1,3,8,5,5,0,3,3,4,0,2,0,14
3667,785907,13,1,1,1,1,0,0,1,2,1,1,0,0,0,2,1,3
3667,797093,20,2,7,2,6,0,1,2,2,0,4,7,4,2,4,1,6
3667,797094,3,0,0,0,0,0,0,1,2,0,0,0,0,0,0,0,1
3667,781614,12,1,1,0,0,1,1,0,0,1,1,2,1,2,0,0,3
3667,791417,1,0,0,0,0,0,0,1,2,0,0,0,0,0,0,0,1
3667,791415,1,0,0,0,0,0,0,0,0,0,0,0,0,0,0,0,0
3667,767484,2,0,0,0,0,0,0,0,0,0,0,0,0,0,0,0,0
3668,791058,17,3,5,3,5,0,0,4,5,3,2,0,0,0,1,1,10
3668,785532,28,5,8,5,8,0,0,1,4,0,5,0,5,2,2,0,11
3668,791280,16,1,5,1,3,0,2,0,0,1,1,4,2,1,1,0,2
3668,791055,35,2,6,2,5,0,1,3,4,0,2,4,4,3,1,0,7
3668,775926,35,2,11,0,5,2,6,4,4,1,4,1,0,1,1,0,10
3668,780063,20,4,8,3,7,1,1,0,0,0,1,1,5,1,1,0,9
3668,791057,10,0,3,0,1,0,2,1,2,1,2,1,3,0,0,1,1
3668,775573,26,2,9,1,2,1,7,2,3,0,0,1,1,0,0,0,7
3668,796733,6,0,1,0,1,0,0,0,0,0,1,0,0,0,0,0,0
3668,796734,6,1,2,0,0,1,2,0,0,0,1,0,0,0,0,0,3
3668,791059,1,0,0,0,0,0,0,0,0,0,0,0,0,0,0,0,0
3669,797831,31,0,4,0,1,0,3,2,3,0,6,2,0,0,2,0,2
3669,797823,27,4,8,1,4,3,4,1,2,3,6,0,3,1,3,0,12
3669,797829,16,3,5,3,5,0,0,2,2,0,2,0,3,0,0,1,8
3669,792280,28,4,11,3,9,1,2,2,2,0,1,0,4,2,3,0,11
3669,780505,36,7,11,5,7,2,4,6,6,0,5,6,3,1,5,0,22
3669,792286,20,3,6,3,6,0,0,1,2,4,4,0,4,0,0,1,7
3669,785701,2,0,0,0,0,0,0,0,2,0,0,0,0,0,0,0,0
3669,799468,13,0,1,0,0,0,1,0,0,0,1,2,1,0,1,0,0
3669,797826,12,1,2,1,1,0,1,0,0,0,0,1,0,0,0,1,2
3669,785950,15,1,4,0,1,1,3,4,4,1,5,0,1,1,0,0,7
3678,797728,27,2,6,0,3,2,3,2,2,1,3,0,3,0,2,2,8
3678,792036,13,2,3,2,2,0,1,3,4,0,1,0,3,0,1,0,7
3678,786266,26,5,7,3,5,2,2,3,3,0,3,2,1,2,2,0,15
3678,792040,28,4,7,3,6,1,1,0,0,0,5,3,1,2,1,0,9
3678,775028,28,5,14,4,10,1,4,3,4,0,3,8,2,1,3,0,14
3678,797726,25,10,13,5,7,5,6,7,9,3,3,1,1,0,1,0,32
3678,786039,11,1,2,1,2,0,0,0,0,0,3,1,3,0,2,0,2
3678,797719,20,1,4,0,0,1,4,1,2,0,5,2,1,0,0,0,4
3678,797718,21,1,3,0,1,1,2,0,0,0,5,2,2,1,0,0,3
3678,797727,1,0,0,0,0,0,0,0,0,0,0,0,0,0,0,0,0
3679,775110,29,3,6,3,6,0,0,2,5,1,7,1,3,0,2,0,8
3679,797135,28,6,13,4,6,2,7,4,6,0,5,0,0,1,1,0,18
3679,791392,17,1,1,0,0,1,1,2,3,1,2,4,3,0,0,0,5
3679,785264,25,5,8,4,4,1,4,1,2,0,3,0,3,0,1,0,12
3679,775458,33,3,17,2,9,1,8,2,2,0,2,2,2,3,2,0,9
3679,797140,5,1,1,1,1,0,0,1,1,1,1,0,0,0,0,0,3
3679,797134,7,0,0,0,0,0,0,0,0,0,0,0,2,0,0,0,0
3679,786062,3,0,0,0,0,0,0,0,0,0,1,0,1,0,0,0,0
3679,781353,7,1,1,1,1,0,0,0,0,1,0,0,3,0,1,0,2
3679,797138,15,1,3,1,2,0,1,0,0,0,4,3,1,0,2,0,2
3679,785936,5,0,0,0,0,0,0,0,0,1,1,0,1,0,2,0,0
3679,780128,22,4,10,1,4,3,6,0,0,0,1,0,1,1,2,0,11
3679,791394,4,0,0,0,0,0,0,0,0,0,0,0,0,0,0,0,0
3680,790232,29,4,11,4,8,0,3,3,3,0,0,1,3,0,3,0,11
3680,780614,30,3,6,2,5,1,1,0,0,1,2,0,1,1,2,1,7
3680,780093,11,1,3,1,3,0,0,0,0,1,0,0,2,0,2,0,2
3680,789066,37,5,15,1,4,4,11,3,4,0,6,5,1,1,0,0,17
3680,776278,24,1,6,0,0,1,6,0,0,0,2,1,0,1,0,0,3
3680,780255,18,4,5,4,5,0,0,1,2,5,3,0,1,1,0,0,9
3680,792411,12,3,3,1,1,2,2,0,0,0,0,0,2,0,0,0,8
3680,786463,21,4,8,3,4,1,4,4,4,2,4,2,1,0,0,0,13
3680,785806,18,0,1,0,1,0,0,0,0,0,1,4,0,0,0,0,0
3681,786623,27,7,11,7,11,0,0,5,6,2,5,0,2,0,0,0,19
3681,797405,32,4,9,4,9,0,0,1,1,1,3,3,1,0,1,0,9
3681,791833,33,6,8,6,7,0,1,1,1,1,0,6,1,0,3,0,13
3681,785920,37,5,8,1,2,4,6,0,0,0,8,4,3,1,3,0,14
3681,785698,25,2,6,0,0,2,6,0,0,0,3,0,2,0,0,0,6
3681,797413,5,0,1,0,0,0,1,1,2,1,0,0,0,0,0,0,1
3681,786624,12,2,4,2,4,0,0,0,0,1,1,1,2,0,0,0,4
3681,797404,1,0,0,0,0,0,0,0,0,0,0,0,0,0,0,0,0
3681,797403,2,0,0,0,0,0,0,0,0,0,1,0,0,0,0,0,0
3681,791834,11,0,0,0,0,0,0,2,2,0,1,0,3,0,0,0,2
3681,784077,15,3,6,1,3,2,3,0,0,0,1,1,0,0,1,0,8
3682,792593,37,3,8,3,7,0,1,3,6,4,3,4,3,0,1,1,9
3682,792594,35,3,9,2,6,1,3,2,4,0,6,0,3,0,2,1,9
3682,792588,30,3,7,3,4,0,3,2,3,0,2,1,4,2,0,0,8
3682,792595,35,3,7,3,7,0,0,1,2,1,5,5,4,1,2,0,7
3682,792583,33,5,12,2,3,3,9,0,0,1,3,1,1,0,0,0,13
3682,796989,3,0,1,0,0,0,1,0,0,0,0,0,1,1,1,1,0
3682,796987,12,5,9,5,8,0,1,0,0,0,2,0,0,1,1,0,10
3682,792591,15,2,4,0,0,2,4,0,0,0,1,0,2,0,0,0,6
3683,797380,23,4,7,3,5,1,2,0,0,0,6,4,4,0,2,0,9
3683,789043,25,2,7,2,7,0,0,3,4,4,9,1,3,1,1,0,7
3683,797377,40,5,7,0,0,5,7,2,2,0,2,3,1,0,1,1,17
3683,791818,37,6,17,2,7,4,10,6,8,2,6,4,2,0,4,0,22
3683,780646,37,1,1,0,0,1,1,5,9,1,1,3,1,1,1,0,8
3683,797382,4,0,1,0,1,0,0,0,0,0,0,0,1,0,1,0,0
3683,797379,15,1,4,1,3,0,1,1,2,0,5,0,0,0,0,0,3
3683,775168,19,1,4,1,4,0,0,0,0,0,2,0,2,0,2,0,2
3684,791023,15,2,5,2,4,0,1,0,0,2,2,0,3,0,1,1,4
3684,791027,34,2,4,2,2,0,2,0,0,0,6,5,2,2,1,0,4
3684,791024,34,6,13,4,6,2,7,0,0,1,4,5,1,1,3,0,14
3684,781507,25,2,5,1,4,1,1,0,0,1,5,1,1,0,3,0,5
3684,777572,37,11,16,10,13,1,3,4,4,2,5,3,3,4,3,0,27
3684,791028,25,1,4,0,1,1,3,0,0,0,5,1,3,1,1,0,3
3684,796685,25,6,15,2,4,4,11,3,3,0,2,3,0,1,3,0,19
3684,796684,3,0,2,0,1,0,1,0,0,0,0,0,0,0,0,0,0
3684,796683,2,0,0,0,0,0,0,0,0,0,0,0,1,0,0,0,0
3685,791089,7,0,1,0,0,0,1,0,0,0,0,1,0,0,0,0,0
3685,791097,20,2,8,2,6,0,2,2,2,1,2,0,1,0,0,1,6
3685,796753,25,3,7,0,1,3,6,0,0,0,2,1,1,1,3,0,9
3685,791091,34,5,9,3,5,2,4,5,6,0,2,3,2,0,3,0,17
3685,791093,24,5,12,3,7,2,5,0,0,1,3,0,0,1,2,0,12
3685,785577,25,5,8,5,8,0,0,1,3,3,7,1,2,1,1,1,11
3685,796752,35,3,11,3,6,0,5,1,2,0,4,6,2,2,0,0,7
3685,791094,30,1,4,1,1,0,3,0,0,0,5,2,3,1,4,0,2
3690,786080,34,11,22,10,20,1,2,7,8,5,1,1,3,1,2,0,30
3690,786216,36,4,15,4,15,0,0,2,4,7,4,1,2,2,1,2,10
3690,791348,36,1,3,1,2,0,1,0,0,1,5,4,3,2,2,1,2
3690,786218,29,2,2,2,2,0,0,0,3,1,4,3,3,2,4,0,4
3690,780663,40,6,14,3,7,3,7,2,2,0,2,5,1,5,4,1,17
3690,791350,18,0,1,0,1,0,0,0,0,0,2,1,0,1,2,0,0
3690,780150,7,1,2,0,0,1,2,0,0,0,1,1,2,0,0,0,3
3691,797616,26,1,4,1,3,0,1,1,2,2,2,1,2,0,2,0,3
3691,786493,36,8,14,2,3,6,11,1,2,1,4,1,4,1,2,1,23
3691,791881,30,3,8,2,4,1,4,2,2,1,3,9,2,0,7,0,9
3691,786420,36,7,12,5,6,2,6,2,2,0,2,1,0,1,5,0,18
3691,781052,31,2,7,1,1,1,6,0,0,1,1,0,1,0,0,0,5
3691,797618,13,2,6,2,6,0,0,2,3,2,3,0,3,1,2,0,6
3691,797617,5,0,0,0,0,0,0,0,0,0,0,0,0,0,0,0,0
3691,797613,14,0,1,0,0,0,1,0,0,0,1,1,2,1,0,0,0
3691,781258,9,0,0,0,0,0,0,1,2,0,1,0,0,0,0,0,1
3692,780521,36,1,2,1,1,0,1,2,2,0,1,2,3,2,1,2,4
3692,775163,26,3,3,3,3,0,0,0,3,1,5,2,2,1,1,0,6
3692,791370,38,6,11,3,7,3,4,0,0,2,9,0,2,0,3,0,15
3692,786199,38,13,24,9,18,4,6,11,12,1,8,4,2,0,3,1,41
3692,780991,35,9,18,9,18,0,0,1,2,0,0,4,4,2,2,0,19
3692,780145,13,0,0,0,0,0,0,0,0,1,3,0,1,0,1,0,0
3692,781611,5,0,1,0,1,0,0,0,0,0,1,0,1,0,0,0,0
3692,797271,14,1,4,1,1,0,3,0,0,0,3,0,2,1,0,0,2
3692,743593,16,4,5,3,4,1,1,0,0,0,0,0,2,0,0,0,9
3692,791371,4,0,1,0,1,0,0,0,0,0,1,0,1,0,0,0,0
3693,785916,41,6,15,3,5,3,10,0,0,2,5,0,3,1,1,1,15
3693,780105,44,4,8,3,6,1,2,7,9,3,8,5,4,0,1,0,16
3693,791409,41,4,5,4,4,0,1,1,2,0,5,2,0,1,2,2,9
3693,785915,35,5,16,0,1,5,15,0,0,0,3,1,4,1,1,1,15
3693,781131,42,13,27,11,23,2,4,3,6,2,4,6,3,3,4,1,31
3693,785914,1,0,1,0,1,0,0,0,0,0,0,0,1,0,0,1,0
3693,780106,16,1,4,1,3,0,1,1,4,3,1,0,3,0,0,1,3
3693,797108,5,0,1,0,0,0,1,0,0,0,0,0,0,0,0,0,0
3694,786542,21,1,7,1,4,0,3,1,2,3,5,0,3,0,0,0,3
3694,786540,24,0,3,0,2,0,1,2,2,2,2,1,1,1,0,0,2
3694,792019,21,3,7,1,4,2,3,0,1,0,1,0,4,0,1,2,8
3694,792015,38,4,9,3,7,1,2,4,6,1,3,4,1,2,3,0,13
3694,775995,37,6,9,3,4,3,5,1,2,2,4,4,1,1,0,0,16
3694,785364,22,6,11,6,11,0,0,5,7,2,0,0,1,0,0,4,17
3694,781147,3,0,1,0,1,0,0,0,0,0,1,0,0,1,0,0,0
3694,792016,18,4,7,3,4,1,3,0,0,0,1,1,1,0,1,0,9
3694,791845,16,1,4,1,3,0,1,1,2,2,3,2,0,2,1,0,3
3695,776253,34,12,17,10,13,2,4,0,0,2,4,1,1,1,4,1,26
3695,775651,26,1,3,1,3,0,0,1,4,1,4,1,2,0,2,0,3
3695,791070,30,3,4,2,2,1,2,2,2,3,5,1,4,1,1,0,9
3695,791627,36,6,11,5,6,1,5,0,0,0,3,2,2,3,1,0,13
3695,785665,27,3,8,1,4,2,4,0,1,0,2,0,1,0,1,0,8
3695,796505,4,0,3,0,3,0,0,0,0,1,0,0,0,0,0,0,0
3695,791071,7,0,0,0,0,0,0,0,2,0,1,0,1,0,0,1,0
3695,785660,3,0,0,0,0,0,0,0,0,0,0,0,2,0,0,0,0
3695,796504,1,0,0,0,0,0,0,0,0,0,1,0,0,0,0,0,0
3695,796502,2,0,1,0,0,0,1,0,0,0,0,0,1,0,0,0,0
3695,796501,14,2,5,1,2,1,3,0,0,0,1,4,2,0,0,0,5
3695,776178,16,1,4,1,4,0,0,1,2,2,2,0,1,0,2,1,3
3698,785681,21,4,6,4,6,0,0,0,0,2,2,1,0,0,1,2,8
3698,796789,16,1,7,0,2,1,5,0,0,0,2,1,3,0,0,1,3
3698,791126,35,2,8,2,7,0,1,1,2,4,6,2,3,2,0,0,5
3698,791124,31,3,5,2,4,1,1,1,2,0,2,2,2,0,2,0,8
3698,780050,29,4,9,2,4,2,5,4,6,0,8,3,2,0,1,0,14
3698,784479,2,0,0,0,0,0,0,0,0,0,0,0,0,0,0,0,0
3698,796786,19,3,10,0,1,3,9,0,0,1,3,0,2,0,0,0,9
3698,775813,17,2,4,2,4,0,0,3,5,2,4,2,2,0,4,0,7
3698,796784,7,1,3,1,3,0,0,0,0,0,1,1,0,0,0,0,2
3698,796783,11,0,0,0,0,0,0,0,0,1,0,0,1,0,1,0,0
3698,796782,12,1,3,1,1,0,2,0,0,0,0,1,1,2,0,0,2
3698,792709,0,0,0,0,0,0,0,0,0,0,0,0,0,0,0,0,0
3698,792711,0,0,0,0,0,0,0,0,0,0,0,0,0,0,0,0,0
3699,797558,15,1,6,0,3,1,3,0,0,2,2,0,0,1,3,0,3
3699,786519,33,3,4,3,4,0,0,1,4,6,5,0,2,2,1,1,7
3699,797556,30,3,15,2,8,1,7,0,0,1,2,3,0,1,1,0,7
3699,791913,30,2,9,2,6,0,3,0,0,0,2,0,2,0,0,0,4
3699,786520,33,6,13,5,6,1,7,4,6,2,2,1,4,1,1,0,17
3699,791912,9,1,1,1,1,0,0,0,0,4,0,0,4,1,2,0,2
3699,791911,3,0,1,0,0,0,1,0,0,0,0,0,1,0,1,0,0
3699,797559,7,0,1,0,1,0,0,0,0,0,0,0,1,0,0,0,0
3699,797557,16,1,4,0,0,1,4,0,0,0,3,1,0,0,1,0,3
3699,797555,18,0,6,0,4,0,2,1,2,0,5,1,0,0,1,0,1
3699,781076,6,0,1,0,0,0,1,0,0,0,1,0,0,0,1,0,0
3700,791787,19,3,10,2,7,1,3,2,2,0,2,2,0,0,3,0,9
3700,789048,33,2,7,2,7,0,0,4,5,4,6,1,1,2,3,2,8
3700,789046,29,5,9,2,3,3,6,3,4,4,2,0,3,1,2,0,16
3700,791786,31,3,9,1,4,2,5,3,5,0,2,4,4,2,1,0,11
3700,789041,27,2,9,1,4,1,5,0,0,0,0,4,1,1,2,0,5
3700,791785,9,2,2,2,2,0,0,0,1,0,0,0,1,0,1,0,4
3700,785540,22,1,4,1,3,0,1,7,8,4,3,1,4,1,0,2,9
3700,797630,19,5,9,2,2,3,7,0,0,1,0,0,4,0,3,0,13
3700,797629,5,0,1,0,1,0,0,0,0,0,0,0,0,0,0,0,0
3700,789044,6,0,0,0,0,0,0,2,2,0,1,0,0,1,2,0,2
3701,792167,31,8,11,8,11,0,0,2,6,3,4,1,4,2,2,1,18
3701,792170,21,1,3,1,3,0,0,1,2,3,1,0,4,0,1,0,3
3701,791372,27,4,7,2,4,2,3,1,2,0,2,1,3,2,2,0,11
3701,792164,33,10,16,2,6,8,10,1,2,0,6,4,2,0,4,1,29
3701,780974,36,3,10,3,8,0,2,10,13,2,5,5,1,6,2,0,16
3701,797766,6,0,0,0,0,0,0,0,0,1,1,0,2,0,1,0,0
3701,797767,16,0,2,0,1,0,1,2,2,0,1,4,3,1,1,0,2
3701,797772,9,0,0,0,0,0,0,1,2,0,2,1,1,0,2,0,1
3701,792163,21,2,3,0,0,2,3,0,0,0,1,2,3,2,1,1,6
3702,785374,8,0,0,0,0,0,0,0,0,0,1,0,4,0,1,1,0
3702,785372,30,3,8,3,5,0,3,7,8,2,5,2,2,1,1,2,13
3702,786384,23,2,5,0,0,2,5,3,4,1,3,1,4,0,3,0,9
3702,796385,26,0,3,0,2,0,1,3,4,0,3,4,1,0,2,0,3
3702,774905,28,4,11,3,8,1,3,1,1,1,3,0,2,1,1,1,10
3702,796387,8,1,1,1,1,0,0,0,0,0,1,0,2,0,2,0,2
3702,790827,23,1,3,1,2,0,1,1,2,0,2,3,0,1,0,1,3
3702,785371,11,0,1,0,1,0,0,0,0,0,0,1,1,0,1,0,0
3702,790825,19,3,6,3,6,0,0,1,2,0,3,1,2,0,2,0,7
3702,785375,10,0,0,0,0,0,0,3,4,1,3,0,1,0,0,3,3
3702,790828,8,2,3,2,3,0,0,0,0,1,0,0,3,1,1,0,4
3702,785373,6,0,0,0,0,0,0,0,0,0,0,0,0,0,0,1,0
3703,790839,11,0,2,0,0,0,2,0,0,1,0,0,3,0,2,0,0
3703,785388,26,9,14,9,14,0,0,8,12,3,6,2,2,0,3,1,26
3703,790840,22,1,3,1,1,0,2,0,0,0,1,1,3,0,2,2,2
3703,785386,30,1,7,0,1,1,6,4,4,2,4,4,2,1,2,0,7
3703,780373,32,1,8,0,4,1,4,0,0,0,3,0,2,0,1,0,3
3703,796393,14,3,5,3,5,0,0,0,0,2,1,0,2,0,0,0,6
3703,796395,16,3,9,3,6,0,3,0,1,2,4,1,2,0,0,0,6
3703,780370,29,1,5,0,0,1,5,0,0,1,1,1,5,1,1,0,3
3703,790841,11,0,3,0,1,0,2,2,2,0,0,0,0,0,0,0,2
3703,796396,9,0,0,0,0,0,0,0,0,0,0,0,0,0,0,0,0
3704,792158,28,4,6,4,6,0,0,1,2,0,2,2,2,1,1,1,9
3704,780138,30,4,10,4,10,0,0,9,13,3,2,1,3,1,1,0,17
3704,792154,35,13,16,11,13,2,3,8,11,0,2,1,1,1,0,0,36
3704,792152,37,2,6,0,1,2,5,0,0,0,6,4,2,2,2,0,6
3704,780581,25,2,3,1,1,1,2,0,0,0,0,6,2,2,1,0,5
3704,797755,6,0,0,0,0,0,0,0,0,0,2,1,2,0,1,1,0
3704,792162,3,0,0,0,0,0,0,0,0,1,0,0,0,0,1,0,0
3704,792157,10,0,3,0,3,0,0,1,2,1,2,0,3,0,1,2,1
3704,797756,13,4,6,1,1,3,5,0,0,0,1,4,3,1,1,0,11
3704,786014,13,1,5,1,3,0,2,0,1,2,0,3,2,0,0,2,2
3706,776100,27,4,9,4,7,0,2,2,3,3,6,1,1,1,1,0,10
3706,785991,30,7,11,6,9,1,2,9,10,5,12,0,3,0,0,4,24
3706,797762,26,2,4,2,3,0,1,0,0,0,0,0,3,1,1,0,4
3706,781406,35,4,14,4,11,0,3,3,4,1,4,2,1,1,2,0,11
3706,781401,26,2,8,2,6,0,2,8,10,2,5,0,3,0,2,0,12
3706,797760,8,0,1,0,1,0,0,0,0,0,1,0,1,0,1,0,0
3706,792133,27,0,3,0,1,0,2,2,4,1,2,4,2,0,2,0,2
3706,781029,21,1,6,0,1,1,5,0,0,0,1,1,0,2,1,0,3
3707,797139,16,0,2,0,2,0,0,0,0,0,1,2,4,1,1,1,0
3707,775394,24,5,8,3,4,2,4,0,0,1,5,0,2,1,1,0,12
3707,791526,20,2,4,2,3,0,1,1,2,0,1,1,5,1,1,0,5
3707,780272,33,2,14,2,9,0,5,0,0,0,3,3,1,1,1,0,4
3707,775592,30,5,11,2,5,3,6,1,5,0,4,1,2,0,0,0,14
3707,791524,21,4,9,4,6,0,3,6,6,1,2,0,4,1,4,0,14
3707,786354,4,0,0,0,0,0,0,1,2,2,0,0,1,0,0,1,1
3707,785970,20,6,6,6,6,0,0,0,1,4,6,0,3,1,4,0,12
3707,797136,8,0,5,0,2,0,3,0,0,0,1,0,1,0,0,0,0
3707,780273,24,1,2,1,2,0,0,0,0,0,0,0,0,1,0,0,2
3708,785829,21,5,8,5,8,0,0,0,0,2,1,0,3,1,0,0,10
3708,775838,31,4,11,4,9,0,2,2,4,2,7,5,3,6,2,0,10
3708,796729,12,1,3,0,1,1,2,0,0,0,0,2,3,0,0,0,3
3708,796724,21,0,3,0,0,0,3,4,7,0,2,3,2,0,4,0,4
3708,786531,29,7,16,6,10,1,6,3,4,1,0,1,2,0,1,0,18
3708,796728,10,0,1,0,1,0,0,0,0,0,5,0,0,0,0,0,0
3708,780723,16,2,5,2,5,0,0,0,0,1,4,0,3,0,0,1,4
3708,796727,17,3,6,0,0,3,6,2,2,0,2,1,1,0,2,0,11
3708,796726,27,3,5,2,3,1,2,7,7,1,2,3,1,3,3,0,14
3708,791048,16,3,7,3,5,0,2,0,0,2,1,1,4,1,1,0,6
3709,774812,31,4,10,3,8,1,2,7,12,2,5,1,2,1,4,1,16
3709,791498,27,7,10,7,10,0,0,2,2,1,3,3,3,0,1,1,16
3709,797180,25,1,4,0,2,1,2,0,0,2,1,0,0,2,1,0,3
3709,791497,34,6,13,4,7,2,6,1,4,2,5,3,3,1,5,0,15
3709,780461,31,6,9,2,5,4,4,4,6,0,5,1,3,0,8,0,20
3709,790517,3,0,1,0,1,0,0,0,0,0,1,0,0,0,0,0,0
3709,791499,23,2,5,1,2,1,3,0,0,2,2,2,3,3,1,0,5
3709,791503,20,3,3,2,2,1,1,0,1,0,5,0,4,0,0,0,7
3709,791502,6,0,1,0,1,0,0,0,0,0,0,0,2,0,2,0,0
3710,797807,40,11,19,8,13,3,6,5,6,3,2,4,1,3,2,0,30
3710,792264,39,4,9,3,4,1,5,2,3,2,12,1,2,0,1,1,11
3710,791868,32,3,11,3,9,0,2,3,3,1,2,2,4,1,1,0,9
3710,786058,40,3,7,3,6,0,1,2,2,1,1,3,3,1,1,0,8
3710,797812,16,0,1,0,1,0,0,0,0,1,2,1,3,0,0,1,0
3710,795730,15,3,7,1,1,2,6,0,0,0,1,1,5,1,1,1,8
3710,797809,17,1,3,0,1,1,2,3,4,0,1,0,4,0,3,0,6
3710,797802,1,0,0,0,0,0,0,0,0,0,0,0,0,0,0,0,0
3710,797810,0,0,0,0,0,0,0,0,0,0,0,0,0,0,0,0,0
3711,780353,32,6,9,6,8,0,1,7,8,2,7,1,1,0,1,0,19
3711,791317,36,3,9,2,6,1,3,3,6,1,1,6,4,1,3,0,10
3711,790851,20,3,6,3,4,0,2,1,1,0,0,3,3,0,0,0,7
3711,776279,23,1,6,0,3,1,3,1,2,0,4,2,4,0,1,1,4
3711,781505,20,0,3,0,1,0,2,2,2,1,4,0,3,0,1,0,2
3711,786222,26,5,8,4,6,1,2,3,5,4,3,3,1,0,2,0,14
3711,777573,22,3,7,3,6,0,1,5,6,1,1,2,2,0,2,0,11
3711,796649,12,2,2,0,0,2,2,0,0,0,2,0,0,0,2,0,6
3711,796648,8,1,2,1,1,0,1,0,0,0,0,2,0,0,0,0,2
3711,785966,1,0,1,0,1,0,0,0,0,0,0,0,0,0,0,0,0
3712,781044,35,7,15,6,8,1,7,4,4,1,11,2,2,1,1,1,19
3712,791795,29,3,7,2,4,1,3,1,3,0,3,0,1,1,2,0,8
3712,786489,28,1,5,1,3,0,2,0,0,0,1,0,2,0,0,0,2
3712,786488,33,6,11,5,9,1,2,6,7,1,4,1,3,1,0,0,19
3712,781038,32,5,8,4,6,1,2,0,0,2,6,4,2,1,2,0,11
3712,797620,14,4,5,4,4,0,1,0,0,0,1,0,1,0,3,0,8
3712,786490,3,1,1,1,1,0,0,0,0,1,0,0,0,0,0,0,2
3712,797621,15,0,2,0,2,0,0,0,0,0,1,0,2,0,0,0,0
3712,797619,11,1,2,1,2,0,0,0,0,0,0,1,2,0,2,0,2
3713,780570,33,14,19,14,19,0,0,3,4,1,3,0,2,0,4,1,31
3713,797438,27,1,4,1,3,0,1,0,0,1,0,0,4,1,0,0,2
3713,791697,33,6,15,3,10,3,5,0,2,2,5,1,4,1,2,0,15
3713,780565,31,2,7,2,4,0,3,5,5,0,1,5,1,0,0,0,9
3713,797434,10,0,0,0,0,0,0,0,0,2,2,0,0,0,1,0,0
3713,797432,18,2,4,2,4,0,0,0,1,0,1,0,2,1,0,0,4
3713,791696,9,0,3,0,1,0,2,0,0,0,2,0,0,0,1,0,0
3713,791695,8,1,3,1,3,0,0,0,0,0,2,0,0,0,0,0,2
3713,780569,29,3,6,3,6,0,0,0,0,0,6,0,1,1,2,0,6
3713,785824,2,0,0,0,0,0,0,0,0,0,0,0,0,0,0,0,0
3714,796347,17,2,6,1,4,1,2,0,0,0,1,0,2,1,0,0,5
3714,785243,34,8,18,8,15,0,3,4,7,4,6,1,0,1,2,1,20
3714,790788,22,0,3,0,0,0,3,0,0,1,0,1,1,0,1,0,0
3714,781028,42,11,18,6,7,5,11,0,0,1,4,1,3,0,1,0,27
3714,781026,33,6,12,6,10,0,2,1,2,1,3,1,2,0,0,0,13
3714,785242,11,1,1,1,1,0,0,0,0,0,0,0,1,1,4,1,2
3714,796349,25,1,2,1,2,0,0,0,0,1,3,1,4,2,0,0,2
3714,796348,27,4,6,3,4,1,2,0,0,0,2,1,3,1,1,0,9
3714,781027,14,0,2,0,1,0,1,0,0,2,1,2,3,0,0,0,0
3715,799906,27,3,4,1,1,2,3,4,4,0,4,0,2,0,1,0,12
3715,775833,18,3,3,3,3,0,0,0,0,0,8,0,3,0,2,0,6
3715,785439,36,4,5,4,4,0,1,3,3,0,2,7,1,0,1,0,11
3715,781036,44,11,17,7,11,4,6,3,3,0,2,3,1,1,1,0,29
3715,774894,43,6,14,2,6,4,8,8,10,1,2,2,2,0,0,0,24
3715,796847,29,2,6,1,1,1,5,1,2,0,0,0,0,1,2,0,6
3715,791178,7,0,0,0,0,0,0,0,0,0,3,0,4,0,2,0,0
3715,796845,21,0,2,0,0,0,2,1,2,0,4,0,1,0,0,1,1
3716,797546,16,1,4,1,4,0,0,0,0,1,2,0,3,0,0,0,2
3716,780351,27,2,8,2,8,0,0,0,0,1,0,0,2,0,2,0,4
3716,797549,7,0,3,0,2,0,1,0,0,0,0,0,1,1,1,0,0
3716,797545,16,0,3,0,1,0,2,0,0,0,3,1,5,1,1,0,0
3716,780586,25,5,11,4,7,1,4,2,2,0,2,0,1,2,2,2,13
3716,797544,15,3,7,3,6,0,1,1,2,2,2,0,1,0,0,1,7
3716,791799,3,0,0,0,0,0,0,0,0,0,1,1,0,0,1,1,0
3716,797539,15,3,6,2,3,1,3,0,0,1,1,0,1,1,0,0,7
3716,797540,20,0,4,0,1,0,3,0,0,0,1,1,2,0,0,0,0
3716,791716,6,0,1,0,0,0,1,0,0,0,0,1,0,0,0,0,0
3716,791715,15,0,2,0,0,0,2,0,0,0,2,0,1,1,3,0,0
3716,790857,19,3,7,1,5,2,2,0,0,0,0,3,0,0,2,0,8
3716,785855,16,2,5,1,3,1,2,0,0,0,1,1,0,0,1,0,5
3717,781579,25,6,9,5,7,1,2,0,0,8,5,2,1,0,2,0,13
3717,786731,27,5,10,5,10,0,0,1,3,3,10,1,1,2,2,3,11
3717,798023,22,4,7,4,6,0,1,0,0,0,4,2,2,0,3,0,8
3717,781584,21,1,6,0,1,1,5,0,0,1,1,3,0,0,0,0,3
3717,780347,31,5,10,4,9,1,1,1,2,3,5,4,1,1,3,0,12
3717,775696,16,2,4,1,3,1,1,2,2,0,1,1,0,1,0,0,7
3717,798026,3,0,1,0,1,0,0,0,0,0,0,0,0,0,0,0,0
3717,776481,10,3,4,3,4,0,0,0,2,2,3,1,1,1,2,1,6
3717,798018,1,1,1,0,0,1,1,0,0,0,0,0,0,0,0,0,3
3717,798017,3,0,0,0,0,0,0,2,2,0,1,1,0,0,1,0,2
3717,798008,24,3,7,1,3,2,4,2,2,0,0,5,1,1,2,0,10
3717,792358,17,2,4,2,3,0,1,3,4,0,2,0,1,0,0,1,7
3718,791053,18,4,4,4,4,0,0,1,2,1,1,0,5,0,0,0,9
3718,780739,24,4,5,4,5,0,0,0,0,1,2,0,1,1,2,0,8
3718,785524,32,1,6,0,4,1,2,2,2,1,1,1,2,0,0,1,5
3718,781115,25,4,11,4,11,0,0,3,4,3,5,5,2,1,0,0,11
3718,775094,19,1,7,1,6,0,1,3,3,2,0,2,1,1,0,0,5
3718,796731,10,0,1,0,0,0,1,0,0,0,2,0,0,1,1,0,0
3718,796730,12,1,3,0,0,1,3,0,0,0,1,0,0,0,0,0,3
3718,791051,15,0,1,0,1,0,0,0,0,2,2,0,4,0,1,0,0
3718,790819,18,3,8,2,3,1,5,4,4,0,1,3,1,1,2,0,11
3718,786310,7,0,2,0,1,0,1,0,1,0,2,0,1,0,0,0,0
3718,775456,20,3,7,2,6,1,1,3,4,1,3,0,0,0,3,1,10
3719,785512,17,3,4,3,4,0,0,4,6,1,1,0,3,1,1,1,10
3719,774834,31,1,1,1,1,0,0,3,4,3,6,0,1,0,3,1,5
3719,791043,35,8,15,6,10,2,5,0,0,2,2,2,1,0,1,0,18
3719,776374,14,1,2,1,2,0,0,0,0,0,1,0,4,1,1,0,2
3719,775412,25,1,4,0,0,1,4,0,0,0,1,0,1,0,1,0,3
3719,796723,20,2,8,1,2,1,6,0,0,0,2,1,0,0,2,1,5
3719,766998,16,1,2,1,2,0,0,0,0,0,5,0,3,0,3,0,2
3719,796718,23,1,3,1,1,0,2,0,0,0,1,1,4,1,2,0,2
3719,796717,10,0,5,0,3,0,2,0,0,0,3,0,0,1,0,0,0
3719,796720,9,1,4,1,3,0,1,0,0,0,0,2,2,0,0,0,2
3728,780377,42,3,8,2,3,1,5,6,6,1,4,2,1,1,1,0,13
3728,791852,42,7,8,7,8,0,0,2,3,1,8,0,4,1,0,4,16
3728,797460,28,6,10,3,5,3,5,2,3,0,1,0,5,2,0,0,17
3728,786601,39,3,14,2,6,1,8,2,2,1,4,2,2,2,3,1,9
3728,786600,34,2,7,2,7,0,0,4,8,1,3,8,2,1,5,0,8
3728,791851,33,4,7,4,5,0,2,5,6,1,5,6,3,1,6,1,13
3728,791853,8,0,2,0,2,0,0,2,2,1,0,0,2,0,0,0,2
3728,797459,9,1,3,1,2,0,1,0,0,0,2,1,0,0,1,0,2
3728,786599,15,1,1,1,1,0,0,2,3,1,1,0,1,0,0,0,4
3729,780378,27,6,10,6,10,0,0,7,9,5,4,0,4,0,1,2,19
3729,797061,41,4,10,3,6,1,4,1,2,4,3,2,3,1,2,0,10
3729,786374,47,2,7,2,6,0,1,3,4,3,5,2,3,5,4,1,7
3729,786253,36,4,15,3,9,1,6,6,8,3,8,4,5,1,4,0,15
3729,785798,25,1,11,0,4,1,7,0,0,1,3,0,2,2,2,0,3
3729,786404,11,0,2,0,1,0,1,1,4,2,0,1,2,2,1,0,1
3729,780382,21,3,4,3,4,0,0,1,1,0,6,1,4,0,1,0,7
3729,791562,3,0,0,0,0,0,0,2,2,1,0,0,0,0,0,0,2
3729,786378,32,4,13,2,5,2,8,0,1,0,2,5,4,0,2,0,10
3729,780381,0,0,0,0,0,0,0,0,0,0,0,0,0,0,0,0,0
3729,780121,7,2,2,1,1,1,1,0,0,0,0,0,1,0,0,0,5
3730,775556,26,5,12,5,9,0,3,0,0,4,4,6,1,1,2,2,10
3730,780234,27,8,13,8,11,0,2,4,9,5,7,1,1,3,1,1,20
3730,786405,29,3,9,3,8,0,1,0,0,0,2,5,3,1,4,0,6
3730,786411,30,6,12,2,4,4,8,0,1,0,4,1,2,1,3,2,16
3730,780046,33,4,13,3,6,1,7,0,0,0,1,2,2,2,3,0,9
3730,797188,2,0,1,0,1,0,0,0,0,0,0,0,0,0,0,0,0
3730,781110,23,4,7,4,6,0,1,1,2,2,2,3,1,0,0,0,9
3730,786328,3,0,0,0,0,0,0,0,0,0,0,0,0,0,0,0,0
3730,797189,1,0,0,0,0,0,0,0,0,0,0,0,0,0,1,0,0
3730,797186,1,0,0,0,0,0,0,0,0,0,0,0,0,0,0,0,0
3730,797185,24,0,4,0,2,0,2,1,2,3,1,1,3,2,1,1,1
3730,792656,1,0,0,0,0,0,0,0,0,0,0,0,0,0,0,0,0
3731,786131,36,3,8,3,6,0,2,0,2,2,7,0,0,0,3,0,6
3731,780904,29,2,7,2,7,0,0,2,2,1,8,4,3,1,2,0,6
3731,797685,36,3,11,3,8,0,3,0,0,0,2,1,1,0,5,0,6
3731,797688,32,3,5,1,2,2,3,2,2,0,4,0,0,0,4,2,10
3731,786128,33,10,16,9,12,1,4,0,0,4,3,3,3,2,1,1,21
3731,797684,3,0,0,0,0,0,0,0,0,0,0,0,0,0,1,0,0
3731,792100,6,1,1,1,1,0,0,1,2,2,1,0,1,0,0,0,3
3731,797686,11,1,3,1,2,0,1,0,0,0,1,2,0,0,2,0,2
3731,792099,2,1,1,0,0,1,1,0,0,0,0,0,0,0,0,0,3
3731,792096,8,0,3,0,0,0,3,0,0,0,0,0,1,0,1,0,0
3731,786141,2,0,0,0,0,0,0,0,0,0,0,1,0,0,0,0,0
3731,775251,2,0,3,0,3,0,0,1,2,2,1,0,3,1,1,0,1
3732,797701,21,3,4,3,4,0,0,6,6,2,3,1,4,1,1,0,12
3732,792101,34,5,12,5,12,0,0,1,2,1,2,3,3,3,1,0,11
3732,780923,27,4,11,3,8,1,3,6,8,0,0,5,3,0,3,0,15
3732,775564,37,3,8,3,4,0,4,2,3,1,13,2,2,1,2,1,8
3732,776386,30,6,12,4,6,2,6,1,2,3,0,1,2,1,1,0,15
3732,797700,10,0,2,0,2,0,0,0,0,0,0,1,4,1,1,1,0
3732,797697,10,1,2,1,2,0,0,0,0,1,0,0,1,0,0,1,2
3732,780922,17,1,1,1,1,0,0,0,0,1,6,0,1,1,1,1,2
3732,792102,7,1,3,1,2,0,1,0,0,1,1,0,0,0,0,0,2
3732,786165,1,0,0,0,0,0,0,0,0,0,0,0,1,0,0,0,0
3732,786156,6,0,2,0,1,0,1,0,0,0,1,1,1,0,2,0,0
3733,785740,20,2,4,2,4,0,0,2,3,2,1,0,5,0,3,1,6
3733,785809,29,4,8,3,6,1,2,0,0,1,4,2,3,1,4,0,9
3733,780530,32,4,10,4,8,0,2,3,6,6,4,0,4,0,0,3,11
3733,797402,30,2,6,0,2,2,4,0,0,1,3,0,0,1,2,0,6
3733,785738,37,4,16,4,12,0,4,7,9,0,4,3,3,2,4,0,15
3733,797396,12,1,2,1,1,0,1,0,1,0,1,1,1,0,1,0,2
3733,797401,0,0,1,0,0,0,1,0,0,0,0,0,0,0,0,0,0
3733,786144,19,2,4,0,1,2,3,0,0,0,3,1,1,0,1,0,6
3733,797399,19,0,3,0,1,0,2,0,0,0,3,1,1,0,0,0,0
3733,791664,2,0,0,0,0,0,0,0,0,0,0,0,0,0,0,0,0
3733,780526,0,0,0,0,0,0,0,0,0,0,0,0,0,0,0,0,0
3734,796657,18,1,2,1,2,0,0,0,0,1,1,1,0,0,0,2,2
3734,796651,13,2,5,2,4,0,1,2,3,1,3,2,0,0,2,0,6
3734,791323,34,2,5,0,1,2,4,0,0,0,4,4,0,2,0,1,6
3734,791320,40,6,16,5,10,1,6,5,6,0,2,5,1,4,0,0,18
3734,781511,35,6,10,3,4,3,6,0,0,1,5,1,4,0,2,0,15
3734,796650,18,3,8,3,7,0,1,0,2,3,1,0,0,1,2,1,6
3734,796656,21,3,4,3,4,0,0,0,2,1,4,2,4,0,1,0,6
3734,796653,4,0,0,0,0,0,0,0,0,0,1,0,1,0,2,0,0
3734,791321,8,0,1,0,1,0,0,0,0,0,0,1,2,0,0,0,0
3734,785912,34,8,10,4,5,4,5,5,5,0,2,5,2,2,1,0,25
3735,797529,27,3,5,3,5,0,0,0,0,2,3,0,4,1,1,0,6
3735,791936,44,6,13,6,13,0,0,8,10,8,10,2,1,1,3,2,20
3735,797532,45,9,16,5,10,4,6,11,12,0,2,5,1,1,6,0,33
3735,791932,30,1,7,1,4,0,3,0,0,0,4,0,1,1,0,0,2
3735,785688,31,6,17,3,5,3,12,0,0,0,0,1,3,2,1,0,15
3735,797528,12,0,0,0,0,0,0,0,0,0,1,0,2,0,0,0,0
3735,791933,22,1,2,0,0,1,2,0,0,0,1,1,1,0,1,0,3
3735,785988,12,1,4,1,3,0,1,0,0,1,1,0,2,0,1,0,2
3735,791931,2,0,0,0,0,0,0,0,0,0,0,0,1,0,0,0,0
3736,791135,28,4,12,4,12,0,0,1,2,7,7,3,2,0,2,0,9
3736,796790,29,5,10,2,3,3,7,0,0,1,4,2,0,0,1,0,13
3736,786090,35,7,10,4,5,3,5,9,9,1,5,3,2,4,1,0,26
3736,791134,7,0,2,0,2,0,0,0,0,1,0,0,2,1,0,1,0
3736,791131,9,0,1,0,0,0,1,0,0,1,2,0,3,0,1,0,0
3736,791132,26,5,14,1,2,4,12,0,0,1,4,1,0,0,3,0,14
3736,774921,28,1,5,1,4,0,1,2,2,0,4,5,3,3,2,0,4
3736,786088,30,4,9,2,5,2,4,2,2,1,2,3,1,0,3,0,12
3736,791133,5,0,0,0,0,0,0,0,0,0,0,0,0,0,0,1,0
3736,786097,3,0,2,0,0,0,2,0,0,1,1,0,0,0,0,0,0
3737,790907,31,7,17,7,16,0,1,5,6,6,3,1,3,1,2,1,19
3737,787175,40,3,11,0,0,3,11,0,0,0,4,1,4,0,1,1,9
3737,790909,25,3,8,1,2,2,6,0,0,0,3,2,4,1,0,1,8
3737,781393,38,6,16,2,6,4,10,0,0,0,3,5,1,0,3,1,16
3737,775351,36,2,8,2,8,0,0,0,0,2,3,4,3,3,3,0,4
3737,796455,12,1,1,1,1,0,0,1,2,4,0,0,2,0,1,0,3
3737,782126,16,2,6,0,2,2,4,0,0,0,2,0,0,0,1,0,6
3737,796456,0,0,0,0,0,0,0,0,0,0,0,0,0,0,0,0,0
3737,796454,2,0,0,0,0,0,0,0,0,0,0,0,0,0,0,0,0
3737,790910,0,0,0,0,0,0,0,0,0,0,0,0,0,0,0,0,0
3738,797972,30,7,9,7,8,0,1,1,1,1,1,1,3,0,2,4,15
3738,797967,31,5,10,4,7,1,3,2,3,3,4,4,2,0,3,0,13
3738,797970,30,6,7,4,5,2,2,2,2,0,3,7,3,0,4,0,16
3738,781453,32,6,10,1,1,5,9,1,2,0,6,6,2,4,5,0,18
3738,774869,35,4,8,2,2,2,6,4,4,1,4,2,2,2,0,0,14
3738,792254,17,3,5,1,2,2,3,0,0,0,4,1,2,0,2,2,8
3738,792256,2,0,0,0,0,0,0,0,0,0,0,0,0,0,0,0,0
3738,797962,3,0,0,0,0,0,0,0,0,0,0,0,0,0,0,0,0
3738,786098,19,3,4,3,3,0,1,5,6,0,0,2,4,0,1,0,11
3738,786106,1,0,2,0,0,0,2,0,0,0,0,0,0,0,0,0,0
3739,792197,34,3,11,1,6,2,5,0,0,1,2,1,3,0,3,0,8
3739,781132,34,4,11,2,5,2,6,4,4,0,6,1,4,1,3,1,14
3739,797517,26,6,8,6,8,0,0,1,2,1,3,1,0,1,3,0,13
3739,797518,26,6,9,4,5,2,4,6,6,2,1,8,4,1,1,0,20
3739,791940,29,3,8,2,3,1,5,0,0,0,0,2,4,2,1,0,7
3739,797521,4,0,1,0,1,0,0,2,2,2,0,0,0,0,0,0,2
3739,797519,10,1,3,1,1,0,2,0,2,0,1,0,1,0,0,0,2
3739,797522,6,0,1,0,1,0,0,0,0,0,1,0,0,0,2,0,0
3739,786539,3,0,0,0,0,0,0,2,2,0,1,1,0,0,0,0,2
3739,797520,4,0,2,0,1,0,1,0,0,1,0,1,0,0,0,0,0
3739,791938,24,4,8,2,4,2,4,0,0,0,2,1,2,3,2,0,10
3742,796979,28,4,7,3,4,1,3,0,0,4,3,0,0,0,4,1,9
3742,776200,19,1,4,1,4,0,0,1,3,2,2,0,3,2,2,0,3
3742,780925,32,6,10,2,3,4,7,1,2,1,2,2,1,0,5,0,17
3742,780446,31,1,6,1,3,0,3,3,4,0,4,3,3,0,3,0,5
3742,781034,31,4,9,4,7,0,2,1,1,1,1,3,2,0,2,0,9
3742,791625,19,1,7,1,5,0,2,0,0,2,1,0,1,1,1,0,2
3742,791622,13,1,1,1,1,0,0,0,0,0,0,0,2,1,2,0,2
3742,791624,19,3,6,1,1,2,5,0,0,0,5,1,0,0,1,1,8
3742,791637,8,0,3,0,0,0,3,0,0,0,3,0,0,0,0,0,0
3743,791266,17,3,4,3,4,0,0,0,0,1,3,0,4,1,1,3,6
3743,785977,33,6,9,3,3,3,6,0,0,0,3,3,1,2,3,1,15
3743,791265,26,6,10,5,6,1,4,0,0,0,1,3,0,1,1,0,13
3743,791269,34,2,6,0,1,2,5,0,0,1,2,0,1,0,0,0,6
3743,785685,35,6,15,6,13,0,2,5,6,2,5,2,2,1,7,0,17
3743,796524,12,2,2,2,2,0,0,1,2,0,3,0,3,0,0,0,5
3743,796523,14,1,3,1,1,0,2,0,0,0,0,0,0,2,0,0,2
3743,796522,12,0,3,0,0,0,3,0,0,0,1,1,0,2,0,0,0
3743,791271,11,2,4,2,4,0,0,0,0,4,1,0,0,1,0,0,4
3743,781313,5,0,2,0,0,0,2,0,0,0,0,1,0,1,1,0,0
3743,791270,1,0,0,0,0,0,0,0,0,0,0,0,0,0,0,0,0
3744,792246,22,3,9,3,9,0,0,4,4,2,6,1,3,1,0,0,10
3744,791701,28,1,6,1,3,0,3,0,0,1,6,4,4,1,4,0,2
3744,792245,30,1,4,0,1,1,3,0,0,0,0,3,2,1,0,0,3
3744,781420,40,4,9,2,3,2,6,4,6,1,3,3,2,1,4,0,14
3744,781405,40,11,24,8,15,3,9,1,2,1,0,0,1,2,1,0,26
3744,797924,6,0,1,0,1,0,0,0,0,0,0,0,0,0,0,0,0
3744,792244,10,1,2,0,0,1,2,0,0,1,1,1,0,1,0,0,3
3744,780615,7,1,1,1,1,0,0,0,0,1,1,0,3,1,0,0,2
3744,781624,8,1,1,1,1,0,0,0,0,0,1,0,1,0,0,0,2
3744,797925,9,3,6,1,3,2,3,0,0,0,0,1,0,0,0,0,8
3745,791883,32,7,9,4,5,3,4,0,0,0,5,3,1,1,2,3,17
3745,781066,31,5,6,5,6,0,0,3,4,1,5,3,4,1,3,1,13
3745,797594,25,4,8,0,0,4,8,1,2,0,3,2,0,0,0,0,13
3745,791884,38,4,13,4,12,0,1,7,8,0,6,5,2,1,1,0,15
3745,780695,30,2,6,0,0,2,6,0,0,1,1,5,4,3,3,0,6
3745,797600,6,2,3,2,3,0,0,0,0,1,1,0,0,0,0,1,4
3745,797598,2,0,0,0,0,0,0,0,0,0,1,0,0,0,0,0,0
3745,797596,16,0,4,0,1,0,3,2,2,0,1,1,0,0,1,0,2
3745,786496,20,3,3,2,2,1,1,0,0,2,0,1,2,0,1,0,7
3746,776344,29,8,23,7,17,1,6,3,4,2,4,2,4,0,2,1,20
3746,775821,23,2,7,2,4,0,3,0,0,0,4,0,4,0,3,0,4
3746,792453,33,7,13,7,10,0,3,4,5,1,9,2,3,0,4,1,18
3746,785131,29,5,7,4,5,1,2,1,1,3,4,0,3,0,3,0,12
3746,781538,23,4,4,2,2,2,2,2,2,1,0,3,4,0,0,0,12
3746,798113,2,0,0,0,0,0,0,0,0,1,0,0,0,0,0,0,0
3746,785152,15,2,5,1,4,1,1,0,0,1,2,0,1,1,0,0,5
3746,798115,31,2,4,0,0,2,4,2,3,0,3,2,3,1,1,0,8
3746,792324,4,0,2,0,0,0,2,0,0,0,0,0,0,0,0,0,0
3746,776233,11,2,3,2,2,0,1,0,0,0,3,0,3,1,1,0,4
3747,791760,31,10,15,7,11,3,4,1,2,1,4,1,0,1,1,0,24
3747,780256,23,2,4,1,1,1,3,4,8,0,3,2,3,0,0,0,9
3747,796880,36,7,11,5,7,2,4,5,6,1,6,3,3,3,3,1,21
3747,791757,28,4,12,4,9,0,3,3,4,1,2,2,5,1,1,0,11
3747,791334,33,2,4,1,1,1,3,5,8,0,1,1,1,1,1,0,10
3747,791330,3,0,0,0,0,0,0,0,0,0,1,0,2,0,0,0,0
3747,785874,14,2,6,1,3,1,3,2,2,1,3,1,0,0,0,0,7
3747,796879,12,2,3,2,3,0,0,0,0,0,2,0,0,0,0,0,4
3747,796883,8,0,0,0,0,0,0,0,0,0,1,0,0,0,0,0,0
3747,781590,12,1,6,1,2,0,4,0,0,0,1,0,3,1,1,1,2
3748,796617,18,0,2,0,1,0,1,1,2,2,3,1,3,0,1,1,1
3748,775131,34,6,13,5,7,1,6,3,3,2,3,5,4,2,2,0,16
3748,796616,37,2,7,0,2,2,5,2,2,0,1,4,1,2,2,0,8
3748,796612,25,4,9,3,7,1,2,0,1,0,2,3,3,0,3,1,9
3748,785562,31,6,12,5,11,1,1,1,3,4,5,1,3,1,1,0,14
3748,792429,21,5,10,2,4,3,6,0,0,2,3,1,1,0,2,0,13
3748,796614,3,1,1,1,1,0,0,0,0,0,0,0,1,0,2,0,2
3748,796607,12,1,1,1,1,0,0,0,0,1,1,1,0,0,0,0,2
3748,796606,19,3,5,2,2,1,3,0,0,0,2,1,0,1,0,0,7
3749,780229,31,3,8,3,8,0,0,1,2,3,5,0,1,1,5,0,7
3749,795572,37,6,11,3,5,3,6,1,1,0,7,3,3,2,3,1,16
3749,791483,32,7,11,3,5,4,6,2,3,0,2,3,1,1,3,0,20
3749,786322,28,1,2,1,1,0,1,3,3,0,3,3,1,2,1,0,5
3749,780228,35,4,8,0,0,4,8,7,9,0,2,1,2,0,1,0,19
3749,781592,20,3,4,2,3,1,1,3,4,0,4,0,3,2,0,0,10
3749,791488,13,0,2,0,1,0,1,0,0,0,0,0,0,0,1,0,0
3749,791485,4,0,0,0,0,0,0,0,0,0,0,0,0,0,0,0,0
3750,792334,32,3,11,2,8,1,3,1,2,0,4,3,2,0,4,0,8
3750,786575,22,3,6,3,6,0,0,6,10,5,8,1,4,0,3,2,12
3750,798094,32,4,7,3,3,1,4,0,0,0,4,4,1,1,0,1,9
3750,792338,32,5,9,5,8,0,1,0,0,0,1,2,2,3,1,1,10
3750,781666,29,3,11,0,3,3,8,3,4,1,1,0,1,1,2,0,12
3750,798097,18,5,7,5,7,0,0,0,0,4,5,1,2,0,2,3,10
3750,785531,8,0,3,0,1,0,2,0,0,0,0,0,1,0,0,0,0
3750,798095,2,0,1,0,0,0,1,0,0,0,0,0,0,0,0,0,0
3750,799842,12,2,5,1,4,1,1,0,0,1,2,0,0,0,1,0,5
3750,791636,13,0,2,0,0,0,2,0,0,1,1,1,1,0,0,0,0
3751,791493,36,8,15,8,14,0,1,1,4,3,10,2,4,0,1,1,17
3751,789036,21,8,13,8,13,0,0,2,2,2,1,2,5,1,2,0,18
3751,797191,33,3,5,1,2,2,3,1,2,0,2,5,1,1,3,0,9
3751,791495,13,0,3,0,0,0,3,0,0,0,0,0,0,0,0,0,0
3751,776494,36,1,4,0,2,1,2,2,2,0,2,2,3,0,1,0,5
3751,781307,19,3,6,3,6,0,0,0,0,0,3,0,2,0,2,0,6
3751,780504,3,0,0,0,0,0,0,0,0,0,2,0,0,0,0,0,0
3751,791492,6,2,4,2,3,0,1,0,0,0,0,0,0,0,0,0,4
3751,791494,7,1,3,0,1,1,2,0,0,0,1,0,0,0,0,0,3
3751,786324,26,1,6,1,4,0,2,0,0,0,1,4,0,2,1,0,2
3754,792340,33,4,11,1,4,3,7,0,1,4,1,0,4,0,3,0,11
3754,792345,21,2,5,2,3,0,2,0,2,0,2,1,4,0,0,0,4
3754,792346,33,5,11,5,10,0,1,0,0,1,5,5,4,1,3,0,10
3754,781553,40,4,10,4,7,0,3,5,8,4,8,0,3,1,2,1,13
3754,781552,36,6,10,2,3,4,7,3,4,0,4,4,3,4,2,0,19
3754,798080,5,1,1,0,0,1,1,0,0,1,1,1,2,1,1,0,3
3754,792341,6,0,0,0,0,0,0,0,0,0,0,0,0,0,0,0,0
3754,792342,26,0,5,0,2,0,3,4,4,0,2,1,2,0,1,0,4
3755,792029,27,2,4,2,4,0,0,2,2,1,3,1,3,0,0,0,6
3755,761149,21,3,6,0,1,3,5,0,0,1,2,1,4,1,1,0,9
3755,792032,37,2,11,1,7,1,4,9,9,2,5,2,2,2,2,0,14
3755,792031,27,1,2,0,1,1,1,0,0,0,1,2,2,0,2,0,3
3755,780828,34,5,13,5,12,0,1,8,9,0,6,1,1,0,4,0,18
3755,797641,6,2,4,2,4,0,0,0,0,1,2,0,1,0,0,0,4
3755,797640,13,0,0,0,0,0,0,0,0,0,1,1,2,0,0,0,0
3755,797637,22,2,4,0,1,2,3,0,0,1,2,1,4,1,3,1,6
3755,792027,13,2,3,2,3,0,0,2,4,0,3,0,0,1,1,0,6
3756,781174,27,4,5,4,5,0,0,1,4,5,3,0,5,1,0,1,9
3756,781159,35,11,20,9,17,2,3,1,2,3,8,5,1,1,1,1,25
3756,791001,30,1,6,1,5,0,1,0,0,0,2,2,3,0,1,0,2
3756,781215,31,5,8,4,4,1,4,3,5,2,2,2,3,1,1,0,14
3756,775255,37,5,9,2,3,3,6,6,6,0,0,3,2,2,1,1,19
3756,785320,19,3,7,2,4,1,3,0,0,0,1,1,2,0,0,0,7
3756,785231,21,2,4,2,4,0,0,0,0,1,2,0,2,1,2,0,4
3757,792473,21,0,2,0,1,0,1,2,2,0,3,2,5,0,1,0,2
3757,780043,30,1,5,1,3,0,2,1,1,0,2,1,4,0,0,1,3
3757,799276,40,5,7,3,4,2,3,2,2,1,3,1,4,0,1,0,14
3757,785249,40,8,14,4,8,4,6,3,4,0,1,4,3,2,6,0,23
3757,780035,39,7,11,4,6,3,5,0,0,1,4,2,2,0,2,0,17
3757,792477,1,0,0,0,0,0,0,0,0,0,1,0,0,0,0,0,0
3757,780036,29,3,6,3,3,0,3,4,4,0,3,1,0,0,2,1,10
3758,781454,29,3,6,3,6,0,0,2,4,2,6,3,3,0,4,0,8
3758,786424,19,5,10,5,10,0,0,2,4,6,8,0,1,0,1,0,12
3758,792366,30,8,14,8,13,0,1,2,4,3,5,3,4,2,3,2,18
3758,791015,34,3,7,2,3,1,4,2,2,0,1,7,0,2,1,0,9
3758,785483,26,3,10,2,6,1,4,4,4,1,2,3,4,0,4,0,11
3758,797991,16,2,4,1,2,1,2,0,0,0,5,2,0,1,0,0,5
3758,797983,2,1,2,1,1,0,1,0,0,0,0,0,0,0,0,0,2
3758,797973,1,0,0,0,0,0,0,0,0,0,0,0,0,0,0,0,0
3758,785959,15,2,2,2,2,0,0,2,3,3,2,0,2,1,0,1,6
3758,797996,1,0,1,0,0,0,1,0,0,0,0,0,0,0,0,0,0
3758,797979,25,2,5,1,1,1,4,1,1,1,2,3,2,0,0,0,6
3758,797976,1,0,0,0,0,0,0,0,0,0,0,0,0,0,0,0,0
3758,793113,1,0,0,0,0,0,0,0,0,0,0,0,0,0,0,0,0
3759,774806,21,6,11,6,11,0,0,2,2,3,4,0,4,0,3,3,14
3759,775823,21,0,5,0,4,0,1,2,2,0,1,1,1,2,0,0,2
3759,791041,11,1,1,1,1,0,0,0,0,0,1,2,5,0,1,0,2
3759,791038,31,4,11,3,7,1,4,2,3,2,1,1,2,1,1,0,11
3759,789023,31,3,9,2,5,1,4,0,2,0,1,4,2,1,2,0,7
3759,796716,27,1,7,1,3,0,4,0,0,0,2,0,4,1,1,0,2
3759,796714,14,2,3,2,3,0,0,0,0,0,2,0,2,0,2,0,4
3759,786689,3,0,0,0,0,0,0,0,0,0,0,0,1,0,0,0,0
3759,796712,3,0,0,0,0,0,0,0,0,0,0,0,0,0,0,0,0
3759,796711,9,0,2,0,1,0,1,0,0,0,1,0,0,0,0,0,0
3759,791346,6,1,3,1,2,0,1,0,0,1,2,0,1,0,1,0,2
3759,775205,23,2,4,0,1,2,3,0,0,0,2,1,1,0,2,0,6
3760,792034,36,4,9,1,3,3,6,5,6,0,9,4,1,1,2,0,16
3760,780830,39,2,7,2,4,0,3,6,6,0,3,2,1,0,2,0,10
3760,780833,17,4,9,4,9,0,0,0,0,1,1,0,3,0,1,2,8
3760,791688,36,2,8,1,5,1,3,1,2,2,2,2,4,1,2,0,6
3760,785381,29,1,3,0,0,1,3,2,2,0,3,2,1,2,1,2,5
3760,792035,25,9,14,9,14,0,0,4,9,2,2,3,1,2,0,1,22
3760,797645,18,8,10,8,10,0,0,0,2,4,1,1,3,0,0,0,16
3761,797768,27,5,8,5,8,0,0,2,2,0,2,3,2,0,3,0,12
3761,797779,26,3,7,1,2,2,5,2,2,1,3,2,5,0,0,0,10
3761,797769,36,4,10,3,7,1,3,0,0,1,8,2,5,0,3,0,9
3761,786256,27,3,8,3,7,0,1,2,2,4,3,1,5,2,6,1,8
3761,797780,14,0,3,0,2,0,1,0,0,0,0,0,0,0,0,0,0
3761,797770,22,6,11,6,10,0,1,4,4,4,5,0,2,0,0,1,16
3761,797778,20,5,9,2,4,3,5,0,0,0,3,1,1,2,1,0,13
3761,785568,11,3,4,3,4,0,0,0,0,0,1,0,2,1,0,0,6
3761,797774,17,1,4,0,1,1,3,0,2,1,3,2,3,0,1,1,3
3762,786547,21,2,3,1,1,1,2,0,0,3,3,2,5,0,1,2,5
3762,786544,37,6,16,5,12,1,4,8,8,8,10,0,2,1,1,2,21
3762,797507,29,2,8,1,5,1,3,0,0,1,4,3,3,0,2,1,5
3762,792012,40,5,18,3,8,2,10,6,7,0,2,2,2,0,2,0,18
3762,775084,33,5,11,4,6,1,5,0,0,0,5,3,1,0,2,0,11
3762,786860,17,3,5,2,2,1,3,0,0,1,1,0,2,0,0,2,7
3762,797509,3,0,0,0,0,0,0,0,0,1,1,0,2,0,2,1,0
3762,786546,20,2,4,2,2,0,2,0,0,1,1,0,0,1,0,0,4
3763,797628,22,5,7,5,7,0,0,0,0,1,2,1,1,0,1,0,10
3763,786481,30,11,20,10,17,1,3,1,5,3,6,2,2,1,0,2,24
3763,797624,31,3,5,1,2,2,3,2,4,0,5,2,1,1,2,1,10
3763,785965,31,0,6,0,3,0,3,4,4,0,5,5,3,0,1,0,4
3763,781032,35,4,9,1,3,3,6,0,0,0,0,1,3,0,0,0,11
3763,791793,13,3,6,1,2,2,4,0,0,0,2,0,3,0,0,0,8
3763,791791,13,1,3,1,2,0,1,1,2,0,0,2,1,1,0,0,3
3763,791790,9,0,2,0,1,0,1,0,0,2,2,1,0,0,2,0,0
3763,786480,16,1,4,1,3,0,1,0,0,0,1,1,3,1,1,0,2
3764,780095,30,5,6,5,6,0,0,2,2,1,2,1,3,0,1,2,12
3764,776321,40,11,18,8,11,3,7,4,5,5,3,2,3,2,1,0,29
3764,786081,32,9,16,7,11,2,5,2,6,5,2,5,1,3,0,0,22
3764,785431,38,9,14,4,6,5,8,1,2,0,3,6,5,1,2,1,24
3764,780232,34,3,10,1,5,2,5,1,1,0,3,4,2,0,0,0,9
3764,786020,3,0,0,0,0,0,0,0,0,1,0,0,0,0,0,0,0
3764,785356,7,0,1,0,0,0,1,0,0,1,0,0,3,0,0,0,0
3764,789040,16,1,5,1,3,0,2,3,3,3,2,0,2,0,0,0,5
3765,791839,34,10,11,10,11,0,0,2,2,4,1,7,1,0,1,0,22
3765,785322,31,5,7,1,1,4,6,0,0,0,5,2,1,0,0,0,14
3765,792381,33,6,12,2,4,4,8,5,6,0,2,2,4,0,2,0,21
3765,791842,26,2,8,1,4,1,4,1,1,0,5,1,3,0,2,0,6
3765,786616,33,2,8,1,5,1,3,2,2,0,3,2,2,0,3,0,7
3765,797443,4,0,0,0,0,0,0,0,0,0,1,1,1,0,0,1,0
3765,797444,8,1,3,0,0,1,3,3,4,1,0,0,1,0,0,0,6
3765,786613,5,1,1,1,1,0,0,2,2,0,0,1,2,0,1,0,4
3765,776341,2,0,0,0,0,0,0,0,0,0,0,1,0,0,0,0,0
3765,786736,24,3,4,3,3,0,1,3,4,0,1,6,2,0,1,0,9
3766,791281,38,7,14,5,10,2,4,7,10,6,8,2,1,1,3,3,23
3766,785764,19,2,3,2,3,0,0,1,2,3,1,0,1,0,1,0,5
3766,796535,10,1,6,0,0,1,6,0,0,0,0,1,0,2,2,0,3
3766,792276,32,4,11,3,5,1,6,3,4,0,2,5,0,1,3,0,12
3766,791278,24,2,6,2,3,0,3,0,0,1,7,1,2,0,1,1,4
3766,796536,13,2,3,2,3,0,0,0,0,4,1,0,4,0,0,1,4
3766,786026,20,4,7,3,5,1,2,5,6,3,2,0,2,1,2,0,14
3766,785507,7,1,3,0,0,1,3,0,2,1,0,0,0,0,0,0,3
3766,785398,29,5,9,4,7,1,2,0,1,4,3,2,1,2,1,1,11
3766,775814,8,0,1,0,1,0,0,0,0,0,0,0,0,0,1,0,0
3767,797343,20,0,3,0,2,0,1,0,0,1,2,0,0,0,2,0,0
3767,791743,20,6,7,6,7,0,0,1,1,1,3,0,4,0,4,0,13
3767,791747,39,11,24,8,16,3,8,5,5,2,4,3,2,1,5,0,30
3767,791746,13,0,1,0,1,0,0,0,0,0,2,2,2,1,2,1,0
3767,786193,33,1,3,0,1,1,2,0,0,0,1,1,2,0,0,0,3
3767,797342,19,1,1,1,1,0,0,0,0,0,3,0,3,2,0,1,2
3767,791744,2,0,0,0,0,0,0,0,0,0,0,0,0,0,0,0,0
3767,797341,22,3,4,3,4,0,0,0,1,1,1,0,3,0,1,0,6
3767,797340,15,2,9,1,5,1,4,0,0,0,1,0,3,0,2,0,5
3767,780711,17,2,3,1,1,1,2,0,0,0,2,1,0,0,0,1,5
3800,797591,17,1,4,0,0,1,4,0,0,0,0,1,3,0,0,0,3
3800,781071,32,4,9,1,2,3,7,0,1,0,5,2,1,0,2,2,11
3800,791889,37,6,9,4,5,2,4,0,0,1,2,0,2,0,1,0,14
3800,791890,39,8,17,1,4,7,13,0,0,1,2,5,2,1,1,1,23
3800,780719,36,2,7,1,2,1,5,2,2,0,2,7,3,2,1,1,7
3800,785424,3,1,1,1,1,0,0,0,0,1,0,0,1,0,2,0,2
3800,797589,31,3,10,2,6,1,4,0,0,1,8,4,1,1,1,1,7
3800,797588,5,0,0,0,0,0,0,0,0,0,2,0,0,0,0,1,0
3800,791888,0,0,0,0,0,0,0,0,0,0,0,0,0,0,1,0,0
3801,791344,34,2,3,2,3,0,0,2,4,2,9,1,1,0,0,0,6
3801,781425,37,4,7,4,7,0,0,0,0,3,12,0,2,1,4,0,8
3801,791343,38,4,11,3,8,1,3,1,2,1,2,5,2,0,3,0,10
3801,781602,32,6,16,6,11,0,5,2,3,0,2,1,4,4,4,0,14
3801,775746,36,5,10,2,5,3,5,2,2,2,1,0,2,1,2,1,15
3801,781601,2,0,1,0,1,0,0,0,0,1,2,0,1,0,1,0,0
3801,797001,15,1,4,0,3,1,1,0,0,0,1,0,2,0,2,0,3
3801,797000,6,0,0,0,0,0,0,0,0,0,0,0,1,0,1,0,0
3802,796699,23,4,7,3,4,1,3,6,7,1,8,2,3,3,0,4,15
3802,790983,21,2,6,2,2,0,4,0,0,0,1,0,4,0,4,2,4
3802,790979,34,6,12,3,6,3,6,4,5,3,5,4,2,1,3,1,19
3802,796697,32,8,19,7,12,1,7,9,10,1,3,9,3,3,5,0,26
3802,788820,26,3,6,1,2,2,4,2,3,0,2,1,4,1,2,0,10
3802,796701,26,2,4,2,4,0,0,2,2,1,3,0,1,1,2,2,6
3802,790978,24,4,6,3,3,1,3,1,1,0,2,1,3,0,2,1,10
3802,790980,6,0,1,0,1,0,0,0,0,0,1,0,0,0,0,0,0
3802,796698,3,0,0,0,0,0,0,0,0,0,1,0,0,0,2,0,0
3802,790976,5,0,1,0,1,0,0,0,0,0,2,0,2,0,0,0,0
3803,776110,26,7,12,4,6,3,6,3,5,5,2,4,2,3,1,1,20
3803,780059,34,7,9,7,9,0,0,5,5,2,6,2,4,5,4,2,19
3803,796494,38,5,17,1,9,4,8,8,8,3,2,3,2,2,5,1,22
3803,790944,27,4,13,3,8,1,5,2,4,1,6,1,2,1,0,0,11
3803,780061,30,4,10,3,3,1,7,1,1,1,7,2,4,1,2,0,10
3803,790941,2,0,2,0,0,0,2,0,0,0,0,0,1,0,1,0,0
3803,780058,12,1,3,0,0,1,3,0,0,0,1,1,1,1,0,0,3
3803,796496,19,1,4,1,3,0,1,5,5,0,1,1,5,2,2,0,7
3803,790943,12,1,3,1,3,0,0,0,1,0,1,0,4,0,1,1,2
3804,790764,31,10,15,6,8,4,7,2,2,4,2,2,4,3,3,0,26
3804,796322,4,0,0,0,0,0,0,0,0,1,1,0,2,0,3,0,0
3804,796319,39,8,15,7,8,1,7,4,6,3,3,2,0,0,1,2,21
3804,796320,36,5,11,3,4,2,7,0,0,1,1,4,1,0,2,0,12
3804,779993,38,6,10,4,7,2,3,0,0,3,2,5,2,3,0,0,14
3804,796321,17,0,2,0,1,0,1,0,0,0,3,2,3,3,1,1,0
3804,790761,27,1,7,1,5,0,2,2,2,2,6,2,4,1,4,0,4
3804,785219,8,1,1,1,1,0,0,0,0,0,1,0,0,0,0,1,2
3804,796323,0,0,0,0,0,0,0,0,0,0,0,0,0,0,0,0,0
3805,790899,14,3,5,3,5,0,0,3,4,1,0,1,5,1,2,0,9
3805,785442,35,3,5,2,3,1,2,2,2,1,2,0,2,0,1,0,9
3805,799907,29,3,7,3,6,0,1,2,2,0,2,3,2,3,7,0,8
3805,785579,39,6,9,5,5,1,4,4,4,0,2,2,1,2,2,0,17
3805,775737,19,1,3,0,0,1,3,0,0,0,0,0,1,1,1,0,3
3805,790897,26,5,10,3,4,2,6,5,7,2,6,0,3,0,2,1,17
3805,790898,6,0,2,0,1,0,1,0,0,0,2,0,0,0,0,0,0
3805,785448,11,0,3,0,2,0,1,0,0,0,1,1,0,0,0,0,0
3805,796446,4,0,1,0,1,0,0,0,0,1,0,0,1,0,0,0,0
3805,775959,17,1,3,0,1,1,2,2,2,1,2,1,1,0,0,1,5
3806,780634,25,3,5,3,5,0,0,2,3,4,4,0,3,2,2,1,8
3806,786785,34,5,12,4,8,1,4,0,0,1,3,2,3,1,0,1,11
3806,786784,24,3,9,2,7,1,2,0,0,1,2,0,1,0,0,0,7
3806,780633,29,2,10,2,5,0,5,0,1,1,1,3,2,1,1,1,4
3806,776009,30,9,15,8,12,1,3,0,1,0,2,2,2,2,1,0,19
3806,797390,6,0,2,0,1,0,1,0,0,0,0,0,3,0,1,0,0
3806,791826,22,3,4,3,4,0,0,1,2,0,4,3,3,2,0,0,7
3806,786783,23,4,9,2,4,2,5,2,3,1,3,3,4,0,0,0,12
3806,780635,2,0,0,0,0,0,0,0,0,0,0,0,1,0,0,0,0
3806,797387,5,0,0,0,0,0,0,0,0,0,0,0,0,0,0,0,0
3807,790873,31,5,9,4,7,1,2,4,6,0,6,2,1,0,1,3,15
3807,780054,31,3,4,3,3,0,1,6,9,2,8,5,4,0,2,0,12
3807,781140,30,6,9,5,7,1,2,0,0,2,3,0,1,0,0,0,13
3807,786851,34,6,14,2,6,4,8,1,2,1,0,1,1,2,4,0,17
3807,780343,28,2,6,0,1,2,5,0,0,1,2,4,3,1,1,0,6
3807,785429,11,1,4,0,0,1,4,0,0,0,0,0,0,0,1,0,3
3807,796433,9,1,1,1,1,0,0,6,9,2,4,1,1,0,1,2,8
3807,781139,9,0,0,0,0,0,0,2,2,0,2,0,3,0,1,0,2
3807,776245,9,1,2,0,0,1,2,0,0,0,3,0,0,0,0,0,3
3807,796432,4,0,0,0,0,0,0,0,0,0,2,1,0,0,0,0,0
3807,799973,4,0,0,0,0,0,0,0,0,0,0,0,0,0,0,0,0
3808,797728,25,3,5,2,3,1,2,1,2,0,5,0,2,1,3,1,8
3808,792036,24,3,7,3,6,0,1,0,0,0,1,3,2,2,0,0,6
3808,786266,30,4,6,4,5,0,1,1,2,0,5,0,1,0,1,0,9
3808,792040,31,6,10,6,9,0,1,2,3,0,7,2,2,3,2,0,14
3808,775028,31,7,12,7,9,0,3,1,1,0,5,4,2,1,5,0,15
3808,797726,17,2,3,1,2,1,1,1,2,0,4,0,5,1,2,0,6
3808,786039,10,1,1,1,1,0,0,1,2,1,1,0,0,0,1,0,3
3808,797719,15,2,5,1,1,1,4,0,0,0,0,1,1,0,0,0,5
3808,797718,17,1,3,0,2,1,1,2,2,0,2,3,0,1,2,0,5
3809,775110,33,4,7,4,7,0,0,2,4,1,12,0,1,1,3,0,10
3809,797135,25,2,7,1,3,1,4,0,0,1,2,0,4,0,3,0,5
3809,791392,36,1,3,1,2,0,1,1,3,0,3,3,3,2,2,1,3
3809,780128,34,7,16,3,8,4,8,6,6,0,1,3,2,0,1,0,24
3809,775458,27,6,14,3,6,3,8,0,0,0,2,2,4,1,4,0,15
3809,797140,6,1,1,0,0,1,1,0,0,0,0,0,2,0,1,0,3
3809,797134,3,0,0,0,0,0,0,0,0,0,2,0,0,0,0,1,0
3809,786062,2,0,0,0,0,0,0,0,0,0,0,0,1,0,1,0,0
3809,797138,4,0,1,0,1,0,0,0,0,0,0,0,0,0,0,0,0
3809,785264,17,0,3,0,2,0,1,0,0,0,1,2,2,1,0,0,0
3809,785936,11,1,2,0,0,1,2,0,0,0,2,1,1,1,0,0,3
3809,781353,2,0,0,0,0,0,0,0,0,0,0,0,0,0,0,0,0
3810,791216,17,3,5,2,3,1,2,0,0,1,0,0,2,1,2,0,7
3810,791209,11,0,0,0,0,0,0,0,0,1,1,0,5,0,0,2,0
3810,791215,35,9,14,6,8,3,6,8,12,1,1,0,4,0,3,0,29
3810,791213,33,3,12,3,8,0,4,2,2,0,2,3,2,0,0,1,8
3810,776313,28,2,8,2,4,0,4,0,0,3,5,1,2,1,0,0,4
3810,785589,30,3,9,3,8,0,1,4,6,1,9,2,2,1,3,1,10
3810,791207,11,0,2,0,2,0,0,0,1,0,2,0,1,0,0,0,0
3810,776364,18,1,3,1,1,0,2,0,0,0,2,1,1,3,1,0,2
3810,791210,17,0,1,0,0,0,1,3,4,0,1,3,1,0,1,0,3
3811,785996,28,1,4,1,4,0,0,2,2,3,3,1,3,1,0,0,4
3811,780858,30,4,11,4,6,0,5,2,2,2,4,1,2,0,1,1,10
3811,797646,17,1,2,1,2,0,0,0,0,1,2,4,1,1,1,0,2
3811,780849,21,3,7,0,2,3,5,3,4,1,3,0,2,1,3,0,12
3811,780853,35,6,14,4,9,2,5,2,6,0,5,5,2,1,4,0,16
3811,792039,17,2,3,1,1,1,2,1,5,3,1,0,3,0,1,1,6
3811,792235,11,2,4,2,4,0,0,3,4,2,3,0,4,0,2,0,7
3811,785998,10,1,3,0,0,1,3,0,0,0,2,0,0,0,2,0,3
3811,785990,25,2,6,2,5,0,1,2,4,0,4,2,1,0,1,0,6
3811,786010,6,1,1,0,0,1,1,0,0,0,1,0,2,0,0,0,3
3812,775820,19,1,2,0,1,1,1,0,0,1,4,0,2,1,0,0,3
3812,775538,30,1,1,1,1,0,0,0,0,1,1,0,2,2,2,1,2
3812,791110,20,1,7,1,7,0,0,1,2,0,2,0,2,1,2,1,3
3812,785603,34,3,13,2,8,1,5,3,3,0,3,5,2,2,4,1,10
3812,776425,36,9,13,6,8,3,5,1,3,0,3,3,2,0,1,0,22
3812,796763,4,0,1,0,0,0,1,0,0,0,0,0,2,0,0,0,0
3812,791107,7,1,4,1,4,0,0,0,0,0,0,0,2,0,0,0,2
3812,791106,24,3,5,1,2,2,3,0,0,1,2,0,1,1,1,0,8
3812,786494,26,5,6,4,5,1,1,0,0,0,4,0,0,0,1,1,11
3813,791201,29,5,6,5,6,0,0,2,2,1,6,0,1,0,2,2,12
3813,791202,17,0,3,0,1,0,2,0,0,0,2,0,2,0,0,0,0
3813,775767,32,7,11,7,11,0,0,6,9,3,11,2,1,0,1,1,20
3813,785628,38,2,11,2,8,0,3,0,0,2,0,6,0,3,6,0,4
3813,785627,33,4,11,2,5,2,6,3,3,2,4,1,1,1,1,0,13
3813,796904,0,0,0,0,0,0,0,0,0,0,0,0,0,0,0,0,0
3813,781135,8,0,0,0,0,0,0,0,0,1,1,0,1,1,0,0,0
3813,796902,6,0,1,0,0,0,1,0,0,0,0,0,0,1,0,0,0
3813,796901,9,1,2,0,0,1,2,1,2,0,0,0,1,0,1,0,4
3813,785629,28,3,5,2,3,1,2,0,0,0,1,3,4,2,2,0,7
3814,791980,18,1,2,1,1,0,1,0,0,2,1,0,4,0,1,1,2
3814,785972,28,3,7,2,5,1,2,2,4,4,4,0,4,1,2,1,9
3814,785967,35,6,16,6,16,0,0,2,6,4,12,2,2,1,4,1,14
3814,791977,26,4,11,1,3,3,8,3,3,0,1,1,2,0,1,0,14
3814,791978,37,4,11,2,8,2,3,2,2,1,2,2,0,1,3,0,12
3814,791976,29,5,13,2,3,3,10,4,4,0,1,1,1,1,1,0,17
3814,780160,11,0,0,0,0,0,0,0,0,0,1,1,2,1,2,0,0
3814,797800,6,0,0,0,0,0,0,0,0,0,1,1,3,0,0,0,0
3814,797801,2,0,0,0,0,0,0,0,0,0,1,0,0,0,0,0,0
3814,785973,8,1,2,1,1,0,1,0,0,0,0,1,0,0,0,0,2
3815,796469,33,4,10,4,6,0,4,4,8,2,12,0,3,0,1,0,12
3815,779981,17,1,2,1,2,0,0,0,0,0,3,0,5,1,1,0,2
3815,785463,37,7,11,7,9,0,2,5,6,1,4,6,2,1,3,0,19
3815,779978,29,5,10,5,6,0,4,3,3,1,1,2,2,0,4,1,13
3815,776003,35,6,14,2,7,4,7,0,0,0,3,1,1,1,2,0,16
3815,790923,21,4,8,4,7,0,1,2,2,3,1,0,2,2,2,1,10
3815,785466,20,0,1,0,0,0,1,0,1,3,2,0,1,1,0,0,0
3815,779980,8,0,2,0,2,0,0,0,0,1,0,0,2,0,0,0,0
3816,791781,8,0,3,0,3,0,0,0,0,1,2,2,0,0,0,1,0
3816,776285,18,3,6,3,6,0,0,1,3,4,1,0,3,0,2,1,7
3816,791777,26,3,12,3,9,0,3,4,7,1,2,4,2,0,2,1,10
3816,781025,25,1,4,1,3,0,1,0,0,0,6,1,3,0,2,1,2
3816,780488,17,2,4,1,2,1,2,5,6,0,1,0,1,2,2,0,10
3816,791778,5,0,0,0,0,0,0,0,0,0,2,0,0,0,0,0,0
3816,786476,16,1,3,1,3,0,0,0,0,3,0,0,2,0,1,2,2
3816,791780,2,0,1,0,0,0,1,0,0,0,0,0,1,0,0,0,0
3816,791776,7,0,1,0,0,0,1,0,0,0,1,0,1,0,0,0,0
3816,791829,17,2,5,0,0,2,5,8,8,0,5,1,1,0,1,0,14
3816,786474,29,3,10,0,4,3,6,0,0,1,3,2,1,1,1,0,9
3816,775503,30,7,14,3,4,4,10,2,3,1,2,1,2,1,0,1,20
3817,788113,26,6,11,4,7,2,4,0,0,6,4,1,4,1,1,0,14
3817,776497,28,8,19,4,11,4,8,4,5,1,1,0,1,0,0,1,24
3817,785731,22,0,6,0,5,0,1,2,2,2,4,4,2,1,1,2,2
3817,785729,27,3,6,3,6,0,0,0,0,1,2,2,1,1,0,1,6
3817,780864,21,1,3,0,0,1,3,4,4,1,5,1,2,0,2,0,7
3817,799881,2,1,1,1,1,0,0,1,1,0,0,0,0,0,1,0,3
3817,792405,6,1,1,1,1,0,0,0,0,0,1,1,0,0,0,0,2
3817,776397,5,1,1,1,1,0,0,0,0,0,3,0,3,0,4,0,2
3817,797296,19,2,6,2,4,0,2,2,2,1,0,3,3,1,0,0,6
3817,792402,7,2,3,1,2,1,1,0,0,0,0,2,1,0,1,0,5
3817,796211,3,0,1,0,1,0,0,0,0,0,0,0,2,0,0,0,0
3817,786231,19,1,11,1,5,0,6,1,2,1,6,3,3,0,0,1,3
3817,785443,15,1,2,1,1,0,1,2,2,1,0,2,2,1,1,0,4
3818,792110,19,4,6,3,4,1,2,1,2,2,2,0,3,0,2,2,10
3818,786031,30,3,8,3,7,0,1,7,7,4,4,2,1,1,2,1,13
3818,797734,33,4,15,3,11,1,4,0,0,2,2,1,2,0,2,0,9
3818,797735,32,4,9,1,4,3,5,1,2,1,7,1,2,1,4,0,12
3818,781386,38,3,14,3,10,0,4,2,4,0,2,7,2,3,2,0,8
3818,786033,21,4,5,4,5,0,0,1,3,4,5,0,2,1,1,1,9
3818,797733,13,1,3,1,2,0,1,2,2,1,3,0,1,0,1,0,4
3818,792109,11,1,1,1,1,0,0,0,0,0,2,0,3,0,0,0,2
3818,792105,3,0,0,0,0,0,0,0,0,0,0,0,0,0,0,0,0
3819,796850,14,1,2,1,1,0,1,0,0,0,0,0,3,1,1,0,2
3819,774969,33,6,14,6,14,0,0,2,4,7,8,2,0,0,0,1,14
3819,796848,39,6,14,5,10,1,4,0,0,3,3,0,4,0,2,0,13
3819,791181,34,1,4,1,2,0,2,3,5,0,3,2,4,1,3,3,5
3819,781054,39,6,14,5,10,1,4,0,1,0,3,3,3,0,3,0,13
3819,780981,8,2,3,2,2,0,1,0,0,0,0,2,3,1,1,0,4
3819,791179,33,4,10,2,4,2,6,1,1,0,3,1,4,3,0,3,11
3820,775738,19,2,4,2,3,0,1,1,2,0,0,0,4,0,1,0,5
3820,786096,26,4,7,3,4,1,3,2,3,1,4,2,1,4,3,0,11
3820,786728,32,7,11,7,9,0,2,3,3,0,0,3,3,4,3,1,17
3820,785904,31,9,17,3,6,6,11,6,6,0,4,1,2,0,6,0,30
3820,780892,30,2,4,1,3,1,1,2,2,0,3,5,2,0,2,0,7
3820,786091,19,2,7,0,3,2,4,5,6,2,3,1,1,0,0,0,11
3820,797669,6,0,0,0,0,0,0,0,0,0,0,0,1,0,0,0,0
3820,797666,4,0,0,0,0,0,0,0,2,0,0,0,0,0,0,0,0
3820,786788,21,0,2,0,0,0,2,2,2,4,0,0,0,1,0,0,2
3820,781030,12,0,3,0,1,0,2,0,0,0,2,0,1,0,1,0,0
3821,781650,14,4,6,4,6,0,0,0,0,0,2,0,5,0,2,0,8
3821,797070,21,3,6,1,2,2,4,0,0,0,2,0,0,0,1,0,8
3821,791432,35,3,5,3,3,0,2,0,0,0,0,2,1,1,2,0,6
3821,777865,30,5,11,5,8,0,3,6,6,0,4,2,5,2,2,0,16
3821,791429,27,2,8,2,5,0,3,0,0,0,1,6,3,2,5,0,4
3821,797066,18,3,4,3,4,0,0,1,2,0,3,0,2,0,3,1,7
3821,780180,21,2,3,2,3,0,0,4,4,2,2,1,3,1,1,0,8
3821,785401,7,0,0,0,0,0,0,0,0,0,0,0,2,0,0,1,0
3821,797067,25,5,8,5,6,0,2,0,0,1,2,3,2,0,2,0,10
3821,791428,2,0,0,0,0,0,0,0,0,0,0,0,0,0,0,0,0
3822,785836,31,2,8,1,4,1,4,3,5,2,7,0,3,0,3,4,8
3822,785833,20,0,2,0,1,0,1,0,0,2,2,3,3,0,3,0,0
3822,791707,31,3,5,1,3,2,2,2,2,0,1,2,2,0,2,0,10
3822,785838,14,2,7,2,6,0,1,0,0,1,1,0,0,1,1,0,4
3822,780577,16,1,5,1,1,0,4,0,0,0,3,0,1,0,0,0,2
3822,791705,12,3,7,3,5,0,2,0,0,3,2,1,1,0,0,0,6
3822,775872,10,0,3,0,1,0,2,1,2,0,0,0,1,1,0,0,1
3822,785332,7,1,3,1,2,0,1,1,2,1,2,0,1,0,0,0,3
3822,797534,3,0,0,0,0,0,0,0,0,0,0,0,0,0,0,0,0
3822,797533,16,2,5,2,3,0,2,0,0,0,1,0,2,0,0,0,4
3822,785892,23,4,8,3,5,1,3,0,0,1,2,1,2,1,2,0,9
3822,791704,17,2,5,0,3,2,2,1,2,0,4,0,1,0,0,0,7
3823,781158,25,4,7,4,7,0,0,0,0,1,6,2,2,0,0,0,8
3823,781652,33,4,10,3,8,1,2,4,4,1,4,0,1,1,1,0,13
3823,786034,32,6,11,2,5,4,6,1,1,1,3,1,0,1,1,0,17
3823,786419,25,2,6,2,5,0,1,7,8,0,1,0,2,0,2,0,11
3823,781283,20,0,4,0,1,0,3,2,2,0,0,2,3,0,1,0,2
3823,791614,3,0,0,0,0,0,0,0,0,1,0,0,0,0,0,0,0
3823,785419,17,1,4,0,2,1,2,2,2,2,1,0,3,0,1,0,5
3823,796993,3,1,2,1,1,0,1,0,0,0,1,0,1,0,0,0,2
3823,796992,1,0,0,0,0,0,0,0,0,0,0,0,0,0,0,0,0
3823,796991,1,0,1,0,0,0,1,0,0,1,0,0,0,0,0,0,0
3823,791615,21,2,6,2,4,0,2,2,2,1,9,1,4,0,2,2,6
3823,785277,19,2,7,1,3,1,4,0,0,0,3,0,3,2,3,0,5
3824,786509,37,3,3,3,3,0,0,6,7,2,5,2,4,1,3,1,12
3824,786508,44,4,14,2,3,2,11,4,6,1,8,3,3,0,4,1,14
3824,786507,21,1,2,0,0,1,2,0,0,0,2,0,2,0,0,0,3
3824,785796,1,1,1,1,1,0,0,0,0,0,0,0,0,0,0,0,2
3824,797576,39,8,16,5,6,3,10,2,2,0,7,1,3,0,2,0,21
3824,797577,9,0,1,0,1,0,0,2,2,0,0,0,2,0,0,0,2
3824,791897,9,0,2,0,0,0,2,0,0,0,0,0,3,0,1,0,0
3824,786505,35,2,9,0,3,2,6,2,2,0,0,0,2,0,0,0,8
3824,781325,30,4,8,3,4,1,4,3,3,1,3,0,4,0,1,0,12
3825,791652,14,0,1,0,1,0,0,1,4,2,1,0,5,0,0,0,1
3825,786495,31,1,4,1,1,0,3,1,2,1,7,0,2,1,2,0,3
3825,797285,21,0,3,0,1,0,2,2,2,0,0,0,2,0,0,0,2
3825,791650,40,13,23,12,20,1,3,9,10,1,8,1,2,0,3,1,36
3825,776384,42,10,17,8,10,2,7,0,0,0,4,2,3,3,2,0,22
3825,791653,9,1,5,0,2,1,3,0,0,0,2,0,3,0,0,0,3
3825,775705,26,2,3,2,3,0,0,0,1,1,4,0,2,0,0,0,4
3825,797289,2,0,1,0,0,0,1,0,0,0,0,0,0,0,0,0,0
3825,797286,8,1,4,1,1,0,3,1,1,2,0,0,0,0,1,0,3
3825,797283,32,0,4,0,1,0,3,2,2,0,1,1,2,0,0,0,2
3826,780218,32,2,12,1,8,1,4,2,3,4,5,0,3,1,1,1,7
3826,790771,32,3,7,2,3,1,4,2,4,1,8,0,2,0,0,3,9
3826,790772,33,2,10,1,7,1,3,1,2,2,4,3,1,0,1,0,6
3826,796328,34,5,7,4,5,1,2,3,5,2,2,2,0,1,2,0,14
3826,780375,32,4,8,3,6,1,2,1,1,1,4,1,1,1,6,0,10
3826,790774,8,1,1,0,0,1,1,0,0,0,0,1,0,0,0,0,3
3826,785230,21,0,9,0,5,0,4,0,0,1,0,2,2,0,0,0,0
3826,796329,8,0,1,0,0,0,1,0,0,0,0,0,1,0,1,2,0
3827,775510,35,7,16,5,10,2,6,1,2,2,8,1,2,2,2,0,17
3827,774976,29,7,11,7,10,0,1,4,4,2,6,0,4,1,2,5,18
3827,797865,37,0,4,0,2,0,2,4,4,0,3,3,1,0,0,0,4
3827,786614,38,3,9,1,3,2,6,0,0,0,4,0,3,0,1,1,8
3827,786759,40,6,8,6,8,0,0,0,0,0,3,3,0,0,1,0,12
3827,792294,9,1,5,1,5,0,0,0,0,1,3,0,2,0,0,0,2
3827,792291,7,0,0,0,0,0,0,0,0,0,0,0,2,0,0,0,0
3827,786761,3,0,0,0,0,0,0,0,0,0,0,0,1,0,0,0,0
3827,797867,2,0,0,0,0,0,0,0,0,0,0,0,0,0,0,0,0
3828,774962,35,4,9,2,2,2,7,1,1,0,0,1,0,2,1,0,11
3828,796912,33,1,6,0,1,1,5,5,5,0,5,1,3,1,0,0,8
3828,774964,31,3,7,3,7,0,0,0,2,3,11,5,1,1,2,2,6
3828,796907,23,1,3,0,0,1,3,2,2,3,2,1,2,0,5,2,5
3828,775626,19,1,4,1,3,0,1,2,4,2,2,0,5,0,3,0,4
3828,775566,20,2,9,1,3,1,6,1,2,0,1,1,1,1,2,0,6
3828,796910,10,2,4,2,3,0,1,0,0,0,1,0,1,0,0,0,4
3828,785606,10,1,3,1,2,0,1,0,0,0,2,0,2,0,0,1,2
3828,785609,8,1,1,1,1,0,0,0,0,0,1,0,0,0,0,0,2
3828,796906,9,0,1,0,0,0,1,0,0,0,1,0,0,0,1,0,0
3828,796908,2,0,0,0,0,0,0,0,0,0,0,1,0,0,0,0,0
3829,785746,40,5,11,3,5,2,6,5,7,1,1,0,4,1,0,0,17
3829,785741,39,3,15,3,8,0,7,2,3,2,7,4,3,4,1,0,8
3829,785755,33,3,4,3,4,0,0,2,2,4,5,0,0,0,1,0,8
3829,791276,16,3,4,3,4,0,0,2,4,2,8,2,4,0,4,0,8
3829,796529,38,0,10,0,6,0,4,0,0,1,1,5,2,1,5,0,0
3829,791275,24,1,6,1,2,0,4,0,0,1,2,0,4,1,3,0,2
3829,796526,10,0,1,0,0,0,1,2,2,0,0,0,2,0,0,0,2
3830,791194,33,3,10,2,8,1,2,1,3,6,2,1,4,2,3,0,8
3830,791193,23,4,7,4,7,0,0,2,2,2,2,0,1,0,1,1,10
3830,786738,37,7,11,7,10,0,1,8,9,2,2,4,2,2,3,0,22
3830,775694,16,0,4,0,2,0,2,0,0,0,0,0,3,1,1,0,0
3830,774827,28,3,12,2,9,1,3,0,1,1,1,5,4,0,2,0,7
3830,780384,15,3,5,3,5,0,0,2,3,1,2,0,4,0,0,1,8
3830,780159,18,1,3,1,2,0,1,0,0,1,2,3,0,1,2,0,2
3830,796863,19,3,6,2,4,1,2,1,2,1,1,1,4,3,2,0,8
3830,796865,11,1,2,0,0,1,2,0,0,0,1,0,1,0,1,0,3
3831,780765,35,6,13,5,9,1,4,2,2,2,6,2,2,1,6,0,15
3831,781301,16,4,4,4,4,0,0,1,2,2,2,0,4,0,0,1,9
3831,786255,35,6,13,6,11,0,2,6,7,2,4,2,3,0,4,0,18
3831,780762,30,3,7,1,1,2,6,3,4,0,3,1,2,1,3,0,11
3831,780768,23,1,3,0,1,1,2,4,4,1,2,4,5,2,1,0,7
3831,791729,26,5,7,5,6,0,1,0,0,3,4,2,4,1,2,0,10
3831,780755,18,1,3,1,1,0,2,0,0,1,2,3,0,2,2,0,2
3831,797320,17,0,0,0,0,0,0,4,4,0,1,2,2,0,2,0,4
3832,780494,22,6,7,6,7,0,0,0,0,2,4,0,3,2,2,0,12
3832,797276,22,3,5,2,4,1,1,1,2,1,0,1,1,4,0,0,8
3832,780497,26,3,6,2,5,1,1,2,2,1,9,4,0,0,1,0,9
3832,780496,25,1,3,0,0,1,3,3,4,0,3,3,1,1,1,1,6
3832,780495,31,6,13,4,9,2,4,7,7,1,2,1,2,0,2,0,21
3832,797277,3,0,0,0,0,0,0,0,0,0,1,0,0,0,0,0,0
3832,797274,9,1,2,1,2,0,0,2,2,0,3,2,2,0,1,1,4
3832,785693,16,0,0,0,0,0,0,2,4,1,1,0,3,0,1,2,2
3832,797275,4,1,1,0,0,1,1,1,2,0,1,0,0,1,0,0,4
3832,791643,13,3,6,3,3,0,3,0,0,1,0,1,0,0,0,0,6
3832,785692,16,0,1,0,1,0,0,0,0,0,0,1,4,0,1,0,0
3832,785644,13,3,10,1,8,2,2,0,0,0,1,0,0,0,0,0,8
3833,797058,20,2,4,0,1,2,3,0,0,0,2,0,1,0,2,0,6
3833,775549,21,6,8,6,8,0,0,0,4,2,7,0,4,0,3,1,12
3833,797056,27,5,11,3,4,2,7,0,2,0,1,3,3,0,1,0,12
3833,797054,26,2,7,0,2,2,5,0,0,0,1,1,2,1,4,0,6
3833,786381,21,1,3,0,0,1,3,0,0,0,4,0,2,1,1,0,3
3833,791564,19,2,7,2,2,0,5,0,0,1,3,4,2,1,1,2,4
3833,780425,19,3,4,3,4,0,0,0,1,2,3,0,2,0,0,0,6
3833,797057,2,0,0,0,0,0,0,0,0,0,0,0,0,0,1,0,0
3833,791568,15,0,2,0,2,0,0,0,0,0,0,0,2,1,1,0,0
3833,797055,30,5,9,3,5,2,4,3,3,1,0,5,1,0,0,0,15
3834,781612,19,5,6,5,6,0,0,0,0,1,5,1,4,0,1,1,10
3834,786459,35,4,9,4,9,0,0,5,6,2,6,4,2,0,3,0,13
3834,797005,27,0,5,0,0,0,5,0,0,1,0,0,1,1,4,1,0
3834,797004,29,3,7,1,2,2,5,1,2,0,0,8,2,2,5,0,9
3834,781609,27,6,9,2,3,4,6,0,2,1,8,1,4,1,3,0,16
3834,797008,5,0,0,0,0,0,0,0,0,0,1,0,1,0,1,0,0
3834,797006,19,1,5,1,4,0,1,0,0,0,0,1,3,0,1,0,2
3834,791360,25,5,9,1,1,4,8,0,0,0,3,0,1,0,2,0,14
3834,797003,14,1,4,0,0,1,4,1,2,1,0,0,2,0,1,1,4
3835,796585,13,2,4,2,4,0,0,0,0,0,2,0,4,0,2,0,4
3835,780192,32,8,10,5,5,3,5,0,1,3,2,0,2,1,1,0,19
3835,798139,17,1,3,1,2,0,1,0,2,0,2,2,1,0,2,0,2
3835,786818,32,9,13,9,13,0,0,2,2,1,3,0,3,2,2,2,20
3835,780182,29,3,11,1,3,2,8,4,4,1,2,2,1,1,1,0,12
3835,796587,1,0,0,0,0,0,0,0,0,0,0,0,0,0,0,0,0
3835,790974,1,0,0,0,0,0,0,0,0,0,0,0,0,0,0,0,0
3835,780186,26,4,6,4,6,0,0,0,0,3,4,4,2,3,2,0,8
3835,798138,7,0,3,0,0,0,3,0,0,1,0,1,0,0,0,0,0
3835,786819,1,0,0,0,0,0,0,0,0,0,0,0,0,0,0,0,0
3835,786820,23,2,9,2,8,0,1,3,5,1,7,3,1,3,1,0,7
3835,780188,1,0,0,0,0,0,0,0,0,0,0,0,0,0,0,0,0
3835,780184,17,3,5,1,1,2,4,3,3,0,1,2,1,0,1,0,11
3836,780201,40,11,12,11,12,0,0,3,3,6,6,1,2,1,2,1,25
3836,797210,22,2,2,2,2,0,0,5,5,0,1,6,3,1,4,0,9
3836,797208,30,3,6,3,6,0,0,4,5,1,4,1,3,1,3,0,10
3836,791467,40,4,15,3,7,1,8,1,2,2,3,3,2,1,1,0,10
3836,786311,26,2,8,0,2,2,6,0,0,0,2,2,3,2,3,0,6
3836,798344,22,4,8,4,6,0,2,0,0,0,7,0,1,1,3,0,8
3836,775516,20,1,4,1,4,0,0,1,2,0,0,4,0,2,2,0,3
3837,791440,19,4,4,4,4,0,0,0,2,0,4,1,3,1,1,0,8
3837,797013,23,3,9,3,6,0,3,1,1,0,3,2,3,0,2,0,7
3837,791441,25,4,4,3,3,1,1,0,0,0,2,3,2,2,4,0,9
3837,781378,36,6,10,4,5,2,5,2,2,2,8,2,3,2,8,3,16
3837,775267,35,3,7,0,1,3,6,1,3,0,0,7,3,0,1,0,10
3837,791443,5,1,1,1,1,0,0,0,0,1,0,0,1,0,0,0,2
3837,781629,3,0,0,0,0,0,0,0,0,0,1,0,1,0,1,1,0
3837,797015,21,1,5,1,2,0,3,0,0,0,1,1,1,2,2,0,2
3837,797019,13,0,2,0,2,0,0,0,0,0,1,4,1,1,0,0,0
3837,797016,14,3,5,1,1,2,4,0,0,0,0,1,0,1,0,0,8
3837,774959,6,1,2,0,0,1,2,0,0,0,0,0,0,0,3,0,3
3838,786059,27,4,9,3,7,1,2,2,2,2,4,2,3,0,3,1,11
3838,776174,28,7,8,7,8,0,0,1,2,6,2,3,2,1,2,3,15
3838,791958,27,10,16,10,15,0,1,4,6,5,5,4,2,2,2,0,24
3838,791960,27,1,11,0,4,1,7,4,4,0,3,1,2,2,1,0,7
3838,785861,30,4,9,3,4,1,5,2,4,2,5,1,1,0,0,0,11
3838,786063,3,0,0,0,0,0,0,0,1,0,0,0,0,0,0,0,0
3838,781334,15,4,5,1,1,3,4,0,0,0,3,0,1,1,1,0,11
3838,797706,14,1,2,1,1,0,1,0,0,0,5,2,0,0,1,0,2
3838,797704,22,4,8,0,1,4,7,0,0,1,4,4,3,1,0,0,12
3838,791957,3,0,0,0,0,0,0,0,0,0,0,0,0,0,1,0,0
3838,791959,4,0,0,0,0,0,0,0,0,0,0,2,0,0,0,0,0
3839,780683,12,0,1,0,0,0,1,0,0,0,1,0,0,0,0,0,0
3839,780686,26,3,9,3,9,0,0,1,2,1,6,0,1,1,3,0,7
3839,797679,28,4,14,2,8,2,6,6,6,1,1,0,1,1,1,0,16
3839,797681,25,1,9,1,5,0,4,0,0,0,2,4,2,1,0,0,2
3839,780688,26,3,4,3,3,0,1,1,2,0,0,2,2,0,2,0,7
3839,797682,13,0,2,0,2,0,0,0,0,3,1,0,5,0,1,0,0
3839,791942,15,1,5,1,4,0,1,0,2,0,1,1,1,1,3,0,2
3839,797680,23,3,7,3,6,0,1,7,7,1,2,0,2,0,1,0,13
3839,797683,16,2,4,1,1,1,3,0,1,1,3,0,2,1,0,0,5
3839,780689,10,1,2,0,1,1,1,0,0,0,0,0,0,1,0,0,3
3839,797678,2,0,1,0,1,0,0,0,0,0,0,0,0,0,0,0,0
3839,791941,4,0,1,0,1,0,0,0,0,1,0,0,0,0,0,0,0
3840,786583,10,1,2,1,2,0,0,2,3,1,3,0,0,0,1,0,4
3840,790784,27,4,9,3,5,1,4,0,0,3,1,0,4,1,3,1,9
3840,776219,15,0,2,0,1,0,1,0,0,0,4,2,1,0,0,1,0
3840,786548,28,10,11,10,11,0,0,1,4,4,8,1,4,1,3,2,21
3840,797475,28,2,6,1,3,1,3,3,5,1,2,3,2,2,4,0,8
3840,791871,10,2,2,1,1,1,1,0,0,0,0,2,1,1,1,0,5
3840,786581,18,1,5,1,4,0,1,3,5,1,3,2,2,1,2,1,5
3840,786770,14,3,7,2,5,1,2,0,0,1,2,0,1,1,0,0,7
3840,786719,4,0,1,0,1,0,0,0,0,0,1,0,1,0,0,0,0
3840,786229,22,3,8,3,4,0,4,0,0,1,1,2,0,1,1,1,6
3840,775229,24,2,9,1,6,1,3,2,3,0,3,0,2,3,4,0,7
3842,791032,14,1,2,1,1,0,1,0,0,0,0,2,4,0,1,2,2
3842,780338,20,2,6,2,6,0,0,0,3,1,5,0,2,1,3,1,4
3842,791030,23,3,5,2,4,1,1,2,4,0,2,3,2,0,2,0,9
3842,785477,34,4,9,3,4,1,5,6,6,0,4,1,1,1,5,0,15
3842,785475,25,3,7,1,2,2,5,0,0,0,1,2,3,4,4,0,8
3842,791029,18,0,2,0,1,0,1,2,2,0,5,1,0,0,1,1,2
3842,796689,19,3,4,3,4,0,0,2,3,2,4,1,3,2,0,3,8
3842,791031,1,1,1,0,0,1,1,0,0,0,0,1,0,0,0,0,3
3842,796687,20,0,8,0,4,0,4,0,0,0,2,2,2,0,3,0,0
3842,786655,26,3,6,2,4,1,2,2,2,2,0,1,3,1,3,0,9
3843,791465,21,3,7,3,7,0,0,7,8,3,2,8,0,1,2,0,13
3843,791464,23,5,11,3,7,2,4,1,2,2,2,1,2,0,2,0,13
3843,780200,7,1,3,1,3,0,0,0,0,2,0,0,4,0,1,0,2
3843,786304,32,2,8,2,6,0,2,2,2,1,1,1,3,5,1,1,6
3843,780197,33,4,14,2,7,2,7,1,3,0,5,2,1,2,1,0,11
3843,798342,24,4,7,2,3,2,4,2,4,4,0,1,1,2,2,0,12
3843,786840,1,0,0,0,0,0,0,0,0,0,0,0,0,0,0,0,0
3843,786303,17,1,3,1,3,0,0,3,4,4,7,0,4,2,1,1,5
3843,780616,5,1,1,0,0,1,1,0,0,1,1,0,0,1,1,0,3
3843,798340,1,0,0,0,0,0,0,0,0,0,1,0,0,0,0,0,0
3843,798341,2,0,0,0,0,0,0,0,0,1,0,0,0,0,2,0,0
3843,798343,2,0,1,0,1,0,0,0,0,0,0,0,0,0,0,0,0
3843,786841,1,0,0,0,0,0,0,0,0,0,0,1,0,0,0,0,0
3843,780196,31,7,14,5,10,2,4,2,2,0,3,2,2,4,1,1,18
3844,776286,24,2,5,2,4,0,1,0,0,3,8,0,2,0,0,1,4
3844,775557,21,1,3,1,3,0,0,0,0,5,2,0,1,0,1,0,2
3844,791445,31,10,18,2,3,8,15,0,0,0,1,3,1,1,1,0,28
3844,785357,27,5,12,1,2,4,10,0,0,1,2,3,0,1,2,0,14
3844,775560,16,2,3,2,3,0,0,0,0,2,4,3,2,1,2,0,4
3844,791444,20,0,0,0,0,0,0,1,2,1,7,0,0,0,2,0,1
3844,785287,11,1,1,1,1,0,0,0,0,2,1,1,2,0,2,1,2
3844,797011,4,1,2,1,2,0,0,0,0,1,0,0,0,1,0,0,2
3844,797010,24,1,8,1,5,0,3,1,2,0,5,3,0,0,2,0,3
3844,797012,7,1,3,1,2,0,1,0,0,0,1,0,1,0,1,0,2
3844,785895,15,3,6,0,0,3,6,0,0,1,0,1,2,0,0,0,9
3845,791686,11,0,2,0,2,0,0,0,0,0,1,0,1,0,1,0,0
3845,798028,27,2,3,2,3,0,0,0,0,0,1,0,3,1,1,0,4
3845,790940,26,2,5,0,2,2,3,5,5,0,1,1,4,2,1,0,11
3845,786060,25,1,9,1,5,0,4,2,2,1,1,3,0,0,1,0,4
3845,780770,29,4,11,1,5,3,6,2,3,2,1,1,1,0,0,0,13
3845,792271,25,3,9,3,9,0,0,0,0,1,5,0,1,1,1,1,6
3845,792305,6,1,2,1,2,0,0,0,0,0,0,0,0,0,0,0,2
3845,792269,23,2,3,1,1,1,2,0,0,2,2,2,1,0,3,0,5
3845,798022,7,0,3,0,2,0,1,2,3,0,0,0,1,1,0,0,2
3845,792270,21,0,5,0,2,0,3,3,4,0,3,0,0,2,1,0,3
3846,781606,31,3,9,2,6,1,3,0,0,0,3,1,0,1,1,0,7
3846,791257,11,0,1,0,1,0,0,2,2,0,1,1,4,1,0,0,2
3846,781257,36,1,9,1,5,0,4,3,5,0,1,1,1,2,1,0,5
3846,786620,27,4,8,4,6,0,2,3,3,2,0,3,2,0,2,0,11
3846,791838,17,1,4,0,1,1,3,0,0,0,3,1,2,0,1,0,3
3846,796954,17,3,4,2,2,1,2,2,3,0,0,1,0,0,1,0,9
3846,796955,18,3,6,3,6,0,0,1,1,2,4,0,2,0,1,1,7
3846,781263,31,5,12,4,10,1,2,1,1,2,5,3,1,1,1,2,12
3846,780900,9,1,2,1,1,0,1,0,0,2,2,0,2,1,1,0,2
3846,791255,1,0,0,0,0,0,0,0,0,0,0,0,0,0,0,0,0
3846,796956,2,0,0,0,0,0,0,0,0,0,0,0,0,0,0,0,0
3847,775228,34,2,5,0,1,2,4,0,0,1,5,1,1,2,1,0,6
3847,780773,37,3,11,2,8,1,3,2,2,4,3,5,1,2,3,0,9
3847,791728,15,5,8,5,8,0,0,1,3,1,3,1,3,1,1,1,11
3847,791726,31,3,5,3,4,0,1,2,2,0,1,5,1,1,1,0,8
3847,786273,37,6,13,3,6,3,7,0,0,0,9,6,2,0,3,0,15
3847,797315,3,0,0,0,0,0,0,0,0,0,0,0,1,0,0,0,0
3847,780274,3,1,1,1,1,0,0,1,1,0,1,0,1,0,0,0,3
3847,797317,17,2,6,1,3,1,3,2,2,0,1,1,4,0,0,1,7
3847,786569,22,7,7,7,7,0,0,1,2,2,3,0,1,0,2,0,15
3847,786272,1,0,0,0,0,0,0,0,0,0,0,0,0,0,0,0,0
3848,780377,30,2,5,1,3,1,2,4,4,0,10,0,1,0,1,0,9
3848,791852,33,1,2,1,2,0,0,4,6,2,5,1,1,0,0,2,6
3848,797460,33,1,8,1,6,0,2,1,4,0,4,0,3,0,2,2,3
3848,786601,24,4,10,3,5,1,5,0,0,1,4,0,5,0,0,0,9
3848,786600,22,2,4,2,4,0,0,0,1,1,3,0,2,0,5,0,4
3848,791851,24,2,7,1,3,1,4,0,0,0,4,2,2,0,3,0,5
3848,791853,6,0,2,0,1,0,1,0,0,0,1,0,3,0,0,0,0
3848,797459,11,1,3,1,3,0,0,1,3,1,1,1,1,0,1,0,3
3848,786602,3,0,0,0,0,0,0,0,0,0,1,0,0,0,0,0,0
3848,786599,14,1,3,1,1,0,2,1,2,1,4,0,0,1,2,0,3
3849,780378,22,2,7,2,7,0,0,1,2,1,4,1,2,0,1,2,5
3849,797061,27,2,6,1,3,1,3,0,2,2,1,0,2,1,0,0,5
3849,786374,36,2,13,1,9,1,4,0,0,1,3,1,1,1,1,2,5
3849,786253,25,2,8,2,6,0,2,1,3,0,2,2,3,1,1,0,5
3849,780121,9,1,3,1,1,0,2,0,0,0,0,0,1,0,0,0,2
3849,786404,15,3,7,2,4,1,3,0,0,1,2,1,5,1,1,0,7
3849,780382,18,1,2,1,1,0,1,0,0,1,8,1,1,0,0,1,2
3849,786378,22,2,3,0,0,2,3,2,4,1,0,2,3,2,2,0,8
3849,785798,20,2,10,1,6,1,4,1,1,0,5,1,2,1,0,0,6
3849,780381,6,0,1,0,0,0,1,0,0,0,1,0,0,0,0,0,0
3850,792246,20,7,10,7,10,0,0,2,2,2,4,1,1,0,1,0,16
3850,791701,29,2,5,2,5,0,0,2,4,0,2,1,2,3,1,1,6
3850,792245,26,1,2,1,1,0,1,3,3,0,4,2,2,0,2,0,5
3850,781420,38,5,16,1,4,4,12,0,1,0,4,2,2,1,1,0,14
3850,781405,40,11,15,6,8,5,7,4,5,0,6,3,3,0,4,1,31
3850,797924,3,0,0,0,0,0,0,0,0,0,0,0,1,0,2,0,0
3850,792244,8,1,3,0,2,1,1,0,0,2,2,0,1,0,0,0,3
3850,780615,12,1,1,1,1,0,0,0,0,1,2,0,5,0,0,0,2
3850,797925,24,0,3,0,1,0,2,0,0,0,0,2,2,2,0,0,0
3851,791883,34,3,9,2,4,1,5,0,0,2,7,0,2,2,1,1,7
3851,781066,18,4,4,4,4,0,0,3,4,1,2,0,4,0,3,0,11
3851,797594,30,1,4,0,1,1,3,1,2,1,6,2,3,0,0,0,4
3851,791884,27,4,15,3,10,1,5,9,10,1,2,2,4,0,1,0,18
3851,780695,37,5,12,4,5,1,7,1,1,1,3,0,2,4,2,0,12
3851,797600,16,2,2,2,2,0,0,4,4,2,2,1,0,0,1,0,8
3851,797598,2,0,0,0,0,0,0,0,0,0,0,0,0,0,2,0,0
3851,797596,17,2,6,1,4,1,2,2,2,0,1,4,1,1,1,0,7
3851,786496,19,0,2,0,2,0,0,2,2,1,2,1,1,1,0,0,2
3852,781480,37,6,16,4,11,2,5,0,0,2,6,4,2,2,2,0,14
3852,774846,31,6,10,6,10,0,0,3,3,0,3,0,4,0,0,0,15
3852,791376,19,1,4,0,1,1,3,0,0,2,0,1,2,0,0,0,3
3852,786558,32,6,11,5,9,1,2,2,2,0,3,2,2,0,5,0,15
3852,766611,32,4,9,2,3,2,6,1,1,0,1,1,3,1,3,0,11
3852,797273,8,0,1,0,1,0,0,0,0,0,2,0,5,2,1,0,0
3852,786185,10,1,2,1,2,0,0,0,0,1,1,1,1,0,1,0,2
3852,797182,14,2,3,2,3,0,0,0,1,1,2,0,0,1,2,0,4
3852,797272,10,0,2,0,0,0,2,0,0,0,0,1,0,0,1,0,0
3852,797181,7,0,1,0,1,0,0,0,0,0,0,0,1,0,0,0,0
3853,780323,21,3,5,3,5,0,0,0,0,1,3,1,2,2,2,0,6
3853,797894,20,2,5,2,5,0,0,2,2,1,0,3,4,2,0,0,6
3853,792229,27,5,8,5,7,0,1,5,6,3,8,0,1,2,1,1,15
3853,785954,29,6,9,3,4,3,5,4,5,0,4,3,2,1,0,0,19
3853,785811,32,8,10,7,7,1,3,1,2,0,2,1,1,0,3,0,18
3853,792234,9,1,1,1,1,0,0,0,0,1,3,0,2,0,0,1,2
3853,792233,26,3,8,2,6,1,2,4,4,1,4,6,1,2,3,0,11
3853,786016,23,4,8,3,3,1,5,0,0,0,0,0,0,1,0,0,9
3853,781356,3,1,1,0,0,1,1,0,0,0,0,0,0,0,1,0,3
3853,797893,3,0,0,0,0,0,0,0,0,0,0,0,1,1,0,0,0
3853,792230,2,0,1,0,0,0,1,2,2,0,2,1,0,0,0,0,2
3853,797891,5,0,0,0,0,0,0,0,0,0,0,0,0,0,0,0,0
3854,797290,30,4,10,1,4,3,6,0,0,1,5,1,0,0,3,0,11
3854,797291,31,3,8,2,6,1,2,2,2,0,1,3,0,1,1,1,9
3854,780509,25,3,6,2,4,1,2,0,1,1,2,1,4,0,2,1,7
3854,786064,24,0,8,0,2,0,6,0,0,1,6,1,2,0,2,0,0
3854,791658,19,2,2,2,2,0,0,1,4,2,1,1,4,0,0,1,5
3854,797292,20,7,11,7,11,0,0,0,0,4,8,1,3,0,1,5,14
3854,797293,8,1,2,1,2,0,0,0,0,0,2,0,2,0,0,1,2
3854,791661,4,0,1,0,0,0,1,0,0,0,1,0,0,0,0,0,0
3854,785658,12,0,0,0,0,0,0,0,0,0,2,1,0,0,2,1,0
3854,791660,27,3,9,1,5,2,4,0,0,0,1,3,0,0,0,0,8
3855,797247,32,4,9,1,5,3,4,2,2,0,3,1,4,1,2,0,13
3855,797248,18,1,2,1,1,0,1,0,0,0,0,0,0,1,0,0,2
3855,797251,36,2,8,0,2,2,6,0,0,0,5,1,2,1,2,1,6
3855,776297,36,3,14,3,6,0,8,1,2,0,3,5,4,0,2,0,7
3855,780455,24,4,9,4,9,0,0,5,8,4,6,0,2,0,0,1,13
3855,797249,10,0,3,0,2,0,1,1,2,0,1,2,0,0,0,0,1
3855,786227,6,0,0,0,0,0,0,0,0,1,0,0,0,0,1,1,0
3855,797250,4,0,1,0,1,0,0,0,0,0,0,0,0,0,0,0,0
3855,791354,24,4,8,4,7,0,1,0,0,2,6,0,3,1,1,0,8
3855,791355,10,1,3,0,1,1,2,2,2,1,0,0,0,0,0,0,5
3856,796761,25,0,4,0,4,0,0,3,4,6,6,0,4,0,2,1,3
3856,796758,29,5,10,5,10,0,0,4,7,1,3,0,1,0,1,0,14
3856,791101,31,6,18,5,13,1,5,6,10,2,6,2,1,2,2,0,19
3856,791105,31,1,3,1,3,0,0,2,2,0,4,3,1,0,3,1,4
3856,780794,21,1,4,0,0,1,4,0,0,0,5,0,0,0,1,1,3
3856,798158,1,0,0,0,0,0,0,0,0,0,0,0,0,0,0,1,0
3856,791103,9,1,1,1,1,0,0,8,10,3,0,0,4,0,0,0,10
3856,780109,21,1,3,1,2,0,1,0,0,1,2,0,2,0,0,0,2
3856,796760,4,0,0,0,0,0,0,0,0,0,0,0,1,0,0,0,0
3856,796757,17,3,12,2,8,1,4,3,5,2,2,1,0,0,3,0,10
3856,791104,3,0,1,0,0,0,1,0,0,0,0,0,1,0,0,0,0
3856,785597,8,0,4,0,3,0,1,0,0,0,1,0,2,1,1,0,0
3856,796759,0,0,0,0,0,0,0,0,0,0,0,0,0,0,0,0,0
3857,780291,21,3,10,2,8,1,2,0,0,3,11,2,4,0,0,0,7
3857,785607,9,1,2,1,2,0,0,0,1,1,2,0,2,0,0,0,2
3857,796665,29,5,12,1,5,4,7,0,0,0,1,2,0,3,0,0,14
3857,785333,26,4,7,1,1,3,6,2,2,1,5,4,4,1,1,1,13
3857,796663,16,4,6,4,6,0,0,0,0,1,2,0,1,0,0,2,8
3857,791004,21,6,13,5,6,1,7,0,1,1,1,1,3,1,1,0,13
3857,775305,33,8,20,6,14,2,6,6,7,0,2,8,3,1,0,0,24
3857,796667,3,0,0,0,0,0,0,1,2,0,1,1,1,0,0,0,1
3857,791006,6,1,4,1,4,0,0,2,2,3,3,0,0,0,1,0,4
3857,796666,16,2,3,2,3,0,0,0,2,5,2,1,3,0,2,1,4
3857,796664,17,1,2,0,1,1,1,0,0,0,3,1,3,0,0,0,3
3857,791005,3,0,1,0,1,0,0,0,0,0,0,0,1,0,0,0,0
3858,785495,30,6,16,3,10,3,6,1,2,3,3,0,1,0,2,1,16
3858,785958,31,7,13,6,12,1,1,4,5,11,8,6,1,0,2,2,19
3858,775377,16,3,4,3,4,0,0,0,1,2,2,0,1,2,0,0,6
3858,785494,31,5,11,3,6,2,5,2,3,0,3,5,2,2,3,0,14
3858,780698,33,6,18,4,12,2,6,2,4,3,4,4,3,2,2,0,16
3858,796704,1,0,1,0,0,0,1,0,0,0,0,0,1,0,0,0,0
3858,785490,6,0,1,0,0,0,1,0,0,0,1,0,1,0,0,0,0
3858,785659,15,0,4,0,2,0,2,0,0,3,4,2,3,2,1,1,0
3858,791130,18,4,11,1,4,3,7,1,3,0,0,0,2,1,1,0,12
3858,791033,3,0,0,0,0,0,0,1,2,0,0,0,0,1,0,0,1
3858,780427,16,1,3,1,3,0,0,0,0,1,2,2,2,2,3,0,2
3859,780214,20,2,6,0,0,2,6,2,2,0,7,0,4,0,3,0,8
3859,775087,22,4,7,4,6,0,1,3,4,1,5,1,1,0,2,2,11
3859,790984,30,4,10,2,4,2,6,4,6,0,1,4,3,1,2,0,14
3859,780212,12,2,4,2,3,0,1,0,0,0,1,1,1,2,1,1,4
3859,767245,34,7,13,7,13,0,0,3,4,2,5,2,1,1,3,0,17
3859,790985,18,4,4,4,4,0,0,0,1,1,3,0,1,0,2,1,8
3859,780215,8,0,1,0,1,0,0,0,0,1,2,0,3,0,1,0,0
3859,796597,11,0,2,0,1,0,1,0,0,1,1,0,0,0,0,0,0
3859,796596,24,2,8,1,6,1,2,0,0,1,2,2,2,0,3,0,5
3859,785297,21,1,5,1,5,0,0,0,0,0,1,2,2,2,2,0,2
3860,791511,23,4,4,4,4,0,0,1,4,2,2,1,2,0,1,2,9
3860,778442,40,7,18,6,13,1,5,0,0,1,3,3,2,2,0,0,15
3860,791514,15,0,3,0,1,0,2,2,2,0,2,2,1,0,0,0,2
3860,786637,38,5,9,3,6,2,3,3,5,0,5,5,1,3,6,1,15
3860,791513,31,7,11,2,6,5,5,0,0,2,2,1,2,1,2,1,19
3860,797151,12,0,3,0,3,0,0,0,0,2,1,0,1,0,1,0,0
3860,791515,13,2,4,2,3,0,1,0,0,2,2,0,4,0,1,1,4
3860,797154,4,0,1,0,1,0,0,0,0,0,1,0,0,0,0,0,0
3860,780946,24,4,7,2,3,2,4,0,0,0,2,3,2,3,0,0,10
3861,797895,17,3,8,2,6,1,2,5,6,1,3,0,4,1,1,0,12
3861,789058,30,3,9,3,6,0,3,4,4,1,3,0,3,0,0,0,10
3861,797898,35,3,9,2,5,1,4,4,4,1,5,7,0,0,4,0,11
3861,792240,32,1,3,1,2,0,1,0,0,0,3,0,2,4,3,0,2
3861,792237,26,7,11,3,3,4,8,0,0,0,1,3,0,1,4,0,18
3861,792238,6,1,1,1,1,0,0,0,0,0,1,0,0,0,0,0,2
3861,787239,5,0,1,0,1,0,0,0,0,1,1,0,0,0,0,1,0
3861,785818,21,2,6,2,2,0,4,0,0,2,6,2,2,0,0,0,4
3861,785286,26,4,5,1,2,3,3,5,6,0,2,1,2,1,1,1,16
3861,797897,2,0,0,0,0,0,0,0,0,0,0,0,1,0,0,0,0
3862,780758,16,1,2,1,2,0,0,1,2,3,4,0,2,0,2,0,3
3862,775489,32,7,10,6,9,1,1,4,4,4,7,1,3,0,5,0,19
3862,785560,32,3,7,1,2,2,5,3,4,0,3,2,2,0,2,0,11
3862,785561,34,6,15,6,13,0,2,4,6,3,2,2,1,0,3,2,16
3862,780313,38,6,14,6,9,0,5,9,15,1,7,5,2,2,2,1,21
3862,796751,9,1,1,1,1,0,0,0,0,1,1,0,2,0,2,0,2
3862,791088,13,1,4,1,3,0,1,0,0,1,1,0,0,0,0,0,2
3862,785563,26,2,3,2,3,0,0,2,3,0,5,1,2,0,1,0,6
3863,797367,14,1,3,1,3,0,0,1,2,3,4,0,4,0,1,0,3
3863,797369,33,7,13,3,6,4,7,1,1,0,1,3,3,1,1,0,19
3863,797366,23,1,2,1,1,0,1,1,2,2,3,4,4,2,1,0,3
3863,791807,34,9,17,6,7,3,10,2,2,0,3,0,2,2,0,0,23
3863,786130,28,7,21,2,10,5,11,0,0,0,4,3,5,1,1,0,19
3863,797371,9,0,1,0,1,0,0,0,0,0,1,0,2,1,0,1,0
3863,797368,7,1,2,1,2,0,0,0,0,1,1,0,2,1,0,0,2
3863,797364,8,1,2,1,2,0,0,0,0,1,0,0,5,0,1,2,2
3863,797365,10,1,2,1,1,0,1,0,0,0,1,0,0,2,1,0,2
3863,797363,27,6,9,5,6,1,3,3,3,0,3,6,1,0,2,0,16
3863,791808,7,1,1,1,1,0,0,0,0,0,0,1,0,0,0,0,2
3864,792334,30,5,7,5,6,0,1,0,0,2,3,3,5,0,1,1,10
3864,786575,39,8,11,8,11,0,0,1,1,4,6,1,4,0,3,5,17
3864,798094,37,4,5,1,1,3,4,0,0,0,5,3,1,1,2,1,11
3864,792338,34,3,13,3,12,0,1,4,4,1,3,3,4,1,2,0,10
3864,781666,40,5,13,1,6,4,7,3,4,0,4,1,1,0,5,0,17
3864,798097,17,0,1,0,1,0,0,0,1,0,4,0,3,1,0,0,0
3864,785531,4,0,2,0,1,0,1,0,0,0,0,0,0,0,0,0,0
3864,798095,2,0,0,0,0,0,0,0,0,0,0,0,0,0,1,0,0
3864,798100,1,0,0,0,0,0,0,0,0,0,0,1,0,0,0,0,0
3864,799842,12,1,2,1,2,0,0,2,2,1,0,1,2,0,0,0,4
3864,791636,9,3,8,2,3,1,5,0,0,0,1,0,3,0,0,0,7
3865,791493,40,5,10,5,10,0,0,9,11,6,10,2,1,0,0,1,19
3865,789036,34,5,13,5,11,0,2,2,2,1,1,0,5,0,4,1,12
3865,797191,20,3,4,2,3,1,1,0,0,0,3,1,0,0,1,0,7
3865,791495,5,0,1,0,0,0,1,0,0,0,0,0,0,1,0,0,0
3865,776494,36,4,6,4,4,0,2,0,1,0,2,1,1,0,0,0,8
3865,781307,12,0,0,0,0,0,0,0,2,0,1,1,4,1,2,0,0
3865,780504,4,0,0,0,0,0,0,0,0,0,0,0,0,0,0,0,0
3865,791492,9,0,2,0,0,0,2,0,0,0,0,0,0,1,1,0,0
3865,791494,40,5,12,5,10,0,2,7,9,2,3,0,2,4,1,0,17
3865,786324,25,5,15,4,9,1,6,4,5,1,3,3,1,2,0,0,15
3866,781181,32,6,14,2,2,4,12,0,0,0,1,0,2,2,0,1,16
3866,785571,23,6,7,5,6,1,1,1,1,0,2,2,0,2,4,0,14
3866,791224,38,5,12,4,7,1,5,1,1,0,2,7,2,5,4,3,12
3866,791225,13,1,3,1,2,0,1,0,0,1,1,0,2,0,1,1,2
3866,791223,17,0,0,0,0,0,0,0,0,0,3,0,5,1,1,0,0
3866,796927,20,3,6,0,2,3,4,4,4,2,3,2,3,0,0,0,13
3866,775324,9,1,1,1,1,0,0,4,4,1,1,0,0,0,0,0,6
3866,791811,8,1,1,1,1,0,0,2,2,1,1,0,2,0,1,0,4
3866,796929,17,1,7,0,1,1,6,0,0,0,0,0,1,1,1,0,3
3866,785564,22,0,7,0,1,0,6,1,2,0,1,1,0,0,0,0,1
3866,791222,1,0,0,0,0,0,0,0,0,0,0,0,0,0,0,0,0
3867,780210,39,16,31,13,26,3,5,3,4,9,8,2,2,1,2,0,38
3867,775005,35,2,10,1,4,1,6,3,4,0,6,0,0,0,1,1,8
3867,792432,33,2,6,1,3,1,3,0,0,1,3,6,2,0,2,0,5
3867,796592,30,1,4,1,3,0,1,3,5,2,4,0,2,2,3,1,5
3867,792433,22,1,3,0,1,1,2,0,0,0,1,0,2,1,3,0,3
3867,792427,19,3,4,2,3,1,1,0,0,0,3,4,1,0,1,0,7
3867,791306,9,2,3,2,3,0,0,1,2,1,1,1,1,1,1,0,5
3867,786422,9,1,1,1,1,0,0,1,1,0,1,0,1,0,2,0,3
3867,796594,3,0,1,0,0,0,1,0,0,0,0,0,1,0,0,0,0
3867,790880,1,0,0,0,0,0,0,0,0,0,0,0,0,0,0,0,0
3868,796657,18,3,9,3,9,0,0,0,0,1,4,1,1,1,1,1,6
3868,796651,13,2,7,2,3,0,4,2,2,1,3,0,3,1,0,0,6
3868,791323,18,2,5,1,1,1,4,0,0,0,2,5,1,0,1,0,5
3868,791320,38,9,15,7,12,2,3,5,6,1,5,3,1,2,1,0,25
3868,781511,35,1,5,0,2,1,3,5,5,0,3,5,0,0,2,0,8
3868,796650,20,5,6,5,6,0,0,1,2,1,2,1,2,3,0,0,11
3868,796656,8,0,4,0,4,0,0,0,2,2,2,0,2,0,1,0,0
3868,796653,16,2,3,1,1,1,2,2,2,0,4,1,2,1,0,0,7
3868,791321,5,0,1,0,1,0,0,0,0,1,0,0,1,0,0,0,0
3868,785912,29,8,12,6,8,2,4,1,1,1,2,2,2,0,1,0,19
3869,797529,34,4,6,4,6,0,0,5,6,1,8,0,3,1,1,2,13
3869,797527,25,4,6,4,5,0,1,2,2,3,3,0,5,2,2,0,10
3869,791936,38,6,14,6,14,0,0,6,8,1,7,1,4,2,3,0,18
3869,797532,38,7,15,6,9,1,6,0,0,0,2,11,2,0,4,0,15
3869,785688,39,7,16,1,4,6,12,0,0,0,2,0,1,0,2,0,20
3869,797530,2,0,0,0,0,0,0,2,2,0,0,0,0,0,0,0,2
3869,797528,3,0,0,0,0,0,0,0,0,0,0,0,1,0,0,1,0
3869,797531,2,0,0,0,0,0,0,0,0,0,1,1,0,0,0,0,0
3869,791932,3,0,0,0,0,0,0,0,0,0,0,0,1,0,0,0,0
3869,791933,4,0,0,0,0,0,0,0,0,0,0,0,1,0,1,0,0
3869,791935,2,0,0,0,0,0,0,0,0,0,0,0,0,0,0,0,0
3869,785988,10,0,3,0,3,0,0,0,0,0,4,0,0,0,0,0,0
3870,791482,26,1,6,0,3,1,3,0,0,1,2,5,1,1,0,1,3
3870,786319,20,4,4,4,4,0,0,3,4,2,3,4,1,0,0,0,11
3870,786318,22,5,12,3,7,2,5,0,0,0,2,0,3,1,0,0,12
3870,784268,25,5,9,5,9,0,0,0,0,0,1,3,0,0,0,0,10
3870,780223,18,3,7,2,5,1,2,0,0,1,3,0,2,1,0,0,7
3870,797198,9,2,4,1,3,1,1,0,0,0,1,2,3,0,0,0,5
3870,791481,12,2,6,2,5,0,1,2,2,2,3,0,2,0,0,1,6
3870,780225,17,3,4,1,1,2,3,0,0,0,6,0,1,0,1,0,8
3870,797200,15,3,4,2,2,1,2,1,1,1,1,0,3,1,1,0,8
3870,797199,16,1,4,1,3,0,1,2,2,1,0,1,0,1,1,0,4
3870,797201,6,1,2,1,2,0,0,0,0,1,0,0,1,0,0,0,2
3870,796079,2,0,0,0,0,0,0,0,0,0,0,0,1,0,0,0,0
3870,791480,2,0,0,0,0,0,0,0,0,0,0,0,0,0,0,0,0
3870,791479,3,0,0,0,0,0,0,0,0,0,0,0,1,0,0,0,0
3870,786317,3,0,0,0,0,0,0,0,0,0,1,0,0,0,0,0,0
3870,786320,4,0,2,0,1,0,1,0,0,0,0,0,1,0,0,0,0
3871,797235,16,1,1,1,1,0,0,0,0,1,2,0,0,0,0,0,2
3871,797232,36,4,8,1,1,3,7,5,5,0,1,3,3,0,0,3,16
3871,791367,24,0,5,0,4,0,1,0,0,0,2,1,0,0,2,0,0
3871,797234,25,1,5,1,4,0,1,0,1,2,3,0,1,0,1,0,2
3871,797239,30,4,16,2,10,2,6,2,2,0,1,0,0,0,5,0,12
3871,797233,10,0,3,0,3,0,0,1,2,2,3,0,3,0,1,0,1
3871,791368,11,0,0,0,0,0,0,1,2,1,1,0,3,0,1,0,1
3871,797238,4,1,1,1,1,0,0,0,0,0,0,0,0,0,0,0,2
3871,786535,14,3,3,3,3,0,0,0,0,1,4,1,1,0,0,0,6
3871,797237,16,1,3,1,2,0,1,0,0,0,2,1,1,1,1,0,2
3871,785446,10,0,2,0,2,0,0,1,2,0,0,2,1,0,1,0,1
3871,791369,4,0,0,0,0,0,0,2,5,0,1,0,0,0,0,0,2
3872,785799,17,3,7,3,7,0,0,0,0,4,3,0,0,0,1,0,6
3872,785800,27,2,7,1,2,1,5,0,0,3,5,0,3,1,1,0,5
3872,791676,29,3,8,2,2,1,6,0,0,0,2,2,2,3,4,0,7
3872,780553,31,5,15,5,11,0,4,0,0,1,8,4,4,1,6,0,10
3872,780554,34,1,5,0,2,1,3,0,0,1,1,0,0,0,0,1,3
3872,797427,20,1,7,1,2,0,5,0,0,1,1,0,0,0,0,0,2
3872,785807,15,1,2,1,1,0,1,0,0,0,4,0,0,0,1,0,2
3872,780760,20,4,5,3,3,1,2,1,2,1,3,0,3,0,0,3,10
3872,797426,3,0,2,0,1,0,1,0,0,0,1,0,0,0,0,1,0
3872,791679,4,0,0,0,0,0,0,0,0,1,0,0,1,0,1,0,0
3873,797712,22,4,5,4,5,0,0,2,2,6,3,2,1,0,1,0,10
3873,781337,37,6,13,2,3,4,10,2,3,0,3,1,0,0,2,0,18
3873,786056,29,1,4,1,3,0,1,1,2,1,7,3,0,0,1,0,3
3873,791964,29,1,7,1,4,0,3,2,2,0,1,2,0,0,0,0,4
3873,781339,27,0,7,0,2,0,5,0,0,0,3,0,1,2,3,0,0
3873,797711,29,3,11,1,5,2,6,2,2,1,1,1,2,0,2,0,10
3873,792041,15,1,4,0,3,1,1,0,0,0,2,0,1,0,1,1,3
3873,797713,4,0,1,0,1,0,0,0,0,1,0,0,1,1,1,0,0
3873,797710,5,0,1,0,1,0,0,0,0,0,0,0,1,0,3,0,0
3873,799737,3,0,1,0,0,0,1,0,0,0,0,0,0,0,0,0,0
3874,785368,24,3,8,3,8,0,0,0,0,0,3,0,2,1,2,1,6
3874,780281,29,6,13,4,8,2,5,1,2,2,1,0,1,0,1,0,15
3874,790793,31,2,9,0,4,2,5,1,2,1,5,3,0,1,3,0,7
3874,790792,32,1,4,1,4,0,0,0,0,2,1,0,2,1,1,2,2
3874,780886,23,4,9,3,6,1,3,1,3,1,1,1,2,0,3,0,10
3874,796351,4,0,2,0,2,0,0,0,0,1,1,1,0,0,1,0,0
3874,790794,16,0,1,0,1,0,0,2,4,3,3,1,4,0,2,1,2
3874,785246,23,2,7,1,3,1,4,0,0,1,0,2,0,0,0,0,5
3874,790789,11,1,1,0,0,1,1,0,0,0,1,2,1,1,2,0,3
3874,796350,5,2,2,0,0,2,2,2,2,1,0,0,0,0,1,0,8
3874,796353,2,0,0,0,0,0,0,0,0,0,0,0,0,0,0,0,0
3875,797223,6,0,0,0,0,0,0,0,0,0,1,0,1,0,1,0,0
3875,781526,24,5,8,5,7,0,1,0,0,1,1,2,3,1,0,0,10
3875,797217,31,2,5,1,4,1,1,4,4,0,3,3,3,1,3,1,9
3875,797218,28,3,8,2,6,1,2,6,6,1,3,2,1,4,0,0,13
3875,775697,36,5,7,3,3,2,4,1,1,0,1,4,3,2,2,0,13
3875,791453,22,2,5,0,2,2,3,0,0,0,2,0,0,0,0,1,6
3875,797222,20,4,7,4,7,0,0,1,2,1,5,2,1,1,4,4,9
3875,791454,25,6,8,6,6,0,2,0,0,0,6,4,0,1,2,1,12
3875,791846,8,2,4,2,4,0,0,0,0,0,1,1,2,0,0,0,4
3876,775563,17,6,9,5,8,1,1,4,4,3,5,0,3,1,2,1,17
3876,781011,24,4,8,4,8,0,0,1,2,0,4,1,2,2,3,4,9
3876,797601,36,6,15,3,6,3,9,2,2,2,4,5,0,1,4,0,17
3876,775119,26,5,7,5,6,0,1,0,0,0,6,2,3,1,3,1,10
3876,797602,14,3,6,3,4,0,2,0,0,1,2,0,3,0,0,0,6
3876,775806,13,0,3,0,1,0,2,2,2,1,1,2,3,1,1,0,2
3876,775188,11,0,0,0,0,0,0,0,0,1,3,0,4,1,0,0,0
3876,797604,17,3,6,2,2,1,4,0,0,0,1,0,2,0,1,0,7
3876,791770,2,0,0,0,0,0,0,1,2,0,0,0,1,0,0,1,1
3876,786466,17,0,0,0,0,0,0,3,4,0,3,0,2,1,1,0,3
3876,797599,1,0,0,0,0,0,0,0,0,0,0,0,0,0,0,0,0
3876,797605,1,0,0,0,0,0,0,0,0,0,0,0,0,0,0,0,0
3876,781012,21,7,9,6,7,1,2,0,0,1,0,3,3,1,0,0,15
3877,791512,27,3,3,3,3,0,0,2,4,3,2,1,2,0,1,1,8
3877,786338,33,4,12,2,6,2,6,4,5,0,3,1,3,3,3,2,14
3877,792052,12,0,2,0,0,0,2,0,0,0,1,0,1,0,0,0,0
3877,785347,24,2,11,1,8,1,3,3,4,0,1,3,1,0,2,0,8
3877,775601,32,7,16,3,8,4,8,7,8,2,0,1,3,0,4,0,25
3877,792045,6,0,1,0,1,0,0,0,0,0,1,0,2,0,2,0,0
3877,797648,11,1,2,1,1,0,1,0,0,1,0,0,0,1,0,0,2
3877,797647,4,0,0,0,0,0,0,0,2,0,0,0,0,0,0,0,0
3877,792047,12,0,3,0,1,0,2,2,2,1,1,0,2,2,0,1,2
3877,792051,15,0,3,0,3,0,0,4,6,0,1,0,1,0,0,1,4
3877,780862,7,0,1,0,1,0,0,1,2,0,0,0,0,0,0,0,1
3877,775476,16,1,3,0,0,1,3,0,0,0,1,0,1,0,0,0,3
3877,792048,1,0,0,0,0,0,0,0,0,0,0,0,0,0,0,0,0
3878,786080,37,11,24,11,20,0,4,8,8,2,6,0,2,1,5,2,30
3878,780663,38,6,15,1,4,5,11,1,2,1,4,7,2,3,0,0,18
3878,786216,25,4,5,4,5,0,0,2,3,0,3,1,0,0,1,0,10
3878,786218,33,4,9,4,8,0,1,0,0,3,1,0,0,2,0,2,8
3878,791348,27,0,2,0,2,0,0,0,0,1,1,3,2,3,0,0,0
3878,791350,18,1,4,1,1,0,3,0,0,2,1,2,4,1,0,0,2
3878,780150,16,0,6,0,1,0,5,0,0,1,4,1,1,0,0,0,0
3878,797258,4,0,1,0,0,0,1,0,0,0,0,0,0,0,0,1,0
3878,781645,2,0,0,0,0,0,0,0,0,0,0,1,0,0,0,0,0
3879,786420,34,6,13,4,7,2,6,4,5,2,6,8,2,0,1,0,18
3879,786493,36,4,12,0,4,4,8,0,0,0,7,1,2,1,2,0,12
3879,781052,35,3,5,0,1,3,4,0,0,1,1,2,0,0,0,0,9
3879,797616,25,2,3,2,3,0,0,4,6,3,7,2,3,1,4,0,8
3879,791881,32,2,7,0,3,2,4,1,2,0,0,4,4,0,5,1,7
3879,797613,20,3,7,1,2,2,5,0,0,1,5,0,1,0,2,1,8
3879,797618,15,4,6,4,6,0,0,0,0,3,1,1,2,1,1,0,8
3879,797617,3,0,1,0,0,0,1,0,0,0,0,0,0,0,0,0,0
3880,789484,38,12,17,10,14,2,3,5,7,3,7,3,4,2,1,2,31
3880,796693,39,8,14,5,8,3,6,6,6,0,1,9,0,3,4,0,25
3880,792422,21,6,6,6,6,0,0,1,2,1,3,0,5,1,0,0,13
3880,792418,23,3,7,3,6,0,1,2,3,3,1,2,5,0,1,1,8
3880,782654,9,0,1,0,1,0,0,1,2,0,0,0,4,1,1,0,1
3880,796691,19,2,5,0,1,2,4,4,4,0,3,1,0,1,1,0,10
3880,792421,7,1,2,1,1,0,1,0,0,0,0,0,0,0,2,0,2
3880,792419,13,0,1,0,1,0,0,1,2,0,0,1,1,0,0,0,1
3880,792424,18,0,0,0,0,0,0,0,0,2,3,1,4,0,2,1,0
3880,796692,9,0,0,0,0,0,0,0,0,0,0,0,0,0,1,0,0
3880,796695,4,0,1,0,1,0,0,0,0,0,1,0,0,0,0,0,0
3881,786717,36,7,13,5,10,2,3,2,3,3,7,1,2,1,3,0,18
3881,792318,19,4,8,4,8,0,0,3,4,0,1,1,4,0,0,1,11
3881,780753,31,4,7,3,5,1,2,0,0,0,2,3,3,3,3,0,9
3881,796516,7,2,2,2,2,0,0,0,0,0,0,1,0,0,2,0,4
3881,775329,10,0,1,0,1,0,0,2,2,0,0,1,3,1,1,0,2
3881,796520,27,4,9,3,5,1,4,8,8,0,0,2,0,0,0,0,17
3881,796518,22,3,6,0,1,3,5,0,0,0,2,0,1,0,1,0,9
3881,796517,24,2,2,1,1,1,1,2,2,0,2,3,2,2,2,0,7
3881,792308,6,1,2,1,2,0,0,2,2,0,1,0,4,0,1,0,4
3881,796519,18,0,1,0,1,0,0,1,2,1,1,4,4,0,2,0,1
3882,796637,16,2,4,2,4,0,0,0,0,4,2,0,2,0,1,0,4
3882,792632,32,2,6,2,6,0,0,2,3,1,7,1,2,0,1,1,6
3882,792629,30,1,8,0,3,1,5,0,0,1,3,2,1,0,2,0,3
3882,781491,24,3,4,3,3,0,1,1,2,2,1,2,1,2,4,1,7
3882,780250,26,3,9,2,6,1,3,1,2,0,5,0,3,2,2,0,8
3882,796634,14,1,5,1,3,0,2,1,2,2,3,0,3,1,1,0,3
3882,796638,2,0,1,0,0,0,1,0,0,0,0,1,0,0,0,0,0
3882,792627,14,0,3,0,3,0,0,3,4,1,1,1,0,4,1,0,3
3882,792631,11,1,4,0,0,1,4,0,0,0,0,0,0,0,0,0,3
3882,792626,31,7,15,7,14,0,1,4,7,1,2,2,5,4,1,1,18
3883,792067,35,6,9,3,6,3,3,3,5,1,5,2,1,0,1,0,18
3883,775523,24,4,10,3,7,1,3,2,4,3,10,2,3,1,1,2,11
3883,792059,34,3,6,1,2,2,4,1,2,0,3,2,3,2,6,1,9
3883,792058,29,2,3,2,3,0,0,0,1,1,2,1,4,1,4,0,4
3883,789053,35,3,12,2,7,1,5,1,2,1,1,6,4,1,5,0,8
3883,786836,5,0,0,0,0,0,0,0,0,0,0,0,1,0,1,0,0
3883,797650,11,2,3,2,3,0,0,2,5,0,2,1,1,0,0,0,6
3883,790779,5,0,0,0,0,0,0,1,2,0,0,1,2,1,1,0,1
3883,797649,22,1,6,0,3,1,3,1,1,0,4,1,0,0,1,0,4
3884,791787,32,4,10,3,4,1,6,2,2,2,4,1,5,3,6,0,11
3884,789048,27,1,3,1,3,0,0,0,0,0,7,1,2,2,3,1,2
3884,789046,32,2,8,2,5,0,3,3,4,1,5,2,2,0,3,1,7
3884,791786,35,1,4,1,3,0,1,2,2,0,3,3,1,1,4,0,4
3884,789041,35,6,12,0,2,6,10,2,2,0,1,1,4,0,2,0,20
3884,791785,15,5,8,5,7,0,1,3,4,0,3,1,0,1,1,0,13
3884,785540,20,4,8,4,7,0,1,1,1,1,6,0,2,1,0,1,9
3884,797630,22,2,7,0,0,2,7,1,2,1,3,1,1,1,0,0,7
3884,797629,3,0,0,0,0,0,0,0,0,0,0,0,1,0,1,0,0
3884,789044,4,0,0,0,0,0,0,0,0,0,1,0,0,0,0,0,0
3885,792167,12,2,2,2,2,0,0,0,0,1,2,0,1,1,1,0,4
3885,792170,19,1,1,1,1,0,0,2,2,1,4,0,1,0,0,0,4
3885,791372,38,7,17,3,6,4,11,1,2,0,3,3,3,0,4,0,19
3885,792164,40,2,12,2,8,0,4,2,5,1,5,3,4,1,7,0,6
3885,780974,38,4,16,3,12,1,4,5,8,3,5,3,0,5,3,0,14
3885,797777,2,0,1,0,1,0,0,0,0,0,0,0,1,0,1,0,0
3885,797766,21,2,7,0,5,2,2,3,4,3,3,1,3,1,0,0,9
3885,797767,12,0,1,0,0,0,1,0,0,0,2,1,4,1,3,0,0
3885,797772,7,0,1,0,0,0,1,0,0,0,1,1,0,0,1,0,0
3885,792163,36,3,5,0,0,3,5,1,1,2,4,2,3,2,3,1,10
3886,791230,33,5,9,2,2,3,7,0,0,3,1,3,1,1,2,0,13
3886,785557,27,13,23,11,18,2,5,1,2,2,7,1,2,0,2,1,29
3886,791228,30,4,7,1,2,3,5,0,1,1,1,2,0,0,0,0,11
3886,796932,33,3,10,1,5,2,5,2,2,0,3,15,1,2,2,0,10
3886,785624,29,4,9,1,4,3,5,0,0,3,2,0,4,0,0,0,11
3886,796933,5,0,1,0,0,0,1,1,2,0,2,0,0,1,1,0,1
3886,791226,9,2,3,2,3,0,0,0,0,1,2,0,4,0,2,2,4
3886,791227,23,2,7,1,2,1,5,0,0,1,1,2,1,0,0,0,5
3886,781201,4,0,0,0,0,0,0,0,0,0,1,2,1,0,0,0,0
3886,781198,7,2,5,0,1,2,4,0,0,0,0,1,1,1,1,0,6
3887,792192,26,2,3,2,3,0,0,0,0,2,4,1,0,0,2,0,4
3887,797824,21,2,4,0,2,2,2,0,0,1,3,0,2,1,5,0,6
3887,797822,27,5,11,1,4,4,7,0,0,0,5,2,1,0,2,0,14
3887,792190,36,6,14,4,10,2,4,4,4,0,4,5,0,0,1,0,18
3887,786664,36,6,15,4,6,2,9,1,1,0,2,10,3,1,1,0,15
3887,775116,19,4,7,0,0,4,7,0,2,0,1,2,1,3,1,0,12
3887,797825,7,1,1,1,1,0,0,0,0,0,1,0,2,0,1,0,2
3887,799164,0,0,0,0,0,0,0,0,0,0,0,0,1,0,0,0,0
3887,792193,8,0,0,0,0,0,0,0,0,0,2,0,2,0,2,0,0
3887,792191,20,2,3,1,1,1,2,4,5,1,5,0,1,0,1,0,9
3888,776344,30,7,16,6,14,1,2,0,0,1,3,4,3,1,2,2,15
3888,775821,27,6,12,5,10,1,2,0,0,0,1,1,2,1,2,0,13
3888,792453,29,4,7,3,5,1,2,0,0,0,4,3,2,0,1,0,9
3888,785131,25,5,5,2,2,3,3,1,1,0,3,2,4,2,2,0,14
3888,781538,31,3,6,3,4,0,2,2,2,0,4,3,0,0,0,0,8
3888,785152,14,1,3,1,1,0,2,0,0,1,0,0,3,0,1,0,2
3888,798115,19,1,4,0,1,1,3,1,3,1,2,0,2,0,1,0,4
3888,792324,7,0,0,0,0,0,0,1,2,0,2,0,0,1,1,0,1
3888,776233,18,0,1,0,1,0,0,4,5,2,1,1,1,2,1,1,4
3889,791760,18,2,8,2,5,0,3,2,4,0,2,0,0,0,2,0,6
3889,780256,32,10,12,6,8,4,4,2,3,1,8,2,3,0,0,0,26
3889,796880,32,4,12,3,7,1,5,0,1,1,2,2,3,0,3,0,9
3889,791757,15,2,5,2,5,0,0,0,0,0,0,0,1,1,3,0,4
3889,791334,24,3,8,3,4,0,4,1,2,0,0,0,0,0,0,0,7
3889,785874,25,1,2,0,0,1,2,0,0,3,2,1,3,0,4,0,3
3889,796879,18,2,4,2,4,0,0,3,3,0,2,2,3,0,0,0,7
3889,796883,28,2,3,0,1,2,2,0,0,1,1,3,0,1,1,0,6
3889,781590,8,0,2,0,1,0,1,0,0,1,2,1,2,0,1,0,0
3889,791330,0,0,0,0,0,0,0,0,0,0,0,0,0,0,0,0,0
3890,786257,28,4,10,4,10,0,0,1,2,3,8,1,1,0,1,0,9
3890,786263,8,2,8,1,5,1,3,1,1,2,1,0,3,2,1,0,6
3890,797724,22,0,1,0,0,0,1,0,0,1,1,0,2,0,1,0,0
3890,785661,37,9,14,8,10,1,4,7,9,1,3,2,2,2,1,0,26
3890,775825,40,4,17,3,14,1,3,3,4,0,3,4,2,2,3,0,12
3890,792121,31,0,2,0,0,0,2,0,0,0,8,0,5,1,0,0,0
3890,797725,13,2,2,2,2,0,0,1,2,1,1,1,3,0,2,1,5
3890,786249,20,2,5,0,1,2,4,0,0,0,1,0,1,1,0,0,6
3890,797721,1,0,0,0,0,0,0,0,0,0,0,0,0,0,0,0,0
3891,786203,36,8,12,5,8,3,4,4,5,0,3,3,1,0,1,1,23
3891,786197,27,4,7,3,6,1,1,1,2,0,2,0,4,0,2,1,10
3891,780717,27,3,7,3,6,0,1,5,6,1,7,2,2,0,3,0,11
3891,791742,26,2,5,2,5,0,0,2,2,0,5,2,3,1,0,1,6
3891,776266,29,3,7,3,6,0,1,2,3,0,2,1,2,1,2,0,8
3891,776328,17,1,5,1,3,0,2,0,0,0,3,1,2,0,0,1,2
3891,791738,13,0,1,0,1,0,0,0,0,0,2,2,1,1,0,2,0
3891,791740,11,2,3,0,0,2,3,0,0,0,2,0,1,0,1,0,6
3891,791741,14,0,2,0,2,0,0,0,0,0,2,0,1,0,3,0,0
3891,797337,0,0,0,0,0,0,0,0,0,0,0,0,0,0,0,0,0
3892,780602,36,7,10,7,9,0,1,4,4,2,5,3,2,2,4,2,18
3892,780604,35,7,11,6,10,1,1,3,4,1,6,2,1,2,1,0,18
3892,786460,30,3,5,3,5,0,0,2,2,1,3,1,1,2,0,0,8
3892,791766,30,3,6,3,4,0,2,2,2,0,2,3,2,1,1,0,8
3892,780603,15,1,5,0,1,1,4,0,0,0,1,3,3,0,1,0,3
3892,786230,29,9,12,6,7,3,5,0,0,0,1,2,0,1,4,0,21
3892,786071,13,3,3,3,3,0,0,0,1,1,0,0,3,1,1,0,6
3892,791768,8,1,1,1,1,0,0,0,0,0,3,0,4,0,3,0,2
3892,797565,1,1,1,1,1,0,0,0,0,0,0,0,2,0,1,0,2
3892,797564,1,0,0,0,0,0,0,0,0,0,0,0,0,0,0,0,0
3892,780605,1,0,0,0,0,0,0,0,0,0,0,1,1,0,0,0,0
3892,797563,1,0,0,0,0,0,0,0,0,0,0,0,0,0,0,0,0
3893,785928,38,3,4,1,1,2,3,0,0,0,2,0,2,0,2,0,8
3893,791407,32,3,15,2,10,1,5,1,2,0,1,1,3,1,2,0,8
3893,785923,31,2,7,1,5,1,2,2,2,0,1,0,0,1,3,0,7
3893,791403,10,3,3,3,3,0,0,1,1,0,3,0,1,2,2,1,7
3893,797109,13,1,4,1,3,0,1,0,0,2,1,1,2,0,1,0,2
3893,797111,15,4,4,4,4,0,0,2,3,1,1,0,1,2,0,0,10
3893,797117,15,4,6,4,6,0,0,0,0,2,1,0,3,0,3,1,8
3893,791404,28,2,8,2,3,0,5,3,4,3,0,7,1,3,5,0,7
3893,797110,14,2,4,0,1,2,3,0,0,0,1,0,1,0,0,0,6
3893,797113,3,0,0,0,0,0,0,1,2,0,0,0,0,0,0,0,1
3893,797115,1,0,0,0,0,0,0,0,0,0,0,0,0,0,0,0,0
3894,791118,42,6,15,5,7,1,8,6,8,0,7,1,1,0,4,0,19
3894,774974,42,5,10,3,7,2,3,7,8,0,5,5,3,5,3,3,19
3894,785676,34,4,10,2,4,2,6,0,2,1,5,0,1,0,4,0,10
3894,791117,36,3,6,2,4,1,2,2,2,2,1,2,2,0,1,1,9
3894,780824,9,0,1,0,1,0,0,3,4,2,2,2,2,0,1,1,3
3894,791115,32,3,8,3,8,0,0,5,10,5,3,1,2,3,3,1,11
3894,796769,21,0,4,0,2,0,2,1,2,2,0,1,3,1,1,0,1
3894,796768,5,0,1,0,0,0,1,0,0,0,0,0,1,0,1,0,0
3894,796771,4,0,2,0,2,0,0,0,0,1,2,0,1,0,0,0,0
3896,786424,36,8,12,8,12,0,0,7,8,5,11,2,2,1,4,3,23
3896,785483,36,5,9,3,5,2,4,3,3,0,4,2,4,0,4,0,15
3896,792366,35,5,10,5,9,0,1,5,9,0,1,5,4,1,4,4,15
3896,781454,32,5,11,3,9,2,2,2,2,2,9,4,3,1,1,0,14
3896,791015,32,2,5,0,2,2,3,0,0,0,2,7,4,0,1,0,6
3896,797979,19,3,4,1,1,2,3,0,2,2,1,2,4,1,0,0,8
3896,797991,8,0,1,0,1,0,0,0,0,0,1,0,2,0,0,0,0
3896,785959,2,0,0,0,0,0,0,0,0,0,0,0,0,0,0,0,0
3897,791038,32,6,9,5,7,1,2,11,11,1,1,2,3,2,1,0,24
3897,775823,32,7,15,7,12,0,3,2,4,3,4,3,3,1,2,0,16
3897,791041,31,4,12,3,9,1,3,5,7,2,1,4,5,2,1,0,14
3897,774806,29,5,12,5,12,0,0,2,2,2,7,3,3,2,0,0,12
3897,789023,33,2,13,2,10,0,3,1,2,1,1,4,5,0,3,0,5
3897,796716,7,2,2,1,1,1,1,1,1,0,4,1,0,0,1,0,6
3897,775205,20,0,2,0,1,0,1,0,0,0,0,1,0,0,0,0,0
3897,796714,12,0,0,0,0,0,0,0,0,0,1,0,2,2,0,0,0
3897,796711,4,0,0,0,0,0,0,0,0,1,0,0,0,0,0,0,0
3898,797482,17,2,8,2,8,0,0,2,3,1,1,0,4,0,1,0,6
3898,797485,23,4,8,1,3,3,5,1,2,0,1,1,1,1,1,0,12
3898,797481,27,5,11,4,7,1,4,0,0,1,1,3,2,0,0,1,11
3898,797480,21,1,5,1,4,0,1,0,0,1,2,2,1,0,1,1,2
3898,785944,23,5,10,2,3,3,7,6,6,0,0,3,3,0,0,0,19
3898,781217,22,2,3,0,0,2,3,0,0,0,3,0,2,0,1,1,6
3898,797483,18,0,3,0,3,0,0,0,0,3,2,0,4,1,4,1,0
3898,797478,18,2,5,1,3,1,2,6,6,1,5,0,1,1,1,0,11
3898,791873,19,3,8,3,8,0,0,2,3,3,0,7,4,1,2,0,8
3898,797479,12,4,6,1,1,3,5,2,2,0,0,0,1,0,0,0,13
3899,790799,24,8,9,7,8,1,1,6,7,1,2,0,3,0,1,1,23
3899,790798,27,10,14,10,14,0,0,6,6,3,4,2,0,0,1,1,26
3899,780140,28,6,14,4,7,2,7,0,0,2,4,4,0,0,0,0,14
3899,796355,22,3,5,3,3,0,2,5,8,0,2,3,4,3,2,0,11
3899,780137,28,5,7,5,6,0,1,2,2,2,11,14,1,0,0,0,12
3899,785245,25,4,5,4,4,0,1,2,2,0,1,5,1,1,0,0,10
3899,775553,11,0,1,0,0,0,1,0,1,0,1,1,2,1,2,0,0
3899,790796,11,3,5,3,5,0,0,0,1,2,1,0,1,0,2,2,6
3899,796354,8,4,6,3,4,1,2,3,3,2,1,0,2,0,0,1,12
3899,796359,8,0,1,0,1,0,0,0,0,0,0,0,2,0,0,0,0
3899,799892,4,1,2,1,1,0,1,0,0,1,1,0,0,0,0,0,2
3899,794905,2,0,1,0,0,0,1,0,0,0,0,0,0,0,0,0,0
3899,790795,2,0,0,0,0,0,0,0,0,0,0,0,0,0,0,0,0
3900,792035,21,3,7,3,7,0,0,8,11,1,5,0,3,1,1,0,14
3900,780833,33,4,8,4,8,0,0,1,5,3,1,2,2,1,2,1,9
3900,792034,31,5,9,4,4,1,5,0,0,0,11,3,1,0,0,0,11
3900,785381,22,5,8,1,2,4,6,1,2,0,3,0,4,0,1,1,15
3900,780830,33,4,8,3,6,1,2,2,2,0,2,3,2,1,1,0,11
3900,797645,6,1,2,1,2,0,0,5,6,1,1,0,5,0,1,0,7
3900,785982,5,0,0,0,0,0,0,0,0,0,0,0,3,0,0,0,0
3900,791688,19,0,1,0,0,0,1,0,0,0,4,3,2,2,2,0,0
3900,792033,30,9,15,4,8,5,7,2,4,2,6,2,1,0,2,1,25
3901,797779,23,2,7,2,5,0,2,5,6,0,1,1,3,0,0,0,9
3901,797769,29,2,7,2,4,0,3,1,2,0,5,1,3,0,0,0,5
3901,786256,22,4,7,4,7,0,0,5,7,0,1,0,3,0,2,0,13
3901,797780,23,2,6,2,3,0,3,0,0,0,2,0,3,2,0,0,4
3901,797768,24,3,8,3,7,0,1,0,0,1,4,1,1,1,4,0,6
3901,797770,23,2,5,2,4,0,1,7,9,0,7,4,3,0,1,2,11
3901,785568,19,4,5,4,5,0,0,0,0,0,1,0,4,2,2,0,8
3901,797778,17,1,7,0,5,1,2,2,2,2,2,1,2,0,1,0,5
3901,797781,2,0,0,0,0,0,0,0,0,0,0,0,0,0,0,0,0
3901,797775,3,0,0,0,0,0,0,0,0,0,0,0,0,0,0,0,0
3901,797774,15,1,3,1,2,0,1,0,1,0,0,0,3,1,0,0,2
3902,780462,26,0,9,0,3,0,6,2,2,1,1,4,1,1,2,0,2
3902,796971,25,2,7,0,1,2,6,2,2,1,1,2,1,3,3,1,8
3902,786448,21,3,5,2,2,1,3,2,4,2,3,1,2,1,4,1,9
3902,775074,23,2,3,2,3,0,0,0,2,1,2,0,1,1,1,0,4
3902,786447,15,0,1,0,1,0,0,3,4,0,1,1,4,0,5,2,3
3902,791631,17,3,4,1,2,2,2,2,2,0,3,0,0,1,3,0,10
3902,776365,17,2,5,2,2,0,3,2,2,1,0,1,0,2,0,0,6
3902,780731,24,2,8,0,3,2,5,3,4,0,1,1,2,1,1,0,9
3902,786132,15,1,2,1,2,0,0,0,0,1,2,0,1,0,0,0,2
3902,791632,10,1,1,0,0,1,1,0,0,1,1,1,1,0,0,0,3
3902,775121,7,1,3,1,3,0,0,3,6,1,3,0,1,1,0,0,5
3903,797143,36,6,14,5,8,1,6,4,4,0,0,6,1,1,6,0,17
3903,797146,4,0,1,0,0,0,1,0,0,0,0,0,1,0,1,0,0
3903,797142,28,2,2,2,2,0,0,0,0,2,1,2,2,2,1,0,4
3903,791522,31,7,16,5,12,2,4,5,5,1,5,3,4,2,2,0,21
3903,786351,27,5,9,2,3,3,6,2,2,2,5,0,3,1,2,0,15
3903,797147,28,3,7,1,4,2,3,2,4,0,2,2,3,4,2,0,10
3903,785816,21,1,1,1,1,0,0,0,0,1,4,1,3,0,0,3,2
3903,786348,17,2,4,2,3,0,1,0,1,0,5,0,0,0,0,0,4
3903,797144,8,1,2,1,2,0,0,0,0,0,1,1,2,1,2,0,2
3904,786157,28,6,11,6,11,0,0,3,6,4,2,1,1,1,2,1,15
3904,780676,32,4,7,3,5,1,2,11,11,1,7,3,3,0,2,0,20
3904,791756,23,3,6,2,3,1,3,0,0,0,2,3,3,1,3,0,7
3904,780677,31,2,10,1,4,1,6,2,3,2,2,2,2,0,0,0,7
3904,780673,32,2,5,0,0,2,5,0,0,0,1,0,3,0,1,0,6
3904,786150,16,3,4,3,4,0,0,0,0,0,0,0,2,1,0,2,6
3904,775533,12,1,3,1,3,0,0,0,0,0,1,1,2,0,1,0,2
3904,797348,6,0,0,0,0,0,0,0,0,0,0,0,2,0,1,0,0
3904,780992,20,2,7,0,1,2,6,0,0,0,5,3,0,1,2,0,6
3905,791699,16,2,6,1,3,1,3,0,0,1,4,0,4,0,1,0,5
3905,797523,31,2,3,1,2,1,1,0,0,0,0,3,2,0,3,0,5
3905,785402,7,0,1,0,1,0,0,0,0,1,1,0,3,0,0,0,0
3905,792118,37,5,12,3,6,2,6,8,9,0,4,9,0,3,2,0,20
3905,782593,35,7,16,4,8,3,8,0,1,0,2,2,1,1,2,2,17
3905,785828,23,5,9,5,8,0,1,4,5,2,1,1,3,1,1,1,14
3905,791702,28,2,3,2,3,0,0,0,0,0,7,0,4,1,1,0,4
3905,797525,5,0,0,0,0,0,0,0,0,0,1,0,0,0,1,0,0
3905,791700,18,1,3,1,2,0,1,0,0,2,1,1,1,1,1,0,2
3906,780095,24,2,2,2,2,0,0,3,4,4,3,1,3,1,0,0,7
3906,776321,33,6,16,5,10,1,6,0,0,1,3,1,3,1,3,1,13
3906,786081,36,3,10,3,8,0,2,0,0,3,4,1,1,2,3,0,6
3906,785431,26,5,10,2,5,3,5,3,4,0,3,3,5,1,1,0,16
3906,780232,35,2,13,0,8,2,5,6,9,0,2,2,4,1,2,0,12
3906,786020,9,3,4,3,4,0,0,0,0,0,2,0,1,0,1,0,6
3906,785356,13,1,2,0,1,1,1,0,0,1,3,0,1,0,0,1,3
3906,797918,6,0,0,0,0,0,0,0,0,0,0,0,0,0,0,0,0
3906,789040,18,1,2,0,1,1,1,2,2,0,2,0,4,1,1,0,5
3907,791839,31,9,14,9,14,0,0,1,2,3,10,2,2,0,4,1,19
3907,785322,27,3,9,1,5,2,4,0,0,1,4,0,1,1,2,0,8
3907,792381,34,7,13,2,5,5,8,2,2,0,3,6,1,3,1,0,21
3907,791842,28,2,3,1,2,1,1,3,4,1,4,3,4,0,2,0,8
3907,786616,34,3,7,3,7,0,0,2,4,1,3,0,4,0,1,0,8
3907,797444,6,0,0,0,0,0,0,0,0,0,1,0,0,0,0,0,0
3907,786613,3,1,1,1,1,0,0,0,2,1,1,0,2,0,1,0,2
3907,776341,16,1,5,1,5,0,0,0,0,1,1,1,2,0,0,1,2
3907,786736,21,1,6,1,2,0,4,1,2,2,2,3,2,1,4,0,3
3908,792351,37,8,14,7,12,1,2,3,3,1,6,2,4,0,2,0,20
3908,786724,29,3,4,2,2,1,2,0,0,2,3,0,3,0,1,1,7
3908,786723,36,9,13,8,10,1,3,4,7,1,4,3,2,2,4,2,23
3908,798060,32,5,8,2,5,3,3,2,2,1,4,5,5,0,4,0,15
3908,792352,32,1,5,1,1,0,4,0,0,1,3,8,2,0,2,0,2
3908,792349,12,1,3,1,3,0,0,0,0,1,3,0,2,0,1,3,2
3908,792355,17,2,5,2,2,0,3,0,0,0,2,2,0,0,2,0,4
3908,798061,5,0,0,0,0,0,0,0,0,0,0,0,1,0,0,0,0
3909,780094,34,6,13,3,7,3,6,4,5,3,3,1,5,1,1,3,19
3909,775142,19,0,7,0,6,0,1,0,0,1,0,4,3,1,2,0,0
3909,790843,38,9,13,6,8,3,5,4,5,0,3,2,1,6,2,0,25
3909,786212,29,6,11,4,6,2,5,1,1,0,3,1,1,2,0,0,15
3909,781563,33,4,9,2,7,2,2,3,3,0,2,4,2,0,1,0,13
3909,790844,24,2,3,2,3,0,0,0,0,2,4,1,4,0,1,2,4
3909,792125,16,1,5,1,2,0,3,1,2,0,3,2,0,0,0,0,3
3909,799986,3,0,1,0,1,0,0,0,0,0,0,0,0,0,0,1,0
3909,790847,1,0,0,0,0,0,0,0,0,0,0,0,0,0,0,0,0
3909,781161,3,0,0,0,0,0,0,0,0,0,0,0,0,0,0,0,0
3942,791606,37,5,12,3,6,2,6,8,8,0,9,2,1,2,2,1,20
3942,786410,27,0,2,0,2,0,0,1,2,1,1,1,0,0,0,0,1
3942,775095,25,9,12,9,12,0,0,1,4,1,3,1,1,1,1,1,19
3942,786406,34,2,3,2,2,0,1,0,0,1,1,6,2,0,2,1,4
3942,780414,36,8,13,7,10,1,3,7,7,1,5,1,3,2,4,0,24
3942,797020,11,0,1,0,1,0,0,1,4,0,1,1,1,2,1,2,1
3942,797021,17,0,2,0,0,0,2,0,0,0,2,0,2,2,2,0,0
3942,791605,5,1,1,1,1,0,0,0,0,0,0,0,1,0,1,0,2
3942,791603,8,0,1,0,1,0,0,0,0,0,0,0,1,0,1,0,0
3943,792417,27,8,11,8,10,0,1,0,2,0,6,0,5,0,4,0,16
3943,786861,33,3,9,3,6,0,3,5,5,2,2,2,4,0,3,0,11
3943,786867,31,3,3,0,0,3,3,0,0,0,0,1,4,1,3,0,9
3943,780387,36,5,12,4,9,1,3,3,5,1,5,1,4,0,3,0,14
3943,767033,26,3,7,2,4,1,3,0,0,0,1,1,4,1,3,0,7
3943,792416,25,0,1,0,0,0,1,0,0,0,4,3,2,2,2,0,0
3943,786866,18,2,7,1,1,1,6,0,0,0,3,1,0,3,0,0,5
3943,796870,2,0,0,0,0,0,0,0,0,0,0,0,0,0,0,0,0
3943,796867,1,0,0,0,0,0,0,0,0,0,0,0,0,0,0,0,0
3943,796868,1,0,0,0,0,0,0,0,0,0,0,0,0,0,0,0,0
3944,785409,25,3,5,3,5,0,0,3,5,5,5,0,3,0,1,2,9
3944,785408,23,2,6,1,3,1,3,0,0,2,3,1,5,2,1,1,5
3944,796416,14,2,6,1,3,1,3,0,0,0,2,2,1,0,2,0,5
3944,780539,15,0,5,0,4,0,1,1,2,2,0,1,1,0,2,0,1
3944,776484,33,5,13,4,7,1,6,0,1,1,2,3,3,1,4,0,11
3944,796415,23,1,7,1,3,0,4,0,0,0,1,3,1,3,2,0,2
3944,780560,30,5,9,1,4,4,5,0,0,1,4,1,3,0,1,0,14
3944,785407,29,4,7,4,7,0,0,4,4,4,4,0,2,0,0,1,12
3944,790861,7,0,1,0,0,0,1,0,0,0,0,0,0,0,2,0,0
3944,796417,1,0,0,0,0,0,0,0,0,0,1,0,0,0,0,0,0
3945,796381,32,3,7,0,2,3,5,0,0,0,2,0,1,1,2,0,9
3945,775585,26,2,3,2,3,0,0,1,2,0,4,0,2,0,0,1,5
3945,796380,27,4,6,4,6,0,0,5,6,2,2,1,4,1,1,0,13
3945,790822,36,8,16,7,13,1,3,7,9,0,9,2,1,3,2,1,24
3945,790820,35,2,7,2,6,0,1,2,3,0,4,3,2,1,2,2,6
3945,790821,7,0,0,0,0,0,0,0,0,0,0,0,3,0,2,0,0
3945,780445,14,0,2,0,2,0,0,0,0,0,1,0,1,0,2,0,0
3945,780982,23,3,7,2,5,1,2,0,0,2,0,0,1,0,1,0,7
3946,791295,20,2,4,2,4,0,0,1,2,0,5,0,2,0,1,1,5
3946,776345,31,8,12,8,11,0,1,0,0,1,5,0,0,0,1,3,16
3946,796579,33,3,9,2,4,1,5,0,0,0,5,1,2,0,3,0,7
3946,785794,31,3,8,3,7,0,1,2,2,1,3,3,0,0,3,0,8
3946,781373,35,1,7,0,3,1,4,0,0,1,6,2,2,2,3,0,3
3946,781379,16,3,4,3,4,0,0,1,1,3,1,1,1,1,4,0,7
3946,796577,2,0,1,0,1,0,0,0,0,0,0,0,1,0,0,0,0
3946,791292,4,0,1,0,1,0,0,0,0,0,1,0,1,0,0,0,0
3946,796580,4,0,0,0,0,0,0,1,2,0,0,0,0,0,2,0,1
3946,785792,23,3,5,1,1,2,4,2,2,0,0,0,2,0,1,0,10
3946,796578,1,0,0,0,0,0,0,0,0,0,0,0,0,0,0,0,0
3947,791837,36,6,11,4,6,2,5,3,4,3,5,0,0,3,0,1,17
3947,780613,27,3,6,3,6,0,0,0,0,0,0,0,4,1,2,0,6
3947,775097,27,7,11,7,11,0,0,4,4,4,6,2,1,0,1,1,18
3947,780609,39,5,13,2,5,3,8,2,2,1,3,5,1,5,0,0,15
3947,776395,36,5,18,3,12,2,6,1,1,2,4,3,3,4,4,0,13
3947,786621,13,2,2,1,1,1,1,0,0,0,0,1,3,0,0,1,5
3947,786619,16,1,2,1,2,0,0,1,2,1,2,1,1,0,1,0,3
3947,797439,1,0,1,0,1,0,0,0,0,0,0,0,0,0,0,0,0
3947,797437,5,0,1,0,0,0,1,0,0,0,2,1,0,0,0,0,0
3948,785714,18,4,7,4,7,0,0,2,4,2,3,3,1,0,2,2,10
3948,775894,30,5,9,4,5,1,4,0,1,2,2,4,1,0,1,0,11
3948,791167,22,4,7,2,3,2,4,0,0,1,2,3,3,1,1,0,10
3948,780985,35,5,11,1,1,4,10,0,0,0,3,4,1,2,2,0,14
3948,775266,33,8,18,4,7,4,11,4,6,0,4,2,3,2,2,0,24
3948,796829,22,4,5,4,5,0,0,1,1,3,3,2,2,0,0,4,9
3948,785710,9,0,0,0,0,0,0,0,0,0,0,0,0,1,2,0,0
3948,779994,17,6,7,2,2,4,5,0,1,1,5,2,2,1,1,0,16
3948,785378,14,1,4,0,2,1,2,0,0,1,1,4,1,0,1,0,3
3949,776327,13,2,3,2,3,0,0,0,0,1,0,1,0,2,0,0,4
3949,797709,20,0,5,0,3,0,2,2,2,0,0,0,1,1,0,0,2
3949,792104,33,13,21,9,15,4,6,3,4,2,8,2,3,3,2,2,33
3949,797708,33,4,11,4,9,0,2,0,0,3,3,6,1,0,2,0,8
3949,786198,22,2,6,1,4,1,2,0,0,0,4,2,3,0,3,0,5
3949,785608,14,3,10,3,9,0,1,0,0,3,2,0,1,0,1,0,6
3949,786204,21,6,9,5,5,1,4,0,0,1,5,0,1,1,1,0,13
3949,775779,16,1,2,1,2,0,0,0,0,0,1,1,1,0,2,0,2
3949,786180,3,0,0,0,0,0,0,0,0,0,1,0,0,0,0,0,0
3949,797707,21,2,4,0,1,2,3,0,0,1,0,1,3,0,2,0,6
3949,792106,4,0,0,0,0,0,0,0,0,0,0,0,0,0,0,0,0
3950,785459,17,3,7,3,7,0,0,1,2,1,4,0,1,1,2,1,7
3950,789101,26,4,8,2,5,2,3,0,0,4,3,3,4,0,1,0,10
3950,789102,37,3,11,2,5,1,6,5,6,1,6,8,2,2,4,0,12
3950,781371,18,2,5,0,1,2,4,2,2,1,4,1,2,1,2,0,8
3950,781367,23,2,6,0,0,2,6,2,2,0,5,1,2,0,0,0,8
3950,797731,14,1,5,1,5,0,0,1,2,4,3,0,0,0,0,0,3
3950,792066,15,0,2,0,1,0,1,1,2,0,0,0,1,0,0,1,1
3950,797730,3,0,0,0,0,0,0,0,0,0,1,0,0,0,0,0,0
3950,792064,7,1,2,1,1,0,1,0,0,0,0,0,0,0,0,0,2
3950,792063,11,0,3,0,1,0,2,5,6,0,3,0,2,0,2,0,5
3950,792061,11,1,6,1,2,0,4,0,0,0,2,1,3,1,1,0,2
3950,788037,18,5,9,1,4,4,5,3,3,1,4,2,3,0,3,0,17
3951,791289,19,2,5,2,5,0,0,1,3,1,5,1,2,1,1,1,5
3951,785786,27,1,1,0,0,1,1,3,4,2,5,1,4,0,0,2,6
3951,791290,21,1,9,0,2,1,7,2,2,1,1,2,5,1,1,1,5
3951,796571,30,3,16,3,12,0,4,1,2,1,9,2,5,2,4,0,7
3951,781346,34,6,13,5,9,1,4,4,5,0,4,3,0,0,2,0,17
3951,791287,0,0,0,0,0,0,0,0,0,0,0,0,1,0,0,0,0
3951,796576,17,0,4,0,1,0,3,0,0,0,1,0,3,0,3,0,0
3951,796574,25,7,11,4,6,3,5,1,1,0,3,0,3,0,3,1,18
3951,791288,4,0,0,0,0,0,0,0,0,0,0,0,0,0,1,0,0
3951,796572,23,2,4,1,3,1,1,2,4,4,4,1,5,0,2,0,7
3952,792306,27,4,9,1,4,3,5,5,5,0,7,1,4,0,0,2,16
3952,786618,25,3,4,3,4,0,0,0,3,4,4,1,0,1,1,0,6
3952,792303,35,4,11,2,5,2,6,8,9,0,2,12,5,1,3,0,18
3952,781603,19,1,3,0,1,1,2,1,2,0,1,0,3,1,3,0,4
3952,780456,28,5,11,2,5,3,6,0,0,0,3,0,3,0,0,0,13
3952,797914,21,6,11,1,2,5,9,0,0,2,0,3,1,0,1,0,17
3952,797912,21,1,3,0,0,1,3,0,0,1,1,1,3,0,1,0,3
3952,781605,8,0,2,0,2,0,0,0,0,0,1,0,0,0,0,0,0
3952,792300,13,1,6,1,4,0,2,2,2,2,2,1,0,1,1,0,4
3952,797904,3,0,0,0,0,0,0,0,0,0,0,0,0,0,0,0,0
3953,785999,31,7,8,7,8,0,0,4,8,2,6,0,3,0,1,1,18
3953,775171,26,3,5,0,1,3,4,1,2,0,2,0,3,1,2,1,10
3953,775654,34,4,8,4,8,0,0,0,0,3,5,1,4,0,0,1,8
3953,791639,37,9,11,9,11,0,0,6,9,0,8,1,2,4,4,0,24
3953,785389,34,5,11,5,11,0,0,6,7,0,2,3,3,1,1,0,16
3953,796398,11,0,1,0,0,0,1,1,2,0,0,0,3,1,2,0,1
3953,796399,18,2,5,2,5,0,0,0,0,0,3,4,1,0,1,0,4
3953,791640,9,1,2,0,0,1,2,0,0,0,3,0,0,0,0,0,3
3954,792253,6,0,0,0,0,0,0,0,0,0,0,0,0,0,1,0,0
3954,781430,36,10,17,3,7,7,10,10,12,0,13,2,2,0,2,0,37
3954,792248,36,6,11,2,3,4,8,0,1,0,2,3,1,1,0,1,16
3954,781445,36,7,16,2,4,5,12,2,2,0,6,4,2,1,0,0,21
3954,768845,34,1,6,1,5,0,1,4,4,2,1,7,4,2,2,0,6
3954,792249,27,3,4,3,4,0,0,2,3,0,4,4,4,2,2,5,8
3954,781448,12,0,1,0,1,0,0,0,0,0,1,1,3,0,1,1,0
3954,797941,7,1,1,1,1,0,0,0,0,0,1,0,2,0,0,0,2
3954,792250,6,0,0,0,0,0,0,2,2,0,1,0,2,0,2,0,2
3955,780890,27,7,13,5,8,2,5,3,3,0,5,1,5,0,0,0,19
3955,775757,27,6,11,6,11,0,0,5,6,4,3,1,5,0,2,0,17
3955,791123,38,5,7,2,2,3,5,4,4,0,2,0,2,1,2,0,17
3955,786066,31,5,12,4,10,1,2,5,5,1,6,5,4,1,1,0,16
3955,785636,32,2,9,1,4,1,5,0,0,1,6,2,5,0,1,0,5
3955,791119,6,0,4,0,4,0,0,0,0,1,1,0,1,1,0,0,0
3955,780405,5,0,0,0,0,0,0,0,0,0,1,0,0,1,1,0,0
3955,775574,34,6,14,5,9,1,5,0,0,0,1,4,1,0,2,0,13
3956,781249,24,2,9,2,8,0,1,0,0,1,2,1,4,2,0,2,4
3956,775165,34,2,3,0,0,2,3,0,0,0,3,3,1,0,0,0,6
3956,785514,36,8,12,5,7,3,5,0,0,2,3,1,2,0,2,0,19
3956,785515,30,5,13,4,8,1,5,4,4,2,5,6,0,2,1,0,15
3956,781253,29,1,9,1,3,0,6,0,0,0,4,0,0,0,0,0,2
3956,796953,14,3,5,3,5,0,0,2,2,2,0,0,2,1,0,0,8
3956,796951,3,0,0,0,0,0,0,0,0,0,1,0,0,0,0,0,0
3956,791687,27,1,6,0,1,1,5,0,0,1,4,1,1,0,2,0,3
3956,791251,3,0,0,0,0,0,0,0,0,0,0,0,0,0,0,0,0
3957,797103,23,1,3,1,3,0,0,1,6,3,8,1,1,0,1,0,3
3957,791414,8,1,1,1,1,0,0,0,0,0,1,0,0,0,0,1,2
3957,791413,35,4,7,2,4,2,3,1,3,0,1,0,1,0,2,0,11
3957,791411,30,4,8,3,4,1,4,1,2,0,5,2,3,1,3,1,10
3957,785776,34,5,13,5,11,0,2,0,0,0,1,1,2,1,2,0,10
3957,785911,17,1,3,0,1,1,2,0,0,1,0,1,1,1,3,2,3
3957,797105,21,0,1,0,1,0,0,0,0,1,1,0,0,1,2,0,0
3957,797100,18,0,2,0,2,0,0,1,2,0,8,2,3,0,2,0,1
3957,781209,14,2,4,0,2,2,2,2,2,0,0,0,3,0,0,0,8
3958,776209,27,4,7,4,6,0,1,2,2,0,2,3,5,0,1,1,10
3958,796938,33,4,5,4,4,0,1,2,5,2,1,1,1,2,0,1,10
3958,791237,34,4,10,2,3,2,7,4,5,0,6,1,3,2,1,1,14
3958,791351,29,7,13,4,7,3,6,1,2,0,3,1,3,0,5,0,18
3958,791238,35,4,9,3,5,1,4,1,2,1,4,1,0,1,0,1,10
3958,781227,7,0,0,0,0,0,0,2,2,1,3,0,1,0,0,0,2
3958,791235,16,1,5,1,2,0,3,1,2,1,1,2,2,1,0,1,3
3958,791236,5,1,2,1,1,0,1,0,0,1,0,0,0,0,0,0,2
3958,791240,14,1,4,1,4,0,0,0,1,1,1,1,0,0,1,0,2
3959,790935,19,1,3,1,2,0,1,0,0,1,2,3,1,0,1,0,2
3959,792442,17,4,7,4,6,0,1,0,0,0,3,0,2,0,1,0,8
3959,790938,15,1,2,1,1,0,1,3,4,0,0,1,1,0,2,0,5
3959,775340,33,3,9,0,0,3,9,1,2,1,1,2,3,1,5,0,10
3959,774826,26,4,7,4,5,0,2,2,3,0,4,2,0,1,2,0,10
3959,796491,12,0,0,0,0,0,0,0,0,0,6,0,3,0,1,0,0
3959,796190,12,0,2,0,0,0,2,0,0,0,0,0,2,0,2,0,0
3959,790937,15,1,4,1,4,0,0,0,0,0,4,1,2,0,0,0,2
3959,785497,3,1,1,1,1,0,0,0,0,1,0,0,2,0,0,0,2
3959,785445,10,0,1,0,0,0,1,0,0,1,4,2,0,0,2,0,0
3959,796493,4,0,1,0,1,0,0,2,2,0,2,0,2,0,0,0,2
3959,780933,27,3,8,0,0,3,8,0,0,0,0,1,3,0,0,1,9
3959,796492,7,3,5,2,2,1,3,2,2,0,0,1,1,2,0,0,9
3960,786502,39,11,22,10,17,1,5,5,7,3,4,7,3,2,3,0,28
3960,781078,32,4,6,1,1,3,5,0,0,0,3,0,4,0,1,0,11
3960,797587,20,2,3,2,3,0,0,2,2,3,4,2,2,0,0,1,6
3960,786501,27,1,5,0,0,1,5,0,0,0,1,0,1,0,0,0,3
3960,791891,23,1,2,1,1,0,1,0,0,1,0,1,1,0,3,0,2
3960,797586,24,5,8,5,8,0,0,5,7,5,1,0,3,0,1,1,15
3960,797584,21,1,2,0,1,1,1,0,1,0,1,0,2,0,0,0,3
3960,781561,5,0,0,0,0,0,0,2,2,0,0,0,1,0,1,0,2
3960,791895,5,0,1,0,1,0,0,0,0,2,1,0,0,0,1,0,0
3960,791894,4,0,1,0,1,0,0,0,0,0,0,0,0,1,0,0,0
3961,785899,34,8,10,4,5,4,5,4,4,0,3,4,2,0,1,0,24
3961,791421,35,6,12,2,4,4,8,1,2,0,0,2,3,1,2,0,17
3961,797085,33,3,6,2,4,1,2,1,2,2,3,8,2,1,2,1,8
3961,791424,21,2,6,2,5,0,1,0,0,2,3,2,4,1,0,0,4
3961,785509,26,1,6,1,2,0,4,1,2,1,2,0,3,0,1,1,3
3961,791425,17,3,5,3,5,0,0,3,4,0,1,0,2,0,0,0,9
3961,797090,13,4,5,4,5,0,0,0,0,0,0,0,2,0,0,0,8
3961,797088,7,1,1,0,0,1,1,0,0,0,0,1,0,0,0,0,3
3961,797087,10,0,1,0,0,0,1,0,0,1,1,0,1,2,1,0,0
3961,797079,4,0,0,0,0,0,0,0,0,0,0,0,0,0,0,0,0
3962,790996,35,6,15,3,6,3,9,1,1,0,2,1,2,2,2,0,16
3962,785621,36,4,12,1,3,3,9,2,3,0,2,6,2,1,2,0,13
3962,796633,22,5,5,5,5,0,0,0,3,2,2,0,1,1,3,0,10
3962,790998,35,1,7,1,4,0,3,0,1,1,4,2,2,0,0,0,2
3962,790997,22,0,2,0,2,0,0,0,0,0,2,1,3,0,1,0,0
3962,796631,19,5,8,4,4,1,4,3,4,0,4,0,4,1,0,0,14
3962,790995,9,1,2,0,1,1,1,0,0,0,0,0,1,0,1,0,3
3962,786375,19,1,1,1,1,0,0,0,0,0,1,1,2,0,1,0,2
3962,790992,3,0,0,0,0,0,0,0,0,0,1,0,1,0,0,0,0
3962,781520,0,0,0,0,0,0,0,0,0,0,0,0,0,0,0,0,0
3963,786752,28,11,18,10,15,1,3,2,2,5,6,0,3,2,2,0,25
3963,781616,32,5,11,2,3,3,8,3,4,0,3,1,3,0,0,0,16
3963,792329,21,6,10,5,7,1,3,1,1,2,3,2,1,0,0,0,14
3963,776350,28,2,3,2,2,0,1,0,0,1,5,9,1,0,1,1,4
3963,781384,28,0,0,0,0,0,0,3,4,0,3,4,0,1,2,1,3
3963,781615,21,3,4,2,2,1,2,0,0,0,4,0,0,1,1,0,7
3963,781075,8,1,4,1,4,0,0,4,4,1,1,0,1,0,1,0,6
3963,792601,8,0,3,0,1,0,2,1,2,0,0,1,1,0,1,0,1
3963,785435,12,0,1,0,1,0,0,0,0,1,0,0,1,0,0,0,0
3963,786749,12,0,0,0,0,0,0,0,0,0,0,0,1,0,0,0,0
3963,792330,1,0,1,0,1,0,0,0,0,0,0,0,1,0,0,0,0
3963,792331,1,0,0,0,0,0,0,0,0,0,0,0,0,0,1,0,0
3964,797538,34,7,14,3,8,4,6,4,5,1,1,2,0,0,1,0,22
3964,780578,34,4,11,3,7,1,4,3,6,4,4,3,3,0,3,0,12
3964,785293,27,3,6,2,4,1,2,0,0,0,1,3,0,0,0,0,7
3964,785845,17,2,5,2,5,0,0,0,2,2,3,1,1,1,1,0,4
3964,780579,37,1,7,1,3,0,4,0,1,0,7,1,1,2,3,1,2
3964,785843,23,3,4,3,3,0,1,0,0,0,4,0,5,0,0,0,6
3964,785847,16,2,3,1,2,1,1,1,1,0,2,2,0,1,1,0,6
3964,797535,6,1,2,0,0,1,2,0,0,0,0,0,2,1,0,0,3
3964,791709,6,0,0,0,0,0,0,1,2,0,0,0,1,1,0,0,1
3964,791712,0,0,0,0,0,0,0,0,0,0,0,0,0,0,0,0,0
3965,797072,36,6,11,1,1,5,10,1,2,0,1,0,0,0,1,0,18
3965,786371,36,7,13,6,11,1,2,0,1,1,9,3,2,1,1,3,15
3965,791556,22,3,7,0,0,3,7,0,0,0,4,1,4,0,1,0,9
3965,786369,22,1,7,1,4,0,3,1,2,2,3,1,3,0,0,1,3
3965,791559,20,1,2,1,2,0,0,0,0,0,3,2,1,1,2,0,2
3965,791558,8,1,1,0,0,1,1,0,0,0,0,0,0,0,1,1,3
3965,797074,18,1,6,1,4,0,2,0,0,1,1,3,1,2,1,0,2
3965,786372,13,1,4,1,3,0,1,0,0,1,2,2,3,0,1,0,2
3965,786373,12,0,2,0,1,0,1,0,0,0,1,0,2,1,1,0,0
3965,791554,10,0,1,0,1,0,0,0,2,0,0,0,1,0,0,0,0
3965,791555,1,0,0,0,0,0,0,0,0,0,0,0,1,0,1,0,0
3965,797073,1,0,0,0,0,0,0,0,0,0,0,0,0,0,0,0,0
3965,797076,1,0,0,0,0,0,0,0,0,0,0,0,0,0,0,0,0
3966,792560,13,0,1,0,1,0,0,0,2,2,2,0,4,0,2,0,0
3966,792565,37,3,8,3,8,0,0,2,2,1,3,1,1,0,0,0,8
3966,798132,10,0,4,0,0,0,4,0,0,0,3,1,1,0,0,0,0
3966,798134,23,2,4,1,2,1,2,0,0,0,2,0,2,2,4,0,5
3966,792561,31,3,10,2,6,1,4,2,2,0,2,1,1,0,2,0,9
3966,776333,10,0,3,0,3,0,0,2,2,3,0,0,2,0,0,0,2
3966,792563,21,1,3,0,0,1,3,8,8,0,0,3,3,2,2,0,11
3966,789634,1,0,0,0,0,0,0,0,0,0,0,0,1,0,0,0,0
3966,780266,16,2,4,1,1,1,3,0,0,2,1,1,3,2,3,0,5
3966,780270,29,4,8,0,2,4,6,0,1,1,2,1,1,1,2,1,12
3966,798133,7,1,2,1,1,0,1,0,1,0,1,0,0,0,0,0,2
3966,785472,2,0,0,0,0,0,0,0,0,0,0,0,0,0,0,0,0
3967,775954,30,4,7,4,7,0,0,3,4,1,4,1,2,1,1,3,11
3967,796194,36,8,13,2,3,6,10,1,3,0,5,3,2,2,1,0,23
3967,796459,30,5,6,5,5,0,1,0,0,1,0,6,2,0,6,0,10
3967,790917,25,1,4,1,1,0,3,0,0,0,2,5,3,2,0,0,2
3967,781006,33,4,6,4,5,0,1,0,0,1,3,3,2,0,1,2,8
3967,781157,18,1,5,0,0,1,5,0,0,0,2,2,2,0,0,0,3
3967,780648,6,0,0,0,0,0,0,0,0,0,1,0,0,0,0,0,0
3967,796464,19,2,3,1,2,1,1,2,2,0,3,3,4,1,1,0,7
3967,790918,3,2,2,2,2,0,0,0,0,0,0,0,0,0,0,0,4
3968,786746,31,1,9,0,5,1,4,1,2,2,4,2,2,2,2,2,4
3968,780178,9,1,2,1,2,0,0,5,5,0,1,0,3,0,1,0,7
3968,775075,16,0,1,0,1,0,0,0,0,0,2,0,3,0,0,2,0
3968,792376,33,8,19,4,8,4,11,4,5,0,5,0,4,2,3,0,24
3968,797883,22,0,4,0,2,0,2,4,4,0,1,1,4,3,3,0,4
3968,797890,16,2,3,1,1,1,2,3,4,0,1,0,2,1,1,1,8
3968,792378,21,3,4,3,4,0,0,2,2,0,4,0,1,0,1,4,8
3968,797888,8,0,0,0,0,0,0,0,0,0,1,0,2,0,2,0,0
3968,792375,0,0,1,0,0,0,1,0,0,0,0,0,0,0,0,0,0
3968,792374,18,1,4,1,2,0,2,0,0,0,1,5,4,2,1,1,2
3968,786747,26,5,7,4,6,1,1,0,2,1,0,1,1,0,2,1,11
3969,781407,7,1,2,0,1,1,1,0,0,0,1,0,4,1,2,0,3
3969,786110,31,5,8,3,5,2,3,1,1,0,0,2,3,1,1,0,13
3969,791583,17,1,3,1,3,0,0,0,0,1,3,2,4,0,2,2,2
3969,780580,31,4,11,2,7,2,4,13,14,1,8,0,0,2,2,0,23
3969,776150,31,8,13,6,9,2,4,2,3,2,5,2,3,2,3,0,20
3969,797448,5,1,1,0,0,1,1,0,0,0,1,0,2,0,2,1,3
3969,786608,25,1,2,1,2,0,0,4,6,0,4,1,2,0,1,0,6
3969,797445,11,3,4,3,4,0,0,2,5,2,2,0,4,0,2,0,8
3969,785623,28,2,6,2,5,0,1,1,1,1,2,0,0,2,1,0,5
3969,786659,14,0,4,0,4,0,0,0,0,1,1,2,1,0,1,0,0
3970,786314,27,3,3,2,2,1,1,0,2,2,4,2,2,1,4,0,7
3970,786316,32,8,15,8,15,0,0,1,3,1,5,1,2,1,2,3,17
3970,791475,14,0,1,0,0,0,1,0,0,0,0,3,1,0,1,0,0
3970,791476,27,1,3,1,1,0,2,0,0,0,0,2,2,2,2,0,2
3970,780220,31,3,9,2,6,1,3,0,0,0,4,2,5,0,0,0,7
3970,797206,12,3,3,3,3,0,0,0,0,2,2,2,2,1,1,0,6
3970,797205,8,0,1,0,1,0,0,0,0,0,0,1,0,0,1,0,0
3970,791473,11,2,3,2,3,0,0,0,0,0,1,1,2,0,1,0,4
3970,797202,27,5,7,4,5,1,2,3,3,0,1,5,5,0,3,0,14
3970,791477,11,2,3,2,2,0,1,0,1,1,0,0,4,0,1,0,4
3971,792486,12,1,1,1,1,0,0,0,0,0,1,0,0,0,0,0,2
3971,785772,24,5,6,5,6,0,0,0,0,2,0,0,3,1,2,0,10
3971,785778,26,2,5,2,5,0,0,2,5,2,6,2,1,1,0,0,6
3971,785766,31,6,14,2,7,4,7,2,2,0,2,0,0,1,0,0,18
3971,780543,31,3,11,3,10,0,1,4,6,0,2,5,1,4,1,0,10
3971,792481,16,3,7,3,7,0,0,2,3,1,1,1,2,0,0,1,8
3971,792488,24,3,4,3,4,0,0,4,4,3,5,1,0,1,2,0,10
3971,797419,17,0,1,0,0,0,1,3,3,0,0,0,1,0,3,0,3
3971,792482,14,0,1,0,0,0,1,0,1,0,0,2,0,2,0,0,0
3971,792489,5,0,0,0,0,0,0,2,2,0,1,0,2,2,2,0,2
3972,792370,37,6,15,2,9,4,6,5,9,0,1,5,3,2,0,2,21
3972,792373,34,8,13,6,11,2,2,3,3,1,3,1,1,0,0,2,21
3972,797960,36,3,6,0,0,3,6,2,4,2,3,1,2,5,2,0,11
3972,786739,22,1,3,1,2,0,1,0,0,0,1,1,1,0,0,0,2
3972,775303,18,0,1,0,0,0,1,1,2,0,5,1,4,1,1,0,1
3972,797951,22,4,9,3,5,1,4,0,1,0,2,2,0,0,0,1,9
3972,781598,19,1,7,0,2,1,5,0,0,0,4,0,2,0,1,0,3
3972,797958,9,0,0,0,0,0,0,0,0,0,1,0,1,1,0,0,0
3972,781597,3,0,2,0,0,0,2,0,0,0,0,0,0,0,1,0,0
3973,790869,38,11,18,10,15,1,3,6,6,1,7,5,2,0,4,0,29
3973,790870,35,6,10,6,10,0,0,5,8,4,12,3,3,1,5,0,17
3973,790866,32,4,11,2,4,2,7,3,3,0,1,3,0,0,1,0,13
3973,780116,31,4,6,1,1,3,5,0,0,0,5,0,3,0,1,0,11
3973,780493,28,2,6,0,0,2,6,0,0,0,2,0,3,1,0,0,6
3973,796421,22,2,2,1,1,1,1,0,1,0,5,3,3,0,1,0,5
3973,796427,9,0,0,0,0,0,0,0,0,0,1,0,2,0,0,0,0
3973,780492,5,0,0,0,0,0,0,0,0,0,0,1,2,0,0,0,0
3974,780063,30,1,7,1,5,0,2,2,2,3,3,5,2,0,1,0,4
3974,785532,29,11,13,11,13,0,0,0,3,0,3,0,0,1,1,0,22
3974,775926,34,6,11,2,4,4,7,2,2,1,0,3,3,0,2,1,18
3974,791055,31,4,6,3,4,1,2,0,1,2,2,5,3,1,1,0,9
3974,775573,27,4,10,0,1,4,9,2,2,0,0,1,2,0,1,0,14
3974,791058,17,2,2,2,2,0,0,1,3,0,3,1,3,1,1,0,5
3974,791280,22,2,6,1,1,1,5,4,5,0,3,3,4,1,0,1,9
3974,796734,7,1,1,0,0,1,1,0,0,1,0,1,2,0,2,0,3
3974,791059,3,0,0,0,0,0,0,0,0,0,0,0,0,1,0,0,0
3975,786772,22,1,4,1,4,0,0,2,2,3,3,0,3,0,2,0,4
3975,781484,32,1,3,0,0,1,3,0,0,1,4,1,3,3,3,1,3
3975,786769,37,7,10,6,8,1,2,3,4,2,3,0,2,0,1,0,18
3975,780002,31,6,15,6,13,0,2,4,4,0,4,4,4,0,2,0,16
3975,786024,36,7,11,1,2,6,9,7,9,0,5,1,2,2,3,0,27
3975,785441,15,3,3,2,2,1,1,1,2,1,1,1,0,0,1,0,8
3975,791967,12,1,3,1,2,0,1,0,0,0,0,1,1,0,1,0,2
3975,790823,2,0,0,0,0,0,0,0,0,0,0,0,1,0,0,0,0
3975,786773,5,0,1,0,1,0,0,0,0,0,1,0,0,0,1,0,0
3975,797840,8,0,0,0,0,0,0,0,0,0,0,3,0,0,0,0,0
3976,791135,30,4,7,4,7,0,0,2,2,5,9,0,0,1,4,4,10
3976,791132,31,10,16,4,5,6,11,2,2,5,1,0,5,0,1,1,28
3976,786090,34,5,11,1,4,4,7,0,0,2,3,5,3,1,3,1,14
3976,786088,28,1,2,1,1,0,1,0,0,0,6,9,4,2,1,0,2
3976,774921,30,5,13,2,4,3,9,5,5,0,3,3,3,1,2,0,18
3976,791133,6,1,3,1,3,0,0,0,0,1,0,0,0,1,0,0,2
3976,791134,4,0,0,0,0,0,0,0,0,0,0,0,1,0,0,0,0
3976,791131,9,0,0,0,0,0,0,0,0,0,1,0,0,0,1,0,0
3976,796790,25,3,10,0,1,3,9,0,0,1,2,1,3,0,0,0,9
3976,786092,3,0,1,0,1,0,0,0,0,1,0,0,0,0,2,0,0
3977,790907,6,2,4,2,4,0,0,1,2,2,0,1,5,0,1,0,5
3977,787175,14,1,2,0,0,1,2,0,0,0,1,1,2,0,0,0,3
3977,790909,40,4,10,2,3,2,7,1,2,0,5,2,2,6,2,0,11
3977,781393,36,8,17,4,10,4,7,9,14,0,3,4,1,0,4,0,29
3977,775351,38,4,7,4,6,0,1,0,0,0,0,0,2,0,3,1,8
3977,796456,8,0,1,0,0,0,1,0,0,0,1,0,1,0,1,0,0
3977,796455,30,0,3,0,3,0,0,3,4,3,3,0,2,0,1,0,3
3977,782126,27,4,8,2,4,2,4,0,0,0,5,1,1,2,1,1,10
3977,796454,1,0,0,0,0,0,0,0,0,0,0,0,0,0,0,0,0
3978,780023,32,4,4,4,4,0,0,0,0,1,5,1,3,0,1,7,8
3978,792493,34,2,3,2,2,0,1,0,0,0,5,1,2,0,1,0,4
3978,792495,38,14,25,13,20,1,5,3,5,2,13,5,1,2,4,3,32
3978,792491,33,1,8,1,8,0,0,0,0,0,3,5,4,2,4,0,2
3978,781144,38,7,15,4,8,3,7,3,3,0,3,0,1,1,2,0,20
3978,798960,1,0,0,0,0,0,0,0,0,0,0,0,0,0,0,0,0
3978,793441,1,0,0,0,0,0,0,0,0,0,0,0,0,0,0,0,0
3978,792490,18,3,4,3,4,0,0,1,1,2,4,0,1,0,3,0,7
3978,788128,5,0,3,0,1,0,2,0,0,0,0,0,1,0,0,0,0
3979,785791,27,4,9,2,2,2,7,0,0,1,4,1,1,0,0,0,10
3979,775606,27,6,10,6,10,0,0,0,0,1,7,0,1,2,0,1,12
3979,780552,34,5,13,3,6,2,7,5,6,1,2,1,1,0,1,1,17
3979,780550,25,4,13,3,8,1,5,6,7,1,4,5,1,1,2,0,15
3979,780538,27,2,8,1,4,1,4,1,2,0,3,1,4,5,4,0,6
3979,797424,7,0,0,0,0,0,0,0,0,0,1,0,0,0,0,0,0
3979,785793,4,0,1,0,1,0,0,0,0,0,1,0,2,0,0,0,0
3979,791672,24,3,6,3,6,0,0,1,2,4,4,2,1,0,2,0,7
3979,791674,25,2,7,2,6,0,1,0,0,1,0,3,1,1,3,0,4
3980,785638,28,1,4,1,2,0,2,0,0,0,9,0,2,1,1,0,2
3980,781326,27,3,7,3,7,0,0,0,3,6,5,1,2,2,3,2,6
3980,797870,39,3,11,0,3,3,8,8,8,0,2,3,1,1,5,0,17
3980,792210,25,0,2,0,1,0,1,0,0,0,0,1,3,1,4,0,0
3980,781323,31,5,14,2,8,3,6,1,3,1,5,1,4,2,2,1,14
3980,780874,12,1,4,1,3,0,1,2,2,1,1,0,1,1,2,0,4
3980,785430,13,1,2,1,1,0,1,2,2,1,1,1,2,0,1,0,4
3980,792215,13,0,0,0,0,0,0,0,0,0,1,2,0,0,0,0,0
3980,792209,12,1,1,1,1,0,0,0,0,0,0,1,1,0,2,0,2
3981,785298,16,1,1,1,1,0,0,0,2,1,6,0,3,1,0,1,2
3981,775224,25,2,4,2,4,0,0,5,6,2,4,0,4,0,2,0,9
3981,778046,39,11,17,7,9,4,8,2,4,2,6,4,3,5,2,0,28
3981,782121,38,3,9,3,5,0,4,4,6,0,0,6,4,1,3,0,10
3981,775793,31,5,14,3,8,2,6,0,0,2,0,2,0,1,1,0,12
3981,785485,20,2,6,2,6,0,0,0,0,2,1,1,3,1,1,1,4
3981,785302,15,1,1,1,1,0,0,0,0,0,2,3,2,0,1,1,2
3981,786594,11,0,3,0,2,0,1,0,1,0,1,1,1,1,0,0,0
3981,796598,5,0,0,0,0,0,0,0,0,0,0,0,0,0,0,0,0
3982,785536,3,0,0,0,0,0,0,0,0,1,1,0,0,0,1,0,0
3982,775679,25,5,10,1,5,4,5,1,2,0,2,2,3,0,2,0,15
3982,796558,36,9,14,8,12,1,2,1,1,1,6,6,4,2,3,0,20
3982,796559,38,9,15,7,9,2,6,5,5,2,2,2,2,1,1,0,25
3982,776097,34,5,10,4,8,1,2,4,5,1,3,10,2,2,1,0,15
3982,796560,20,1,2,1,2,0,0,0,0,4,5,2,3,1,3,1,2
3982,785280,23,3,8,2,6,1,2,1,1,0,5,2,3,1,1,0,8
3982,780149,17,3,9,0,5,3,4,3,4,0,0,0,1,0,2,0,12
3982,785285,2,1,1,1,1,0,0,0,0,1,0,0,0,0,0,0,2
3982,781908,1,0,0,0,0,0,0,0,0,0,0,0,0,0,0,0,0
3982,792636,1,0,0,0,0,0,0,0,0,0,0,0,0,0,0,0,0
3982,796562,0,0,0,0,0,0,0,0,0,0,0,0,0,0,0,0,0
3983,791302,16,6,13,3,7,3,6,0,0,0,0,0,5,0,2,0,15
3983,781622,36,4,6,2,2,2,4,0,0,0,5,0,2,1,0,0,10
3983,791309,30,6,14,6,13,0,1,2,4,1,3,5,2,2,5,0,14
3983,785835,23,3,7,3,5,0,2,1,1,0,2,2,0,1,0,0,7
3983,776334,34,1,5,1,3,0,2,3,3,1,1,2,1,0,4,0,5
3983,775862,19,6,8,6,8,0,0,3,3,3,8,1,4,0,4,0,15
3983,791301,17,0,4,0,2,0,2,1,2,0,0,0,2,1,2,0,1
3983,796604,14,1,3,1,3,0,0,0,0,1,1,1,3,0,0,0,2
3983,796602,2,0,1,0,1,0,0,0,0,0,0,0,0,0,2,0,0
3983,796603,6,0,2,0,0,0,2,0,0,0,1,0,0,0,1,0,0
3983,791304,2,0,0,0,0,0,0,0,0,0,0,0,0,0,0,0,0
3983,796605,1,0,0,0,0,0,0,0,0,0,0,0,0,0,0,0,0
3984,792116,28,3,5,0,1,3,4,4,4,1,6,7,1,0,1,0,13
3984,780410,34,5,13,2,3,3,10,2,4,1,4,2,1,1,5,0,15
3984,797028,32,4,6,4,5,0,1,1,1,1,2,5,2,1,2,3,9
3984,785687,15,1,5,0,0,1,5,1,2,1,1,2,2,1,1,0,4
3984,791598,30,3,5,3,4,0,1,5,6,0,8,2,2,0,0,1,11
3984,797025,22,1,5,1,4,0,1,6,8,0,3,1,1,1,1,0,8
3984,775047,4,0,0,0,0,0,0,0,0,0,0,0,0,0,1,0,0
3984,791600,7,2,7,2,6,0,1,0,1,2,3,0,0,0,1,0,4
3984,797026,9,1,2,0,1,1,1,1,2,1,1,0,0,0,0,1,4
3984,797027,17,6,8,5,7,1,1,2,4,4,3,0,2,0,2,1,15
3984,797024,1,0,0,0,0,0,0,0,0,0,0,0,0,0,1,0,0
3984,797029,1,0,0,0,0,0,0,0,0,0,0,0,1,0,0,0,0
3985,780792,21,4,6,2,2,2,4,1,1,1,2,1,3,2,0,0,11
3985,797214,24,7,14,7,13,0,1,0,0,1,4,1,2,2,1,0,14
3985,797215,29,3,10,3,6,0,4,0,0,1,1,2,0,3,2,0,6
3985,780122,19,2,6,2,4,0,2,1,4,0,6,0,3,0,1,2,5
3985,786295,27,2,10,1,7,1,3,2,4,2,3,2,3,0,3,0,7
3985,791459,11,1,2,0,1,1,1,0,0,0,0,2,4,0,0,0,3
3985,775598,21,3,6,1,2,2,4,0,0,0,2,0,3,0,1,0,8
3985,786299,7,1,1,1,1,0,0,0,0,1,0,0,1,0,1,0,2
3985,791461,16,4,7,4,5,0,2,0,0,2,3,2,1,1,1,0,8
3985,791460,25,1,6,0,3,1,3,0,0,0,1,1,3,2,2,0,3
3986,791144,25,3,5,3,4,0,1,2,4,1,0,1,1,0,2,0,8
3986,785782,30,3,7,0,1,3,6,0,0,0,4,0,2,0,1,0,9
3986,791148,20,6,9,3,4,3,5,0,0,1,1,2,1,0,1,0,15
3986,791146,37,6,13,0,5,6,8,4,5,2,4,8,3,1,5,0,22
3986,785777,33,1,3,0,2,1,1,0,0,0,5,1,1,1,2,0,3
3986,791147,9,0,0,0,0,0,0,2,2,0,0,1,4,0,0,0,2
3986,796804,4,1,2,0,0,1,2,0,0,0,0,0,1,1,0,0,3
3986,791145,32,8,14,7,9,1,5,1,2,1,4,6,1,0,1,2,18
3986,786748,10,1,1,0,0,1,1,0,0,0,0,0,2,0,0,0,3
3987,796473,17,0,0,0,0,0,0,0,0,2,1,1,3,0,2,0,0
3987,781560,33,4,6,4,6,0,0,1,2,5,10,0,0,2,2,1,9
3987,791375,29,1,5,0,0,1,5,0,0,0,0,1,1,1,1,0,3
3987,785482,35,10,22,7,14,3,8,5,6,1,2,3,4,1,1,0,28
3987,780837,32,13,19,11,13,2,6,1,1,0,0,1,2,1,1,0,29
3987,796476,16,1,2,1,2,0,0,0,0,2,1,0,4,0,0,1,2
3987,786164,14,0,1,0,0,0,1,2,2,0,3,0,2,0,1,2,2
3987,796477,24,2,7,2,4,0,3,3,4,1,2,4,2,0,4,0,7
3988,785498,30,3,10,3,9,0,1,4,5,2,3,1,4,1,2,0,10
3988,776469,36,6,8,5,7,1,1,5,8,1,5,1,2,1,0,1,18
3988,796705,21,1,4,1,3,0,1,2,2,0,0,1,0,1,4,0,4
3988,780701,37,6,9,6,9,0,0,2,6,0,1,6,4,1,2,1,14
3988,776322,31,3,7,0,1,3,6,0,0,0,2,1,1,0,3,0,9
3988,785500,7,0,2,0,0,0,2,0,0,0,1,0,1,0,0,0,0
3988,796708,22,2,5,1,1,1,4,0,0,0,4,2,3,2,3,0,5
3988,796706,16,0,0,0,0,0,0,0,0,1,2,0,0,0,0,0,0
3989,796812,9,2,3,2,3,0,0,0,1,0,4,0,3,0,3,0,4
3989,780952,33,4,7,3,5,1,2,0,0,1,2,2,5,2,2,3,9
3989,786609,32,5,12,2,8,3,4,2,2,3,4,3,1,2,2,0,15
3989,785752,34,2,6,1,3,1,3,4,5,0,0,3,1,2,2,0,9
3989,796810,25,3,9,3,7,0,2,1,2,1,6,2,4,0,1,0,7
3989,780950,32,5,10,0,2,5,8,4,4,0,0,0,0,0,0,0,19
3989,791156,19,2,6,2,5,0,1,1,1,1,3,3,0,0,1,0,5
3989,780945,10,1,3,1,3,0,0,0,0,1,2,0,3,1,0,0,2
3989,791154,6,1,2,1,1,0,1,0,0,0,0,0,0,0,0,0,2
3989,791158,0,0,0,0,0,0,0,0,0,0,0,0,0,0,0,0,0
3990,791648,21,3,6,3,6,0,0,4,4,1,5,0,1,0,0,0,10
3990,786195,26,4,7,4,7,0,0,0,1,3,5,1,3,0,2,0,8
3990,797280,23,5,7,5,6,0,1,2,2,1,0,1,4,1,3,0,12
3990,797281,26,4,7,4,7,0,0,3,3,0,2,1,0,1,4,1,11
3990,791649,27,4,8,1,3,3,5,3,4,0,3,5,2,0,1,0,14
3990,785697,11,2,3,1,1,1,2,2,2,0,3,0,0,1,3,0,7
3990,786640,18,2,2,2,2,0,0,0,0,0,3,5,1,1,3,0,4
3990,791647,15,1,3,1,3,0,0,1,2,0,3,3,2,3,2,0,3
3990,797279,27,3,9,1,2,2,7,4,4,0,2,3,0,0,1,0,12
3990,785695,3,0,0,0,0,0,0,0,0,0,0,0,0,0,0,0,0
3990,785694,3,1,1,1,1,0,0,1,2,1,1,0,0,0,0,0,3
3992,791446,9,0,2,0,0,0,2,0,0,0,1,0,2,0,1,0,0
3992,781558,26,4,7,4,7,0,0,0,1,2,2,0,2,2,2,0,8
3992,780993,28,5,10,5,7,0,3,0,0,5,4,2,2,1,2,0,10
3992,791452,28,4,6,1,1,3,5,2,2,0,1,3,1,1,1,0,13
3992,797224,35,10,19,6,7,4,12,2,2,2,3,1,1,2,0,0,26
3992,797230,18,3,5,3,5,0,0,0,0,2,6,0,3,1,0,0,6
3992,797226,5,1,1,0,0,1,1,0,0,0,0,0,1,0,0,0,3
3992,797231,16,2,7,1,1,1,6,0,0,0,2,0,1,0,1,0,5
3992,797227,5,0,1,0,0,0,1,0,0,0,0,0,0,0,0,0,0
3992,797225,23,4,6,4,6,0,0,1,3,1,3,3,3,1,4,2,9
3992,791449,7,0,2,0,1,0,1,0,0,0,1,1,0,1,1,0,0
3993,786003,15,1,6,0,1,1,5,1,2,1,4,0,3,1,2,0,4
3993,775455,21,4,8,3,4,1,4,0,0,1,3,2,3,1,3,0,9
3993,792123,31,4,10,2,4,2,6,2,2,1,3,2,2,0,4,0,12
3993,786005,14,0,2,0,1,0,1,0,0,0,1,0,0,0,1,0,0
3993,781397,24,4,5,4,5,0,0,0,0,2,2,1,1,2,0,0,8
3993,797754,9,2,3,2,3,0,0,0,3,0,1,0,0,0,0,0,4
3993,792119,8,1,1,1,1,0,0,0,0,0,0,0,0,1,0,1,2
3993,792124,21,1,4,1,4,0,0,4,4,0,0,1,3,0,2,0,6
3993,797752,4,0,0,0,0,0,0,0,0,0,0,0,0,0,0,0,0
3993,797749,8,1,3,1,1,0,2,0,0,0,0,0,1,0,1,0,2
3993,797747,4,0,1,0,1,0,0,2,2,1,0,0,0,0,2,0,2
3993,792120,24,1,6,1,4,0,2,1,2,1,2,3,1,0,1,0,3
3993,786002,11,0,0,0,0,0,0,0,0,0,1,0,0,0,1,0,0
3993,786008,6,1,2,1,1,0,1,0,0,0,0,0,0,0,0,0,2
3994,776278,30,1,4,0,2,1,2,0,0,0,4,0,1,1,0,0,3
3994,790232,34,7,15,6,12,1,3,6,10,1,2,0,3,2,1,0,21
3994,789066,35,4,10,3,6,1,4,3,4,1,9,8,1,0,1,0,12
3994,780614,25,4,6,3,4,1,2,0,0,1,3,1,2,1,1,1,9
3994,780093,15,2,3,2,3,0,0,1,2,0,1,0,1,0,0,0,5
3994,786463,15,2,8,2,5,0,3,4,6,2,2,1,5,1,0,0,8
3994,785806,11,0,4,0,1,0,3,0,0,0,1,0,0,0,0,0,0
3994,780255,22,3,4,3,4,0,0,2,3,1,2,0,3,0,0,0,8
3994,792411,13,0,1,0,0,0,1,0,0,0,1,2,2,0,0,0,0
3995,791833,29,1,7,1,6,0,1,3,4,0,4,4,3,0,1,0,5
3995,786623,29,4,10,4,10,0,0,2,2,5,5,0,2,0,1,1,10
3995,797405,18,1,4,1,3,0,1,0,0,1,1,1,5,0,0,0,2
3995,785698,19,2,7,2,2,0,5,0,1,1,4,0,2,1,0,0,4
3995,785920,40,4,10,1,3,3,7,6,6,1,6,3,3,1,4,0,17
3995,786624,11,1,2,1,2,0,0,0,0,0,2,0,2,0,0,0,2
3995,797404,5,1,1,1,1,0,0,0,0,0,1,0,0,0,0,0,2
3995,791834,25,1,4,0,2,1,2,0,1,0,0,2,3,0,0,0,3
3995,784077,22,4,8,4,5,0,3,2,4,0,2,1,1,0,2,0,10
3995,797413,2,0,1,0,0,0,1,0,0,0,1,0,1,0,0,0,0
3996,780146,26,1,7,1,4,0,3,3,4,0,3,6,3,3,2,0,5
3996,786240,22,2,3,2,2,0,1,0,0,0,0,1,2,0,2,0,4
3996,790961,30,8,11,8,11,0,0,3,3,1,3,3,0,3,1,0,19
3996,785278,36,7,13,5,7,2,6,1,2,0,2,1,1,2,2,0,17
3996,780832,29,4,7,4,7,0,0,6,9,5,6,0,1,0,1,0,14
3996,796554,9,1,3,1,2,0,1,1,2,2,1,0,0,0,0,0,3
3996,775860,32,5,8,2,2,3,6,2,3,0,4,2,2,1,1,0,15
3996,796555,4,0,0,0,0,0,0,0,0,0,2,1,0,0,0,0,0
3996,796556,12,0,1,0,1,0,0,0,0,1,1,0,1,1,0,0,0
3997,785841,36,6,13,4,7,2,6,0,0,1,3,4,2,0,3,0,14
3997,796611,21,3,8,0,1,3,7,0,0,0,0,1,0,0,0,0,9
3997,796609,33,4,9,1,2,3,7,3,6,0,5,7,4,0,6,0,14
3997,792869,30,4,8,1,1,3,7,2,2,0,5,4,0,0,3,1,13
3997,785664,16,5,7,5,6,0,1,0,0,2,0,0,5,1,0,0,10
3997,796613,18,2,5,2,4,0,1,0,0,0,0,3,3,1,0,0,4
3997,791312,9,0,0,0,0,0,0,0,0,0,0,0,1,0,0,0,0
3997,792232,15,1,4,1,3,0,1,0,0,1,3,0,2,0,0,1,2
3997,766623,22,2,2,2,2,0,0,1,2,1,1,1,2,0,1,0,5
3998,790810,29,2,4,0,1,2,3,3,4,1,10,3,1,0,7,0,9
3998,785362,25,8,14,8,14,0,0,1,3,0,1,0,3,1,1,2,17
3998,790808,38,2,7,1,1,1,6,0,0,1,8,2,2,0,1,1,5
3998,785361,38,4,10,1,3,3,7,3,3,1,5,2,2,1,1,0,14
3998,779997,32,3,6,3,4,0,2,1,2,2,3,4,2,2,2,1,7
3998,774854,15,3,3,3,3,0,0,1,3,0,0,0,2,0,0,2,7
3998,790811,10,1,2,1,1,0,1,2,4,0,1,1,0,0,0,0,4
3998,790809,10,0,0,0,0,0,0,0,0,0,1,1,2,1,2,0,0
3998,796368,3,0,1,0,0,0,1,0,0,0,0,0,0,0,1,0,0
3999,785432,20,3,8,2,5,1,3,1,2,1,3,1,4,2,0,2,8
3999,785699,38,2,8,1,5,1,3,0,1,0,5,2,1,3,1,1,5
3999,790882,25,4,13,3,11,1,2,0,0,0,1,2,3,2,1,0,9
3999,790876,28,4,8,4,6,0,2,1,2,1,2,2,1,1,1,0,9
3999,774987,39,7,14,5,7,2,7,4,4,2,7,3,3,1,4,0,20
3999,781062,27,1,4,0,1,1,3,0,0,0,1,1,1,1,0,0,3
3999,790879,18,2,5,2,5,0,0,1,1,4,3,0,4,0,2,0,5
3999,790878,2,0,0,0,0,0,0,0,0,0,0,0,0,0,0,0,0
3999,796434,3,0,0,0,0,0,0,0,0,0,0,0,0,0,0,0,0
4000,792288,38,2,5,1,4,1,1,1,2,2,3,0,3,0,2,1,6
4000,785227,19,2,5,2,5,0,0,0,0,3,5,0,3,2,0,1,4
4000,792278,33,3,15,0,3,3,12,2,2,2,2,1,2,2,0,0,11
4000,786232,34,5,15,1,6,4,9,2,2,1,2,3,1,1,1,1,16
4000,780287,28,2,8,2,6,0,2,0,0,0,3,2,2,0,1,0,4
4000,798072,18,2,2,2,2,0,0,2,2,2,4,0,1,0,0,0,6
4000,798067,5,2,2,2,2,0,0,1,2,1,0,0,0,0,1,0,5
4000,798084,2,0,0,0,0,0,0,0,0,0,1,0,1,0,1,0,0
4000,786237,23,4,4,4,4,0,0,2,3,0,0,7,2,0,1,0,10
4001,797662,33,5,8,2,4,3,4,2,2,2,6,0,2,0,0,1,15
4001,786067,38,7,12,7,12,0,0,4,5,2,5,2,2,1,3,2,18
4001,797661,10,0,4,0,4,0,0,0,0,0,1,0,0,0,1,0,0
4001,785591,37,4,10,3,7,1,3,1,1,0,3,3,3,0,0,0,10
4001,780258,29,3,9,3,6,0,3,1,1,1,3,0,1,1,1,0,7
4001,792082,13,0,1,0,0,0,1,0,1,1,1,1,1,0,1,0,0
4001,792078,7,0,0,0,0,0,0,0,0,0,1,0,0,0,1,0,0
4001,792083,33,4,7,4,6,0,1,0,0,0,2,3,4,0,4,0,8
4002,796612,36,6,19,6,18,0,1,4,7,6,1,0,2,0,1,0,16
4002,785562,29,2,6,1,3,1,3,7,8,0,2,4,1,1,3,1,12
4002,796616,31,3,11,2,5,1,6,2,2,2,1,1,4,1,0,0,9
4002,775131,35,1,4,1,3,0,1,2,2,1,5,0,2,2,0,0,4
4002,796617,10,0,0,0,0,0,0,0,0,0,2,0,2,0,0,0,0
4002,792429,17,4,6,3,4,1,2,0,0,1,1,0,1,0,3,0,9
4002,796606,27,2,4,1,3,1,1,0,0,1,3,1,5,1,2,0,5
4002,796607,15,1,1,0,0,1,1,0,0,0,1,0,3,0,1,1,3
4003,780229,30,9,18,9,18,0,0,1,4,6,5,4,1,0,3,1,19
4003,791483,36,4,12,2,6,2,6,4,4,0,2,3,0,0,1,0,14
4003,780228,34,2,7,0,0,2,7,2,2,0,5,0,4,0,2,0,8
4003,795572,32,2,5,2,4,0,1,3,4,0,2,2,4,2,2,1,7
4003,786322,33,1,2,0,0,1,2,0,0,0,1,1,1,0,2,1,3
4003,781592,22,2,2,2,2,0,0,4,5,5,4,2,4,1,1,0,8
4003,791488,13,2,3,0,0,2,3,0,0,0,0,0,0,0,2,0,6
4004,796979,29,3,8,3,5,0,3,0,0,1,5,1,1,2,2,2,6
4004,776200,21,5,8,5,8,0,0,2,4,2,6,2,4,2,1,1,12
4004,780925,33,0,2,0,1,0,1,2,2,0,2,2,2,1,6,0,2
4004,780446,28,5,8,4,6,1,2,4,4,0,6,2,2,0,2,0,15
4004,781034,32,4,10,2,5,2,5,3,4,0,4,1,3,3,1,1,13
4004,791625,23,2,7,1,5,1,2,2,2,4,1,0,2,1,1,0,7
4004,791622,8,0,1,0,1,0,0,0,0,0,2,1,1,0,0,0,0
4004,791624,20,4,10,4,8,0,2,1,3,0,3,0,3,0,2,1,9
4004,791637,6,1,2,0,0,1,2,0,0,0,1,0,0,0,0,0,3
4005,791266,23,3,5,3,5,0,0,0,1,2,6,0,4,1,2,2,6
4005,785977,32,4,7,3,3,1,4,2,2,3,6,1,2,0,3,0,11
4005,791265,35,4,10,2,5,2,5,0,0,0,2,2,3,1,1,0,10
4005,791269,32,3,13,2,5,1,8,1,2,0,3,0,3,1,1,0,8
4005,785685,38,8,18,8,15,0,3,4,6,0,7,1,1,4,9,0,20
4005,796524,10,0,1,0,1,0,0,1,2,1,0,0,2,1,1,1,1
4005,796523,4,0,0,0,0,0,0,0,0,0,1,0,0,0,1,0,0
4005,796522,8,0,1,0,0,0,1,0,0,0,0,0,0,0,0,0,0
4005,791270,6,0,1,0,0,0,1,0,0,0,0,0,2,0,0,0,0
4005,791271,7,0,0,0,0,0,0,0,0,0,0,0,1,0,0,0,0
4005,781313,5,0,1,0,1,0,0,0,0,0,1,2,0,0,0,0,0
4006,785305,14,0,1,0,0,0,1,4,4,0,0,1,0,0,0,0,4
4006,785123,24,4,6,3,5,1,1,2,5,1,3,2,1,0,3,1,11
4006,790990,22,3,5,2,2,1,3,0,0,1,0,0,1,0,1,0,7
4006,789219,26,2,8,0,0,2,8,0,0,0,1,4,3,3,1,0,6
4006,785059,23,3,3,2,2,1,1,2,3,1,8,7,2,1,1,0,9
4006,796624,12,0,4,0,1,0,3,3,4,1,3,0,1,0,0,0,3
4006,796622,13,5,6,5,6,0,0,0,1,0,3,0,0,0,1,0,10
4006,796623,22,6,9,4,5,2,4,7,7,0,1,1,2,1,1,0,21
4006,785303,14,1,6,0,0,1,6,0,0,0,2,2,1,0,2,0,3
4006,785122,15,1,4,0,1,1,3,0,0,0,2,2,1,1,0,0,3
4006,790989,4,1,1,1,1,0,0,0,0,1,1,0,1,1,1,0,2
4006,790988,11,4,4,2,2,2,2,0,0,1,2,2,1,1,0,0,10
4007,797842,27,4,10,3,8,1,2,1,2,3,2,2,4,1,2,1,10
4007,797849,25,2,4,1,3,1,1,1,2,0,2,0,1,0,1,0,6
4007,779986,12,0,2,0,2,0,0,2,2,3,5,0,1,0,1,0,2
4007,786079,29,1,3,1,3,0,0,1,2,0,3,1,0,1,4,0,3
4007,797843,28,3,8,0,4,3,4,2,2,1,3,6,1,2,0,0,11
4007,797848,13,3,8,3,7,0,1,0,0,3,1,1,3,1,2,0,6
4007,781537,19,3,6,2,3,1,3,0,0,0,2,1,4,1,1,0,7
4007,797838,8,0,1,0,1,0,0,0,0,0,0,0,1,0,3,0,0
4007,797835,10,1,2,0,0,1,2,0,0,0,1,0,1,0,0,0,3
4007,797846,22,7,16,4,10,3,6,4,4,3,3,0,1,2,2,0,21
4007,797836,1,0,1,0,1,0,0,0,0,0,0,0,0,1,0,0,0
4007,797847,4,0,1,0,0,0,1,0,0,0,0,0,1,0,0,0,0
4007,792201,2,0,0,0,0,0,0,0,0,0,0,0,0,0,0,0,0
4008,780521,24,5,6,3,3,2,3,0,0,1,2,0,1,0,1,0,12
4008,775163,20,1,3,1,3,0,0,2,3,1,6,0,1,2,3,1,4
4008,791370,26,5,8,0,2,5,6,0,0,1,4,3,2,1,3,0,15
4008,786199,25,6,11,4,7,2,4,2,2,0,4,2,1,2,4,0,16
4008,780991,31,4,10,4,10,0,0,6,6,0,2,3,2,4,1,2,14
4008,780145,4,0,1,0,1,0,0,0,0,1,2,0,2,0,0,0,0
4008,781611,13,3,6,3,6,0,0,2,3,2,3,0,1,0,0,0,8
4008,797271,18,2,9,1,5,1,4,0,0,2,3,3,1,1,2,0,5
4008,743593,16,1,3,1,3,0,0,1,1,1,1,2,1,0,2,0,3
4008,791371,13,3,5,2,4,1,1,2,2,0,0,2,1,1,1,0,9
4008,797269,4,1,1,1,1,0,0,0,0,0,0,0,0,0,0,0,2
4008,797270,3,0,0,0,0,0,0,0,0,0,0,0,0,0,0,0,0
4008,797268,2,0,0,0,0,0,0,0,0,0,0,0,0,0,0,0,0
4008,786205,1,0,0,0,0,0,0,0,0,0,0,0,0,0,0,0,0
4009,785916,18,3,6,2,4,1,2,0,0,1,1,1,5,1,1,0,7
4009,780105,29,10,15,7,11,3,4,0,0,0,4,1,3,1,4,0,23
4009,791409,33,0,7,0,3,0,4,2,2,0,1,0,1,3,1,1,2
4009,785915,39,1,10,0,0,1,10,0,0,0,3,0,0,0,1,0,3
4009,781131,30,4,10,4,8,0,2,0,0,0,4,5,2,2,9,0,8
4009,785914,14,1,2,1,1,0,1,0,0,0,2,1,2,0,0,1,2
4009,780106,21,2,4,1,3,1,1,3,4,0,3,0,1,0,0,0,8
4009,797108,13,1,2,1,2,0,0,0,0,0,3,0,1,0,1,0,2
4009,786279,2,0,0,0,0,0,0,0,0,1,0,0,0,0,2,0,0
4009,797106,1,0,0,0,0,0,0,0,0,0,0,0,0,0,0,0,0
4010,780812,37,7,18,5,9,2,9,4,5,1,3,3,2,1,2,1,20
4010,780813,32,3,8,3,7,0,1,5,6,0,4,3,4,1,0,0,11
4010,796765,25,1,5,0,3,1,2,0,0,0,0,2,0,0,2,0,3
4010,796766,13,1,4,0,1,1,3,0,0,1,1,0,5,0,1,0,3
4010,791113,19,0,3,0,1,0,2,2,2,1,6,0,3,0,2,2,2
4010,785618,27,4,8,1,1,3,7,1,2,1,4,1,1,0,1,0,12
4010,785614,19,3,3,3,3,0,0,2,4,1,2,0,3,0,1,1,8
4010,796767,19,1,5,0,1,1,4,0,0,1,2,2,1,0,1,0,3
4010,791111,9,1,3,1,3,0,0,0,0,0,0,1,1,1,1,0,2
4011,797451,28,8,14,6,11,2,3,2,5,1,1,3,1,0,1,0,20
4011,780327,26,3,5,3,5,0,0,2,3,3,4,0,3,4,0,0,8
4011,785622,24,2,6,1,3,1,3,3,4,1,1,0,5,1,1,0,8
4011,781058,23,3,5,3,5,0,0,1,2,1,7,2,2,1,1,1,7
4011,797458,25,1,3,1,3,0,0,2,2,0,3,4,3,1,1,0,4
4011,786607,21,4,7,2,2,2,5,0,0,0,1,1,2,1,1,1,10
4011,797455,14,3,4,3,4,0,0,2,2,0,6,0,3,0,2,1,8
4011,797452,12,2,5,2,4,0,1,1,6,1,2,0,1,0,1,0,5
4011,791848,10,2,3,1,2,1,1,0,0,1,2,0,0,0,1,0,5
4011,797456,11,1,2,1,1,0,1,1,1,0,1,0,0,0,0,0,3
4011,791847,5,0,0,0,0,0,0,1,2,1,0,1,2,0,0,0,1
4011,791850,1,0,0,0,0,0,0,0,0,0,0,0,0,0,0,0,0
4012,792143,26,3,7,2,3,1,4,0,0,2,4,3,3,2,2,1,7
4012,797753,32,5,10,5,7,0,3,6,8,0,3,2,1,2,1,0,16
4012,786293,33,4,14,4,10,0,4,2,2,1,3,0,0,2,1,0,10
4012,780953,34,10,18,9,15,1,3,6,9,3,10,2,3,1,4,2,27
4012,797750,32,3,5,2,2,1,3,0,0,0,1,1,2,2,0,0,7
4012,786302,16,3,3,3,3,0,0,0,0,2,1,2,3,0,0,0,6
4012,797742,15,0,0,0,0,0,0,2,2,0,1,0,3,1,0,0,2
4012,797751,12,0,0,0,0,0,0,0,0,0,0,0,0,0,2,0,0
4012,786294,0,0,0,0,0,0,0,0,0,0,1,0,0,0,0,0,0
4012,796192,0,0,0,0,0,0,0,0,0,0,0,0,0,0,0,0,0
4012,792147,0,0,0,0,0,0,0,0,0,0,0,0,0,0,0,0,0
4012,786301,0,0,0,0,0,0,0,0,0,0,0,0,0,0,0,0,0
4013,797831,35,7,13,2,4,5,9,0,0,1,2,0,2,0,1,1,19
4013,797823,27,3,9,0,3,3,6,0,0,1,2,0,2,0,2,2,9
4013,797829,25,0,2,0,2,0,0,0,1,3,4,0,2,1,2,1,0
4013,792280,11,1,5,1,4,0,1,0,0,0,1,3,1,1,0,0,2
4013,780505,36,7,13,4,9,3,4,1,2,0,3,7,3,4,4,0,18
4013,785701,21,3,5,3,4,0,1,5,6,4,4,0,3,0,3,0,11
4013,797826,23,0,6,0,5,0,1,1,2,1,1,2,2,0,1,0,1
4013,792286,7,0,0,0,0,0,0,0,0,0,0,0,1,0,1,0,0
4013,785950,4,0,1,0,0,0,1,0,0,0,0,0,1,0,1,0,0
4013,799468,6,0,2,0,1,0,1,0,0,0,0,0,1,1,1,0,0
4013,797833,5,0,0,0,0,0,0,0,0,1,0,0,1,0,1,0,0
4014,780471,35,10,15,10,14,0,1,2,3,4,4,5,2,1,2,0,22
4014,776011,38,7,13,7,11,0,2,3,6,3,6,9,4,0,1,0,17
4014,786413,19,5,6,3,3,2,3,0,0,1,2,2,2,0,5,0,12
4014,791608,29,2,9,1,4,1,5,1,4,0,2,2,1,1,0,0,6
4014,780417,32,1,2,0,0,1,2,0,0,0,4,2,5,2,2,0,3
4014,786353,28,3,8,0,2,3,6,1,2,1,3,2,3,0,1,0,10
4014,796996,16,2,7,2,7,0,0,1,2,3,1,0,3,1,0,0,5
4014,785680,3,0,0,0,0,0,0,0,0,0,0,0,1,0,1,0,0
4015,791923,28,6,10,6,10,0,0,1,2,0,1,0,3,1,1,1,13
4015,791925,28,4,7,4,5,0,2,5,7,0,3,3,4,3,1,0,13
4015,791926,20,2,5,0,1,2,4,4,4,0,0,0,3,0,0,0,10
4015,781112,17,2,4,2,3,0,1,0,0,0,2,4,1,1,1,0,4
4015,781122,14,2,3,2,3,0,0,0,0,1,3,1,2,1,1,1,4
4015,791927,21,5,7,4,5,1,2,2,6,0,4,1,2,0,1,0,13
4015,786527,17,3,5,0,0,3,5,0,0,0,1,0,2,1,0,0,9
4015,786858,22,2,5,2,5,0,0,2,2,1,1,6,0,1,1,0,6
4015,797542,13,1,1,1,1,0,0,2,2,0,0,0,2,1,0,0,4
4015,797541,14,1,6,1,6,0,0,0,0,0,5,0,1,0,0,1,2
4015,786529,6,0,0,0,0,0,0,0,0,1,1,0,2,0,2,1,0
4016,780280,31,7,12,6,8,1,4,1,2,0,2,2,4,0,3,0,16
4016,780277,35,5,15,5,10,0,5,5,7,5,8,2,0,1,1,1,15
4016,780282,29,5,8,5,8,0,0,3,4,3,3,0,2,0,1,0,13
4016,785330,11,2,3,2,3,0,0,2,2,2,2,0,3,0,2,0,6
4016,791002,21,2,6,1,4,1,2,0,0,0,1,2,4,1,0,0,5
4016,791003,21,4,6,1,3,3,3,0,0,0,2,1,3,0,0,0,11
4016,785329,17,2,8,1,2,1,6,1,2,1,3,1,3,0,1,1,6
4016,780279,19,2,4,1,2,1,2,0,0,2,2,0,0,0,2,0,5
4016,796661,6,1,4,1,2,0,2,0,0,0,1,0,1,0,1,0,2
4016,796662,7,0,2,0,0,0,2,0,0,0,1,0,2,0,1,0,0
4016,796659,3,0,0,0,0,0,0,0,0,0,0,0,0,0,0,0,0
4017,780910,33,9,18,5,9,4,9,4,5,3,4,6,2,0,1,0,26
4017,786084,32,5,9,2,5,3,4,1,2,0,1,4,1,4,0,0,14
4017,780288,26,5,14,4,8,1,6,3,5,0,2,0,4,1,2,0,14
4017,791140,29,3,4,3,4,0,0,1,4,1,10,0,1,0,0,0,7
4017,791138,20,1,2,1,1,0,1,2,2,1,1,0,2,1,1,0,4
4017,780911,18,2,4,0,1,2,3,6,6,0,4,2,1,0,0,0,12
4017,781635,13,2,3,2,2,0,1,1,2,0,1,1,0,0,0,0,5
4017,796794,10,1,2,1,1,0,1,0,0,0,1,0,2,0,0,0,2
4017,796795,10,1,1,1,1,0,0,0,0,0,1,0,4,0,0,0,2
4017,780912,9,0,3,0,1,0,2,0,0,0,0,0,2,0,0,0,0
4018,780937,32,6,12,5,6,1,6,1,1,2,4,3,0,2,2,1,14
4018,797715,33,5,12,4,7,1,5,2,2,2,2,9,0,2,4,0,13
4018,791149,27,5,8,4,5,1,3,1,2,0,4,1,3,0,2,1,12
4018,791950,33,4,6,4,5,0,1,0,2,0,4,1,4,2,4,0,8
4018,792113,30,2,5,2,3,0,2,0,0,1,2,0,3,0,3,0,4
4018,780779,13,4,6,2,4,2,2,0,0,0,2,1,1,0,1,0,10
4018,792115,21,1,2,1,2,0,0,2,4,2,3,1,2,0,1,0,4
4018,797716,5,1,1,1,1,0,0,0,0,0,0,1,3,0,0,0,2
4018,797717,6,0,2,0,2,0,0,0,0,1,0,0,1,1,1,0,0
4019,781134,29,5,10,5,9,0,1,3,4,1,2,1,3,0,2,1,13
4019,786475,34,4,13,3,6,1,7,2,2,0,2,4,2,1,4,0,11
4019,774874,32,5,9,5,9,0,0,1,2,3,6,1,3,0,0,0,11
4019,785270,34,3,7,0,0,3,7,0,0,0,1,1,2,1,4,0,9
4019,796531,20,1,4,0,2,1,2,0,0,0,2,3,0,0,3,0,3
4019,776038,20,2,5,0,1,2,4,0,0,0,2,3,1,0,2,0,6
4019,790946,13,2,3,2,2,0,1,0,0,1,0,0,2,0,0,0,4
4019,780085,6,2,2,2,2,0,0,0,0,2,0,1,3,0,1,0,4
4019,775468,12,1,4,0,1,1,3,0,0,0,2,2,0,0,1,0,3
4020,775357,32,3,7,0,1,3,6,2,2,0,1,2,2,1,1,0,11
4020,786699,18,5,6,5,6,0,0,0,0,3,2,1,2,2,1,0,10
4020,785593,26,2,8,2,3,0,5,0,0,1,1,0,1,1,2,0,4
4020,797174,27,1,8,0,3,1,5,0,0,1,1,0,1,0,0,0,3
4020,791510,23,0,8,0,4,0,4,3,4,3,2,1,1,0,4,0,3
4020,797168,27,5,9,5,6,0,3,1,2,0,9,3,2,1,2,0,11
4020,791507,19,5,7,5,7,0,0,0,2,2,0,0,1,0,0,0,10
4020,791504,22,1,5,1,5,0,0,2,2,1,2,3,3,0,3,0,4
4020,791509,3,1,1,1,1,0,0,0,0,1,2,0,0,0,1,0,2
4020,791505,3,0,0,0,0,0,0,0,0,0,0,0,0,0,1,0,0
4021,780743,37,9,12,7,8,2,4,0,1,0,3,3,0,1,1,0,20
4021,791062,34,7,14,7,12,0,2,5,6,0,3,2,1,2,0,0,19
4021,791060,14,4,6,3,4,1,2,0,0,0,4,2,1,1,3,0,9
4021,791064,35,2,6,2,4,0,2,0,0,1,3,4,2,2,3,0,4
4021,796735,11,1,2,1,1,0,1,0,2,0,0,0,2,0,1,0,2
4021,791063,18,3,4,3,3,0,1,0,0,0,2,0,5,0,2,0,6
4021,785542,30,0,2,0,1,0,1,2,2,0,3,3,0,1,1,0,2
4021,785548,16,1,3,1,2,0,1,0,0,1,2,0,2,0,3,0,2
4021,796742,5,0,0,0,0,0,0,0,0,0,2,0,0,0,0,0,0
4022,796372,12,2,3,2,3,0,0,0,1,0,1,1,4,0,0,0,4
4022,796377,39,2,11,2,6,0,5,2,4,0,1,7,2,1,3,0,6
4022,796378,40,4,9,3,6,1,3,0,0,2,2,2,1,2,1,0,9
4022,790815,39,6,16,5,10,1,6,1,2,3,8,3,2,0,2,0,14
4022,780176,40,5,13,2,5,3,8,2,3,1,3,1,4,2,3,0,15
4022,796376,14,0,1,0,0,0,1,0,0,1,1,1,2,0,1,0,0
4022,790817,15,2,5,1,4,1,1,1,2,1,1,0,1,0,0,0,6
4022,796373,1,0,0,0,0,0,0,0,0,0,0,0,0,0,0,0,0
4023,796439,20,2,3,2,3,0,0,2,5,3,5,0,3,0,2,0,6
4023,791635,6,0,1,0,0,0,1,0,0,0,0,0,1,0,0,0,0
4023,790883,30,5,10,4,7,1,3,0,0,1,3,4,5,1,2,0,11
4023,796436,31,1,3,0,1,1,2,2,2,0,6,5,2,0,2,1,5
4023,785436,34,6,9,5,8,1,1,2,3,1,8,1,1,0,4,0,15
4023,796442,3,1,1,1,1,0,0,0,0,0,0,0,1,0,0,0,2
4023,790884,22,7,11,7,11,0,0,0,0,0,2,3,1,2,1,0,14
4023,796438,34,4,7,1,2,3,5,4,5,0,3,2,0,2,3,0,15
4023,790885,20,1,3,1,1,0,2,0,0,1,2,1,1,1,1,3,2
4024,786542,28,6,10,5,6,1,4,1,1,3,6,0,2,1,1,0,14
4024,786540,18,2,5,2,5,0,0,3,4,3,2,1,4,0,2,0,7
4024,792019,34,4,10,1,4,3,6,6,6,2,2,0,2,2,1,0,17
4024,792015,32,3,8,3,7,0,1,4,6,0,1,2,1,4,3,0,10
4024,775995,36,2,5,2,4,0,1,1,2,0,1,1,2,1,3,0,5
4024,785364,22,1,7,1,7,0,0,3,5,1,5,0,1,1,1,0,5
4024,792016,19,0,3,0,2,0,1,2,2,0,1,5,0,2,0,0,2
4024,791845,11,1,2,0,0,1,2,1,2,0,1,0,1,2,0,0,4
4025,776253,37,4,10,1,2,3,8,0,0,1,9,6,2,1,4,1,11
4025,775651,29,4,8,4,6,0,2,2,2,2,4,0,4,1,2,1,10
4025,791070,18,2,3,2,2,0,1,0,0,0,1,0,4,0,4,0,4
4025,791627,35,5,9,1,2,4,7,0,0,1,3,2,2,2,6,0,14
4025,785665,29,2,12,1,3,1,9,0,0,2,3,1,2,0,0,0,5
4025,791071,7,1,1,1,1,0,0,0,0,1,1,0,4,0,1,0,2
4025,785660,6,1,1,1,1,0,0,0,0,0,0,0,3,0,1,1,2
4025,796504,1,0,0,0,0,0,0,0,0,0,0,0,0,0,0,0,0
4025,796502,6,0,1,0,1,0,0,0,0,1,0,0,0,0,1,0,0
4025,796501,10,0,0,0,0,0,0,0,0,1,0,1,0,0,1,0,0
4025,776178,22,2,6,2,5,0,1,3,6,2,6,3,2,1,3,0,7
4026,785681,23,2,3,2,3,0,0,0,0,1,1,0,1,0,2,1,4
4026,796789,12,1,5,1,3,0,2,1,2,0,1,0,2,0,1,0,3
4026,791126,22,1,4,1,3,0,1,4,4,2,1,3,4,0,1,0,6
4026,791124,43,2,6,1,4,1,2,9,10,0,3,6,1,5,3,0,14
4026,780050,40,7,16,7,12,0,4,4,6,4,8,2,3,3,2,0,18
4026,784479,1,0,0,0,0,0,0,3,4,0,0,0,0,0,0,0,3
4026,796786,27,1,7,1,2,0,5,1,2,1,1,1,0,2,1,0,3
4026,775813,21,2,6,2,5,0,1,2,2,3,4,1,5,1,1,0,6
4026,796784,3,0,0,0,0,0,0,0,0,0,0,0,0,0,1,0,0
4026,796783,6,0,1,0,1,0,0,0,0,1,0,0,2,0,0,0,0
4026,796782,27,6,10,1,2,5,8,0,0,1,1,0,4,0,2,0,17
4027,797558,22,1,6,0,2,1,4,0,0,0,1,1,3,0,2,0,3
4027,786519,37,3,3,3,3,0,0,2,2,0,5,0,4,1,2,1,8
4027,797556,40,8,15,5,7,3,8,6,6,2,2,0,3,1,1,0,25
4027,791913,42,1,6,1,2,0,4,3,4,0,2,8,3,1,1,0,5
4027,786520,34,4,13,3,10,1,3,7,7,2,4,1,2,1,7,0,16
4027,791912,5,0,0,0,0,0,0,0,0,0,1,0,1,0,1,0,0
4027,797560,3,0,0,0,0,0,0,0,0,0,0,0,1,0,0,0,0
4027,797559,1,0,0,0,0,0,0,0,0,1,0,0,0,0,0,0,0
4027,797557,18,2,6,1,4,1,2,0,0,0,1,0,4,2,0,0,5
4027,797555,21,2,2,0,0,2,2,3,4,1,4,1,1,1,3,0,9
4027,781076,2,0,0,0,0,0,0,0,0,0,0,0,0,0,2,0,0
4028,776100,23,2,5,1,3,1,2,0,0,2,0,1,0,1,0,0,5
4028,785991,32,6,11,4,7,2,4,0,0,3,10,1,3,0,2,3,14
4028,797762,33,1,4,1,4,0,0,3,4,4,3,6,2,1,3,0,5
4028,781406,35,3,14,0,9,3,5,7,7,0,6,2,1,3,4,0,16
4028,781401,31,4,6,3,5,1,1,0,0,1,2,0,2,1,1,0,9
4028,797760,5,0,1,0,1,0,0,0,0,0,0,0,0,0,1,0,0
4028,792133,24,2,6,2,4,0,2,2,2,0,0,2,5,0,3,0,6
4028,781029,17,1,7,0,0,1,7,0,0,0,0,0,2,0,2,0,3
4029,797139,21,3,7,3,7,0,0,0,0,1,4,1,2,0,1,1,6
4029,775394,27,4,5,3,3,1,2,0,0,1,3,1,0,0,0,0,9
4029,791526,29,2,7,2,6,0,1,2,2,0,6,4,2,1,2,1,6
4029,780272,30,5,8,3,5,2,3,2,2,0,1,4,2,0,4,0,14
4029,775592,28,2,8,2,4,0,4,2,2,0,3,1,3,2,1,0,6
4029,791524,20,3,6,3,6,0,0,2,3,3,2,4,2,2,2,0,8
4029,785970,20,5,7,5,7,0,0,1,4,1,3,0,3,2,3,0,11
4029,797136,8,0,1,0,1,0,0,0,0,0,0,0,0,0,0,0,0
4029,780273,17,1,3,0,1,1,2,0,0,0,0,0,0,2,0,0,3
4030,796343,28,2,3,2,3,0,0,1,2,2,1,0,4,0,2,1,5
4030,796344,38,3,12,1,5,2,7,3,4,2,11,0,4,0,1,2,11
4030,790785,37,4,13,2,8,2,5,7,8,0,2,3,3,1,4,0,17
4030,796340,32,3,11,1,7,2,4,3,4,0,3,2,4,1,0,0,11
4030,781232,38,7,15,4,7,3,8,1,2,0,3,4,4,2,1,0,18
4030,780040,19,1,5,1,5,0,0,0,2,0,2,0,3,0,0,0,2
4030,790780,4,0,0,0,0,0,0,0,2,0,0,0,1,0,0,0,0
4030,796345,3,0,0,0,0,0,0,0,0,0,0,0,2,0,0,0,0
4030,790783,1,0,0,0,0,0,0,0,0,0,0,0,0,0,0,0,0
4031,790893,33,5,11,5,10,0,1,3,4,5,5,1,3,1,0,1,13
4031,796444,36,5,7,4,5,1,2,8,9,3,10,1,2,0,3,6,19
4031,786615,32,4,10,2,5,2,5,1,2,0,4,4,4,0,1,3,11
4031,786732,28,2,4,2,2,0,2,3,4,2,2,0,3,1,3,0,7
4031,775260,34,4,12,4,6,0,6,8,9,2,7,4,2,1,1,0,16
4031,775536,11,0,2,0,2,0,0,1,2,1,3,0,2,0,2,1,1
4031,780702,12,1,6,1,1,0,5,0,0,0,1,0,1,1,2,0,2
4031,790889,13,1,4,1,3,0,1,2,2,0,3,3,1,0,2,1,4
4031,799891,1,0,0,0,0,0,0,0,0,0,0,0,1,0,0,0,0
4032,780913,20,1,5,1,2,0,3,0,0,0,1,2,4,1,1,0,2
4032,798124,35,2,5,1,3,1,2,1,2,0,3,5,2,2,6,1,6
4032,798119,40,9,12,6,7,3,5,0,1,0,2,1,2,0,1,0,21
4032,780594,28,1,9,0,2,1,7,0,0,1,2,2,1,3,4,0,3
4032,775664,32,2,6,0,0,2,6,0,0,1,3,3,3,0,1,1,6
4032,798123,22,8,13,8,10,0,3,4,7,1,4,0,3,2,1,0,20
4032,798118,10,2,5,2,3,0,2,0,0,1,1,0,2,0,1,0,4
4032,769332,5,1,2,0,0,1,2,0,0,0,2,1,0,0,0,0,3
4032,798126,5,0,0,0,0,0,0,0,0,0,0,0,0,0,0,0,0
4032,798121,3,0,0,0,0,0,0,0,0,0,0,0,0,0,0,0,0
4033,786296,10,1,4,1,3,0,1,0,0,0,3,0,0,1,2,0,2
4033,781530,27,3,6,3,5,0,1,5,6,1,5,3,1,0,3,0,11
4033,776423,14,0,0,0,0,0,0,0,0,0,4,1,5,1,2,1,0
4033,798096,26,6,10,6,8,0,2,2,2,1,3,0,1,0,1,0,14
4033,792319,18,1,2,0,0,1,2,4,4,0,1,1,1,3,2,0,7
4033,792316,9,1,2,1,2,0,0,1,2,2,1,0,1,0,1,0,3
4033,792314,12,0,1,0,1,0,0,0,0,0,1,1,4,0,1,0,0
4033,792320,10,1,1,1,1,0,0,2,2,0,3,1,0,0,0,0,4
4033,798106,16,1,4,1,2,0,2,2,2,0,0,2,0,1,0,0,4
4033,798104,22,8,11,3,3,5,8,2,3,0,1,2,1,1,0,0,23
4033,792307,15,2,5,0,2,2,3,0,0,1,1,3,0,1,3,0,6
4033,792309,13,2,5,1,3,1,2,0,0,0,1,0,1,1,1,0,5
4033,792321,8,0,2,0,2,0,0,0,0,1,3,0,2,0,1,0,0
4034,792181,30,3,11,2,8,1,3,5,5,4,5,0,4,0,1,1,12
4034,780986,40,4,7,4,7,0,0,3,4,2,6,2,2,1,3,0,11
4034,785902,33,4,10,3,4,1,6,0,0,2,3,2,3,0,1,1,9
4034,792179,37,6,12,3,8,3,4,3,4,0,3,8,1,2,2,0,18
4034,786662,37,9,18,6,12,3,6,0,1,0,5,3,0,1,1,0,21
4034,797796,6,0,1,0,1,0,0,0,0,0,0,1,0,0,0,0,0
4034,786661,17,1,3,0,1,1,2,0,0,0,2,1,2,3,0,1,3
4035,781403,38,5,13,4,7,1,6,6,8,2,7,1,0,1,2,3,17
4035,792654,20,3,4,3,4,0,0,3,3,0,1,0,3,0,1,1,9
4035,797301,28,1,8,0,3,1,5,0,0,0,2,2,2,1,1,0,3
4035,780524,30,4,6,2,2,2,4,0,0,1,1,3,1,1,1,0,10
4035,781400,40,6,15,2,5,4,10,0,0,0,4,10,3,1,5,0,16
4035,786857,19,3,4,1,1,2,3,1,2,2,2,1,3,0,0,0,9
4035,797306,7,0,0,0,0,0,0,0,0,0,3,0,0,0,0,1,0
4035,797304,3,0,0,0,0,0,0,0,0,0,0,0,2,0,0,0,0
4035,797303,9,1,3,0,0,1,3,0,0,0,1,1,1,0,1,0,3
4035,797302,6,1,2,1,1,0,1,0,0,0,2,0,0,0,1,1,2
4036,786531,37,7,13,3,6,4,7,4,6,0,6,4,2,1,2,0,22
4036,785829,36,7,13,7,13,0,0,2,3,5,11,0,1,0,1,0,16
4036,775838,32,4,9,4,9,0,0,1,4,3,6,3,3,0,3,0,9
4036,796726,30,4,10,3,6,1,4,0,0,0,1,1,3,4,3,0,9
4036,796729,10,0,2,0,1,0,1,2,2,0,0,0,0,0,0,0,2
4036,785519,20,3,9,2,4,1,5,0,0,1,0,2,3,1,1,0,7
4036,780723,9,2,3,2,3,0,0,1,3,1,1,0,0,0,1,0,5
4036,796727,20,1,5,0,1,1,4,0,2,1,1,1,2,1,1,1,3
4036,791048,10,1,3,1,2,0,1,0,2,1,1,0,0,0,0,0,2
4036,796724,14,0,3,0,1,0,2,0,0,0,1,2,2,1,0,0,0
4036,791044,4,0,0,0,0,0,0,0,0,0,0,1,0,1,0,0,0
4036,796728,3,0,0,0,0,0,0,0,0,0,1,0,0,0,1,0,0
4037,797180,28,5,10,1,1,4,9,3,3,1,5,1,2,1,0,1,17
4037,780461,43,7,19,6,14,1,5,1,1,0,4,9,4,1,7,0,16
4037,791497,39,3,11,2,4,1,7,2,6,0,6,0,1,0,1,0,9
4037,791498,36,3,5,3,5,0,0,0,0,1,11,1,3,0,6,2,6
4037,774812,15,1,3,0,2,1,1,2,2,1,2,1,5,0,2,0,5
4037,791503,26,5,6,3,3,2,3,0,0,1,3,1,1,1,2,0,12
4037,791499,23,2,5,0,2,2,3,0,0,2,0,0,3,0,2,0,6
4037,791502,11,0,2,0,1,0,1,1,2,0,1,0,1,1,1,0,1
4037,790517,4,0,0,0,0,0,0,0,0,0,0,0,2,0,0,0,0
4038,791868,28,5,14,3,10,2,4,2,2,0,0,2,3,0,2,0,14
4038,797807,37,3,8,3,6,0,2,3,3,0,5,3,3,1,1,0,9
4038,786058,40,2,10,1,7,1,3,2,2,0,1,2,4,0,1,0,7
4038,792264,21,2,6,2,4,0,2,0,0,0,4,2,2,0,1,0,4
4038,797812,13,0,0,0,0,0,0,0,0,0,0,0,1,0,0,1,0
4038,797809,34,3,10,1,7,2,3,1,2,3,6,0,5,3,2,1,9
4038,797802,26,1,5,0,2,1,3,2,4,0,2,2,4,3,0,0,5
4038,797810,1,0,0,0,0,0,0,0,0,0,0,0,2,0,0,0,0
4039,780353,32,6,8,6,8,0,0,6,8,3,8,2,3,0,3,5,18
4039,776279,28,4,8,0,2,4,6,0,0,0,1,2,2,1,1,2,12
4039,791317,32,2,3,1,2,1,1,2,4,1,3,2,2,0,2,0,7
4039,777573,26,1,7,1,4,0,3,4,6,0,4,2,1,0,0,0,6
4039,781505,23,2,4,1,1,1,3,1,2,1,2,0,2,0,1,1,6
4039,786222,25,2,4,2,3,0,1,2,2,2,9,0,0,0,1,1,6
4039,790851,12,1,2,1,1,0,1,0,2,1,1,0,0,0,1,0,2
4039,796649,12,1,3,1,1,0,2,0,0,0,2,2,2,0,2,0,2
4039,796648,10,0,2,0,1,0,1,0,0,0,0,0,0,0,1,0,0
4040,792340,37,5,9,3,5,2,4,7,9,2,8,0,2,0,1,1,19
4040,781552,37,6,13,4,8,2,5,1,1,0,3,2,5,2,3,0,15
4040,792345,31,6,14,6,11,0,3,1,1,2,4,0,5,0,1,1,13
4040,792346,31,4,9,4,6,0,3,0,0,3,4,3,5,0,4,0,8
4040,781553,8,0,1,0,1,0,0,0,0,0,1,0,2,0,1,0,0
4040,792342,27,1,4,0,2,1,2,1,2,0,4,0,0,0,0,0,4
4040,798080,12,1,3,0,0,1,3,0,0,0,0,1,0,1,0,0,3
4040,792341,13,0,1,0,1,0,0,0,0,0,1,1,2,0,0,0,0
4040,792344,4,0,0,0,0,0,0,0,0,0,0,1,1,0,0,0,0
4041,792032,35,6,15,1,7,5,8,2,2,1,3,6,4,1,3,0,19
4041,780828,31,3,11,2,7,1,4,6,8,0,7,4,3,0,2,2,13
4041,792029,23,3,6,3,6,0,0,3,4,3,2,2,2,0,2,0,9
4041,792031,23,2,6,0,3,2,3,0,0,0,3,2,2,1,0,0,6
4041,761149,30,2,3,2,2,0,1,0,0,0,6,1,0,0,0,1,4
4041,797637,28,5,6,2,2,3,4,0,1,0,1,1,1,0,3,0,13
4041,792027,12,1,3,1,3,0,0,1,2,1,0,2,2,0,1,0,3
4041,797640,10,0,1,0,1,0,0,1,2,0,0,1,0,0,0,1,1
4041,797641,8,0,1,0,1,0,0,0,0,0,3,0,1,0,0,1,0
4042,781044,31,6,13,3,7,3,6,4,4,2,9,4,1,0,0,0,19
4042,791795,30,4,7,3,4,1,3,5,5,1,4,0,3,0,0,0,14
4042,786489,10,2,4,1,1,1,3,0,0,0,1,0,3,0,2,0,5
4042,786488,36,5,10,5,9,0,1,8,9,0,4,3,3,0,1,1,18
4042,781038,35,2,8,2,6,0,2,0,0,0,5,1,2,0,2,0,4
4042,797620,27,5,9,4,6,1,3,0,0,3,5,1,1,0,1,4,11
4042,791796,1,0,0,0,0,0,0,0,0,0,0,0,0,0,0,0,0
4042,786490,5,1,2,1,2,0,0,0,0,2,0,0,0,1,0,0,2
4042,797621,16,1,2,0,1,1,1,1,2,1,0,0,2,0,0,0,4
4042,797619,7,1,2,0,1,1,1,0,0,0,0,1,2,0,2,0,3
4042,797622,1,0,0,0,0,0,0,0,0,0,1,0,0,0,0,0,0
4042,786487,1,0,0,0,0,0,0,0,0,0,0,0,0,0,0,0,0
4043,780570,24,1,4,1,4,0,0,3,4,1,4,0,3,0,2,1,5
4043,780569,31,5,8,5,8,0,0,1,1,3,5,0,2,0,1,0,11
4043,797438,25,1,4,1,4,0,0,0,0,0,0,1,3,1,0,0,2
4043,791697,31,4,17,1,13,3,4,3,4,2,4,0,1,0,0,0,14
4043,780565,16,1,6,1,3,0,3,3,4,0,1,1,1,1,0,0,5
4043,797434,16,3,5,3,5,0,0,1,2,3,3,0,2,0,0,0,7
4043,797433,2,0,0,0,0,0,0,0,0,0,0,0,1,0,0,0,0
4043,791693,1,0,0,0,0,0,0,0,0,0,0,0,0,0,0,0,0
4043,797432,15,2,4,1,2,1,2,2,2,0,1,0,2,1,0,0,7
4043,797436,11,0,3,0,1,0,2,0,0,0,0,1,1,0,1,0,0
4043,791696,24,6,11,6,10,0,1,1,3,0,3,1,4,1,0,1,13
4043,791695,2,0,1,0,1,0,0,0,0,0,0,0,0,0,1,0,0
4043,785824,2,1,1,1,1,0,0,0,0,0,0,1,0,0,0,0,2
4044,786547,13,1,2,0,0,1,2,0,1,0,2,0,3,0,1,1,3
4044,786544,34,5,12,4,9,1,3,3,3,4,6,2,1,0,7,1,14
4044,797507,27,1,7,0,4,1,3,0,0,2,3,4,2,1,1,1,3
4044,792012,36,6,12,2,6,4,6,0,0,0,3,1,2,1,2,1,16
4044,775084,30,5,11,1,5,4,6,0,0,0,3,3,1,2,1,0,14
4044,797512,6,0,0,0,0,0,0,0,0,0,1,0,1,0,0,0,0
4044,786860,25,5,10,2,3,3,7,2,2,0,3,2,2,1,2,1,15
4044,797511,2,1,1,1,1,0,0,1,1,0,0,0,0,0,0,0,3
4044,797510,3,1,2,0,1,1,1,0,0,0,0,0,0,0,0,0,3
4044,797508,2,0,0,0,0,0,0,0,0,0,0,0,0,0,0,0,0
4044,792013,2,0,0,0,0,0,0,0,1,0,1,0,0,1,0,0,0
4044,787622,2,0,1,0,0,0,1,0,0,0,0,0,0,0,0,0,0
4044,786546,18,1,2,1,2,0,0,1,2,0,4,1,0,3,1,0,3
4045,797628,21,0,4,0,3,0,1,0,0,0,3,0,2,1,2,0,0
4045,786481,36,5,13,5,11,0,2,1,4,0,7,3,3,4,0,0,11
4045,797624,27,2,5,1,2,1,3,0,0,1,5,1,3,0,0,1,5
4045,785965,31,6,14,3,6,3,8,2,3,0,2,3,0,0,3,0,17
4045,781032,30,3,6,2,4,1,2,4,4,0,2,0,2,2,3,0,11
4045,797625,2,0,0,0,0,0,0,0,0,0,1,0,1,0,0,0,0
4045,791793,9,1,2,1,2,0,0,0,0,0,2,0,1,0,5,0,2
4045,791791,19,0,2,0,1,0,1,0,0,0,2,1,2,0,1,0,0
4045,797627,2,0,0,0,0,0,0,0,0,0,0,1,1,0,0,0,0
4045,786480,23,4,10,2,4,2,6,1,1,0,2,1,1,0,1,0,11
4046,785827,20,2,5,2,5,0,0,3,5,1,4,0,3,1,1,1,7
4046,796332,15,2,3,1,1,1,2,0,0,0,2,1,1,0,1,0,5
4046,785813,37,8,16,4,9,4,7,5,5,0,2,8,4,1,1,0,25
4046,786289,23,2,7,2,3,0,4,0,0,1,0,2,1,1,0,0,4
4046,790776,14,3,3,3,3,0,0,2,3,3,0,0,4,1,0,1,8
4046,796337,30,1,9,1,6,0,3,0,0,2,2,3,1,0,1,0,2
4046,779975,10,1,3,1,3,0,0,0,0,1,0,0,4,0,2,0,2
4046,796330,21,3,7,1,2,2,5,0,0,2,2,0,3,1,0,0,8
4046,796334,30,6,12,5,10,1,2,2,3,3,5,1,4,0,3,0,15
4047,780283,17,2,3,2,3,0,0,5,7,3,3,0,3,1,2,0,9
4047,790925,30,4,9,3,7,1,2,4,5,2,7,1,1,1,2,0,13
4047,791456,33,5,10,2,6,3,4,3,4,0,2,1,1,0,1,0,16
4047,785476,32,7,10,7,10,0,0,8,8,0,2,2,1,0,0,0,22
4047,785474,20,2,4,1,3,1,1,3,4,0,3,1,1,1,3,0,8
4047,780292,14,1,2,1,2,0,0,4,4,3,2,0,4,0,1,0,6
4047,790926,15,1,4,1,2,0,2,0,0,1,0,0,0,1,0,0,2
4047,785478,9,0,1,0,1,0,0,0,0,0,1,0,4,0,0,0,0
4047,796470,10,1,2,1,1,0,1,0,0,1,1,0,2,0,0,0,2
4047,785480,20,1,4,0,1,1,3,0,0,0,0,1,0,0,0,0,3
4048,797325,28,5,7,5,7,0,0,1,2,1,10,6,1,0,1,0,11
4048,797329,15,1,5,1,2,0,3,2,2,2,2,1,5,0,2,0,4
4048,797323,34,4,8,3,3,1,5,8,8,1,2,7,1,3,2,0,17
4048,786236,32,10,15,7,9,3,6,1,2,1,5,0,3,0,1,2,24
4048,780759,31,5,8,0,2,5,6,1,2,0,6,3,2,1,0,0,16
4048,786246,11,2,4,0,1,2,3,2,2,0,2,0,1,0,0,0,8
4048,781002,19,2,4,2,4,0,0,1,4,1,5,0,1,1,0,2,5
4048,776478,9,0,2,0,0,0,2,0,0,0,1,0,2,0,1,0,0
4048,797330,3,0,0,0,0,0,0,0,0,0,0,1,0,0,0,0,0
4048,797324,3,0,0,0,0,0,0,3,3,0,0,0,0,0,0,0,3
4048,786239,12,2,5,2,4,0,1,0,0,1,1,2,1,0,1,0,4
4048,786233,3,2,2,0,0,2,2,0,0,0,0,1,0,0,0,1,6
4050,775094,29,5,9,3,6,2,3,1,2,1,6,3,3,1,2,0,13
4050,785524,27,4,6,2,3,2,3,2,4,3,3,1,3,1,0,0,12
4050,780739,28,5,8,5,8,0,0,1,2,1,0,0,2,1,0,3,11
4050,791053,20,0,2,0,1,0,1,1,2,2,3,1,2,0,1,0,1
4050,781115,16,0,4,0,3,0,1,0,0,0,1,0,1,0,1,0,0
4050,775456,25,6,12,5,10,1,2,3,5,3,4,4,0,3,4,0,16
4050,790819,25,2,9,2,8,0,1,3,3,1,1,4,1,1,1,0,7
4050,796730,10,1,5,0,0,1,5,0,0,0,3,0,0,0,0,1,3
4050,791051,13,1,1,1,1,0,0,0,1,3,4,1,4,0,1,1,2
4050,786310,4,0,0,0,0,0,0,0,0,1,1,1,0,0,1,0,0
4050,796731,3,0,1,0,1,0,0,0,0,0,0,0,2,0,0,0,0
4051,796717,31,4,11,4,7,0,4,4,4,0,3,4,2,2,1,0,12
4051,791043,37,3,11,2,8,1,3,4,4,1,1,1,3,4,1,0,11
4051,774834,28,3,5,3,4,0,1,2,4,3,2,0,1,0,2,0,8
4051,785512,19,2,6,2,6,0,0,1,2,2,3,0,4,0,1,1,5
4051,796718,19,0,6,0,2,0,4,0,0,1,4,1,3,0,1,0,0
4051,775412,25,3,8,1,3,2,5,0,0,1,0,1,1,0,2,0,8
4051,796723,24,1,4,1,2,0,2,0,0,1,4,2,0,1,3,0,2
4051,766998,9,1,2,1,2,0,0,0,0,0,1,0,3,0,1,0,2
4051,796720,8,1,3,1,1,0,2,0,0,0,2,0,2,1,2,0,2
4060,785836,38,4,14,1,6,3,8,0,0,3,4,1,1,1,2,0,11
4060,785833,36,11,20,7,14,4,6,8,8,3,3,1,2,1,1,0,34
4060,785332,24,5,8,5,8,0,0,1,2,5,6,1,2,1,2,1,11
4060,791707,14,1,3,1,3,0,0,0,1,0,0,2,1,0,1,0,2
4060,785838,35,1,7,0,3,1,4,0,0,0,2,1,2,1,1,0,3
4060,775872,5,0,0,0,0,0,0,0,0,0,0,0,1,0,0,0,0
4060,791704,11,0,1,0,0,0,1,0,2,0,2,1,2,0,0,0,0
4060,785892,18,0,4,0,3,0,1,0,0,0,1,5,5,0,0,0,0
4060,780577,19,1,2,0,1,1,1,2,2,0,2,2,2,0,0,0,5
4061,781158,18,3,6,3,6,0,0,0,2,1,6,0,1,0,1,0,6
4061,781652,37,3,8,3,7,0,1,2,2,0,8,1,3,1,3,0,8
4061,786034,27,1,4,1,3,0,1,3,4,0,1,1,4,0,0,0,5
4061,786419,33,10,15,9,10,1,5,6,7,1,2,1,2,0,1,0,27
4061,781283,26,4,4,3,3,1,1,0,0,0,0,0,3,2,0,0,9
4061,785419,12,0,1,0,1,0,0,0,0,0,0,0,1,1,1,1,0
4061,791615,29,5,10,5,7,0,3,3,3,1,4,2,3,0,2,1,13
4061,785277,18,0,2,0,1,0,1,0,0,0,3,0,2,0,0,0,0
4062,775820,22,1,3,1,3,0,0,0,0,0,2,2,2,0,0,1,2
4062,775538,26,3,3,3,3,0,0,0,1,1,2,0,2,0,0,0,6
4062,791110,36,13,16,8,9,5,7,4,4,0,3,1,0,5,1,0,35
4062,785603,33,3,8,2,2,1,6,0,0,0,1,2,2,0,1,0,7
4062,776425,31,3,11,3,5,0,6,0,1,1,5,2,2,0,1,1,6
4062,796763,13,3,3,1,1,2,2,0,0,1,3,0,1,0,0,2,8
4062,791106,19,2,5,2,3,0,2,2,2,0,1,2,2,1,3,1,6
4062,786494,20,1,3,0,1,1,2,0,0,0,2,0,1,0,0,0,3
4063,791201,26,1,5,1,4,0,1,2,2,2,5,0,1,0,0,0,4
4063,791202,23,1,6,0,0,1,6,0,0,0,1,1,1,0,0,0,3
4063,775767,34,6,9,6,9,0,0,4,4,4,6,1,0,0,1,1,16
4063,785628,36,6,12,4,8,2,4,5,5,0,3,5,3,0,3,0,19
4063,785627,28,6,10,3,4,3,6,2,2,1,2,1,4,0,3,0,17
4063,781135,6,0,1,0,1,0,0,0,0,0,0,1,1,0,1,0,0
4063,796902,6,0,1,0,1,0,0,0,0,0,0,0,0,0,0,0,0
4063,796901,13,1,2,0,1,1,1,0,0,0,3,0,0,1,1,0,3
4063,785629,28,2,5,2,2,0,3,2,2,0,1,2,3,1,1,0,6
4064,785459,17,6,11,6,11,0,0,2,3,1,3,2,1,1,3,3,14
4064,789101,28,3,4,2,2,1,2,0,0,2,5,2,3,0,1,0,7
4064,789102,37,4,5,2,2,2,3,7,12,0,8,6,1,2,5,0,17
4064,781371,21,2,4,1,1,1,3,3,3,0,5,0,3,2,2,0,8
4064,781367,25,5,8,2,3,3,5,2,2,0,2,0,3,1,2,0,15
4064,797731,12,2,2,2,2,0,0,0,0,0,1,0,1,0,0,0,4
4064,792066,14,0,1,0,0,0,1,0,0,0,0,0,3,0,1,1,0
4064,797730,1,0,0,0,0,0,0,0,0,0,0,0,0,0,0,0,0
4064,792064,6,2,3,0,0,2,3,0,0,0,2,0,0,0,0,0,6
4064,792063,15,2,3,1,2,1,1,6,6,0,0,2,4,0,0,0,11
4064,792061,10,2,6,2,4,0,2,1,2,1,2,0,2,1,1,1,5
4064,788037,14,2,4,2,3,0,1,0,0,0,2,0,1,0,3,0,4
4065,791289,10,0,1,0,1,0,0,0,0,1,0,0,3,0,1,0,0
4065,785786,32,4,6,4,5,0,1,1,2,2,3,1,4,0,0,2,9
4065,796574,25,4,10,3,7,1,3,0,1,0,3,2,5,1,3,0,9
4065,796571,36,4,12,3,6,1,6,11,12,1,4,1,1,3,2,0,20
4065,781346,32,7,11,6,6,1,5,3,4,0,2,9,2,1,4,0,18
4065,791287,1,1,1,1,1,0,0,0,1,1,0,0,0,0,2,0,2
4065,796576,22,4,10,2,6,2,4,2,4,0,1,1,4,2,1,0,12
4065,791290,20,2,5,1,2,1,3,0,0,1,0,0,0,0,0,0,5
4065,796572,22,4,9,4,7,0,2,0,0,2,5,0,5,1,0,1,8
4066,797241,17,4,5,4,5,0,0,1,4,3,2,0,3,0,2,1,9
4066,791361,12,2,4,1,2,1,2,0,0,1,1,0,1,2,1,0,5
4066,797244,19,3,5,3,4,0,1,2,3,0,0,4,3,1,0,0,8
4066,797243,15,1,5,1,4,0,1,0,0,1,6,1,1,0,2,0,2
4066,780163,28,10,12,4,4,6,8,2,4,1,3,3,2,1,0,0,28
4066,791366,22,3,4,2,2,1,2,5,7,2,2,4,3,1,0,0,12
4066,780170,17,4,9,4,8,0,1,0,0,1,4,0,0,1,0,0,8
4066,791363,11,3,5,2,2,1,3,1,1,0,6,1,4,1,2,0,8
4066,785742,22,4,10,2,4,2,6,0,0,0,1,1,2,0,2,0,10
4066,786340,21,3,7,3,4,0,3,0,0,0,1,1,4,1,1,1,6
4066,797242,7,1,1,1,1,0,0,0,0,1,2,2,0,0,1,0,2
4066,786155,5,1,1,1,1,0,0,0,0,0,0,0,2,0,0,0,2
4066,797246,2,0,1,0,0,0,1,0,0,0,0,0,0,0,0,0,0
4066,797245,2,0,1,0,1,0,0,0,0,0,0,0,0,0,0,0,0
4068,781249,24,6,10,5,6,1,4,0,0,0,5,1,3,0,0,0,13
4068,775165,31,3,4,0,0,3,4,0,0,0,4,2,1,1,1,0,9
4068,785514,35,4,10,4,6,0,4,0,0,2,4,7,2,1,0,0,8
4068,785515,39,4,10,0,4,4,6,0,0,0,6,8,2,1,5,0,12
4068,781253,32,5,12,0,2,5,10,0,0,0,1,0,4,1,0,0,15
4068,796953,21,4,8,4,6,0,2,0,0,2,0,0,0,0,0,0,8
4068,796951,4,0,1,0,1,0,0,0,0,0,0,0,0,0,0,0,0
4068,791687,14,1,5,1,4,0,1,1,1,1,2,2,0,0,1,0,3
4069,797103,24,5,6,4,5,1,1,2,5,0,1,1,1,1,0,0,13
4069,791414,33,2,2,1,1,1,1,0,0,0,9,0,1,0,1,0,5
4069,791413,31,9,11,8,10,1,1,2,3,1,5,0,1,0,1,0,21
4069,791411,26,4,8,2,6,2,2,0,1,0,4,1,3,0,2,0,10
4069,785776,27,4,9,4,8,0,1,2,4,0,1,1,0,1,0,0,10
4069,785911,16,1,3,0,1,1,2,0,0,0,3,2,2,0,0,0,3
4069,797100,21,2,3,2,3,0,0,0,0,0,2,2,1,0,2,0,4
4069,781209,18,3,6,2,3,1,3,0,2,0,0,0,1,1,1,0,7
4069,797105,4,0,0,0,0,0,0,0,0,0,0,0,0,0,0,0,0
4070,780494,26,6,11,5,6,1,5,3,4,2,3,0,3,1,1,0,16
4070,797276,18,0,0,0,0,0,0,0,0,0,3,5,5,3,4,0,0
4070,780497,22,1,2,1,2,0,0,1,3,2,3,0,1,0,0,0,3
4070,780496,23,3,4,0,0,3,4,0,0,0,2,0,0,0,3,1,9
4070,780495,31,5,13,3,6,2,7,9,11,1,8,2,3,1,2,1,21
4070,797274,8,1,4,1,4,0,0,1,2,1,1,0,1,0,1,0,3
4070,785693,13,0,3,0,3,0,0,0,0,0,1,0,2,0,0,0,0
4070,797275,7,0,1,0,0,0,1,0,0,0,0,0,2,0,0,0,0
4070,791643,11,1,3,1,2,0,1,0,0,0,1,1,1,0,2,0,2
4070,785692,20,1,2,0,0,1,2,2,2,0,2,2,2,0,3,0,5
4070,785644,18,4,7,1,3,3,4,2,2,0,3,1,1,2,1,0,13
4070,797277,3,0,1,0,0,0,1,0,0,0,0,0,1,0,0,0,0
4071,797058,14,2,2,1,1,1,1,2,2,1,1,2,0,1,0,0,7
4071,775549,20,2,2,2,2,0,0,6,8,1,2,0,4,1,1,5,10
4071,797056,24,2,7,2,3,0,4,0,0,0,3,0,3,0,5,0,4
4071,797055,29,4,8,3,5,1,3,2,4,1,1,5,1,3,1,0,11
4071,786381,29,3,12,2,4,1,8,3,4,1,1,0,2,2,0,0,10
4071,791564,22,3,12,3,5,0,7,1,2,1,5,1,4,1,2,0,7
4071,791566,2,1,1,1,1,0,0,0,0,0,0,0,1,0,1,0,2
4071,780425,18,0,0,0,0,0,0,0,0,2,5,0,4,1,1,2,0
4071,797054,27,1,10,1,6,0,4,5,6,0,5,3,1,1,1,0,7
4071,791568,15,2,2,2,2,0,0,0,2,0,1,0,2,0,1,0,4
4072,785845,25,3,6,3,6,0,0,4,8,4,4,0,3,0,1,0,10
4072,780578,29,4,13,4,13,0,0,2,2,3,4,1,3,1,1,0,10
4072,797538,33,1,10,1,4,0,6,2,2,1,4,1,0,1,1,0,4
4072,785293,22,0,3,0,3,0,0,0,0,2,1,1,5,0,0,0,0
4072,780579,36,2,12,2,8,0,4,0,3,2,7,3,0,2,2,0,4
4072,791709,7,0,2,0,1,0,1,0,0,0,1,0,1,0,2,1,0
4072,785843,19,2,4,2,2,0,2,1,2,1,0,1,1,0,0,0,5
4072,797537,5,0,1,0,1,0,0,0,0,0,2,0,0,1,1,0,0
4072,797535,3,0,0,0,0,0,0,0,0,0,1,0,2,0,1,0,0
4072,785847,21,2,5,1,1,1,4,3,3,1,3,0,1,0,1,0,8
4073,791558,20,2,4,2,2,0,2,0,0,1,0,1,4,0,1,0,4
4073,786371,38,2,8,2,6,0,2,6,9,2,10,0,2,0,1,6,10
4073,797072,38,6,15,3,8,3,7,0,2,1,4,1,2,0,2,0,15
4073,791554,29,3,7,2,4,1,3,2,4,1,1,1,2,2,2,0,9
4073,791556,37,2,7,1,3,1,4,0,0,0,7,2,2,1,4,0,5
4073,797076,16,0,2,0,0,0,2,0,0,0,6,1,4,0,1,1,0
4073,791555,8,0,2,0,1,0,1,0,0,0,0,1,0,1,0,0,0
4073,786369,14,1,3,1,2,0,1,0,0,0,2,1,1,2,2,0,2
4074,785766,30,6,13,2,2,4,11,2,2,0,5,0,2,0,2,0,18
4074,780543,34,7,10,6,9,1,1,2,4,0,1,4,0,0,0,0,17
4074,792486,21,3,7,1,5,2,2,2,2,4,4,1,3,0,1,2,10
4074,785772,21,1,1,1,1,0,0,1,2,2,1,2,2,1,4,0,3
4074,785778,18,1,5,1,4,0,1,0,0,1,2,2,1,0,2,1,2
4074,792488,19,1,3,0,1,1,2,3,4,2,1,2,1,2,0,0,6
4074,792481,19,3,6,3,5,0,1,0,0,2,2,2,2,0,1,0,6
4074,792482,16,3,4,3,4,0,0,0,1,2,4,1,0,1,2,0,6
4074,792489,12,1,2,0,0,1,2,2,2,1,5,2,0,0,0,0,5
4074,797419,10,0,2,0,1,0,1,0,0,0,0,0,4,0,2,0,0
4075,780220,36,8,19,7,15,1,4,2,3,1,3,3,2,3,1,0,19
4075,786316,34,7,9,7,9,0,0,0,0,0,7,1,3,0,0,1,14
4075,791476,33,4,8,4,6,0,2,0,0,0,0,0,2,1,2,0,8
4075,797202,25,2,7,2,6,0,1,0,0,1,2,2,2,2,3,0,4
4075,786314,18,1,2,0,1,1,1,0,0,0,0,0,3,0,2,0,3
4075,791475,12,2,2,1,1,1,1,0,0,0,1,0,0,1,1,0,5
4075,797206,10,1,3,1,2,0,1,3,4,1,0,0,0,0,0,0,5
4075,791473,22,0,1,0,1,0,0,0,1,0,0,1,3,0,0,0,0
4075,791477,10,0,2,0,0,0,2,0,0,0,0,2,1,0,0,0,0
4076,780812,37,7,17,3,6,4,11,0,0,0,4,4,2,0,1,0,18
4076,796766,24,1,4,0,1,1,3,6,7,1,2,0,5,2,1,0,9
4076,780813,28,4,8,4,8,0,0,0,1,3,2,1,3,3,4,1,8
4076,796765,16,2,7,0,4,2,3,0,0,0,1,0,1,2,3,0,6
4076,791113,20,0,2,0,0,0,2,0,0,0,3,1,3,0,2,3,0
4076,796767,21,2,8,2,6,0,2,0,0,1,4,1,0,1,4,0,4
4076,785614,18,0,0,0,0,0,0,2,2,1,1,0,2,0,0,0,2
4076,785618,20,0,4,0,1,0,3,1,2,1,2,1,1,1,1,0,1
4076,791111,14,0,1,0,0,0,1,0,0,0,0,1,0,0,1,0,0
4076,800004,2,0,1,0,0,0,1,0,0,0,0,0,0,0,0,0,0
4077,785622,31,4,7,1,1,3,6,5,5,3,2,1,2,1,1,0,16
4077,797451,27,5,11,4,8,1,3,1,2,0,6,2,1,1,2,0,12
4077,780327,21,3,3,3,3,0,0,2,5,1,5,1,2,1,0,1,8
4077,781058,25,3,7,3,7,0,0,1,3,2,7,0,0,1,3,0,7
4077,797458,25,2,8,1,3,1,5,0,0,0,2,2,1,0,1,0,5
4077,797455,12,1,1,1,1,0,0,3,4,0,3,0,2,0,1,0,5
4077,797452,11,2,3,2,3,0,0,0,0,0,1,0,2,0,3,0,4
4077,797456,11,2,3,2,2,0,1,0,0,0,2,0,1,2,0,0,4
4077,797453,3,1,2,0,0,1,2,0,0,0,0,0,0,0,0,0,3
4077,786607,13,1,3,1,1,0,2,0,0,0,0,2,3,3,2,0,2
4077,791847,6,1,1,1,1,0,0,0,0,0,0,1,0,0,0,0,2
4077,791848,9,0,1,0,1,0,0,0,0,0,1,1,2,0,1,0,0
4077,797454,2,0,0,0,0,0,0,0,0,0,1,0,0,0,0,0,0
4077,791850,2,0,0,0,0,0,0,0,0,0,0,0,1,0,1,0,0
4077,797457,2,0,0,0,0,0,0,0,0,0,1,0,0,0,0,0,0
4078,786620,34,8,16,8,13,0,3,2,3,0,3,4,1,0,0,0,18
4078,791838,29,3,7,2,3,1,4,2,2,0,4,1,4,0,0,0,9
4078,781257,29,2,7,1,5,1,2,2,2,1,4,1,1,2,0,0,7
4078,781606,30,2,4,0,1,2,3,0,0,0,0,2,4,0,1,0,6
4078,791257,6,0,1,0,1,0,0,0,0,2,1,0,3,0,1,0,0
4078,781263,29,7,11,7,9,0,2,0,0,1,0,2,5,3,1,0,14
4078,796955,13,3,5,3,5,0,0,2,2,0,2,0,2,1,2,0,8
4078,796954,19,2,3,1,2,1,1,1,2,1,0,0,1,1,1,0,6
4078,780900,11,0,1,0,1,0,0,0,0,0,1,2,0,0,0,0,0
4079,797317,37,8,11,6,8,2,3,1,1,0,1,1,2,0,0,0,19
4079,791726,36,4,10,1,3,3,7,7,8,0,2,1,2,0,3,0,18
4079,780773,37,5,11,5,11,0,0,7,10,4,8,6,0,1,3,0,17
4079,791728,14,1,1,1,1,0,0,4,6,0,2,0,3,0,2,0,6
4079,775228,32,2,6,1,2,1,4,0,0,0,3,1,2,0,1,0,5
4079,786569,22,5,6,5,6,0,0,0,0,3,1,0,3,0,2,0,10
4079,797315,13,0,0,0,0,0,0,0,0,0,0,0,2,0,0,0,0
4079,780274,9,0,0,0,0,0,0,0,0,0,2,0,1,2,1,0,0
4080,781439,39,6,15,3,7,3,8,6,7,0,5,1,5,0,3,0,21
4080,781322,25,5,9,0,0,5,9,0,0,1,5,0,4,0,1,0,15
4080,781007,26,5,7,5,7,0,0,0,0,0,3,1,3,2,3,1,10
4080,786571,37,3,10,3,8,0,2,4,5,1,5,6,3,2,1,0,10
4080,785989,31,4,8,4,6,0,2,2,6,2,4,7,3,0,0,1,10
4080,797299,2,0,0,0,0,0,0,0,0,0,0,0,0,0,0,0,0
4080,781419,15,1,4,0,2,1,2,0,0,0,0,0,1,0,0,0,3
4080,780563,11,0,0,0,0,0,0,0,0,0,2,0,0,0,0,0,0
4080,781207,14,2,4,2,4,0,0,3,4,0,1,1,0,0,1,0,7
4081,780118,38,6,13,4,9,2,4,3,6,0,4,2,3,0,0,0,17
4081,785931,30,7,15,4,9,3,6,1,3,3,2,4,4,1,2,0,18
4081,791401,38,3,8,3,8,0,0,9,14,3,8,2,1,0,2,3,15
4081,780125,26,4,7,3,5,1,2,2,2,2,3,2,3,1,0,0,11
4081,797125,22,4,8,4,4,0,4,0,0,1,0,3,1,0,0,0,8
4081,786837,21,4,7,3,4,1,3,0,0,3,3,0,0,1,0,0,9
4081,797132,20,1,4,0,0,1,4,0,0,0,4,1,2,1,2,0,3
4081,797130,2,1,2,0,1,1,1,0,0,0,1,0,0,0,0,0,3
4081,797126,3,0,1,0,1,0,0,0,0,0,2,0,0,0,0,0,0
4082,797174,32,1,5,0,1,1,4,2,2,0,5,0,1,1,1,0,5
4082,791510,20,0,2,0,1,0,1,2,2,0,3,1,1,0,1,0,2
4082,786699,21,2,3,2,3,0,0,0,2,0,4,0,3,2,0,0,4
4082,785593,29,8,10,3,3,5,7,1,2,0,4,0,2,0,1,0,22
4082,775357,33,5,12,3,6,2,6,4,4,0,3,6,1,1,2,0,16
4082,791509,2,0,1,0,1,0,0,0,0,0,0,0,0,0,0,0,0
4082,791507,17,4,4,4,4,0,0,3,4,2,1,0,4,0,0,0,11
4082,797168,22,6,9,5,7,1,2,1,2,2,0,1,1,0,1,0,14
4082,791504,21,1,4,1,2,0,2,2,2,1,2,1,1,0,1,0,4
4082,791505,3,0,1,0,1,0,0,0,0,0,0,0,0,0,0,0,0
4083,791062,35,7,14,6,10,1,4,2,2,0,3,0,4,0,0,0,17
4083,791063,21,4,7,4,7,0,0,0,0,0,4,2,4,0,1,1,8
4083,791064,34,1,5,1,1,0,4,0,0,0,0,1,4,0,2,0,2
4083,785542,34,3,4,2,2,1,2,0,1,0,1,0,1,0,1,0,7
4083,780743,38,7,11,4,4,3,7,6,6,0,0,3,3,1,0,0,23
4083,785548,19,4,8,3,6,1,2,1,2,2,5,1,0,1,1,0,10
4083,796735,13,1,2,1,1,0,1,0,0,0,4,2,0,1,1,0,2
4083,796736,0,0,0,0,0,0,0,0,0,0,0,0,0,0,0,0,0
4083,796737,3,0,0,0,0,0,0,0,0,0,0,1,2,0,1,0,0
4083,796742,3,0,0,0,0,0,0,0,0,0,0,0,0,0,0,0,0
4084,781342,34,5,9,5,7,0,2,5,6,4,8,2,4,0,2,1,15
4084,785452,29,4,7,4,7,0,0,1,2,4,4,0,3,0,1,0,9
4084,781593,35,7,13,7,11,0,2,0,0,4,3,2,3,0,1,0,14
4084,781620,21,2,5,2,3,0,2,0,0,0,3,2,3,2,2,0,4
4084,790901,22,0,6,0,4,0,2,0,0,0,4,1,4,1,2,0,0
4084,790902,26,5,10,2,5,3,5,2,2,1,3,0,2,2,1,1,15
4084,790903,24,5,12,1,2,4,10,4,6,0,0,0,1,1,0,0,18
4084,796450,7,1,2,1,2,0,0,0,0,0,0,1,2,0,0,0,2
4084,796452,2,0,0,0,0,0,0,0,0,0,0,0,0,0,0,0,0
4085,775676,23,3,5,3,5,0,0,0,1,0,3,1,2,0,0,3,6
4085,774957,24,1,2,1,1,0,1,2,2,3,3,0,1,0,1,1,4
4085,785423,29,3,6,3,5,0,1,11,12,0,4,0,5,1,1,0,17
4085,785422,37,3,14,2,6,1,8,2,3,2,1,6,2,1,5,0,9
4085,786298,31,3,10,1,2,2,8,2,4,1,6,4,2,2,1,0,10
4085,785425,30,3,4,1,1,2,3,4,4,0,1,0,1,0,1,0,12
4085,796431,5,1,2,1,2,0,0,0,0,0,0,0,0,0,0,0,2
4085,786210,18,1,4,0,2,1,2,0,0,0,0,0,0,0,2,0,3
4085,796429,1,0,1,0,1,0,0,0,0,0,0,0,1,0,1,0,0
4085,793801,2,0,0,0,0,0,0,0,0,0,0,0,1,0,0,0,0
4086,791537,25,4,7,4,6,0,1,11,11,2,3,2,1,0,1,0,19
4086,786357,37,4,8,3,6,1,2,1,3,3,2,0,2,3,3,0,10
4086,780306,36,7,18,5,15,2,3,4,6,3,7,3,1,0,5,2,20
4086,797116,26,2,5,2,3,0,2,0,0,0,2,3,2,1,6,0,4
4086,780312,36,2,5,1,1,1,4,0,1,0,3,3,1,3,4,0,5
4086,791535,4,0,0,0,0,0,0,0,0,1,0,0,2,0,1,0,0
4086,786358,21,2,2,2,2,0,0,0,0,0,5,1,4,0,1,3,4
4086,775418,15,2,6,2,6,0,0,2,2,1,2,1,1,0,2,1,6
4087,791750,26,1,4,0,0,1,4,0,0,1,2,2,4,0,3,2,3
4087,786177,35,3,7,1,3,2,4,1,2,1,5,1,4,1,2,0,9
4087,780244,30,2,3,1,1,1,2,0,0,0,1,1,5,0,1,2,5
4087,786179,32,6,19,4,11,2,8,2,2,1,2,1,1,6,3,1,16
4087,780238,37,5,14,5,12,0,2,2,2,1,5,2,2,3,3,1,12
4087,791752,6,2,2,2,2,0,0,0,0,0,0,0,3,0,1,0,4
4087,785909,9,2,3,2,3,0,0,0,0,0,1,0,0,0,2,0,4
4087,790773,3,0,0,0,0,0,0,0,0,1,0,0,0,0,1,0,0
4087,781500,20,3,8,2,4,1,4,0,0,0,4,2,1,1,1,1,7
4087,791749,2,0,0,0,0,0,0,0,0,0,0,0,0,0,0,0,0
4088,791416,33,8,10,8,10,0,0,5,6,3,7,0,1,0,1,2,21
4088,797096,31,3,6,0,1,3,5,0,0,0,1,0,1,1,3,0,9
4088,785906,40,9,23,7,18,2,5,3,4,2,6,2,2,0,3,0,23
4088,780100,32,0,3,0,2,0,1,0,2,0,9,5,2,1,0,0,0
4088,780096,23,0,2,0,1,0,1,0,0,0,1,5,1,2,0,0,0
4088,785907,7,0,2,0,2,0,0,0,0,1,0,0,1,0,0,0,0
4088,797093,26,4,12,4,10,0,2,0,0,0,2,3,4,2,1,0,8
4088,781614,6,0,2,0,1,0,1,0,0,1,0,0,1,0,0,0,0
4088,797094,2,1,1,1,1,0,0,0,0,1,0,0,0,1,0,0,2
4089,791585,37,5,10,2,6,3,4,3,5,1,7,1,0,0,2,2,16
4089,780062,27,1,3,1,3,0,0,0,0,2,4,0,2,0,2,1,2
4089,791581,29,2,5,1,2,1,3,4,4,1,4,2,3,0,0,0,9
4089,786394,38,3,11,2,7,1,4,5,5,1,2,1,0,1,1,3,12
4089,780404,36,8,16,7,13,1,3,2,3,1,3,3,2,1,2,0,19
4089,797041,7,1,2,1,2,0,0,0,0,0,0,0,0,0,1,0,2
4089,791582,8,1,4,0,1,1,3,0,0,0,1,0,2,0,0,0,3
4089,785228,11,1,3,0,1,1,2,0,0,1,0,1,4,0,2,1,3
4089,797037,7,0,1,0,0,0,1,0,0,0,1,0,0,0,0,0,0
4096,780747,34,2,7,1,4,1,3,3,4,0,3,4,3,1,3,0,8
4096,776363,28,5,8,1,2,4,6,0,3,0,4,2,1,2,0,0,14
4096,776014,25,2,6,2,4,0,2,0,0,4,2,2,2,1,0,1,4
4096,797690,22,4,6,3,5,1,1,0,0,1,2,2,1,1,2,0,9
4096,791949,38,7,15,7,13,0,2,3,4,3,5,2,1,1,6,1,17
4096,784336,10,2,2,2,2,0,0,1,2,2,2,0,0,0,0,1,5
4096,797691,19,1,3,1,2,0,1,1,2,0,1,3,1,2,0,0,3
4096,785304,18,4,9,4,4,0,5,0,1,0,0,5,0,2,1,0,8
4096,797689,6,2,4,0,1,2,3,0,0,1,0,0,0,0,1,0,6
4097,780025,36,8,11,8,11,0,0,1,4,2,12,1,1,1,1,0,17
4097,796391,22,1,2,1,1,0,1,0,0,0,1,0,1,1,2,0,2
4097,785385,37,3,12,0,6,3,6,0,0,1,3,3,1,1,1,0,9
4097,785383,39,11,18,4,9,7,9,1,2,0,3,6,3,2,5,1,30
4097,785384,31,3,7,2,5,1,2,0,0,0,4,5,4,2,2,0,7
4097,781046,5,1,3,0,0,1,3,0,0,1,0,0,1,0,0,0,3
4097,790837,26,1,2,0,1,1,1,0,0,0,1,5,2,0,3,0,3
4097,786297,4,1,1,1,1,0,0,0,0,0,0,0,0,1,1,0,2
4098,791606,36,3,9,3,5,0,4,0,0,2,8,0,2,1,4,2,6
4098,786410,20,1,3,0,1,1,2,0,0,0,1,0,1,0,1,0,3
4098,775095,27,4,5,4,5,0,0,0,0,4,4,1,2,0,2,0,8
4098,786406,31,3,7,3,5,0,2,0,2,4,3,6,0,0,3,0,6
4098,780414,38,7,20,6,13,1,7,3,4,2,2,5,3,4,6,0,18
4098,797020,10,1,1,1,1,0,0,0,0,0,2,0,4,0,1,0,2
4098,797021,3,0,1,0,1,0,0,0,0,0,1,0,0,0,0,0,0
4098,791605,20,5,10,2,5,3,5,0,0,0,1,0,2,1,1,0,13
4098,791603,3,0,0,0,0,0,0,0,0,0,0,0,2,0,0,0,0
4098,791843,12,1,4,1,3,0,1,0,0,0,1,1,1,0,1,0,2
4099,792417,30,3,7,2,5,1,2,1,2,2,0,1,4,3,2,1,8
4099,786861,40,2,10,1,1,1,9,8,8,0,8,1,1,0,0,0,13
4099,786867,37,4,8,2,2,2,6,0,0,0,2,1,3,2,2,0,10
4099,780387,40,11,17,9,12,2,5,5,7,1,5,0,2,1,2,0,29
4099,767033,34,6,10,6,9,0,1,1,2,0,4,7,3,3,3,0,13
4099,796870,7,0,1,0,1,0,0,0,0,0,0,0,0,0,1,0,0
4099,792416,9,0,1,0,1,0,0,2,2,1,1,0,2,0,0,0,2
4099,786866,3,0,0,0,0,0,0,0,0,0,0,0,1,0,0,0,0
4100,780023,20,2,3,2,3,0,0,2,4,2,3,0,4,1,4,2,6
4100,792493,38,5,8,1,4,4,4,1,1,0,2,1,3,0,1,0,15
4100,792495,38,6,15,6,11,0,4,10,12,2,6,3,4,3,3,0,22
4100,792491,32,6,10,6,10,0,0,0,2,0,5,7,4,1,1,0,12
4100,781144,39,5,16,2,11,3,5,0,0,1,6,3,4,0,3,0,13
4100,798960,5,0,1,0,1,0,0,0,0,2,0,0,1,0,0,0,0
4100,793441,3,0,0,0,0,0,0,0,0,0,0,0,1,0,1,0,0
4100,792490,22,4,8,3,4,1,4,0,0,3,3,0,3,1,2,2,9
4100,788128,3,0,1,0,0,0,1,0,0,0,2,0,0,0,0,0,0
4101,775606,17,1,3,1,3,0,0,0,2,1,1,0,2,0,1,0,2
4101,791672,28,7,8,7,8,0,0,4,8,3,4,1,3,0,2,0,18
4101,780552,33,3,9,1,2,2,7,0,2,1,2,2,1,2,0,0,8
4101,780550,26,6,11,5,9,1,2,4,5,1,3,2,2,1,2,0,17
4101,780538,27,4,6,2,3,2,3,1,4,0,4,1,4,3,3,2,11
4101,797425,1,0,1,0,1,0,0,0,0,0,0,0,0,1,0,0,0
4101,797424,8,1,2,1,2,0,0,0,0,0,0,0,1,0,1,0,2
4101,785791,28,4,9,1,3,3,6,0,0,1,3,2,2,0,0,1,11
4101,785793,2,0,0,0,0,0,0,0,0,0,0,0,0,0,0,0,0
4101,791674,30,5,10,4,5,1,5,5,5,1,3,2,1,2,1,0,16
4102,780129,24,1,3,0,0,1,3,1,2,0,2,3,3,1,7,0,4
4102,781658,27,5,6,5,5,0,1,1,3,1,3,2,4,1,0,0,11
4102,781656,29,5,8,5,8,0,0,2,2,1,3,2,2,2,3,4,12
4102,786798,38,9,15,9,15,0,0,3,5,2,11,5,2,3,3,0,21
4102,796962,22,3,8,0,3,3,5,0,0,0,1,1,1,2,3,0,9
4102,798206,30,4,13,2,4,2,9,0,0,1,7,1,1,1,1,0,10
4102,790256,4,0,0,0,0,0,0,0,0,0,0,1,1,0,0,0,0
4102,791264,4,0,1,0,0,0,1,0,2,0,0,0,1,0,0,0,0
4102,796967,4,0,1,0,0,0,1,0,0,0,0,0,0,0,1,0,0
4102,791263,17,1,2,1,2,0,0,1,2,0,3,0,1,1,3,1,3
4102,796964,1,0,0,0,0,0,0,0,0,0,0,0,0,0,0,0,0
4103,791718,27,4,12,3,7,1,5,0,1,0,2,2,3,1,3,0,9
4103,791717,34,6,11,3,5,3,6,3,4,2,4,2,2,3,2,0,18
4103,798962,23,2,2,2,2,0,0,1,5,7,5,2,2,1,0,1,5
4103,781446,10,1,3,0,2,1,1,0,0,0,4,0,2,0,3,0,3
4103,798965,25,2,8,2,3,0,5,3,5,0,2,0,0,0,2,0,7
4103,798963,30,5,13,4,10,1,3,0,0,1,1,7,0,1,4,0,11
4103,798966,18,2,7,2,7,0,0,0,0,2,4,1,2,1,0,0,4
4103,798961,8,1,4,1,3,0,1,0,0,0,1,0,0,1,1,0,2
4103,798968,4,0,0,0,0,0,0,0,0,0,0,0,2,1,2,0,0
4103,791719,0,0,0,0,0,0,0,0,0,0,1,0,0,0,0,1,0
4103,791720,5,1,1,1,1,0,0,0,0,0,0,0,2,0,1,0,2
4103,787996,9,2,3,2,3,0,0,0,1,1,2,0,2,0,0,0,4
4103,768880,7,1,3,0,0,1,3,0,0,0,1,0,1,0,1,0,3
4104,776285,28,6,9,6,9,0,0,9,11,5,2,0,2,0,0,1,21
4104,791777,19,3,5,3,5,0,0,6,8,0,4,2,3,1,2,0,12
4104,781025,32,3,9,3,7,0,2,2,2,1,2,6,1,1,0,0,8
4104,786474,35,4,7,1,3,3,4,1,4,0,5,1,2,0,3,0,12
4104,780488,9,2,3,1,1,1,2,0,0,0,0,2,1,0,1,0,5
4104,791778,12,1,2,1,2,0,0,2,2,3,2,0,3,1,0,1,4
4104,786476,12,3,3,3,3,0,0,1,1,1,3,0,1,0,0,1,7
4104,791780,10,1,4,0,1,1,3,1,2,0,1,0,2,0,0,0,4
4104,791776,4,0,2,0,0,0,2,0,0,1,0,0,0,0,0,0,0
4104,791829,26,4,12,1,6,3,6,2,4,0,6,4,1,0,5,0,13
4104,775503,13,1,4,0,3,1,1,0,0,0,0,2,0,0,1,1,3
4105,788113,22,1,4,0,2,1,2,0,0,2,2,2,4,0,0,0,3
4105,786231,33,9,15,2,5,7,10,5,5,0,10,2,2,2,3,0,30
4105,785731,20,3,4,3,4,0,0,0,2,0,2,0,1,0,3,0,6
4105,785729,26,2,5,2,4,0,1,1,2,0,1,6,4,0,2,1,5
4105,780864,24,6,11,3,3,3,8,2,3,0,1,4,4,1,0,0,17
4105,799881,4,1,2,1,2,0,0,0,0,0,0,0,0,0,0,0,2
4105,792407,3,0,0,0,0,0,0,0,0,0,0,0,1,0,1,0,0
4105,792405,8,1,2,1,2,0,0,0,0,2,0,0,1,0,1,0,2
4105,776497,18,6,10,4,5,2,5,1,2,1,2,0,4,1,1,0,15
4105,797296,15,1,1,1,1,0,0,1,2,0,0,3,5,0,2,0,3
4105,792402,10,0,3,0,3,0,0,0,0,1,2,1,0,0,0,0,0
4105,796211,6,0,1,0,0,0,1,0,0,0,3,1,1,0,0,0,0
4105,785443,11,1,5,1,3,0,2,0,2,1,0,0,0,0,1,0,2
4106,792373,28,6,13,6,13,0,0,0,0,2,2,2,2,0,0,1,12
4106,792370,26,1,5,1,3,0,2,1,1,2,3,3,4,0,1,0,3
4106,797960,32,1,6,0,0,1,6,0,0,0,2,0,1,1,0,0,3
4106,786739,28,1,8,1,6,0,2,5,6,1,2,6,4,2,2,0,7
4106,775303,36,4,12,2,7,2,5,3,4,0,7,1,0,0,4,1,13
4106,797958,12,4,7,2,3,2,4,3,3,2,2,0,0,0,0,0,13
4106,781598,16,3,6,2,3,1,3,0,0,0,1,0,4,1,1,1,7
4106,797951,21,3,8,2,4,1,4,3,5,3,2,1,2,0,0,0,10
4106,781597,1,0,0,0,0,0,0,0,0,0,0,0,1,0,0,0,0
4107,790870,32,6,10,6,10,0,0,4,4,3,7,4,3,2,4,1,16
4107,790869,35,11,16,10,12,1,4,6,6,0,6,3,3,1,6,0,29
4107,780493,35,2,6,0,0,2,6,0,1,1,3,1,1,0,1,1,6
4107,780116,30,0,2,0,0,0,2,2,4,0,8,1,2,1,1,0,2
4107,790866,32,5,9,2,2,3,7,1,3,0,3,4,0,0,1,1,14
4107,796426,2,0,0,0,0,0,0,0,0,0,0,0,1,0,0,0,0
4107,796427,14,1,4,1,2,0,2,2,2,0,3,2,2,0,1,0,4
4107,796421,20,2,3,1,2,1,1,2,2,0,3,2,5,0,1,0,7
4108,790998,4,1,1,1,1,0,0,0,0,0,2,0,0,0,0,0,2
4108,796633,14,1,2,1,2,0,0,1,4,2,0,0,1,0,0,1,3
4108,790997,27,2,8,2,3,0,5,0,1,0,1,1,1,0,0,0,4
4108,790996,30,3,12,3,9,0,3,0,0,1,0,0,0,0,1,0,6
4108,785621,31,2,11,1,5,1,6,3,3,1,3,1,2,0,2,0,8
4108,796631,30,3,8,2,6,1,2,1,2,1,6,0,2,2,1,0,8
4108,790999,9,0,1,0,1,0,0,6,6,3,0,0,1,0,0,0,6
4108,790992,11,1,1,1,1,0,0,0,0,3,0,0,2,0,0,0,2
4108,796632,14,0,4,0,0,0,4,0,0,0,3,0,0,1,1,0,0
4108,790995,7,0,2,0,0,0,2,0,0,0,0,2,3,0,1,0,0
4108,786375,8,0,5,0,3,0,2,1,2,2,2,0,2,0,1,0,1
4108,781520,9,1,6,1,3,0,3,2,2,2,0,0,1,0,2,0,4
4108,785313,3,0,0,0,0,0,0,0,0,0,0,0,0,0,0,0,0
4108,790993,3,0,1,0,0,0,1,0,0,0,0,1,1,0,0,0,0
4109,792329,12,5,6,3,4,2,2,0,0,0,3,1,3,0,1,0,12
4109,786752,19,3,5,2,4,1,1,2,2,2,6,0,0,0,0,0,9
4109,781384,24,3,7,3,5,0,2,2,2,2,0,3,2,1,0,1,8
4109,781616,20,3,10,1,2,2,8,0,0,0,0,0,3,1,1,0,8
4109,776350,22,2,4,0,1,2,3,0,0,0,6,4,0,2,0,0,6
4109,797880,5,1,1,1,1,0,0,0,0,0,0,0,2,0,0,0,2
4109,792330,6,1,2,1,1,0,1,1,2,0,1,0,0,1,0,0,3
4109,785435,13,0,1,0,0,0,1,1,2,1,0,0,2,0,0,0,1
4109,781075,14,4,6,3,4,1,2,4,4,0,4,0,2,1,2,0,13
4109,781615,15,2,4,1,1,1,3,3,4,0,2,6,2,0,0,0,8
4109,792331,12,1,3,1,3,0,0,2,2,0,2,0,1,0,1,0,4
4109,792601,12,2,3,0,0,2,3,0,0,0,1,2,0,0,0,0,6
4109,786749,26,1,2,1,1,0,1,2,2,1,6,4,1,1,1,1,4
4110,780027,34,13,20,12,18,1,2,6,8,0,5,3,2,0,2,1,33
4110,786176,36,7,9,4,6,3,3,3,4,0,6,2,1,0,3,0,20
4110,786173,25,1,4,1,3,0,1,0,0,0,2,2,1,1,0,0,2
4110,780028,19,1,2,0,1,1,1,0,1,0,1,2,4,2,0,0,3
4110,774828,36,5,8,1,1,4,7,5,6,0,7,14,1,0,0,0,19
4110,797175,11,0,1,0,1,0,0,0,0,2,2,0,3,0,3,0,0
4110,791379,14,2,5,2,5,0,0,0,0,1,3,0,1,0,0,0,4
4110,780029,17,1,4,1,4,0,0,1,2,1,9,2,0,0,1,1,3
4110,791380,7,1,3,1,3,0,0,0,0,0,0,2,2,0,1,0,2
4110,797176,1,0,0,0,0,0,0,0,0,0,0,0,0,0,0,0,0
4111,776462,30,6,9,6,8,0,1,0,0,1,7,1,2,2,1,0,12
4111,785635,31,3,10,2,9,1,1,3,6,3,3,1,4,0,1,2,10
4111,786440,30,3,10,2,4,1,6,0,0,1,1,1,2,0,1,0,7
4111,786720,26,3,7,1,2,2,5,5,6,0,6,3,0,1,1,0,13
4111,781199,34,5,19,2,8,3,11,0,0,2,2,4,4,2,2,0,13
4111,791628,10,1,3,1,1,0,2,0,0,1,0,0,1,0,0,0,2
4111,775642,9,0,1,0,1,0,0,0,0,2,0,1,2,1,0,0,0
4111,791629,14,2,4,0,1,2,3,1,2,1,4,2,1,1,1,0,7
4111,796974,16,2,8,1,3,1,5,2,2,0,0,2,1,0,0,0,7
4112,780192,30,9,14,6,7,3,7,0,1,1,3,0,5,1,3,1,21
4112,786818,32,5,10,5,10,0,0,2,2,1,1,2,2,3,2,0,12
4112,780182,31,3,8,1,2,2,6,1,1,0,4,2,1,2,2,0,9
4112,798139,19,2,7,2,5,0,2,0,1,0,0,2,1,1,4,0,4
4112,796585,14,1,5,1,5,0,0,2,2,3,5,0,2,0,0,1,4
4112,786820,21,2,5,1,2,1,3,0,0,0,0,2,0,2,1,0,5
4112,780186,25,1,2,1,2,0,0,2,4,2,4,3,0,0,1,0,4
4112,780188,3,1,1,1,1,0,0,0,0,0,0,0,1,0,0,0,2
4112,780184,18,0,4,0,1,0,3,0,0,0,2,2,1,0,0,0,0
4112,798138,7,0,3,0,1,0,2,0,0,0,0,0,0,0,1,0,0
4112,796587,0,0,0,0,0,0,0,0,0,0,0,0,0,0,0,0,0
4113,781612,28,6,11,5,7,1,4,2,3,2,3,0,3,4,1,0,15
4113,781609,37,5,13,2,8,3,5,0,1,4,10,2,3,0,4,0,13
4113,786459,33,5,10,5,10,0,0,2,2,1,7,3,1,1,2,4,12
4113,797004,30,2,5,0,2,2,3,2,2,0,2,2,2,0,3,0,8
4113,797005,24,1,5,0,1,1,4,0,0,0,2,1,1,1,1,0,3
4113,791360,24,3,7,1,3,2,4,3,4,1,1,3,1,0,1,0,11
4113,797003,13,2,4,0,0,2,4,0,0,0,0,1,2,2,1,0,6
4113,797006,11,1,1,1,1,0,0,0,0,0,0,0,1,2,2,0,2
4114,781364,21,4,6,4,6,0,0,0,0,1,3,1,3,1,0,0,8
4114,791904,15,1,2,0,0,1,2,0,0,0,1,0,2,2,1,0,3
4114,781103,27,7,11,6,10,1,1,3,5,2,7,3,5,0,1,0,18
4114,797566,28,3,7,2,2,1,5,4,4,1,3,1,1,4,2,1,11
4114,797568,25,2,4,0,2,2,2,0,0,0,2,2,1,0,1,0,6
4114,791907,8,0,2,0,2,0,0,0,0,0,1,1,0,0,0,0,0
4114,791906,7,1,1,0,0,1,1,0,0,0,1,0,0,0,2,0,3
4114,781102,21,0,0,0,0,0,0,0,0,0,2,1,0,0,3,0,0
4114,781191,27,5,11,2,5,3,6,2,4,0,3,3,3,0,0,0,15
4114,791905,21,5,11,4,6,1,5,3,4,2,1,1,1,0,2,1,14
4115,780303,33,6,13,6,12,0,1,3,4,1,8,0,3,1,1,0,15
4115,791011,31,5,11,2,5,3,6,1,2,4,2,1,2,0,3,0,14
4115,781385,33,5,13,0,4,5,9,2,2,0,2,5,4,2,4,0,17
4115,791594,29,5,12,5,7,0,5,3,3,2,1,3,1,2,4,0,13
4115,791012,29,0,3,0,0,0,3,2,2,0,3,3,3,0,1,0,2
4115,791013,10,1,2,1,2,0,0,0,0,0,3,1,0,0,0,0,2
4115,796668,5,0,0,0,0,0,0,1,2,1,0,0,1,0,0,0,1
4115,785337,24,3,5,1,3,2,2,0,0,2,3,1,3,0,1,0,8
4115,796671,6,0,2,0,2,0,0,0,0,0,1,0,0,0,0,1,0
4116,786029,25,8,12,8,12,0,0,2,3,2,3,2,4,1,3,0,18
4116,792114,39,6,13,4,9,2,4,2,4,0,5,3,2,1,2,0,16
4116,781398,21,1,6,0,4,1,2,0,0,2,3,0,0,1,0,1,3
4116,786018,26,0,6,0,2,0,4,4,4,2,2,1,4,1,1,0,4
4116,775678,21,0,5,0,5,0,0,0,0,1,0,2,0,2,1,0,0
4116,786022,10,2,2,2,2,0,0,0,0,1,1,0,3,0,1,0,4
4116,797737,17,1,2,1,2,0,0,4,6,0,3,3,0,1,0,0,6
4116,797746,12,1,1,1,1,0,0,4,6,2,2,1,1,0,1,0,6
4116,797740,23,8,11,8,10,0,1,7,11,2,4,2,2,1,4,1,23
4116,792112,4,1,3,1,2,0,1,0,0,1,1,0,1,1,0,0,2
4116,797744,2,0,0,0,0,0,0,0,0,0,0,0,0,0,0,0,0
4117,796778,22,4,8,4,6,0,2,0,0,2,2,0,4,2,3,1,8
4117,791972,29,2,9,2,3,0,6,2,2,1,5,1,2,1,2,0,6
4117,791974,30,0,5,0,3,0,2,2,2,0,2,2,1,0,0,0,2
4117,785366,33,4,11,3,7,1,4,3,4,0,6,7,3,0,2,0,12
4117,780863,25,4,10,3,8,1,2,5,6,2,2,3,4,2,2,0,14
4117,781107,9,2,3,2,3,0,0,3,6,5,1,0,3,0,1,0,7
4117,796780,9,2,3,2,2,0,1,0,0,0,1,0,1,0,0,0,4
4117,780867,11,1,3,1,3,0,0,0,0,0,2,1,2,0,1,0,2
4117,791971,26,7,10,3,6,4,4,1,3,1,2,1,3,1,2,0,19
4117,796777,6,1,1,1,1,0,0,0,0,0,0,0,1,0,0,0,2
4118,780282,28,4,8,4,8,0,0,5,5,4,7,0,1,1,1,1,13
4118,785330,13,1,3,1,2,0,1,2,2,0,1,0,2,1,3,0,4
4118,780277,30,4,15,4,9,0,6,2,3,4,2,0,0,1,0,0,10
4118,791003,21,1,6,1,4,0,2,0,0,0,2,0,2,0,3,0,2
4118,791002,28,0,7,0,3,0,4,2,2,0,0,1,1,0,0,0,2
4118,785329,19,2,5,1,2,1,3,1,2,0,6,0,4,1,3,0,6
4118,796659,9,0,2,0,0,0,2,0,0,0,0,0,3,0,0,0,0
4118,796661,14,1,7,1,2,0,5,0,0,0,2,1,3,2,1,1,2
4118,780279,22,2,5,2,2,0,3,0,0,0,0,0,0,0,0,0,4
4118,796662,13,0,3,0,0,0,3,2,2,0,0,0,2,0,0,0,2
4118,792705,1,0,0,0,0,0,0,0,0,0,0,0,1,0,0,0,0
4118,792706,1,0,0,0,0,0,0,0,0,0,0,0,0,0,0,0,0
4118,792707,1,0,0,0,0,0,0,0,0,0,0,0,0,0,0,0,0
4119,791140,13,4,5,4,5,0,0,1,3,2,3,1,2,0,0,0,9
4119,791138,13,0,1,0,1,0,0,0,0,1,2,0,4,1,0,0,0
4119,786084,25,3,9,3,4,0,5,0,0,0,1,2,0,1,1,1,6
4119,780910,27,7,12,4,6,3,6,0,0,1,5,7,1,1,5,1,17
4119,780288,23,3,6,2,4,1,2,2,2,1,1,0,0,0,0,0,9
4119,796794,18,2,3,2,3,0,0,3,5,3,4,0,3,0,0,0,7
4119,796795,21,3,4,3,4,0,0,2,3,1,3,2,2,2,1,1,8
4119,780912,16,3,4,2,3,1,1,2,2,0,2,0,1,0,0,0,9
4119,780911,13,4,8,1,3,3,5,3,3,0,3,0,0,0,0,0,14
4119,781635,17,1,3,1,3,0,0,0,0,0,3,1,2,2,1,0,2
4119,796793,6,1,2,1,1,0,1,4,4,0,1,0,0,0,1,0,6
4119,786082,8,1,2,1,2,0,0,0,0,0,1,0,1,0,1,0,2
4120,791465,22,2,6,2,6,0,0,2,4,3,7,5,1,0,2,3,6
4120,791464,24,1,7,0,3,1,4,0,0,1,2,2,0,0,0,0,3
4120,780200,11,0,1,0,0,0,1,0,0,1,2,2,2,0,1,1,0
4120,786304,30,5,6,1,2,4,4,3,3,0,2,3,4,1,0,0,17
4120,780197,34,6,12,4,7,2,5,1,2,0,6,0,1,0,2,0,15
4120,798342,20,2,8,2,4,0,4,0,0,2,0,1,0,0,0,1,4
4120,786303,17,2,2,2,2,0,0,0,0,1,3,0,3,1,1,0,4
4120,780616,5,0,1,0,1,0,0,0,0,0,1,1,0,0,0,0,0
4120,780196,31,9,14,6,7,3,7,10,10,0,3,5,2,1,2,0,31
4120,798343,6,3,4,2,3,1,1,0,0,0,0,0,0,0,0,0,7
4121,791032,15,1,1,0,0,1,1,0,0,0,2,0,0,0,0,0,3
4121,780338,21,5,8,5,8,0,0,1,2,1,7,0,4,0,1,0,11
4121,791030,31,9,14,8,13,1,1,4,5,0,3,4,3,1,0,0,23
4121,785477,36,6,13,5,7,1,6,0,0,1,2,1,1,1,2,0,13
4121,785475,34,1,6,1,3,0,3,0,0,0,5,2,2,1,2,0,2
4121,791029,7,0,1,0,0,0,1,0,0,0,1,1,0,0,0,0,0
4121,796689,19,4,6,4,6,0,0,0,0,0,5,2,3,0,2,2,8
4121,796687,9,1,3,0,0,1,3,2,2,0,0,1,1,0,1,0,5
4121,786655,28,4,9,3,5,1,4,2,2,1,0,1,1,1,1,0,11
4122,791391,9,0,2,0,2,0,0,0,0,1,3,0,5,0,2,0,0
4122,797156,17,1,2,1,2,0,0,3,4,1,1,1,1,1,0,0,5
4122,791390,35,0,5,0,3,0,2,4,4,2,6,5,3,2,2,3,4
4122,780133,35,4,10,2,5,2,5,2,4,0,3,0,0,2,2,2,12
4122,780130,37,8,12,5,7,3,5,12,14,2,8,2,3,1,2,0,31
4122,791388,24,5,9,4,6,1,3,2,3,0,4,0,3,0,0,0,13
4122,775743,21,0,4,0,3,0,1,1,2,0,0,0,1,0,2,0,1
4122,776446,18,4,6,2,4,2,2,0,0,0,0,3,1,0,1,0,10
4122,797158,4,0,0,0,0,0,0,0,0,0,0,0,0,0,0,0,0
4123,775897,20,0,0,0,0,0,0,1,2,0,1,0,1,1,1,0,1
4123,780324,22,5,12,5,12,0,0,1,2,1,5,0,3,0,2,2,11
4123,786530,35,2,12,0,2,2,10,0,0,1,3,9,2,0,5,0,6
4123,784246,30,1,4,0,2,1,2,1,2,2,4,0,4,1,1,0,4
4123,780317,34,2,7,0,1,2,6,4,4,2,4,4,2,1,2,0,10
4123,791546,17,7,8,6,7,1,1,3,4,2,1,0,5,0,0,0,18
4123,791543,17,2,6,2,4,0,2,2,2,0,0,2,5,2,2,0,6
4123,791545,14,4,4,3,3,1,1,0,0,0,1,1,2,0,0,0,9
4123,786360,11,2,5,0,0,2,5,0,0,0,3,1,0,0,2,0,6
4123,797092,0,0,0,0,0,0,0,0,0,0,0,0,0,0,0,0,0
4124,791281,31,5,9,4,8,1,1,0,2,2,5,6,1,1,0,1,11
4124,785764,16,0,0,0,0,0,0,5,6,2,0,1,2,0,0,0,5
4124,796535,9,0,5,0,2,0,3,0,0,2,2,0,0,0,1,0,0
4124,792276,27,4,7,3,5,1,2,0,0,0,2,3,0,1,1,0,9
4124,791278,12,0,2,0,0,0,2,0,0,1,0,0,1,1,1,1,0
4124,796534,5,0,0,0,0,0,0,0,0,2,1,0,1,0,1,0,0
4124,796536,14,1,2,1,2,0,0,0,0,1,4,1,2,0,0,1,2
4124,785763,3,0,1,0,1,0,0,0,0,0,0,0,1,0,1,0,0
4124,796537,5,0,3,0,2,0,1,0,0,0,0,1,2,0,0,0,0
4124,786026,23,8,12,3,6,5,6,1,3,1,2,1,1,0,3,0,22
4124,785507,15,2,5,0,0,2,5,0,2,0,2,0,1,0,0,0,6
4124,785398,23,6,11,5,8,1,3,3,6,3,6,1,0,2,0,2,16
4124,781536,4,1,1,0,0,1,1,0,0,0,0,0,0,0,0,0,3
4124,775814,13,2,8,0,3,2,5,0,1,1,0,0,0,0,1,0,6
4125,797343,19,1,5,1,4,0,1,5,6,4,6,0,2,0,0,1,7
4125,791743,25,7,11,7,11,0,0,0,0,1,3,0,3,0,2,0,14
4125,797340,29,3,9,0,3,3,6,0,0,0,3,0,4,1,4,1,9
4125,791747,38,8,17,4,8,4,9,4,4,1,7,2,1,0,1,0,24
4125,791746,31,1,5,1,4,0,1,0,0,1,3,3,2,3,3,2,2
4125,797342,10,0,1,0,0,0,1,0,0,0,1,1,1,0,1,0,0
4125,791744,4,2,2,2,2,0,0,1,2,2,0,0,0,1,0,0,5
4125,797341,14,1,6,1,4,0,2,0,0,0,1,0,1,1,1,0,2
4125,786193,23,1,3,1,2,0,1,0,0,1,3,1,0,0,0,0,2
4125,780711,7,0,3,0,1,0,2,0,0,0,1,1,1,0,0,0,0
4132,791194,34,2,5,0,2,2,3,0,0,0,7,1,3,0,5,0,6
4132,780384,16,3,5,3,5,0,0,1,2,1,0,0,5,0,1,1,7
4132,780159,29,4,8,3,6,1,2,1,2,1,2,1,2,0,2,0,10
4132,786738,25,4,11,4,8,0,3,0,0,2,5,1,2,2,6,1,8
4132,774827,35,4,12,3,9,1,3,0,0,2,2,3,1,0,5,0,9
4132,791193,24,3,4,3,4,0,0,2,4,4,3,0,3,0,2,0,8
4132,796863,17,0,2,0,0,0,2,0,0,0,4,4,1,1,1,0,0
4132,775694,12,2,3,1,1,1,2,0,0,0,1,1,1,0,1,0,5
4132,796865,8,0,0,0,0,0,0,0,0,0,1,0,1,0,1,0,0
4133,796812,10,0,0,0,0,0,0,0,0,0,0,0,3,0,0,2,0
4133,780952,32,4,10,4,9,0,1,0,0,2,3,0,2,2,4,2,8
4133,786609,37,7,14,7,12,0,2,4,8,2,2,1,3,5,3,1,18
4133,785752,29,1,6,1,3,0,3,2,4,1,4,3,0,2,1,0,4
4133,796810,35,3,9,1,5,2,4,4,6,1,2,4,1,4,1,0,12
4133,780945,15,1,3,1,3,0,0,1,2,3,1,1,3,1,2,1,3
4133,780950,28,4,9,1,1,3,8,1,2,1,3,0,0,0,1,0,12
4133,791156,11,1,1,1,1,0,0,1,2,0,1,1,1,2,2,0,3
4133,791154,3,0,0,0,0,0,0,0,0,0,0,0,0,0,0,0,0
4134,791391,32,1,3,1,2,0,1,1,5,3,4,0,2,1,2,2,3
4134,797156,18,2,5,1,4,1,1,0,1,2,0,0,2,1,0,0,5
4134,791390,31,4,12,3,9,1,3,2,3,2,4,2,4,1,4,0,11
4134,780133,30,2,8,0,4,2,4,2,2,0,5,0,0,0,1,0,8
4134,780130,33,2,7,1,4,1,3,2,2,2,4,4,1,0,1,0,7
4134,791388,12,0,0,0,0,0,0,2,4,1,0,0,2,1,0,0,2
4134,775743,23,3,6,1,4,2,2,0,0,0,3,0,3,2,2,0,8
4134,776446,21,2,4,2,4,0,0,0,0,0,1,0,1,0,0,0,4
4135,775897,17,3,4,2,3,1,1,2,2,0,3,1,4,1,1,0,9
4135,780324,33,7,11,7,11,0,0,2,4,2,6,2,2,1,3,1,16
4135,786530,29,1,6,0,3,1,3,0,0,0,3,3,2,0,1,0,3
4135,784246,24,2,6,0,0,2,6,0,0,0,5,0,2,0,0,0,6
4135,780317,33,2,7,2,4,0,3,4,4,1,3,3,2,1,1,1,8
4135,791546,12,2,3,2,3,0,0,0,1,1,0,0,1,0,2,0,4
4135,791543,27,2,6,0,1,2,5,2,4,1,1,1,1,0,0,0,8
4135,797091,8,0,0,0,0,0,0,2,2,0,1,0,1,1,1,0,2
4135,791545,17,1,4,1,1,0,3,0,0,0,1,1,2,1,1,0,2
4136,781081,12,2,4,2,3,0,1,0,0,1,1,3,5,0,1,2,4
4136,791864,35,9,11,6,6,3,5,0,1,0,6,1,4,1,5,1,21
4136,791863,23,2,3,2,3,0,0,5,6,1,4,3,2,2,0,0,9
4136,797472,32,3,10,2,6,1,4,1,1,1,2,3,3,1,2,0,8
4136,780965,38,4,15,1,6,3,9,4,4,2,3,9,3,3,5,0,15
4136,797473,17,1,1,1,1,0,0,0,0,2,2,1,5,0,1,0,2
4136,797470,27,4,10,1,3,3,7,3,4,1,4,1,3,1,1,0,14
4136,776447,2,0,0,0,0,0,0,0,0,0,0,1,0,0,1,0,0
4136,786791,13,0,1,0,1,0,0,0,0,0,1,0,3,2,0,1,0
4136,786307,1,0,0,0,0,0,0,0,0,0,0,0,0,0,0,0,0
4137,799000,22,2,6,2,6,0,0,1,4,0,2,0,4,1,1,0,5
4137,785471,26,3,5,3,4,0,1,1,4,2,2,0,1,1,0,1,7
4137,780263,34,5,9,2,4,3,5,2,4,1,8,2,2,0,5,0,15
4137,780571,23,2,7,1,4,1,3,0,0,1,1,2,1,2,0,0,5
4137,775628,23,4,6,4,5,0,1,5,6,0,1,3,2,2,4,1,13
4137,792399,17,2,5,2,5,0,0,2,2,1,0,1,0,1,0,0,6
4137,775198,23,1,5,1,5,0,0,3,8,3,2,2,1,2,2,0,5
4137,792397,3,0,0,0,0,0,0,0,0,0,2,0,0,0,1,0,0
4137,786697,18,0,0,0,0,0,0,2,4,0,4,2,2,1,6,1,2
4137,775547,11,2,3,2,2,0,1,5,6,1,1,1,3,0,2,1,9
4142,786041,28,6,14,6,9,0,5,6,8,3,8,0,0,0,0,0,18
4142,780881,25,4,8,1,3,3,5,1,2,0,3,5,4,0,2,0,12
4142,780275,13,1,3,1,3,0,0,1,2,2,2,0,5,1,0,2,3
4142,792075,37,6,11,2,5,4,6,0,0,1,6,0,4,0,1,0,16
4142,786686,36,6,13,5,9,1,4,7,8,1,3,8,0,2,0,0,20
4142,785437,13,0,3,0,2,0,1,1,2,2,3,0,5,0,1,1,1
4142,780052,23,1,4,0,1,1,3,0,0,0,1,0,0,0,1,0,3
4142,792074,18,2,4,0,0,2,4,0,0,1,0,0,1,0,1,0,6
4142,786051,7,0,1,0,1,0,0,0,0,3,2,1,2,0,0,0,0
4143,785930,17,2,4,2,4,0,0,2,4,2,4,0,3,0,1,0,6
4143,780996,27,3,6,2,4,1,2,0,0,1,4,1,5,1,1,0,7
4143,780995,29,3,9,2,3,1,6,2,3,1,7,2,2,1,2,1,9
4143,796468,23,2,4,2,3,0,1,0,0,0,1,4,3,0,1,0,4
4143,790920,35,4,17,4,15,0,2,9,11,1,2,5,4,0,2,0,17
4143,775709,33,5,8,0,1,5,7,2,2,0,1,0,0,1,1,0,17
4143,796466,3,0,0,0,0,0,0,0,0,0,0,0,0,0,0,0,0
4143,796467,24,2,6,1,2,1,4,0,0,1,0,2,1,1,0,0,5
4143,785492,7,1,1,1,1,0,0,1,2,1,0,0,0,0,0,0,3
4143,785461,2,0,1,0,1,0,0,0,2,0,0,0,1,0,0,0,0
4144,792351,26,3,3,3,3,0,0,0,0,1,1,0,2,0,0,1,6
4144,786724,24,1,7,1,4,0,3,0,0,1,8,0,3,1,2,0,2
4144,786723,35,9,16,9,15,0,1,1,5,0,5,4,2,1,3,0,19
4144,798060,15,1,2,0,1,1,1,0,0,0,0,1,2,0,3,0,3
4144,792352,22,0,3,0,1,0,2,0,2,0,2,4,4,2,0,0,0
4144,792349,23,4,6,4,6,0,0,0,2,2,7,1,3,0,0,2,8
4144,798061,22,3,9,2,3,1,6,1,1,0,1,1,2,1,0,1,8
4144,792355,30,5,11,3,6,2,5,0,1,0,2,1,3,0,1,0,12
4144,792348,3,0,1,0,0,0,1,0,0,0,0,1,0,0,0,0,0
4145,780919,33,2,6,2,6,0,0,6,7,3,3,1,2,1,1,0,10
4145,775816,26,2,4,2,3,0,1,0,0,0,7,1,0,0,1,0,4
4145,785803,30,1,6,1,4,0,2,3,4,0,3,1,2,0,1,2,5
4145,780920,34,2,8,1,4,1,4,4,7,0,1,4,1,0,2,0,9
4145,780914,29,6,15,5,10,1,5,2,2,4,11,2,4,0,2,0,15
4145,796797,16,5,8,3,6,2,2,3,4,4,6,0,3,1,1,1,15
4145,791142,22,2,6,1,3,1,3,0,0,1,1,1,1,0,0,1,5
4145,791141,3,0,1,0,1,0,0,0,0,0,1,1,0,0,1,0,0
4145,796799,2,1,2,1,2,0,0,0,0,1,1,0,0,0,0,0,2
4145,796801,5,0,4,0,2,0,2,0,0,0,0,0,1,0,0,0,0
4146,791904,10,1,5,1,3,0,2,0,0,3,3,1,1,0,0,0,2
4146,781103,30,1,3,1,2,0,1,7,11,3,8,6,2,1,2,2,9
4146,781364,11,1,1,1,1,0,0,0,0,0,1,0,1,1,3,0,2
4146,797568,30,5,8,2,2,3,6,4,5,1,3,1,3,1,4,0,17
4146,797566,30,3,6,0,1,3,5,0,0,0,2,1,1,1,1,0,9
4146,791907,10,0,0,0,0,0,0,1,2,0,0,5,0,0,1,0,1
4146,791905,23,3,9,1,3,2,6,0,1,1,3,0,3,0,0,0,8
4146,791906,5,1,4,1,2,0,2,0,0,1,1,0,0,0,0,0,2
4146,781191,32,5,12,2,4,3,8,2,2,0,5,1,4,0,1,0,15
4146,781102,19,3,4,2,2,1,2,1,2,1,4,0,2,0,3,0,8
4147,791011,27,4,7,1,2,3,5,2,2,1,3,2,2,0,0,0,13
4147,780303,33,8,13,8,12,0,1,0,2,2,6,2,3,1,1,0,16
4147,791594,25,3,5,2,3,1,2,0,1,0,2,4,1,1,1,0,7
4147,791012,21,1,2,0,0,1,2,0,0,0,1,1,0,0,2,0,3
4147,781385,26,2,8,0,4,2,4,4,4,1,1,3,3,2,2,0,10
4147,796671,9,1,1,1,1,0,0,0,1,0,3,0,4,0,0,0,2
4147,785337,25,8,15,8,12,0,3,0,1,0,1,1,1,0,1,0,16
4147,796668,6,1,2,0,0,1,2,0,0,0,0,0,1,0,0,0,3
4147,791013,14,1,1,1,1,0,0,3,4,0,2,2,1,2,2,0,5
4147,786349,14,0,3,0,0,0,3,0,0,0,1,1,4,2,0,1,0
4148,797698,19,1,7,0,4,1,3,0,0,1,2,0,3,0,0,1,3
4148,780844,34,1,6,0,1,1,5,2,2,0,3,1,1,0,0,0,5
4148,797699,36,5,10,4,8,1,2,5,7,0,5,3,1,0,1,1,16
4148,791956,29,3,6,2,5,1,1,0,0,0,4,2,2,1,0,0,7
4148,780846,36,5,13,5,11,0,2,0,0,1,3,1,4,1,4,0,10
4148,797694,19,0,1,0,0,0,1,0,0,0,1,1,1,1,0,1,0
4148,797692,16,3,5,1,1,2,4,2,2,0,0,0,1,0,0,0,10
4148,791954,11,3,6,3,5,0,1,3,4,0,2,1,2,0,2,0,9
4149,781174,25,5,8,5,8,0,0,2,2,8,6,3,2,0,1,0,12
4149,781159,34,8,12,8,10,0,2,5,9,1,2,4,1,0,1,5,21
4149,791001,26,4,5,3,4,1,1,0,0,0,3,2,4,1,1,0,9
4149,781215,36,3,11,2,8,1,3,0,1,2,4,1,3,0,1,0,7
4149,775255,25,2,10,2,6,0,4,0,0,2,4,1,2,0,1,0,4
4149,796643,3,0,0,0,0,0,0,0,0,0,0,0,1,0,0,0,0
4149,785320,25,4,7,3,3,1,4,0,0,0,8,0,1,0,1,0,9
4149,785231,25,8,13,4,6,4,7,1,1,1,3,2,3,1,2,0,21
4149,796644,1,0,0,0,0,0,0,0,0,0,0,0,0,0,0,0,0
4156,775455,25,3,8,3,8,0,0,2,3,0,9,0,2,0,2,2,8
4156,792124,15,4,6,4,6,0,0,0,1,3,3,0,3,0,4,0,8
4156,786002,10,0,1,0,1,0,0,0,0,0,0,2,1,0,1,0,0
4156,786005,13,1,2,1,1,0,1,0,0,0,0,0,0,0,0,0,2
4156,781397,18,0,5,0,5,0,0,0,0,2,1,1,1,0,0,0,0
4156,797754,8,2,2,2,2,0,0,2,2,1,0,0,0,0,0,0,6
4156,786003,29,7,10,4,4,3,6,1,1,0,3,2,0,0,2,0,18
4156,797749,22,2,6,1,2,1,4,1,2,0,4,1,3,1,2,1,6
4156,792120,24,3,5,1,3,2,2,1,2,0,6,0,1,0,3,0,9
4156,792123,33,4,13,2,8,2,5,2,3,0,2,5,2,1,1,0,12
4156,792119,3,0,0,0,0,0,0,0,0,0,0,0,0,0,0,0,0
4157,785495,32,10,17,8,12,2,5,3,5,3,11,3,4,1,1,0,25
4157,785958,30,6,12,6,11,0,1,2,4,2,7,1,3,1,2,0,14
4157,775377,16,1,1,1,1,0,0,0,0,1,1,0,0,1,0,1,2
4157,785494,28,5,10,3,8,2,2,2,2,3,0,1,2,0,1,0,14
4157,780698,36,5,15,1,8,4,7,0,0,0,7,3,3,1,2,2,14
4157,785490,5,0,0,0,0,0,0,0,0,0,2,0,0,1,0,0,0
4157,785659,12,1,1,1,1,0,0,2,2,0,0,0,1,1,1,0,4
4157,791130,25,2,10,0,4,2,6,0,0,1,1,4,2,0,0,0,6
4157,780427,13,3,5,3,4,0,1,0,0,0,1,0,1,1,1,0,6
4157,791033,1,0,0,0,0,0,0,0,0,0,1,0,0,0,0,0,0
4157,796704,1,0,0,0,0,0,0,0,0,0,0,0,0,0,0,0,0
4157,785486,1,0,0,0,0,0,0,0,0,0,0,0,0,0,0,0,0
4158,796761,25,4,6,4,6,0,0,9,9,5,6,1,5,0,3,1,17
4158,796758,35,6,16,6,16,0,0,2,4,1,2,0,1,1,2,0,14
4158,791101,34,6,11,5,9,1,2,7,11,2,3,3,2,5,3,0,20
4158,791105,35,2,5,2,5,0,0,7,8,3,4,5,2,1,4,0,11
4158,780794,28,4,7,1,2,3,5,1,2,0,1,0,4,0,2,1,12
4158,791103,6,0,1,0,0,0,1,0,0,0,0,0,3,0,1,0,0
4158,780109,14,1,2,1,2,0,0,3,6,1,1,0,2,1,0,0,5
4158,796757,18,3,9,3,7,0,2,0,1,1,2,2,2,2,2,1,6
4158,785597,5,0,1,0,0,0,1,0,0,0,0,1,2,0,0,0,0
4159,781558,21,4,6,4,6,0,0,2,3,1,3,1,5,1,2,0,10
4159,780993,17,4,8,4,7,0,1,1,2,2,4,0,5,2,3,0,9
4159,775248,35,7,14,5,7,2,7,12,16,6,5,4,3,0,3,3,28
4159,791452,32,4,7,1,2,3,5,0,0,0,2,3,3,1,1,0,11
4159,797224,35,6,13,4,7,2,6,4,4,2,5,2,1,1,3,0,18
4159,797225,24,3,6,3,6,0,0,8,9,0,2,4,4,3,2,0,14
4159,797230,11,2,4,2,4,0,0,0,0,0,1,0,1,0,1,0,4
4159,797231,2,0,1,0,0,0,1,0,0,1,0,0,2,1,0,0,0
4159,791449,22,0,2,0,1,0,1,0,0,0,0,3,3,1,0,0,0
4159,797226,1,0,0,0,0,0,0,0,0,0,0,0,1,0,0,0,0
4160,792634,37,7,15,3,6,4,9,4,4,1,6,1,3,0,3,0,22
4160,799129,35,5,14,3,6,2,8,0,0,0,2,1,1,2,1,2,12
4160,799134,29,3,9,1,5,2,4,0,0,0,6,4,3,1,1,1,8
4160,799135,13,0,1,0,1,0,0,0,0,2,4,0,0,0,0,1,0
4160,799133,28,1,9,1,4,0,5,1,4,2,0,1,3,1,2,1,3
4160,799136,25,1,1,1,1,0,0,0,0,0,0,0,1,0,2,0,2
4160,799128,16,0,2,0,0,0,2,0,0,0,3,2,0,0,0,0,0
4160,800005,17,1,3,1,3,0,0,2,2,0,1,1,5,0,1,0,4
4161,775329,28,6,10,1,4,5,6,2,2,0,4,1,1,0,1,0,19
4161,786717,39,4,7,4,6,0,1,3,3,1,10,2,1,1,1,0,11
4161,792318,27,4,8,4,8,0,0,0,2,1,8,0,3,0,4,0,8
4161,780753,25,2,5,2,4,0,1,0,0,1,0,3,3,0,1,0,4
4161,796519,24,1,4,0,2,1,2,0,0,1,5,1,1,0,2,0,3
4161,796520,18,3,8,1,3,2,5,1,2,0,0,2,0,0,1,0,9
4161,796518,15,3,5,1,2,2,3,0,0,1,0,2,3,0,1,0,8
4161,796517,23,0,3,0,1,0,2,2,2,0,2,2,1,1,2,0,2
4161,792308,1,0,1,0,1,0,0,0,0,0,0,0,0,0,0,0,0
4162,781342,35,7,15,7,13,0,2,3,4,1,6,1,1,1,0,1,17
4162,781593,30,4,5,3,4,1,1,0,3,0,5,3,3,0,2,0,9
4162,790901,26,2,7,1,5,1,2,2,2,0,2,2,2,0,0,1,7
4162,785452,33,7,12,7,12,0,0,4,7,4,8,5,3,0,3,1,18
4162,781620,19,1,2,1,1,0,1,0,0,0,1,1,3,0,1,2,2
4162,790902,24,2,4,1,2,1,2,0,0,0,1,3,1,1,1,0,5
4162,790903,20,4,9,1,4,3,5,3,3,0,1,1,2,1,2,0,14
4162,796450,11,1,1,1,1,0,0,0,0,0,3,0,1,0,1,0,2
4162,796452,2,0,1,0,0,0,1,0,0,0,0,0,0,0,0,0,0
4163,796321,27,2,4,2,2,0,2,0,0,0,3,0,3,0,1,0,4
4163,790764,38,8,16,4,8,4,8,0,2,0,11,0,3,1,2,2,20
4163,796319,35,5,13,3,5,2,8,2,2,1,2,2,2,1,2,0,14
4163,796320,34,6,14,4,7,2,7,8,8,1,1,1,4,0,3,0,22
4163,779993,32,0,5,0,3,0,2,1,2,1,2,6,4,4,3,0,1
4163,790761,15,2,6,2,4,0,2,0,1,3,2,0,2,0,0,0,4
4163,796322,2,0,1,0,1,0,0,0,0,0,0,0,0,0,0,0,0
4163,796318,4,1,1,1,1,0,0,0,0,0,0,1,1,0,0,0,2
4163,785219,13,0,0,0,0,0,0,0,0,0,2,1,1,0,0,3,0
4163,779990,0,0,0,0,0,0,0,0,0,0,0,0,0,0,0,0,0
4164,797972,26,4,4,4,4,0,0,0,1,2,1,3,2,0,0,1,8
4164,797967,27,5,11,5,11,0,0,0,2,4,3,3,0,0,2,0,10
4164,797970,29,6,9,4,5,2,4,0,0,1,5,4,3,0,0,0,14
4164,781453,31,6,13,1,4,5,9,0,0,0,0,5,3,1,3,0,17
4164,774869,34,6,12,1,2,5,10,2,2,2,4,3,1,1,2,1,19
4164,792254,21,3,8,3,6,0,2,0,0,2,4,4,2,1,2,0,6
4164,792256,2,0,1,0,1,0,0,0,0,0,1,0,0,0,0,0,0
4164,797962,6,1,1,1,1,0,0,0,0,0,2,0,1,0,0,1,2
4164,786098,22,7,9,2,3,5,6,1,1,2,3,4,3,1,1,0,20
4164,786106,2,0,1,0,0,0,1,0,0,0,1,0,0,0,0,0,0
4165,776209,32,5,12,5,11,0,1,0,0,3,1,4,2,1,2,0,10
4165,796938,33,4,11,2,5,2,6,2,4,0,1,3,0,1,1,1,12
4165,791237,25,2,6,2,4,0,2,3,3,0,1,1,3,1,2,0,7
4165,791351,13,3,5,0,1,3,4,0,0,0,3,1,0,1,1,0,9
4165,791238,26,3,4,2,3,1,1,0,2,2,3,1,3,0,1,0,7
4165,781227,15,1,2,1,2,0,0,0,0,0,1,0,2,0,0,0,2
4165,796939,2,0,1,0,0,0,1,0,0,0,0,0,0,1,0,0,0
4165,791235,20,3,9,3,8,0,1,2,2,0,3,1,1,0,1,0,8
4165,791236,13,1,6,0,3,1,3,3,4,2,1,1,0,0,0,0,6
4165,791240,21,1,2,1,2,0,0,0,0,0,2,2,0,1,2,0,2
4166,792197,32,7,11,1,1,6,10,0,0,0,0,3,0,2,1,0,20
4166,781132,35,6,12,4,5,2,7,1,1,0,8,7,2,0,5,0,15
4166,797517,23,3,4,3,4,0,0,2,2,1,2,0,3,1,2,1,8
4166,791940,30,4,7,3,5,1,2,0,0,0,0,0,2,0,2,0,9
4166,786534,32,5,7,5,6,0,1,0,0,0,6,8,2,1,2,1,10
4166,797521,5,1,3,1,3,0,0,0,0,0,0,0,2,0,2,0,2
4166,797522,4,1,1,1,1,0,0,0,0,1,0,0,0,0,0,0,2
4166,786539,2,1,1,0,0,1,1,0,0,0,0,0,0,0,0,0,3
4166,797518,20,3,7,2,5,1,2,2,2,1,6,4,0,1,0,0,9
4166,791938,17,0,1,0,1,0,0,0,0,0,3,1,1,0,0,0,0
4167,791619,8,1,1,1,1,0,0,0,0,0,2,0,0,0,0,0,2
4167,781125,13,1,2,1,2,0,0,0,0,0,0,1,3,0,4,0,2
4167,780440,30,4,8,2,4,2,4,6,6,1,4,0,0,0,1,0,16
4167,791621,27,4,13,0,4,4,9,0,0,0,3,1,1,1,3,0,12
4167,786431,34,6,11,4,5,2,6,1,4,0,4,5,2,2,0,0,15
4167,786434,19,3,6,3,6,0,0,0,0,2,2,2,2,0,1,2,6
4167,775620,5,0,1,0,1,0,0,0,0,1,0,0,0,1,0,0,0
4167,786432,24,2,4,2,2,0,2,0,0,2,0,1,0,0,1,0,4
4167,781088,31,2,8,2,7,0,1,0,0,2,2,6,0,1,2,0,4
4167,775622,9,0,3,0,2,0,1,0,0,0,1,0,0,0,0,0,0
4168,796347,23,5,8,2,3,3,5,2,4,2,7,2,2,0,4,1,15
4168,785243,29,4,7,3,6,1,1,3,5,3,3,2,4,0,3,1,12
4168,790788,35,4,9,1,3,3,6,3,4,2,5,4,1,0,1,0,14
4168,781028,38,8,14,4,6,4,8,1,3,1,6,2,2,0,2,1,21
4168,781026,21,2,7,1,2,1,5,0,0,0,4,4,2,0,1,0,5
4168,790787,4,0,0,0,0,0,0,0,0,1,0,0,1,0,0,0,0
4168,785242,13,1,1,1,1,0,0,0,0,0,2,2,3,2,4,0,2
4168,781027,10,0,2,0,1,0,1,0,0,1,0,1,0,0,1,0,0
4168,796346,0,0,0,0,0,0,0,0,0,0,0,0,1,0,0,0,0
4168,796348,7,0,0,0,0,0,0,0,0,0,2,1,1,0,4,0,0
4168,796349,20,4,6,2,3,2,3,1,2,1,1,1,0,2,0,0,11
4169,797715,36,4,11,3,8,1,3,3,4,2,5,6,2,2,3,0,12
4169,780937,30,6,14,3,4,3,10,4,4,1,2,1,4,1,0,0,19
4169,791149,34,7,13,3,6,4,7,1,1,0,5,2,3,1,1,0,19
4169,791950,29,0,4,0,1,0,3,1,2,0,2,0,2,0,3,0,1
4169,792113,32,4,12,3,6,1,6,2,2,2,1,0,3,3,2,0,11
4169,797716,10,0,0,0,0,0,0,0,0,1,0,1,2,0,0,1,0
4169,797717,11,1,3,1,2,0,1,2,3,0,2,0,2,0,1,0,4
4169,792115,10,0,2,0,1,0,1,0,0,0,1,0,0,2,0,0,0
4169,780779,8,0,1,0,0,0,1,0,0,0,1,0,1,0,1,0,0
4170,785432,20,3,8,2,6,1,2,2,2,4,3,1,3,0,1,2,9
4170,790882,30,4,8,4,7,0,1,2,2,1,5,1,1,2,1,0,10
4170,790876,35,9,16,5,9,4,7,0,0,1,5,4,2,0,0,0,22
4170,785699,18,2,6,0,2,2,4,0,0,1,3,2,2,1,0,0,6
4170,774987,35,4,9,3,6,1,3,2,2,0,3,6,1,0,2,0,11
4170,790879,18,4,5,4,5,0,0,0,0,1,3,3,3,0,0,1,8
4170,796434,9,1,3,0,0,1,3,0,0,0,2,0,0,1,1,0,3
4170,781062,22,4,10,1,4,3,6,0,0,0,2,3,3,3,0,0,11
4170,790874,1,1,2,1,2,0,0,0,0,1,0,0,0,0,0,0,2
4170,790881,2,0,0,0,0,0,0,0,0,0,1,0,0,0,0,1,0
4170,796435,1,0,0,0,0,0,0,0,0,0,0,0,0,0,0,0,0
4170,790875,2,0,1,0,0,0,1,0,0,0,0,0,0,0,0,0,0
4170,779987,2,0,0,0,0,0,0,0,0,0,0,0,0,0,0,0,0
4170,790878,5,0,1,0,1,0,0,0,0,0,2,0,1,1,0,1,0
4171,785638,23,2,5,1,1,1,4,0,2,2,2,0,1,0,1,0,5
4171,781326,23,4,7,4,7,0,0,0,4,5,2,0,2,0,0,0,8
4171,797870,36,3,7,2,5,1,2,1,3,0,9,1,2,0,0,0,8
4171,792210,19,0,5,0,3,0,2,2,2,1,3,1,0,1,3,1,2
4171,781323,35,4,14,3,10,1,4,1,2,0,5,2,1,0,5,0,10
4171,792213,13,1,2,0,0,1,2,0,0,0,1,0,0,0,1,0,3
4171,785430,18,3,5,3,5,0,0,1,2,0,1,0,1,0,2,0,7
4171,780874,13,1,4,1,1,0,3,0,0,1,0,1,0,1,1,2,2
4171,797869,3,0,0,0,0,0,0,1,2,0,0,0,1,1,1,0,1
4171,792215,16,0,2,0,0,0,2,0,0,0,0,2,1,0,2,0,0
4171,797868,1,0,1,0,1,0,0,0,0,0,0,0,0,0,0,1,0
4171,786688,0,0,0,0,0,0,0,0,0,0,1,0,0,0,0,0,0
4171,786687,0,0,0,0,0,0,0,0,0,0,0,0,0,0,0,0,0
4172,796637,14,2,2,2,2,0,0,2,3,1,2,1,2,0,2,0,6
4172,792627,21,3,6,2,4,1,2,2,2,0,2,0,1,0,0,1,9
4172,792626,33,1,5,1,4,0,1,2,4,1,2,11,3,0,6,0,4
4172,781491,18,2,3,1,2,1,1,3,5,0,3,1,2,0,2,0,8
4172,780250,37,7,12,5,7,2,5,8,9,0,4,2,1,3,3,1,24
4172,796634,17,4,10,4,9,0,1,2,6,4,4,0,3,0,0,0,10
4172,792632,26,4,5,4,5,0,0,4,9,3,7,2,1,2,0,0,12
4172,796638,21,1,4,1,2,0,2,2,2,0,2,3,5,0,2,0,4
4172,796642,2,0,2,0,1,0,1,0,2,1,0,0,0,0,1,0,0
4172,792629,5,0,0,0,0,0,0,0,0,0,0,0,2,0,0,0,0
4172,792631,6,1,1,1,1,0,0,0,0,0,1,0,0,0,0,0,2
4173,796540,27,5,6,2,3,3,3,2,2,1,5,1,4,0,1,0,15
4173,790951,19,1,3,1,3,0,0,1,2,0,2,1,4,2,1,1,3
4173,786309,26,2,8,2,3,0,5,2,4,1,0,0,1,2,1,1,6
4173,780087,25,4,8,4,6,0,2,10,10,0,5,0,5,1,1,0,18
4173,776136,37,5,13,2,5,3,8,7,9,1,3,6,4,0,3,0,20
4173,796543,13,0,0,0,0,0,0,0,0,0,0,0,1,1,0,0,0
4173,775037,6,0,1,0,1,0,0,0,0,1,0,0,0,0,0,0,0
4173,796545,15,2,5,1,2,1,3,0,0,0,1,2,2,3,1,0,5
4173,790952,1,0,0,0,0,0,0,0,0,0,0,0,2,0,0,0,0
4173,786089,8,0,1,0,0,0,1,0,0,0,0,1,1,0,1,0,0
4173,781410,23,2,9,1,3,1,6,2,2,0,1,1,0,1,1,0,7
4174,797050,32,7,11,6,8,1,3,5,5,4,2,1,1,0,0,0,20
4174,780394,35,4,10,2,5,2,5,2,4,2,2,1,2,1,3,1,12
4174,780391,26,2,4,2,4,0,0,0,0,2,4,3,3,2,1,2,4
4174,790871,31,3,9,2,3,1,6,6,7,0,2,4,2,1,1,0,13
4174,776473,36,5,12,3,5,2,7,5,8,0,8,5,2,2,0,0,17
4174,797048,22,5,9,4,8,1,1,0,0,3,3,1,2,1,2,3,11
4174,791570,4,0,0,0,0,0,0,0,0,0,1,0,3,0,0,0,0
4174,791573,2,0,1,0,0,0,1,0,0,0,0,1,0,0,0,0,0
4174,780392,12,1,2,1,1,0,1,0,0,0,3,0,0,0,1,0,2
4175,780025,29,7,8,7,8,0,0,4,4,1,2,0,2,1,1,0,18
4175,785384,26,4,7,1,4,3,3,0,0,0,1,0,4,1,1,0,11
4175,796391,15,0,4,0,2,0,2,0,0,0,1,0,2,1,0,0,0
4175,785385,36,4,10,1,3,3,7,1,1,0,6,1,1,1,5,0,12
4175,785383,40,5,18,3,14,2,4,5,6,0,3,9,4,1,1,0,17
4175,786297,11,1,3,1,3,0,0,0,1,4,2,1,2,0,1,0,2
4175,781046,15,2,5,1,3,1,2,0,0,1,2,3,1,0,0,1,5
4175,790837,21,1,2,1,2,0,0,2,3,1,3,1,3,0,1,0,4
4175,785382,7,0,2,0,1,0,1,0,0,1,0,1,1,1,0,0,0
4176,796444,41,8,12,8,11,0,1,4,4,7,4,2,2,1,3,6,20
4176,790893,42,6,15,6,12,0,3,4,7,4,8,0,2,1,1,1,16
4176,786615,40,4,9,4,6,0,3,4,4,0,8,3,1,0,1,1,12
4176,786732,32,2,10,1,6,1,4,1,3,2,2,0,2,0,0,0,6
4176,775260,36,3,11,1,5,2,6,2,2,1,3,1,2,2,2,0,10
4176,790889,12,1,4,1,1,0,3,1,2,0,4,0,2,0,0,0,3
4176,775536,7,0,1,0,1,0,0,0,0,0,0,0,1,0,1,1,0
4176,780702,15,0,1,0,0,0,1,0,0,0,2,0,2,0,1,0,0
4177,776344,26,5,11,5,8,0,3,0,3,3,4,2,5,4,1,2,10
4177,775821,34,4,11,2,5,2,6,0,0,5,5,2,4,1,1,0,10
4177,792453,32,4,9,2,4,2,5,0,0,0,4,2,0,0,1,0,10
4177,785131,36,4,12,1,3,3,9,1,2,0,3,3,1,1,1,0,12
4177,781538,39,6,7,2,3,4,4,0,0,0,2,4,2,0,1,0,16
4177,785152,7,0,2,0,2,0,0,0,0,0,2,0,4,0,1,0,0
4177,798115,17,1,2,0,0,1,2,1,2,0,1,3,1,0,1,0,4
4177,776233,12,0,3,0,3,0,0,0,0,0,0,0,2,0,0,0,0
4177,798113,19,0,3,0,1,0,2,0,2,1,2,1,1,0,3,1,0
4177,792324,3,0,1,0,0,0,1,0,0,0,1,0,0,0,0,0,0
4184,797574,14,2,2,0,0,2,2,0,0,0,1,0,1,0,2,1,6
4184,797575,16,2,3,2,3,0,0,2,5,1,1,0,3,0,0,0,6
4184,786512,40,5,12,2,6,3,6,2,2,0,3,4,2,2,2,0,15
4184,786435,22,0,4,0,3,0,1,0,0,1,3,2,4,1,4,0,0
4184,786032,38,2,11,2,8,0,3,2,3,4,4,7,2,2,3,1,6
4184,797573,24,5,9,5,9,0,0,0,0,1,5,1,1,1,0,1,10
4184,791903,23,4,7,3,6,1,1,0,0,0,6,2,0,0,0,0,9
4184,786513,23,5,6,4,5,1,1,4,4,3,8,2,4,1,3,0,15
4185,775340,36,4,10,3,7,1,3,1,3,0,0,7,2,2,4,0,10
4185,780933,30,4,12,0,1,4,11,0,0,0,0,1,3,0,2,0,12
4185,790935,30,5,10,1,3,4,7,1,2,1,4,4,1,0,1,0,15
4185,792442,24,4,5,4,5,0,0,1,1,3,8,0,2,0,1,0,9
4185,796492,4,0,1,0,1,0,0,0,0,0,0,0,0,0,0,0,0
4185,785445,7,2,4,2,3,0,1,0,3,1,2,0,2,0,0,0,4
4185,796190,6,0,1,0,0,0,1,0,0,0,0,0,0,0,0,0,0
4185,785497,5,1,2,1,1,0,1,0,0,0,0,0,1,0,0,0,2
4185,790937,11,1,3,1,3,0,0,1,2,0,1,0,2,0,1,0,3
4185,774826,29,1,6,1,2,0,4,2,2,0,4,4,2,0,1,0,4
4185,790938,18,3,6,3,5,0,1,0,0,0,1,0,0,1,1,0,6
4186,796473,18,2,3,2,3,0,0,0,0,4,4,1,0,1,0,0,4
4186,781560,22,9,12,9,12,0,0,0,0,5,5,0,0,2,0,0,18
4186,791375,23,4,6,3,3,1,3,0,2,0,2,2,0,2,0,0,9
4186,785482,20,6,8,3,4,3,4,0,0,0,1,3,2,0,1,0,15
4186,780837,24,6,14,3,6,3,8,2,2,0,1,5,2,1,1,0,17
4186,796476,16,0,1,0,1,0,0,2,2,2,3,0,4,0,1,2,2
4186,786164,22,7,8,4,4,3,4,0,0,1,2,0,0,0,1,1,17
4186,796477,27,1,8,1,5,0,3,2,4,2,4,6,4,0,4,0,4
4186,785487,21,2,2,1,1,1,1,1,2,1,1,6,4,1,0,0,6
4186,790928,2,1,1,0,0,1,1,0,0,1,0,0,0,0,0,0,3
4186,796472,5,0,2,0,2,0,0,0,0,1,2,0,0,0,0,0,0
4188,786180,23,3,4,3,4,0,0,2,3,0,3,0,2,0,0,0,8
4188,792104,34,6,12,2,4,4,8,2,2,1,4,1,1,2,2,2,18
4188,797708,29,3,9,1,5,2,4,2,4,1,3,2,2,3,1,0,10
4188,786198,16,2,4,2,2,0,2,2,2,0,0,2,4,0,2,1,6
4188,775779,34,3,9,3,8,0,1,1,3,0,4,5,3,4,2,0,7
4188,786204,15,3,5,2,3,1,2,0,0,0,3,0,2,0,1,0,7
4188,797709,29,3,8,2,5,1,3,1,2,1,5,3,0,0,0,0,8
4188,792106,3,0,1,0,0,0,1,0,0,0,0,0,1,0,0,1,0
4188,776327,7,0,0,0,0,0,0,0,0,0,0,1,0,0,0,0,0
4188,797707,10,2,4,2,2,0,2,1,1,1,1,0,0,0,0,0,5
4189,785498,26,6,10,6,8,0,2,0,1,1,1,0,0,0,3,0,12
4189,776469,34,3,7,3,6,0,1,1,2,3,11,5,2,1,1,1,7
4189,796708,40,3,14,3,8,0,6,2,2,1,5,4,3,2,3,0,8
4189,780701,25,4,4,4,4,0,0,2,5,0,3,2,4,0,5,0,10
4189,776322,38,6,14,1,2,5,12,0,0,0,1,0,2,0,3,0,17
4189,796706,26,1,3,0,1,1,2,0,0,0,5,1,3,1,0,1,3
4189,785500,7,0,1,0,0,0,1,0,0,1,3,0,1,0,1,1,0
4189,791036,4,0,0,0,0,0,0,0,0,0,1,1,0,0,0,0,0
4190,790771,35,3,8,1,4,2,4,2,2,1,7,2,2,3,0,5,10
4190,780271,35,4,7,1,3,3,4,1,3,2,5,2,3,1,1,2,12
4190,790772,37,9,19,4,10,5,9,2,2,1,6,4,2,2,2,0,25
4190,796328,31,2,7,1,3,1,4,1,2,0,3,3,0,2,1,0,6
4190,780375,38,10,16,3,4,7,12,0,1,1,1,4,2,0,1,0,27
4190,780218,8,2,4,2,4,0,0,0,0,2,0,0,4,0,2,0,4
4190,790774,13,0,2,0,0,0,2,0,0,3,1,1,2,0,1,0,0
4190,792438,1,0,0,0,0,0,0,0,0,0,0,0,0,0,0,0,0
4190,796329,2,0,0,0,0,0,0,0,0,0,0,0,0,0,0,0,0
4191,796381,22,0,4,0,0,0,4,0,0,0,0,0,0,0,2,0,0
4191,775585,21,4,7,4,7,0,0,6,6,4,3,1,1,0,2,0,14
4191,796380,28,5,8,5,8,0,0,2,4,3,5,2,3,1,2,0,12
4191,790822,36,3,9,3,4,0,5,0,0,1,4,3,2,1,3,1,6
4191,790820,35,5,8,5,7,0,1,0,0,0,5,2,1,0,0,0,10
4191,790821,21,2,4,2,4,0,0,2,4,0,2,0,2,0,1,1,6
4191,780982,30,5,11,3,7,2,4,2,4,1,5,0,1,2,2,0,14
4191,785365,7,0,2,0,0,0,2,0,0,0,1,0,0,0,0,0,0
4192,780291,33,1,4,1,4,0,0,4,6,2,6,0,1,1,4,1,6
4192,785607,8,3,4,3,4,0,0,2,2,1,1,0,2,0,1,0,8
4192,796665,32,2,9,0,1,2,8,2,3,0,1,2,2,3,1,0,8
4192,785333,29,0,2,0,0,0,2,1,2,0,1,1,2,0,2,0,1
4192,796663,9,4,5,4,5,0,0,1,1,1,1,0,2,0,1,0,9
4192,775305,33,6,12,5,9,1,3,5,7,0,4,5,3,3,4,1,18
4192,791004,21,2,10,1,3,1,7,1,2,0,1,0,0,2,0,0,6
4192,791006,3,1,3,1,2,0,1,0,0,0,1,0,0,0,0,0,2
4192,796667,1,0,0,0,0,0,0,0,0,0,0,0,0,0,0,0,0
4192,796666,10,1,2,1,1,0,1,0,0,1,2,0,4,0,0,0,2
4192,796664,19,1,3,0,1,1,2,1,3,0,1,2,3,2,1,0,4
4192,791005,2,0,0,0,0,0,0,0,0,0,0,0,0,0,0,0,0
4193,780214,4,0,1,0,0,0,1,0,0,0,0,1,0,0,0,0,0
4193,775087,24,5,7,5,7,0,0,4,6,1,7,2,4,0,0,1,14
4193,790984,34,3,6,0,1,3,5,2,2,0,6,3,0,1,2,0,11
4193,780212,28,7,15,2,4,5,11,1,1,0,1,3,3,5,3,0,20
4193,767245,33,6,11,6,11,0,0,2,4,2,7,1,4,0,4,0,14
4193,780406,19,2,4,1,1,1,3,1,2,2,4,3,2,1,3,0,6
4193,790985,8,1,1,1,1,0,0,0,0,0,1,1,3,0,1,1,2
4193,780215,2,0,0,0,0,0,0,0,0,0,0,0,1,0,0,0,0
4193,796597,2,0,0,0,0,0,0,0,0,0,0,0,0,0,0,0,0
4193,796596,20,4,6,1,1,3,5,0,0,0,2,1,1,1,1,0,11
4193,785297,26,3,5,3,4,0,1,4,4,2,4,1,2,0,2,0,10
4194,785368,31,6,12,6,12,0,0,9,12,5,5,3,1,0,3,8,21
4194,780281,39,1,7,0,4,1,3,0,0,2,4,1,1,1,1,1,3
4194,790793,28,4,12,3,9,1,3,8,8,2,5,3,3,3,1,0,17
4194,785246,38,4,8,1,2,3,6,4,4,1,3,0,2,0,1,0,15
4194,780886,32,2,4,2,4,0,0,1,2,0,7,2,3,2,2,0,5
4194,796351,2,0,0,0,0,0,0,0,0,0,0,0,1,0,0,0,0
4194,790794,7,1,1,1,1,0,0,0,0,0,1,0,0,0,0,1,2
4194,796350,13,2,3,1,1,1,2,0,0,0,2,0,0,0,0,0,5
4194,790789,10,2,4,2,4,0,0,0,0,0,0,0,0,0,0,0,4
4195,786447,37,4,9,4,9,0,0,0,2,2,3,1,0,1,2,1,8
4195,776365,9,0,4,0,3,0,1,0,0,1,1,0,1,0,2,0,0
4195,791631,26,1,5,1,3,0,2,0,0,0,4,0,2,0,0,0,2
4195,786448,21,2,8,0,6,2,2,0,0,1,3,1,4,2,0,1,6
4195,780462,34,7,14,5,9,2,5,3,3,0,1,3,1,1,0,0,19
4195,786132,13,1,2,1,2,0,0,2,2,3,0,1,4,0,0,1,4
4195,775074,21,2,5,2,5,0,0,6,8,1,1,0,5,0,3,0,10
4195,796971,2,0,1,0,1,0,0,0,0,0,1,0,0,0,0,0,0
4195,780731,25,4,9,3,6,1,3,0,0,0,3,2,3,0,0,0,9
4195,775121,12,2,3,1,2,1,1,0,0,0,2,0,0,0,1,0,5
4196,780012,31,5,11,2,6,3,5,0,0,0,6,3,0,0,0,3,13
4196,796309,25,5,10,5,10,0,0,2,2,3,3,0,1,1,0,3,12
4196,790824,28,7,10,6,8,1,2,0,0,0,10,1,4,4,0,1,15
4196,780011,30,2,5,1,3,1,2,0,0,1,4,2,0,1,1,0,5
4196,775667,30,6,9,4,6,2,3,2,2,0,2,6,1,0,4,0,16
4196,796383,3,0,1,0,1,0,0,0,0,1,2,0,0,0,0,0,0
4196,785370,14,1,2,0,1,1,1,0,0,0,3,0,0,0,1,1,3
4196,780941,3,0,2,0,2,0,0,0,0,0,0,0,0,0,0,0,0
4196,774895,12,2,4,2,4,0,0,0,0,2,2,1,1,0,0,0,4
4196,796384,3,0,1,0,1,0,0,0,0,0,0,0,1,0,0,0,0
4196,796382,3,1,1,1,1,0,0,0,0,0,0,0,0,0,1,0,2
4196,781524,15,3,6,2,3,1,3,0,0,1,1,0,1,0,1,1,7
4196,785367,3,0,0,0,0,0,0,0,0,0,0,0,0,0,0,0,0
4197,776004,24,5,11,3,6,2,5,0,0,2,4,0,3,0,4,1,12
4197,780358,19,2,9,2,6,0,3,0,0,1,1,0,0,0,1,0,4
4197,775011,26,2,8,1,4,1,4,1,1,0,4,0,2,1,0,0,6
4197,780357,25,1,8,1,5,0,3,0,1,0,2,1,0,1,0,0,2
4197,775018,35,7,13,3,6,4,7,2,2,0,2,2,1,0,2,0,20
4197,790930,24,1,4,0,3,1,1,2,2,2,4,1,0,0,2,0,5
4197,796486,3,1,3,1,1,0,2,0,0,0,0,0,0,0,0,0,2
4197,796480,26,0,6,0,5,0,1,0,0,1,3,1,0,1,1,1,0
4197,776270,17,1,3,0,1,1,2,0,0,1,1,3,0,1,0,0,3
4197,796485,1,0,0,0,0,0,0,0,0,0,0,0,0,0,0,0,0
4198,796439,16,2,5,2,5,0,0,2,2,1,1,1,3,0,0,1,6
4198,791635,26,5,9,2,2,3,7,4,5,0,1,2,2,3,2,0,17
4198,790883,32,5,6,4,4,1,2,3,3,0,3,3,2,2,3,0,14
4198,796436,39,6,12,3,6,3,6,3,4,0,7,3,2,0,4,2,18
4198,785436,38,3,8,2,7,1,1,3,5,2,2,6,1,3,1,0,10
4198,796438,25,3,11,2,7,1,4,1,1,3,7,0,3,0,0,0,8
4198,790884,16,1,3,1,3,0,0,0,0,1,0,0,1,1,1,0,2
4198,790885,4,0,1,0,0,0,1,0,0,0,1,0,0,0,0,0,0
4198,796442,4,0,0,0,0,0,0,0,0,0,0,0,0,0,0,0,0
4199,790810,32,2,7,2,3,0,4,0,0,1,4,3,3,0,3,0,4
4199,785362,31,10,18,10,18,0,0,4,4,4,8,2,3,0,1,3,24
4199,790808,25,3,7,2,3,1,4,0,0,1,2,0,1,1,1,1,7
4199,785361,36,4,12,0,3,4,9,2,2,2,2,0,2,1,2,1,14
4199,779997,36,6,12,6,9,0,3,0,0,0,2,3,2,0,3,0,12
4199,774854,9,1,1,1,1,0,0,1,1,0,1,0,0,0,0,1,3
4199,796368,1,0,0,0,0,0,0,0,0,0,0,0,0,0,1,0,0
4199,796370,13,0,3,0,2,0,1,2,2,0,2,1,2,1,1,0,2
4199,790811,11,2,2,2,2,0,0,0,0,1,0,0,3,0,1,0,4
4199,790809,6,0,0,0,0,0,0,0,0,0,0,0,0,0,0,0,0
4200,775697,26,2,10,1,6,1,4,0,0,2,3,1,0,0,1,0,5
4200,791454,23,4,12,4,10,0,2,2,2,3,1,0,3,1,3,1,10
4200,797217,35,4,9,3,4,1,5,3,3,1,2,2,2,1,3,0,12
4200,797218,26,2,7,2,6,0,1,1,2,2,3,1,4,0,1,0,5
4200,781526,19,1,4,1,4,0,0,4,5,2,3,2,1,0,2,0,6
4200,791846,24,2,6,2,5,0,1,1,2,1,5,1,3,1,1,1,5
4200,791453,24,3,8,1,3,2,5,0,0,1,5,0,2,0,4,0,8
4200,797222,23,3,5,3,5,0,0,8,10,3,3,0,3,2,3,7,14
4201,780059,8,3,6,1,3,2,3,0,0,0,1,2,1,0,0,0,8
4201,796494,33,4,9,3,6,1,3,3,3,1,1,1,3,4,0,1,12
4201,776110,19,3,7,1,1,2,6,0,0,1,1,2,0,0,0,0,8
4201,780061,38,9,15,5,8,4,7,1,1,0,5,2,3,0,2,0,23
4201,790944,38,6,15,4,10,2,5,4,5,1,1,6,2,0,3,0,18
4201,796496,18,0,0,0,0,0,0,0,0,0,6,0,4,2,2,0,0
4201,780058,13,3,5,1,1,2,4,0,0,1,1,1,5,1,1,2,8
4201,790943,19,1,4,0,2,1,2,0,0,2,4,1,4,1,2,0,3
4201,790941,13,2,7,2,7,0,0,0,2,4,1,0,1,1,0,0,4
4201,785097,1,0,0,0,0,0,0,1,2,0,1,0,0,0,0,0,1
4201,796495,0,0,0,0,0,0,0,0,0,0,0,0,0,0,0,0,0
4201,788853,0,0,0,0,0,0,0,0,0,0,0,0,0,0,0,0,0
4201,796497,0,0,0,0,0,0,0,0,0,0,0,0,0,0,0,0,0
4201,796499,0,0,0,0,0,0,0,0,0,0,0,0,0,0,0,0,0
4202,790856,27,7,13,7,13,0,0,1,3,7,5,2,2,1,0,0,15
4202,780452,33,5,12,5,12,0,0,6,6,2,8,2,2,3,3,2,16
4202,796413,21,4,9,3,4,1,5,0,0,2,1,0,1,0,2,1,9
4202,796408,20,2,10,1,5,1,5,2,2,0,2,1,2,0,2,0,7
4202,796407,34,1,7,1,3,0,4,3,4,2,2,7,1,1,1,3,5
4202,796411,5,1,2,1,2,0,0,0,0,2,1,1,2,0,1,0,2
4202,796410,15,3,6,3,6,0,0,2,4,0,4,2,4,0,1,0,8
4202,780450,20,3,5,2,2,1,3,0,0,3,0,2,3,0,0,0,7
4202,796409,21,3,8,1,2,2,6,4,4,1,1,1,0,2,0,0,12
4202,796412,4,0,1,0,0,0,1,0,0,0,0,0,0,0,0,0,0
4203,792181,37,9,18,8,12,1,6,4,5,3,8,1,5,1,0,5,23
4203,785902,32,6,12,3,4,3,8,1,2,3,4,2,2,1,6,3,16
4203,780986,35,2,3,2,3,0,0,2,2,0,1,2,3,1,1,0,6
4203,792179,26,2,7,0,3,2,4,0,0,1,2,3,1,0,2,0,6
4203,786662,38,7,15,3,6,4,9,0,0,0,2,4,3,3,3,0,18
4203,792177,7,0,0,0,0,0,0,0,1,0,0,0,1,0,1,1,0
4203,786661,9,1,3,1,1,0,2,2,2,0,2,0,1,0,0,0,4
4203,797796,16,1,2,1,2,0,0,0,0,0,2,1,0,1,1,0,2
4212,791299,31,4,5,4,5,0,0,1,2,3,3,1,3,2,4,2,9
4212,786397,30,6,8,6,6,0,2,1,3,4,8,1,5,5,6,1,13
4212,775871,38,4,13,4,12,0,1,4,4,3,6,1,1,3,2,1,12
4212,796590,13,1,3,0,2,1,1,0,0,0,0,0,1,1,1,0,3
4212,791519,40,5,19,4,14,1,5,13,15,1,3,3,0,1,8,0,24
4212,792084,2,1,1,1,1,0,0,0,0,0,0,0,4,0,0,0,2
4212,786276,8,2,3,0,0,2,3,0,0,0,0,0,0,0,0,0,6
4212,796593,7,0,1,0,1,0,0,0,0,0,1,1,2,0,0,1,0
4212,796591,31,2,6,0,3,2,3,2,2,0,5,3,3,2,2,1,8
4212,780529,0,0,0,0,0,0,0,0,0,0,0,0,0,0,0,0,0
4213,786746,25,4,9,3,8,1,1,3,4,1,4,3,2,0,3,0,12
4213,780178,11,2,2,2,2,0,0,1,2,0,0,0,2,1,1,1,5
4213,775075,19,3,4,3,4,0,0,1,2,1,1,1,4,2,1,0,7
4213,792376,33,5,13,3,5,2,8,5,6,0,4,2,2,6,7,0,17
4213,797883,30,2,4,2,3,0,1,2,3,1,4,8,2,4,2,0,6
4213,797890,18,5,7,5,6,0,1,0,1,0,1,1,3,1,0,0,10
4213,792378,22,4,6,4,6,0,0,3,4,2,3,0,0,1,0,4,11
4213,797888,11,2,3,2,3,0,0,1,1,0,2,0,2,0,1,0,5
4213,792374,11,2,3,1,1,1,2,0,0,0,1,1,2,1,1,0,5
4213,786747,20,2,7,2,5,0,2,2,2,0,2,1,1,1,3,1,6
4214,792249,27,3,7,3,5,0,2,0,0,0,5,3,3,2,2,5,6
4214,781430,33,5,10,4,6,1,4,7,8,2,10,1,4,0,5,0,18
4214,792248,34,2,11,1,3,1,8,0,0,0,2,3,2,0,2,1,5
4214,781445,36,7,14,1,2,6,12,0,0,2,4,1,2,0,3,0,20
4214,768845,24,5,6,4,5,1,1,2,3,2,4,3,4,1,4,0,13
4214,792253,8,1,1,1,1,0,0,2,2,0,2,0,1,0,2,2,4
4214,781448,3,1,1,1,1,0,0,0,0,1,0,0,1,0,1,0,2
4214,797941,18,3,7,2,4,1,3,3,5,1,0,0,3,1,0,0,10
4214,792250,17,3,8,1,4,2,4,2,2,1,0,4,0,0,1,0,10
4215,785775,24,2,4,2,3,0,1,5,6,2,6,4,4,0,4,1,9
4215,781335,34,9,21,9,17,0,4,0,2,1,4,3,2,1,3,2,18
4215,776351,26,10,12,6,7,4,5,5,6,1,3,2,3,1,3,0,29
4215,785770,35,7,15,6,12,1,3,2,2,3,5,5,1,4,1,0,17
4215,781341,37,4,7,2,3,2,4,0,0,0,5,4,1,4,2,0,10
4215,796542,15,3,4,3,4,0,0,0,2,3,3,0,4,0,1,0,6
4215,791285,5,0,2,0,0,0,2,0,0,0,0,0,1,0,0,0,0
4215,796538,10,1,3,0,0,1,3,0,0,0,0,1,3,2,0,0,3
4215,791284,14,1,4,1,2,0,2,0,0,0,0,2,2,1,0,0,2
4216,775510,36,6,13,5,9,1,4,2,2,0,9,1,2,0,0,0,15
4216,774976,24,7,13,3,5,4,8,0,1,0,5,1,4,0,1,2,18
4216,797865,36,2,5,1,3,1,2,2,2,1,3,3,4,3,2,0,7
4216,786614,31,4,6,2,2,2,4,0,0,0,0,4,3,0,1,1,10
4216,786759,37,5,11,4,8,1,3,1,1,0,1,6,2,0,1,0,12
4216,792293,24,6,7,3,4,3,3,0,0,0,4,0,2,0,0,0,15
4216,786761,12,1,2,1,2,0,0,1,1,1,0,1,0,0,0,0,3
4217,785423,32,4,8,3,4,1,4,3,4,2,6,2,0,0,1,0,12
4217,775676,28,4,6,4,6,0,0,2,2,2,2,0,2,2,2,0,10
4217,786298,28,4,8,3,5,1,3,7,7,0,4,0,0,1,0,0,16
4217,785425,33,1,8,1,2,0,6,0,0,0,3,1,0,1,0,0,2
4217,785422,33,4,9,4,7,0,2,1,1,0,1,3,2,0,2,0,9
4217,774957,19,1,3,1,1,0,2,4,4,0,1,0,3,0,0,2,6
4217,786210,24,4,9,1,4,3,5,2,2,0,3,4,1,0,2,0,13
4217,796431,1,0,0,0,0,0,0,0,0,0,0,0,0,0,0,0,0
4217,796429,1,0,0,0,0,0,0,0,0,0,0,0,0,0,0,0,0
4217,793801,1,0,0,0,0,0,0,0,0,0,0,0,0,0,0,0,0
4218,790873,24,0,6,0,4,0,2,6,8,0,10,2,3,0,5,0,6
4218,785429,23,4,5,0,0,4,5,0,0,0,2,0,3,0,0,0,12
4218,780054,34,5,9,4,5,1,4,2,3,0,7,1,2,0,1,0,13
4218,781140,36,5,5,5,5,0,0,2,3,1,8,0,3,0,1,1,12
4218,786851,36,7,17,4,6,3,11,6,8,0,3,6,0,0,1,0,23
4218,796433,18,3,6,3,6,0,0,1,2,3,0,2,3,0,1,1,7
4218,781139,13,1,2,1,1,0,1,0,1,0,1,0,2,1,1,0,2
4218,776245,3,0,1,0,1,0,0,0,0,0,1,0,1,0,0,0,0
4218,799973,11,2,3,0,1,2,2,0,0,0,1,1,1,0,1,0,6
4218,796432,2,0,0,0,0,0,0,0,0,0,0,0,0,0,0,0,0
4219,791917,24,0,3,0,2,0,1,0,1,0,4,1,2,1,1,1,0
4219,786526,20,4,8,2,6,2,2,2,2,1,4,0,4,0,0,0,12
4219,786525,37,4,11,2,6,2,5,6,6,1,8,0,2,1,1,0,16
4219,791914,35,1,9,0,3,1,6,2,2,1,2,5,3,2,0,0,5
4219,786030,33,11,23,10,16,1,7,2,3,1,4,2,4,0,0,0,25
4219,786856,20,4,5,4,5,0,0,1,4,2,1,1,2,1,1,0,9
4219,797550,8,0,2,0,0,0,2,0,0,0,0,0,2,0,0,0,0
4219,781109,16,1,2,1,2,0,0,0,1,0,2,0,2,0,1,0,2
4219,786524,7,0,0,0,0,0,0,2,2,0,0,0,0,0,0,0,2
4220,797028,42,7,9,6,6,1,3,6,8,1,5,3,3,2,3,0,21
4220,785687,25,2,8,2,2,0,6,0,0,0,2,1,0,1,1,4,4
4220,791598,30,5,12,4,8,1,4,5,6,1,6,4,4,2,0,0,16
4220,792116,40,4,12,4,9,0,3,2,2,0,8,5,2,4,5,2,10
4220,780410,38,5,13,3,4,2,9,3,4,1,3,4,2,2,0,1,15
4220,775047,5,0,1,0,1,0,0,0,0,2,1,0,1,0,0,0,0
4220,797025,31,2,7,1,5,1,2,4,4,0,1,2,4,3,2,1,9
4220,791597,2,0,0,0,0,0,0,0,0,0,0,0,0,0,0,0,0
4220,791600,12,2,5,1,2,1,3,0,0,0,0,0,0,2,1,0,5
4221,781407,11,3,6,1,4,2,2,0,0,1,1,1,2,0,3,0,8
4221,791583,34,10,13,10,13,0,0,3,9,2,4,0,5,1,2,1,23
4221,786110,33,4,7,1,3,3,4,0,0,1,3,4,4,1,4,0,11
4221,780580,41,3,13,2,10,1,3,5,8,2,5,5,1,2,3,0,12
4221,776150,36,3,8,3,4,0,4,0,0,0,2,7,2,1,5,0,6
4221,797448,25,4,6,1,1,3,5,0,0,0,6,1,0,0,0,1,11
4221,786608,9,0,5,0,5,0,0,0,0,0,1,0,1,0,0,0,0
4221,797445,9,0,1,0,1,0,0,0,0,2,1,2,0,1,0,0,0
4221,785623,14,0,3,0,1,0,2,1,2,2,4,0,1,0,0,1,1
4221,786659,13,2,4,2,3,0,1,2,2,1,3,0,0,0,3,0,6
4222,780890,34,8,13,4,8,4,5,7,8,2,5,0,3,1,1,0,27
4222,775757,15,2,6,2,6,0,0,2,2,0,1,0,1,1,0,0,6
4222,780167,36,4,10,4,8,0,2,2,2,2,1,2,2,2,2,0,10
4222,786066,37,4,12,3,9,1,3,5,6,1,6,3,1,1,3,0,14
4222,775574,34,8,13,6,8,2,5,2,2,0,7,4,1,2,0,0,20
4222,791123,22,1,3,1,2,0,1,2,2,0,1,0,0,0,0,0,4
4222,785636,22,1,2,1,2,0,0,0,0,0,2,3,3,1,0,0,2
4223,780797,29,4,15,2,5,2,10,5,5,2,7,2,3,0,3,1,15
4223,776418,17,4,4,4,4,0,0,0,0,0,4,2,1,0,2,2,8
4223,785505,23,5,10,5,8,0,2,0,1,0,0,3,3,1,1,0,10
4223,780555,39,3,7,1,2,2,5,2,2,0,4,2,2,1,0,0,10
4223,775604,34,8,15,2,3,6,12,0,0,1,2,2,4,0,3,0,22
4223,786429,4,0,1,0,1,0,0,0,0,0,0,1,3,0,2,0,0
4223,796986,16,0,1,0,0,0,1,0,0,0,2,0,0,0,1,0,0
4223,796984,9,1,1,1,1,0,0,0,0,1,1,1,0,0,0,0,2
4223,796981,20,6,8,6,7,0,1,1,1,4,2,2,3,1,2,0,13
4223,791617,9,0,1,0,0,0,1,0,0,0,0,2,1,0,0,0,0
4224,791295,27,8,14,8,14,0,0,1,2,1,3,4,1,1,1,2,17
4224,776345,23,6,8,6,8,0,0,3,3,1,11,0,2,0,2,2,15
4224,796579,31,2,6,1,1,1,5,0,0,0,6,3,3,4,2,0,5
4224,785794,26,5,11,5,10,0,1,0,0,4,4,1,1,0,3,0,10
4224,781373,31,6,12,4,7,2,5,4,4,1,7,2,2,2,5,0,18
4224,796578,2,1,2,1,2,0,0,0,0,0,2,0,0,0,0,1,2
4224,781379,6,0,0,0,0,0,0,0,2,0,2,0,0,0,0,0,0
4224,796577,2,0,1,0,1,0,0,0,0,0,0,0,0,0,0,0,0
4224,791292,3,2,2,2,2,0,0,0,0,2,0,1,0,1,0,0,4
4224,791293,14,0,0,0,0,0,0,0,0,0,1,0,0,2,1,0,0
4224,796580,17,0,1,0,0,0,1,0,0,0,0,1,1,0,0,0,0
4224,785792,16,1,5,1,2,0,3,2,2,0,2,1,1,0,2,0,4
4224,781372,1,0,1,0,1,0,0,0,0,0,0,0,0,0,0,0,0
4224,791294,1,0,0,0,0,0,0,0,0,0,0,0,0,0,0,0,0
4225,780122,15,3,4,2,2,1,2,0,0,0,2,1,3,0,1,2,7
4225,797215,26,2,4,2,3,0,1,0,0,1,3,0,3,1,1,0,4
4225,797214,13,1,4,1,3,0,1,0,0,0,1,0,2,0,2,0,2
4225,786295,32,2,13,1,7,1,6,0,0,1,5,1,1,1,4,0,5
4225,780792,20,0,5,0,2,0,3,0,0,0,1,1,0,1,0,1,0
4225,797216,6,0,2,0,2,0,0,0,0,1,1,0,0,0,2,1,0
4225,786299,16,3,4,3,4,0,0,1,1,3,0,0,2,0,1,1,7
4225,791461,21,3,7,3,5,0,2,1,1,1,7,0,0,0,0,0,7
4225,791459,7,0,3,0,2,0,1,0,0,0,1,0,0,1,2,0,0
4225,791460,26,3,11,3,8,0,3,1,1,0,1,0,3,1,3,0,7
4225,775598,18,1,12,0,8,1,4,0,0,1,1,0,0,0,1,1,3
4226,797142,28,4,4,3,3,1,1,2,2,2,4,1,3,2,0,0,11
4226,791522,33,9,16,8,14,1,2,4,4,2,8,0,3,0,6,0,23
4226,786351,30,8,10,6,6,2,4,0,0,5,8,0,2,2,2,1,18
4226,797146,32,5,15,4,8,1,7,6,8,0,4,3,2,1,3,0,17
4226,797143,35,4,13,3,10,1,3,4,7,1,2,5,2,0,2,0,13
4226,786348,11,2,3,1,2,1,1,0,0,1,3,0,1,1,0,0,5
4226,797147,13,1,2,1,1,0,1,1,3,0,1,1,3,1,4,0,3
4226,785816,15,1,2,1,2,0,0,0,0,1,2,0,2,0,0,2,2
4226,797144,3,0,0,0,0,0,0,0,0,0,1,0,2,0,1,0,0
4227,785536,8,1,3,0,1,1,2,0,0,1,1,0,1,0,0,0,3
4227,775679,22,1,8,1,4,0,4,0,0,3,4,1,1,1,1,0,2
4227,796558,27,1,11,1,10,0,1,2,3,1,2,2,1,2,2,1,4
4227,796559,36,7,18,6,13,1,5,3,4,5,1,2,4,2,3,0,18
4227,776097,21,2,5,1,1,1,4,1,2,0,1,1,2,0,4,0,6
4227,785280,29,4,8,2,3,2,5,4,4,0,4,0,2,0,0,0,14
4227,780149,26,8,20,5,10,3,10,3,4,3,2,1,3,3,2,0,22
4227,796560,28,2,3,2,3,0,0,3,3,4,6,1,5,2,3,1,7
4227,785285,3,0,0,0,0,0,0,0,0,0,0,0,1,0,0,0,0
4228,792158,20,3,3,3,3,0,0,0,0,0,2,1,3,3,2,2,6
4228,792157,16,0,1,0,1,0,0,0,0,0,2,0,2,0,3,1,0
4228,792154,28,7,11,5,6,2,5,5,6,1,2,1,1,0,0,0,21
4228,792152,33,5,13,3,4,2,9,2,2,0,3,8,4,1,2,0,14
4228,780581,16,3,5,1,1,2,4,0,0,0,2,2,1,0,0,0,8
4228,797755,18,3,5,3,4,0,1,4,4,3,3,0,4,3,0,1,10
4228,792162,3,0,2,0,1,0,1,0,0,1,0,0,0,0,0,0,0
4228,780138,23,6,7,6,7,0,0,5,8,4,6,1,0,3,1,0,17
4228,797759,3,0,1,0,1,0,0,0,0,0,0,0,1,0,0,0,0
4228,797756,19,1,6,0,2,1,4,2,2,0,0,4,3,0,2,0,5
4228,792159,5,1,1,1,1,0,0,0,1,0,0,0,1,1,0,0,2
4228,786014,16,5,7,3,4,2,3,0,0,0,1,1,2,2,0,0,12
4229,780758,13,2,3,1,2,1,1,2,2,0,2,0,3,0,0,0,7
4229,775489,26,3,7,3,6,0,1,2,2,3,3,0,2,1,2,0,8
4229,785560,24,3,4,0,1,3,3,0,0,0,1,1,2,0,3,0,9
4229,785561,33,3,9,3,7,0,2,3,3,0,1,3,3,1,2,0,9
4229,780313,33,6,13,4,8,2,5,5,6,0,5,4,2,1,2,0,19
4229,781208,21,5,9,5,8,0,1,0,1,4,2,0,1,0,0,0,10
4229,796751,5,0,0,0,0,0,0,0,0,0,0,0,1,0,1,0,0
4229,791087,4,0,0,0,0,0,0,0,0,0,3,1,2,0,0,0,0
4229,796749,3,0,0,0,0,0,0,1,2,0,0,0,0,0,2,0,1
4229,796748,3,0,0,0,0,0,0,0,0,0,0,0,1,0,1,0,0
4229,791088,8,1,2,1,1,0,1,0,0,0,1,0,1,0,2,0,2
4229,785563,24,0,4,0,3,0,1,4,7,0,1,1,2,1,3,0,4
4229,796750,3,0,0,0,0,0,0,0,0,0,0,0,0,0,0,0,0
4230,797111,34,8,11,6,9,2,2,0,0,2,3,1,2,1,3,1,18
4230,797110,18,3,8,0,1,3,7,0,0,0,2,0,1,0,0,0,9
4230,791407,39,9,16,2,6,7,10,3,4,0,3,5,1,0,0,0,28
4230,785928,25,2,2,1,1,1,1,0,0,0,4,7,3,4,2,0,5
4230,785923,34,2,3,2,3,0,0,0,1,1,1,6,1,0,2,1,4
4230,797113,0,0,0,0,0,0,0,0,0,0,0,0,0,0,0,0,0
4230,797117,2,0,0,0,0,0,0,0,0,0,0,0,0,0,0,0,0
4230,797115,0,0,0,0,0,0,0,0,0,0,1,0,0,0,0,0,0
4230,797109,26,3,8,3,5,0,3,0,0,2,3,0,2,1,2,1,6
4230,791404,22,3,4,0,0,3,4,4,4,0,3,5,1,2,3,0,13
4231,786413,12,0,2,0,2,0,0,0,0,0,1,0,1,0,0,0,0
4231,780471,32,5,10,5,10,0,0,7,8,2,2,3,4,1,4,0,17
4231,791608,29,2,4,1,2,1,2,0,0,0,0,1,4,0,0,0,5
4231,780417,18,2,7,1,3,1,4,0,0,0,1,4,0,1,3,0,5
4231,776011,28,2,3,2,2,0,1,0,2,0,4,4,0,0,3,0,4
4231,796996,29,8,9,8,9,0,0,3,3,1,3,2,1,0,1,0,19
4231,796994,20,1,3,0,0,1,3,0,0,0,3,2,1,0,0,0,3
4231,791613,9,0,2,0,1,0,1,0,0,0,0,1,0,0,2,0,0
4231,792071,18,3,7,1,1,2,6,0,0,0,3,0,1,0,0,0,8
4231,785680,5,0,1,0,1,0,0,0,0,0,0,0,2,0,1,0,0
4232,790899,30,4,9,4,9,0,0,3,4,3,3,0,3,1,2,1,11
4232,785442,26,2,9,2,6,0,3,0,0,2,6,0,4,0,1,0,4
4232,790898,19,1,2,1,1,0,1,0,0,0,2,3,1,0,4,0,2
4232,785579,38,6,13,5,9,1,4,6,6,0,1,4,1,1,1,0,19
4232,775737,35,2,7,0,0,2,7,5,5,1,3,3,3,2,1,0,11
4232,790897,13,2,6,1,2,1,4,2,2,1,1,0,0,0,1,0,7
4232,796446,3,0,0,0,0,0,0,0,0,0,0,2,1,0,0,0,0
4232,775959,27,4,11,1,1,3,10,0,1,0,2,0,3,0,0,0,11
4232,785448,6,0,0,0,0,0,0,0,0,0,0,0,2,0,1,0,0
4232,796447,3,0,0,0,0,0,0,0,0,1,0,0,0,0,0,0,0
4233,791534,9,2,2,2,2,0,0,0,0,0,1,0,5,0,0,0,4
4233,797127,29,6,9,6,8,0,1,3,5,2,0,1,3,1,0,1,15
4233,791533,34,5,7,2,3,3,4,2,4,2,9,1,3,0,3,0,15
4233,791528,26,2,8,1,6,1,2,0,0,0,2,9,4,0,1,0,5
4233,775045,36,9,20,8,17,1,3,4,4,1,9,3,1,3,1,1,23
4233,797124,21,3,5,3,4,0,1,1,2,1,1,0,0,0,2,3,7
4233,791531,21,1,1,0,0,1,1,2,2,1,4,1,0,1,2,0,5
4233,791529,18,1,5,0,1,1,4,0,0,0,1,0,1,0,1,0,3
4233,797129,5,0,0,0,0,0,0,0,0,0,0,0,1,0,0,0,0
4233,774880,1,0,0,0,0,0,0,0,0,0,0,0,0,0,0,0,0
4234,797698,27,3,10,3,7,0,3,4,4,1,3,1,4,0,1,1,10
4234,797692,26,1,4,0,2,1,2,4,4,0,1,1,3,0,2,0,7
4234,791954,27,4,10,2,8,2,2,0,0,3,2,2,4,1,1,0,10
4234,791956,28,4,14,4,8,0,6,0,0,2,2,2,1,1,1,2,8
4234,780846,35,6,11,4,7,2,4,3,4,2,7,3,4,0,4,0,17
4234,797699,30,5,11,4,7,1,4,2,2,0,3,3,2,0,0,0,13
4234,797694,27,2,5,1,1,1,4,0,0,0,4,2,1,0,1,0,5
4235,781174,20,4,4,4,4,0,0,2,2,1,2,0,4,0,0,1,10
4235,781159,31,6,10,6,9,0,1,3,4,3,3,1,3,2,2,2,15
4235,791001,33,7,9,7,8,0,1,0,0,0,7,5,2,0,2,1,14
4235,781215,30,2,7,1,4,1,3,7,7,1,5,2,1,1,2,1,12
4235,775255,27,5,11,4,7,1,4,3,4,0,1,1,2,0,3,0,14
4235,796643,5,1,2,1,1,0,1,1,1,0,2,0,1,0,0,0,3
4235,785320,25,2,5,1,2,1,3,0,0,0,2,0,0,2,1,0,5
4235,785231,27,5,11,3,5,2,6,5,5,0,5,1,1,1,1,0,17
4235,796644,1,0,0,0,0,0,0,0,0,0,0,0,0,0,0,0,0
4235,796641,1,0,0,0,0,0,0,0,0,0,0,0,0,0,0,0,0
4236,796469,22,2,5,0,2,2,3,3,5,3,6,0,3,0,2,4,9
4236,779981,33,5,7,5,7,0,0,6,14,3,2,1,2,0,2,2,16
4236,785463,33,5,14,1,6,4,8,1,2,0,4,4,2,0,3,0,15
4236,779978,37,3,12,0,6,3,6,4,4,1,5,3,2,1,3,0,13
4236,776003,34,7,11,3,5,4,6,2,2,2,1,1,2,1,3,0,20
4236,790923,15,1,2,1,2,0,0,1,2,0,2,0,3,0,0,0,3
4236,785466,17,0,1,0,0,0,1,0,0,2,3,0,1,0,0,0,0
4236,779980,5,0,0,0,0,0,0,1,2,0,1,0,3,0,0,0,1
4236,790924,4,0,2,0,1,0,1,0,0,0,0,0,1,0,1,0,0
4237,780323,23,4,5,4,5,0,0,4,5,2,2,0,5,0,2,2,12
4237,797894,20,2,8,2,8,0,0,0,0,1,1,0,4,0,1,0,4
4237,792229,25,6,7,4,5,2,2,2,3,2,6,1,3,0,0,0,16
4237,785954,32,2,7,0,2,2,5,1,2,1,5,1,2,2,1,2,7
4237,785811,36,6,14,4,11,2,3,8,10,1,4,2,2,1,1,0,22
4237,792233,33,4,13,3,5,1,8,5,6,1,6,2,2,1,1,0,14
4237,792234,10,0,0,0,0,0,0,0,0,0,1,0,0,0,0,1,0
4237,786016,19,1,6,1,5,0,1,2,2,0,0,1,5,0,1,0,4
4237,781356,1,0,0,0,0,0,0,0,0,0,0,0,0,0,0,0,0
4237,792230,1,0,0,0,0,0,0,0,0,0,0,0,0,0,0,0,0
4246,791276,26,6,9,6,9,0,0,0,0,5,5,1,5,1,1,0,12
4246,796526,23,2,5,1,1,1,4,1,1,0,1,2,3,0,3,0,6
4246,791275,35,3,10,0,2,3,8,2,3,0,2,3,0,0,2,0,11
4246,785746,40,4,11,2,4,2,7,0,0,0,2,3,4,1,1,0,10
4246,785741,40,3,8,1,3,2,5,1,2,0,1,5,1,1,1,1,9
4246,785755,16,0,0,0,0,0,0,1,4,0,4,0,3,0,1,2,1
4246,781316,7,0,4,0,0,0,4,0,0,0,1,0,1,0,0,0,0
4246,796529,13,2,5,1,2,1,3,0,0,0,2,0,1,0,1,0,5
4247,786123,38,0,4,0,4,0,0,3,4,2,5,7,2,1,1,0,3
4247,780437,30,4,5,4,5,0,0,6,8,3,6,0,3,0,2,0,14
4247,797673,37,10,16,5,9,5,7,1,2,1,3,3,2,2,1,0,26
4247,786118,38,1,7,1,2,0,5,3,4,5,9,3,2,1,1,0,5
4247,786117,34,6,14,5,8,1,6,1,1,1,1,6,3,0,4,0,14
4247,797675,2,0,0,0,0,0,0,0,0,0,1,0,1,0,1,0,0
4247,797672,4,1,2,1,2,0,0,0,0,1,1,0,0,0,0,0,2
4247,792093,17,2,7,2,4,0,3,0,0,0,0,1,1,1,0,0,4
4248,791781,9,1,1,1,1,0,0,0,0,1,1,1,0,0,1,0,2
4248,776285,27,6,8,6,8,0,0,6,8,3,5,1,4,0,0,2,18
4248,791777,24,2,6,1,3,1,3,1,4,1,2,3,4,1,3,0,6
4248,781025,30,5,9,5,6,0,3,4,4,1,3,3,2,1,3,2,14
4248,786474,29,1,5,0,1,1,4,4,4,0,2,1,2,3,1,0,7
4248,791778,5,1,1,1,1,0,0,0,0,0,1,0,1,0,1,0,2
4248,786476,11,2,4,2,4,0,0,0,0,0,2,0,0,0,0,1,4
4248,797612,3,0,0,0,0,0,0,0,0,0,0,0,0,0,1,0,0
4248,791783,5,0,1,0,0,0,1,0,0,0,0,0,1,0,0,0,0
4248,791780,13,1,3,0,0,1,3,0,0,0,2,2,0,1,1,0,3
4248,791776,15,3,4,1,1,2,3,0,0,1,0,0,1,0,1,0,8
4248,791829,17,3,8,3,7,0,1,4,5,3,1,2,2,0,4,0,10
4248,780488,12,2,4,0,1,2,3,0,0,0,0,3,1,1,0,0,6
4250,781300,22,3,6,2,5,1,1,0,0,0,3,4,3,0,2,0,7
4250,790803,14,3,5,3,5,0,0,0,0,0,1,1,1,1,0,1,6
4250,790801,19,9,11,7,9,2,2,4,4,1,5,2,1,1,1,0,24
4250,781304,22,6,7,3,3,3,4,4,4,0,1,4,2,0,2,1,19
4250,781302,21,2,4,1,3,1,1,0,0,2,2,4,2,1,1,1,5
4250,796360,13,5,7,5,6,0,1,1,1,1,2,3,1,0,0,1,11
4250,796364,10,3,3,3,3,0,0,0,0,1,2,0,1,0,1,3,6
4250,796363,15,2,3,1,1,1,2,0,0,0,3,1,0,0,2,0,5
4250,790802,12,7,8,3,3,4,5,0,0,0,1,0,1,0,0,0,18
4250,781305,15,0,0,0,0,0,0,2,2,0,1,1,0,1,0,0,2
4250,780598,20,0,3,0,1,0,2,0,0,1,3,0,2,0,0,0,0
4250,796362,5,1,1,1,1,0,0,0,0,0,1,0,1,0,1,0,2
4250,776372,3,0,0,0,0,0,0,0,0,0,0,1,0,0,1,0,0
4250,776366,3,0,0,0,0,0,0,0,0,0,0,0,0,0,0,0,0
4250,781303,6,0,0,0,0,0,0,0,0,0,0,3,0,2,0,0,0
4251,785408,34,5,11,3,7,2,4,0,0,3,3,0,1,2,3,1,12
4251,785407,17,2,4,2,4,0,0,3,3,3,1,0,4,0,1,1,7
4251,796416,22,3,11,0,6,3,5,0,0,0,3,5,0,1,2,0,9
4251,796415,25,3,10,3,5,0,5,0,0,1,0,1,3,0,0,0,6
4251,776484,32,6,12,5,9,1,3,1,2,0,1,3,1,0,1,0,14
4251,780539,17,1,3,0,0,1,3,0,0,0,0,1,0,0,2,0,3
4251,780560,23,6,8,2,3,4,5,0,0,0,2,0,2,1,1,0,16
4251,790861,11,2,3,2,2,0,1,2,2,0,0,0,1,0,1,0,6
4251,796419,5,0,1,0,1,0,0,0,0,0,0,0,0,1,0,0,0
4251,796417,11,0,0,0,0,0,0,0,1,0,0,0,0,0,0,1,0
4251,796418,3,0,0,0,0,0,0,0,0,0,0,0,0,0,0,0,0
4252,786029,24,6,7,6,7,0,0,8,9,0,8,0,3,0,3,1,20
4252,781398,27,2,3,1,1,1,2,0,0,2,5,0,0,0,1,0,5
4252,792114,39,6,15,1,3,5,12,3,5,0,4,0,0,3,0,0,20
4252,786018,28,2,9,0,2,2,7,3,5,1,2,2,1,0,0,0,9
4252,775678,28,2,8,1,3,1,5,0,0,1,2,8,1,1,3,0,5
4252,797740,19,4,8,2,5,2,3,1,1,2,3,3,0,0,1,0,11
4252,797746,7,1,3,1,3,0,0,0,3,1,2,0,2,1,1,0,2
4252,786022,16,0,1,0,1,0,0,0,0,1,2,0,1,0,0,1,0
4252,797737,6,0,1,0,1,0,0,0,0,0,2,0,0,0,1,0,0
4252,797744,6,0,0,0,0,0,0,0,0,0,0,1,1,0,0,0,0
4252,797743,0,0,0,0,0,0,0,0,0,0,0,0,0,0,0,0,0
4253,792277,2,0,1,0,1,0,0,0,0,0,0,0,0,0,0,0,0
4253,786516,30,3,9,2,4,1,5,0,0,1,5,1,4,0,0,0,7
4253,785282,19,2,6,1,2,1,4,0,0,0,2,0,0,0,2,0,5
4253,781502,33,5,12,4,5,1,7,0,0,0,3,2,2,1,0,0,11
4253,780259,36,2,15,1,8,1,7,0,0,1,6,3,3,0,3,2,5
4253,785913,27,3,8,3,8,0,0,0,0,1,4,2,3,0,1,0,6
4253,781464,25,2,7,2,3,0,4,3,3,0,2,3,2,2,0,0,7
4253,798058,2,0,1,0,1,0,0,0,0,0,0,0,0,0,0,0,0
4253,781501,26,6,10,6,8,0,2,0,0,7,2,1,2,2,2,0,12
4254,786765,30,5,11,5,10,0,1,3,4,1,4,6,2,0,2,0,13
4254,797852,33,7,10,4,5,3,5,3,7,1,4,5,2,1,3,0,20
4254,792379,33,2,6,1,2,1,4,1,2,3,6,1,1,1,2,1,6
4254,792380,38,2,13,1,4,1,9,2,2,1,2,3,0,0,2,0,7
4254,781669,36,10,15,3,7,7,8,2,2,0,2,3,1,3,1,0,29
4254,781668,8,0,0,0,0,0,0,0,0,1,1,0,0,0,0,1,0
4254,797860,2,0,0,0,0,0,0,0,0,0,0,0,0,0,1,0,0
4254,797854,16,1,2,0,0,1,2,0,0,0,4,0,2,0,0,0,3
4254,781671,4,0,0,0,0,0,0,0,0,0,0,0,2,0,1,0,0
4255,797712,25,5,8,5,8,0,0,0,0,2,1,0,2,1,2,1,10
4255,791964,31,4,8,4,5,0,3,2,4,1,6,0,3,0,3,1,10
4255,786056,30,5,8,2,5,3,3,0,0,1,4,3,2,1,2,0,13
4255,781339,36,5,5,0,0,5,5,0,0,0,9,3,2,2,3,0,15
4255,781337,34,7,16,2,6,5,10,4,4,0,1,4,2,1,2,0,23
4255,797713,6,0,0,0,0,0,0,0,2,0,1,0,0,1,0,0,0
4255,792041,9,2,3,2,3,0,0,0,0,0,2,1,4,0,1,0,4
4255,797711,20,2,6,1,3,1,3,0,0,0,0,1,3,1,0,0,5
4255,797710,9,0,3,0,1,0,2,0,0,0,1,0,0,0,0,0,0
4256,799906,35,3,6,2,3,1,3,4,5,1,7,1,3,1,0,2,11
4256,775833,20,1,3,1,2,0,1,0,0,1,8,1,3,0,1,1,2
4256,785439,34,2,6,0,1,2,5,2,2,0,3,6,2,0,3,1,8
4256,781036,37,8,14,6,10,2,4,0,1,1,4,3,2,1,3,0,18
4256,774894,35,6,15,2,7,4,8,3,3,1,4,1,1,1,2,0,19
4256,796846,2,0,1,0,1,0,0,0,0,0,1,0,0,0,0,0,0
4256,796847,20,1,4,0,1,1,3,6,8,0,1,0,2,0,1,0,9
4256,791178,6,0,1,0,1,0,0,0,0,1,0,0,0,0,0,0,0
4256,796845,11,1,1,1,1,0,0,3,4,0,1,0,0,0,0,0,5
4257,796912,27,2,7,2,4,0,3,0,0,0,1,1,5,1,0,1,4
4257,775626,25,6,11,4,9,2,2,5,10,3,5,1,3,0,3,0,19
4257,774964,20,2,8,2,7,0,1,0,0,0,3,0,1,0,1,2,4
4257,796907,32,2,5,2,4,0,1,1,2,2,6,5,1,0,0,1,5
4257,774962,35,4,12,4,8,0,4,0,0,0,3,5,2,1,2,0,8
4257,796910,15,3,5,3,5,0,0,2,4,2,2,0,1,0,2,0,8
4257,785609,6,0,2,0,2,0,0,0,0,2,0,0,0,0,1,1,0
4257,785606,8,3,4,3,4,0,0,0,0,0,0,0,2,0,0,0,6
4257,796908,3,0,0,0,0,0,0,0,0,0,0,0,0,0,0,0,0
4257,796906,11,1,2,1,1,0,1,0,0,0,1,1,1,1,0,0,2
4257,775566,18,3,9,2,4,1,5,0,1,3,1,0,2,0,0,0,7
4258,796602,10,1,2,1,2,0,0,0,2,0,0,0,1,0,0,0,2
4258,791302,32,3,7,3,6,0,1,6,13,2,2,1,5,1,4,1,12
4258,781622,27,2,3,1,1,1,2,0,0,2,1,0,3,0,0,0,5
4258,791309,35,7,18,6,17,1,1,4,6,0,0,5,5,4,4,0,19
4258,776334,26,3,7,3,6,0,1,3,4,0,0,0,2,3,3,0,9
4258,796601,29,9,19,7,15,2,4,1,3,2,5,2,3,4,3,2,21
4258,775862,12,1,5,1,5,0,0,1,2,3,2,0,3,0,0,0,3
4258,785835,10,1,1,1,1,0,0,0,0,1,0,0,0,1,1,0,2
4258,791301,17,1,5,1,4,0,1,2,4,2,6,0,1,0,2,0,4
4258,796604,2,0,0,0,0,0,0,0,0,0,1,0,2,0,0,0,0
4259,796699,16,3,3,2,2,1,1,4,7,0,8,1,4,0,1,0,11
4259,790983,32,5,7,5,6,0,1,1,2,1,3,0,2,1,2,5,11
4259,790979,25,4,8,3,4,1,4,2,2,0,4,3,4,0,1,0,11
4259,796697,34,9,22,9,18,0,4,10,12,0,5,12,3,2,5,0,28
4259,788820,34,3,6,1,1,2,5,2,2,1,3,2,2,2,1,1,10
4259,796701,14,3,3,3,3,0,0,0,0,1,0,0,4,3,4,1,6
4259,790978,26,6,10,5,6,1,4,1,1,2,2,1,1,3,4,5,14
4259,790976,16,2,3,2,2,0,1,0,0,2,3,0,3,0,1,2,4
4259,790980,3,0,0,0,0,0,0,0,0,0,1,0,0,0,1,0,0
4260,791923,16,3,6,3,6,0,0,3,4,1,4,0,3,0,0,1,9
4260,781122,21,5,8,5,8,0,0,1,5,1,11,0,3,0,0,1,11
4260,791925,33,4,8,3,6,1,2,7,8,2,3,4,4,1,5,1,16
4260,791926,29,2,13,0,1,2,12,0,0,1,3,1,3,0,0,0,6
4260,781112,18,1,2,1,2,0,0,0,0,0,0,1,0,0,2,0,2
4260,791922,8,0,1,0,0,0,1,0,0,1,1,0,2,0,0,1,0
4260,786529,4,0,2,0,2,0,0,0,0,2,0,0,0,0,1,0,0
4260,797541,10,2,2,2,2,0,0,1,2,0,1,0,0,0,0,0,5
4260,797542,22,4,9,3,7,1,2,0,0,0,2,5,0,1,3,0,9
4260,791927,25,3,8,3,7,0,1,0,2,1,3,0,4,1,2,0,6
4260,786527,14,0,3,0,1,0,2,2,2,1,0,1,1,0,2,0,2
4261,775563,28,9,18,9,17,0,1,1,4,0,6,0,4,1,1,1,19
4261,781011,20,2,4,2,4,0,0,1,2,2,5,1,4,1,1,3,5
4261,797601,36,6,15,4,6,2,9,3,5,4,7,8,0,1,1,0,17
4261,781012,36,2,9,1,4,1,5,4,4,1,1,0,1,2,1,0,9
4261,775119,29,5,12,5,9,0,3,3,5,0,4,1,2,0,4,0,13
4261,797602,11,3,4,2,2,1,2,0,0,2,1,0,2,0,1,0,7
4261,775188,9,0,1,0,1,0,0,3,4,0,0,0,1,0,0,0,3
4261,797604,19,0,0,0,0,0,0,0,0,3,5,0,1,1,1,0,0
4261,786466,12,1,3,0,1,1,2,0,0,0,0,0,1,2,1,0,3
4262,797367,16,1,1,1,1,0,0,2,4,0,3,2,1,0,0,0,4
4262,797369,27,1,6,1,2,0,4,0,0,1,1,4,3,1,1,1,2
4262,797366,24,3,4,3,4,0,0,1,2,2,1,3,0,2,0,0,7
4262,791807,27,5,12,2,6,3,6,4,4,0,5,3,1,0,2,0,17
4262,786130,24,11,14,6,7,5,7,1,1,1,9,0,2,0,3,0,28
4262,797371,10,2,2,2,2,0,0,0,0,3,3,2,3,1,3,0,4
4262,797368,9,1,1,1,1,0,0,0,0,0,2,0,1,0,0,0,2
4262,797364,8,2,2,2,2,0,0,0,0,0,0,1,4,0,1,0,4
4262,797365,19,3,8,0,1,3,7,2,2,0,3,0,1,0,3,0,11
4262,797363,21,6,12,3,5,3,7,0,0,0,3,5,5,1,2,0,15
4262,791805,5,1,2,1,2,0,0,0,0,1,0,0,1,0,1,0,2
4262,791808,10,0,1,0,1,0,0,0,0,0,1,0,1,0,0,0,0
4263,780201,32,4,8,4,8,0,0,4,5,3,4,1,2,0,1,1,12
4263,797210,25,5,7,5,7,0,0,4,7,1,3,3,3,4,3,0,14
4263,797208,28,6,13,6,11,0,2,1,3,1,3,3,3,1,4,0,13
4263,791467,30,2,10,2,7,0,3,2,4,1,0,1,2,1,1,1,6
4263,786311,28,3,9,2,6,1,3,0,0,0,0,2,1,1,1,0,7
4263,798344,18,5,6,5,5,0,1,2,2,0,3,1,1,1,3,0,12
4263,797209,1,0,0,0,0,0,0,0,0,0,0,0,1,0,1,0,0
4263,791470,18,1,3,1,3,0,0,0,5,1,3,0,0,0,0,1,2
4263,791471,1,0,0,0,0,0,0,0,0,0,0,0,0,0,0,0,0
4263,775516,19,2,3,1,1,1,2,0,0,0,1,3,2,1,1,0,5
4264,791512,21,1,2,1,2,0,0,1,2,0,2,0,4,0,4,0,3
4264,786338,34,2,10,0,3,2,7,0,0,1,12,1,3,0,6,0,6
4264,792050,28,1,5,1,1,0,4,2,2,0,4,1,3,0,0,1,4
4264,785347,19,2,4,0,1,2,3,2,2,0,0,4,1,2,3,0,8
4264,775601,38,5,13,3,6,2,7,14,15,1,0,4,2,0,1,0,26
4264,792052,21,2,4,1,1,1,3,0,0,1,1,1,4,0,0,0,5
4264,792047,25,6,8,5,6,1,2,4,5,3,6,0,0,5,2,1,17
4264,792051,14,3,6,2,2,1,4,0,0,0,1,1,1,0,0,0,7
4264,780862,0,0,0,0,0,0,0,0,0,0,0,0,0,0,0,0,0
4265,776018,24,5,8,5,8,0,0,1,2,2,2,1,3,0,1,1,11
4265,797859,23,0,3,0,2,0,1,0,1,1,1,3,0,0,2,0,0
4265,792208,16,2,4,2,3,0,1,3,8,0,2,1,5,1,3,0,7
4265,781317,30,2,5,1,2,1,3,0,0,0,5,6,1,0,1,0,5
4265,781314,34,3,6,1,1,2,5,3,3,1,3,0,3,1,3,0,11
4265,786983,1,0,0,0,0,0,0,0,0,0,0,0,0,0,0,0,0
4265,797861,20,2,8,2,6,0,2,2,2,3,5,2,4,2,4,0,6
4265,797863,14,1,4,0,3,1,1,0,0,0,0,1,4,0,2,0,3
4265,797856,6,0,1,0,1,0,0,0,0,0,1,0,3,0,0,0,0
4265,786262,32,7,14,2,3,5,11,1,3,0,3,0,2,1,0,1,20
4266,796892,18,1,6,1,6,0,0,3,4,3,6,1,1,0,1,1,5
4266,796886,35,5,7,3,5,2,2,0,0,0,2,2,2,1,1,0,12
4266,796884,35,4,14,3,7,1,7,4,4,3,5,2,4,1,2,0,13
4266,796896,27,2,8,1,4,1,4,0,1,0,4,1,4,0,2,0,5
4266,796882,34,0,8,0,4,0,4,2,6,0,1,5,0,3,0,0,2
4266,796891,24,4,10,3,8,1,2,2,4,3,2,1,4,0,1,0,11
4266,796888,2,0,1,0,0,0,1,0,0,0,0,0,1,0,0,0,0
4266,796887,19,6,12,3,8,3,4,0,0,2,2,2,2,0,0,0,15
4266,796881,6,0,0,0,0,0,0,0,0,0,1,2,2,1,0,0,0
4267,797546,16,4,9,4,9,0,0,0,1,2,2,0,1,0,1,0,8
4267,780351,33,4,10,4,10,0,0,0,0,6,6,2,1,0,0,2,8
4267,797549,36,5,8,5,8,0,0,7,10,2,4,4,3,1,1,4,17
4267,790857,20,0,8,0,2,0,6,3,4,1,3,0,1,0,3,0,3
4267,780586,30,5,12,5,11,0,1,2,2,1,5,2,4,0,2,1,12
4267,797544,24,4,7,4,6,0,1,0,0,2,3,1,3,0,1,4,8
4267,797539,8,0,1,0,1,0,0,0,0,0,2,0,0,0,0,0,0
4267,797545,15,4,6,2,3,2,3,3,4,1,3,0,5,0,1,0,13
4267,797540,18,1,3,1,2,0,1,1,2,0,3,0,1,0,0,0,3
4268,785999,38,4,7,4,7,0,0,0,0,3,3,1,1,0,1,1,8
4268,775654,30,2,3,2,3,0,0,0,0,1,4,0,2,1,2,1,4
4268,775171,20,2,6,1,3,1,3,1,2,1,1,1,2,1,1,0,6
4268,791639,37,6,11,5,10,1,1,3,4,0,2,4,2,1,3,0,16
4268,785389,36,3,14,2,8,1,6,2,2,2,2,4,3,1,5,2,9
4268,791640,10,2,3,1,1,1,2,0,0,1,2,0,1,0,0,1,5
4268,796399,15,1,2,1,2,0,0,0,0,0,2,0,1,2,1,0,2
4268,796398,14,2,5,1,3,1,2,0,2,2,1,1,1,0,0,1,5
4269,792560,27,2,5,2,5,0,0,1,2,0,4,0,3,0,0,2,5
4269,792565,30,3,8,3,8,0,0,4,5,4,4,0,2,0,5,0,10
4269,798132,10,0,1,0,0,0,1,0,0,0,0,0,0,0,0,0,0
4269,798134,24,3,7,3,5,0,2,0,0,2,1,5,3,1,0,1,6
4269,792561,27,5,8,4,6,1,2,0,0,0,2,0,1,2,1,0,11
4269,780266,24,5,13,3,9,2,4,0,0,0,3,0,1,1,1,0,12
4269,780270,26,1,6,1,5,0,1,0,0,2,1,3,1,1,1,0,2
4269,776333,7,1,2,1,2,0,0,0,0,0,0,0,0,0,0,0,2
4269,792563,12,2,2,2,2,0,0,2,2,0,0,0,0,1,2,0,6
4269,798135,2,0,0,0,0,0,0,0,0,1,0,0,0,0,0,0,0
4269,785472,7,1,1,1,1,0,0,0,0,1,1,0,0,1,0,0,2
4269,798133,3,0,0,0,0,0,0,0,0,0,0,0,0,0,0,0,0
4269,789634,1,0,0,0,0,0,0,0,0,0,0,0,0,0,0,0,0
4282,780919,20,4,6,4,6,0,0,0,1,1,2,0,3,0,0,0,8
4282,785803,23,0,2,0,1,0,1,0,0,0,2,3,1,3,0,0,0
4282,780920,31,4,8,3,6,1,2,4,5,1,1,12,1,1,2,0,13
4282,775816,20,3,6,1,2,2,4,0,0,0,1,1,3,1,0,0,8
4282,780914,31,7,12,4,7,3,5,1,1,0,1,0,2,0,2,0,18
4282,796797,28,9,13,6,10,3,3,2,2,1,10,1,2,0,1,0,23
4282,791142,20,4,5,2,2,2,3,2,2,0,1,1,0,1,0,0,12
4282,796801,4,0,1,0,1,0,0,0,0,0,0,0,1,0,1,0,0
4282,796799,8,1,2,1,1,0,1,0,1,0,1,0,1,0,1,0,2
4282,796796,7,1,4,0,2,1,2,0,0,1,3,0,2,0,0,0,3
4282,775639,2,0,0,0,0,0,0,0,0,0,0,0,0,0,0,0,0
4282,796798,1,0,1,0,1,0,0,0,0,0,0,0,0,0,0,0,0
4282,796800,1,0,0,0,0,0,0,0,0,0,0,0,0,0,0,0,0
4282,785805,2,0,0,0,0,0,0,0,0,0,0,0,0,0,0,0,0
4282,785808,1,0,0,0,0,0,0,0,0,0,0,0,0,0,0,0,0
4282,796802,1,0,0,0,0,0,0,2,2,0,1,0,1,0,0,0,2
4283,775926,33,4,11,2,5,2,6,2,4,0,4,1,1,0,2,0,12
4283,791055,20,0,2,0,1,0,1,0,0,0,3,2,0,1,4,0,0
4283,775573,23,5,8,2,5,3,3,0,0,1,3,1,1,0,1,0,13
4283,780063,25,1,4,1,3,0,1,2,2,0,1,1,4,0,1,1,4
4283,785532,23,6,7,6,7,0,0,4,5,1,3,2,2,0,1,2,16
4283,796733,7,0,1,0,1,0,0,0,0,0,0,0,0,1,0,0,0
4283,791058,13,0,0,0,0,0,0,0,0,0,2,0,0,0,1,3,0
4283,791280,23,3,7,2,4,1,3,1,1,0,1,2,5,0,3,0,8
4283,796734,18,1,4,1,1,0,3,1,2,0,3,2,0,1,0,0,3
4283,791056,6,1,2,0,0,1,2,0,1,0,1,0,1,0,1,0,3
4283,791059,7,0,1,0,1,0,0,0,0,0,0,0,0,0,0,0,0
4283,785538,1,0,1,0,1,0,0,1,2,1,1,0,0,0,0,0,1
4283,791054,1,0,1,0,1,0,0,0,0,0,0,0,0,0,0,0,0
4284,786550,34,4,11,2,7,2,4,3,4,5,4,1,3,0,2,0,13
4284,776054,29,7,11,4,7,3,4,0,0,2,9,2,3,2,0,2,17
4284,792007,31,3,8,2,5,1,3,0,0,3,2,1,1,0,0,0,7
4284,792009,28,7,14,6,13,1,1,0,0,0,2,1,3,0,0,0,15
4284,792006,19,5,8,5,8,0,0,2,2,0,2,5,0,0,0,0,12
4284,780177,13,0,2,0,2,0,0,1,2,0,2,0,3,0,1,0,1
4284,792008,7,2,3,2,3,0,0,0,0,0,1,0,3,0,0,2,4
4284,791689,9,1,3,1,1,0,2,0,0,0,0,1,0,0,0,0,2
4284,786552,11,0,2,0,1,0,1,0,0,0,3,1,0,0,0,0,0
4284,776273,19,4,7,4,7,0,0,0,0,0,3,0,2,2,0,0,8
4285,786203,30,6,10,4,5,2,5,5,6,0,3,0,0,0,0,0,19
4285,786197,20,1,7,1,6,0,1,0,0,1,1,1,1,0,1,1,2
4285,780717,24,1,7,1,5,0,2,0,0,2,5,1,1,0,2,0,2
4285,776266,23,4,8,2,5,2,3,0,0,0,1,0,1,0,0,0,10
4285,776328,26,5,8,4,4,1,4,1,2,2,2,1,0,0,0,0,12
4285,791738,12,0,0,0,0,0,0,0,0,0,4,0,2,0,1,1,0
4285,791740,13,0,1,0,0,0,1,0,0,0,2,2,1,0,2,0,0
4285,791742,29,1,7,1,2,0,5,7,8,1,3,0,1,0,2,0,9
4285,791741,16,1,6,0,3,1,3,1,2,1,2,0,0,0,1,0,4
4285,797334,4,0,0,0,0,0,0,0,0,0,0,0,2,0,0,0,0
4285,797337,3,0,0,0,0,0,0,0,0,0,0,0,0,0,0,0,0
4286,780283,18,5,9,5,9,0,0,2,2,2,4,2,2,1,1,0,12
4286,790925,24,4,7,3,4,1,3,7,7,0,4,2,0,2,1,0,16
4286,791456,29,7,14,4,8,3,6,0,0,3,2,1,3,2,1,1,17
4286,785476,28,7,8,5,6,2,2,0,0,0,3,6,1,1,2,0,16
4286,785474,19,2,6,2,6,0,0,2,2,1,0,3,1,0,0,0,6
4286,780292,20,1,4,1,4,0,0,2,2,3,4,2,2,0,5,3,4
4286,790926,21,3,7,1,4,2,3,2,2,1,1,3,0,0,0,0,10
4286,796470,16,3,4,3,3,0,1,1,1,2,3,0,3,1,2,0,7
4286,785480,17,1,1,0,0,1,1,0,0,0,1,1,0,2,0,0,3
4286,796471,2,0,0,0,0,0,0,0,2,0,1,0,1,0,0,0,0
4286,785478,4,0,1,0,1,0,0,0,0,0,0,0,1,0,0,1,0
4286,790343,2,0,0,0,0,0,0,0,0,0,1,0,0,0,0,0,0
4287,797831,24,2,5,2,2,0,3,0,0,0,1,0,3,0,1,0,4
4287,797823,15,2,3,2,2,0,1,0,0,1,1,0,2,0,3,1,4
4287,797829,16,2,2,2,2,0,0,4,6,0,1,0,0,0,1,1,8
4287,792280,21,3,5,0,0,3,5,0,0,0,0,0,1,0,2,0,9
4287,780505,36,10,17,7,12,3,5,0,0,0,3,3,1,3,3,0,23
4287,785701,19,1,4,1,4,0,0,0,1,0,2,4,1,0,2,0,2
4287,785950,13,0,3,0,1,0,2,2,2,1,1,1,0,0,1,0,2
4287,792286,13,1,2,1,2,0,0,0,0,3,0,0,3,0,1,0,2
4287,797826,23,2,6,1,5,1,1,0,0,1,4,0,1,0,3,1,5
4287,797833,17,0,3,0,1,0,2,2,2,0,1,0,2,1,0,0,2
4287,799468,3,0,0,0,0,0,0,0,0,0,0,0,1,0,0,0,0
4288,791062,38,5,13,4,10,1,3,1,2,1,6,0,2,1,4,4,12
4288,791063,18,3,5,3,5,0,0,0,2,3,6,2,4,0,1,2,6
4288,796735,9,2,3,1,1,1,2,0,0,0,0,1,2,0,0,0,5
4288,785542,38,1,1,1,1,0,0,0,1,0,5,4,3,1,2,0,2
4288,780743,36,3,5,2,4,1,1,1,2,0,1,3,1,1,5,0,8
4288,796741,2,0,0,0,0,0,0,0,0,0,0,0,0,0,0,0,0
4288,785548,22,4,8,4,7,0,1,1,2,1,5,2,3,0,1,1,9
4288,796737,10,0,3,0,3,0,0,0,0,0,0,0,1,1,1,0,0
4288,791064,27,2,6,0,1,2,5,0,1,0,2,1,1,1,3,0,6
4289,791858,29,1,4,0,2,1,2,2,5,1,2,1,4,2,2,0,5
4289,797469,24,0,5,0,4,0,1,0,0,1,2,1,2,1,2,0,0
4289,791109,33,5,13,4,12,1,1,4,4,1,3,4,5,0,4,0,15
4289,791854,32,1,5,1,4,0,1,0,0,0,2,2,0,2,1,0,2
4289,785625,38,4,11,3,7,1,4,0,2,3,2,1,1,3,2,0,9
4289,797466,28,5,11,5,9,0,2,2,2,4,8,0,1,2,1,1,12
4289,797465,16,1,5,0,1,1,4,0,0,0,2,0,1,0,1,0,3
4290,797281,29,2,7,1,3,1,4,2,2,1,3,3,2,1,2,2,7
4290,791648,31,5,11,4,8,1,3,2,2,3,1,0,1,0,0,0,13
4290,786195,31,5,7,4,6,1,1,2,5,1,10,0,4,0,3,0,13
4290,791649,33,5,7,2,2,3,5,2,2,0,6,2,2,1,0,2,15
4290,797280,28,1,4,1,2,0,2,3,4,2,0,5,3,0,1,0,5
4290,791647,7,1,1,1,1,0,0,2,4,0,0,0,1,0,1,0,4
4290,797279,17,1,3,0,0,1,3,2,2,0,1,1,2,0,2,0,5
4290,786640,17,1,1,1,1,0,0,0,0,0,1,4,1,0,1,0,2
4290,785697,7,1,2,0,0,1,2,0,0,0,1,0,1,0,1,0,3
4291,797587,16,0,2,0,2,0,0,1,2,4,2,0,3,1,0,1,1
4291,797586,24,1,3,1,3,0,0,1,2,2,2,1,1,0,2,0,3
4291,786501,26,2,9,0,5,2,4,0,0,0,0,0,3,1,1,1,6
4291,786502,39,6,19,5,15,1,4,6,9,1,9,5,2,4,4,0,19
4291,781561,21,1,5,1,4,0,1,0,0,2,1,2,3,0,0,0,2
4291,791891,18,3,4,3,4,0,0,0,0,0,0,0,5,0,0,1,6
4291,791894,6,1,1,1,1,0,0,0,0,0,1,0,1,0,0,0,2
4291,797584,19,1,2,1,2,0,0,0,0,0,1,0,0,0,0,0,2
4291,791895,25,5,9,2,5,3,4,2,4,3,0,2,1,0,2,0,15
4291,791892,1,0,0,0,0,0,0,0,0,0,0,0,0,0,0,0,0
4291,797583,5,0,0,0,0,0,0,0,0,0,0,0,1,0,0,0,0
4292,791401,27,9,16,9,16,0,0,7,14,2,2,1,4,0,1,1,25
4292,780125,34,4,7,4,6,0,1,5,9,4,6,3,3,2,1,0,13
4292,797125,27,1,3,1,2,0,1,1,1,2,1,4,3,2,1,0,3
4292,785931,23,2,5,2,3,0,2,0,0,0,3,2,5,0,2,0,4
4292,780118,28,1,5,0,2,1,3,1,2,0,1,3,3,0,1,0,4
4292,786837,22,2,5,0,0,2,5,0,0,0,2,0,2,1,1,1,6
4292,797130,2,0,1,0,0,0,1,0,0,0,0,0,1,0,0,0,0
4292,791400,33,6,15,6,10,0,5,2,3,0,7,1,5,3,1,0,14
4292,797132,4,0,0,0,0,0,0,0,0,0,0,0,1,0,0,0,0
4293,790839,26,2,3,2,2,0,1,3,4,2,4,1,4,0,0,0,7
4293,785388,31,9,15,9,15,0,0,4,9,3,7,2,4,0,2,0,22
4293,790840,27,2,6,0,3,2,3,6,6,0,6,1,3,2,3,1,12
4293,785386,32,3,5,0,1,3,4,2,2,0,2,4,1,0,1,0,11
4293,780373,25,3,6,1,2,2,4,0,0,0,1,3,5,0,1,0,8
4293,780370,13,2,3,1,1,1,2,0,0,0,5,1,2,0,3,0,5
4293,796393,9,0,4,0,4,0,0,0,1,0,0,0,2,0,1,0,0
4293,796395,21,3,4,1,2,2,2,5,7,0,2,2,3,1,3,0,13
4293,796396,7,1,1,0,0,1,1,0,0,0,2,0,0,0,0,0,3
4293,790841,9,0,0,0,0,0,0,0,2,1,1,1,0,0,0,0,0
4294,786131,33,6,12,3,8,3,4,2,4,2,7,1,1,1,1,2,17
4294,780904,16,2,3,2,3,0,0,1,1,0,3,1,5,2,2,0,5
4294,797688,23,6,11,2,3,4,8,1,2,0,2,2,4,0,2,0,17
4294,786145,19,0,6,0,3,0,3,0,0,0,3,1,1,0,1,0,0
4294,786128,36,4,15,4,12,0,3,3,4,3,4,10,4,2,6,0,11
4294,792100,8,1,1,1,1,0,0,2,2,0,2,1,1,1,0,0,4
4294,785884,21,4,10,4,9,0,1,6,6,3,4,1,3,1,1,0,14
4294,797685,29,6,14,3,8,3,6,6,7,0,2,1,2,2,1,0,21
4294,792096,2,0,0,0,0,0,0,0,0,0,0,0,0,0,0,0,0
4294,797686,10,0,0,0,0,0,0,0,0,0,0,0,1,0,0,0,0
4294,797684,3,0,0,0,0,0,0,0,0,0,0,0,0,0,0,0,0
4295,791023,33,2,4,2,3,0,1,4,8,2,5,0,3,3,1,5,8
4295,791027,32,7,12,6,8,1,4,5,6,5,3,2,4,1,3,0,20
4295,791024,37,8,16,5,9,3,7,5,7,1,6,3,2,1,7,0,24
4295,781507,20,1,2,1,1,0,1,0,0,0,6,1,3,0,2,0,2
4295,777572,31,4,13,4,9,0,4,6,7,1,3,3,3,1,3,0,14
4295,791028,10,0,1,0,0,0,1,1,2,1,5,0,1,0,1,0,1
4295,796685,23,2,10,0,2,2,8,2,2,0,2,0,1,0,1,0,8
4295,796684,14,2,5,1,3,1,2,0,0,0,2,0,4,2,1,0,5
4296,781533,25,3,5,3,3,0,2,0,0,0,3,1,4,0,1,0,6
4296,780840,24,0,1,0,1,0,0,1,2,1,2,2,5,2,2,0,1
4296,797845,16,2,5,1,2,1,3,0,0,1,0,0,2,1,1,0,5
4296,797851,29,2,11,0,1,2,10,1,2,0,1,2,2,0,0,0,7
4296,792395,40,9,19,7,15,2,4,5,5,4,3,1,3,0,6,1,25
4296,792388,11,2,2,2,2,0,0,2,3,2,3,0,5,1,1,0,6
4296,792396,6,1,1,1,1,0,0,0,0,0,0,0,0,0,1,0,2
4296,792393,32,4,10,3,9,1,1,5,6,1,1,5,3,2,3,0,14
4296,786115,6,0,2,0,1,0,1,0,0,0,1,0,2,0,0,0,0
4296,781541,11,0,1,0,1,0,0,0,0,0,1,1,2,3,3,0,0
4297,775556,36,10,17,7,11,3,6,4,7,2,6,1,1,5,2,1,27
4297,780234,37,4,7,2,5,2,2,9,12,4,6,1,2,2,2,3,19
4297,786405,32,1,4,1,2,0,2,0,3,1,4,2,1,0,10,0,2
4297,786411,25,2,6,1,4,1,2,4,6,2,3,1,4,1,1,0,9
4297,780046,30,1,4,0,1,1,3,6,6,0,1,6,4,0,2,0,9
4297,781110,21,1,1,1,1,0,0,2,5,2,1,2,5,1,2,0,4
4297,797185,18,3,9,2,5,1,4,0,0,2,3,1,1,3,1,0,7
4297,786328,1,0,0,0,0,0,0,0,0,0,0,0,0,0,0,0,0
4298,791266,2,0,0,0,0,0,0,1,2,0,0,0,0,0,0,0,1
4298,785977,30,7,9,5,5,2,4,0,0,1,2,1,1,1,0,1,16
4298,791270,19,0,0,0,0,0,0,0,0,0,2,0,2,1,0,0,0
4298,791265,37,5,12,2,6,3,6,1,2,1,2,6,2,2,1,0,14
4298,785685,33,5,20,1,10,4,10,1,4,0,4,3,2,0,3,0,15
4298,796524,15,3,4,3,4,0,0,1,2,0,2,1,1,1,1,2,7
4298,796523,7,1,1,1,1,0,0,0,0,1,1,0,0,0,0,0,2
4298,796522,19,4,5,0,1,4,4,0,0,0,0,3,3,0,0,0,12
4298,796525,3,0,1,0,1,0,0,0,0,0,1,0,0,0,0,0,0
4298,791271,13,2,3,2,3,0,0,0,0,1,0,1,5,0,0,2,4
4298,781313,12,0,2,0,2,0,0,5,5,1,0,0,0,0,0,0,5
4298,797879,10,1,4,0,1,1,3,0,0,0,0,1,0,0,2,1,3
4299,776253,29,10,18,9,14,1,4,3,4,4,5,3,3,0,2,0,24
4299,775651,25,2,5,2,4,0,1,1,2,1,3,1,1,0,1,0,5
4299,791070,20,2,5,1,2,1,3,2,2,0,2,1,4,0,3,1,7
4299,791627,29,4,8,3,7,1,1,2,3,0,4,4,3,0,3,0,11
4299,785665,34,4,9,1,2,3,7,0,0,0,3,1,0,1,1,0,11
4299,791071,5,0,2,0,2,0,0,1,2,1,1,2,0,0,1,0,1
4299,785660,9,1,1,1,1,0,0,0,0,1,1,0,0,0,0,0,2
4299,796504,3,0,0,0,0,0,0,0,0,0,0,0,0,0,0,0,0
4299,796502,1,1,1,1,1,0,0,0,0,0,0,0,0,0,0,0,2
4299,796501,17,3,4,1,2,2,2,0,0,4,3,0,0,0,2,0,8
4299,776178,28,2,7,2,7,0,0,6,8,6,3,0,2,0,2,0,10
4300,797482,32,7,14,5,12,2,2,4,4,0,6,0,2,1,3,0,20
4300,797485,26,1,6,0,2,1,4,1,2,0,1,2,3,1,0,1,4
4300,797480,19,2,7,2,6,0,1,1,2,1,1,1,2,1,1,1,5
4300,797479,20,0,5,0,2,0,3,0,0,0,0,0,0,0,0,0,0
4300,785944,27,3,10,3,6,0,4,5,5,2,1,4,1,0,1,0,11
4300,797483,11,0,0,0,0,0,0,0,0,0,2,0,1,1,1,0,0
4300,786579,1,0,0,0,0,0,0,0,0,0,0,0,0,0,0,0,0
4300,797481,20,2,3,2,3,0,0,6,6,0,6,2,2,1,2,0,10
4300,797478,16,2,4,1,1,1,3,4,4,1,2,2,1,1,0,0,9
4300,791873,17,0,1,0,0,0,1,2,2,0,0,0,2,0,2,0,2
4300,781217,11,1,3,1,2,0,1,0,0,0,1,0,0,0,0,0,2
4301,791750,22,0,0,0,0,0,0,0,0,3,8,5,4,0,2,3,0
4301,786177,21,2,8,1,1,1,7,0,0,1,3,1,1,0,3,1,5
4301,780244,31,4,7,1,1,3,6,0,0,0,4,2,1,0,1,0,11
4301,786179,32,5,12,2,5,3,7,0,0,1,5,0,4,2,3,0,13
4301,780238,35,12,19,9,12,3,7,1,1,1,1,2,2,0,2,0,28
4301,791749,3,0,0,0,0,0,0,0,0,0,1,0,0,0,0,0,0
4301,791752,6,1,1,1,1,0,0,0,0,1,0,0,0,0,0,0,2
4301,785909,12,3,6,3,6,0,0,1,2,4,4,0,3,0,1,1,7
4301,791748,2,0,2,0,0,0,2,0,0,0,0,0,0,0,0,0,0
4301,790773,20,3,8,0,0,3,8,2,3,0,4,0,5,1,0,0,11
4301,781500,16,1,2,1,1,0,1,0,0,0,1,1,2,2,1,0,2
4302,791352,10,0,2,0,1,0,1,0,0,0,0,0,0,0,1,0,0
4302,780455,22,7,8,7,8,0,0,3,5,1,4,0,1,1,0,2,17
4302,797251,30,5,9,5,7,0,2,0,0,1,6,5,2,1,1,0,10
4302,797247,26,0,2,0,2,0,0,0,0,0,2,3,3,0,1,0,0
4302,776297,38,7,11,5,7,2,4,5,6,2,6,3,2,2,5,0,21
4302,791354,13,0,1,0,1,0,0,3,6,0,1,0,0,0,2,0,3
4302,785837,20,3,10,2,6,1,4,1,2,2,4,1,2,1,0,0,8
4302,797249,23,2,6,1,3,1,3,1,2,0,2,2,1,1,0,0,6
4302,797248,18,0,2,0,0,0,2,0,0,0,0,2,2,0,4,0,0
4302,786227,0,0,0,0,0,0,0,0,0,0,0,0,0,0,0,0,0
4303,797821,13,0,5,0,3,0,2,0,0,0,1,0,2,0,0,0,0
4303,792186,22,4,7,4,7,0,0,1,3,2,1,0,4,1,2,0,9
4303,797816,32,5,11,4,8,1,3,0,0,0,3,2,3,2,1,0,11
4303,792188,34,9,14,6,9,3,5,3,3,1,5,1,2,1,1,0,24
4303,792183,37,5,13,4,9,1,4,4,6,1,7,2,2,1,4,0,15
4303,797820,16,1,2,1,2,0,0,0,0,0,1,0,0,1,0,0,2
4303,781447,4,0,1,0,1,0,0,1,2,0,0,1,4,0,0,0,1
4303,781490,28,0,3,0,0,0,3,0,0,2,2,1,1,0,3,0,0
4303,786675,11,1,1,1,1,0,0,0,0,0,1,1,0,2,0,0,2
4303,792187,3,0,0,0,0,0,0,0,0,0,0,0,0,0,0,0,0
4303,797819,0,0,0,0,0,0,0,0,0,0,0,0,0,0,0,0,0
4303,796255,0,0,0,0,0,0,0,0,0,0,0,0,0,0,0,0,0
4304,790799,28,3,3,3,3,0,0,0,0,2,8,1,3,2,2,0,6
4304,790798,36,8,16,8,15,0,1,4,8,4,3,4,2,1,2,1,20
4304,780140,37,7,13,1,2,6,11,3,3,0,8,1,1,1,2,0,23
4304,796355,25,8,13,7,9,1,4,1,1,0,3,3,3,2,4,0,18
4304,780137,27,5,7,3,4,2,3,7,10,3,3,2,4,4,0,0,19
4304,790796,3,0,1,0,1,0,0,0,0,1,1,0,1,0,0,0,0
4304,785245,23,1,3,1,2,0,1,2,3,0,2,4,4,1,3,0,4
4304,775553,13,1,3,1,1,0,2,0,0,0,2,3,1,0,4,0,2
4304,796359,4,1,3,1,2,0,1,1,2,1,0,0,1,0,0,0,3
4304,799892,2,0,1,0,1,0,0,0,0,0,1,0,0,0,0,0,0
4304,796354,2,0,1,0,1,0,0,0,0,0,0,0,1,0,0,0,0
4305,786566,34,5,13,3,7,2,6,2,2,1,3,0,3,2,2,1,14
4305,781204,20,4,7,1,2,3,5,0,0,1,3,0,4,0,1,1,11
4305,786568,12,2,6,2,6,0,0,0,0,0,5,0,0,0,0,2,4
4305,791993,24,3,6,3,6,0,0,3,4,0,0,2,3,2,3,0,9
4305,781188,31,2,10,2,7,0,3,5,8,0,3,7,3,3,6,0,9
4305,781189,24,3,4,2,2,1,2,0,0,1,2,0,3,0,1,0,7
4305,786563,7,0,1,0,1,0,0,0,0,0,1,1,2,1,1,0,0
4305,797493,14,0,1,0,1,0,0,0,0,0,2,0,3,1,0,0,0
4305,797494,14,3,7,3,5,0,2,3,4,0,1,1,0,1,1,0,9
4305,786562,9,2,2,1,1,1,1,2,2,0,2,0,1,0,0,0,7
4305,791997,11,0,2,0,2,0,0,0,0,1,0,0,2,0,1,0,0
4306,781579,29,2,7,2,6,0,1,0,0,0,4,3,2,2,1,2,4
4306,786731,33,7,11,7,10,0,1,0,0,5,11,1,3,3,4,1,14
4306,798023,28,2,6,1,3,1,3,0,0,0,4,3,2,1,6,1,5
4306,781584,34,5,11,1,1,4,10,2,2,0,2,2,2,0,1,0,16
4306,780347,34,1,4,1,2,0,2,0,0,0,5,2,0,1,2,0,2
4306,775696,11,2,4,0,2,2,2,0,0,0,0,0,0,1,0,0,6
4306,776481,7,0,0,0,0,0,0,0,0,0,0,1,3,1,0,0,0
4306,798008,16,2,7,1,4,1,3,0,0,0,2,4,0,1,0,0,5
4306,792358,8,2,3,1,2,1,1,0,0,0,1,0,0,0,1,0,5
4307,786157,25,6,9,6,9,0,0,1,2,3,6,1,1,3,5,2,13
4307,780676,26,4,11,3,9,1,2,1,2,0,2,2,2,0,5,0,10
4307,791756,27,1,6,0,4,1,2,2,2,0,5,2,1,2,1,0,5
4307,780677,34,3,10,1,4,2,6,0,0,0,3,1,1,3,0,0,8
4307,780673,27,1,4,0,0,1,4,0,0,1,1,2,1,1,0,0,3
4307,791754,5,0,2,0,1,0,1,0,0,0,1,0,0,0,0,0,0
4307,786150,20,1,4,1,2,0,2,0,1,2,0,0,2,0,2,0,2
4307,775533,12,1,5,1,2,0,3,2,2,2,2,0,1,1,1,0,4
4307,797348,3,0,0,0,0,0,0,0,0,0,0,0,1,0,2,0,0
4307,780992,21,0,3,0,2,0,1,0,0,0,2,2,0,0,0,0,0
4308,797343,11,0,2,0,2,0,0,0,0,0,2,0,0,0,0,0,0
4308,791743,22,1,5,1,5,0,0,0,0,1,1,0,3,0,6,0,2
4308,797340,29,3,12,2,6,1,6,0,0,1,4,1,0,3,2,0,7
4308,791747,34,12,26,6,13,6,13,5,6,3,2,0,1,0,2,0,35
4308,791746,30,0,4,0,3,0,1,0,0,1,4,2,0,2,0,1,0
4308,797342,24,1,1,1,1,0,0,0,1,1,4,2,3,1,2,1,2
4308,791744,3,0,1,0,1,0,0,0,0,0,1,0,1,0,1,0,0
4308,797341,22,1,4,0,1,1,3,0,0,0,0,0,3,0,2,0,3
4308,786193,25,4,9,4,7,0,2,0,0,1,1,0,0,0,0,0,8
4309,791144,17,4,4,4,4,0,0,0,0,0,2,0,1,1,2,1,8
4309,785782,23,3,6,2,2,1,4,0,0,0,2,0,1,1,0,0,7
4309,791145,28,5,10,3,6,2,4,5,5,3,11,3,0,1,4,0,17
4309,791146,30,5,11,3,5,2,6,2,2,0,5,5,1,1,0,0,14
4309,785777,29,7,11,3,3,4,8,0,0,0,0,1,4,2,1,0,18
4309,791147,18,2,6,1,4,1,2,0,0,2,3,1,1,0,2,0,5
4309,796804,16,2,5,1,1,1,4,0,0,1,1,3,1,1,1,0,5
4309,791148,21,6,9,6,7,0,2,1,1,0,6,1,1,2,2,0,13
4309,786748,17,1,2,0,0,1,2,0,0,0,1,2,5,0,1,0,3
4309,796803,1,0,0,0,0,0,0,0,0,0,0,0,0,0,0,0,0
4310,790854,20,3,4,3,4,0,0,0,0,0,4,0,3,1,0,0,6
4310,796404,24,3,6,3,6,0,0,0,0,0,1,1,0,1,3,2,6
4310,785434,15,2,5,1,2,1,3,2,2,1,1,1,4,0,1,0,7
4310,781164,24,2,6,1,3,1,3,2,2,2,2,4,1,1,1,0,7
4310,781163,32,5,13,5,9,0,4,3,7,0,3,5,1,4,1,0,13
4310,790849,25,4,9,2,5,2,4,0,0,0,2,3,2,0,1,0,10
4310,790853,10,0,2,0,2,0,0,0,0,0,1,0,5,0,2,2,0
4310,790850,23,5,13,4,7,1,6,1,1,2,2,1,0,1,1,0,12
4310,790848,12,1,2,1,1,0,1,0,0,0,2,0,5,0,0,0,2
4310,796406,2,0,0,0,0,0,0,0,0,1,1,0,0,0,2,0,0
4310,781223,8,0,1,0,0,0,1,0,0,0,0,1,0,0,0,0,0
4310,790852,5,0,0,0,0,0,0,1,2,0,0,0,1,0,0,0,1
4311,796334,28,6,11,5,10,1,1,2,3,2,3,2,1,0,3,1,15
4311,790776,17,1,2,1,2,0,0,4,5,4,6,0,2,1,0,3,6
4311,796330,30,10,12,4,5,6,7,5,6,2,6,0,1,1,1,1,31
4311,785813,34,3,11,3,8,0,3,2,2,0,4,9,2,5,1,0,8
4311,796337,25,2,3,2,3,0,0,2,2,0,0,5,2,0,0,0,6
4311,785827,21,10,12,10,12,0,0,5,7,2,3,0,4,1,1,1,25
4311,779975,9,1,3,1,3,0,0,0,0,1,1,0,0,0,1,0,2
4311,796332,24,1,3,1,1,0,2,0,1,0,4,5,2,0,3,0,2
4311,796333,7,1,3,0,0,1,3,0,0,0,1,0,1,0,0,0,3
4311,796335,3,0,1,0,0,0,1,0,0,0,0,0,0,0,0,0,0
4311,796338,2,0,0,0,0,0,0,0,0,0,0,0,0,0,0,0,0
4322,790920,36,6,14,4,11,2,3,6,8,1,3,2,1,0,4,0,20
4322,796468,30,3,5,2,3,1,2,5,7,0,3,4,1,3,1,0,12
4322,780995,36,2,4,1,2,1,2,0,1,0,13,3,3,2,3,1,5
4322,785930,27,2,6,2,6,0,0,2,3,3,2,0,4,0,2,0,6
4322,780996,27,4,10,2,4,2,6,0,1,0,3,1,0,1,0,1,10
4322,775709,30,2,4,0,0,2,4,0,0,0,2,3,1,0,2,0,6
4322,796467,11,1,5,0,0,1,5,0,0,2,1,1,0,0,1,0,3
4322,785492,3,0,1,0,1,0,0,0,0,1,0,0,0,0,0,0,0
4323,785470,37,1,9,1,6,0,3,2,2,1,3,7,4,1,3,0,4
4323,791099,37,7,12,4,8,3,4,0,2,1,3,2,3,0,1,1,17
4323,785586,27,2,5,0,1,2,4,0,0,0,10,0,2,0,1,0,6
4323,780315,21,1,3,1,1,0,2,3,4,1,0,2,2,0,4,0,5
4323,790846,30,2,7,2,7,0,0,2,2,4,4,1,3,3,2,1,6
4323,796755,7,0,3,0,3,0,0,0,0,1,2,0,1,0,0,0,0
4323,796754,32,6,14,4,10,2,4,3,3,1,2,1,2,2,2,0,17
4323,780814,6,0,3,0,3,0,0,0,0,1,0,1,0,0,0,0,0
4323,780795,3,0,2,0,0,0,2,0,0,0,1,0,2,0,0,0,0
4324,775606,21,3,5,3,5,0,0,0,0,2,4,3,3,0,2,1,6
4324,791672,27,3,6,3,6,0,0,2,2,2,2,1,4,0,1,1,8
4324,780552,23,9,13,2,3,7,10,0,0,0,4,1,0,1,1,2,25
4324,780550,17,5,8,5,7,0,1,0,0,2,1,7,1,0,0,0,10
4324,780538,22,0,2,0,1,0,1,0,0,0,4,1,1,3,4,0,0
4324,797424,6,0,0,0,0,0,0,0,2,0,0,0,0,0,1,1,0
4324,785791,20,4,6,0,0,4,6,0,0,0,4,1,1,0,0,0,12
4324,785793,8,0,0,0,0,0,0,0,0,0,0,0,0,0,0,2,0
4324,791674,25,5,7,5,6,0,1,4,5,1,3,4,3,0,3,0,14
4324,785787,13,4,9,2,4,2,5,0,0,0,3,0,2,0,1,0,10
4324,785790,4,0,2,0,0,0,2,0,0,0,0,0,0,1,0,0,0
4324,791765,3,1,1,1,1,0,0,0,0,0,0,1,0,1,0,0,2
4324,797423,4,0,1,0,1,0,0,1,2,1,0,0,1,0,0,0,1
4324,797425,4,1,1,1,1,0,0,0,0,1,2,0,1,0,0,0,2
4324,800021,3,1,2,1,2,0,0,0,0,0,0,1,1,0,0,0,2
4325,796766,18,0,7,0,3,0,4,0,1,1,1,0,0,0,2,0,0
4325,791113,23,1,4,1,3,0,1,0,0,1,4,0,1,1,1,0,2
4325,780813,21,2,4,1,3,1,1,0,0,0,1,0,3,1,2,0,5
4325,796765,31,2,9,2,7,0,2,1,3,5,1,2,2,1,2,0,5
4325,780812,33,5,16,3,9,2,7,8,10,1,6,2,1,1,6,1,20
4325,785614,17,2,5,2,5,0,0,2,4,2,0,0,3,1,0,1,6
4325,796767,12,1,3,1,2,0,1,0,0,0,1,0,1,0,4,0,2
4325,791111,23,2,5,1,4,1,1,3,4,2,1,2,0,0,0,0,8
4325,785618,18,2,5,0,2,2,3,0,0,0,1,0,0,0,0,0,6
4325,800004,4,0,1,0,0,0,1,0,0,0,0,0,1,0,0,0,0
4326,792351,33,5,7,5,5,0,2,1,1,1,6,1,3,3,0,0,11
4326,786724,15,0,4,0,1,0,3,2,2,0,3,1,1,1,1,0,2
4326,786723,35,6,15,6,13,0,2,10,12,1,7,5,3,1,4,0,22
4326,798060,34,2,3,2,2,0,1,3,4,2,4,4,4,0,1,1,7
4326,792352,20,2,5,1,3,1,2,4,4,0,0,2,4,0,1,0,9
4326,792349,24,5,7,5,7,0,0,2,4,0,4,0,3,0,1,4,12
4326,792355,24,5,9,2,2,3,7,3,3,0,2,2,1,1,3,0,16
4326,798061,8,0,1,0,1,0,0,0,0,1,1,0,4,0,3,1,0
4326,792348,6,0,0,0,0,0,0,0,0,2,1,1,0,0,0,0,0
4326,786726,1,0,0,0,0,0,0,0,0,0,0,0,0,0,0,0,0
4327,792143,21,1,4,0,1,1,3,0,0,1,1,1,2,1,0,0,3
4327,797753,31,4,13,0,5,4,8,5,6,0,4,2,5,1,4,1,17
4327,786293,27,3,5,2,4,1,1,2,2,1,3,2,5,1,0,1,9
4327,780953,31,3,5,3,5,0,0,5,9,1,1,3,3,0,4,0,11
4327,797750,30,0,4,0,4,0,0,2,2,1,4,2,2,1,3,0,2
4327,786302,5,0,2,0,2,0,0,0,0,1,0,0,2,0,0,0,0
4327,780955,25,4,11,1,5,3,6,8,11,1,4,2,5,3,2,0,19
4327,797742,9,1,1,1,1,0,0,0,0,0,0,0,1,0,0,0,2
4327,792147,2,0,0,0,0,0,0,0,0,0,1,0,0,0,0,0,0
4327,797751,11,0,1,0,1,0,0,0,0,0,1,0,1,0,0,0,0
4327,797748,7,1,2,1,2,0,0,0,0,0,0,0,1,0,1,1,2
4327,786301,1,0,0,0,0,0,0,0,0,0,0,0,0,0,0,0,0
4328,785948,15,2,5,2,5,0,0,0,2,0,1,0,1,1,0,0,4
4328,792020,33,4,16,3,10,1,6,1,2,3,2,5,0,3,4,0,10
4328,785941,31,1,7,0,2,1,5,2,2,0,1,2,1,1,0,0,5
4328,785939,35,5,15,2,7,3,8,8,9,0,3,5,3,0,1,0,21
4328,785938,37,7,15,1,3,6,12,0,2,1,4,2,1,1,2,0,20
4328,792026,20,2,2,2,2,0,0,1,2,2,5,1,0,1,1,0,5
4328,792025,5,0,1,0,1,0,0,0,0,1,3,0,1,0,0,0,0
4328,785946,24,1,2,0,0,1,2,0,0,1,5,0,2,0,1,1,3
4329,780023,33,4,6,4,6,0,0,0,0,1,9,0,2,0,2,1,8
4329,792493,38,5,13,2,5,3,8,0,0,0,4,1,1,2,2,1,13
4329,792495,40,13,20,10,13,3,7,5,5,1,7,3,0,1,6,0,34
4329,792491,31,2,4,2,3,0,1,0,0,0,5,5,2,1,1,0,4
4329,781144,27,1,9,0,3,1,6,0,0,0,4,3,4,0,1,0,3
4329,792492,7,1,3,0,1,1,2,0,0,1,2,0,0,0,0,0,3
4329,786832,24,1,3,1,2,0,1,2,2,0,1,1,4,0,1,1,4
4330,785459,15,5,9,5,9,0,0,0,0,2,1,0,3,1,0,1,10
4330,789101,27,3,3,2,2,1,1,7,9,0,2,3,2,0,1,0,14
4330,789102,33,6,9,6,7,0,2,1,1,0,8,5,3,1,5,0,13
4330,781371,15,0,5,0,2,0,3,0,0,1,1,1,2,1,2,1,0
4330,781367,25,3,9,3,5,0,4,3,3,1,3,0,1,1,1,0,9
4330,797731,12,3,4,3,4,0,0,1,2,0,4,0,2,0,1,0,7
4330,792066,22,1,2,1,1,0,1,2,2,1,2,0,3,0,0,1,4
4330,797730,3,1,3,0,0,1,3,0,0,0,0,0,0,0,0,0,3
4330,792064,9,0,1,0,0,0,1,0,0,0,0,0,1,0,0,0,0
4330,792063,15,1,3,1,3,0,0,0,0,3,2,1,4,2,1,0,2
4330,792061,6,0,1,0,1,0,0,0,0,0,1,0,1,0,1,0,0
4330,788037,18,4,8,2,3,2,5,0,1,0,4,0,3,0,2,1,10
4331,797174,23,1,4,1,3,0,1,0,0,2,1,1,4,0,1,0,2
4331,791510,24,1,4,1,3,0,1,2,4,1,6,0,3,0,0,0,4
4331,786699,25,3,6,3,6,0,0,1,2,4,3,2,2,1,2,0,7
4331,785593,29,3,11,2,6,1,5,1,1,0,2,0,1,2,3,0,8
4331,775357,25,2,10,1,3,1,7,6,10,0,1,1,5,2,4,0,11
4331,791507,15,3,7,3,7,0,0,0,0,2,1,0,2,0,2,0,6
4331,797168,29,4,8,3,6,1,2,6,7,0,3,1,1,1,2,0,15
4331,791504,27,2,7,1,6,1,1,3,4,3,4,1,0,0,0,1,8
4331,791505,3,0,0,0,0,0,0,0,0,0,0,0,1,0,1,0,0
4332,797824,22,1,3,1,2,0,1,0,0,0,3,1,0,0,1,0,2
4332,797825,7,0,0,0,0,0,0,0,0,0,0,0,5,0,2,0,0
4332,797822,20,4,12,1,5,3,7,0,0,0,5,0,2,0,2,0,11
4332,792190,24,2,4,2,3,0,1,0,0,0,1,6,1,3,2,0,4
4332,786664,28,1,12,0,5,1,7,4,4,1,2,1,0,2,2,0,7
4332,797828,2,0,0,0,0,0,0,0,0,0,0,0,1,0,0,0,0
4332,792192,15,2,4,2,4,0,0,1,2,4,5,1,1,0,3,0,5
4332,775116,24,7,8,2,2,5,6,0,0,1,1,2,3,1,0,0,19
4332,799164,1,0,0,0,0,0,0,0,0,0,0,0,0,0,0,0,0
4332,792193,18,3,8,3,8,0,0,0,0,1,2,1,0,1,2,1,6
4332,792191,17,1,1,1,1,0,0,3,4,0,2,1,0,1,0,0,5
4332,791928,13,1,1,0,0,1,1,0,2,0,3,1,1,0,2,0,3
4332,781266,9,1,4,0,0,1,4,2,2,0,0,0,1,0,0,0,5
4333,785305,20,1,1,1,1,0,0,3,4,0,3,0,0,0,1,0,5
4333,796623,27,3,9,3,6,0,3,4,4,2,4,5,2,0,4,0,10
4333,790990,24,6,9,3,3,3,6,0,0,0,4,1,2,0,0,0,15
4333,789219,23,5,11,1,3,4,8,0,0,0,1,3,3,2,0,0,14
4333,785059,24,6,8,6,6,0,2,2,2,0,1,5,1,7,2,0,14
4333,796624,7,0,2,0,2,0,0,0,0,0,1,1,1,1,1,0,0
4333,790989,9,0,2,0,0,0,2,1,2,1,3,1,0,0,0,0,1
4333,782133,6,2,3,1,1,1,2,0,0,0,0,0,0,0,1,0,5
4333,796622,14,3,5,3,5,0,0,2,3,1,3,1,3,0,0,0,8
4333,790988,16,2,6,1,3,1,3,0,0,1,1,1,1,2,2,0,5
4333,785303,12,3,4,1,1,2,3,0,0,0,3,1,0,0,0,0,8
4333,785122,18,1,3,0,0,1,3,0,0,1,2,3,0,0,0,0,3
4334,785740,15,3,6,3,6,0,0,2,3,6,5,2,4,0,1,0,8
4334,785809,28,2,8,2,6,0,2,0,1,3,6,5,3,1,5,0,4
4334,780530,31,5,11,5,10,0,1,1,3,1,8,3,2,0,3,4,11
4334,797402,27,5,10,2,5,3,5,0,0,0,4,0,1,1,2,0,13
4334,785738,31,6,10,4,7,2,3,5,5,0,4,4,2,0,1,0,19
4334,797396,12,0,1,0,1,0,0,0,0,0,0,1,1,0,1,2,0
4334,797401,0,0,0,0,0,0,0,0,0,0,0,0,0,0,0,0,0
4334,786144,23,2,4,1,1,1,3,2,3,0,0,1,1,1,1,0,7
4334,797399,25,4,5,2,2,2,3,2,3,0,3,2,0,1,1,1,12
4334,791664,6,1,3,0,0,1,3,0,0,0,0,1,0,0,0,0,3
4334,780526,2,0,1,0,0,0,1,0,0,0,1,0,0,0,0,0,0
4335,792593,27,4,13,4,12,0,1,6,7,1,8,0,3,1,3,1,14
4335,792594,22,0,1,0,0,0,1,2,2,0,2,1,4,1,3,2,2
4335,792588,32,1,7,0,1,1,6,3,5,0,1,0,1,2,0,0,6
4335,792595,31,7,13,6,11,1,2,2,2,0,1,0,2,4,3,0,17
4335,792583,26,0,5,0,2,0,3,0,0,0,1,2,2,2,1,1,0
4335,796989,13,3,5,2,3,1,2,0,1,2,5,0,1,0,0,0,7
4335,796987,18,4,10,4,8,0,2,0,0,1,1,2,3,1,2,0,8
4335,792591,24,1,2,0,1,1,1,0,0,0,1,0,1,1,0,0,3
4335,792582,3,0,0,0,0,0,0,0,0,0,0,0,0,0,0,0,0
4335,792586,4,0,0,0,0,0,0,0,0,0,1,1,2,0,0,0,0
4336,797380,14,1,5,0,2,1,3,0,0,2,1,1,2,0,0,0,3
4336,789043,28,5,10,5,10,0,0,5,7,5,14,0,3,0,1,0,15
4336,797377,29,1,3,1,1,0,2,2,2,0,2,5,2,3,4,2,4
4336,791818,33,6,22,4,12,2,10,1,2,3,4,1,0,4,2,2,15
4336,780646,28,4,8,2,3,2,5,2,2,0,0,1,2,0,2,0,12
4336,797382,21,3,7,3,5,0,2,2,3,1,6,1,4,1,0,2,8
4336,797379,12,1,2,1,2,0,0,1,1,1,4,1,0,0,0,0,3
4336,797375,4,0,0,0,0,0,0,0,0,0,0,0,0,0,0,0,0
4336,797381,3,0,0,0,0,0,0,0,0,0,0,0,1,0,1,0,0
4336,797378,24,1,4,1,4,0,0,0,0,0,0,1,1,0,3,0,2
4336,797376,4,0,0,0,0,0,0,3,5,0,1,0,0,0,0,0,3
4337,791097,24,3,6,3,5,0,1,0,1,2,2,0,1,0,1,1,6
4337,785577,19,0,3,0,3,0,0,0,0,0,4,0,3,0,4,3,0
4337,791091,27,3,6,3,5,0,1,2,2,2,1,2,4,0,0,0,8
4337,791093,28,4,12,2,9,2,3,1,2,0,3,1,1,3,1,0,11
4337,785569,21,2,10,1,4,1,6,0,0,0,1,1,2,0,2,0,5
4337,791089,7,0,1,0,1,0,0,0,0,0,2,0,0,0,1,1,0
4337,791092,6,1,1,0,0,1,1,1,2,0,1,0,2,0,0,0,4
4337,796753,25,2,7,1,2,1,5,3,4,0,4,0,2,1,2,0,8
4337,796752,19,0,6,0,4,0,2,2,2,1,3,0,1,0,2,0,2
4337,791094,24,2,9,2,5,0,4,0,0,2,5,0,3,1,2,0,4
4338,775747,16,2,9,2,7,0,2,1,2,6,3,1,2,0,2,0,5
4338,786578,9,0,0,0,0,0,0,0,1,0,1,0,0,0,0,0,0
4338,797358,25,1,8,1,4,0,4,2,2,2,4,2,4,1,3,1,4
4338,785669,23,3,6,2,4,1,2,2,2,0,3,0,1,1,4,0,9
4338,775195,14,0,8,0,1,0,7,2,2,2,0,0,2,0,1,0,2
4338,786136,16,2,7,1,3,1,4,3,4,3,4,0,4,0,1,0,8
4338,797357,22,3,3,1,1,2,2,1,2,1,0,1,3,1,0,0,9
4338,786138,16,0,4,0,2,0,2,2,2,1,1,0,2,0,3,0,2
4338,785416,28,6,10,5,9,1,1,3,7,1,3,1,2,1,1,0,16
4338,776236,23,3,8,3,6,0,2,2,2,0,3,0,3,1,2,0,8
4338,797359,4,0,0,0,0,0,0,0,0,0,1,0,0,0,0,0,0
4338,786140,2,0,0,0,0,0,0,0,2,0,0,0,1,0,0,0,0
4338,797362,1,0,0,0,0,0,0,0,0,0,0,0,0,0,1,0,0
4338,791802,1,0,0,0,0,0,0,0,0,0,0,0,0,0,1,0,0
4339,785800,22,3,9,2,4,1,5,0,0,3,2,1,4,0,2,0,7
4339,785799,19,3,4,3,4,0,0,2,2,2,7,1,3,1,2,0,8
4339,791676,22,4,9,3,3,1,6,0,0,0,1,3,5,1,0,0,9
4339,780554,26,4,8,1,5,3,3,2,4,0,2,2,0,2,1,0,13
4339,780553,28,5,11,5,8,0,3,8,14,2,6,2,1,2,4,0,18
4339,797426,6,1,1,1,1,0,0,2,4,0,1,0,0,0,0,1,4
4339,791678,8,1,1,1,1,0,0,0,0,0,1,0,2,0,0,1,2
4339,785807,13,0,1,0,0,0,1,0,0,0,1,1,2,0,0,0,0
4339,780760,17,3,5,1,1,2,4,0,0,0,5,1,3,0,0,5,8
4339,797427,21,4,9,1,1,3,8,2,2,0,2,0,0,0,2,0,13
4339,791677,14,2,4,1,3,1,1,0,0,0,2,4,2,1,0,0,5
4339,785804,1,0,0,0,0,0,0,0,0,0,0,0,0,0,0,0,0
4339,790964,1,0,0,0,0,0,0,0,0,0,0,0,0,0,0,0,0
4339,797428,2,0,0,0,0,0,0,0,0,0,0,0,0,0,0,0,0
4340,776209,38,8,11,8,11,0,0,3,6,2,8,1,3,0,3,0,19
4340,796938,36,2,9,0,4,2,5,10,12,2,6,4,1,1,1,0,16
4340,791237,29,3,9,1,3,2,6,5,7,0,2,0,0,2,3,0,13
4340,791351,22,1,6,1,3,0,3,0,0,0,1,1,1,1,0,1,2
4340,791238,14,0,1,0,0,0,1,1,2,0,4,1,0,0,2,0,1
4340,781227,7,0,1,0,0,0,1,1,1,0,1,0,0,1,1,0,1
4340,791235,28,5,8,5,8,0,0,3,3,4,6,0,1,1,4,2,13
4340,791236,17,0,0,0,0,0,0,0,0,0,2,0,3,0,1,1,0
4340,791240,9,1,2,1,1,0,1,0,0,0,0,1,0,0,1,0,2
4342,791652,27,5,6,5,6,0,0,5,8,4,7,2,4,1,3,4,15
4342,786495,18,0,2,0,2,0,0,6,6,0,9,2,3,0,2,0,6
4342,797285,10,0,2,0,0,0,2,0,0,0,0,0,2,0,1,0,0
4342,791650,17,4,8,4,8,0,0,0,0,0,3,0,4,1,1,1,8
4342,776384,37,1,6,1,4,0,2,4,4,0,4,7,2,2,5,0,6
4342,791653,27,5,8,2,3,3,5,0,1,3,4,0,1,0,0,0,13
4342,775705,8,0,0,0,0,0,0,0,1,1,1,0,2,0,0,1,0
4342,797289,2,0,0,0,0,0,0,0,0,0,0,0,0,0,1,0,0
4342,797286,28,7,13,4,6,3,7,2,2,1,1,2,0,1,2,0,19
4342,797283,25,1,7,1,1,0,6,2,2,0,0,0,0,0,2,0,4
4342,791654,1,0,0,0,0,0,0,0,0,0,0,0,0,0,0,0,0
4343,790784,19,0,3,0,2,0,1,0,0,1,3,0,2,2,2,0,0
4343,786548,22,4,9,4,9,0,0,0,1,0,2,0,4,1,1,4,8
4343,797475,25,1,5,0,2,1,3,3,4,0,2,1,4,0,2,0,6
4343,786229,27,0,3,0,0,0,3,0,0,0,3,1,1,0,0,0,0
4343,775229,35,8,21,6,15,2,6,5,6,6,8,1,2,2,3,0,23
4343,776219,15,1,2,0,0,1,2,1,2,2,1,0,1,1,0,0,4
4343,786235,16,1,2,1,2,0,0,1,4,3,0,0,2,0,1,0,3
4343,786770,20,7,14,4,7,3,7,0,0,0,0,0,2,0,1,0,17
4343,786719,3,0,0,0,0,0,0,0,1,1,0,0,0,2,0,0,0
4343,781518,18,1,4,1,4,0,0,1,2,1,3,1,4,1,4,0,3
4344,775324,14,4,5,4,5,0,0,0,0,2,3,0,1,0,0,2,8
4344,791223,22,3,10,3,9,0,1,1,4,2,1,2,3,1,0,0,7
4344,791224,30,7,20,6,14,1,6,3,5,1,3,2,1,2,3,0,18
4344,785564,32,5,8,2,3,3,5,0,0,0,4,3,0,2,3,0,13
4344,781181,36,0,10,0,0,0,10,1,3,1,5,1,2,0,3,0,1
4344,796927,18,1,3,0,1,1,2,0,0,1,1,0,4,0,0,2,3
4344,791811,15,1,2,1,2,0,0,1,2,5,3,0,1,0,1,0,3
4344,796929,18,3,5,1,1,2,4,0,0,0,0,3,1,0,0,0,8
4344,796926,13,0,2,0,2,0,0,0,0,0,0,0,1,1,0,0,0
4344,796928,2,0,0,0,0,0,0,0,0,0,0,0,0,0,0,0,0
4345,797292,25,9,11,9,11,0,0,2,2,2,7,0,1,0,3,0,20
4345,780509,25,6,8,3,5,3,3,0,0,3,3,1,1,0,1,0,15
4345,797290,30,4,9,2,4,2,5,4,5,0,4,1,0,0,0,0,14
4345,797291,25,3,4,2,2,1,2,3,4,0,1,5,0,2,1,1,10
4345,786064,29,2,9,1,3,1,6,5,6,1,2,0,3,1,1,0,10
4345,791658,12,0,2,0,2,0,0,2,4,1,5,0,0,1,0,0,2
4345,791663,4,1,1,1,1,0,0,0,0,0,0,0,0,0,1,0,2
4345,791661,3,1,2,0,1,1,1,0,0,1,1,0,0,0,0,0,3
4345,785658,15,2,4,2,3,0,1,1,1,2,2,4,1,2,0,1,5
4345,797295,5,0,2,0,1,0,1,0,0,0,1,0,1,0,0,0,0
4345,797294,1,0,0,0,0,0,0,0,0,0,0,1,0,0,0,0,0
4345,791660,26,2,5,1,3,1,2,1,2,0,5,4,4,1,3,0,6
4346,781650,20,4,10,4,10,0,0,0,0,0,0,0,4,0,1,0,8
4346,797070,20,1,5,1,2,0,3,0,0,0,2,1,2,0,0,0,2
4346,791432,34,3,8,1,5,2,3,0,0,0,2,2,4,1,0,0,8
4346,777865,27,6,12,4,9,2,3,2,2,0,5,3,3,0,4,0,16
4346,791429,28,2,6,2,4,0,2,0,1,0,5,1,1,0,3,0,4
4346,797066,17,3,4,3,4,0,0,3,6,2,4,1,1,1,1,2,9
4346,780180,19,1,4,1,3,0,1,3,4,1,0,0,1,1,0,3,5
4346,797067,17,1,2,1,2,0,0,0,0,0,3,0,1,1,0,0,2
4346,776079,18,0,2,0,1,0,1,0,0,0,2,2,3,0,1,1,0
4347,786509,30,4,6,4,6,0,0,1,1,1,6,2,2,0,1,0,9
4347,786508,33,2,11,1,7,1,4,7,10,2,7,2,3,3,1,1,12
4347,786505,31,2,3,0,0,2,3,4,4,0,3,4,2,0,0,0,10
4347,785796,32,6,11,3,7,3,4,2,4,2,2,1,1,1,3,0,17
4347,797576,30,6,10,2,3,4,7,2,2,1,2,2,3,0,1,0,18
4347,797579,2,1,1,0,0,1,1,0,0,0,0,0,0,0,0,0,3
4347,797577,5,0,1,0,1,0,0,0,0,0,0,1,3,0,0,0,0
4347,786511,2,0,1,0,0,0,1,0,0,0,0,0,1,0,0,0,0
4347,797582,4,0,1,0,1,0,0,0,0,0,3,0,0,0,1,0,0
4347,797580,1,0,0,0,0,0,0,0,0,0,0,0,0,0,0,0,0
4347,797578,2,0,2,0,2,0,0,0,0,0,0,0,0,0,0,0,0
4347,791896,2,0,0,0,0,0,0,0,0,0,0,0,0,0,0,0,0
4347,791897,11,0,1,0,1,0,0,0,0,0,3,1,1,0,0,0,0
4347,781325,15,1,4,0,0,1,4,2,2,0,1,2,2,0,2,0,5
4348,776205,24,4,8,1,3,3,5,4,5,0,4,0,4,1,0,0,15
4348,791245,31,3,12,3,6,0,6,3,4,0,5,4,2,2,0,0,9
4348,781243,38,3,8,3,6,0,2,3,4,2,8,4,2,0,2,3,9
4348,791243,12,0,3,0,2,0,1,0,0,1,1,0,1,0,1,0,0
4348,781244,23,7,15,5,12,2,3,9,9,3,4,0,4,0,3,0,25
4348,791241,17,3,4,3,4,0,0,0,0,2,2,0,5,1,2,0,6
4348,791246,13,2,5,2,3,0,2,0,0,0,0,3,0,0,0,1,4
4348,785529,12,1,3,1,2,0,1,0,0,0,3,1,0,0,2,0,2
4348,781237,29,1,2,0,0,1,2,2,2,0,2,2,1,3,3,0,5
4348,796943,1,0,0,0,0,0,0,0,0,0,0,0,0,0,0,0,0
4349,786728,34,3,10,3,9,0,1,6,9,3,2,4,4,1,4,2,12
4349,780892,36,4,10,1,3,3,7,0,0,1,3,4,2,0,2,0,11
4349,785904,25,4,10,1,3,3,7,2,2,0,4,1,3,0,1,0,13
4349,786091,36,7,18,7,11,0,7,0,0,4,7,0,4,0,1,1,14
4349,775738,14,1,4,1,2,0,2,1,2,3,3,1,2,0,1,0,3
4349,786350,1,1,1,1,1,0,0,0,0,0,0,0,2,0,0,0,2
4349,797669,5,0,2,0,1,0,1,0,1,0,2,0,1,0,0,0,0
4349,786788,9,1,2,1,1,0,1,1,2,0,2,1,1,1,1,0,3
4349,786096,24,2,9,1,2,1,7,0,0,0,4,0,3,0,4,0,5
4349,781030,16,0,1,0,0,0,1,0,0,0,0,0,0,1,1,0,0
4349,792087,0,0,0,0,0,0,0,0,0,0,0,0,0,0,0,0,0
4350,790893,24,6,9,5,8,1,1,5,9,1,2,4,3,1,1,0,18
4350,796444,27,6,10,6,9,0,1,5,7,4,2,3,1,1,1,2,17
4350,786615,24,4,8,2,3,2,5,4,4,1,6,2,1,0,3,0,14
4350,786732,19,2,4,2,3,0,1,5,7,1,3,3,2,1,1,0,9
4350,775260,26,4,6,2,2,2,4,0,0,1,2,3,1,2,0,0,10
4350,790890,14,1,3,1,3,0,0,1,1,0,0,2,2,0,1,0,3
4350,790889,20,0,3,0,2,0,1,4,4,1,4,2,0,1,0,0,4
4350,780702,16,2,6,0,0,2,6,0,0,0,1,0,0,1,2,0,6
4350,775536,18,5,10,5,10,0,0,2,5,2,3,1,4,2,1,0,12
4350,796445,6,1,2,1,2,0,0,0,0,2,1,0,0,0,0,0,2
4350,799891,5,0,0,0,0,0,0,0,0,0,0,0,2,0,0,0,0
4350,791501,1,0,0,0,0,0,0,0,0,0,0,0,0,0,0,0,0
4351,786772,28,4,7,4,7,0,0,2,3,2,6,3,3,0,0,0,10
4351,781484,23,3,6,3,5,0,1,3,4,4,1,2,2,0,3,2,9
4351,786769,27,4,7,2,3,2,4,1,2,0,4,2,4,1,2,0,11
4351,786024,34,6,14,2,6,4,8,0,0,1,3,2,4,1,3,0,16
4351,780002,26,2,11,1,6,1,5,0,0,1,3,3,1,1,6,0,5
4351,785441,14,2,4,1,3,1,1,3,4,0,0,0,2,0,2,0,8
4351,791970,19,0,4,0,2,0,2,2,2,0,2,0,2,1,0,0,2
4351,790823,24,1,4,0,2,1,2,2,2,0,0,1,4,1,0,0,5
4351,786773,5,0,1,0,1,0,0,2,2,1,1,0,1,0,0,1,2
4352,786257,29,3,13,2,10,1,3,1,4,0,4,1,2,1,2,1,8
4352,786263,23,3,10,2,5,1,5,2,2,1,4,0,1,0,0,0,9
4352,797724,17,0,1,0,0,0,1,0,0,1,2,0,0,0,1,0,0
4352,785661,34,4,7,4,5,0,2,0,1,1,2,1,3,0,1,0,8
4352,775825,40,5,11,5,7,0,4,2,2,0,2,4,1,1,4,1,12
4352,792121,18,1,1,0,0,1,1,0,0,1,4,1,2,2,0,1,3
4352,786249,27,3,6,0,0,3,6,3,3,1,3,0,5,1,1,0,12
4352,797725,9,0,1,0,1,0,0,0,1,0,3,0,3,0,0,0,0
4352,797721,2,0,0,0,0,0,0,0,0,0,0,0,0,0,0,0,0
4352,792356,1,0,0,0,0,0,0,0,0,0,0,0,0,0,0,0,0
4353,785126,17,2,3,2,2,0,1,0,0,0,6,0,2,0,0,0,4
4353,779857,21,4,11,4,8,0,3,1,2,1,3,1,3,0,0,2,9
4353,791014,31,3,5,2,4,1,1,0,0,0,3,0,2,0,0,0,7
4353,779976,29,6,10,6,9,0,1,2,2,0,2,2,2,2,0,0,14
4353,774990,26,3,8,3,6,0,2,3,4,1,0,3,2,3,2,0,9
4353,796673,14,3,6,3,5,0,1,2,2,1,0,0,0,0,2,0,8
4353,796674,21,1,2,1,2,0,0,2,2,2,7,0,1,0,0,0,4
4353,781586,21,2,7,2,6,0,1,0,1,2,3,0,3,2,3,0,4
4353,785961,12,0,2,0,2,0,0,1,2,0,1,0,0,0,1,0,1
4353,785339,8,1,2,1,2,0,0,0,0,0,0,0,0,0,0,1,2
4360,791585,20,3,6,2,3,1,3,2,4,0,2,3,1,1,1,0,9
4360,780062,11,5,7,5,7,0,0,3,4,1,3,1,2,0,1,0,13
4360,791581,23,4,6,2,2,2,4,1,1,0,3,6,1,0,0,0,11
4360,786394,26,6,11,2,4,4,7,5,6,0,6,3,1,1,2,0,21
4360,780404,25,3,4,2,2,1,2,4,5,0,2,5,1,0,2,0,11
4360,799920,13,4,6,2,2,2,4,0,0,0,4,0,1,0,1,0,10
4360,797042,8,0,0,0,0,0,0,1,2,0,3,0,2,0,1,0,1
4360,785228,20,2,3,2,3,0,0,1,1,0,5,0,0,1,0,0,5
4360,791582,12,1,3,1,1,0,2,2,5,0,2,1,1,0,3,2,4
4360,797040,2,0,0,0,0,0,0,2,2,0,0,1,1,0,0,0,2
4360,797041,21,1,2,1,2,0,0,3,4,0,3,5,3,0,4,1,5
4360,797037,11,2,3,1,1,1,2,0,0,0,2,0,0,0,0,0,5
4360,789071,2,1,2,0,0,1,2,0,0,0,0,0,2,0,0,0,3
4360,780403,6,0,0,0,0,0,0,0,0,0,3,2,0,0,0,0,0
4362,796860,32,7,10,7,10,0,0,0,1,3,7,2,3,1,2,1,14
4362,791185,26,2,9,1,3,1,6,2,2,1,3,0,4,0,1,1,7
4362,775208,16,2,4,2,4,0,0,0,0,0,0,0,0,1,0,0,4
4362,785650,34,3,5,1,1,2,4,0,1,0,3,3,3,2,0,2,8
4362,785649,32,8,20,5,13,3,7,8,10,1,1,2,4,0,2,0,27
4362,791183,15,2,6,2,6,0,0,5,7,4,1,0,0,0,1,1,9
4362,796861,29,4,6,2,3,2,3,2,2,0,4,1,2,0,2,0,12
4362,796857,9,1,3,0,2,1,1,0,0,0,2,0,1,0,1,0,3
4362,791184,7,0,3,0,2,0,1,0,0,0,1,1,0,0,0,0,0
4363,786547,24,1,2,0,0,1,2,0,0,1,1,1,3,1,1,1,3
4363,786544,21,4,7,3,6,1,1,2,2,2,6,0,5,1,0,1,11
4363,797507,27,2,5,2,5,0,0,2,3,2,5,0,1,0,2,0,6
4363,792012,40,13,30,11,22,2,8,6,6,1,4,5,3,0,3,0,34
4363,775084,29,3,6,1,3,2,3,6,6,0,1,1,1,0,1,0,14
4363,797512,4,0,2,0,2,0,0,0,0,0,1,0,1,0,0,0,0
4363,786860,22,5,7,3,4,2,3,0,0,0,3,0,1,0,0,1,12
4363,797509,3,0,0,0,0,0,0,0,0,0,1,0,2,0,1,0,0
4363,792013,7,1,1,1,1,0,0,0,0,0,2,0,1,0,0,0,2
4363,786546,23,2,2,1,1,1,1,1,2,0,3,3,2,0,1,0,6
4364,791839,33,3,4,3,4,0,0,0,1,7,5,8,0,1,1,0,6
4364,785322,31,2,5,1,1,1,4,0,0,1,4,0,3,0,3,1,5
4364,792381,33,4,15,0,3,4,12,2,3,0,1,3,1,0,2,0,14
4364,791842,36,7,21,0,4,7,17,2,2,2,7,1,0,2,0,0,23
4364,786616,32,6,14,5,9,1,5,1,2,3,2,6,1,2,0,0,14
4364,797444,3,1,1,1,1,0,0,0,0,1,0,0,0,0,0,0,2
4364,786613,6,1,3,0,0,1,3,2,2,0,2,0,2,1,1,0,5
4364,776341,16,0,0,0,0,0,0,0,2,1,0,0,1,1,0,1,0
4364,786736,10,0,2,0,1,0,1,0,0,0,1,1,1,1,1,0,0
4365,786542,20,0,6,0,3,0,3,2,4,2,3,3,3,2,1,0,2
4365,786540,23,5,7,5,7,0,0,0,0,1,6,0,2,1,2,1,10
4365,792019,33,3,8,3,5,0,3,2,2,2,5,2,3,0,2,0,8
4365,792015,36,7,12,3,6,4,6,0,0,0,3,3,2,2,2,0,18
4365,775995,36,2,10,2,5,0,5,2,2,0,4,3,1,0,3,0,6
4365,785364,21,6,10,6,10,0,0,3,4,2,4,0,1,0,3,0,15
4365,797515,1,0,1,0,0,0,1,0,0,0,0,0,0,0,0,0,0
4365,792016,19,0,0,0,0,0,0,0,0,0,1,0,1,0,0,0,0
4365,791845,7,0,1,0,0,0,1,0,0,0,0,1,2,0,0,1,0
4365,797514,1,0,0,0,0,0,0,0,0,0,0,0,0,0,0,0,0
4365,781147,2,0,0,0,0,0,0,0,0,0,0,0,0,0,0,0,0
4365,797513,1,0,0,0,0,0,0,0,0,0,0,0,0,0,0,0,0
4366,786131,18,3,10,3,7,0,3,0,1,2,4,0,3,0,0,0,6
4366,780904,16,0,2,0,2,0,0,1,2,1,1,1,4,0,0,1,1
4366,797688,25,1,7,1,5,0,2,0,0,0,2,0,1,0,0,0,2
4366,786145,26,3,8,0,0,3,8,0,0,0,4,3,2,1,1,1,9
4366,786128,36,8,16,8,14,0,2,2,2,1,4,3,2,5,4,0,18
4366,792100,18,4,6,4,6,0,0,1,1,5,3,0,3,0,1,1,9
4366,785884,25,5,10,5,9,0,1,2,3,4,4,0,3,1,0,0,12
4366,797685,26,1,9,1,6,0,3,0,0,1,0,2,3,0,1,0,2
4366,797686,9,2,3,2,2,0,1,0,0,0,0,1,1,1,1,0,4
4366,792096,1,0,2,0,0,0,2,0,0,0,0,0,0,0,0,0,0
4367,791023,33,3,7,3,7,0,0,3,5,3,17,0,3,0,2,3,9
4367,791027,33,1,8,0,6,1,2,4,6,1,1,3,0,1,3,0,7
4367,791024,39,3,11,1,6,2,5,8,8,0,4,3,0,2,2,0,16
4367,781507,10,0,2,0,2,0,0,1,2,3,1,0,3,0,1,0,1
4367,777572,35,7,12,3,6,4,6,4,4,2,4,2,2,2,4,0,22
4367,791028,11,1,2,1,1,0,1,0,0,0,0,1,2,0,0,0,2
4367,796685,33,4,12,1,2,3,10,0,0,1,1,1,0,0,0,0,11
4367,796684,6,2,2,2,2,0,0,0,0,0,0,0,3,0,1,0,4
4368,776100,28,1,3,1,2,0,1,1,2,3,5,2,3,0,4,1,3
4368,785991,34,8,19,7,15,1,4,4,4,8,11,0,3,0,4,5,21
4368,781401,34,6,9,5,6,1,3,9,9,0,3,0,2,4,3,1,22
4368,781406,30,4,12,4,11,0,1,0,0,0,3,4,0,0,2,0,8
4368,797762,24,2,5,2,4,0,1,2,2,0,5,1,2,1,4,1,6
4368,792133,19,2,5,2,4,0,1,2,2,1,0,2,0,0,1,0,6
4368,781029,14,2,2,0,0,2,2,0,0,0,1,1,1,0,1,0,6
4368,775317,9,1,1,0,0,1,1,1,2,0,1,1,2,0,0,0,4
4368,797760,7,2,3,1,1,1,2,0,0,1,1,0,0,0,0,0,5
4368,797758,1,0,0,0,0,0,0,0,0,0,0,0,0,0,0,0,0
4369,775515,29,7,11,2,4,5,7,0,0,0,3,0,1,2,0,2,19
4369,797047,8,2,4,1,2,1,2,0,0,0,1,1,4,0,0,1,5
4369,791579,36,4,7,3,4,1,3,0,1,2,5,9,3,2,1,0,9
4369,780399,32,3,13,2,8,1,5,0,2,3,1,5,2,1,2,1,7
4369,786387,40,8,19,7,16,1,3,0,0,4,1,3,0,0,4,1,17
4369,786846,20,3,6,2,2,1,4,0,0,0,4,0,2,2,3,0,7
4369,791575,10,1,4,1,4,0,0,0,0,1,1,1,2,0,0,2,2
4369,780400,13,2,3,1,1,1,2,0,0,0,1,1,3,0,2,0,5
4369,791577,4,0,0,0,0,0,0,0,0,0,1,0,0,0,1,0,0
4369,797046,8,0,4,0,2,0,2,2,2,1,0,0,1,1,0,0,2
4370,780494,27,8,14,5,8,3,6,4,7,2,6,1,5,4,3,2,23
4370,780495,35,5,21,3,12,2,9,9,11,2,0,1,2,2,4,2,21
4370,780496,33,3,9,1,4,2,5,8,11,0,5,3,3,2,1,0,16
4370,780497,36,4,10,3,8,1,2,2,3,2,6,5,3,1,0,2,11
4370,797276,17,2,5,2,3,0,2,0,0,0,4,1,4,3,1,0,4
4370,785692,28,2,4,1,2,1,2,2,2,1,4,7,2,0,3,1,7
4370,785693,14,1,4,1,4,0,0,0,0,3,6,1,1,0,2,1,2
4370,785644,15,2,9,1,4,1,5,1,2,0,0,0,0,0,1,0,6
4370,791643,6,1,2,1,1,0,1,0,0,0,1,0,0,0,1,0,2
4370,797274,8,0,3,0,3,0,0,0,0,2,1,0,2,1,1,0,0
4370,797277,3,0,0,0,0,0,0,0,0,0,1,0,0,0,0,0,0
4370,797275,3,0,0,0,0,0,0,0,0,0,1,0,1,0,0,0,0
4371,797460,34,7,12,4,6,3,6,0,0,0,1,0,4,1,3,1,17
4371,780377,35,4,9,2,5,2,4,8,11,0,14,1,2,1,2,1,18
4371,791852,30,2,2,2,2,0,0,3,4,1,8,0,4,2,2,4,7
4371,786600,35,5,14,5,11,0,3,4,6,0,4,6,4,4,9,0,14
4371,786601,30,5,10,2,3,3,7,1,2,0,0,1,5,1,6,1,14
4371,791853,13,1,1,1,1,0,0,0,0,0,5,0,3,0,1,0,2
4371,797459,10,0,4,0,4,0,0,1,2,0,1,3,1,1,1,0,1
4371,786599,9,1,7,0,2,1,5,0,0,1,1,0,0,0,0,0,3
4371,786602,3,0,1,0,1,0,0,0,0,0,1,0,1,0,0,0,0
4371,797461,3,0,0,0,0,0,0,0,0,0,0,0,0,0,0,0,0
4371,786604,0,0,0,0,0,0,0,0,0,0,0,0,0,0,0,0,0
4371,791851,23,2,5,2,4,0,1,0,0,0,5,2,4,2,3,0,4
4372,797239,32,5,11,5,8,0,3,0,0,0,4,2,2,3,3,0,10
4372,797235,25,4,8,4,8,0,0,1,2,2,3,0,1,0,1,1,9
4372,797232,33,2,7,1,3,1,4,0,0,0,4,0,1,0,2,1,5
4372,791367,15,1,3,1,2,0,1,1,3,1,3,1,1,1,2,0,3
4372,797234,14,0,3,0,0,0,3,1,2,0,1,0,2,0,3,0,1
4372,797237,22,2,2,2,2,0,0,0,0,0,3,1,1,1,2,0,4
4372,791368,16,1,3,0,1,1,2,1,2,0,2,0,0,0,2,0,4
4372,797236,3,0,1,0,0,0,1,3,4,1,0,0,0,0,0,0,3
4372,785446,10,1,4,1,4,0,0,0,0,1,1,1,0,0,1,0,2
4372,797238,6,1,1,1,1,0,0,0,1,0,1,0,0,0,0,0,2
4372,786535,12,0,4,0,2,0,2,0,2,1,1,0,1,0,3,1,0
4372,797233,9,0,1,0,0,0,1,0,0,1,0,0,1,0,0,1,0
4372,797240,3,0,1,0,0,0,1,0,0,0,0,0,0,1,0,0,0
4373,791786,33,9,13,8,11,1,2,0,0,0,2,2,2,0,0,1,19
4373,791787,29,4,7,3,6,1,1,0,0,2,1,0,2,2,3,0,9
4373,789048,27,4,11,4,11,0,0,0,0,3,5,3,2,0,4,0,8
4373,789046,17,2,8,0,3,2,5,0,0,0,4,1,2,0,0,0,6
4373,789041,10,0,5,0,2,0,3,0,0,0,1,0,1,0,0,0,0
4373,797629,11,2,3,2,3,0,0,2,2,0,2,0,1,0,0,0,6
4373,789044,11,1,4,0,1,1,3,2,2,0,3,0,1,2,0,0,5
4373,797630,19,2,5,2,3,0,2,0,0,1,0,0,2,2,1,0,4
4373,785540,10,1,1,1,1,0,0,2,2,1,4,0,2,0,0,1,4
4373,799762,3,1,2,0,0,1,2,0,0,0,1,0,1,0,0,0,3
4373,791785,18,1,3,1,3,0,0,0,0,0,4,1,1,0,0,0,2
4373,797631,8,0,0,0,0,0,0,0,0,0,2,0,0,0,2,0,0
4373,797632,3,0,0,0,0,0,0,0,0,1,0,0,0,0,0,0,0
4373,797633,1,0,0,0,0,0,0,0,0,0,0,0,0,0,0,0,0
4374,789101,26,2,4,2,2,0,2,8,8,0,4,1,2,1,1,0,12
4374,785459,16,5,7,5,7,0,0,2,2,0,4,0,1,2,0,0,12
4374,789102,30,3,9,3,6,0,3,0,0,0,6,7,3,2,4,1,6
4374,781371,24,2,6,0,2,2,4,0,0,3,2,1,0,3,2,0,6
4374,781367,17,0,1,0,0,0,1,0,0,1,2,2,0,2,1,0,0
4374,788037,19,3,10,2,5,1,5,8,9,0,8,4,1,1,2,0,15
4374,792064,10,2,6,0,0,2,6,0,0,0,2,0,1,0,0,0,6
4374,792066,20,2,3,2,3,0,0,1,2,2,1,0,1,0,1,2,5
4374,792063,14,2,3,1,2,1,1,0,0,0,0,1,1,1,1,0,5
4374,797730,4,1,1,0,0,1,1,0,0,0,0,0,1,0,0,0,3
4374,792061,10,0,1,0,0,0,1,0,0,0,0,1,0,0,0,0,0
4374,797731,6,0,1,0,1,0,0,0,0,0,0,0,2,0,1,0,0
4374,781362,2,0,0,0,0,0,0,0,0,0,0,0,0,0,0,0,0
4374,789982,1,0,0,0,0,0,0,0,0,0,0,0,0,0,0,0,0
4374,797729,1,0,0,0,0,0,0,0,0,0,0,0,0,0,0,0,0
4375,775357,38,5,11,1,1,4,10,1,3,0,6,1,2,1,3,0,15
4375,797174,28,2,5,1,3,1,2,0,0,0,3,2,2,0,1,0,5
4375,791510,22,1,5,1,2,0,3,0,0,2,1,0,1,0,1,0,2
4375,786699,14,1,3,1,3,0,0,0,0,0,0,0,1,0,2,0,2
4375,785593,13,1,4,1,2,0,2,0,0,0,1,0,0,0,0,1,2
4375,791507,19,5,5,5,5,0,0,1,2,1,2,0,4,0,2,2,11
4375,797168,21,3,9,3,7,0,2,2,2,0,3,2,2,1,3,0,8
4375,791504,27,2,8,2,7,0,1,0,0,0,1,0,2,3,4,0,4
4375,791509,7,0,0,0,0,0,0,1,2,0,2,0,1,2,0,0,1
4375,791505,11,0,1,0,0,0,1,0,0,1,2,0,2,0,1,0,0
4376,786519,26,5,5,5,5,0,0,1,1,2,5,0,2,1,1,0,11
4376,797555,31,3,9,3,5,0,4,0,0,1,2,1,2,1,3,0,6
4376,797556,36,8,13,4,6,4,7,0,1,1,1,2,0,0,2,0,20
4376,791913,28,1,3,1,1,0,2,0,2,0,0,4,4,0,1,0,2
4376,786520,34,6,15,6,10,0,5,7,9,3,6,1,2,0,4,0,19
4376,791912,10,0,1,0,1,0,0,0,0,0,2,0,0,0,0,1,0
4376,797558,14,4,5,2,2,2,3,1,3,1,1,1,4,0,1,0,11
4376,797559,12,0,1,0,0,0,1,0,0,1,1,1,2,0,1,0,0
4376,797557,6,0,1,0,0,0,1,0,0,2,0,0,1,1,1,0,0
4376,797560,3,0,0,0,0,0,0,0,0,0,1,0,0,0,0,0,0
4377,775110,33,2,7,2,7,0,0,1,2,5,2,2,2,0,1,0,5
4377,780128,35,5,12,4,6,1,6,7,8,0,3,1,2,1,4,0,18
4377,785936,24,2,5,2,4,0,1,2,4,5,0,1,3,3,0,0,6
4377,791392,37,2,4,2,3,0,1,2,3,0,5,3,2,2,1,0,6
4377,775458,35,10,21,4,14,6,7,1,3,1,1,2,2,2,3,0,27
4377,797135,16,3,7,1,4,2,3,2,2,2,0,0,4,0,0,0,10
4377,797140,3,0,0,0,0,0,0,0,0,0,0,0,0,0,0,0,0
4377,797138,3,0,0,0,0,0,0,0,0,0,0,1,0,0,0,0,0
4377,785264,10,1,1,1,1,0,0,0,0,0,0,2,1,2,0,0,2
4377,797134,2,0,1,0,1,0,0,0,0,0,0,0,0,0,0,0,0
4377,786062,2,0,0,0,0,0,0,0,0,0,0,0,0,0,0,0,0
4378,786792,25,3,3,3,3,0,0,0,1,1,7,0,0,0,1,0,6
4378,781497,15,1,2,1,2,0,0,0,0,0,2,0,0,0,1,1,2
4378,789020,35,6,7,1,2,5,5,2,4,0,6,1,1,2,2,0,19
4378,786787,37,10,16,5,7,5,9,1,1,0,3,8,1,1,8,0,26
4378,774954,15,0,2,0,2,0,0,2,2,1,1,2,0,2,0,0,2
4378,786795,16,1,2,0,0,1,2,0,0,0,1,1,4,2,3,0,3
4378,796876,2,0,0,0,0,0,0,0,0,0,1,0,0,0,1,0,0
4378,792414,27,5,8,1,1,4,7,1,1,0,1,1,1,2,0,0,15
4378,791961,2,1,1,1,1,0,0,0,0,0,0,0,0,0,0,0,2
4378,792091,24,4,6,2,3,2,3,1,2,2,3,2,0,2,3,1,11
4378,796875,2,0,0,0,0,0,0,0,0,0,0,0,1,0,0,0,0
4379,796657,22,1,1,1,1,0,0,0,0,2,2,2,2,1,1,0,2
4379,796651,12,1,2,0,0,1,2,0,0,0,2,0,3,1,2,0,3
4379,791323,23,1,3,0,0,1,3,0,0,0,3,3,0,1,2,1,3
4379,791320,24,3,11,1,6,2,5,0,0,0,2,5,2,3,4,0,8
4379,781511,33,6,13,1,3,5,10,0,0,0,0,5,0,2,1,0,17
4379,796650,24,4,6,3,4,1,2,0,0,1,0,0,0,0,0,0,9
4379,796656,7,1,2,1,2,0,0,0,0,0,0,0,0,0,1,0,2
4379,796653,15,2,4,1,2,1,2,0,0,1,1,0,3,0,0,1,5
4379,792257,8,1,3,1,3,0,0,0,0,0,1,0,1,1,2,0,2
4379,796654,4,0,0,0,0,0,0,0,0,0,0,0,1,0,0,0,0
4379,791321,7,0,0,0,0,0,0,0,0,0,0,0,0,0,0,0,0
4379,785912,21,3,11,0,3,3,8,1,2,1,2,2,2,0,3,0,10
4380,791062,32,7,11,6,7,1,4,6,8,0,6,1,3,1,0,1,21
4380,791063,29,3,9,2,7,1,2,6,7,1,3,4,4,2,2,0,13
4380,796735,27,3,5,3,4,0,1,2,2,0,3,1,2,2,2,1,8
4380,785542,36,1,2,1,2,0,0,0,0,0,2,1,2,3,1,0,2
4380,780743,22,3,7,1,3,2,4,0,0,0,0,3,3,0,2,0,8
4380,796741,6,1,2,1,2,0,0,0,1,0,1,0,1,1,1,0,2
4380,785548,9,1,2,0,0,1,2,0,0,0,3,2,5,0,2,1,3
4380,796737,8,0,0,0,0,0,0,2,2,0,1,1,1,0,0,0,2
4380,791064,27,4,5,0,0,4,5,0,0,0,2,3,0,0,3,0,12
4380,796736,2,1,2,1,2,0,0,0,0,1,0,0,1,0,0,0,2
4380,796742,1,0,0,0,0,0,0,0,0,0,0,0,0,0,0,0,0
4380,791061,1,0,0,0,0,0,0,0,0,0,0,0,0,0,0,0,0
4381,797466,35,6,12,6,10,0,2,11,14,1,5,1,3,4,3,1,23
4381,791858,25,5,11,4,8,1,3,0,0,1,1,0,5,0,0,0,11
4381,797469,21,0,2,0,0,0,2,1,2,0,1,0,3,0,3,0,1
4381,791109,40,2,5,2,5,0,0,3,6,0,3,4,2,0,2,0,7
4381,785625,20,1,5,1,4,0,1,0,0,2,7,0,4,0,3,1,2
4381,797467,8,1,2,1,2,0,0,0,0,1,1,0,2,0,1,0,2
4381,797465,20,1,2,0,1,1,1,2,2,0,1,1,2,1,3,0,5
4381,791854,28,0,3,0,1,0,2,0,0,0,1,1,0,1,1,0,0
4381,789074,3,0,0,0,0,0,0,0,1,0,0,0,1,0,0,0,0
4382,797895,22,2,6,2,6,0,0,0,0,3,2,0,1,1,1,2,4
4382,789058,23,4,7,1,3,3,4,2,2,1,6,1,3,0,1,1,13
4382,797898,37,9,18,6,13,3,5,10,11,1,7,5,1,2,3,0,31
4382,792240,26,1,5,1,5,0,0,0,0,4,3,5,3,1,2,1,2
4382,792237,28,4,13,2,6,2,7,4,6,0,2,2,2,1,2,0,14
4382,787239,20,1,1,1,1,0,0,0,0,2,4,0,1,0,1,7,2
4382,785818,15,3,7,1,2,2,5,0,0,0,1,0,5,0,0,1,8
4382,785286,26,4,7,3,5,1,2,8,9,0,3,2,2,0,2,0,17
4382,792359,3,0,0,0,0,0,0,0,0,0,0,0,0,0,0,0,0
4383,786575,31,4,10,4,10,0,0,2,2,4,6,1,2,0,3,4,10
4383,785531,13,3,4,1,1,2,3,2,5,2,3,0,0,0,1,0,10
4383,798094,28,3,6,1,2,2,4,0,0,0,0,6,3,3,4,0,8
4383,791636,17,4,9,4,6,0,3,0,0,0,1,1,3,0,0,0,8
4383,792338,30,5,16,4,13,1,3,0,0,0,7,0,1,1,0,1,11
4383,798097,8,2,2,2,2,0,0,0,0,0,3,1,1,0,1,0,4
4383,792334,26,5,13,5,10,0,3,3,8,4,2,3,2,2,0,0,13
4383,798095,5,1,1,0,0,1,1,0,0,0,0,0,1,0,0,0,3
4383,798100,2,0,0,0,0,0,0,0,0,0,0,0,0,1,0,0,0
4383,799842,11,1,2,1,2,0,0,0,0,0,1,2,2,0,1,0,2
4383,781666,29,5,12,2,7,3,5,4,6,0,1,1,3,0,0,0,17
4384,781393,38,12,20,5,11,7,9,0,0,0,3,2,4,3,2,0,31
4384,790909,34,5,12,2,6,3,6,1,2,1,2,0,3,2,5,0,14
4384,775351,40,2,6,2,6,0,0,2,2,0,3,3,1,1,2,1,6
4384,782126,8,0,3,0,0,0,3,2,2,1,2,0,0,0,1,0,2
4384,787175,13,0,2,0,0,0,2,0,0,0,3,0,3,0,2,0,0
4384,790907,35,5,7,5,7,0,0,6,8,4,5,2,2,0,2,2,16
4384,796455,32,1,2,1,2,0,0,2,3,3,10,1,4,0,0,3,4
4384,796454,0,0,0,0,0,0,0,0,0,0,0,0,0,0,0,0,0
4384,790910,0,0,0,0,0,0,0,0,0,0,0,0,0,0,0,0,0
4384,796456,0,0,0,0,0,0,0,0,0,0,0,0,0,0,0,0,0
4385,790961,32,7,9,7,9,0,0,0,2,2,3,4,2,2,1,0,14
4385,785278,36,3,11,0,0,3,11,0,0,1,7,0,2,1,1,1,9
4385,780832,22,3,5,3,5,0,0,2,3,3,1,1,3,0,0,0,8
4385,780146,25,2,12,1,6,1,6,0,0,0,3,3,4,1,4,0,5
4385,786240,16,0,2,0,1,0,1,0,0,0,0,4,2,0,0,0,0
4385,775860,34,5,14,3,4,2,10,0,0,2,1,4,0,1,1,0,12
4385,796556,17,2,4,2,4,0,0,4,4,2,2,0,1,0,2,0,8
4385,796555,10,3,6,1,2,2,4,0,0,0,1,0,1,0,1,0,8
4385,796554,8,0,2,0,2,0,0,0,0,0,1,1,0,0,0,0,0
4386,785294,21,0,5,0,4,0,1,0,0,1,5,0,0,0,3,1,0
4386,796514,27,2,8,2,6,0,2,3,4,0,3,6,3,2,2,0,7
4386,791085,29,4,9,3,6,1,3,2,4,0,2,3,4,1,5,0,11
4386,791080,25,3,7,3,5,0,2,0,1,0,3,0,4,2,0,1,6
4386,785675,28,6,8,3,3,3,5,0,0,0,4,0,4,2,4,0,15
4386,796511,13,1,2,0,0,1,2,3,5,1,4,0,0,0,0,0,6
4386,791083,20,1,4,0,1,1,3,2,4,1,1,0,0,0,1,2,5
4386,791081,6,1,1,1,1,0,0,0,0,1,1,0,2,1,2,0,2
4386,796512,19,3,10,2,3,1,7,1,1,0,1,1,1,1,0,0,8
4386,796515,12,0,3,0,1,0,2,0,0,0,0,0,1,1,0,1,0
4387,796617,12,3,3,3,3,0,0,2,2,1,0,0,2,1,2,0,8
4387,775131,33,5,7,4,4,1,3,4,4,2,4,2,2,2,1,0,15
4387,796616,31,6,14,3,5,3,9,4,4,0,6,1,2,1,0,1,19
4387,796612,33,4,10,4,6,0,4,4,5,2,4,7,1,1,6,0,12
4387,785562,27,1,8,1,6,0,2,2,2,0,8,2,2,2,5,2,4
4387,792429,19,2,8,1,2,1,6,0,0,0,3,0,1,1,0,1,5
4387,796614,3,1,2,1,2,0,0,0,0,0,0,0,1,0,0,0,2
4387,796607,16,2,4,1,3,1,1,0,0,2,2,0,4,0,1,0,5
4387,796606,26,1,2,1,1,0,1,2,4,1,2,1,2,2,0,0,4
4388,791042,25,6,17,3,10,3,7,0,0,2,6,0,1,0,0,3,15
4388,774834,25,1,3,0,0,1,3,0,0,2,1,0,2,0,3,0,3
4388,796718,20,1,5,1,4,0,1,0,1,0,2,3,0,0,0,0,2
4388,791043,29,3,12,2,8,1,4,0,0,0,4,0,2,1,5,0,7
4388,776374,29,1,4,1,2,0,2,1,1,0,3,4,1,2,1,1,3
4388,796723,17,0,2,0,2,0,0,2,4,1,2,1,0,0,0,0,2
4388,796719,9,0,2,0,0,0,2,1,2,0,3,0,1,0,1,0,1
4388,785512,8,1,4,1,4,0,0,0,0,0,1,0,1,0,1,0,2
4388,775412,21,3,6,1,2,2,4,2,3,1,0,1,1,1,1,0,10
4388,766998,6,0,1,0,1,0,0,2,2,0,0,0,1,0,0,1,2
4388,796717,11,2,4,2,4,0,0,0,0,0,1,0,1,0,0,0,4
4389,776344,23,6,9,4,6,2,3,0,0,2,5,1,1,0,1,1,14
4389,775821,25,4,8,2,5,2,3,1,2,1,5,1,2,0,1,3,11
4389,792453,29,6,10,5,8,1,2,0,0,0,4,6,0,3,2,0,13
4389,785131,25,5,9,3,4,2,5,1,2,0,7,3,3,2,0,0,13
4389,781538,27,2,3,2,3,0,0,0,0,0,3,6,1,2,2,0,4
4389,798113,12,0,5,0,4,0,1,3,4,2,5,0,3,0,0,0,3
4389,785152,11,3,3,3,3,0,0,0,0,2,1,0,3,0,0,1,6
4389,798115,23,7,11,2,4,5,7,0,0,0,2,1,2,0,1,0,19
4389,776233,19,1,6,1,4,0,2,1,2,1,3,0,2,1,2,0,3
4389,792322,2,0,1,0,0,0,1,0,0,0,0,1,0,0,0,0,0
4389,792324,4,0,1,0,0,0,1,0,0,0,0,0,0,0,0,0,0
4390,792388,28,4,8,4,8,0,0,2,3,2,4,2,3,2,3,0,10
4390,781533,37,6,9,1,2,5,7,0,0,1,4,0,1,1,0,0,17
4390,797851,31,7,15,6,11,1,4,0,0,1,1,0,2,1,0,1,15
4390,792393,36,8,11,6,7,2,4,1,1,0,5,4,2,0,2,0,19
4390,792395,36,5,17,5,14,0,3,0,0,0,1,14,3,4,3,0,10
4390,780840,15,1,2,1,2,0,0,0,0,0,2,0,2,1,0,0,2
4390,797845,14,1,1,0,0,1,1,0,0,1,2,1,3,0,0,0,3
4390,781541,3,0,1,0,1,0,0,0,0,0,0,0,0,0,0,0,0
4391,775556,35,3,7,1,3,2,4,3,4,0,5,3,1,1,0,3,11
4391,780234,32,5,9,3,5,2,4,3,4,1,4,2,2,0,2,2,15
4391,786411,35,6,8,3,3,3,5,0,0,0,2,3,3,1,1,0,15
4391,780046,37,5,8,2,2,3,6,1,2,0,5,4,3,2,7,0,14
4391,781104,33,3,9,3,4,0,5,5,7,0,2,4,1,1,4,0,11
4391,781110,19,3,5,3,4,0,1,0,0,2,2,0,1,0,1,0,6
4391,797185,9,1,2,1,2,0,0,0,0,1,1,0,3,0,1,0,2
4392,785495,35,6,14,6,10,0,4,5,7,2,4,2,3,1,3,1,17
4392,785958,28,3,11,3,8,0,3,8,11,8,7,1,5,0,2,0,14
4392,775377,9,0,0,0,0,0,0,0,0,0,1,1,1,1,0,0,0
4392,785494,37,4,15,1,8,3,7,4,5,0,5,4,2,0,3,0,15
4392,780698,35,7,17,4,8,3,9,0,1,1,3,2,3,0,4,0,17
4392,785490,1,0,0,0,0,0,0,0,0,0,0,0,0,0,0,0,0
4392,785659,20,2,3,2,3,0,0,0,2,5,4,1,5,1,1,1,4
4392,791130,18,0,3,0,0,0,3,0,0,0,1,0,3,1,0,0,0
4392,780427,17,1,3,1,2,0,1,0,0,1,0,0,3,1,1,1,2
4392,791034,0,0,0,0,0,0,0,0,0,0,0,0,0,0,0,0,0
4393,780291,28,4,13,2,10,2,3,3,4,6,2,1,4,1,1,0,13
4393,785607,10,1,2,1,1,0,1,0,0,0,2,0,3,0,0,0,2
4393,796665,25,2,9,2,4,0,5,1,2,1,3,2,3,1,4,0,5
4393,785333,35,2,9,0,2,2,7,6,6,1,7,0,1,0,1,0,12
4393,775305,39,9,18,8,15,1,3,6,8,0,5,5,3,1,3,0,25
4393,796663,22,3,7,3,7,0,0,4,4,7,4,0,2,2,0,0,10
4393,791004,16,0,7,0,5,0,2,4,4,3,2,0,3,0,1,0,4
4393,791006,1,0,0,0,0,0,0,0,0,0,0,0,0,0,0,0,0
4393,796666,7,0,0,0,0,0,0,1,2,3,2,0,2,0,1,0,1
4393,796664,17,1,6,1,5,0,1,2,7,2,3,0,2,0,0,0,4
4394,791524,30,3,12,1,5,2,7,3,5,0,5,0,1,0,2,1,11
4394,797139,15,2,7,2,7,0,0,0,0,2,3,3,0,0,3,0,4
4394,775394,35,3,6,2,2,1,4,11,12,1,3,0,2,3,3,0,18
4394,791526,31,2,8,2,5,0,3,2,2,1,7,6,3,1,2,0,6
4394,780272,36,6,10,5,7,1,3,6,6,1,4,2,1,2,2,0,19
4394,785970,20,6,8,6,8,0,0,2,2,1,11,0,2,1,3,0,14
4394,791523,6,0,1,0,1,0,0,0,0,0,4,0,0,0,0,0,0
4394,780273,24,2,4,1,3,1,1,0,0,1,0,1,1,0,1,0,5
4394,786354,3,0,0,0,0,0,0,0,0,0,0,0,0,0,0,0,0
4395,792246,20,1,6,1,6,0,0,0,1,0,2,0,0,1,1,3,2
4395,791701,21,0,1,0,1,0,0,2,2,1,5,1,3,3,4,1,2
4395,792245,27,0,3,0,0,0,3,0,0,0,0,2,4,0,1,0,0
4395,781420,37,5,16,3,6,2,10,6,6,0,9,4,2,1,3,0,18
4395,781405,35,12,23,12,17,0,6,1,2,0,2,1,3,2,2,1,25
4395,792244,12,1,7,1,5,0,2,0,0,0,1,3,2,1,1,0,2
4395,780615,10,0,0,0,0,0,0,0,0,1,1,0,3,1,0,0,0
4395,781624,18,3,5,1,2,2,3,0,0,3,2,0,1,1,0,0,8
4395,797925,20,4,7,3,4,1,3,0,0,0,3,1,2,0,0,0,9
4396,797662,24,2,4,1,3,1,1,0,2,1,4,2,3,0,0,1,5
4396,786067,28,6,10,6,10,0,0,0,0,0,7,2,1,1,0,0,12
4396,797661,27,9,11,3,3,6,8,0,0,1,9,2,0,1,2,0,24
4396,785591,28,3,8,2,7,1,1,1,2,0,3,6,1,2,1,1,8
4396,780258,23,1,5,0,0,1,5,0,0,0,1,2,2,1,0,0,3
4396,792082,17,5,10,3,5,2,5,0,0,0,2,1,1,1,1,1,12
4396,792078,18,6,7,6,7,0,0,0,0,3,2,1,0,1,1,0,12
4396,797659,4,0,1,0,0,0,1,0,0,0,3,0,1,0,0,0,0
4396,797663,3,0,2,0,2,0,0,0,0,0,0,0,0,0,0,0,0
4396,797660,9,1,7,1,7,0,0,0,0,1,2,0,1,0,0,0,2
4396,792083,13,2,5,2,4,0,1,0,0,0,2,0,1,1,0,0,4
4396,774898,3,1,2,1,1,0,1,0,0,0,1,0,0,0,0,0,2
4396,792079,3,0,0,0,0,0,0,0,0,0,0,0,0,0,0,0,0
4397,796979,22,2,9,2,6,0,3,0,1,4,2,2,0,0,1,0,4
4397,776200,16,2,5,2,5,0,0,1,2,1,1,0,0,0,2,0,5
4397,780925,30,0,4,0,3,0,1,4,5,1,6,3,1,1,3,0,4
4397,780446,26,2,7,0,2,2,5,3,4,0,2,1,1,1,3,0,9
4397,781034,30,6,11,5,8,1,3,0,0,0,3,1,1,2,3,0,13
4397,796980,5,0,0,0,0,0,0,1,2,0,0,0,0,0,0,0,1
4397,791625,16,1,7,0,4,1,3,1,2,0,3,0,1,0,1,0,4
4397,796978,3,1,2,0,0,1,2,0,0,0,0,0,0,0,0,0,3
4397,791622,19,1,2,1,2,0,0,1,2,0,1,0,1,0,2,0,3
4397,791624,16,1,8,1,5,0,3,0,0,1,5,0,0,0,0,0,2
4397,791637,17,2,6,0,0,2,6,0,0,1,4,1,0,0,0,0,6
4398,786704,25,6,10,6,10,0,0,2,4,5,9,0,2,0,2,0,14
4398,785395,22,2,8,2,7,0,1,0,0,1,7,2,1,1,2,0,4
4398,775840,33,6,10,3,5,3,5,0,0,1,2,4,0,2,0,0,15
4398,775955,36,5,14,4,9,1,5,0,0,3,4,7,1,4,1,0,11
4398,775811,11,1,3,1,3,0,0,0,0,0,0,1,1,1,1,0,2
4398,786706,15,5,6,5,6,0,0,2,4,4,2,1,3,1,1,2,12
4398,775287,15,1,4,0,1,1,3,0,0,0,0,0,0,0,1,0,3
4398,786702,3,0,1,0,1,0,0,0,0,0,2,0,1,0,0,0,0
4398,790921,10,0,1,0,0,0,1,0,0,0,1,0,0,0,2,0,0
4398,786551,27,3,9,2,4,1,5,1,2,0,1,2,1,1,1,0,8
4398,786703,3,0,0,0,0,0,0,0,0,0,0,0,0,0,0,0,0
4399,780913,22,4,8,4,4,0,4,0,0,0,1,0,4,2,4,0,8
4399,798119,30,5,11,2,6,3,5,0,0,1,4,2,0,0,2,0,13
4399,798117,31,3,9,1,6,2,3,4,6,0,3,4,2,0,4,0,12
4399,780594,29,2,6,1,2,1,4,0,0,0,6,3,0,1,2,0,5
4399,775664,31,3,6,1,1,2,5,0,1,1,2,0,1,0,0,0,8
4399,798118,6,0,1,0,1,0,0,0,0,1,2,1,0,0,0,0,0
4399,769332,5,0,1,0,0,0,1,0,0,0,0,0,0,0,1,0,0
4399,798124,28,0,1,0,1,0,0,0,0,0,2,5,1,0,2,0,0
4399,798121,1,0,0,0,0,0,0,0,0,0,0,0,0,0,0,0,0
4399,798123,17,2,6,2,5,0,1,2,4,0,1,1,4,0,4,2,6
4400,797628,22,2,4,2,2,0,2,0,0,0,3,0,2,0,1,1,4
4400,786481,34,7,19,7,17,0,2,0,0,1,9,2,2,0,2,0,14
4400,797624,24,0,1,0,1,0,0,0,0,0,2,1,4,0,1,2,0
4400,785965,23,1,4,1,3,0,1,0,0,0,1,2,1,0,1,0,2
4400,781032,30,2,10,1,5,1,5,0,0,1,1,2,3,0,2,1,5
4400,791793,12,1,7,1,6,0,1,0,0,2,2,0,1,0,0,0,2
4400,791791,14,0,0,0,0,0,0,0,0,0,1,1,0,0,1,0,0
4400,797626,29,3,3,3,3,0,0,0,0,0,1,3,2,2,3,0,6
4400,786480,12,4,7,0,1,4,6,0,0,0,2,0,2,0,0,0,12
4401,781044,34,4,12,3,7,1,5,2,2,0,6,1,2,1,1,0,11
4401,791795,31,2,5,2,4,0,1,4,5,2,5,1,1,0,0,0,8
4401,786489,32,5,9,3,5,2,4,1,1,0,4,0,0,0,1,1,13
4401,786488,34,1,7,1,7,0,0,3,4,0,7,2,0,4,3,0,5
4401,781038,31,4,6,4,5,0,1,2,3,1,2,2,1,0,2,1,10
4401,797620,25,3,6,2,3,1,3,6,6,2,2,1,0,0,3,3,13
4401,786490,5,1,3,1,3,0,0,0,0,2,1,0,0,0,0,0,2
4401,797619,7,0,1,0,0,0,1,0,0,0,0,1,0,0,2,0,0
4401,786487,1,0,0,0,0,0,0,0,0,0,1,0,1,0,0,0,0
4401,797622,0,0,0,0,0,0,0,0,0,0,0,0,0,0,0,0,0
4402,774806,29,7,10,7,10,0,0,4,5,3,14,4,3,0,1,1,18
4402,775823,31,2,6,1,4,1,2,6,7,1,4,3,3,0,2,0,11
4402,791041,35,2,9,0,5,2,4,2,2,1,3,2,2,1,4,0,8
4402,791038,34,6,11,2,5,4,6,2,2,1,6,4,2,0,2,0,18
4402,789023,40,3,9,1,2,2,7,9,9,1,0,5,3,0,3,0,17
4402,796714,11,1,2,1,2,0,0,0,1,0,3,0,3,0,1,2,2
4402,775205,20,3,5,0,0,3,5,0,0,0,1,2,2,0,0,0,9
4403,791868,27,3,11,3,9,0,2,1,1,0,0,6,1,0,0,1,7
4403,797802,22,4,7,1,2,3,5,0,0,0,0,2,4,1,0,0,11
4403,797809,20,1,8,1,7,0,1,0,2,2,6,1,5,1,1,0,2
4403,797807,30,4,9,3,8,1,1,2,2,0,2,1,1,0,0,0,11
4403,786058,40,4,6,4,6,0,0,5,6,0,6,4,4,0,3,0,13
4403,797812,3,0,0,0,0,0,0,1,2,0,0,0,1,0,1,0,1
4403,795730,27,4,8,0,2,4,6,0,0,0,3,2,1,1,2,0,12
4403,797810,10,2,2,1,1,1,1,0,2,0,2,0,3,0,0,0,5
4403,797811,2,2,2,2,2,0,0,0,0,0,0,0,0,0,0,0,4
4403,792264,19,2,5,0,2,2,3,2,2,1,4,1,5,0,2,0,8
4404,781505,19,8,9,5,6,3,3,0,0,0,8,1,1,0,0,0,19
4404,780353,20,6,8,6,7,0,1,5,5,1,8,0,2,0,2,2,17
4404,776279,13,4,7,2,3,2,4,0,0,0,2,3,1,1,0,1,10
4404,791317,18,4,7,4,6,0,1,1,1,0,0,8,0,1,3,0,9
4404,777573,15,3,6,1,3,2,3,0,0,0,0,2,0,0,1,0,8
4404,790851,10,8,8,8,8,0,0,3,6,0,1,2,2,2,0,1,19
4404,796647,15,5,8,3,4,2,4,1,2,0,0,3,0,0,1,0,13
4404,796649,22,4,6,2,3,2,3,0,0,1,5,4,2,1,0,1,10
4404,791318,12,3,4,3,3,0,1,0,0,1,2,0,3,0,1,0,6
4404,796646,20,2,4,1,3,1,1,0,0,1,6,6,1,2,1,0,5
4404,791319,3,1,2,0,0,1,2,0,0,0,0,1,1,0,0,0,3
4404,796648,17,1,1,1,1,0,0,0,0,0,2,4,1,2,2,0,2
4404,786222,16,0,0,0,0,0,0,0,0,0,2,1,3,0,1,1,0
4406,796880,32,4,11,3,5,1,6,3,6,3,7,2,3,3,3,0,12
4406,791760,24,4,6,4,5,0,1,3,4,0,3,0,2,1,1,1,11
4406,791334,27,1,7,0,4,1,3,1,2,0,1,0,0,0,2,0,4
4406,791757,6,1,1,1,1,0,0,0,0,0,0,0,1,0,0,0,2
4406,780256,36,3,8,1,3,2,5,1,3,3,5,1,2,1,2,0,9
4406,796883,19,0,5,0,0,0,5,1,2,0,2,1,0,0,2,0,1
4406,791330,1,0,0,0,0,0,0,0,0,0,0,0,0,0,0,0,0
4406,785874,15,3,5,3,5,0,0,4,5,3,2,0,5,1,1,0,10
4406,796879,28,2,7,1,4,1,3,1,2,0,0,3,3,0,2,0,6
4406,781590,12,0,4,0,2,0,2,0,0,3,2,0,2,0,2,0,0
4407,775456,27,3,7,3,7,0,0,4,6,2,7,2,2,1,2,0,10
4407,781115,33,2,5,2,5,0,0,0,0,0,2,4,2,2,1,0,4
4407,785524,25,3,7,1,3,2,4,0,0,0,2,0,4,0,1,0,8
4407,775094,25,2,5,1,2,1,3,3,4,0,3,0,2,2,2,0,8
4407,791053,30,5,12,5,12,0,0,3,4,1,4,2,3,0,3,0,13
4407,791051,9,1,2,1,2,0,0,0,2,0,2,0,1,0,1,0,2
4407,790819,12,1,7,0,5,1,2,0,0,0,2,1,2,0,2,0,3
4407,796730,7,2,5,2,2,0,3,0,0,0,1,0,2,2,0,0,4
4407,796731,11,1,1,1,1,0,0,0,0,1,1,0,0,0,0,0,2
4407,780739,21,3,5,3,5,0,0,0,0,1,1,0,3,0,1,0,6
4414,796850,36,8,15,8,12,0,3,3,3,1,3,4,2,0,1,1,19
4414,781054,34,8,16,5,7,3,9,0,0,1,5,4,4,1,2,0,19
4414,774969,35,8,15,8,15,0,0,2,2,6,13,2,2,1,5,1,18
4414,791181,39,2,6,2,4,0,2,0,0,2,3,3,1,3,0,0,4
4414,796848,27,1,8,1,6,0,2,0,0,1,0,3,3,2,2,1,2
4414,791179,22,4,5,3,4,1,1,3,3,0,1,0,4,0,2,0,12
4414,780981,7,0,0,0,0,0,0,0,0,0,2,1,0,0,1,0,0
4415,781602,38,9,19,8,14,1,5,6,7,1,4,3,3,3,3,0,25
4415,781425,36,5,11,5,11,0,0,0,0,2,6,0,1,1,4,1,10
4415,791343,40,2,6,1,4,1,2,3,3,0,1,2,2,1,1,0,8
4415,775746,29,1,5,0,1,1,4,4,6,0,3,0,5,0,5,0,7
4415,791344,36,3,7,3,5,0,2,0,0,3,4,0,2,0,1,2,6
4415,797001,15,0,4,0,2,0,2,0,0,0,1,0,2,0,1,0,0
4415,776173,6,0,1,0,0,0,1,0,0,0,2,0,0,0,0,0,0
4416,775606,27,2,6,2,6,0,0,1,4,2,6,1,2,1,2,4,5
4416,791672,27,6,6,6,6,0,0,1,2,0,2,0,4,1,3,1,13
4416,780552,37,7,14,3,4,4,10,2,4,0,4,0,1,1,1,1,20
4416,780550,28,7,12,6,11,1,1,3,3,1,5,3,2,1,2,0,18
4416,780538,22,5,8,5,7,0,1,0,1,0,0,5,4,2,1,0,10
4416,797424,1,0,0,0,0,0,0,0,0,0,0,0,0,0,1,0,0
4416,785791,24,0,3,0,0,0,3,2,2,0,5,0,1,1,0,0,2
4416,791674,23,4,5,3,4,1,1,6,7,1,0,3,3,3,3,0,15
4416,785787,11,0,4,0,1,0,3,0,0,0,0,0,4,0,0,0,0
4417,796766,13,0,0,0,0,0,0,0,0,0,2,0,2,0,1,1,0
4417,785614,13,1,1,1,1,0,0,0,0,1,0,0,2,1,0,0,2
4417,780813,34,5,7,5,6,0,1,2,3,0,5,4,2,1,4,1,12
4417,796765,29,5,11,2,5,3,6,0,0,3,1,2,4,0,3,0,13
4417,780812,38,4,16,3,10,1,6,7,7,0,6,3,3,2,4,0,16
4417,791113,24,1,3,1,3,0,0,0,4,2,5,0,1,0,0,1,2
4417,796767,27,7,15,7,10,0,5,7,7,1,3,1,3,0,2,0,21
4417,785618,22,4,6,3,3,1,3,0,1,0,0,1,2,0,0,0,9
4418,780378,32,3,7,3,7,0,0,0,2,6,5,1,3,1,4,3,6
4418,797061,22,2,5,0,3,2,2,1,2,0,2,1,2,0,1,0,7
4418,786374,31,5,13,2,8,3,5,1,1,3,6,3,2,2,2,2,14
4418,786253,25,1,8,1,4,0,4,2,2,1,1,3,2,3,7,0,4
4418,780121,8,1,1,0,0,1,1,0,0,0,0,0,2,1,1,0,3
4418,786404,23,1,5,1,3,0,2,3,4,1,8,2,0,0,0,0,5
4418,780382,3,0,0,0,0,0,0,0,0,0,1,0,5,0,0,0,0
4418,797065,8,2,2,0,0,2,2,0,0,0,0,0,1,0,0,0,6
4418,786378,30,4,9,2,2,2,7,3,3,3,0,3,1,4,4,0,13
4418,785798,17,0,5,0,1,0,4,0,1,0,1,2,1,0,0,0,0
4418,780381,1,0,0,0,0,0,0,0,0,0,0,0,0,0,0,0,0
4419,790232,29,3,6,2,4,1,2,5,6,0,2,2,2,1,4,0,12
4419,780614,29,2,3,1,2,1,1,0,0,1,6,0,4,1,3,1,5
4419,780093,17,2,3,2,3,0,0,0,0,1,3,1,2,1,1,1,4
4419,789066,34,3,10,1,5,2,5,2,2,0,4,0,1,0,5,0,10
4419,785806,34,2,5,1,3,1,2,2,3,0,2,1,2,3,1,0,7
4419,780255,22,3,6,3,5,0,1,3,7,0,4,3,4,4,2,0,9
4419,792411,23,1,6,1,2,0,4,0,0,0,0,0,2,0,1,0,2
4419,786463,12,0,5,0,5,0,0,0,0,0,2,0,2,0,2,0,0
4419,792412,0,0,0,0,0,0,0,0,0,0,0,0,0,0,0,0,0
4420,785740,26,2,6,2,6,0,0,0,0,1,6,0,2,0,3,2,4
4420,785809,32,6,12,5,9,1,3,1,3,3,10,2,1,2,2,1,14
4420,780530,27,1,4,1,4,0,0,0,0,2,2,1,0,0,2,2,2
4420,797402,24,5,9,3,4,2,5,0,0,0,1,2,3,0,1,0,12
4420,785738,33,2,3,2,2,0,1,6,7,0,3,10,2,0,6,0,10
4420,797396,8,0,2,0,2,0,0,0,0,0,2,0,2,0,0,0,0
4420,785745,1,0,0,0,0,0,0,0,0,1,0,0,0,0,1,0,0
4420,786144,27,6,7,1,1,5,6,1,1,0,3,0,2,0,1,0,18
4420,797399,19,1,4,1,2,0,2,1,1,0,2,0,2,0,3,0,3
4420,791664,3,0,0,0,0,0,0,0,0,0,0,0,1,0,0,0,0
4421,792593,26,2,9,2,9,0,0,3,4,2,3,1,5,1,3,0,7
4421,792594,29,2,10,0,4,2,6,0,0,0,7,2,2,1,1,1,6
4421,792588,22,1,4,0,0,1,4,0,0,0,0,0,0,2,1,0,3
4421,792595,30,5,9,5,7,0,2,1,1,0,3,2,0,0,4,0,11
4421,792583,29,2,7,2,4,0,3,2,2,0,2,2,2,3,0,0,6
4421,796989,14,1,3,1,1,0,2,0,0,0,1,0,4,0,0,1,2
4421,796987,17,1,7,1,6,0,1,3,3,2,2,2,2,0,1,0,5
4421,792591,27,4,4,1,1,3,3,0,1,0,0,2,0,4,1,0,11
4421,792586,2,0,0,0,0,0,0,1,2,1,0,0,0,0,0,0,1
4421,792582,2,0,0,0,0,0,0,0,0,0,0,0,0,0,0,0,0
4421,792592,2,0,0,0,0,0,0,0,0,0,0,0,0,0,0,0,0
4422,780824,19,2,2,2,2,0,0,2,2,2,6,1,0,0,2,0,6
4422,791118,31,2,7,1,2,1,5,3,4,0,4,2,0,1,6,1,8
4422,791117,30,4,9,3,6,1,3,4,4,2,3,0,2,2,5,3,13
4422,774974,31,0,6,0,4,0,2,1,2,0,2,1,1,0,2,1,1
4422,785676,37,2,6,2,4,0,2,0,0,1,3,3,0,1,2,2,4
4422,796768,4,0,1,0,1,0,0,0,0,0,0,0,0,0,0,0,0
4422,796769,23,2,4,1,1,1,3,0,1,0,1,0,1,0,1,0,5
4422,800022,4,0,1,0,1,0,0,0,0,0,1,0,0,0,1,0,0
4422,796771,4,0,1,0,1,0,0,0,0,0,0,0,0,0,0,0,0
4422,791115,17,0,1,0,1,0,0,0,0,0,0,0,2,0,2,0,0
4423,792288,29,4,7,4,6,0,1,1,3,4,10,0,1,1,0,1,9
4423,785227,28,3,5,3,5,0,0,0,0,1,2,2,4,1,1,2,6
4423,786232,25,3,5,2,3,1,2,0,0,0,2,0,3,1,1,0,7
4423,780287,31,6,16,3,9,3,7,0,0,0,2,0,1,1,0,0,15
4423,786237,28,3,9,3,9,0,0,0,0,1,1,8,0,6,4,0,6
4423,798068,1,0,0,0,0,0,0,0,0,0,1,0,0,0,0,0,0
4423,792278,30,4,12,2,5,2,7,0,0,0,1,5,1,0,1,0,10
4423,798072,11,1,2,1,2,0,0,0,0,3,2,1,2,0,1,0,2
4423,798084,6,1,1,1,1,0,0,0,0,0,0,0,0,1,0,0,2
4423,798067,11,2,2,2,2,0,0,0,0,0,1,0,1,1,1,0,4
4424,775549,23,7,9,7,9,0,0,0,1,2,1,1,2,0,1,2,14
4424,786381,29,3,5,1,1,2,4,1,2,1,6,1,2,0,0,1,9
4424,797056,34,4,7,4,5,0,2,0,0,0,1,5,2,1,0,0,8
4424,797058,22,3,6,2,3,1,3,1,2,0,1,2,2,0,2,2,8
4424,797055,21,1,5,0,1,1,4,2,4,0,2,3,3,1,0,0,5
4424,797054,28,4,8,2,4,2,4,4,4,0,3,9,1,0,3,0,14
4424,791564,16,3,5,0,1,3,4,0,0,0,3,0,1,2,1,0,9
4424,780425,17,3,4,3,4,0,0,0,1,2,2,0,0,0,0,3,6
4424,791568,10,0,1,0,0,0,1,0,0,1,2,0,1,0,0,0,0
4425,786620,33,4,8,2,5,2,3,6,6,0,4,4,1,0,1,0,16
4425,781606,38,4,6,0,2,4,4,2,2,0,3,3,2,0,0,0,14
4425,781263,26,5,10,4,8,1,2,0,0,3,3,2,1,0,0,0,11
4425,781257,32,2,11,2,4,0,7,3,4,1,1,1,3,1,3,1,7
4425,791838,11,0,5,0,2,0,3,0,0,0,1,0,2,0,0,0,0
4425,796955,7,4,6,4,6,0,0,1,2,0,0,0,4,0,2,1,9
4425,791257,12,2,2,2,2,0,0,0,0,1,2,0,2,1,0,0,4
4425,780900,14,1,3,1,2,0,1,0,0,1,2,3,3,1,0,0,2
4425,796954,12,0,2,0,0,0,2,0,0,0,0,0,0,0,2,0,0
4425,796956,10,0,1,0,0,0,1,0,0,0,0,0,0,0,0,0,0
4425,791255,5,0,0,0,0,0,0,0,0,0,0,1,2,0,0,0,0
4426,796611,13,4,8,1,3,3,5,1,2,3,0,1,0,1,0,0,12
4426,796609,32,3,7,2,3,1,4,2,3,1,3,2,3,1,6,0,9
4426,792869,23,2,7,0,2,2,5,0,0,1,3,0,0,1,1,0,6
4426,785841,27,1,4,0,2,1,2,1,2,0,3,2,4,2,2,0,4
4426,785664,23,1,3,1,3,0,0,1,2,2,4,0,3,0,2,2,3
4426,781504,33,3,8,2,5,1,3,5,7,0,4,3,1,2,1,1,12
4426,786685,28,3,10,3,9,0,1,3,3,0,2,0,1,0,1,0,9
4426,796613,13,2,4,0,0,2,4,0,0,0,1,1,3,0,1,1,6
4426,791312,11,2,2,2,2,0,0,0,1,1,2,0,2,1,2,1,4
4426,792232,13,1,3,1,2,0,1,0,0,0,2,1,0,0,0,1,2
4426,766623,9,0,1,0,1,0,0,0,0,0,0,1,0,3,0,0,0
4427,798009,43,7,20,3,9,4,11,5,6,2,2,1,2,0,3,0,23
4427,792266,37,5,17,5,14,0,3,2,4,3,6,3,3,4,1,0,12
4427,786152,43,5,13,5,12,0,1,1,2,3,6,1,4,0,6,1,11
4427,798006,39,3,7,2,4,1,3,0,0,1,1,0,0,1,1,1,7
4427,792265,6,2,3,2,3,0,0,0,0,1,0,1,0,0,0,0,4
4427,798007,15,1,4,1,3,0,1,1,2,4,0,0,5,2,1,0,3
4427,792267,23,1,4,1,2,0,2,0,0,0,1,0,3,0,3,0,2
4427,798005,19,0,1,0,1,0,0,2,2,1,7,0,1,0,1,2,2
4428,785939,35,6,16,4,11,2,5,5,6,0,1,1,4,1,0,0,19
4428,785948,34,4,9,4,9,0,0,10,14,8,5,0,5,2,6,1,18
4428,792020,38,8,18,7,12,1,6,0,0,1,4,3,3,0,2,0,17
4428,785938,34,1,9,0,4,1,5,0,0,0,7,4,3,2,0,0,3
4428,785946,26,0,4,0,3,0,1,2,2,2,1,0,4,0,1,0,2
4428,785941,29,5,9,3,5,2,4,1,1,3,5,3,2,1,2,1,13
4428,792026,4,1,1,1,1,0,0,0,0,0,2,0,0,0,1,0,2
4429,792495,38,8,21,5,12,3,9,8,10,2,6,4,2,1,2,0,27
4429,792491,38,3,4,3,4,0,0,12,13,1,6,6,2,2,1,1,18
4429,792493,33,6,9,2,2,4,7,0,0,0,1,1,3,1,0,0,16
4429,781144,35,5,13,2,5,3,8,0,0,1,2,0,1,0,3,0,13
4429,780023,26,2,4,2,4,0,0,0,0,1,7,1,5,0,1,1,4
4429,786832,21,1,3,1,2,0,1,2,6,0,1,0,2,0,0,1,4
4429,792492,3,1,2,1,2,0,0,0,0,1,0,0,0,0,0,0,2
4429,788128,3,0,1,0,0,0,1,0,0,0,1,0,2,0,2,0,0
4429,798960,3,0,0,0,0,0,0,0,0,0,0,0,1,0,0,0,0
4430,797527,25,3,4,3,3,0,1,0,0,1,3,1,1,1,2,0,6
4430,791936,36,4,8,4,8,0,0,3,4,3,7,3,1,1,3,0,11
4430,797529,27,6,10,4,8,2,2,0,0,1,3,1,4,2,3,0,14
4430,785688,31,7,13,3,3,4,10,0,0,0,2,4,2,0,0,0,18
4430,797532,38,4,9,3,7,1,2,9,12,0,4,14,2,3,2,0,18
4430,785988,17,3,7,2,5,1,2,2,2,0,2,0,3,1,0,0,9
4430,791935,1,0,0,0,0,0,0,0,0,0,0,0,0,0,0,0,0
4430,797528,11,0,1,0,1,0,0,0,0,1,3,0,2,0,0,0,0
4430,791932,12,2,4,0,1,2,3,0,0,0,0,2,0,1,0,0,6
4430,791931,1,0,0,0,0,0,0,0,0,0,0,0,0,0,0,0,0
4430,797530,1,0,0,0,0,0,0,0,0,0,0,0,0,0,0,0,0
4431,780683,13,1,6,1,2,0,4,1,1,0,4,1,0,0,3,0,3
4431,780686,34,5,8,5,8,0,0,1,2,5,4,2,1,1,2,0,11
4431,797680,38,7,12,3,7,4,5,0,0,1,2,0,1,0,0,0,18
4431,797681,26,4,10,2,2,2,8,0,0,1,0,3,4,0,2,0,10
4431,780688,35,5,11,4,6,1,5,4,5,3,1,5,4,3,2,0,15
4431,780772,11,1,2,1,2,0,0,1,2,0,1,1,2,0,3,0,3
4431,791942,6,0,1,0,1,0,0,0,0,0,1,3,1,0,0,0,0
4431,797679,20,2,10,2,5,0,5,1,1,0,3,3,3,0,0,0,5
4431,780689,7,0,2,0,2,0,0,0,0,1,0,0,0,0,0,0,0
4431,797682,4,0,0,0,0,0,0,0,0,0,1,0,1,0,0,1,0
4431,797683,6,0,2,0,0,0,2,0,0,0,0,0,0,0,0,0,0
4432,786059,28,5,8,5,7,0,1,5,6,2,6,2,3,0,2,3,15
4432,776174,29,5,7,5,7,0,0,4,6,4,4,1,1,1,4,4,14
4432,791958,37,2,3,1,2,1,1,6,6,5,3,3,2,0,2,0,11
4432,791960,35,3,8,2,4,1,4,2,5,0,2,3,2,0,2,0,9
4432,785861,35,4,10,2,4,2,6,0,0,2,4,1,2,2,2,1,10
4432,797706,2,0,0,0,0,0,0,0,0,0,1,0,0,0,2,0,0
4432,797704,16,1,5,0,0,1,5,0,0,0,1,0,2,0,0,0,3
4432,781332,18,1,4,1,3,0,1,0,2,0,3,1,0,0,3,0,2
4433,785681,23,3,5,3,5,0,0,3,4,4,5,1,1,0,0,0,9
4433,796789,28,3,6,2,3,1,3,0,0,1,1,4,4,2,0,0,7
4433,791126,19,1,6,1,4,0,2,0,0,0,0,1,0,2,1,0,2
4433,791124,32,3,8,2,7,1,1,1,2,1,2,3,1,2,3,0,8
4433,780050,33,7,13,6,9,1,4,2,4,4,4,1,2,3,3,0,17
4433,784479,6,3,7,2,3,1,4,0,0,1,0,0,2,0,0,0,7
4433,796786,17,1,4,0,1,1,3,2,3,0,0,0,2,1,0,0,5
4433,775813,18,3,8,3,8,0,0,2,3,2,1,0,3,1,1,0,8
4433,796784,8,0,1,0,1,0,0,0,0,1,0,1,3,1,1,0,0
4433,796782,13,1,5,0,3,1,2,0,0,0,0,0,2,1,0,0,3
4433,796788,0,0,0,0,0,0,0,0,0,0,0,0,1,0,0,0,0
4433,796783,3,0,0,0,0,0,0,0,0,0,0,0,0,0,0,0,0
4434,790969,28,5,8,3,5,2,3,7,11,0,7,6,0,1,4,0,19
4434,780166,31,3,10,1,5,2,5,1,2,1,2,6,4,1,3,0,9
4434,796566,25,4,6,4,6,0,0,0,0,6,6,0,4,0,3,2,8
4434,775107,17,0,3,0,1,0,2,0,0,0,1,1,2,1,3,0,0
4434,790971,11,0,2,0,2,0,0,0,0,0,2,0,1,1,1,0,0
4434,790967,24,5,13,0,2,5,11,0,0,0,0,3,0,1,1,0,15
4434,796569,23,5,6,5,6,0,0,0,0,3,3,1,3,0,3,0,10
4434,781380,15,3,4,3,4,0,0,0,0,0,3,0,2,0,2,0,6
4434,790968,10,2,3,0,0,2,3,0,0,1,2,1,3,0,1,0,6
4434,796563,16,0,2,0,2,0,0,1,2,3,2,1,1,0,0,0,1
4435,786637,34,8,14,6,10,2,4,4,7,2,0,2,1,4,2,0,22
4435,778442,38,6,16,5,9,1,7,5,7,1,7,2,2,2,3,0,18
4435,791511,24,6,11,6,11,0,0,2,3,3,3,1,2,1,1,2,14
4435,791513,31,2,8,2,4,0,4,0,0,0,1,6,0,2,1,1,4
4435,791514,17,1,4,1,3,0,1,0,0,0,4,1,1,0,1,0,2
4435,780946,23,1,4,1,4,0,0,2,3,1,1,4,3,0,1,0,4
4435,797150,15,1,3,1,1,0,2,0,0,0,1,0,1,1,1,0,2
4435,797151,10,1,2,1,2,0,0,0,0,2,1,0,0,0,0,0,2
4435,791515,6,1,2,1,1,0,1,0,0,1,1,0,0,0,0,0,2
4435,797152,2,1,1,1,1,0,0,0,0,0,1,0,1,0,0,0,2
4436,797728,21,2,4,0,0,2,4,1,2,2,4,0,2,2,0,0,7
4436,792036,21,2,4,2,3,0,1,0,1,1,1,0,1,0,0,0,4
4436,786266,29,6,12,3,5,3,7,1,2,0,4,2,3,2,3,0,16
4436,792040,35,6,15,6,13,0,2,1,2,1,3,4,1,3,0,2,13
4436,775028,20,1,11,0,7,1,4,2,2,1,2,6,3,0,2,0,5
4436,797726,22,3,11,3,6,0,5,4,4,1,3,0,1,1,1,1,10
4436,786039,16,3,3,3,3,0,0,1,1,1,0,0,3,2,1,2,7
4436,797719,15,3,6,1,1,2,5,0,0,0,3,1,3,1,0,0,8
4436,797718,21,0,1,0,0,0,1,2,2,0,2,2,1,0,1,0,2
4437,780521,29,3,6,1,1,2,5,0,0,0,3,1,1,0,2,0,8
4437,775163,16,5,5,5,5,0,0,2,3,0,3,4,4,0,3,1,12
4437,791370,32,3,8,2,5,1,3,1,3,3,7,3,1,0,1,1,8
4437,786199,33,7,14,5,9,2,5,7,8,4,6,7,0,1,4,0,23
4437,780991,32,4,9,3,6,1,3,0,0,0,6,3,2,0,5,1,9
4437,780145,15,4,5,4,5,0,0,1,1,2,0,2,3,0,1,0,9
4437,781611,9,0,1,0,1,0,0,0,0,0,1,0,3,1,0,0,0
4437,797271,16,3,6,2,3,1,3,0,0,1,3,1,2,1,1,0,7
4437,743593,14,2,3,2,2,0,1,1,3,0,3,0,1,0,3,0,5
4437,791371,4,0,1,0,1,0,0,0,0,0,0,0,0,0,0,0,0
4438,797766,16,2,4,2,3,0,1,0,0,0,1,0,1,0,0,1,4
4438,791372,36,7,16,5,7,2,9,2,2,1,5,3,3,2,2,1,18
4438,792164,31,1,8,1,4,0,4,2,2,0,5,1,1,0,0,1,4
4438,780974,37,6,12,6,9,0,3,9,11,2,8,3,2,2,1,1,21
4438,797767,25,1,4,0,2,1,2,4,6,0,3,2,1,1,1,0,7
4438,797772,16,4,6,1,2,3,4,0,0,0,1,0,1,2,2,0,11
4438,792163,30,0,4,0,2,0,2,0,0,1,4,1,4,4,3,0,0
4438,797764,9,0,1,0,1,0,0,0,0,0,0,0,1,0,0,0,0
4439,791482,31,2,6,1,3,1,3,0,0,1,0,1,3,0,3,1,5
4439,786319,21,5,8,5,8,0,0,1,3,0,6,3,3,0,1,0,11
4439,784268,33,7,13,5,9,2,4,2,2,1,4,2,2,0,4,0,18
4439,786318,35,3,10,2,4,1,6,0,0,0,6,1,2,0,1,0,7
4439,780223,36,5,7,4,4,1,3,1,1,0,3,4,2,1,2,1,12
4439,791481,11,0,0,0,0,0,0,0,0,1,5,0,3,0,1,0,0
4439,797199,10,2,4,2,4,0,0,0,0,0,0,0,0,0,0,0,4
4439,780225,14,1,4,1,3,0,1,0,0,0,2,0,1,1,1,0,2
4439,797200,6,0,2,0,0,0,2,0,0,0,1,0,2,0,1,0,0
4439,797198,3,0,0,0,0,0,0,0,0,0,1,0,0,0,0,0,0
4440,781319,18,5,8,5,8,0,0,6,6,2,2,1,5,2,4,0,16
4440,786693,21,5,11,2,4,3,7,2,2,1,2,3,1,2,2,0,15
4440,781329,28,6,10,6,10,0,0,0,1,1,3,8,1,4,1,0,12
4440,797876,20,2,3,2,3,0,0,0,1,1,4,0,1,0,2,0,4
4440,792222,19,1,4,0,1,1,3,0,0,3,0,1,2,1,1,0,3
4440,792220,23,4,12,1,2,3,10,0,0,1,4,1,0,2,1,0,11
4440,792046,17,4,11,3,4,1,7,0,0,0,1,1,0,2,3,0,9
4440,792221,18,4,7,4,4,0,3,0,0,2,4,4,3,4,0,2,8
4440,786656,14,1,3,1,3,0,0,1,2,1,5,0,5,0,2,6,3
4440,792447,1,0,1,0,1,0,0,1,2,0,1,0,0,0,0,0,1
4440,781455,20,0,1,0,1,0,0,0,2,1,2,2,2,0,0,0,0
4440,776059,1,0,0,0,0,0,0,0,0,1,0,0,0,0,0,0,0
4441,796882,28,3,6,3,6,0,0,7,8,1,4,3,2,1,4,0,13
4441,796884,30,4,8,4,7,0,1,1,2,1,2,3,4,2,5,1,9
4441,796887,17,2,7,1,3,1,4,1,2,0,1,1,0,0,6,0,6
4441,796892,17,1,5,1,5,0,0,1,2,1,1,0,3,0,1,0,3
4441,796886,18,0,3,0,3,0,0,0,0,0,2,0,1,1,1,0,0
4441,796896,22,3,5,3,3,0,2,2,2,1,3,2,2,1,6,0,8
4441,796891,22,3,8,3,7,0,1,0,1,1,2,0,4,0,2,0,6
4441,796889,14,2,5,2,2,0,3,0,0,1,1,0,2,1,3,1,4
4441,796888,13,0,2,0,1,0,1,0,0,0,3,1,2,0,0,0,0
4441,796881,12,0,1,0,0,0,1,0,0,0,0,0,0,0,1,0,0
4441,776336,6,0,1,0,0,0,1,0,0,1,0,0,0,0,0,0,0
4441,796894,1,0,1,0,1,0,0,0,0,0,0,0,0,0,0,0,0
4442,786623,27,3,4,3,4,0,0,0,0,3,5,0,3,0,2,0,6
4442,797405,34,7,19,7,18,0,1,3,4,5,7,2,3,1,1,0,17
4442,791834,24,0,4,0,3,0,1,0,0,0,0,2,2,2,2,0,0
4442,785920,38,9,15,8,11,1,4,6,6,1,4,3,0,0,2,0,25
4442,785698,24,3,9,1,4,2,5,0,0,1,4,1,1,1,1,0,8
4442,797413,3,0,0,0,0,0,0,0,0,0,0,0,3,0,0,0,0
4442,786624,12,0,2,0,2,0,0,0,0,2,0,0,2,0,1,0,0
4442,791833,21,1,9,1,8,0,1,2,2,1,1,2,5,0,0,0,4
4442,784077,17,3,6,0,1,3,5,0,0,0,1,0,2,0,0,0,9
4443,791728,14,2,2,2,2,0,0,2,2,3,2,0,1,0,1,1,6
4443,797317,33,2,7,2,4,0,3,3,5,0,2,3,3,2,1,0,7
4443,791726,35,6,11,1,3,5,8,4,8,0,3,3,0,1,2,0,21
4443,780773,39,7,11,5,8,2,3,1,4,0,9,6,2,0,4,0,17
4443,775228,33,3,7,1,1,2,6,2,2,0,1,0,2,1,0,0,10
4443,786569,25,4,6,4,6,0,0,2,2,1,5,1,3,0,2,1,10
4443,797315,0,0,0,0,0,0,0,0,0,0,0,0,0,0,0,0,0
4443,797313,21,3,6,2,3,1,3,0,0,0,6,0,1,0,1,0,7
4444,786123,39,3,7,3,7,0,0,2,4,5,7,1,2,2,0,4,8
4444,780437,34,2,7,2,5,0,2,0,0,2,5,2,2,1,0,0,4
4444,797673,40,5,15,5,12,0,3,1,2,4,5,2,4,2,2,0,11
4444,786118,23,0,3,0,1,0,2,0,1,0,2,1,2,2,1,0,0
4444,786117,40,8,16,8,12,0,4,12,14,0,2,2,2,1,3,0,28
4444,797675,1,0,0,0,0,0,0,0,0,0,0,0,1,0,0,0,0
4444,797672,4,0,2,0,1,0,1,0,0,0,0,0,0,0,0,0,0
4444,792093,19,2,5,0,1,2,4,5,6,0,2,0,1,1,1,0,11
4445,796912,20,2,6,0,2,2,4,0,0,3,2,0,6,0,1,2,6
4445,775626,29,4,10,3,7,1,3,3,8,2,7,3,1,1,3,0,12
4445,774964,27,7,10,7,9,0,1,0,0,1,2,1,3,0,1,1,14
4445,796907,22,0,4,0,3,0,1,0,0,1,3,1,4,1,1,0,0
4445,774962,33,2,10,0,4,2,6,0,1,1,2,7,1,0,3,0,6
4445,796910,12,1,2,1,2,0,0,0,0,1,0,0,2,0,1,0,2
4445,785606,12,0,3,0,3,0,0,0,0,2,3,0,2,0,3,2,0
4445,796906,26,0,1,0,0,0,1,0,0,0,2,3,0,2,0,0,0
4445,775566,14,3,6,1,2,2,4,0,0,1,2,0,3,0,1,0,8
4445,796908,5,0,1,0,0,0,1,0,0,0,1,1,0,0,0,0,0
4446,791493,32,6,9,6,8,0,1,2,3,5,5,3,4,1,5,1,14
4446,789036,37,6,14,6,13,0,1,1,5,2,6,1,1,1,0,0,13
4446,776494,34,2,8,0,1,2,7,2,5,1,2,1,4,3,2,0,8
4446,797191,10,0,0,0,0,0,0,2,2,0,1,0,1,0,1,0,2
4446,791494,14,0,4,0,3,0,1,0,0,0,0,0,0,0,4,0,0
4446,791492,26,4,10,1,3,3,7,0,0,1,0,2,2,2,0,0,11
4446,786324,33,1,6,0,1,1,5,6,6,0,3,3,3,0,2,0,9
4446,781307,7,1,1,1,1,0,0,0,0,1,1,0,1,0,0,1,2
4446,791495,7,0,0,0,0,0,0,0,0,0,0,0,0,1,0,0,0
4447,792223,39,7,16,4,6,3,10,1,1,1,3,2,4,1,4,0,18
4447,785935,39,5,10,3,6,2,4,4,4,0,0,3,1,0,5,0,16
4447,776128,38,4,8,2,3,2,5,2,2,1,9,5,5,1,8,0,12
4447,781352,22,4,4,4,4,0,0,0,0,1,3,0,4,0,1,0,8
4447,792227,28,2,5,0,3,2,2,1,2,0,2,1,3,2,0,0,7
4447,786453,5,0,2,0,1,0,1,2,3,3,0,0,0,0,0,1,2
4447,781351,11,0,2,0,1,0,1,0,0,1,2,2,2,0,1,0,0
4447,797881,11,0,0,0,0,0,0,0,0,0,2,0,4,0,0,1,0
4447,797889,7,0,1,0,1,0,0,0,0,0,1,0,1,0,0,0,0
4448,791883,18,3,3,1,1,2,2,0,0,0,4,1,3,0,3,2,8
4448,781066,23,3,5,3,5,0,0,0,0,0,5,5,1,1,1,0,6
4448,797594,23,3,5,1,1,2,4,1,2,0,1,1,0,0,0,0,9
4448,791884,21,3,7,3,6,0,1,2,2,1,7,3,2,0,5,0,8
4448,780695,30,5,8,3,3,2,5,4,6,0,5,1,1,0,0,0,16
4448,797600,15,1,4,1,3,0,1,0,0,0,4,1,1,0,2,0,2
4448,797598,6,2,3,2,3,0,0,0,2,2,1,1,5,0,0,0,4
4448,797597,5,0,0,0,0,0,0,0,0,0,0,0,0,0,0,0,0
4448,791885,10,0,1,0,1,0,0,0,0,1,1,1,4,0,0,0,0
4448,797596,28,2,8,0,4,2,4,0,0,1,2,1,0,1,2,0,6
4448,786496,21,2,4,2,3,0,1,0,0,0,2,1,0,2,1,0,4
4449,780095,23,1,4,1,4,0,0,0,0,1,1,1,2,1,2,0,2
4449,776321,22,0,8,0,3,0,5,4,4,0,3,0,3,0,3,1,4
4449,786081,24,1,8,1,5,0,3,1,2,0,2,0,1,1,1,0,3
4449,785431,32,3,8,2,4,1,4,0,2,0,3,2,3,0,2,0,7
4449,780232,18,1,4,0,2,1,2,0,1,0,1,0,4,0,1,0,3
4449,786020,14,3,6,3,6,0,0,0,0,2,2,0,0,0,0,1,6
4449,785356,20,0,2,0,0,0,2,2,2,0,2,0,2,0,0,0,2
4449,789019,11,0,3,0,0,0,3,0,0,0,1,0,0,1,1,0,0
4449,797918,6,0,1,0,0,0,1,0,0,0,0,0,0,0,0,0,0
4449,789040,30,2,8,2,3,0,5,2,4,2,2,1,1,0,3,0,6
4450,785916,19,1,7,0,5,1,2,3,3,0,2,0,4,0,1,2,6
4450,780105,31,6,10,4,7,2,3,2,2,2,4,0,5,0,2,1,16
4450,785637,33,1,5,1,3,0,2,4,4,0,2,3,3,1,1,0,6
4450,785915,38,4,8,0,0,4,8,0,0,0,5,2,1,1,0,0,12
4450,781131,33,5,13,5,12,0,1,2,3,2,8,4,4,2,6,0,12
4450,791408,13,4,6,4,6,0,0,3,6,0,1,1,1,1,1,0,11
4450,780106,17,0,1,0,1,0,0,1,2,1,4,1,2,0,1,2,1
4450,797108,1,0,0,0,0,0,0,0,0,0,0,0,0,0,0,0,0
4450,791409,15,1,3,1,2,0,1,1,3,0,3,0,1,0,0,2,3
4451,780631,17,1,7,1,3,0,4,1,2,1,2,0,2,1,0,1,3
4451,791827,33,6,18,6,18,0,0,7,9,6,8,0,2,1,4,0,19
4451,797391,27,2,4,1,2,1,2,1,1,0,1,1,3,0,0,0,6
4451,786625,20,0,1,0,0,0,1,0,0,1,0,0,2,0,1,0,0
4451,780625,33,0,4,0,1,0,3,0,0,0,1,5,2,1,1,0,0
4451,797397,6,1,1,1,1,0,0,3,4,0,2,0,1,0,1,0,5
4451,785481,22,3,7,3,5,0,2,2,3,1,4,0,2,0,1,1,8
4451,797395,24,3,10,3,9,0,1,2,4,0,5,4,2,1,3,0,8
4451,791828,1,0,0,0,0,0,0,0,0,0,0,0,0,0,0,0,0
4451,786630,17,2,8,2,7,0,1,0,0,2,2,1,2,0,0,0,4
4452,780229,31,5,10,5,10,0,0,4,5,2,1,4,3,1,3,1,14
4452,795572,32,8,11,6,9,2,2,3,4,3,5,3,1,2,1,1,21
4452,791483,31,1,2,1,1,0,1,4,5,2,5,2,1,0,1,0,6
4452,786322,34,2,5,2,2,0,3,5,6,0,6,1,0,1,1,0,9
4452,780228,34,5,15,2,4,3,11,2,2,0,3,2,2,2,0,1,15
4452,791487,6,1,1,1,1,0,0,0,0,0,1,0,0,1,0,0,2
4452,781592,19,5,6,4,5,1,1,6,7,3,1,0,4,0,1,0,17
4452,791488,8,0,2,0,1,0,1,0,0,0,0,0,1,0,1,0,0
4452,797193,0,0,1,0,1,0,0,0,0,0,0,0,0,0,0,0,0
4452,791485,5,0,1,0,0,0,1,0,0,0,0,0,0,1,0,0,0
4453,797616,22,1,3,0,0,1,3,2,2,0,1,2,5,1,2,0,5
4453,791882,30,7,8,6,6,1,2,0,0,3,2,0,3,1,1,0,15
4453,786493,32,2,11,1,2,1,9,4,5,0,7,4,4,0,2,0,9
4453,791881,31,5,7,2,3,3,4,2,2,1,1,1,0,2,3,0,15
4453,786420,34,3,10,2,5,1,5,1,2,1,1,5,4,0,3,0,8
4453,797618,14,3,5,3,5,0,0,0,0,2,2,0,2,1,0,0,6
4453,797617,0,0,1,0,1,0,0,0,0,0,0,0,0,0,0,0,0
4453,797613,13,3,6,0,0,3,6,0,0,0,2,0,0,0,0,0,9
4453,781258,0,0,0,0,0,0,0,0,0,0,0,0,1,0,0,0,0
4453,781052,24,2,6,1,2,1,4,0,0,0,0,1,3,0,1,0,5
4453,797614,0,0,0,0,0,0,0,0,0,0,0,0,0,0,0,0,0
4454,797325,42,3,9,3,9,0,0,0,0,3,2,0,3,0,2,1,6
4454,797329,22,0,4,0,1,0,3,1,2,0,2,1,5,0,1,1,1
4454,797323,34,7,22,4,17,3,5,9,10,2,5,4,5,5,3,0,26
4454,786236,43,5,16,3,10,2,6,8,9,0,3,0,5,1,2,0,20
4454,780759,42,5,12,3,5,2,7,7,7,0,2,0,3,5,2,0,19
4454,781002,19,1,2,1,2,0,0,4,6,2,3,0,2,1,1,1,6
4454,776478,3,0,0,0,0,0,0,0,0,0,0,0,0,0,0,0,0
4454,797322,12,3,7,1,4,2,3,2,2,0,0,0,0,0,0,0,10
4454,786239,7,1,1,1,1,0,0,2,4,1,0,0,3,0,0,0,4
4454,786233,1,0,0,0,0,0,0,0,0,0,1,0,3,0,0,0,0
4454,786246,0,0,0,0,0,0,0,0,0,0,0,0,0,0,0,0,0
4454,797324,0,0,0,0,0,0,0,0,0,0,0,0,0,0,0,0,0
4455,781454,40,4,8,4,6,0,2,4,5,3,8,3,4,0,3,1,12
4455,786424,41,8,12,8,12,0,0,13,15,4,10,0,4,2,3,4,29
4455,792366,39,7,14,7,13,0,1,7,10,1,2,3,5,1,3,0,21
4455,791015,28,2,6,1,2,1,4,1,1,0,2,3,4,0,1,0,6
4455,785483,35,8,12,6,9,2,3,2,5,0,5,0,4,0,7,0,20
4455,797991,3,0,0,0,0,0,0,1,2,0,0,0,1,0,1,0,1
4455,785959,6,0,0,0,0,0,0,0,0,0,0,0,0,0,0,0,0
4455,797988,17,0,2,0,0,0,2,1,2,0,3,0,4,2,3,0,1
4455,797979,16,1,3,0,1,1,2,0,1,0,2,0,3,1,1,0,3
4456,780634,25,4,5,4,5,0,0,1,3,7,5,1,2,3,1,1,9
4456,786785,32,2,13,2,8,0,5,0,0,1,6,2,0,0,0,0,4
4456,786784,17,1,6,1,4,0,2,0,0,3,5,0,3,0,1,1,2
4456,780633,30,4,11,4,9,0,2,0,0,1,4,0,2,0,2,0,8
4456,776009,33,9,15,8,11,1,4,0,2,1,1,3,4,1,4,0,19
4456,797389,15,1,3,1,3,0,0,1,2,1,2,0,1,0,0,0,3
4456,791826,27,1,5,1,2,0,3,0,0,2,4,0,5,1,4,0,2
4456,786783,21,3,9,2,6,1,3,0,0,1,3,0,2,1,0,2,7
4457,776004,23,3,11,3,7,0,4,4,4,3,5,0,1,2,2,1,10
4457,790930,35,2,3,2,3,0,0,0,3,2,4,2,4,1,1,2,4
4457,775011,34,5,12,5,9,0,3,4,5,1,5,0,2,2,0,4,14
4457,780357,36,3,12,0,3,3,9,5,5,0,7,1,3,3,1,0,14
4457,775018,32,4,8,2,3,2,5,3,4,0,4,5,2,2,2,0,13
4457,780358,17,1,5,0,2,1,3,0,0,0,0,0,1,0,0,1,3
4457,796480,11,1,2,1,2,0,0,0,0,1,1,1,4,0,2,1,2
4457,776270,12,0,1,0,0,0,1,0,0,0,0,1,0,0,1,0,0
4458,797523,26,0,2,0,1,0,1,0,0,1,5,1,2,1,1,0,0
4458,791699,15,2,4,1,2,1,2,0,0,1,0,1,3,0,3,0,5
4458,792118,34,9,15,5,7,4,8,1,2,0,5,4,1,1,5,0,23
4458,782593,34,5,12,2,5,3,7,0,0,0,8,5,0,0,2,0,13
4458,785402,25,5,10,5,10,0,0,3,4,2,5,2,3,0,2,0,13
4458,791702,16,0,1,0,1,0,0,1,2,2,1,0,3,0,0,1,1
4458,791700,28,3,5,2,2,1,3,2,2,1,0,1,0,0,0,0,9
4458,797526,7,1,1,0,0,1,1,0,0,0,0,0,0,0,0,0,3
4458,785828,15,3,4,3,3,0,1,0,0,0,2,2,4,1,1,1,6
4459,791281,35,5,12,4,9,1,3,4,6,1,5,2,3,1,6,1,15
4459,785764,17,3,5,3,5,0,0,0,0,1,1,0,2,0,1,0,6
4459,786026,25,3,10,2,5,1,5,0,0,0,1,0,3,3,2,1,7
4459,792276,33,4,9,1,4,3,5,4,4,0,3,4,3,1,1,0,15
4459,785398,20,2,6,2,2,0,4,0,0,0,1,0,0,0,0,0,4
4459,796535,19,2,3,1,1,1,2,0,1,1,1,3,1,2,1,0,5
4459,796537,12,1,3,0,2,1,1,0,0,0,1,0,0,0,0,0,3
4459,791278,15,1,2,1,1,0,1,0,0,1,0,1,1,1,0,0,2
4459,785507,18,0,5,0,1,0,4,0,0,0,3,0,1,0,0,0,0
4459,796536,6,0,1,0,1,0,0,0,0,1,0,0,0,1,0,0,0
4480,786180,20,2,2,2,2,0,0,0,0,1,1,1,2,1,0,4,4
4480,792104,29,7,20,2,9,5,11,1,2,1,2,1,3,2,1,1,20
4480,797708,27,4,8,4,6,0,2,1,2,3,1,8,2,5,4,0,9
4480,786198,31,6,13,4,9,2,4,1,2,0,1,2,2,2,1,1,15
4480,775779,30,1,6,1,5,0,1,5,5,1,3,4,0,0,2,0,7
4480,776327,5,0,1,0,1,0,0,0,0,0,1,0,1,0,0,1,0
4480,797709,19,2,8,1,5,1,3,0,0,0,5,2,2,1,2,0,5
4480,786204,17,2,5,1,3,1,2,0,0,1,1,0,2,0,1,0,5
4480,797707,14,1,4,0,2,1,2,1,2,3,0,0,5,1,0,0,4
4480,785608,8,1,2,1,2,0,0,0,1,1,2,1,2,0,0,0,2
4481,797050,26,4,9,2,5,2,4,1,1,2,3,2,1,0,3,1,11
4481,780394,21,3,9,3,7,0,2,0,0,0,7,0,4,1,1,1,6
4481,780391,31,2,5,2,5,0,0,5,5,3,3,2,3,0,3,3,9
4481,790871,35,6,10,5,7,1,3,1,2,0,5,0,1,3,3,0,14
4481,776473,28,2,8,1,5,1,3,2,2,1,2,2,4,2,4,0,7
4481,797048,23,4,6,4,5,0,1,5,6,3,4,1,3,0,1,2,13
4481,791573,12,0,1,0,0,0,1,0,0,0,2,3,0,0,1,0,0
4481,780392,24,5,8,2,3,3,5,0,0,1,3,2,2,1,3,0,13
4482,781300,30,6,10,6,9,0,1,7,7,0,4,5,3,3,3,1,19
4482,790803,30,3,4,3,4,0,0,4,4,3,6,0,3,1,2,3,10
4482,790801,31,3,9,3,9,0,0,4,4,0,1,4,0,3,3,0,10
4482,781304,32,6,11,2,6,4,5,5,6,0,3,3,1,3,3,0,21
4482,781302,27,1,2,0,0,1,2,2,2,0,1,0,3,0,2,0,5
4482,780598,15,3,5,1,2,2,3,2,2,1,1,0,1,0,1,1,10
4482,796364,7,1,1,1,1,0,0,2,2,0,1,0,2,0,0,1,4
4482,790802,2,0,2,0,0,0,2,0,0,0,0,0,1,0,1,0,0
4482,781305,10,0,1,0,0,0,1,0,0,1,2,0,2,0,1,0,0
4482,796363,16,1,5,0,3,1,2,0,0,0,1,0,0,0,1,0,3
4483,790856,17,3,6,3,6,0,0,3,5,3,2,1,1,0,0,0,9
4483,780452,33,3,5,3,5,0,0,6,7,0,1,3,3,2,2,0,12
4483,796413,29,5,13,1,3,4,10,0,0,0,2,2,4,0,2,0,14
4483,796408,21,4,10,1,4,3,6,0,0,1,1,0,1,2,4,0,11
4483,796407,20,0,3,0,2,0,1,0,0,2,2,3,4,2,2,0,0
4483,796410,22,3,7,3,7,0,0,0,0,4,2,2,2,0,2,1,6
4483,796409,20,6,9,4,6,2,3,2,2,0,4,3,1,1,1,0,16
4483,780450,19,1,6,1,4,0,2,0,0,1,0,2,1,1,0,0,2
4483,796412,2,0,1,0,0,0,1,0,0,0,0,0,1,0,1,0,0
4483,796411,8,0,0,0,0,0,0,0,0,0,1,0,1,1,0,0,0
4483,790858,9,2,2,1,1,1,1,0,0,0,0,3,1,0,0,0,5
4484,792486,14,1,2,0,1,1,1,0,0,1,1,0,0,0,1,0,3
4484,785772,25,2,6,2,6,0,0,3,4,4,2,1,4,0,3,1,7
4484,785778,10,0,1,0,1,0,0,1,4,3,2,1,0,0,1,0,1
4484,785766,34,5,16,5,8,0,8,4,7,2,4,2,2,0,2,0,14
4484,780543,40,10,22,6,14,4,8,10,14,2,1,2,0,3,0,1,34
4484,792481,20,4,8,4,8,0,0,2,2,3,1,0,1,0,1,0,10
4484,792488,12,1,2,1,1,0,1,0,0,0,1,0,0,0,0,0,2
4484,792482,29,1,3,1,3,0,0,7,7,2,2,2,3,1,2,0,9
4484,792489,19,0,2,0,1,0,1,2,2,2,1,1,1,2,1,0,2
4484,797419,22,2,3,1,2,1,1,0,0,0,1,0,2,1,2,0,5
4485,796550,37,5,10,1,2,4,8,0,0,0,8,1,4,0,5,6,14
4485,785275,33,3,6,3,6,0,0,1,2,3,4,4,4,0,4,1,7
4485,790956,33,3,9,2,5,1,4,0,0,1,3,5,4,0,3,0,7
4485,785089,34,10,13,5,7,5,6,5,7,1,4,2,5,1,5,1,30
4485,780460,43,8,14,4,6,4,8,0,0,1,1,4,3,1,3,0,20
4485,796549,12,1,1,1,1,0,0,0,0,0,1,0,3,2,0,0,2
4485,796551,18,1,4,1,2,0,2,0,0,0,3,1,5,1,0,0,2
4485,796547,14,2,2,2,2,0,0,0,0,1,0,1,1,1,0,0,4
4485,796552,1,0,1,0,1,0,0,0,0,0,0,0,0,0,0,0,0
4486,792560,17,0,1,0,1,0,0,0,0,0,2,0,1,0,0,0,0
4486,792565,33,4,7,4,6,0,1,1,2,4,5,1,1,0,5,0,9
4486,798132,6,0,0,0,0,0,0,0,0,0,0,0,1,0,1,0,0
4486,798134,17,1,6,1,4,0,2,0,0,0,1,1,2,1,2,0,2
4486,792561,31,7,12,4,9,3,3,2,2,0,2,4,1,2,1,0,19
4486,780266,28,4,12,2,4,2,8,1,2,0,5,0,3,1,3,0,11
4486,776333,12,0,1,0,1,0,0,0,0,3,2,0,1,1,2,1,0
4486,792563,17,0,7,0,5,0,2,2,2,0,1,2,2,1,1,0,2
4486,780270,24,3,6,2,2,1,4,2,5,1,2,1,0,0,2,0,9
4486,789634,4,0,0,0,0,0,0,0,0,0,1,0,1,0,0,0,0
4486,785472,4,0,0,0,0,0,0,0,0,2,0,0,0,0,0,0,0
4486,798133,7,0,0,0,0,0,0,0,0,0,0,1,0,0,0,0,0
4487,790863,23,4,5,3,4,1,1,0,1,0,5,1,4,1,1,2,9
4487,780021,33,5,6,5,6,0,0,4,5,5,5,1,1,1,2,3,14
4487,785412,19,3,6,2,3,1,3,0,0,1,0,1,1,0,4,0,7
4487,780099,19,1,8,0,1,1,7,0,0,0,2,1,1,1,2,0,3
4487,776214,37,6,14,4,8,2,6,1,2,1,5,6,1,4,1,1,15
4487,785413,27,5,8,4,6,1,2,1,1,1,1,2,2,0,3,0,12
4487,785411,5,0,3,0,1,0,2,0,0,1,1,1,0,0,0,0,0
4487,776221,19,1,2,1,1,0,1,0,0,0,3,2,2,1,1,0,2
4487,775686,16,2,3,2,3,0,0,2,2,0,1,0,2,0,0,0,6
4487,785417,2,0,0,0,0,0,0,0,0,0,0,0,0,0,0,0,0
4488,785329,20,2,11,1,6,1,5,2,2,4,2,1,1,0,2,0,7
4488,780282,27,3,6,3,6,0,0,0,0,1,3,2,1,0,2,1,6
4488,780277,30,6,14,3,5,3,9,2,2,1,5,2,2,0,3,0,17
4488,791003,24,2,5,1,1,1,4,0,1,0,3,1,3,0,3,0,5
4488,791002,24,0,1,0,1,0,0,0,0,0,1,1,3,0,3,0,0
4488,796662,17,1,3,0,0,1,3,1,1,0,2,1,2,1,1,0,4
4488,796661,8,2,5,0,2,2,3,0,0,1,0,1,3,0,1,1,6
4488,785326,24,1,2,0,0,1,2,2,2,0,1,3,2,0,2,0,5
4488,780279,23,3,6,0,0,3,6,0,0,0,4,0,1,1,1,0,9
4488,792707,1,0,0,0,0,0,0,0,0,0,0,0,0,0,0,0,0
4488,792706,1,0,0,0,0,0,0,0,0,0,1,1,0,0,0,0,0
4488,792705,1,0,0,0,0,0,0,0,0,0,0,0,0,0,0,0,0
4489,796585,15,3,4,3,4,0,0,0,0,0,2,0,4,1,0,1,6
4489,780192,22,9,12,7,8,2,4,0,2,0,1,1,4,2,2,0,20
4489,798139,20,3,8,2,4,1,4,0,0,1,1,0,2,1,1,0,7
4489,786818,29,7,10,6,9,1,1,0,4,1,5,0,1,2,1,0,15
4489,780182,22,3,7,2,3,1,4,3,3,0,2,1,3,0,1,0,10
4489,780186,20,3,4,3,4,0,0,0,2,3,4,2,0,0,2,0,6
4489,798138,14,0,2,0,1,0,1,0,0,0,0,0,0,1,0,0,0
4489,786820,19,0,2,0,2,0,0,4,4,0,4,6,0,0,1,0,4
4489,780184,20,0,6,0,2,0,4,2,2,0,3,2,0,1,0,0,2
4489,796587,5,1,1,1,1,0,0,0,0,0,2,1,0,1,0,0,2
4489,790974,2,0,1,0,1,0,0,0,0,0,0,1,0,0,0,0,0
4489,786819,2,0,2,0,2,0,0,0,0,0,0,0,0,0,0,0,0
4489,780188,10,3,3,2,2,1,1,0,0,1,1,0,1,0,1,0,7
4490,786765,34,12,22,11,14,1,8,8,9,3,8,5,4,0,4,2,33
4490,797852,33,3,6,2,4,1,2,7,9,0,4,2,2,1,2,0,14
4490,792379,37,8,14,1,4,7,10,2,2,3,10,2,4,1,1,1,25
4490,792380,39,2,6,1,3,1,3,4,4,0,1,4,2,1,1,0,9
4490,781669,38,10,17,8,14,2,3,5,6,4,5,3,2,3,0,0,27
4490,781668,5,1,2,1,2,0,0,0,0,0,0,0,4,0,1,0,2
4490,797860,1,0,0,0,0,0,0,0,0,0,0,0,1,0,0,0,0
4490,797854,6,0,1,0,0,0,1,0,0,0,0,0,3,0,0,1,0
4490,781671,7,0,1,0,1,0,0,0,0,0,0,0,2,0,1,0,0
4491,792249,18,2,7,2,6,0,1,3,5,3,1,3,0,0,0,1,7
4491,781430,26,6,14,6,12,0,2,7,9,4,4,0,4,2,2,0,19
4491,792248,37,5,10,3,5,2,5,2,2,1,5,2,3,2,2,0,14
4491,781445,38,9,15,2,5,7,10,4,5,2,5,0,1,0,0,0,29
4491,768845,32,6,13,5,9,1,4,1,2,1,3,5,2,0,4,0,14
4491,797957,3,0,0,0,0,0,0,0,0,0,1,0,1,0,0,0,0
4491,792253,17,2,4,2,4,0,0,4,8,2,4,1,4,1,0,0,8
4491,781448,4,0,1,0,1,0,0,0,0,0,0,1,1,0,0,0,0
4491,797941,12,3,6,1,3,2,3,1,1,0,0,1,3,0,0,0,9
4491,792250,13,1,3,0,0,1,3,0,0,0,1,2,3,0,2,0,3
4492,775820,20,1,4,0,0,1,4,0,1,1,7,0,2,1,0,2,3
4492,775538,26,1,2,1,2,0,0,3,6,2,1,0,4,1,0,0,5
4492,791110,36,6,14,5,10,1,4,4,5,0,4,1,2,0,0,0,17
4492,785603,34,7,15,7,13,0,2,0,1,0,4,3,1,0,1,1,14
4492,776425,37,3,9,2,5,1,4,0,0,1,4,3,2,2,3,0,7
4492,796763,11,2,5,1,2,1,3,0,0,1,0,1,3,0,1,1,5
4492,791107,2,0,2,0,2,0,0,0,0,0,1,0,2,1,1,0,0
4492,791106,24,4,6,1,2,3,4,0,0,0,3,0,1,0,0,1,11
4492,786494,10,0,3,0,2,0,1,0,0,0,1,0,1,0,0,0,0
4493,797591,10,0,2,0,1,0,1,0,0,0,0,0,0,0,0,0,0
4493,781071,30,5,11,2,4,3,7,0,0,1,1,0,3,0,1,0,13
4493,791889,36,2,4,1,2,1,2,2,2,1,3,3,1,0,2,0,7
4493,791890,37,7,16,6,11,1,5,5,6,0,5,2,2,3,3,0,20
4493,780719,32,4,8,3,6,1,2,4,4,0,10,3,4,1,2,0,13
4493,785424,17,2,5,2,5,0,0,7,14,5,3,0,1,0,0,1,11
4493,780098,4,0,0,0,0,0,0,0,0,0,1,0,0,0,0,0,0
4493,797589,27,1,5,0,2,1,3,0,0,1,6,2,1,0,1,1,3
4493,797588,7,0,2,0,2,0,0,0,0,0,0,0,2,0,0,0,0
4494,797281,21,0,4,0,4,0,0,0,0,0,2,0,4,0,1,0,0
4494,791648,23,1,4,1,4,0,0,2,2,1,3,0,3,1,1,1,4
4494,786195,31,4,8,4,7,0,1,1,2,0,9,1,4,0,5,0,9
4494,791649,30,2,7,0,1,2,6,0,0,0,3,3,0,1,0,0,6
4494,797280,34,8,11,4,6,4,5,2,2,1,1,4,2,2,3,0,22
4494,791647,19,2,3,2,3,0,0,0,0,0,3,0,1,0,1,0,4
4494,797279,17,2,4,1,1,1,3,3,3,0,1,0,2,0,2,0,8
4494,786640,25,2,4,1,3,1,1,0,0,0,2,3,0,0,0,0,5
4495,797587,32,6,9,6,9,0,0,1,1,2,3,1,3,0,2,1,13
4495,791891,12,1,2,1,1,0,1,0,0,0,1,0,0,0,0,0,2
4495,786501,34,3,11,1,3,2,8,0,0,0,1,1,1,1,1,0,8
4495,791895,37,2,5,2,5,0,0,1,2,3,2,3,2,1,3,0,5
4495,786502,40,6,19,6,18,0,1,3,3,1,7,4,1,2,1,0,15
4495,797586,3,0,1,0,1,0,0,0,0,0,0,0,0,1,0,0,0
4495,781078,31,6,9,3,5,3,4,2,3,0,4,0,1,1,0,1,17
4495,797584,8,1,1,1,1,0,0,0,0,0,0,0,2,0,1,0,2
4495,781561,3,0,0,0,0,0,0,0,0,0,1,1,0,0,0,0,0
4496,781579,27,1,9,1,7,0,2,2,2,4,2,0,3,1,3,0,4
4496,786731,29,4,6,4,6,0,0,2,6,2,8,4,5,1,5,5,10
4496,798023,23,2,7,1,4,1,3,0,0,0,4,2,1,0,2,1,5
4496,781584,34,4,8,1,2,3,6,0,0,0,2,0,3,1,0,0,11
4496,780347,32,2,6,2,5,0,1,2,3,2,5,2,1,2,3,0,6
4496,775696,20,2,6,2,3,0,3,5,6,2,5,1,2,0,0,0,9
4496,776481,4,0,0,0,0,0,0,0,0,0,0,1,0,0,1,0,0
4496,798008,23,3,8,0,2,3,6,8,8,0,2,1,3,0,0,1,17
4496,792358,8,1,1,1,1,0,0,0,0,0,0,0,1,0,1,0,2
4497,786157,21,1,5,1,5,0,0,1,5,2,3,0,2,0,1,1,3
4497,786150,13,0,1,0,1,0,0,0,0,0,3,1,3,1,1,0,0
4497,791756,29,3,10,2,7,1,3,0,0,1,3,2,4,0,1,0,7
4497,780677,23,5,9,4,4,1,5,0,0,0,3,0,4,0,1,1,11
4497,780673,22,1,3,1,2,0,1,0,0,0,2,1,0,0,2,0,2
4497,791754,20,0,0,0,0,0,0,2,4,1,4,1,1,0,1,1,2
4497,775533,21,2,7,2,5,0,2,1,2,1,2,0,4,0,0,0,5
4497,797348,25,6,8,6,7,0,1,1,2,0,2,1,0,5,3,0,13
4497,780992,26,5,13,1,6,4,7,2,2,0,1,1,4,0,0,0,16
4498,781407,25,8,15,8,12,0,3,1,1,4,5,0,1,0,1,0,17
4498,791583,21,3,5,3,5,0,0,8,13,2,8,0,3,0,5,2,14
4498,786110,25,3,8,3,6,0,2,0,0,1,2,0,1,0,0,0,6
4498,780580,33,6,12,3,7,3,5,3,4,0,3,4,2,2,0,0,18
4498,776150,27,3,6,2,4,1,2,2,2,0,0,3,2,0,2,0,9
4498,785623,15,2,3,1,1,1,2,0,0,0,3,2,0,3,0,2,5
4498,797448,20,2,3,1,1,1,2,0,0,1,3,0,0,0,0,2,5
4498,797445,15,0,0,0,0,0,0,4,6,2,3,1,1,0,0,0,4
4498,786659,17,1,1,1,1,0,0,0,0,1,3,0,2,0,4,1,2
4498,797450,1,0,0,0,0,0,0,0,0,0,1,0,0,0,0,0,0
4498,797447,1,0,0,0,0,0,0,0,2,0,0,0,0,0,0,0,0
4499,791295,20,1,8,1,7,0,1,2,4,2,2,2,3,1,0,0,4
4499,776345,19,3,8,3,7,0,1,1,1,1,2,1,4,0,1,1,7
4499,796579,37,5,14,2,4,3,10,0,0,2,2,2,2,0,1,0,13
4499,785794,33,9,17,5,9,4,8,0,0,2,3,2,2,0,3,0,22
4499,781373,36,1,9,0,4,1,5,2,2,3,6,3,3,5,1,0,5
4499,781379,11,0,1,0,1,0,0,0,0,0,2,0,3,0,1,1,0
4499,796577,3,0,0,0,0,0,0,0,0,0,1,0,0,0,1,0,0
4499,791293,10,0,1,0,1,0,0,0,0,0,0,1,1,0,1,0,0
4499,796580,2,0,1,0,1,0,0,0,0,0,0,0,0,0,0,0,0
4499,785792,24,3,9,2,5,1,4,0,0,0,2,2,2,0,1,0,7
4499,791292,5,1,1,1,1,0,0,0,0,2,0,0,0,0,0,0,2
4500,780346,19,3,9,2,5,1,4,5,6,0,4,0,5,0,5,0,12
4500,780338,23,2,4,2,4,0,0,0,3,3,3,0,4,1,2,4,4
4500,791030,25,2,4,0,1,2,3,4,4,0,1,4,1,1,1,0,10
4500,785477,35,7,12,3,5,4,7,0,1,1,7,1,0,1,1,0,18
4500,785475,26,1,5,0,0,1,5,1,2,1,4,2,2,1,1,1,4
4500,791032,15,2,5,0,1,2,4,0,0,0,0,2,1,0,0,0,6
4500,796689,16,1,6,1,6,0,0,3,4,1,6,1,2,0,1,1,5
4500,796687,16,3,4,3,4,0,0,0,2,1,1,2,2,1,2,0,6
4500,786655,25,3,4,1,1,2,3,2,3,0,1,3,0,0,0,0,10
4501,791473,18,0,1,0,1,0,0,0,0,1,3,0,3,1,3,0,0
4501,786316,27,6,14,6,14,0,0,2,2,3,3,1,4,0,2,0,14
4501,791475,22,2,5,1,2,1,3,0,0,0,3,2,4,0,1,0,5
4501,791476,20,0,4,0,1,0,3,1,2,0,1,2,0,0,0,0,1
4501,780220,35,10,19,9,16,1,3,5,7,2,3,1,5,1,2,0,26
4501,797206,10,0,1,0,1,0,0,0,0,2,0,2,2,1,1,3,0
4501,797205,9,1,3,1,3,0,0,2,2,1,2,0,0,0,0,1,4
4501,786314,29,5,6,5,6,0,0,1,2,0,4,4,1,1,1,0,11
4501,797202,3,0,2,0,0,0,2,0,0,0,0,0,2,0,0,0,0
4501,791477,27,4,9,3,8,1,1,0,0,1,5,0,3,0,2,0,9
4502,786124,27,3,6,3,6,0,0,0,1,6,6,2,3,0,1,0,6
4502,780877,22,0,1,0,1,0,0,2,2,1,3,1,1,2,2,2,2
4502,786122,28,5,12,5,8,0,4,0,0,2,4,2,3,0,4,0,10
4502,786331,24,7,13,5,9,2,4,0,0,0,2,0,2,0,0,0,16
4502,780308,23,2,5,1,2,1,3,2,4,0,2,2,2,0,0,0,7
4502,797980,7,1,1,1,1,0,0,0,0,2,1,0,1,0,1,0,2
4502,792261,23,3,7,3,7,0,0,3,5,3,1,0,2,0,1,1,9
4502,797982,2,0,1,0,0,0,1,0,0,0,0,0,0,0,0,0,0
4502,792258,19,3,6,2,2,1,4,4,5,0,3,2,2,0,4,1,11
4502,786113,25,3,6,2,3,1,3,2,2,0,2,3,3,1,5,0,9
4503,797241,28,4,7,4,7,0,0,3,4,5,5,1,4,1,1,1,11
4503,791366,19,1,5,0,2,1,3,0,0,2,1,1,4,0,3,0,3
4503,797243,11,0,0,0,0,0,0,0,2,1,0,0,0,0,0,1,0
4503,785742,32,4,12,2,3,2,9,8,8,1,2,4,2,2,1,0,18
4503,780163,36,9,14,0,2,9,12,3,5,0,3,8,0,1,2,1,30
4503,791361,16,2,7,1,3,1,4,0,0,1,3,0,1,0,2,0,5
4503,780170,12,1,5,1,5,0,0,0,0,0,1,1,2,0,0,0,2
4503,797244,21,1,3,1,3,0,0,0,2,0,1,2,3,1,2,0,2
4503,791363,13,0,1,0,0,0,1,0,0,1,1,1,1,0,0,0,0
4503,786340,12,3,4,1,1,2,3,2,2,0,2,0,1,0,0,0,10
4504,785498,25,0,6,0,3,0,3,2,3,3,2,2,0,1,1,0,2
4504,776469,40,5,13,3,10,2,3,3,5,3,6,1,3,0,3,0,15
4504,796708,39,4,11,2,6,2,5,5,6,1,9,2,3,2,0,0,15
4504,780701,41,7,14,7,13,0,1,3,6,1,1,6,1,0,1,0,17
4504,776322,31,3,7,2,3,1,4,0,0,0,3,0,4,0,2,0,7
4504,796705,28,3,8,2,5,1,3,3,4,0,0,0,4,0,0,0,10
4504,796706,16,2,5,2,5,0,0,0,1,2,2,0,1,0,0,0,4
4504,791036,5,0,0,0,0,0,0,0,0,0,1,0,1,0,0,0,0
4505,785714,34,5,5,5,5,0,0,0,0,0,7,0,3,0,3,4,10
4505,775894,31,5,11,5,9,0,2,2,4,1,2,0,3,0,3,0,12
4505,791167,29,1,3,0,0,1,3,2,2,1,1,4,3,0,1,0,5
4505,780985,43,1,6,1,1,0,5,0,0,0,4,3,1,0,1,1,2
4505,775266,40,10,22,5,11,5,11,4,6,1,6,2,4,3,3,0,29
4505,796829,10,1,1,1,1,0,0,2,2,1,1,0,3,0,0,1,4
4505,779994,11,1,3,1,2,0,1,0,0,0,3,1,1,0,0,0,2
4505,785378,18,1,3,1,2,0,1,0,0,1,5,1,3,1,2,0,2
4505,785710,9,0,0,0,0,0,0,0,0,0,0,0,1,0,0,0,0
4506,792171,31,5,10,5,10,0,0,2,5,1,2,1,1,2,4,4,12
4506,785674,29,3,5,2,2,1,3,5,5,0,5,1,4,0,2,0,12
4506,780527,14,2,3,1,2,1,1,2,2,0,1,0,3,0,3,0,7
4506,797784,30,3,7,1,3,2,4,2,2,0,5,5,4,0,5,0,10
4506,789059,27,3,7,2,4,1,3,1,2,1,2,1,3,2,2,0,8
4506,797782,19,3,6,3,5,0,1,0,0,0,2,0,0,1,1,0,6
4506,797783,14,0,0,0,0,0,0,1,2,1,1,1,1,1,0,0,1
4506,792173,15,0,1,0,1,0,0,2,2,0,2,0,3,0,0,0,2
4506,780980,18,2,5,2,5,0,0,2,2,0,2,1,3,2,0,1,6
4506,797785,1,0,0,0,0,0,0,0,0,0,0,0,0,0,0,0,0
4506,786658,1,0,0,0,0,0,0,0,0,0,0,0,0,0,0,0,0
4506,792174,1,0,1,0,0,0,1,0,0,0,0,0,0,0,0,0,0
4507,785836,37,5,8,2,2,3,6,3,5,2,8,3,2,0,4,0,16
4507,785833,29,5,8,1,1,4,7,0,0,0,2,6,2,2,1,1,14
4507,785332,6,0,1,0,0,0,1,0,0,0,2,0,1,0,0,0,0
4507,791704,34,6,10,6,9,0,1,1,2,0,3,0,1,2,1,0,13
4507,785838,17,2,5,0,1,2,4,0,0,0,1,0,2,1,1,0,6
4507,791705,6,0,0,0,0,0,0,2,2,0,0,0,0,0,0,0,2
4507,775872,10,1,3,1,1,0,2,0,0,1,0,0,2,0,0,0,2
4507,797533,9,0,1,0,1,0,0,0,0,0,0,1,1,0,1,0,0
4507,791707,24,0,4,0,3,0,1,4,4,0,6,6,3,4,1,0,4
4507,785892,28,7,14,3,7,4,7,6,6,0,0,3,2,0,1,0,24
4508,792329,25,1,5,1,5,0,0,0,0,3,2,1,0,0,0,1,2
4508,786752,20,6,10,4,6,2,4,1,1,0,1,1,2,1,1,0,15
4508,781384,21,1,2,1,1,0,1,0,1,0,3,0,2,0,0,0,2
4508,781616,20,5,12,2,3,3,9,1,1,0,5,1,0,2,2,0,14
4508,776350,23,1,6,1,2,0,4,4,4,1,3,1,2,2,3,1,6
4508,781075,16,3,8,3,5,0,3,1,1,0,3,1,0,0,1,0,7
4508,781615,13,2,3,2,2,0,1,0,0,0,4,0,2,4,2,0,4
4508,792601,15,1,3,1,2,0,1,2,3,2,1,0,1,0,1,0,4
4508,786749,25,0,1,0,0,0,1,1,2,3,6,9,0,1,3,1,1
4508,792330,6,2,4,0,1,2,3,0,1,0,2,0,2,0,0,0,6
4508,785435,5,0,0,0,0,0,0,0,0,0,0,0,1,1,0,0,0
4508,792331,8,2,3,2,2,0,1,0,0,0,1,0,0,1,0,0,4
4508,797880,1,0,0,0,0,0,0,0,0,0,0,0,0,0,0,0,0
4508,792332,1,0,0,0,0,0,0,0,0,0,0,0,0,0,0,0,0
4508,786751,1,0,0,0,0,0,0,0,0,0,0,0,0,0,0,0,0
4509,791558,10,1,3,1,2,0,1,0,0,0,1,0,3,2,2,1,2
4509,786371,21,0,5,0,5,0,0,0,0,0,5,0,4,0,1,2,0
4509,797072,29,1,5,1,5,0,0,0,0,0,2,0,1,0,2,0,2
4509,791554,23,2,6,1,3,1,3,0,0,0,3,1,3,1,3,0,5
4509,791556,26,1,9,1,5,0,4,0,0,1,1,0,1,1,3,0,2
4509,797076,16,0,4,0,3,0,1,1,2,2,3,1,2,1,3,0,1
4509,786372,19,2,5,2,5,0,0,3,5,3,7,1,2,0,2,0,7
4509,786369,27,3,5,3,4,0,1,1,1,0,3,3,2,1,1,0,7
4509,797074,9,1,4,1,2,0,2,0,0,0,0,0,1,0,0,0,2
4509,797077,2,0,0,0,0,0,0,0,0,0,0,0,0,0,1,0,0
4509,786373,11,1,5,1,2,0,3,0,0,0,1,0,0,0,0,0,2
4509,791559,7,0,0,0,0,0,0,0,0,0,0,0,0,0,0,0,0
4510,796860,36,7,13,7,12,0,1,2,2,5,5,1,4,1,2,3,16
4510,791185,28,3,7,1,3,2,4,1,2,1,3,0,5,1,2,1,9
4510,796861,24,3,4,2,2,1,2,1,2,1,0,1,2,2,1,1,8
4510,785650,25,0,6,0,3,0,3,0,0,0,1,0,0,0,0,0,0
4510,785649,36,11,20,7,9,4,11,9,9,2,3,3,1,1,6,0,35
4510,791183,24,3,8,3,8,0,0,3,4,1,1,2,4,1,1,0,9
4510,775208,9,0,1,0,1,0,0,2,2,0,0,1,0,0,2,0,2
4510,796857,0,0,0,0,0,0,0,0,0,0,0,0,0,0,0,0,0
4510,791184,18,1,3,0,2,1,1,0,0,2,2,1,5,0,1,0,3
4511,786547,21,2,3,1,1,1,2,0,0,1,2,0,4,1,0,1,5
4511,786544,29,8,13,7,12,1,1,8,8,2,4,2,4,1,4,0,25
4511,797507,28,3,3,1,1,2,2,7,8,2,2,2,1,2,1,0,15
4511,792012,40,3,14,1,6,2,8,6,6,1,5,3,3,0,2,0,14
4511,775084,37,5,10,5,7,0,3,5,6,1,2,1,2,2,3,0,15
4511,797512,3,1,2,1,2,0,0,1,2,1,0,0,2,0,1,0,3
4511,786860,12,2,3,1,2,1,1,1,2,0,1,1,1,1,0,0,6
4511,797509,8,1,1,1,1,0,0,0,0,0,1,0,1,1,0,3,2
4511,786546,22,2,2,1,1,1,1,1,2,0,1,1,1,3,1,0,6
4512,790935,32,1,2,0,1,1,1,3,4,1,5,0,4,1,2,1,6
4512,792442,26,2,2,2,2,0,0,0,1,2,5,0,3,1,1,2,4
4512,780933,36,7,16,2,3,5,13,0,0,2,2,0,2,1,1,0,19
4512,775340,42,10,22,5,6,5,16,9,9,2,3,7,2,0,6,0,34
4512,774826,29,6,11,4,6,2,5,0,0,2,3,3,2,0,0,0,14
4512,796491,9,0,1,0,0,0,1,0,0,1,3,1,4,0,0,1,0
4512,796190,13,1,5,1,2,0,3,1,1,1,1,1,2,0,1,0,3
4512,790937,19,2,2,2,2,0,0,0,0,0,1,0,2,0,0,0,4
4512,790938,13,2,2,2,2,0,0,0,0,0,1,0,3,0,1,0,4
4512,796492,6,3,4,2,3,1,1,0,0,0,0,0,0,1,0,0,7
4513,797972,33,2,6,2,6,0,0,0,0,2,2,3,1,0,1,1,4
4513,797967,42,6,9,3,5,3,4,1,2,1,3,2,2,2,0,0,16
4513,797970,37,4,11,4,9,0,2,5,6,2,2,2,2,2,3,0,13
4513,781453,36,8,23,6,14,2,9,6,7,1,8,10,2,2,1,0,24
4513,774869,42,6,10,1,1,5,9,4,4,1,0,0,4,1,0,1,21
4513,792254,15,2,6,1,3,1,3,1,4,1,1,0,3,0,0,0,6
4513,786098,20,3,5,2,4,1,1,3,4,2,3,0,1,0,0,0,10
4514,780797,15,3,6,2,2,1,4,0,0,1,8,1,5,1,0,1,7
4514,776418,26,10,13,10,13,0,0,2,4,3,4,0,5,2,1,1,22
4514,785505,39,6,15,4,9,2,6,10,13,2,1,1,4,1,3,0,24
4514,780555,31,0,9,0,5,0,4,5,5,1,1,1,3,3,2,0,5
4514,775604,30,0,2,0,0,0,2,0,0,0,4,3,5,1,2,0,0
4514,786429,22,0,0,0,0,0,0,3,4,1,4,1,4,0,0,0,3
4514,796986,4,0,0,0,0,0,0,0,0,0,1,0,1,0,0,0,0
4514,796981,33,7,10,7,8,0,2,3,4,0,3,3,2,1,5,1,17
4515,792140,30,5,7,5,7,0,0,3,4,0,3,1,3,1,2,0,13
4515,786596,31,3,14,3,10,0,4,4,4,3,3,1,2,2,5,0,10
4515,792144,33,0,4,0,2,0,2,5,8,1,5,4,5,0,0,0,5
4515,781429,39,4,9,0,0,4,9,0,0,0,1,0,2,0,0,0,12
4515,776092,36,4,11,3,7,1,4,16,18,1,7,4,4,2,1,0,25
4515,792146,7,0,1,0,1,0,0,0,0,0,0,1,0,0,0,0,0
4515,792148,12,0,1,0,1,0,0,0,0,0,0,0,4,1,3,0,0
4515,785976,7,2,3,0,0,2,3,0,0,0,0,0,0,0,0,0,6
4515,781431,5,1,1,0,0,1,1,2,2,0,0,0,2,0,1,0,5
4516,780180,24,2,5,2,3,0,2,2,2,1,5,1,2,1,2,0,6
4516,781650,26,8,11,8,11,0,0,7,8,2,1,0,3,1,3,0,23
4516,791432,26,0,4,0,2,0,2,0,0,0,2,1,1,0,2,0,0
4516,777865,34,4,9,3,7,1,2,4,4,0,2,3,5,1,0,0,13
4516,791429,26,3,6,3,5,0,1,0,0,0,4,0,0,1,2,0,6
4516,797066,14,2,7,2,7,0,0,3,4,4,2,0,2,0,0,0,7
4516,797067,11,0,2,0,1,0,1,0,0,0,1,0,2,0,0,0,0
4516,797070,12,1,3,1,2,0,1,0,0,0,2,0,0,0,1,0,2
4516,797068,13,0,1,0,1,0,0,2,2,0,1,1,0,1,2,0,2
4516,776079,14,1,2,1,1,0,1,0,0,0,1,0,1,0,1,0,2
4517,786509,31,5,7,5,7,0,0,4,4,3,4,2,4,0,1,1,14
4517,786508,30,6,12,4,5,2,7,0,0,0,5,2,4,3,1,2,14
4517,786505,34,5,8,2,2,3,6,1,2,0,2,4,0,2,0,0,14
4517,785796,34,4,11,3,8,1,3,0,1,1,3,1,2,0,2,1,9
4517,797576,31,5,11,1,4,4,7,4,4,0,2,2,1,1,3,1,18
4517,797577,2,0,0,0,0,0,0,0,0,0,0,0,3,0,0,0,0
4517,797582,7,0,2,0,2,0,0,0,0,2,1,0,2,0,3,0,0
4517,781325,19,1,4,0,2,1,2,1,2,0,1,2,1,2,1,0,4
4517,791897,12,1,1,1,1,0,0,0,0,1,2,0,0,0,0,0,2
4518,797529,36,2,4,2,3,0,1,2,3,4,5,1,4,2,0,0,6
4518,797527,30,5,5,4,4,1,1,2,2,2,4,0,4,0,1,2,13
4518,791936,33,4,7,4,7,0,0,3,4,3,5,0,1,0,3,1,11
4518,797532,38,9,21,5,12,4,9,9,9,0,3,12,3,4,4,0,31
4518,785688,31,3,12,2,4,1,8,4,4,0,0,3,0,0,1,0,11
4518,797528,7,0,1,0,1,0,0,0,0,1,2,0,2,0,1,0,0
4518,791932,11,1,4,1,2,0,2,0,0,2,1,0,0,0,0,0,2
4518,785988,14,2,5,1,2,1,3,2,2,0,1,0,1,0,0,0,7
4519,780686,38,3,8,3,8,0,0,2,2,4,6,5,4,0,3,0,8
4519,780683,32,3,13,3,7,0,6,2,2,4,4,2,1,1,1,0,8
4519,797681,33,5,14,4,7,1,7,4,4,1,2,7,2,0,4,0,15
4519,797680,39,7,15,3,5,4,10,0,0,1,1,1,3,1,1,2,18
4519,780688,30,8,14,8,12,0,2,0,0,6,1,1,5,2,1,0,16
4519,797679,11,1,5,0,1,1,4,0,0,0,1,2,3,0,0,0,3
4519,780772,7,0,0,0,0,0,0,0,0,1,1,1,0,0,0,0,0
4519,780689,10,2,3,1,1,1,2,1,3,1,1,0,1,0,0,1,6
4520,780920,34,6,12,6,10,0,2,2,2,2,3,8,0,1,2,0,14
4520,780914,14,2,8,2,5,0,3,2,2,1,3,0,2,1,2,1,6
4520,775816,29,3,8,1,3,2,5,2,2,0,4,4,1,1,0,0,10
4520,780919,29,5,9,5,8,0,1,3,3,5,7,1,1,2,0,0,13
4520,796797,18,4,9,4,7,0,2,3,4,3,5,0,2,1,0,2,11
4520,791141,11,1,2,0,0,1,2,0,0,0,0,1,0,0,1,0,3
4520,796799,6,2,4,1,3,1,1,0,0,0,0,0,1,0,2,0,5
4520,796801,2,0,1,0,1,0,0,0,0,0,0,0,1,0,0,0,0
4520,796796,5,0,0,0,0,0,0,0,0,0,0,0,1,0,0,0,0
4520,791142,26,3,7,0,1,3,6,0,0,0,3,1,1,0,0,0,9
4520,785803,26,2,8,0,3,2,5,0,0,0,2,1,3,0,2,2,6
4521,780953,33,7,14,5,11,2,3,6,6,5,7,2,2,0,4,0,22
4521,786293,30,5,15,4,14,1,1,2,2,1,2,0,3,0,0,1,13
4521,797750,23,0,1,0,0,0,1,0,0,0,4,2,1,1,1,0,0
4521,780955,23,1,5,1,2,0,3,2,2,1,2,0,2,0,3,0,4
4521,797753,34,7,15,5,10,2,5,1,1,1,4,2,1,2,6,1,17
4521,797742,14,0,3,0,1,0,2,0,0,0,2,0,1,0,0,0,0
4521,797748,21,1,1,1,1,0,0,3,3,0,0,0,2,0,0,1,5
4521,797751,14,0,5,0,2,0,3,0,0,0,0,0,0,1,0,0,0
4521,786302,5,0,0,0,0,0,0,0,0,0,1,1,1,0,0,1,0
4521,792147,2,1,1,1,1,0,0,1,1,0,1,0,0,1,0,0,3
4521,786301,1,0,0,0,0,0,0,0,0,0,0,0,0,0,0,0,0
4522,780058,14,1,5,0,1,1,4,0,0,0,3,1,0,3,1,0,3
4522,780059,23,3,4,3,3,0,1,7,8,1,3,2,1,2,3,1,13
4522,796494,24,1,6,1,3,0,3,1,2,2,3,3,0,0,1,0,3
4522,790944,24,6,11,2,4,4,7,0,0,0,1,3,2,0,1,0,16
4522,780061,25,6,10,1,1,5,9,0,0,1,3,1,0,1,1,0,17
4522,796496,20,2,4,1,1,1,3,2,3,0,2,2,2,1,1,0,7
4522,786754,21,2,8,2,4,0,4,3,4,0,4,4,1,1,1,0,7
4522,790943,9,0,1,0,1,0,0,0,0,0,3,0,4,0,2,0,0
4522,790941,7,4,4,3,3,1,1,0,0,0,3,0,2,1,0,3,9
4522,796495,13,3,4,1,1,2,3,0,0,0,1,0,2,0,2,0,8
4522,796497,10,2,4,2,4,0,0,0,0,1,3,0,0,0,1,0,4
4522,796499,5,0,2,0,2,0,0,0,0,0,0,1,2,2,0,0,0
4522,788853,2,1,1,0,0,1,1,0,0,0,0,1,0,0,0,0,3
4522,785097,3,0,0,0,0,0,0,0,0,0,1,0,0,1,0,0,0
4523,796560,18,0,1,0,1,0,0,0,0,0,2,1,1,1,0,1,0
4523,780119,18,2,4,2,4,0,0,1,2,1,0,1,2,1,3,0,5
4523,796559,35,10,25,7,18,3,7,5,5,3,6,1,2,0,2,0,28
4523,785280,23,1,8,1,5,0,3,1,1,1,1,1,3,1,2,0,3
4523,776097,29,4,9,4,7,0,2,2,2,0,4,3,3,1,6,0,10
4523,775679,14,0,4,0,2,0,2,1,2,0,2,0,0,3,1,0,1
4523,780149,18,2,7,1,4,1,3,0,2,0,1,0,0,2,3,1,5
4523,796558,28,1,3,1,3,0,0,3,4,1,5,1,3,0,0,0,5
4523,785285,15,1,2,1,2,0,0,0,0,2,2,0,1,0,1,3,2
4523,785536,2,0,0,0,0,0,0,0,0,0,0,0,0,0,0,0,0
4524,791465,19,3,5,3,5,0,0,0,0,2,3,2,4,0,2,1,6
4524,791464,28,7,15,2,5,5,10,0,0,1,0,2,5,0,2,0,19
4524,780200,18,0,1,0,1,0,0,0,0,2,0,2,4,0,1,1,0
4524,786304,33,3,8,2,3,1,5,0,0,0,6,6,4,0,1,0,7
4524,780197,36,9,15,4,5,5,10,2,2,0,3,3,2,3,2,0,25
4524,798342,23,2,4,0,0,2,4,2,2,0,3,2,2,0,1,0,8
4524,786303,13,0,0,0,0,0,0,0,0,1,2,0,4,0,0,0,0
4524,780616,3,0,0,0,0,0,0,0,0,0,1,2,0,0,0,0,0
4524,780196,27,2,8,1,6,1,2,7,8,1,4,2,3,4,3,0,12
4525,791550,26,5,8,5,8,0,0,5,9,4,4,2,2,0,4,0,15
4525,791548,33,4,12,4,9,0,3,3,6,1,4,2,4,0,1,2,11
4525,797080,27,2,5,0,2,2,3,0,0,0,1,1,4,0,2,0,6
4525,786365,25,6,9,1,2,5,7,4,5,1,2,0,2,0,0,0,21
4525,786364,32,6,11,5,8,1,3,0,1,3,4,2,2,0,4,0,13
4525,797082,13,1,4,1,4,0,0,2,2,3,1,2,0,0,0,0,4
4525,786366,8,0,2,0,2,0,0,3,4,1,2,0,1,0,0,0,3
4525,780332,7,0,0,0,0,0,0,0,2,0,0,0,1,0,1,0,0
4525,791549,5,0,1,0,1,0,0,0,0,0,2,1,1,0,1,0,0
4525,786368,2,0,0,0,0,0,0,0,0,0,0,1,0,0,0,0,0
4525,780330,22,1,3,1,2,0,1,0,2,2,1,0,2,1,0,0,2
4526,786805,17,4,5,3,3,1,2,0,0,4,2,2,1,2,1,0,9
4526,774936,17,6,8,5,7,1,1,2,4,0,0,0,0,0,2,2,15
4526,790932,16,1,5,1,4,0,1,2,2,0,2,5,3,4,0,0,4
4526,781345,21,1,4,1,3,0,1,3,4,1,1,3,4,2,2,1,5
4526,786803,27,2,4,0,1,2,3,0,0,0,4,5,2,3,4,0,6
4526,796490,8,3,3,3,3,0,0,1,3,0,2,0,2,0,0,0,7
4526,796488,11,1,3,1,2,0,1,4,4,0,2,1,2,0,0,0,6
4526,790934,11,1,4,0,1,1,3,2,2,1,1,0,2,3,2,1,5
4526,786804,13,1,5,0,0,1,5,0,0,2,0,2,5,0,2,0,3
4526,796489,4,0,1,0,1,0,0,0,0,0,1,0,0,0,0,0,0
4526,796487,14,0,2,0,0,0,2,2,2,0,0,2,0,1,1,0,2
4526,790931,15,1,3,1,3,0,0,2,4,1,4,0,3,0,0,0,4
4526,790933,13,3,6,0,2,3,4,1,2,0,2,1,2,0,0,0,10
4526,780033,8,0,1,0,0,0,1,0,0,0,0,0,0,1,0,0,0
4526,780030,5,0,0,0,0,0,0,0,0,0,1,0,0,0,0,1,0
4527,791512,17,0,0,0,0,0,0,0,0,2,2,0,0,1,1,1,0
4527,786338,25,2,9,0,3,2,6,0,2,0,2,1,4,2,4,1,6
4527,792050,27,1,3,1,3,0,0,0,0,0,1,1,4,1,6,0,2
4527,785347,18,1,5,1,4,0,1,2,2,0,2,1,3,0,8,0,4
4527,775601,19,1,4,1,3,0,1,9,13,1,2,2,3,1,2,0,11
4527,792045,15,1,1,1,1,0,0,0,0,1,1,0,5,0,2,1,2
4527,797648,13,2,3,2,3,0,0,0,1,1,3,0,0,0,0,0,4
4527,792052,23,0,2,0,1,0,1,0,0,0,4,1,2,0,2,0,0
4527,792047,19,0,2,0,1,0,1,5,8,0,2,0,4,3,4,0,5
4527,792051,12,1,1,1,1,0,0,0,0,0,2,0,3,0,0,2,2
4527,780862,12,2,6,0,1,2,5,0,2,0,2,0,0,0,0,0,6
4528,791011,23,4,7,4,5,0,2,0,0,2,7,1,0,0,1,1,8
4528,780303,27,9,11,9,10,0,1,1,2,5,3,0,2,1,2,0,19
4528,791594,28,2,4,2,3,0,1,0,0,0,1,6,3,0,1,1,4
4528,791012,29,4,6,1,2,3,4,2,2,0,2,1,3,1,3,0,13
4528,781385,30,5,10,5,7,0,3,6,6,1,4,2,3,1,3,0,16
4528,796670,1,0,0,0,0,0,0,0,0,0,0,0,0,0,0,0,0
4528,796671,16,2,3,2,3,0,0,0,0,1,5,1,2,0,1,2,4
4528,785337,20,0,1,0,1,0,0,1,4,0,3,0,4,1,2,1,1
4528,796668,3,0,0,0,0,0,0,0,0,0,0,0,0,0,1,0,0
4528,791013,14,1,2,1,2,0,0,2,2,0,3,1,0,0,0,0,4
4528,786349,9,0,0,0,0,0,0,0,0,0,0,0,1,0,2,0,0
4529,781249,31,2,7,0,3,2,4,0,1,0,1,2,3,1,1,1,6
4529,775165,34,3,6,0,0,3,6,0,0,1,2,2,2,0,0,0,9
4529,785514,33,9,14,5,8,4,6,0,1,2,0,2,2,1,3,0,22
4529,785515,18,0,6,0,2,0,4,2,4,2,3,5,3,2,0,0,2
4529,781253,28,3,10,1,4,2,6,0,0,1,2,2,2,1,1,0,8
4529,796953,18,0,0,0,0,0,0,3,4,1,2,0,0,1,0,1,3
4529,796951,10,0,3,0,2,0,1,0,0,1,0,0,0,0,0,1,0
4529,791251,26,3,6,0,0,3,6,0,0,0,0,2,3,0,1,0,9
4529,776804,2,0,1,0,0,0,1,1,1,0,0,0,0,0,1,0,1
4530,797103,28,5,10,5,10,0,0,5,8,5,4,2,0,4,6,2,15
4530,791414,28,3,5,3,3,0,2,2,2,0,3,2,4,2,1,1,8
4530,791413,31,3,10,2,3,1,7,2,4,1,3,1,2,1,1,1,9
4530,791411,34,6,12,3,6,3,6,1,1,0,3,5,2,3,2,0,16
4530,785776,33,4,14,2,8,2,6,0,0,0,0,3,1,0,0,0,10
4530,797102,2,0,1,0,1,0,0,0,0,0,1,0,0,0,0,0,0
4530,785911,12,1,3,1,1,0,2,0,0,0,3,1,1,0,2,3,2
4530,797105,7,1,2,1,2,0,0,0,2,2,0,0,1,0,1,0,2
4530,797100,9,0,1,0,0,0,1,0,0,0,0,2,2,0,1,0,0
4530,781209,16,1,2,0,0,1,2,0,0,0,0,1,0,1,1,0,3
4531,791391,32,5,10,5,10,0,0,2,4,3,10,0,4,0,2,3,12
4531,791390,14,3,7,3,7,0,0,2,2,4,3,2,5,2,1,0,8
4531,776446,28,2,8,2,3,0,5,4,4,1,2,1,1,1,3,0,8
4531,780133,30,4,8,1,2,3,6,6,6,1,1,1,1,0,2,0,17
4531,780130,32,6,11,5,7,1,4,0,0,1,6,2,0,3,2,2,13
4531,797158,3,0,0,0,0,0,0,0,0,0,0,0,0,1,0,0,0
4531,797156,10,1,2,1,2,0,0,0,0,1,2,0,0,2,4,1,2
4531,791388,24,1,4,0,3,1,1,2,2,1,3,2,1,0,2,0,5
4531,775743,20,1,5,1,4,0,1,6,6,0,3,2,1,2,1,0,8
4531,780407,7,0,0,0,0,0,0,0,0,0,0,0,1,0,2,0,0
4532,780378,26,4,6,4,6,0,0,4,4,4,6,1,3,0,0,1,12
4532,797061,15,0,0,0,0,0,0,0,0,0,1,0,3,0,1,0,0
4532,786374,32,5,9,3,4,2,5,2,2,1,2,4,4,1,1,1,14
4532,786253,33,4,11,4,8,0,3,4,5,2,1,2,2,0,6,0,12
4532,780121,13,0,4,0,0,0,4,0,0,0,2,1,2,1,1,0,0
4532,786404,28,2,3,2,2,0,1,2,2,2,8,3,1,1,2,0,6
4532,780382,13,0,0,0,0,0,0,0,0,1,2,0,3,1,1,0,0
4532,797065,5,0,1,0,0,0,1,0,0,0,0,0,1,0,0,0,0
4532,786378,16,3,7,1,3,2,4,0,0,1,0,2,3,0,1,0,8
4532,785798,18,2,7,0,3,2,4,0,0,0,0,1,0,1,1,0,6
4532,780381,1,0,0,0,0,0,0,0,0,0,1,0,0,0,0,0,0
4533,790232,27,3,9,3,7,0,2,0,1,1,1,1,1,0,2,0,6
4533,780614,31,0,2,0,1,0,1,4,5,0,3,0,1,1,0,1,4
4533,780093,16,1,5,1,5,0,0,1,2,2,1,1,1,1,1,1,3
4533,789066,33,3,15,3,10,0,5,4,6,1,5,2,3,1,1,0,10
4533,785806,38,3,5,3,5,0,0,2,2,0,2,2,2,0,1,0,8
4533,780255,24,4,6,4,6,0,0,1,1,2,1,1,2,1,2,0,9
4533,792411,10,0,2,0,1,0,1,2,2,0,2,0,1,0,1,0,2
4533,786463,21,4,8,2,4,2,4,3,4,1,0,1,5,1,0,0,13
4534,780824,23,2,3,2,3,0,0,0,0,0,5,0,3,0,3,0,4
4534,796769,11,0,1,0,0,0,1,0,0,0,1,0,1,0,0,0,0
4534,791118,38,4,7,2,3,2,4,4,4,0,6,7,0,1,0,0,14
4534,785676,39,5,10,2,3,3,7,0,0,1,7,6,1,0,1,0,13
4534,774974,27,3,6,3,5,0,1,0,1,0,0,4,3,1,2,0,6
4534,796771,8,2,2,0,0,2,2,0,0,0,1,0,0,0,0,0,6
4534,791115,18,2,5,2,4,0,1,1,2,2,2,0,2,0,1,0,5
4534,800022,2,0,0,0,0,0,0,0,0,0,0,0,0,0,0,0,0
4534,796768,2,0,0,0,0,0,0,0,0,0,0,0,1,0,1,0,0
4534,794654,1,0,0,0,0,0,0,0,0,0,0,0,0,0,0,0,0
4534,791117,31,7,11,4,8,3,3,5,6,1,2,2,4,1,1,0,22
4535,792288,30,4,6,4,5,0,1,0,0,2,2,1,3,0,1,0,8
4535,785227,23,5,8,5,8,0,0,0,0,2,3,0,4,0,2,0,10
4535,786237,33,6,8,6,8,0,0,2,3,1,2,2,0,2,1,0,14
4535,786232,22,2,4,2,2,0,2,1,2,0,2,2,4,1,0,0,5
4535,780287,29,2,11,2,7,0,4,3,3,0,2,1,0,1,1,0,7
4535,798077,3,0,2,0,2,0,0,0,0,1,0,0,0,0,0,0,0
4535,798072,7,0,0,0,0,0,0,0,0,0,3,0,0,0,0,0,0
4535,798067,12,1,2,1,2,0,0,0,0,1,1,1,0,0,0,0,2
4535,798084,6,0,2,0,0,0,2,2,2,0,0,0,0,1,0,0,2
4535,798068,3,0,0,0,0,0,0,0,0,0,0,0,1,0,0,0,0
4535,792282,3,0,1,0,1,0,0,0,0,0,0,0,0,0,1,0,0
4535,792278,29,2,10,1,4,1,6,2,2,0,1,3,3,0,1,0,7
4536,776253,19,2,5,1,3,1,2,1,2,2,5,2,4,0,1,1,6
4536,775651,14,2,3,2,3,0,0,6,7,1,1,0,0,0,2,1,10
4536,791070,19,3,9,1,3,2,6,1,2,1,5,2,4,0,2,0,9
4536,791627,24,4,10,2,6,2,4,2,3,0,1,5,1,2,2,0,12
4536,785665,31,10,15,3,4,7,11,0,0,1,4,1,2,0,0,0,27
4536,796505,11,3,3,3,3,0,0,1,1,1,1,1,1,0,0,0,7
4536,791071,11,1,3,1,3,0,0,0,0,1,0,2,2,0,2,1,2
4536,785660,3,0,0,0,0,0,0,0,0,0,0,0,1,0,0,0,0
4536,796504,9,2,3,2,3,0,0,0,0,1,1,2,2,0,0,1,4
4536,796502,11,2,4,1,1,1,3,2,2,0,2,0,1,1,1,0,7
4536,796501,22,3,4,2,3,1,1,4,5,0,1,2,4,2,3,1,11
4536,791073,3,0,0,0,0,0,0,0,0,0,0,2,0,0,0,0,0
4536,776178,23,4,7,4,6,0,1,4,4,3,11,2,2,0,1,1,12
4537,791266,8,2,3,2,3,0,0,0,0,1,0,0,4,0,0,1,4
4537,796523,20,1,4,0,1,1,3,0,0,0,1,0,1,0,1,0,3
4537,791270,19,3,5,2,4,1,1,2,2,0,2,0,3,0,1,0,9
4537,791265,27,3,9,3,6,0,3,1,1,0,3,4,3,0,2,0,7
4537,785685,26,5,13,5,11,0,2,11,15,0,3,2,1,3,4,1,21
4537,796524,10,2,3,2,3,0,0,0,0,1,2,0,4,0,3,0,4
4537,797879,20,2,5,1,2,1,3,2,2,0,1,0,1,1,2,0,7
4537,796522,20,1,4,1,2,0,2,0,0,0,3,1,3,0,1,0,2
4537,796525,12,0,4,0,2,0,2,0,2,0,0,0,0,0,0,0,0
4537,791271,15,1,4,1,4,0,0,0,0,1,5,0,3,0,2,0,2
4537,781313,23,1,4,1,1,0,3,2,2,0,0,0,0,0,0,0,4
4538,780323,26,3,7,3,7,0,0,2,4,7,4,1,1,0,5,1,8
4538,797894,20,3,5,3,5,0,0,0,0,3,2,0,5,1,1,1,6
4538,792229,35,3,11,3,8,0,3,4,4,4,6,3,3,2,2,4,10
4538,785954,36,3,8,2,3,1,5,0,1,0,6,1,4,0,4,0,7
4538,785811,35,8,18,4,7,4,11,4,4,1,0,0,2,1,5,3,24
4538,792234,3,0,0,0,0,0,0,0,0,2,0,0,0,0,0,0,0
4538,792233,24,1,7,1,5,0,2,0,1,0,5,0,3,2,2,0,2
4538,786016,19,1,6,0,3,1,3,0,0,1,0,0,0,2,1,0,3
4538,781356,2,0,0,0,0,0,0,0,0,0,0,0,2,0,0,0,0
4538,797891,0,0,0,0,0,0,0,0,0,0,0,0,0,0,0,0,0
4539,785298,13,0,1,0,1,0,0,0,0,1,0,0,3,0,0,0,0
4539,775224,30,1,1,1,1,0,0,2,2,2,3,0,4,3,2,1,4
4539,778046,31,2,11,0,4,2,7,1,4,0,5,3,5,4,7,1,7
4539,782121,31,6,12,3,6,3,6,2,4,0,5,1,3,0,4,0,17
4539,775793,37,6,11,6,9,0,2,2,2,1,3,1,0,1,2,1,14
4539,786594,27,5,8,2,2,3,6,2,4,0,3,1,3,0,1,0,15
4539,785485,17,2,7,2,7,0,0,3,4,3,2,0,0,0,0,0,7
4539,785302,12,1,4,0,1,1,3,1,2,1,2,0,0,0,0,0,4
4539,796598,2,0,0,0,0,0,0,0,0,0,0,0,0,0,0,0,0
4540,796761,23,4,5,4,5,0,0,1,6,3,1,0,3,1,0,2,9
4540,796758,31,7,17,7,17,0,0,3,5,4,2,4,2,2,2,0,17
4540,791101,34,9,16,6,9,3,7,4,4,0,5,1,1,5,2,0,25
4540,791105,35,1,4,1,2,0,2,1,4,0,5,4,1,4,1,0,3
4540,780794,27,2,4,0,0,2,4,0,0,0,5,3,3,1,1,0,6
4540,780109,20,3,7,2,4,1,3,0,3,1,6,1,1,0,1,3,7
4540,796757,16,3,9,1,5,2,4,0,0,2,0,0,0,0,4,0,8
4540,791104,1,0,0,0,0,0,0,0,0,0,0,0,1,0,0,0,0
4540,785597,6,0,0,0,0,0,0,0,0,0,0,0,0,0,1,0,0
4540,791103,6,0,0,0,0,0,0,0,0,0,0,0,0,0,0,0,0
4540,796760,1,0,0,0,0,0,0,0,0,0,0,0,0,0,0,0,0
4541,776209,21,3,6,3,6,0,0,4,4,2,2,1,5,1,2,1,10
4541,796938,38,1,12,0,5,1,7,2,2,2,1,3,3,1,6,0,5
4541,791236,19,0,4,0,1,0,3,0,0,0,2,1,2,0,2,0,0
4541,791237,34,8,15,7,9,1,6,2,2,4,10,0,4,2,4,0,19
4541,791238,24,3,7,2,3,1,4,3,3,0,3,0,1,2,2,0,10
4541,781227,14,3,3,3,3,0,0,0,0,1,5,0,3,0,0,0,6
4541,791235,27,5,10,5,10,0,0,2,2,5,6,0,1,0,3,0,12
4541,791240,3,0,1,0,1,0,0,0,0,0,1,0,0,0,0,0,0
4541,791351,19,0,6,0,2,0,4,0,0,0,0,0,1,0,0,0,0
4541,796939,1,1,2,1,2,0,0,0,0,1,0,0,0,0,0,0,2
4542,775913,23,3,6,3,6,0,0,0,0,0,3,3,0,0,3,0,6
4542,797331,22,2,5,1,2,1,3,1,2,0,1,3,2,0,2,0,6
4542,791737,24,0,1,0,1,0,0,2,5,0,3,2,1,0,3,0,2
4542,783524,28,2,10,1,4,1,6,0,0,0,2,3,1,2,0,0,5
4542,780561,28,5,9,1,2,4,7,0,1,2,3,0,2,1,3,1,14
4542,781516,11,0,1,0,1,0,0,2,2,3,1,1,3,0,1,3,2
4542,797332,7,0,1,0,1,0,0,0,1,0,0,0,3,0,0,0,0
4542,797333,19,2,3,0,1,2,2,0,0,0,4,0,1,1,2,0,6
4542,795372,6,0,0,0,0,0,0,0,0,0,0,0,0,0,1,0,0
4542,786223,14,1,3,0,0,1,3,0,0,0,3,1,3,0,2,0,3
4542,786220,18,3,5,3,4,0,1,0,0,0,3,0,2,1,2,0,6
4543,797291,29,3,6,2,4,1,2,1,3,1,3,4,2,0,4,0,8
4543,797292,25,3,7,3,7,0,0,4,5,1,4,0,3,3,3,1,10
4543,780509,31,6,6,4,4,2,2,0,1,2,4,0,2,0,1,0,14
4543,797290,30,5,9,4,6,1,3,0,0,0,5,3,1,2,0,0,11
4543,786064,33,5,12,4,8,1,4,0,0,0,2,1,2,0,0,0,11
4543,791658,13,0,2,0,2,0,0,4,4,1,1,0,1,0,0,0,4
4543,791661,1,0,1,0,0,0,1,0,0,0,0,0,0,0,0,0,0
4543,785658,11,0,1,0,0,0,1,1,4,1,2,0,4,1,4,0,1
4543,791660,25,1,6,0,3,1,3,2,2,0,1,0,1,2,0,1,5
4543,797295,1,0,0,0,0,0,0,0,0,0,0,0,0,0,0,0,0
4543,791663,1,0,0,0,0,0,0,0,0,0,0,0,0,0,0,0,0
4544,780283,22,5,12,5,12,0,0,4,4,6,2,1,3,0,2,0,14
4544,790925,36,7,14,7,14,0,0,1,2,1,4,2,2,2,0,0,15
4544,791456,24,1,5,0,1,1,4,0,0,0,2,3,0,1,1,1,3
4544,785476,29,5,12,4,10,1,2,0,0,1,1,5,2,2,1,0,11
4544,785474,33,6,13,2,6,4,7,4,4,1,8,1,4,0,0,0,20
4544,796470,4,0,2,0,2,0,0,2,2,1,1,0,0,0,0,0,2
4544,785480,19,3,6,0,1,3,5,0,0,0,0,1,0,0,0,0,9
4544,780292,18,1,3,1,3,0,0,3,5,2,6,3,0,0,1,1,5
4544,790926,15,1,3,1,1,0,2,0,0,1,2,1,1,0,1,0,2
4545,786772,14,0,1,0,1,0,0,0,2,1,2,0,4,0,0,0,0
4545,781484,35,6,9,3,4,3,5,0,0,0,7,3,3,0,2,1,15
4545,786769,31,2,10,1,5,1,5,1,2,0,5,1,2,3,2,0,6
4545,786024,22,4,11,1,5,3,6,0,0,0,1,0,4,0,1,0,11
4545,780002,37,10,16,8,11,2,5,3,3,0,5,5,4,0,5,0,25
4545,791967,27,4,6,3,4,1,2,0,1,0,2,3,0,1,0,0,9
4545,790823,9,0,1,0,1,0,0,0,0,0,0,0,1,0,1,0,0
4545,786773,25,4,4,4,4,0,0,2,2,3,2,1,3,0,0,3,10
4546,797058,22,1,5,1,2,0,3,0,0,0,3,0,0,0,1,0,2
4546,775549,27,7,10,7,10,0,0,3,4,2,5,0,4,0,1,2,17
4546,797056,26,3,8,2,6,1,2,0,0,0,4,2,4,0,1,0,7
4546,797055,26,2,9,2,6,0,3,0,0,0,0,1,0,2,1,0,4
4546,786381,22,2,5,1,1,1,4,0,0,0,1,1,4,1,1,1,5
4546,791564,21,2,5,1,1,1,4,0,0,1,1,2,2,1,0,0,5
4546,780425,13,1,3,1,3,0,0,0,0,2,2,0,1,0,3,1,2
4546,797054,31,5,14,5,10,0,4,0,0,0,3,4,2,1,2,0,10
4546,791568,12,0,0,0,0,0,0,0,0,0,1,0,1,0,0,0,0
4547,791838,10,1,3,1,1,0,2,0,1,0,2,0,2,0,4,0,2
4547,786620,36,4,11,2,5,2,6,2,2,1,1,2,2,0,2,0,12
4547,781606,35,4,7,1,1,3,6,0,0,0,1,2,1,1,2,1,11
4547,781263,28,1,9,1,6,0,3,0,0,1,4,0,1,1,1,0,2
4547,781257,36,3,10,2,7,1,3,3,4,0,10,3,0,0,0,0,10
4547,796955,14,2,2,2,2,0,0,1,2,1,3,1,4,0,1,0,5
4547,791255,2,0,0,0,0,0,0,0,0,0,0,0,0,1,1,0,0
4547,791257,16,3,4,3,4,0,0,0,0,2,3,1,1,1,1,1,6
4547,780900,13,3,5,2,3,1,2,0,0,1,2,2,1,1,0,0,7
4547,796954,10,0,0,0,0,0,0,0,0,0,1,2,2,0,1,0,0
4548,796566,28,8,12,8,12,0,0,6,6,6,11,0,4,0,1,2,22
4548,790971,21,0,1,0,1,0,0,0,2,0,4,1,2,1,1,0,0
4548,790969,31,5,10,4,9,1,1,8,9,2,2,5,2,0,2,0,19
4548,780166,33,5,10,4,7,1,3,6,7,0,3,10,0,0,1,1,17
4548,775107,17,2,4,1,2,1,2,0,0,0,2,1,0,0,0,0,5
4548,796568,13,3,4,3,4,0,0,7,9,2,2,0,4,0,1,0,13
4548,781380,6,1,2,1,2,0,0,0,0,0,2,0,1,0,0,0,2
4548,796569,16,2,5,2,5,0,0,0,0,0,2,1,4,1,2,0,4
4548,796563,3,0,0,0,0,0,0,0,0,1,1,0,1,0,1,0,0
4548,790968,12,3,5,1,1,2,4,0,0,0,2,1,1,0,0,0,8
4548,790967,20,1,4,0,0,1,4,0,0,0,1,0,1,0,1,0,3
4549,791511,10,0,0,0,0,0,0,0,0,1,2,1,1,0,1,0,0
4549,778442,34,4,16,1,8,3,8,7,8,0,8,1,3,0,2,1,18
4549,791514,9,0,4,0,3,0,1,0,0,0,0,0,1,0,0,0,0
4549,786637,36,6,14,4,10,2,4,4,4,2,2,3,4,1,3,0,18
4549,791513,17,0,2,0,2,0,0,0,0,1,0,1,3,1,1,1,0
4549,797151,24,5,5,5,5,0,0,2,4,0,0,1,3,0,0,1,12
4549,791515,8,1,3,0,0,1,3,0,0,0,2,2,2,0,0,0,3
4549,797152,7,0,1,0,1,0,0,2,2,1,0,0,0,0,0,0,2
4549,797150,23,1,4,0,1,1,3,0,0,1,3,1,4,0,1,0,3
4549,797149,4,0,0,0,0,0,0,0,0,0,0,0,0,0,0,0,0
4549,780946,28,6,11,5,10,1,1,3,3,0,2,4,3,3,0,0,16
4550,781134,31,4,6,3,3,1,3,3,4,3,6,0,1,1,2,1,12
4550,774874,24,2,8,2,7,0,1,3,4,0,4,2,2,1,0,0,7
4550,796531,32,6,11,3,7,3,4,3,4,0,2,2,1,2,4,0,18
4550,786475,21,4,7,3,3,1,4,0,1,0,2,1,0,2,3,0,9
4550,785270,35,5,11,2,3,3,8,3,4,0,0,3,2,2,1,0,16
4550,780085,20,2,3,2,3,0,0,0,0,0,3,1,2,0,1,0,4
4550,775468,24,6,7,6,7,0,0,3,4,1,6,3,2,2,4,0,15
4550,790946,3,0,1,0,0,0,1,0,0,0,0,0,1,0,0,0,0
4550,780084,10,1,3,1,1,0,2,0,0,0,1,0,2,0,0,0,2
4551,785845,18,0,1,0,1,0,0,0,2,0,4,2,3,0,1,0,0
4551,780578,25,5,8,4,6,1,2,0,0,0,1,0,3,1,2,0,11
4551,797537,9,2,2,2,2,0,0,0,0,0,1,0,0,0,1,0,4
4551,797538,31,2,6,2,5,0,1,0,1,0,4,3,2,2,3,0,4
4551,780579,40,10,19,8,14,2,5,0,0,0,4,3,4,4,6,0,22
4551,797536,17,3,7,2,4,1,3,0,0,1,1,2,1,1,2,0,7
4551,785843,19,2,6,1,1,1,5,0,0,2,2,1,1,0,2,0,5
4551,797535,5,0,0,0,0,0,0,0,0,0,2,2,1,0,0,0,0
4551,785293,13,0,1,0,1,0,0,0,0,0,1,1,4,1,0,0,0
4551,785847,23,6,9,2,3,4,6,6,6,0,3,1,1,0,0,0,22
4552,780758,20,3,5,1,3,2,2,2,2,1,4,1,1,0,3,0,10
4552,775489,31,4,10,4,10,0,0,6,7,6,12,1,1,0,3,0,14
4552,785560,30,0,8,0,1,0,7,0,0,0,1,3,1,1,2,0,0
4552,785561,28,4,7,4,7,0,0,3,4,0,2,0,1,1,1,1,11
4552,780313,35,8,17,6,11,2,6,6,6,1,2,4,4,0,1,0,24
4552,781208,17,1,4,1,4,0,0,0,0,0,2,0,4,0,1,0,2
4552,796751,2,0,0,0,0,0,0,0,0,0,0,0,1,0,0,0,0
4552,791088,7,2,3,1,1,1,2,0,0,0,1,0,0,0,2,0,5
4552,785563,30,3,6,3,5,0,1,0,0,1,2,3,0,0,0,0,6
4553,775563,25,7,13,7,12,0,1,2,3,3,3,2,3,0,0,0,16
4553,781011,11,2,3,2,3,0,0,2,2,1,1,0,5,2,0,0,6
4553,797601,36,4,14,3,6,1,8,2,2,0,6,9,1,1,4,0,11
4553,781012,37,6,15,1,2,5,13,0,0,1,2,2,3,2,1,0,17
4553,775119,28,5,9,4,6,1,3,1,3,0,1,3,1,0,2,1,12
4553,797602,7,1,3,0,0,1,3,0,0,0,0,0,0,0,0,0,3
4553,775188,19,0,0,0,0,0,0,1,2,2,3,0,3,1,1,2,1
4553,797604,25,3,7,1,2,2,5,0,0,1,5,1,0,1,1,0,8
4553,786466,12,0,0,0,0,0,0,0,0,0,2,1,1,0,0,0,0
4554,781497,11,0,0,0,0,0,0,0,0,1,0,1,0,0,0,0,0
4554,792414,26,1,4,0,2,1,2,0,0,2,4,0,2,0,0,1,3
4554,789020,40,6,12,5,8,1,4,9,11,4,2,0,3,0,4,0,22
4554,786787,38,10,19,3,8,7,11,3,6,0,3,3,2,1,6,0,30
4554,774954,37,5,9,5,9,0,0,0,0,2,7,4,0,1,1,0,10
4554,786795,29,1,4,0,0,1,4,0,0,0,2,2,1,0,0,0,3
4554,792091,11,0,1,0,0,0,1,0,0,0,3,0,1,0,1,0,0
4554,781456,8,0,0,0,0,0,0,0,0,2,0,1,0,0,0,0,0
4555,796657,22,1,3,1,3,0,0,0,0,2,2,1,1,0,0,0,2
4555,796651,10,2,4,1,2,1,2,0,0,1,0,0,3,0,1,1,5
4555,791323,31,3,5,0,0,3,5,0,0,0,7,6,3,1,1,0,9
4555,791320,32,4,16,4,11,0,5,2,3,1,0,2,5,0,1,1,10
4555,781511,28,2,6,1,2,1,4,2,2,0,5,5,3,1,1,0,7
4555,796650,37,8,12,8,12,0,0,0,2,1,0,2,2,2,3,0,16
4555,796653,11,1,2,1,1,0,1,0,0,3,1,1,3,1,0,0,2
4555,785912,29,5,15,1,5,4,10,0,1,0,3,3,1,0,1,0,14
4556,775324,21,7,8,7,8,0,0,4,8,1,3,1,0,2,1,0,18
4556,791223,24,4,11,4,11,0,0,2,3,2,4,0,3,1,1,0,10
4556,791224,36,7,18,7,13,0,5,6,8,2,5,8,4,0,8,0,20
4556,785564,23,4,13,2,3,2,10,0,0,0,4,2,2,1,1,0,10
4556,781181,40,3,7,2,2,1,5,0,0,1,3,7,3,1,1,1,7
4556,796927,27,2,6,1,4,1,2,1,2,0,1,1,2,0,1,0,6
4556,791811,18,3,4,3,4,0,0,0,0,3,4,0,2,0,0,0,6
4556,796929,29,2,6,0,0,2,6,0,0,0,7,1,3,2,2,0,6
4556,796926,7,0,0,0,0,0,0,2,4,1,0,0,1,0,2,0,2
4557,791230,31,4,6,2,4,2,2,0,0,2,5,2,2,3,3,0,10
4557,785557,34,9,17,6,12,3,5,3,5,2,4,2,5,2,3,2,24
4557,791228,29,6,10,4,7,2,3,4,4,3,3,0,2,1,1,0,18
4557,796932,35,6,22,4,17,2,5,3,6,0,2,6,1,2,4,0,17
4557,785624,35,3,7,1,3,2,4,3,4,1,6,2,3,2,1,0,11
4557,796935,6,1,1,1,1,0,0,0,0,0,0,0,1,0,0,0,2
4557,796933,15,2,4,2,4,0,0,3,4,0,2,0,1,0,1,0,7
4557,791226,12,0,0,0,0,0,0,1,2,0,4,0,4,0,1,0,1
4557,791227,18,1,4,0,1,1,3,0,0,1,1,4,2,0,2,0,3
4557,781211,0,0,0,0,0,0,0,0,0,0,0,0,0,0,0,0,0
4557,781198,10,0,2,0,1,0,1,0,1,0,1,1,2,1,0,0,0
4558,797842,33,6,18,6,16,0,2,8,9,11,5,0,2,3,3,0,20
4558,797849,32,4,7,3,4,1,3,2,4,1,4,3,1,0,4,1,11
4558,781537,27,1,6,0,3,1,3,2,2,0,1,2,4,0,3,0,5
4558,786079,30,2,7,2,6,0,1,5,5,0,4,1,2,2,0,0,9
4558,797835,17,1,1,0,0,1,1,0,0,0,2,1,4,1,1,1,3
4558,792201,5,0,0,0,0,0,0,0,0,0,0,0,0,0,1,0,0
4558,797836,6,1,2,1,1,0,1,0,0,0,0,0,0,1,0,0,2
4558,797846,23,2,6,2,4,0,2,0,0,0,1,1,1,3,2,0,4
4558,792202,21,0,6,0,0,0,6,0,0,0,0,2,0,0,3,0,0
4558,797847,1,1,1,0,0,1,1,0,0,0,0,0,0,0,0,0,3
4558,797838,5,0,0,0,0,0,0,0,0,0,0,0,0,0,1,0,0
4559,791669,19,5,5,5,5,0,0,0,0,0,3,0,4,1,1,1,10
4559,785762,29,7,10,6,9,1,1,2,4,4,5,0,4,1,2,2,17
4559,797407,21,4,8,3,5,1,3,2,5,0,2,9,2,1,2,1,11
4559,785760,22,2,3,0,0,2,3,0,0,0,1,3,0,1,2,0,6
4559,780531,37,4,11,0,2,4,9,1,2,1,4,6,1,0,2,0,13
4559,797414,9,1,1,1,1,0,0,0,0,1,3,0,3,0,2,0,2
4559,797411,15,2,3,2,2,0,1,2,2,2,0,1,2,2,1,0,6
4559,780534,7,1,1,1,1,0,0,2,2,2,2,0,0,0,0,0,4
4559,797409,19,0,4,0,2,0,2,0,0,0,0,3,1,1,2,0,0
4559,791666,18,4,8,2,3,2,5,0,0,0,1,0,1,1,1,0,10
4559,797415,2,0,1,0,0,0,1,0,0,0,0,0,0,0,0,0,0
4559,780535,1,0,0,0,0,0,0,0,0,0,0,0,0,0,1,0,0
4559,791671,1,0,1,0,0,0,1,0,0,0,0,0,0,0,0,0,0
4560,792067,15,2,3,2,2,0,1,3,4,1,1,2,5,0,1,0,7
4560,775523,21,5,7,3,5,2,2,7,11,4,9,0,4,0,2,1,19
4560,792059,25,3,5,2,4,1,1,2,2,0,5,1,4,2,1,0,9
4560,792058,16,0,2,0,2,0,0,0,0,0,1,0,0,1,1,0,0
4560,789053,23,2,5,2,5,0,0,0,0,0,0,7,1,0,1,0,4
4560,786836,5,1,1,1,1,0,0,0,0,0,0,0,1,1,1,0,2
4560,792056,8,0,1,0,1,0,0,1,2,1,1,1,3,0,0,0,1
4560,790779,11,3,4,3,4,0,0,1,2,0,3,1,1,0,2,1,7
4560,797649,17,4,4,0,0,4,4,0,1,0,3,0,3,1,1,0,12
4560,789028,17,3,3,3,3,0,0,2,2,0,1,8,2,1,1,0,8
4560,789029,16,1,4,0,0,1,4,1,2,1,0,2,1,0,0,0,4
4560,775323,26,5,7,2,3,3,4,2,2,1,6,0,2,3,1,2,15
4561,792424,12,0,1,0,1,0,0,0,0,0,0,0,3,0,1,0,0
4561,792418,23,3,6,3,6,0,0,1,2,0,2,1,1,0,0,1,7
4561,796693,36,2,8,1,6,1,2,11,11,0,1,2,2,0,6,0,16
4561,792422,33,1,6,1,6,0,0,2,3,2,3,0,1,0,0,0,4
4561,789484,34,4,16,3,11,1,5,9,14,0,3,0,3,2,5,0,18
4561,796695,3,0,1,0,1,0,0,1,2,1,1,0,1,0,0,0,1
4561,792419,1,0,0,0,0,0,0,0,0,0,0,0,0,0,0,0,0
4561,782654,21,0,5,0,5,0,0,1,2,4,0,0,4,0,1,1,1
4561,792421,8,0,1,0,1,0,0,0,0,0,0,0,3,0,0,0,0
4561,796694,2,0,0,0,0,0,0,0,0,0,0,0,0,0,0,0,0
4561,796691,12,2,2,2,2,0,0,0,0,0,1,0,0,1,1,0,4
4561,792423,11,0,0,0,0,0,0,0,0,1,0,0,1,1,0,0,0
4561,796692,4,0,0,0,0,0,0,2,2,0,0,0,0,0,0,0,2
4562,797343,18,1,4,1,3,0,1,0,1,1,2,0,2,0,0,1,2
4562,791743,32,6,9,6,9,0,0,0,0,3,2,0,1,0,1,0,12
4562,797340,24,4,12,2,6,2,6,0,2,0,2,0,1,1,0,1,10
4562,791747,35,5,14,4,9,1,5,4,6,1,2,5,2,1,3,0,15
4562,791746,28,3,7,3,6,0,1,0,1,1,5,1,2,1,1,2,6
4562,797342,11,0,0,0,0,0,0,0,0,2,0,0,0,0,0,0,0
4562,791744,3,0,0,0,0,0,0,0,0,1,1,0,0,0,0,0,0
4562,797341,26,5,12,2,5,3,7,2,3,0,2,0,1,2,3,0,15
4562,786193,23,0,5,0,3,0,2,1,2,0,1,0,1,0,0,0,1
4563,791144,19,7,9,7,8,0,1,0,0,2,4,1,1,0,0,1,14
4563,785782,30,5,10,3,4,2,6,4,4,1,2,1,0,1,0,1,16
4563,791145,29,4,8,4,7,0,1,1,2,3,10,2,2,0,1,0,9
4563,791146,30,6,7,3,3,3,4,1,1,0,1,5,2,1,3,0,16
4563,785777,28,5,12,0,0,5,12,0,0,0,3,2,3,0,2,0,15
4563,791147,10,4,6,3,5,1,1,0,0,2,3,0,2,0,0,0,9
4563,796804,13,1,2,1,1,0,1,0,0,0,2,0,1,0,1,0,2
4563,796803,2,0,1,0,0,0,1,0,0,0,0,0,1,0,0,0,0
4563,791148,24,1,8,0,2,1,6,0,0,2,6,2,3,0,1,0,3
4563,786748,15,2,5,2,4,0,1,0,0,0,1,2,3,0,2,0,4
4564,775954,28,5,6,5,6,0,0,5,6,1,7,1,1,0,0,0,15
4564,796194,31,1,5,0,0,1,5,5,6,2,2,3,2,1,2,0,8
4564,796459,20,4,9,3,6,1,3,1,2,1,6,5,3,3,2,0,10
4564,790917,32,3,5,2,2,1,3,2,3,0,1,0,2,0,0,1,9
4564,781006,25,2,6,2,3,0,3,1,2,1,4,4,2,1,1,1,5
4564,781157,27,3,7,0,1,3,6,2,2,0,3,1,3,1,1,0,11
4564,796464,21,4,8,3,7,1,1,7,8,0,3,3,3,1,2,0,16
4564,790918,4,1,1,1,1,0,0,0,0,0,0,0,2,0,0,0,2
4564,780648,6,0,2,0,2,0,0,0,2,1,0,0,0,1,0,0,0
4564,785238,2,1,1,1,1,0,0,0,0,0,1,0,1,0,0,1,2
4564,790919,2,0,0,0,0,0,0,0,0,0,0,0,0,1,0,0,0
4564,790916,2,1,1,1,1,0,0,1,2,0,0,1,0,0,0,0,3
4565,792306,34,7,9,6,6,1,3,4,5,0,5,2,3,0,5,0,19
4565,776424,23,0,1,0,0,0,1,0,0,2,3,0,2,0,0,0,0
4565,792303,28,5,12,4,7,1,5,7,8,1,1,1,5,1,6,0,18
4565,781603,19,0,2,0,0,0,2,0,1,1,4,0,1,0,0,0,0
4565,780456,20,3,9,1,4,2,5,1,1,1,3,0,5,0,1,0,9
4565,797912,23,1,4,1,2,0,2,1,2,0,1,2,1,0,1,0,3
4565,786618,4,0,0,0,0,0,0,0,0,0,0,0,3,0,0,0,0
4565,792300,22,3,4,3,4,0,0,3,4,2,2,0,4,0,3,0,9
4565,797914,21,1,10,0,5,1,5,0,0,0,2,1,3,1,0,0,3
4565,781605,2,0,0,0,0,0,0,0,0,1,0,0,0,0,0,0,0
4565,781607,2,0,0,0,0,0,0,0,0,0,0,0,0,0,0,0,0
4565,797902,1,0,0,0,0,0,0,0,0,0,0,0,0,0,0,0,0
4565,797907,1,0,0,0,0,0,0,0,0,0,0,0,0,0,0,0,0
4566,780229,28,6,11,6,11,0,0,4,10,3,9,1,3,2,3,0,16
4566,795572,34,7,10,6,9,1,1,3,3,4,2,5,1,1,4,0,18
4566,791483,33,5,11,3,7,2,4,2,2,0,3,0,3,2,1,0,14
4566,786322,28,1,5,1,3,0,2,0,0,1,2,2,1,0,3,0,2
4566,780228,33,2,7,0,0,2,7,0,0,0,0,0,0,1,0,0,6
4566,791487,5,1,2,0,1,1,1,0,0,1,0,0,1,0,0,0,3
4566,781592,24,2,5,2,5,0,0,4,4,3,3,3,2,0,0,1,8
4566,791488,3,0,1,0,0,0,1,0,0,0,0,1,1,0,0,0,0
4566,797193,5,0,1,0,0,0,1,0,0,0,2,0,1,0,1,0,0
4566,791485,6,0,1,0,0,0,1,0,0,0,1,0,0,0,0,0,0
4566,786323,1,0,0,0,0,0,0,0,0,0,0,0,0,0,0,0,0
4567,797616,27,5,9,4,7,1,2,0,0,3,3,1,4,3,3,4,11
4567,791882,33,3,5,3,4,0,1,2,2,4,8,1,3,0,1,2,8
4567,786493,30,6,17,3,6,3,11,1,1,1,5,1,1,0,1,0,16
4567,791881,26,2,6,0,1,2,5,2,2,0,0,4,1,0,1,0,8
4567,786420,30,3,7,0,2,3,5,2,2,0,2,3,2,0,4,0,11
4567,797618,13,2,3,2,3,0,0,0,0,2,0,1,5,0,0,0,4
4567,797613,15,2,7,1,4,1,3,0,1,2,1,1,1,0,0,0,5
4567,781052,26,3,7,0,0,3,7,0,1,0,3,0,0,0,0,0,9
4568,785916,21,6,10,5,9,1,1,5,6,2,3,0,5,0,1,1,18
4568,780105,39,2,10,2,6,0,4,1,6,2,4,3,4,1,2,2,5
4568,785637,43,3,10,2,6,1,4,8,10,0,8,3,2,1,1,0,15
4568,785915,41,1,6,0,0,1,6,0,0,0,3,1,4,0,0,0,3
4568,781131,37,7,10,6,7,1,3,0,0,1,7,3,4,1,3,0,15
4568,791408,20,3,7,3,7,0,0,2,5,0,4,1,2,0,2,0,8
4568,780106,15,0,1,0,1,0,0,1,4,1,2,0,4,0,1,0,1
4568,791409,9,0,1,0,0,0,1,1,3,1,0,0,1,0,2,0,1
4569,780631,8,0,2,0,1,0,1,0,0,0,0,0,5,0,0,2,0
4569,791827,41,6,16,6,16,0,0,11,14,3,13,0,4,2,2,0,23
4569,797391,17,1,2,0,0,1,2,0,0,1,2,1,3,0,1,0,3
4569,786625,40,2,14,2,9,0,5,2,6,0,3,7,2,1,3,0,6
4569,780625,41,1,6,1,3,0,3,2,2,0,3,3,0,1,1,0,4
4569,797397,9,2,2,2,2,0,0,0,0,0,1,0,4,0,1,1,4
4569,785481,22,3,6,3,6,0,0,4,7,1,1,0,3,0,0,1,10
4569,791830,1,0,0,0,0,0,0,0,0,0,0,0,1,0,0,0,0
4569,797395,29,2,6,2,5,0,1,0,0,1,2,2,0,0,1,0,4
4569,786630,17,2,3,1,2,1,1,3,4,1,3,0,4,1,0,0,8
4570,796543,11,1,1,1,1,0,0,0,0,0,1,0,0,0,0,0,2
4570,790951,22,3,3,3,3,0,0,1,2,1,3,0,4,0,0,0,7
4570,786309,26,2,4,1,1,1,3,0,1,1,2,0,2,1,0,0,5
4570,780087,31,9,12,8,10,1,2,4,4,2,4,0,4,0,1,0,23
4570,776136,32,2,12,1,6,1,6,4,5,0,1,2,2,1,2,0,9
4570,796540,19,1,3,1,2,0,1,1,2,1,1,0,2,0,1,0,3
4570,775037,5,2,2,2,2,0,0,0,0,1,2,0,2,0,0,0,4
4570,796545,20,2,4,1,2,1,2,0,0,1,0,0,2,1,2,0,5
4570,786089,20,3,7,2,3,1,4,1,2,1,4,0,1,0,0,0,8
4570,781410,14,2,7,1,3,1,4,0,0,0,1,2,0,0,0,0,5
4571,799136,19,0,4,0,4,0,0,1,3,2,5,0,2,0,1,2,1
4571,800005,25,4,6,4,6,0,0,1,2,1,1,0,3,0,0,0,9
4571,799129,34,2,4,1,2,1,2,6,7,0,3,2,3,0,3,0,11
4571,799134,36,5,13,2,5,3,8,5,6,0,2,2,1,0,0,0,18
4571,792634,37,3,11,2,5,1,6,0,0,1,1,3,5,1,6,0,7
4571,799135,2,1,1,1,1,0,0,0,0,0,0,0,0,0,0,0,2
4571,799128,24,2,3,1,1,1,2,0,0,0,0,3,1,0,1,0,5
4571,799133,23,0,4,0,2,0,2,6,8,3,3,2,1,0,2,0,6
4572,797728,16,0,1,0,0,0,1,1,2,0,1,1,1,1,0,0,1
4572,792036,22,3,5,2,2,1,3,0,1,2,1,1,3,0,0,0,7
4572,786266,32,5,10,5,7,0,3,4,5,1,3,1,0,1,3,0,14
4572,792040,29,3,11,3,8,0,3,0,0,0,1,1,0,2,2,0,6
4572,775028,33,5,11,3,5,2,6,4,4,1,1,7,3,3,5,1,16
4572,797726,26,8,12,4,7,4,5,4,5,0,8,0,4,1,1,0,24
4572,797719,17,3,10,3,5,0,5,0,0,0,1,1,2,1,1,0,6
4572,797718,10,0,0,0,0,0,0,0,0,0,0,2,1,0,1,0,0
4572,786039,15,0,0,0,0,0,0,0,0,0,2,0,2,0,0,0,0
4573,780521,29,4,6,1,1,3,5,4,7,0,3,3,3,0,0,0,15
4573,775163,26,3,5,2,4,1,1,3,8,1,4,1,2,0,3,0,10
4573,791370,14,3,4,2,3,1,1,0,0,0,1,0,1,3,2,0,7
4573,786199,36,7,12,5,9,2,3,2,2,0,6,7,2,2,8,0,18
4573,780991,34,5,7,1,3,4,4,2,2,0,6,3,3,0,2,1,16
4573,780145,9,0,0,0,0,0,0,0,0,0,1,1,1,1,0,1,0
4573,781611,5,0,0,0,0,0,0,2,4,0,0,0,2,0,2,0,2
4573,797271,21,3,6,2,3,1,3,0,0,0,6,2,1,1,2,0,7
4573,743593,19,2,3,2,3,0,0,2,2,0,1,1,2,0,1,0,6
4573,791371,7,0,0,0,0,0,0,0,0,0,0,0,0,1,1,0,0
4574,786566,35,9,17,8,11,1,6,2,3,2,7,3,0,1,2,4,21
4574,781204,34,6,13,5,8,1,5,1,1,0,7,3,1,1,0,0,14
4574,786568,12,3,3,3,3,0,0,1,1,0,2,1,3,1,1,0,7
4574,791993,21,3,7,3,5,0,2,0,1,0,2,3,4,2,3,0,6
4574,781188,33,2,5,2,3,0,2,0,0,1,7,10,3,1,6,0,4
4574,791997,9,3,4,1,1,2,3,0,0,0,1,0,1,0,1,0,8
4574,797494,13,1,5,0,3,1,2,0,0,1,1,0,1,0,0,0,3
4574,786562,19,2,3,1,1,1,2,3,3,0,6,3,3,1,1,0,8
4574,781189,14,3,8,3,6,0,2,1,2,1,4,0,1,3,2,0,7
4574,791995,2,1,2,1,1,0,1,0,0,0,0,0,0,0,0,0,2
4574,786565,1,0,0,0,0,0,0,0,0,0,0,1,0,0,0,0,0
4574,797493,7,0,0,0,0,0,0,0,0,0,0,0,0,0,0,0,0
4575,797482,36,6,13,3,9,3,4,4,5,1,7,2,3,0,4,0,19
4575,797485,33,6,11,4,4,2,7,0,0,0,4,4,1,2,3,0,14
4575,797481,32,5,9,4,5,1,4,4,7,0,6,1,4,1,1,0,15
4575,797480,28,2,7,2,5,0,2,1,2,0,3,3,4,2,3,0,5
4575,791873,40,3,10,2,6,1,4,3,4,0,3,7,0,5,4,0,10
4575,797483,4,1,1,1,1,0,0,0,0,0,2,0,2,0,1,0,2
4575,797478,6,0,2,0,0,0,2,0,0,0,2,0,0,0,0,0,0
4575,781217,17,0,3,0,0,0,3,0,0,0,2,0,1,0,0,0,0
4575,797479,4,0,0,0,0,0,0,0,0,0,0,0,0,0,0,0,0
4576,797876,15,1,5,1,5,0,0,1,2,3,2,3,1,1,0,0,3
4576,792222,19,0,4,0,1,0,3,0,0,0,1,1,1,1,1,0,0
4576,781319,21,5,6,5,5,0,1,2,7,3,5,2,4,0,4,0,12
4576,786693,23,4,6,4,5,0,1,2,2,1,0,0,3,0,1,0,10
4576,781329,34,5,9,4,8,1,1,5,8,0,4,11,2,2,3,0,16
4576,786656,19,1,2,1,2,0,0,0,0,2,3,0,3,2,1,1,2
4576,792046,20,5,11,5,5,0,6,0,1,0,1,0,2,2,1,0,10
4576,792220,20,4,10,2,4,2,6,1,2,0,4,1,1,0,1,0,11
4576,781455,17,2,5,1,4,1,1,1,2,1,3,1,3,1,0,0,6
4576,792221,12,1,3,1,3,0,0,0,1,1,1,0,1,0,0,0,2
4577,796892,14,4,6,4,6,0,0,2,4,0,1,0,3,1,0,0,10
4577,796886,37,2,5,2,4,0,1,4,9,4,6,4,3,1,2,0,8
4577,796884,23,1,5,1,2,0,3,0,0,1,2,0,4,0,2,0,2
4577,796896,26,3,8,1,2,2,6,1,2,0,3,1,5,2,0,0,9
4577,796882,38,7,14,6,8,1,6,3,3,1,3,4,4,2,5,0,18
4577,796891,26,5,9,4,6,1,3,2,3,6,4,2,2,0,4,0,13
4577,796888,14,0,1,0,0,0,1,0,0,0,2,3,3,1,2,0,0
4577,796887,18,2,7,1,2,1,5,0,1,0,2,2,2,0,2,0,5
4577,796889,2,0,1,0,0,0,1,0,0,0,1,0,0,0,0,0,0
4577,796881,2,0,0,0,0,0,0,0,0,0,0,0,0,0,0,0,0
4578,790854,15,2,5,2,5,0,0,2,3,1,1,2,4,0,0,0,6
4578,796404,21,2,8,2,8,0,0,2,4,5,3,1,3,0,1,1,6
4578,790850,30,4,6,0,0,4,6,6,7,0,1,3,2,0,2,0,18
4578,781164,30,3,6,0,1,3,5,2,2,1,4,1,1,0,0,0,11
4578,781163,34,6,11,4,5,2,6,3,3,0,2,5,2,0,3,0,17
4578,790848,3,0,2,0,1,0,1,0,0,0,0,0,0,1,0,0,0
4578,790853,9,4,4,4,4,0,0,1,2,2,0,0,2,0,0,0,9
4578,785434,16,1,1,1,1,0,0,0,0,0,3,2,2,0,3,0,2
4578,790849,23,1,5,1,3,0,2,0,0,0,0,5,2,0,2,0,2
4578,796406,15,2,5,2,5,0,0,5,6,3,3,0,2,0,0,0,9
4578,781223,4,0,1,0,0,0,1,0,0,0,1,0,1,0,0,0,0
4579,796343,32,6,7,6,7,0,0,0,2,2,5,0,4,0,1,0,12
4579,796344,29,7,13,3,4,4,9,1,1,0,2,0,3,2,0,0,19
4579,790785,26,1,4,1,3,0,1,6,6,3,0,8,5,2,2,0,8
4579,796340,29,5,9,4,8,1,1,3,4,1,6,4,4,1,0,0,14
4579,780037,36,3,13,3,5,0,8,8,8,0,0,8,1,1,0,0,14
4579,796339,8,0,1,0,1,0,0,0,0,0,1,0,3,0,1,0,0
4579,780040,19,4,6,4,5,0,1,0,2,0,1,0,2,0,0,0,8
4579,781232,21,2,3,2,2,0,1,0,0,0,2,2,1,0,0,0,4
4580,786623,26,5,6,5,6,0,0,2,3,3,4,0,2,0,1,0,12
4580,797405,32,4,9,4,9,0,0,0,0,1,6,1,4,3,3,0,8
4580,791834,35,7,11,3,5,4,6,0,0,0,1,1,2,1,1,0,18
4580,785920,39,6,16,4,13,2,3,0,0,0,4,7,1,1,4,0,14
4580,785698,16,2,9,2,6,0,3,0,0,3,1,0,0,1,1,1,4
4580,786624,14,1,2,1,2,0,0,0,0,2,1,1,2,1,0,0,2
4580,791833,15,1,6,1,5,0,1,0,0,0,0,1,4,0,1,1,2
4580,784077,22,5,13,3,5,2,8,0,0,0,4,0,3,2,0,0,12
4580,797404,1,0,0,0,0,0,0,0,0,0,2,0,2,0,0,0,0
4581,791728,18,4,6,4,6,0,0,0,1,0,4,1,3,0,1,1,8
4581,797317,35,1,5,1,3,0,2,0,0,1,0,2,3,0,2,0,2
4581,791726,35,6,9,2,3,4,6,6,6,0,0,6,0,0,5,0,22
4581,780773,33,2,9,2,7,0,2,3,5,4,9,0,1,2,4,0,7
4581,775228,31,6,10,3,5,3,5,1,2,0,4,1,0,2,1,0,16
4581,797315,3,0,1,0,0,0,1,0,0,0,0,0,0,0,0,0,0
4581,797313,24,6,10,4,7,2,3,0,1,2,3,1,0,0,1,0,14
4581,786569,21,2,6,2,6,0,0,1,2,2,8,1,3,1,4,0,5
4582,786704,20,6,8,6,8,0,0,2,3,6,7,0,1,0,3,1,14
4582,785395,20,4,9,2,5,2,4,0,0,0,2,1,2,0,0,0,10
4582,775840,22,1,6,0,2,1,4,0,0,0,1,6,2,1,1,0,3
4582,775955,24,5,6,4,5,1,1,0,0,0,5,6,0,0,2,0,11
4582,775811,11,2,2,1,1,1,1,0,0,0,0,1,0,2,0,0,5
4582,792327,11,0,2,0,2,0,0,1,2,1,2,0,1,0,1,0,1
4582,786706,9,2,3,2,3,0,0,0,0,1,0,0,3,0,2,0,4
4582,786703,9,3,6,1,1,2,5,0,0,0,0,0,0,0,0,0,8
4582,775287,15,3,4,2,3,1,1,0,1,1,1,1,0,0,1,2,7
4582,786702,14,0,0,0,0,0,0,2,2,1,4,1,2,0,0,0,2
4582,790921,20,6,6,6,6,0,0,0,1,0,3,2,3,0,2,0,12
4582,786551,25,2,10,2,6,0,4,3,3,0,4,6,1,0,0,0,7
4583,780913,12,0,2,0,0,0,2,0,0,0,0,1,5,0,1,0,0
4583,798119,24,2,10,2,5,0,5,0,0,0,1,1,0,1,2,0,4
4583,798117,26,2,7,2,5,0,2,2,2,0,0,1,1,0,1,0,6
4583,780594,23,3,8,1,2,2,6,0,0,0,3,0,1,0,4,0,8
4583,775664,20,2,3,1,1,1,2,2,2,2,0,0,0,1,0,0,7
4583,798127,8,0,0,0,0,0,0,0,0,0,0,0,0,0,1,0,0
4583,798123,20,6,11,6,9,0,2,4,4,4,3,2,2,0,0,0,16
4583,769332,10,1,3,0,2,1,1,0,0,0,2,0,0,0,0,0,3
4583,786398,10,0,2,0,1,0,1,0,0,0,1,1,4,1,1,0,0
4583,798126,4,0,0,0,0,0,0,0,1,0,0,1,0,0,0,0,0
4583,798124,25,1,4,1,3,0,1,0,1,0,4,0,0,0,1,0,2
4583,798121,14,2,3,1,1,1,2,2,2,0,3,1,1,0,0,0,7
4583,798120,4,0,0,0,0,0,0,0,0,0,0,0,0,0,1,0,0
4584,791750,30,1,2,1,1,0,1,0,0,1,4,2,3,1,0,1,2
4584,786177,24,4,9,2,4,2,5,0,0,1,3,1,2,1,1,0,10
4584,780244,33,0,8,0,2,0,6,0,0,0,6,3,2,0,1,0,0
4584,786179,33,10,21,2,7,8,14,2,2,1,2,1,4,4,1,0,30
4584,780238,35,4,10,3,7,1,3,0,0,0,4,2,3,1,2,0,9
4584,790773,22,3,8,1,2,2,6,0,0,1,0,1,3,2,1,0,8
4584,785909,11,1,1,1,1,0,0,0,0,0,1,0,2,0,2,1,2
4584,781500,12,1,4,1,3,0,1,0,1,0,0,0,0,0,0,0,2
4585,785126,12,1,3,1,1,0,2,0,0,1,2,1,0,0,0,0,2
4585,779857,21,5,7,5,6,0,1,1,1,1,6,3,2,1,1,2,11
4585,791014,19,0,3,0,0,0,3,0,0,0,1,0,1,0,0,0,0
4585,779976,31,4,11,3,7,1,4,10,10,0,2,1,2,0,4,0,19
4585,774990,25,4,7,3,5,1,2,0,0,0,1,1,2,1,1,0,9
4585,785961,23,2,6,1,4,1,2,0,0,1,1,1,1,0,0,0,5
4585,781586,19,5,8,5,8,0,0,3,5,5,6,1,0,0,3,1,13
4585,796673,14,4,10,3,8,1,2,1,2,1,2,0,0,0,1,2,10
4585,796674,22,1,1,0,0,1,1,0,0,1,6,0,0,1,1,0,3
4585,785339,14,0,2,0,1,0,1,0,0,0,4,2,1,1,1,0,0
4586,797142,20,2,2,2,2,0,0,1,2,1,2,2,3,0,0,1,5
4586,791522,35,7,16,7,15,0,1,9,10,2,5,5,4,2,4,0,23
4586,786351,31,3,5,2,2,1,3,4,4,4,5,0,3,3,0,0,11
4586,797146,38,7,19,5,11,2,8,9,10,1,3,0,1,0,2,0,25
4586,797143,35,5,11,1,5,4,6,1,2,0,5,2,1,2,5,0,15
4586,797147,4,0,1,0,1,0,0,0,0,0,1,1,2,0,0,0,0
4586,786348,11,1,2,1,2,0,0,0,2,1,2,0,0,0,0,0,2
4586,785816,23,2,2,2,2,0,0,0,2,0,1,0,2,2,1,1,4
4586,797144,3,0,1,0,1,0,0,0,0,0,0,0,0,1,0,0,0
4587,790914,31,6,8,6,8,0,0,0,0,4,4,1,4,0,2,1,12
4587,780798,40,5,10,4,4,1,6,1,1,5,5,2,2,0,2,1,12
4587,785455,17,1,8,0,2,1,6,2,2,0,1,5,4,1,0,0,5
4587,785453,40,8,19,4,5,4,14,2,3,1,4,5,3,5,3,0,22
4587,774940,15,0,4,0,3,0,1,0,0,0,2,2,2,2,2,0,0
4587,785458,35,10,18,9,17,1,1,5,8,2,5,2,3,0,3,4,26
4587,790913,9,1,2,0,1,1,1,0,0,0,0,0,2,1,0,0,3
4587,785454,11,0,0,0,0,0,0,0,0,0,2,1,1,0,2,0,0
4587,785456,2,0,0,0,0,0,0,0,0,0,1,0,1,0,0,0,0
4588,792399,28,3,7,3,6,0,1,0,0,2,5,2,3,0,1,0,6
4588,785471,29,5,7,5,6,0,1,5,5,5,2,0,3,2,1,3,15
4588,780263,32,6,12,2,5,4,7,1,2,0,3,1,3,0,1,2,17
4588,786697,24,3,5,3,3,0,2,0,0,1,3,4,5,0,1,0,6
4588,780571,31,1,10,0,5,1,5,1,2,1,2,2,3,1,6,0,4
4588,799000,13,2,6,2,6,0,0,3,6,1,2,2,1,0,0,2,7
4588,775198,29,4,9,2,6,2,3,1,2,1,3,2,1,2,2,1,11
4588,775547,8,2,3,2,3,0,0,0,0,1,3,1,2,0,2,0,4
4588,792397,6,1,2,1,1,0,1,0,0,0,0,1,0,0,0,0,2
4589,796637,21,6,11,6,10,0,1,4,4,2,3,0,1,0,4,0,16
4589,792627,28,3,5,3,4,0,1,4,4,1,1,0,0,1,1,0,10
4589,792626,36,4,9,4,8,0,1,1,2,0,3,6,1,2,2,0,9
4589,781491,28,3,8,2,5,1,3,0,0,3,2,2,2,1,1,0,7
4589,780250,27,5,11,2,5,3,6,5,7,2,4,3,2,0,1,0,18
4589,796634,13,0,3,0,3,0,0,2,2,2,3,0,3,1,3,1,2
4589,792632,6,0,4,0,4,0,0,0,0,3,1,0,4,0,2,0,0
4589,796638,31,4,8,2,5,2,3,1,2,0,1,0,1,2,0,0,11
4589,796645,5,0,1,0,0,0,1,2,2,0,0,1,1,1,1,0,2
4589,792631,5,1,1,1,1,0,0,1,2,0,1,0,0,0,0,0,3
4590,774806,29,5,6,5,6,0,0,3,4,2,13,0,5,0,3,5,13
4590,775823,31,2,5,1,2,1,3,2,3,1,6,4,2,0,2,0,7
4590,791041,31,4,8,1,3,3,5,2,3,3,2,1,5,0,4,1,13
4590,791038,32,6,11,1,2,5,9,0,0,0,5,4,2,0,1,0,17
4590,789023,39,6,13,4,5,2,8,4,4,0,1,6,4,0,4,0,18
4590,796714,11,0,1,0,1,0,0,2,2,1,3,1,1,1,3,0,2
4590,796711,1,0,0,0,0,0,0,0,0,0,0,0,0,0,0,0,0
4590,775205,26,1,4,0,0,1,4,0,0,0,0,2,3,1,1,0,3
4591,795730,40,4,12,3,10,1,2,4,4,0,3,2,4,1,1,0,13
4591,797802,40,3,10,3,7,0,3,1,2,1,3,1,4,3,0,0,7
4591,797809,40,5,12,3,7,2,5,8,11,3,10,2,3,2,1,0,20
4591,797807,27,6,9,6,8,0,1,3,3,0,2,2,3,0,3,0,15
4591,786058,40,2,6,2,5,0,1,2,3,1,1,2,4,0,2,0,6
4591,797810,13,2,6,2,6,0,0,2,3,0,0,1,1,0,0,0,6
4592,792351,29,3,3,3,3,0,0,0,0,1,1,1,4,0,3,0,6
4592,786724,18,1,5,0,0,1,5,4,4,0,5,1,0,0,0,0,7
4592,786723,35,8,15,6,12,2,3,8,9,0,6,5,1,2,7,1,26
4592,798060,33,5,10,4,7,1,3,1,1,0,6,4,3,0,2,0,12
4592,792352,26,0,6,0,2,0,4,0,0,1,0,1,4,1,2,0,0
4592,792355,25,3,8,1,1,2,7,0,0,0,1,2,3,1,1,0,8
4592,792349,12,0,1,0,1,0,0,0,0,1,1,0,3,0,0,1,0
4592,798061,14,0,1,0,0,0,1,2,2,0,2,0,1,0,1,0,2
4592,786726,4,1,2,1,2,0,0,0,0,2,0,0,0,0,0,0,2
4592,792348,4,0,0,0,0,0,0,0,0,0,1,2,0,0,0,0,0
4593,791057,11,1,2,0,1,1,1,0,0,0,3,0,3,0,4,1,3
4593,785532,33,4,7,4,7,0,0,3,3,2,7,1,1,1,0,0,11
4593,780063,31,6,10,4,6,2,4,0,0,1,6,0,4,0,0,0,14
4593,775573,27,3,10,1,1,2,9,4,4,0,0,1,0,2,2,0,12
4593,775926,27,2,7,0,2,2,5,3,3,0,2,0,0,0,0,1,9
4593,791058,12,2,3,2,3,0,0,0,0,0,1,0,3,0,1,0,4
4593,796734,18,1,2,0,0,1,2,0,0,0,0,2,4,0,1,1,3
4593,791280,20,4,8,4,6,0,2,3,5,0,0,3,1,0,2,0,11
4593,791055,20,2,4,2,3,0,1,1,4,3,2,5,1,3,1,0,5
4593,796733,1,0,0,0,0,0,0,0,0,0,0,0,0,0,0,0,0
4594,792121,33,1,6,1,2,0,4,0,0,3,5,0,5,1,1,0,2
4594,786257,35,4,10,4,9,0,1,1,2,2,2,2,3,0,0,1,9
4594,786263,38,6,10,3,5,3,5,0,0,2,5,0,0,0,3,1,15
4594,785661,28,3,12,2,9,1,3,5,6,0,3,4,4,1,2,0,12
4594,775825,37,4,12,2,9,2,3,0,0,0,3,7,1,1,1,0,10
4594,786249,19,3,9,1,3,2,6,0,0,0,3,0,2,0,0,0,8
4594,797725,5,0,2,0,2,0,0,0,0,0,0,0,0,0,1,1,0
4594,792356,1,0,0,0,0,0,0,0,0,0,0,0,0,0,0,1,0
4594,797721,2,1,1,0,0,1,1,0,0,0,0,0,0,0,0,0,3
4594,797724,2,0,1,0,1,0,0,0,0,0,0,0,0,0,0,0,0
4595,790799,22,0,0,0,0,0,0,0,0,0,0,0,2,2,1,0,0
4595,790798,33,5,6,5,6,0,0,4,5,0,8,0,2,0,1,3,14
4595,780140,39,5,11,2,5,3,6,4,4,0,5,1,0,1,0,0,17
4595,796355,26,5,12,5,9,0,3,4,4,1,2,2,3,1,5,1,14
4595,780137,36,8,13,8,13,0,0,0,0,0,5,1,2,1,1,0,16
4595,785245,22,2,5,2,4,0,1,0,0,0,1,1,4,0,1,0,4
4595,790796,4,0,1,0,1,0,0,0,0,0,1,0,0,0,0,1,0
4595,775553,15,3,4,2,3,1,1,1,2,0,3,1,1,1,1,0,8
4595,799892,1,0,0,0,0,0,0,0,0,0,0,0,0,0,0,0,0
4595,794905,1,0,0,0,0,0,0,0,0,0,0,0,0,0,0,0,0
4595,796359,1,0,0,0,0,0,0,0,0,0,1,0,0,0,0,0,0
4616,791416,31,7,7,7,7,0,0,1,5,6,5,0,3,0,3,0,15
4616,797096,32,4,9,1,1,3,8,3,3,2,5,0,2,1,0,0,14
4616,785906,35,6,16,5,13,1,3,9,10,2,2,5,3,2,1,0,22
4616,780100,22,1,4,0,1,1,3,0,0,0,2,1,2,1,1,0,3
4616,780096,37,3,9,1,4,2,5,0,0,0,1,4,3,2,1,0,8
4616,781614,12,3,6,1,2,2,4,0,0,0,1,3,4,0,0,1,8
4616,785907,15,4,6,4,5,0,1,1,1,0,0,0,1,0,1,0,9
4616,797093,12,1,3,1,1,0,2,0,1,0,2,2,1,0,2,0,2
4616,797094,4,0,0,0,0,0,0,0,0,0,0,0,1,0,1,0,0
4617,790873,27,10,16,6,9,4,7,2,4,1,6,1,4,0,0,0,26
4617,785429,29,4,6,1,1,3,5,0,0,0,1,0,5,1,1,0,11
4617,780054,34,2,6,2,6,0,0,5,6,2,5,4,1,2,5,0,9
4617,781140,24,2,3,2,2,0,1,2,2,1,1,3,3,1,0,0,6
4617,786851,31,3,10,2,6,1,4,4,4,0,1,2,2,0,3,0,11
4617,799973,17,1,2,0,1,1,1,0,0,0,1,2,1,0,0,0,3
4617,781139,6,0,1,0,1,0,0,2,4,0,1,0,1,0,0,1,2
4617,796433,13,3,4,3,4,0,0,2,2,1,3,0,3,1,1,0,8
4617,776245,16,4,6,2,3,2,3,1,1,1,2,0,0,1,1,0,11
4617,796432,3,0,0,0,0,0,0,0,0,0,0,0,0,0,0,0,0
4618,791876,34,9,18,9,18,0,0,6,7,6,10,1,0,1,3,2,24
4618,791877,23,2,6,2,6,0,0,0,0,0,3,2,3,0,0,1,4
4618,785667,34,7,12,2,2,5,10,1,1,0,6,1,3,0,0,0,20
4618,786572,31,6,14,5,10,1,4,5,7,4,1,0,2,2,0,0,18
4618,786570,35,4,12,2,4,2,8,13,13,1,5,7,3,1,2,0,23
4618,781205,8,0,0,0,0,0,0,0,0,0,2,0,4,0,0,1,0
4618,797491,7,1,1,1,1,0,0,0,0,0,0,1,1,0,0,0,2
4618,797486,20,2,3,2,3,0,0,1,4,1,1,8,1,0,0,0,5
4618,797487,5,0,0,0,0,0,0,0,0,2,0,0,1,0,1,0,0
4618,797489,1,0,0,0,0,0,0,0,0,1,0,0,0,0,0,0,0
4618,791880,1,0,1,0,0,0,1,0,0,0,0,0,0,0,0,0,0
4618,790396,1,0,0,0,0,0,0,0,0,0,0,0,0,0,0,0,0
4619,792181,38,8,19,7,14,1,5,1,1,5,8,3,3,0,0,4,18
4619,780986,39,4,6,4,6,0,0,6,8,0,2,2,4,0,1,3,14
4619,785902,32,10,18,8,14,2,4,6,6,3,4,0,2,0,3,2,28
4619,792179,22,0,4,0,1,0,3,2,2,0,1,1,2,1,1,0,2
4619,786662,40,4,12,4,4,0,8,4,4,0,4,7,3,1,0,0,12
4619,786661,8,0,2,0,0,0,2,0,0,1,3,0,2,0,0,0,0
4619,797796,18,1,5,1,5,0,0,0,1,1,2,4,3,0,0,0,2
4619,792177,1,0,1,0,1,0,0,0,0,0,0,0,1,0,0,0,0
4619,797794,2,0,1,0,0,0,1,0,0,0,0,0,1,0,0,0,0
4620,786447,30,4,6,4,5,0,1,0,1,2,4,3,4,1,3,0,8
4620,775074,23,4,5,4,5,0,0,0,1,2,1,2,0,0,3,0,8
4620,786448,21,1,4,1,2,0,2,0,0,3,2,0,2,0,1,1,2
4620,780731,35,9,17,7,11,2,6,2,3,0,2,2,2,2,1,0,22
4620,780462,35,9,19,5,11,4,8,2,3,1,3,8,2,1,2,0,24
4620,786132,12,1,2,1,2,0,0,1,5,3,0,0,2,0,1,0,3
4620,791631,8,0,3,0,1,0,2,0,0,0,0,2,1,0,0,0,0
4620,796971,15,3,4,2,2,1,2,0,2,2,1,1,1,0,2,0,7
4620,776365,14,0,0,0,0,0,0,0,0,0,1,1,4,0,1,0,0
4620,775121,7,0,1,0,0,0,1,0,0,0,0,0,1,2,1,0,0
4621,781622,30,1,3,0,0,1,3,2,2,1,2,1,2,1,0,0,5
4621,791302,36,4,11,4,9,0,2,5,6,0,5,3,1,1,3,1,13
4621,791309,39,6,8,4,6,2,2,4,4,0,4,9,3,2,5,0,18
4621,785835,25,9,9,8,8,1,1,0,0,1,3,4,3,0,0,0,19
4621,776334,30,1,4,0,2,1,2,1,2,0,2,0,2,1,2,0,4
4621,775862,10,1,2,1,2,0,0,3,3,0,1,1,3,0,1,0,5
4621,796601,22,5,8,1,3,4,5,0,0,0,0,0,3,2,4,0,14
4621,791301,4,0,1,0,1,0,0,0,0,1,1,0,0,0,1,0,0
4621,796603,2,0,0,0,0,0,0,0,0,0,0,0,0,0,0,0,0
4621,796602,2,0,0,0,0,0,0,0,0,0,0,0,0,0,0,0,0
4622,791140,19,5,9,5,9,0,0,2,2,2,2,0,1,0,1,0,12
4622,791138,14,6,8,5,5,1,3,1,1,0,2,2,2,1,1,0,14
4622,786084,25,2,9,1,5,1,4,0,0,4,2,2,1,0,1,0,5
4622,780910,23,3,8,3,6,0,2,0,0,0,5,8,3,1,0,0,6
4622,780288,22,4,7,2,3,2,4,1,1,0,1,0,2,2,0,0,11
4622,796794,13,2,5,2,5,0,0,0,4,2,3,2,1,0,2,0,4
4622,796795,17,1,4,1,4,0,0,1,2,4,3,5,0,0,0,1,3
4622,796793,7,1,4,1,2,0,2,0,0,2,1,1,1,0,0,0,2
4622,786082,7,2,6,1,4,1,2,0,0,1,0,0,0,1,0,0,5
4622,780912,17,3,5,0,1,3,4,0,0,0,4,2,2,1,0,0,9
4622,780911,18,4,7,1,2,3,5,2,2,0,3,2,2,1,0,0,13
4622,781635,18,3,3,0,0,3,3,2,2,1,1,2,1,2,0,0,11
4623,786459,28,5,9,5,9,0,0,1,2,1,1,1,0,1,3,0,11
4623,781612,33,7,14,7,11,0,3,0,0,3,8,3,4,1,0,4,14
4623,797005,21,2,7,2,5,0,2,0,1,0,1,1,3,0,3,0,4
4623,797004,25,0,3,0,1,0,2,1,2,0,2,5,0,0,2,0,1
4623,781609,27,3,6,2,3,1,3,2,4,1,3,2,2,0,3,0,9
4623,785887,1,0,0,0,0,0,0,0,0,0,1,0,0,0,0,0,0
4623,797008,8,2,2,2,2,0,0,0,0,0,0,0,1,0,1,0,4
4623,797006,19,3,7,2,4,1,3,2,3,1,1,1,3,1,1,1,9
4623,791358,3,0,0,0,0,0,0,0,0,0,1,1,1,0,0,0,0
4623,797003,15,1,3,1,1,0,2,1,1,0,0,1,2,0,0,1,3
4623,791360,20,0,4,0,1,0,3,0,0,0,4,2,1,0,2,0,0
4624,792271,17,3,7,3,7,0,0,1,2,2,0,0,3,0,0,0,7
4624,792269,18,0,2,0,1,0,1,0,0,0,4,2,1,0,0,0,0
4624,790940,37,5,15,2,6,3,9,1,2,1,3,1,4,1,2,1,14
4624,786060,25,1,7,1,4,0,3,2,2,0,1,3,0,0,0,0,4
4624,780770,25,3,11,2,8,1,3,2,2,0,0,1,2,2,3,0,9
4624,798028,34,4,8,3,6,1,2,4,4,0,5,4,3,1,0,1,13
4624,792270,22,1,3,1,3,0,0,0,0,0,4,1,2,2,0,1,2
4624,791686,21,3,10,1,3,2,7,0,0,0,5,0,3,0,0,0,8
4624,792305,1,0,0,0,0,0,0,0,0,0,0,0,0,0,0,0,0
4625,785930,27,5,6,5,6,0,0,5,9,3,7,1,1,0,2,0,15
4625,780996,29,4,8,2,2,2,6,0,1,2,5,3,2,0,3,0,10
4625,780995,26,2,6,0,3,2,3,0,0,1,8,4,2,0,0,1,6
4625,796468,35,2,6,1,3,1,3,0,0,0,5,4,2,0,1,1,5
4625,790920,32,7,16,6,13,1,3,5,8,1,6,2,3,0,3,0,20
4625,791035,19,0,4,0,2,0,2,3,5,1,5,0,4,0,2,0,3
4625,775709,28,2,5,0,1,2,4,0,0,0,2,3,1,1,2,0,6
4625,796467,4,0,2,0,0,0,2,0,0,0,0,0,0,0,0,0,0
4626,780406,22,6,7,2,3,4,4,4,5,1,6,0,0,0,2,0,20
4626,790985,19,3,5,3,5,0,0,1,2,0,4,1,0,0,0,1,7
4626,790984,28,3,6,0,1,3,5,2,3,0,3,3,1,1,1,0,11
4626,780212,30,4,12,4,6,0,6,1,2,0,2,3,2,3,1,2,9
4626,767245,29,4,9,4,9,0,0,2,2,4,2,0,1,2,2,0,10
4626,780214,18,0,2,0,0,0,2,0,0,0,1,2,0,1,0,0,0
4626,780215,15,1,2,1,2,0,0,8,10,2,2,2,4,1,2,1,10
4626,796596,10,1,3,0,1,1,2,0,0,0,2,0,2,0,0,0,3
4626,785297,16,3,6,3,5,0,1,0,0,0,3,1,1,0,1,0,6
4626,785296,12,1,3,1,3,0,0,0,0,2,2,1,1,0,0,1,2
4626,796597,1,0,1,0,0,0,1,0,0,0,0,0,0,0,0,0,0
4627,797574,23,5,9,2,4,3,5,2,2,1,0,0,1,0,0,0,15
4627,797575,22,2,5,2,5,0,0,0,0,4,1,1,3,0,0,0,4
4627,786512,40,4,16,2,8,2,8,2,2,0,4,3,2,1,5,0,12
4627,786435,30,3,6,2,4,1,2,0,2,1,2,1,2,0,1,0,7
4627,786032,30,3,13,3,11,0,2,0,0,1,7,7,5,1,3,1,6
4627,797573,18,2,4,2,4,0,0,0,0,0,4,1,4,1,1,1,4
4627,791903,20,3,7,1,2,2,5,0,0,0,2,0,2,1,0,0,8
4627,786513,17,0,3,0,2,0,1,2,2,4,3,0,1,0,3,0,2
4628,791201,22,5,7,5,7,0,0,2,2,0,3,1,1,1,3,0,12
4628,791202,16,1,4,0,1,1,3,0,0,0,1,2,3,1,0,0,3
4628,775767,23,6,8,6,8,0,0,0,0,4,4,1,2,0,1,1,12
4628,785628,34,9,16,8,13,1,3,0,0,0,5,11,1,1,1,0,19
4628,785627,29,8,10,4,4,4,6,0,0,0,2,1,3,0,2,0,20
4628,796904,6,2,3,2,3,0,0,0,0,0,0,0,0,0,1,0,4
4628,781135,10,2,2,2,2,0,0,0,0,2,2,1,1,0,1,1,4
4628,796903,4,0,0,0,0,0,0,0,0,0,1,0,1,0,0,0,0
4628,796902,9,1,2,1,1,0,1,0,0,0,1,1,0,0,0,1,2
4628,796901,14,0,1,0,0,0,1,0,0,0,1,0,3,3,0,1,0
4628,785629,29,2,5,1,3,1,2,0,0,1,2,1,1,2,1,0,5
4628,781138,1,0,1,0,0,0,1,0,0,0,1,0,0,0,0,0,0
4628,789974,1,0,0,0,0,0,0,1,2,0,0,0,0,0,0,0,1
4628,788869,2,0,0,0,0,0,0,0,0,0,0,0,0,0,0,0,0
4629,792110,23,2,3,1,1,1,2,2,3,0,1,0,1,1,0,0,7
4629,786031,25,5,10,4,7,1,3,2,4,1,1,0,3,1,4,0,13
4629,797734,34,5,11,2,8,3,3,2,2,1,5,5,1,1,5,0,15
4629,797735,31,2,3,2,3,0,0,1,1,2,2,3,1,0,2,0,5
4629,781386,29,7,15,6,9,1,6,1,1,0,2,1,1,0,0,0,16
4629,786033,12,1,2,1,2,0,0,0,0,0,1,0,0,0,1,1,2
4629,797733,13,0,3,0,1,0,2,0,0,0,1,1,1,0,2,0,0
4629,792109,17,0,2,0,1,0,1,0,0,0,1,1,1,0,0,0,0
4629,792105,13,0,0,0,0,0,0,0,0,0,0,1,1,0,0,0,0
4629,792107,3,0,1,0,1,0,0,0,0,0,0,0,0,0,0,0,0
4630,781158,19,1,2,1,2,0,0,0,0,1,1,1,0,1,1,0,2
4630,781652,37,7,16,6,11,1,5,3,4,4,7,4,0,0,4,0,18
4630,786034,22,1,7,1,3,0,4,0,0,0,2,0,1,1,0,0,2
4630,786419,33,5,9,4,7,1,2,2,2,1,2,3,3,0,6,0,13
4630,781283,24,0,7,0,1,0,6,3,4,0,1,0,4,0,0,0,3
4630,781653,17,2,3,2,3,0,0,0,3,3,7,0,3,0,1,0,4
4630,791615,28,2,8,2,5,0,3,5,6,2,2,2,3,1,1,2,9
4630,785277,20,4,9,0,1,4,8,0,0,2,1,1,3,1,2,0,12
4631,792417,33,7,11,7,9,0,2,0,1,3,5,2,5,1,4,1,14
4631,786861,35,2,7,0,1,2,6,2,2,0,5,0,3,0,2,1,8
4631,786867,35,3,6,2,2,1,4,0,1,0,3,2,2,2,1,0,7
4631,780387,40,8,18,8,14,0,4,0,2,3,10,1,4,1,3,1,16
4631,767033,40,4,11,2,7,2,4,6,7,1,2,6,3,5,0,1,16
4631,796870,6,1,2,1,2,0,0,0,0,1,1,0,0,0,0,0,2
4631,792416,11,2,2,1,1,1,1,2,2,0,1,0,1,1,2,0,7
4631,786866,0,0,0,0,0,0,0,0,0,0,0,0,1,0,0,0,0
4632,776462,27,3,6,3,6,0,0,2,2,0,6,0,2,2,0,0,8
4632,785635,22,8,13,5,10,3,3,3,3,4,4,1,3,2,1,2,22
4632,786440,34,4,10,3,7,1,3,1,2,1,2,2,1,0,1,0,10
4632,786720,30,2,4,2,2,0,2,2,2,1,3,0,2,0,1,0,6
4632,781199,35,6,18,6,13,0,5,5,6,0,5,6,3,3,2,0,17
4632,775642,15,3,5,3,3,0,2,0,0,0,1,2,2,3,0,0,6
4632,791628,13,0,1,0,0,0,1,0,0,0,6,2,2,0,0,0,0
4632,796974,14,1,1,1,1,0,0,0,0,0,1,4,0,1,2,0,2
4632,791629,6,0,2,0,0,0,2,0,0,0,0,2,1,0,0,0,0
4632,791626,2,0,0,0,0,0,0,0,0,0,0,0,1,0,0,0,0
4632,796972,2,2,2,2,2,0,0,0,0,0,0,0,0,1,0,0,4
4633,780012,33,4,11,1,4,3,7,0,0,3,6,2,3,0,2,0,11
4633,796309,23,4,5,4,5,0,0,1,3,3,2,1,3,0,5,0,9
4633,790824,33,3,9,3,5,0,4,2,4,1,8,2,3,2,1,1,8
4633,781524,27,6,12,4,7,2,5,0,1,2,1,0,4,0,3,0,14
4633,775667,37,0,6,0,4,0,2,0,0,0,2,10,1,1,3,0,0
4633,774895,14,3,5,3,5,0,0,0,0,1,1,0,1,1,1,0,6
4633,785370,9,0,2,0,2,0,0,0,0,1,0,0,0,0,1,0,0
4633,796382,9,0,3,0,0,0,3,1,2,0,1,1,0,0,2,0,1
4633,796383,6,1,2,1,2,0,0,1,2,0,2,0,0,0,1,0,3
4633,796384,3,1,1,0,0,1,1,0,0,0,1,0,0,0,0,0,3
4633,785367,3,0,0,0,0,0,0,0,0,1,0,0,0,0,0,0,0
4633,783865,3,0,0,0,0,0,0,2,2,0,0,0,0,0,0,0,2
4634,780122,21,3,3,3,3,0,0,1,2,1,2,0,2,0,0,2,7
4634,791461,21,1,3,1,1,0,2,0,0,0,4,1,5,0,1,0,2
4634,791460,27,0,6,0,0,0,6,2,2,0,1,0,0,1,1,1,2
4634,780792,16,1,5,1,3,0,2,0,0,0,0,1,0,0,0,0,2
4634,775598,19,4,8,0,1,4,7,0,0,0,3,1,0,2,0,0,12
4634,786299,23,4,6,4,6,0,0,0,0,1,4,0,1,0,2,0,8
4634,797215,23,3,4,3,3,0,1,2,2,0,2,4,4,1,2,0,8
4634,797214,22,2,5,1,4,1,1,0,0,1,1,1,1,2,3,0,5
4634,786295,23,3,10,2,5,1,5,0,0,1,2,1,0,0,1,0,7
4634,791459,5,0,2,0,1,0,1,0,0,0,0,2,0,0,0,0,0
4635,796347,22,3,6,3,4,0,2,1,2,1,1,1,0,2,0,0,7
4635,785243,25,7,9,6,7,1,2,2,3,2,3,4,0,0,0,0,17
4635,790788,29,3,5,2,2,1,3,0,0,2,3,3,1,0,2,0,7
4635,781028,28,2,11,2,7,0,4,0,2,0,3,1,1,0,0,0,4
4635,781026,25,10,12,6,6,4,6,0,0,0,4,3,0,1,2,0,24
4635,785242,14,1,1,1,1,0,0,0,0,0,4,1,0,0,2,0,2
4635,781027,14,1,2,0,0,1,2,0,0,2,2,0,1,0,0,0,3
4635,796348,18,1,5,1,4,0,1,2,2,0,0,2,0,0,0,0,4
4635,796349,17,3,5,3,3,0,2,0,0,0,3,2,1,2,2,0,6
4635,790787,4,1,1,1,1,0,0,1,1,0,1,0,1,0,0,0,3
4635,797899,1,0,0,0,0,0,0,0,0,0,0,0,1,0,0,0,0
4635,796346,2,0,1,0,1,0,0,0,0,0,0,0,0,0,0,0,0
4635,790786,1,0,0,0,0,0,0,0,0,0,0,0,0,0,0,0,0
4636,796699,23,2,9,2,5,0,4,2,2,3,3,0,3,2,1,1,6
4636,790983,26,3,7,2,4,1,3,0,0,0,1,2,3,1,2,2,7
4636,790979,32,6,14,5,11,1,3,8,8,3,6,1,2,0,2,0,21
4636,796697,34,3,13,3,8,0,5,5,10,0,3,8,0,1,4,0,11
4636,788820,29,2,7,2,3,0,4,0,0,0,1,0,1,0,0,0,4
4636,790980,3,0,0,0,0,0,0,0,0,1,1,0,0,0,1,0,0
4636,796701,22,2,2,2,2,0,0,0,1,4,4,0,3,1,2,0,4
4636,790976,6,0,0,0,0,0,0,0,0,1,1,0,4,0,0,0,0
4636,790978,25,5,8,2,3,3,5,0,0,2,3,0,3,2,1,1,13
4637,797222,11,0,3,0,3,0,0,2,2,0,1,0,0,0,0,2,2
4637,781526,14,3,5,3,5,0,0,0,1,2,3,0,2,1,2,1,6
4637,797217,30,2,6,2,4,0,2,1,2,0,3,3,1,0,2,0,5
4637,797218,27,2,9,1,5,1,4,0,1,0,5,1,2,3,5,0,5
4637,775697,24,5,12,4,8,1,4,0,2,2,1,1,4,2,3,0,11
4637,791846,22,3,4,3,4,0,0,4,4,3,3,0,2,1,3,0,10
4637,797223,21,1,4,1,4,0,0,2,3,1,3,1,4,1,2,1,4
4637,791454,28,4,7,4,6,0,1,0,0,5,1,1,5,2,1,2,8
4637,791453,23,3,7,1,1,2,6,0,1,0,2,0,0,0,0,0,8
4638,791316,34,6,9,6,9,0,0,0,0,2,6,3,2,4,3,1,12
4638,796625,33,6,12,4,5,2,7,0,0,0,3,0,2,2,1,1,14
4638,781079,38,4,11,0,3,4,8,2,4,0,3,6,0,1,6,0,14
4638,785380,21,1,4,1,2,0,2,0,0,3,2,2,0,0,0,1,2
4638,775822,40,4,12,1,6,3,6,4,4,2,2,4,1,0,4,0,15
4638,796626,3,0,0,0,0,0,0,2,2,0,0,0,0,0,0,0,2
4638,780870,25,3,5,3,5,0,0,0,2,3,7,0,4,1,0,0,6
4638,796621,15,2,5,2,2,0,3,0,0,1,1,2,2,0,1,0,4
4638,791314,6,0,2,0,1,0,1,0,1,0,0,0,1,0,0,0,0
4638,785831,10,1,4,1,4,0,0,0,0,2,0,0,0,0,0,0,2
4639,791135,33,5,8,5,7,0,1,1,1,3,2,1,0,1,2,0,11
4639,791132,31,2,6,2,2,0,4,1,2,3,1,1,4,1,0,2,5
4639,786090,40,4,13,2,8,2,5,6,6,0,7,3,2,2,3,0,16
4639,786088,43,3,11,2,8,1,3,2,2,0,4,4,0,4,1,0,9
4639,774921,13,0,3,0,3,0,0,0,0,0,2,2,4,1,2,0,0
4639,791133,12,0,1,0,1,0,0,0,0,0,2,0,2,0,0,0,0
4639,791131,14,0,2,0,1,0,1,0,0,0,3,0,1,0,1,1,0
4639,796790,28,7,13,0,4,7,9,0,0,0,0,2,4,3,5,0,21
4639,786092,11,3,3,3,3,0,0,0,0,1,2,1,0,0,0,0,6
4640,788113,15,2,4,0,0,2,4,4,4,0,0,1,3,0,2,0,10
4640,776497,36,10,18,8,12,2,6,0,0,5,7,1,2,0,2,6,22
4640,785731,35,8,11,7,10,1,1,4,4,4,8,3,3,3,5,1,21
4640,785729,33,3,5,1,3,2,2,0,0,0,2,3,3,1,3,0,8
4640,780864,14,0,2,0,0,0,2,1,3,0,0,1,2,0,0,0,1
4640,799881,6,0,0,0,0,0,0,0,0,0,1,0,1,0,2,1,0
4640,792402,9,0,1,0,0,0,1,0,0,0,1,1,0,0,1,0,0
4640,786231,36,9,16,6,8,3,8,8,11,6,2,2,2,4,1,0,29
4640,785443,14,0,4,0,3,0,1,1,4,1,3,1,2,0,1,0,1
4640,792405,2,0,0,0,0,0,0,0,0,0,0,0,1,0,0,0,0
4641,791161,24,2,4,0,0,2,4,0,0,0,0,0,4,2,2,0,6
4641,780629,29,3,10,3,9,0,1,4,4,1,1,1,2,4,4,1,10
4641,774845,39,2,10,1,6,1,4,5,9,0,0,3,0,1,1,0,10
4641,775888,39,6,13,5,8,1,5,4,8,4,12,5,2,2,3,0,17
4641,796816,27,3,10,2,5,1,5,0,0,3,0,2,3,1,5,0,7
4641,785346,21,4,7,0,0,4,7,0,0,0,0,0,2,0,0,0,12
4641,786690,21,4,8,4,7,0,1,2,2,2,2,1,5,0,4,1,10
4642,790998,38,5,13,3,9,2,4,0,1,2,3,3,3,2,0,0,12
4642,790992,6,0,0,0,0,0,0,0,0,0,1,0,3,0,0,1,0
4642,790997,37,2,10,1,5,1,5,0,0,2,6,1,4,0,0,1,5
4642,790996,29,4,14,3,8,1,6,6,6,0,1,2,4,0,1,0,15
4642,785621,34,7,14,4,6,3,8,3,3,0,2,1,3,0,2,0,20
4642,796631,22,4,9,3,3,1,6,4,5,1,1,0,3,0,1,0,13
4642,796633,11,1,1,1,1,0,0,0,2,5,0,0,0,1,1,0,2
4642,790995,19,4,8,2,4,2,4,1,1,1,0,6,0,1,1,0,11
4642,786375,4,0,0,0,0,0,0,0,0,0,0,0,1,0,2,0,0
4643,791606,37,9,13,8,10,1,3,0,2,2,10,4,3,0,5,4,19
4643,786410,28,4,6,2,3,2,3,0,0,0,3,1,3,0,2,0,10
4643,775095,15,2,3,2,3,0,0,3,4,1,1,0,1,0,2,0,7
4643,786406,32,2,5,1,2,1,3,0,0,0,1,5,1,0,1,0,5
4643,780414,31,6,7,4,5,2,2,12,14,1,4,2,2,4,0,1,26
4643,797020,9,2,3,2,3,0,0,3,4,1,0,0,2,1,0,0,7
4643,797021,8,1,2,1,1,0,1,0,0,1,1,2,2,0,0,0,2
4643,791605,29,6,10,2,4,4,6,0,2,0,9,0,1,0,2,1,16
4643,791603,8,0,0,0,0,0,0,0,2,0,0,2,2,0,1,0,0
4643,791843,3,0,2,0,1,0,1,0,0,0,0,0,0,0,0,0,0
4644,791839,27,2,3,2,3,0,0,1,1,2,6,5,2,1,3,2,5
4644,785322,33,4,9,1,2,3,7,1,2,1,3,0,3,1,3,0,12
4644,792381,34,4,9,0,1,4,8,2,4,0,2,1,2,2,3,0,14
4644,791842,23,1,6,0,1,1,5,0,0,0,2,1,2,0,0,0,3
4644,786616,36,3,8,2,5,1,3,0,0,1,4,2,3,0,2,0,7
4644,797444,12,0,2,0,1,0,1,3,4,0,3,0,3,1,2,0,3
4644,786613,9,1,4,1,3,0,1,2,2,1,2,0,1,0,1,0,4
4644,776341,8,0,0,0,0,0,0,0,0,0,1,0,1,1,1,1,0
4644,786736,18,3,7,2,5,1,2,3,4,0,1,2,1,1,5,0,10
4645,786542,26,0,4,0,4,0,0,4,8,2,6,0,0,0,0,3,4
4645,786540,19,3,6,3,6,0,0,2,2,1,4,1,3,1,3,2,8
4645,792019,24,1,3,0,0,1,3,0,0,0,2,1,3,2,4,0,3
4645,792015,35,8,17,8,15,0,2,4,4,1,4,2,4,7,4,0,20
4645,775995,38,4,9,2,5,2,4,1,1,1,3,2,2,1,3,0,11
4645,785364,25,2,8,2,8,0,0,3,5,4,5,0,1,1,1,0,7
4645,792016,23,3,6,2,3,1,3,1,1,0,3,1,3,0,1,0,8
4645,791845,10,0,2,0,2,0,0,0,0,1,0,0,1,1,1,0,0
4646,792197,18,3,8,0,1,3,7,0,0,0,0,0,4,0,1,0,9
4646,781132,32,9,15,4,5,5,10,1,1,0,1,5,4,2,1,0,24
4646,797517,30,3,8,3,8,0,0,3,4,2,4,1,2,1,2,1,9
4646,791940,30,1,8,1,5,0,3,2,4,1,3,0,0,0,1,0,4
4646,786534,38,8,14,4,4,4,10,3,3,1,4,10,1,2,0,0,23
4646,797521,3,0,0,0,0,0,0,0,0,0,1,0,2,0,1,0,0
4646,791938,19,1,3,0,1,1,2,0,0,0,1,2,0,1,0,0,3
4646,797519,3,0,1,0,0,0,1,0,0,0,0,0,0,0,0,0,0
4646,786539,3,0,1,0,0,0,1,0,0,0,0,0,0,0,0,0,0
4646,797518,23,2,5,1,3,1,2,2,2,1,1,2,3,0,0,0,7
4646,797522,1,0,0,0,0,0,0,0,0,0,0,0,0,0,0,0,0
4647,781558,29,8,10,7,9,1,1,1,2,3,2,2,3,0,1,0,18
4647,780993,17,3,6,3,5,0,1,0,0,1,3,2,2,0,2,0,6
4647,775248,31,9,18,7,8,2,10,2,2,2,6,2,2,1,4,2,22
4647,791452,30,2,5,1,1,1,4,4,4,0,3,6,1,0,3,0,9
4647,797224,37,6,8,2,2,4,6,0,2,1,9,1,2,0,2,0,16
4647,797230,8,0,0,0,0,0,0,2,2,0,1,0,0,0,1,0,2
4647,797225,31,6,10,5,9,1,1,1,3,2,4,4,2,0,1,1,14
4647,791449,13,1,2,1,2,0,0,0,0,2,0,1,0,0,1,0,2
4647,797231,3,0,2,0,0,0,2,0,0,0,0,0,0,0,0,0,0
4647,797229,1,0,0,0,0,0,0,0,0,0,0,0,0,0,0,0,0
4648,780890,27,1,10,1,7,0,3,2,2,2,1,0,4,1,0,1,4
4648,775757,18,3,3,3,3,0,0,5,6,2,1,0,3,0,1,0,11
4648,786066,39,6,16,5,12,1,4,2,3,1,6,2,3,0,3,1,15
4648,780167,34,4,10,3,5,1,5,2,2,0,7,0,5,1,4,0,11
4648,775574,29,6,9,5,7,1,2,0,1,0,3,3,5,0,3,0,13
4648,791123,23,2,5,1,1,1,4,0,0,0,0,1,1,0,2,0,5
4648,785636,30,0,3,0,0,0,3,0,0,0,3,0,2,4,0,0,0
4649,797712,19,1,3,1,3,0,0,4,8,3,4,0,2,0,0,1,6
4649,791964,26,7,9,5,5,2,4,3,4,3,4,2,4,0,2,1,19
4649,786056,29,0,1,0,1,0,0,3,4,2,6,2,2,3,3,1,3
4649,781339,36,3,8,1,1,2,7,2,2,0,1,2,1,1,0,0,10
4649,781337,37,7,19,4,10,3,9,6,6,2,3,5,1,2,2,0,23
4649,797713,6,1,2,1,2,0,0,0,0,0,2,0,1,0,0,1,2
4649,792041,15,3,7,3,6,0,1,0,0,3,2,1,3,1,2,0,6
4649,799737,4,0,1,0,1,0,0,0,0,0,0,0,0,0,0,0,0
4649,797711,23,3,7,1,2,2,5,0,0,0,2,3,1,0,1,0,8
4649,797710,3,0,0,0,0,0,0,0,0,0,0,1,0,0,0,0,0
4649,791963,1,0,0,0,0,0,0,0,0,0,0,0,0,0,0,0,0
4649,797714,1,0,0,0,0,0,0,0,0,0,0,0,0,0,0,0,0
4650,791652,28,2,3,2,3,0,0,6,8,2,8,2,2,2,3,1,10
4650,786495,17,1,1,1,1,0,0,2,4,0,2,0,2,0,1,0,4
4650,797285,30,3,7,0,0,3,7,0,0,0,1,1,0,1,0,0,9
4650,791650,22,4,10,4,9,0,1,4,6,0,2,2,4,1,2,0,12
4650,776384,36,5,11,4,9,1,2,11,15,0,5,3,3,2,4,0,22
4650,791653,24,2,7,1,4,1,3,0,0,0,2,0,2,2,2,0,5
4650,775705,12,0,0,0,0,0,0,0,0,0,1,2,2,0,0,1,0
4650,797286,23,2,6,1,3,1,3,2,3,1,2,0,0,0,1,0,7
4650,797283,8,0,0,0,0,0,0,0,0,0,0,0,1,0,0,0,0
4650,797289,0,0,0,0,0,0,0,0,0,0,0,0,0,0,0,0,0
4651,790784,28,5,12,3,6,2,6,2,2,3,4,2,4,1,2,0,14
4651,786548,21,4,7,4,7,0,0,5,6,3,3,0,5,0,3,2,13
4651,797475,10,1,3,0,0,1,3,0,0,1,0,0,3,0,2,0,3
4651,786229,25,2,3,0,1,2,2,0,0,3,3,1,3,3,0,0,6
4651,775229,36,6,17,4,10,2,7,1,5,2,4,6,1,1,4,0,15
4651,776219,12,1,3,0,0,1,3,0,0,0,4,0,1,1,0,0,3
4651,786235,18,0,1,0,1,0,0,0,0,1,1,0,4,1,0,0,0
4651,791871,5,0,2,0,1,0,1,0,0,0,0,0,1,0,2,0,0
4651,786770,24,2,9,1,2,1,7,2,4,1,3,2,1,0,4,0,7
4651,786719,5,0,1,0,1,0,0,0,0,0,0,1,0,0,1,0,0
4651,781518,16,1,3,0,1,1,2,0,0,1,2,1,2,0,0,0,3
4652,786140,7,1,1,1,1,0,0,1,3,2,0,1,1,0,0,0,3
4652,786578,8,1,3,1,2,0,1,1,2,2,2,0,0,0,0,0,3
4652,797358,35,3,9,1,2,2,7,2,2,0,5,3,4,1,2,1,10
4652,785669,30,5,12,3,6,2,6,0,0,1,3,3,0,0,2,0,12
4652,775195,15,2,2,1,1,1,1,0,0,0,0,2,0,0,0,1,5
4652,786136,15,1,6,1,3,0,3,1,2,2,3,2,3,0,1,0,3
4652,775747,11,4,6,4,4,0,2,0,1,2,3,0,5,0,4,0,8
4652,797357,21,3,5,1,1,2,4,0,0,1,1,1,3,0,2,0,8
4652,785416,33,6,12,6,10,0,2,4,8,2,6,3,3,2,3,0,16
4652,776236,17,1,4,1,2,0,2,0,0,0,3,0,3,0,1,0,2
4652,797359,8,0,0,0,0,0,0,0,0,0,0,0,0,0,0,0,0
4653,785800,26,2,9,1,2,1,7,2,2,2,2,1,1,3,0,0,7
4653,785799,21,2,5,2,5,0,0,2,7,3,4,0,4,1,0,0,6
4653,791676,30,4,11,0,1,4,10,7,7,0,0,4,2,0,4,0,19
4653,780554,29,3,5,2,3,1,2,1,2,2,1,0,2,0,2,0,8
4653,780553,31,8,18,7,16,1,2,3,5,1,6,5,2,1,1,0,20
4653,791678,2,1,1,0,0,1,1,0,0,0,0,0,0,0,0,0,3
4653,785807,12,1,4,1,2,0,2,2,3,2,3,0,1,0,0,0,4
4653,780760,19,3,4,2,2,1,2,2,2,1,3,0,3,1,1,1,9
4653,797427,15,2,4,0,0,2,4,0,0,0,4,1,3,0,0,0,6
4653,791677,12,0,1,0,1,0,0,0,0,1,0,4,0,0,0,0,0
4653,797426,3,0,0,0,0,0,0,0,0,0,0,0,0,0,0,0,0
4654,785664,20,3,5,3,5,0,0,0,0,1,3,0,1,2,0,2,6
4654,785841,26,1,5,1,4,0,1,1,2,1,2,2,1,1,3,0,3
4654,796609,27,2,6,1,3,1,3,2,2,1,2,6,1,5,2,0,7
4654,796611,17,5,8,3,4,2,4,0,0,2,1,0,0,0,0,1,12
4654,792869,23,3,8,0,1,3,7,0,0,0,0,2,0,0,1,0,9
4654,796613,14,1,3,1,2,0,1,0,0,0,4,4,2,1,2,0,2
4654,792232,12,2,4,1,3,1,1,0,0,1,4,0,2,2,0,1,5
4654,791312,10,0,0,0,0,0,0,0,0,0,1,0,1,0,0,0,0
4654,786685,10,0,3,0,2,0,1,0,0,1,1,0,3,0,2,0,0
4654,781504,26,7,13,4,7,3,6,0,0,2,2,1,1,0,3,1,17
4654,766623,15,1,1,1,1,0,0,0,0,0,0,0,1,1,1,0,2
4655,798007,14,2,4,2,4,0,0,2,3,0,0,0,3,0,0,0,6
4655,792266,27,0,5,0,4,0,1,0,0,0,0,2,0,1,2,0,0
4655,786152,40,10,14,9,11,1,3,3,4,3,5,0,1,0,5,3,24
4655,798009,38,5,12,3,4,2,8,0,0,0,4,3,1,2,4,0,12
4655,798006,29,2,4,2,3,0,1,0,0,0,1,3,1,0,2,0,4
4655,798005,26,1,2,1,2,0,0,0,0,0,5,0,3,0,0,1,2
4655,792267,26,3,6,1,2,2,4,0,0,1,1,0,4,2,2,0,8
4656,781244,29,7,12,5,9,2,3,5,5,1,4,3,4,1,1,2,21
4656,791243,15,1,2,1,1,0,1,0,0,0,1,5,3,0,0,0,2
4656,791245,37,5,12,3,6,2,6,0,0,1,1,5,5,1,1,0,12
4656,781243,36,7,11,2,2,5,9,4,6,3,9,1,5,2,0,2,23
4656,776205,34,11,27,2,9,9,18,0,0,1,1,1,4,0,2,0,31
4656,796940,1,0,0,0,0,0,0,0,0,0,0,0,1,0,0,0,0
4656,791241,12,0,4,0,3,0,1,0,0,1,3,0,2,0,1,0,0
4656,791246,8,1,4,0,1,1,3,0,0,0,1,0,2,0,1,0,3
4656,785529,8,0,3,0,2,0,1,0,0,0,0,2,0,0,0,0,0
4656,781237,20,1,2,1,1,0,1,0,1,1,1,1,0,0,1,0,2
4657,775738,16,2,3,2,3,0,0,2,2,0,0,1,2,0,1,1,6
4657,786091,39,4,7,4,5,0,2,4,4,1,8,0,1,1,1,0,12
4657,786728,27,7,11,7,11,0,0,7,9,0,2,2,3,1,2,1,21
4657,785904,36,7,13,4,8,3,5,10,10,0,4,1,2,0,3,0,27
4657,780892,35,4,8,2,5,2,3,2,3,0,8,3,2,1,0,0,12
4657,797669,8,0,3,0,2,0,1,1,2,0,1,0,0,0,0,0,1
4657,797666,3,0,0,0,0,0,0,0,0,0,1,0,0,0,0,0,0
4657,786788,4,0,0,0,0,0,0,0,0,0,1,0,0,0,0,0,0
4657,786096,18,1,4,1,4,0,0,4,4,2,3,0,2,0,1,0,6
4657,781030,14,7,8,7,7,0,1,0,0,0,4,0,1,0,0,0,14
4658,785999,34,11,13,11,13,0,0,5,10,7,7,0,1,0,1,3,27
4658,775654,34,5,5,5,5,0,0,1,2,3,6,1,3,1,0,3,11
4658,775171,20,1,4,1,2,0,2,1,2,0,0,2,0,2,1,0,3
4658,791639,35,5,13,4,12,1,1,2,2,0,6,3,2,0,5,0,13
4658,785389,32,4,15,4,12,0,3,3,4,0,4,3,2,2,4,0,11
4658,791640,4,0,0,0,0,0,0,0,0,0,0,0,3,0,2,0,0
4658,796399,26,2,6,2,5,0,1,1,2,1,5,4,4,1,2,0,5
4658,796398,15,1,4,1,3,0,1,0,2,2,2,1,0,0,0,0,2
4659,785368,33,7,13,7,13,0,0,2,3,2,5,2,3,0,3,6,16
4659,780281,16,2,4,2,2,0,2,0,0,0,3,0,4,0,1,0,4
4659,790793,37,6,17,5,12,1,5,1,2,0,2,6,4,3,4,0,14
4659,785246,39,3,10,1,4,2,6,0,0,1,1,1,1,2,0,0,8
4659,780886,37,4,7,3,4,1,3,11,11,0,2,2,2,0,2,0,20
4659,796351,4,0,2,0,2,0,0,0,0,0,1,0,0,0,0,0,0
4659,790794,8,2,3,2,3,0,0,0,0,2,1,0,3,0,1,1,4
4659,796350,16,1,4,0,1,1,3,0,0,1,1,0,0,0,0,0,3
4659,790789,8,0,1,0,1,0,0,0,0,0,0,0,0,0,0,0,0
4659,790790,2,0,0,0,0,0,0,0,0,0,0,0,0,0,0,0,0
4660,785423,33,7,10,5,7,2,3,0,4,1,5,0,1,0,1,0,16
4660,775676,28,6,9,6,9,0,0,0,0,2,9,1,1,0,1,2,12
4660,786210,29,1,6,0,1,1,5,2,2,1,2,3,1,0,2,0,5
4660,785425,31,8,14,3,5,5,9,0,2,0,3,1,4,0,0,0,21
4660,785422,39,5,12,2,5,3,7,0,0,0,5,10,2,3,2,0,13
4660,786298,28,3,11,1,6,2,5,2,2,1,4,3,1,2,1,0,10
4660,774957,12,1,3,0,1,1,2,0,0,1,2,3,2,0,0,0,3
4661,790771,33,4,7,3,3,1,4,1,2,1,8,2,1,0,0,3,10
4661,780271,39,5,7,3,4,2,3,4,5,2,11,2,1,0,1,4,16
4661,790772,30,6,12,5,7,1,5,1,1,0,4,0,2,1,3,0,14
4661,796328,33,2,8,2,6,0,2,2,2,2,4,3,0,2,1,0,6
4661,780375,24,2,9,1,5,1,4,0,0,0,0,2,2,2,1,0,5
4661,780218,8,1,4,1,4,0,0,0,0,0,2,0,0,0,0,0,2
4661,785230,28,5,11,2,2,3,9,1,2,0,1,3,2,0,1,0,14
4661,790774,5,1,2,0,0,1,2,0,0,0,0,0,0,0,1,0,3
4662,792473,17,2,7,1,4,1,3,0,0,0,2,1,2,0,1,1,5
4662,780043,35,5,10,4,5,1,5,2,3,1,1,3,2,2,3,1,13
4662,799276,39,1,5,0,3,1,2,0,0,1,5,6,3,2,1,0,3
4662,785249,40,6,11,5,7,1,4,2,4,0,3,2,2,2,1,0,15
4662,780035,36,8,10,4,5,4,5,1,2,1,2,2,1,0,0,1,21
4662,785251,1,0,1,0,1,0,0,0,0,0,0,0,0,0,0,0,0
4662,792477,4,0,0,0,0,0,0,0,0,0,0,0,0,1,0,0,0
4662,780036,28,6,9,6,8,0,1,3,4,1,5,1,0,4,1,0,15
4663,780844,27,2,6,2,3,0,3,0,0,3,6,1,2,0,0,1,4
4663,797699,36,5,11,3,5,2,6,3,6,0,1,5,0,1,5,0,15
4663,791954,22,3,7,2,3,1,4,1,2,3,4,0,0,1,1,0,8
4663,791956,27,2,5,0,0,2,5,0,0,0,3,1,3,0,2,0,6
4663,780846,38,7,10,7,10,0,0,0,3,2,5,4,3,0,3,1,14
4663,797698,6,0,0,0,0,0,0,0,0,0,2,0,1,0,0,0,0
4663,797694,20,3,5,0,0,3,5,0,0,0,2,1,1,0,2,0,9
4663,797692,24,5,7,3,3,2,4,1,1,0,1,1,4,0,2,0,13
4664,776279,5,2,4,0,0,2,4,0,0,0,1,1,1,0,0,0,6
4664,781505,22,3,10,3,6,0,4,2,4,2,3,0,3,1,2,0,8
4664,780353,21,5,7,5,7,0,0,2,2,3,7,1,0,1,0,1,12
4664,791317,19,3,8,3,4,0,4,0,0,1,2,7,0,2,1,0,6
4664,777573,12,2,6,2,3,0,3,0,0,0,1,1,0,0,2,0,4
4664,791318,12,2,2,2,2,0,0,0,1,1,1,1,0,0,1,1,4
4664,791319,6,0,1,0,0,0,1,0,0,1,2,0,0,0,0,0,0
4664,788965,4,1,3,1,1,0,2,0,2,0,0,0,0,0,0,0,2
4664,786222,13,4,5,4,5,0,0,0,0,2,1,0,1,2,3,0,8
4664,796646,22,6,8,3,3,3,5,0,0,2,8,3,3,2,2,0,15
4664,796647,12,4,7,2,2,2,5,0,0,0,0,3,1,1,1,0,10
4664,796649,21,4,6,3,4,1,2,0,0,0,4,2,0,1,0,0,9
4664,790851,18,3,5,3,5,0,0,2,2,3,1,1,2,3,1,0,8
4664,796648,13,2,3,0,0,2,3,0,0,0,0,4,2,1,0,0,6
4666,783072,15,6,8,6,7,0,1,0,0,2,5,0,0,1,1,1,12
4666,774879,16,4,6,1,2,3,4,2,2,0,4,2,0,0,0,1,13
4666,791540,19,2,3,0,0,2,3,0,0,0,4,5,1,0,3,0,6
4666,787782,18,3,5,0,1,3,4,0,0,0,1,3,1,0,0,0,9
4666,776068,17,3,7,3,4,0,3,2,2,0,4,4,0,1,1,0,8
4666,797817,13,3,5,2,4,1,1,2,2,0,2,3,0,3,0,0,9
4666,793214,5,1,1,0,0,1,1,0,0,0,0,0,0,1,0,0,3
4666,792151,5,1,3,1,2,0,1,0,0,1,1,0,0,1,1,0,2
4666,785647,9,3,4,2,3,1,1,0,0,0,4,0,0,0,0,0,7
4666,785962,14,3,3,3,3,0,0,1,2,1,5,1,0,0,2,0,7
4666,781463,10,5,7,1,1,4,6,0,0,0,4,1,1,1,1,0,14
4666,797818,6,3,4,1,2,2,2,0,0,0,0,3,0,0,1,0,8
4666,793057,21,6,8,2,4,4,4,1,2,0,2,5,2,1,0,0,17
4666,792153,17,3,3,2,2,1,1,0,0,0,3,6,0,1,1,0,7
4666,781202,15,1,2,1,1,0,1,0,0,0,1,4,2,1,1,0,2
4668,791194,28,8,14,5,8,3,6,1,1,2,4,1,3,1,1,1,20
4668,780384,19,2,3,2,3,0,0,7,10,3,6,0,1,0,3,1,11
4668,780159,25,2,8,1,6,1,2,2,2,2,8,2,2,4,0,0,7
4668,786738,25,3,9,2,5,1,4,0,0,0,1,3,3,1,3,0,7
4668,774827,28,5,10,3,7,2,3,2,2,0,3,5,2,1,2,0,14
4668,796863,19,0,2,0,1,0,1,0,0,0,0,3,1,0,2,0,0
4668,791193,21,2,5,2,5,0,0,0,1,1,3,0,1,2,3,0,4
4668,796865,16,3,6,1,1,2,5,0,0,0,2,0,2,0,0,1,8
4668,775694,13,1,4,1,3,0,1,2,3,1,1,1,3,0,0,0,4
4668,799890,4,1,1,1,1,0,0,0,0,0,0,0,1,0,0,0,2
4668,791189,1,0,0,0,0,0,0,0,0,0,0,0,0,0,0,0,0
4668,796866,1,0,0,0,0,0,0,0,0,0,0,0,0,0,0,0,0
4669,792373,31,2,8,2,8,0,0,2,2,3,0,2,4,2,1,1,6
4669,781598,12,1,3,1,1,0,2,0,2,0,2,0,3,0,5,1,2
4669,792370,34,3,9,3,6,0,3,1,2,0,1,2,2,2,5,2,7
4669,786739,34,2,4,2,4,0,0,5,6,0,6,3,2,0,0,0,9
4669,775303,25,3,12,2,8,1,4,5,5,1,6,1,0,0,4,0,12
4669,797958,11,1,2,0,0,1,2,0,0,0,0,1,1,0,0,0,3
4669,797951,18,3,5,3,3,0,2,0,0,0,2,1,0,0,0,0,6
4669,797960,13,2,3,1,2,1,1,0,0,0,2,0,2,0,0,0,5
4669,790499,20,1,7,1,6,0,1,6,6,2,5,0,2,3,1,0,8
4669,781597,2,0,0,0,0,0,0,0,0,0,0,0,0,0,0,0,0
4670,791883,27,4,8,3,4,1,4,0,0,1,5,1,2,0,1,2,9
4670,781066,29,5,7,5,7,0,0,3,4,0,3,4,3,0,2,2,13
4670,797594,19,0,2,0,1,0,1,0,0,0,0,0,0,1,2,0,0
4670,791884,28,3,9,3,8,0,1,7,7,0,2,5,1,0,1,0,13
4670,780695,33,4,8,2,3,2,5,0,2,0,7,1,2,2,0,0,10
4670,797600,10,3,4,2,3,1,1,0,0,1,4,0,0,1,0,0,7
4670,797598,5,0,1,0,1,0,0,0,0,0,1,0,0,0,0,0,0
4670,797596,24,3,4,0,1,3,3,2,2,1,1,1,1,0,1,0,11
4670,786496,25,3,4,2,3,1,1,4,5,1,2,1,4,1,1,1,11
4671,780095,27,1,4,1,4,0,0,0,1,5,3,1,1,0,1,2,2
4671,776321,37,7,16,7,14,0,2,3,4,2,3,1,4,1,1,1,17
4671,786081,28,3,7,1,3,2,4,0,0,1,4,0,1,1,1,0,8
4671,785431,32,1,7,0,3,1,4,0,0,1,3,3,4,0,2,0,3
4671,780232,40,2,11,0,4,2,7,8,10,0,4,3,5,0,2,0,14
4671,785356,13,2,3,1,1,1,2,1,2,0,0,2,0,0,0,0,6
4671,789040,23,5,8,2,3,3,5,2,2,0,1,1,1,0,1,0,15
4672,785775,28,4,5,3,4,1,1,2,2,1,4,3,3,0,5,2,11
4672,781335,34,0,8,0,3,0,5,0,0,0,4,6,1,2,2,1,0
4672,776351,35,6,9,4,4,2,5,0,0,4,5,2,3,1,0,1,14
4672,785770,37,11,19,9,11,2,8,8,9,2,3,2,2,1,4,0,32
4672,781341,31,6,9,3,3,3,6,0,0,0,5,1,3,1,2,0,15
4672,796542,14,1,2,1,2,0,0,1,2,1,1,1,1,0,1,0,3
4672,796538,8,1,1,1,1,0,0,0,0,0,0,0,1,0,1,0,2
4672,791283,11,0,3,0,2,0,1,1,2,2,1,1,1,1,1,0,1
4672,785767,2,0,0,0,0,0,0,0,0,0,0,0,0,0,0,0,0
4673,791220,23,5,7,4,5,1,2,2,2,1,3,2,3,1,2,0,13
4673,791219,33,4,13,3,7,1,6,2,2,2,5,0,2,2,3,0,11
4673,776217,36,0,2,0,2,0,0,1,4,6,2,1,1,1,1,1,1
4673,790818,34,6,11,6,8,0,3,1,3,1,2,5,2,0,3,0,13
4673,786396,35,5,10,5,7,0,3,3,4,1,1,2,3,2,3,0,13
4673,786824,20,5,9,3,4,2,5,0,0,0,3,1,0,1,2,0,12
4673,791221,2,0,1,0,0,0,1,0,0,1,0,0,1,0,0,0,0
4673,796923,7,0,1,0,1,0,0,0,0,0,1,1,1,0,0,0,0
4673,796920,10,1,3,1,3,0,0,1,3,1,0,0,0,1,1,0,3
4674,797235,23,3,6,3,6,0,0,5,6,1,5,0,4,0,3,2,11
4674,791368,18,0,1,0,0,0,1,0,0,0,3,0,4,1,1,1,0
4674,797232,28,3,8,2,4,1,4,3,3,0,4,1,3,0,2,0,10
4674,797237,19,3,4,3,3,0,1,2,2,0,1,3,3,1,2,0,8
4674,797239,29,2,7,2,4,0,3,4,6,0,2,0,4,1,4,0,8
4674,797233,11,3,5,2,3,1,2,3,5,1,1,1,1,0,0,0,10
4674,797238,7,0,2,0,1,0,1,0,0,0,0,0,0,0,0,0,0
4674,786535,6,0,1,0,1,0,0,0,0,0,2,0,2,0,3,0,0
4674,785446,16,1,3,1,3,0,0,0,0,1,2,2,2,0,0,0,2
4674,791367,21,3,9,2,8,1,1,2,2,0,4,1,2,0,2,0,9
4674,797234,22,2,3,0,1,2,2,0,0,1,5,1,2,0,3,0,6
4675,791787,31,4,12,4,9,0,3,7,9,0,8,0,4,1,2,1,15
4675,789048,25,1,4,1,4,0,0,2,3,0,4,0,4,2,2,0,4
4675,789046,31,2,7,0,3,2,4,6,6,1,0,1,4,1,1,2,12
4675,791786,9,0,3,0,3,0,0,0,0,0,2,1,2,0,0,0,0
4675,789041,31,8,16,6,10,2,6,3,4,1,2,3,2,1,2,0,21
4675,791785,15,1,2,1,1,0,1,0,0,1,0,0,1,0,1,1,2
4675,785540,17,1,4,1,4,0,0,4,6,2,5,0,1,0,0,1,6
4675,797630,28,2,6,1,3,1,3,1,2,0,0,0,4,1,3,0,6
4675,797629,11,0,3,0,3,0,0,0,1,1,2,0,3,0,1,2,0
4675,789044,2,0,0,0,0,0,0,0,0,0,0,0,0,0,0,0,0
4676,797367,19,0,2,0,2,0,0,2,4,2,4,3,3,2,0,1,2
4676,797369,32,1,5,1,2,0,3,7,9,1,4,9,3,2,2,0,9
4676,797366,22,2,2,2,2,0,0,0,0,2,2,1,4,0,2,1,4
4676,791807,38,8,15,4,8,4,7,0,0,0,1,1,2,1,1,1,20
4676,786130,32,11,18,5,9,6,9,5,8,4,5,1,2,3,4,1,33
4676,797364,18,3,6,2,4,1,2,1,2,4,0,0,1,1,0,0,8
4676,797365,8,0,0,0,0,0,0,0,0,0,1,0,1,0,2,0,0
4676,797363,18,3,9,2,5,1,4,2,2,0,0,1,0,0,5,0,9
4676,791808,13,1,3,1,2,0,1,0,0,1,1,0,1,0,0,0,2
4677,791440,17,1,2,1,2,0,0,0,0,3,1,0,5,0,2,0,2
4677,797013,26,3,9,2,4,1,5,1,2,1,2,4,3,3,1,1,8
4677,791441,19,1,7,0,2,1,5,0,1,1,1,4,3,1,3,0,3
4677,781378,20,7,9,4,6,3,3,0,0,1,2,1,2,1,3,1,17
4677,775267,27,2,8,1,2,1,6,2,2,0,6,2,2,0,1,1,7
4677,791443,24,6,10,4,6,2,4,2,2,3,2,0,2,1,1,0,16
4677,775739,17,5,6,5,6,0,0,1,2,2,1,0,2,0,2,0,11
4677,797019,16,0,2,0,1,0,1,0,1,0,0,4,2,1,1,0,0
4677,797016,15,1,6,0,2,1,4,3,3,0,2,1,3,2,2,0,6
4677,774959,13,0,0,0,0,0,0,2,2,0,2,3,0,1,0,0,2
4677,781629,6,3,3,3,3,0,0,2,2,1,0,0,0,0,0,0,8
4678,790494,15,0,1,0,1,0,0,0,0,1,1,1,1,0,0,0,0
4678,788866,15,2,4,2,4,0,0,1,2,1,3,0,4,1,0,0,5
4678,781005,31,5,10,2,3,3,7,2,4,0,4,1,0,0,4,1,15
4678,782162,28,5,9,3,6,2,3,8,8,0,0,3,2,2,2,0,20
4678,796851,32,5,11,1,3,4,8,0,0,1,1,5,4,0,2,0,14
4678,781659,15,2,6,2,4,0,2,2,2,1,0,2,2,0,1,0,6
4678,796853,2,0,0,0,0,0,0,0,0,0,1,0,0,0,0,0,0
4678,796854,25,3,4,2,3,1,1,0,0,0,3,2,1,0,0,0,7
4678,792683,15,1,1,1,1,0,0,1,2,1,2,1,2,1,2,0,3
4678,780610,19,2,9,0,1,2,8,0,0,0,1,1,2,0,1,0,6
4678,781411,3,0,0,0,0,0,0,0,0,0,0,0,0,0,0,0,0
4679,791781,7,1,4,1,4,0,0,0,0,1,0,0,0,0,0,0,2
4679,791780,27,6,8,1,2,5,6,4,4,3,3,4,2,1,0,0,21
4679,791777,32,5,9,4,7,1,2,4,8,2,2,8,2,0,4,0,15
4679,781025,36,2,7,2,5,0,2,1,2,2,5,4,2,4,4,0,5
4679,786474,24,4,7,0,1,4,6,3,4,0,2,3,2,0,0,0,15
4679,791778,12,2,2,2,2,0,0,1,2,0,3,0,4,0,1,0,5
4679,786476,20,3,3,3,3,0,0,1,3,0,3,0,2,0,2,3,7
4679,791776,6,1,1,0,0,1,1,0,0,0,1,0,1,1,0,0,3
4679,791829,14,2,6,1,3,1,3,0,0,0,2,1,0,1,3,0,5
4679,780488,13,3,5,2,2,1,3,0,0,0,0,0,2,1,0,0,7
4679,775503,9,1,1,1,1,0,0,0,0,0,2,0,1,0,1,0,2
4680,780494,18,4,10,3,8,1,2,0,0,1,1,1,4,2,1,0,9
4680,797276,17,3,7,1,5,2,2,0,0,1,3,1,0,4,1,2,8
4680,780497,25,1,9,1,9,0,0,0,2,2,4,1,2,1,0,1,2
4680,780496,23,3,4,2,2,1,2,6,6,0,5,0,2,1,1,2,13
4680,780495,27,2,11,1,8,1,3,3,6,0,3,4,0,2,0,2,8
4680,797277,3,0,0,0,0,0,0,0,0,0,1,0,2,0,0,0,0
4680,797274,7,3,6,3,6,0,0,0,0,4,2,1,0,0,1,0,6
4680,791645,4,0,2,0,2,0,0,0,0,1,1,0,0,0,0,0,0
4680,785693,12,2,5,2,5,0,0,0,0,2,1,0,0,0,1,2,4
4680,797275,5,0,0,0,0,0,0,0,0,0,0,1,1,0,0,0,0
4680,791643,17,3,6,2,4,1,2,0,0,1,1,1,1,0,0,0,7
4680,785692,23,3,6,3,6,0,0,2,2,1,1,1,2,2,0,0,8
4680,785644,19,2,6,1,2,1,4,0,1,0,3,2,2,0,2,0,5
4681,780377,35,5,13,1,4,4,9,5,5,0,8,1,2,0,0,0,19
4681,791852,27,2,3,2,3,0,0,6,7,1,6,0,1,1,1,2,10
4681,797460,21,1,7,1,6,0,1,0,0,2,3,0,2,0,1,0,2
4681,786601,12,1,3,0,0,1,3,3,3,0,1,0,2,0,1,0,6
4681,786600,25,4,7,4,7,0,0,2,5,1,5,3,2,1,6,0,10
4681,791851,11,1,6,1,3,0,3,0,0,1,1,1,0,0,1,0,2
4681,791853,10,1,2,1,2,0,0,0,0,1,1,0,3,0,0,1,2
4681,797461,20,4,11,3,9,1,2,1,1,1,1,0,1,0,1,1,10
4681,797459,13,0,2,0,2,0,0,0,0,0,2,0,1,0,2,0,0
4681,786602,7,0,1,0,1,0,0,0,0,0,1,0,0,0,1,0,0
4681,786599,19,1,5,1,3,0,2,0,0,2,2,0,3,0,1,1,2
4682,797662,26,2,4,2,2,0,2,0,0,0,3,1,4,2,1,0,4
4682,786067,36,7,13,7,13,0,0,4,8,2,6,2,2,1,2,1,18
4682,797661,27,2,8,2,6,0,2,4,4,1,8,1,2,2,7,1,8
4682,785591,26,6,11,6,10,0,1,6,6,0,2,3,4,2,1,0,18
4682,780258,30,3,6,0,1,3,5,3,4,0,6,3,4,0,5,0,12
4682,792082,18,0,2,0,1,0,1,0,0,0,2,1,1,0,3,0,0
4682,792078,18,1,1,1,1,0,0,0,2,0,2,0,1,0,0,0,2
4682,797660,6,0,2,0,2,0,0,0,0,0,0,1,2,0,0,0,0
4682,792083,13,1,1,1,1,0,0,0,0,0,0,0,0,0,1,0,2
4683,796979,27,4,7,2,2,2,5,0,1,1,4,0,4,1,2,0,10
4683,776200,34,5,9,5,9,0,0,0,1,1,4,0,1,3,3,0,10
4683,780925,33,4,8,2,3,2,5,4,5,1,5,0,4,1,2,0,14
4683,780446,36,2,8,2,5,0,3,4,6,1,2,3,1,1,3,0,8
4683,781034,36,2,17,2,9,0,8,3,4,1,2,2,3,4,0,0,7
4683,796980,6,1,2,1,2,0,0,0,0,1,1,0,4,0,2,0,2
4683,791625,9,0,1,0,1,0,0,0,0,0,0,0,2,1,0,0,0
4683,791622,4,0,0,0,0,0,0,0,0,0,2,0,0,0,0,0,0
4683,791624,11,3,4,1,1,2,3,0,0,0,2,0,2,0,2,0,8
4683,791637,4,0,2,0,0,0,2,0,0,0,0,0,0,0,0,0,0
4684,791493,36,3,6,3,6,0,0,4,6,3,7,1,2,0,1,1,10
4684,789036,36,4,8,4,8,0,0,3,5,2,1,0,5,1,5,2,11
4684,797191,24,2,4,1,2,1,2,0,0,0,3,4,1,0,3,0,5
4684,791495,17,0,3,0,2,0,1,0,0,1,0,0,1,0,0,0,0
4684,776494,40,6,11,2,5,4,6,4,4,2,2,1,1,1,2,0,20
4684,780504,4,0,0,0,0,0,0,0,0,0,0,0,0,1,0,0,0
4684,791492,20,2,4,2,2,0,2,2,2,0,1,3,0,0,2,0,6
4684,791494,5,0,0,0,0,0,0,0,0,0,0,0,2,0,0,0,0
4684,778888,18,2,4,2,2,0,2,0,0,0,2,2,2,0,0,0,4
4685,792227,26,1,4,1,3,0,1,5,5,1,2,2,2,0,0,2,7
4685,781352,15,4,5,4,5,0,0,1,3,1,0,2,3,0,1,1,9
4685,792223,39,9,11,4,5,5,6,0,0,1,6,1,4,1,2,0,23
4685,785935,38,4,10,3,7,1,3,1,2,0,2,1,1,1,2,0,10
4685,781340,39,5,10,5,10,0,0,1,3,3,3,1,1,3,2,0,11
4685,797881,11,0,2,0,2,0,0,0,0,0,2,1,2,0,0,0,0
4685,797889,13,1,1,1,1,0,0,3,4,0,0,0,4,0,2,0,5
4685,781351,15,1,4,1,4,0,0,0,0,1,0,0,1,0,0,0,2
4685,797882,2,0,0,0,0,0,0,0,0,0,0,0,0,0,1,0,0
4685,786453,2,0,0,0,0,0,0,0,0,0,0,0,0,0,1,0,0
4686,797766,14,2,3,2,2,0,1,0,0,1,1,1,0,0,2,1,4
4686,797767,26,3,5,2,4,1,1,0,0,1,1,5,1,3,1,0,7
4686,791372,31,1,8,0,1,1,7,2,2,0,2,2,3,2,1,0,5
4686,792164,36,8,18,4,12,4,6,0,1,2,6,1,2,1,1,0,20
4686,780974,37,3,19,2,13,1,6,0,0,2,4,2,0,1,0,1,7
4686,797772,24,2,5,2,4,0,1,1,2,0,2,0,0,0,1,1,5
4686,792163,26,3,6,1,2,2,4,0,0,2,2,0,1,0,0,0,8
4686,797764,6,1,3,1,2,0,1,0,0,3,0,0,1,0,0,0,2
4687,791482,29,5,7,4,6,1,1,0,1,2,3,3,0,0,2,0,11
4687,786319,18,3,6,3,6,0,0,2,2,2,7,3,0,0,2,1,8
4687,786318,32,2,5,2,3,0,2,0,0,1,10,3,2,1,0,0,4
4687,784268,34,4,8,3,4,1,4,3,4,0,4,4,0,0,1,0,12
4687,780223,32,5,11,4,5,1,6,0,0,1,3,0,4,0,3,2,11
4687,797198,5,1,4,1,4,0,0,0,0,2,0,0,0,0,0,0,2
4687,791481,7,2,3,2,3,0,0,0,0,0,1,0,0,0,1,0,4
4687,780225,21,4,7,1,1,3,6,0,0,0,2,1,0,0,0,1,11
4687,797199,16,2,4,1,2,1,2,0,0,0,0,3,2,0,1,1,5
4687,797201,6,0,0,0,0,0,0,0,0,0,0,0,1,0,1,0,0
4688,796455,38,2,5,2,5,0,0,1,1,5,5,1,2,1,2,2,5
4688,790907,25,3,4,3,4,0,0,2,3,2,2,0,3,0,4,3,8
4688,790909,27,5,14,3,5,2,9,0,0,0,5,1,4,3,1,0,12
4688,781393,40,10,19,6,10,4,9,3,3,0,3,7,4,2,4,0,27
4688,775351,36,4,9,4,9,0,0,0,0,2,4,0,1,0,2,2,8
4688,787175,26,5,8,0,2,5,6,0,0,0,6,1,3,0,1,0,15
4688,782126,8,1,1,1,1,0,0,0,0,0,0,0,0,0,0,0,2
4689,780832,29,1,5,1,5,0,0,4,4,2,4,0,3,0,1,1,6
4689,790961,31,1,2,1,2,0,0,0,0,2,2,0,1,1,0,1,2
4689,786240,14,0,3,0,1,0,2,0,0,0,0,2,0,0,1,0,0
4689,785278,38,7,14,2,4,5,10,9,9,0,5,3,3,4,1,0,28
4689,780146,29,4,10,0,1,4,9,5,6,0,4,6,1,1,3,0,17
4689,796556,9,1,3,1,3,0,0,0,0,0,0,0,0,0,0,1,2
4689,796554,11,1,1,1,1,0,0,1,1,2,1,1,1,0,1,2,3
4689,796555,10,4,7,1,2,3,5,0,0,0,1,0,0,0,0,0,11
4689,775860,29,4,11,0,1,4,10,2,2,0,3,5,1,0,1,0,14
4690,797895,23,4,10,4,10,0,0,2,3,5,5,0,4,2,3,0,10
4690,789058,20,2,9,0,4,2,5,0,0,1,4,1,3,0,0,0,6
4690,797898,29,3,11,2,6,1,5,3,4,1,3,4,0,3,2,0,10
4690,792240,25,2,5,2,3,0,2,0,0,2,2,1,3,0,0,0,4
4690,792237,20,1,9,1,6,0,3,2,2,0,3,2,0,1,1,0,4
4690,787239,15,1,1,1,1,0,0,0,0,2,0,0,2,0,1,5,2
4690,785818,18,2,7,2,3,0,4,4,4,1,2,1,4,0,0,0,8
4690,785286,27,2,7,2,6,0,1,0,0,0,1,1,1,0,3,0,4
4690,797897,6,0,4,0,1,0,3,0,0,0,3,0,0,0,0,0,0
4690,792359,14,1,5,0,1,1,4,0,0,0,1,0,1,1,0,0,3
4690,785986,3,0,0,0,0,0,0,0,0,0,0,0,0,0,0,0,0
4691,792334,28,2,8,1,7,1,1,2,2,2,8,1,3,2,2,0,7
4691,786575,28,2,4,2,4,0,0,0,0,4,5,2,2,0,0,2,4
4691,798094,15,0,2,0,1,0,1,0,0,0,1,3,0,1,0,0,0
4691,792338,36,8,11,3,6,5,5,4,7,3,13,2,2,4,2,1,25
4691,781666,32,7,17,5,11,2,6,0,0,1,3,3,0,1,6,0,16
4691,798097,14,1,3,1,3,0,0,4,6,1,5,1,2,0,1,0,6
4691,792336,1,0,0,0,0,0,0,0,0,0,0,0,0,0,0,0,0
4691,785531,9,2,3,1,2,1,1,0,0,1,1,1,1,0,2,0,5
4691,798095,2,0,0,0,0,0,0,0,0,0,0,0,0,0,0,0,0
4691,798100,1,0,0,0,0,0,0,0,0,0,1,0,0,0,0,0,0
4691,799842,25,2,4,2,4,0,0,1,3,0,1,3,3,0,3,0,5
4691,791636,9,0,6,0,5,0,1,0,0,0,0,0,1,0,0,0,0
4692,791352,10,1,2,0,1,1,1,0,0,1,0,0,4,0,0,0,3
4692,780455,17,3,7,3,7,0,0,0,0,1,4,0,2,0,1,1,6
4692,797251,22,3,6,2,3,1,3,0,0,2,2,4,1,0,0,1,7
4692,797247,38,3,8,3,6,0,2,1,2,0,6,7,3,1,2,0,7
4692,776297,37,8,13,7,8,1,5,1,4,1,8,10,1,0,4,0,18
4692,791354,9,0,2,0,2,0,0,0,0,1,0,1,2,1,1,0,0
4692,785837,19,8,11,4,5,4,6,0,0,2,2,1,4,0,1,3,20
4692,797248,28,3,9,0,2,3,7,0,0,1,2,2,1,0,1,0,9
4692,791355,20,8,11,3,3,5,8,0,0,0,0,0,1,0,0,0,21
4692,797249,0,0,0,0,0,0,0,0,0,0,0,0,0,0,0,0,0
4692,797255,0,0,0,0,0,0,0,0,0,0,0,0,0,0,0,0,0
4693,785305,13,1,3,1,1,0,2,0,0,1,2,0,1,0,1,0,2
4693,785123,30,6,8,6,7,0,1,6,6,0,10,4,1,0,1,1,18
4693,790990,38,7,13,2,4,5,9,3,4,1,3,1,1,0,2,0,22
4693,789219,36,6,15,2,4,4,11,2,3,1,0,8,2,0,0,0,18
4693,785059,31,4,7,3,4,1,3,1,2,1,5,6,0,1,2,1,10
4693,782133,17,2,6,1,2,1,4,0,0,1,0,1,1,0,1,0,5
4693,796622,8,1,5,1,5,0,0,3,4,4,0,0,0,0,0,0,5
4693,796623,20,4,6,2,3,2,3,5,5,0,3,0,1,1,1,0,15
4693,790988,2,0,1,0,1,0,0,0,0,0,2,0,0,0,0,0,0
4693,785122,5,1,1,0,0,1,1,0,0,0,0,0,2,0,0,0,3
4694,791988,35,2,7,2,7,0,0,4,6,2,2,2,5,1,2,0,8
4694,792443,16,5,7,5,7,0,0,2,3,2,5,0,2,0,1,2,12
4694,796507,31,4,13,1,4,3,9,0,0,1,6,1,2,1,2,0,11
4694,796503,23,0,7,0,3,0,4,7,8,1,1,2,3,0,1,0,7
4694,791989,37,5,10,5,6,0,4,3,5,1,4,2,2,3,1,0,13
4694,796509,17,5,7,4,4,1,3,0,3,1,3,1,5,0,0,1,11
4694,780077,3,0,0,0,0,0,0,0,0,0,1,0,1,0,0,0,0
4694,796506,2,0,0,0,0,0,0,0,0,0,0,0,1,0,0,0,0
4694,796508,11,0,2,0,0,0,2,0,0,1,2,0,2,0,2,0,0
4694,791987,23,0,3,0,2,0,1,8,8,0,3,1,2,0,2,0,8
4694,785258,2,0,0,0,0,0,0,0,0,0,2,0,1,0,2,0,0
4695,792318,19,5,12,5,12,0,0,4,7,8,3,1,4,1,5,0,14
4695,796519,20,0,3,0,2,0,1,0,0,0,2,2,1,1,0,0,0
4695,786717,32,5,15,5,10,0,5,6,10,2,7,1,4,0,4,0,16
4695,780753,32,2,6,2,3,0,3,0,0,0,6,0,4,0,1,1,4
4695,775329,19,1,5,0,2,1,3,4,6,3,1,0,3,1,0,0,7
4695,796516,30,1,5,1,4,0,1,5,7,2,2,0,3,0,2,1,7
4695,796520,22,2,4,1,2,1,2,1,4,1,2,2,2,1,0,0,6
4695,796518,8,0,5,0,1,0,4,0,0,0,3,0,0,0,1,0,0
4695,796517,14,4,8,3,5,1,3,0,0,0,2,0,3,1,0,0,9
4695,792315,4,0,0,0,0,0,0,0,0,0,1,0,1,0,0,0,0
4696,796473,12,0,1,0,0,0,1,0,0,0,3,0,4,0,1,0,0
4696,781560,32,9,11,9,10,0,1,2,3,4,2,1,2,2,2,1,20
4696,791375,26,4,8,2,2,2,6,0,0,0,0,2,5,2,1,0,10
4696,785482,34,7,14,5,10,2,4,3,5,3,5,7,1,4,2,0,19
4696,780837,34,2,8,0,3,2,5,2,2,0,5,3,2,0,2,0,8
4696,796479,6,0,0,0,0,0,0,0,0,1,0,0,0,0,0,0,0
4696,796476,5,0,0,0,0,0,0,0,0,0,3,0,0,0,0,0,0
4696,786164,26,0,2,0,0,0,2,2,2,0,3,2,3,0,1,1,2
4696,796477,24,7,13,3,5,4,8,0,0,0,3,3,1,0,2,0,18
4696,796472,1,0,0,0,0,0,0,0,0,0,0,0,0,0,0,0,0
4697,797546,22,2,4,2,4,0,0,4,6,3,4,0,2,0,0,0,8
4697,780351,22,3,5,3,5,0,0,1,2,2,0,0,1,0,1,0,7
4697,797549,25,0,0,0,0,0,0,7,9,0,5,3,3,0,3,0,7
4697,797545,16,0,3,0,1,0,2,0,0,0,1,3,3,1,2,0,0
4697,780586,30,4,15,3,10,1,5,4,4,0,1,2,3,1,1,0,13
4697,797544,25,5,10,5,9,0,1,0,0,1,3,0,2,0,1,1,10
4697,797539,7,0,0,0,0,0,0,0,0,0,0,0,0,1,0,0,0
4697,797540,17,2,4,0,1,2,3,0,0,1,1,0,2,0,0,0,6
4697,791716,5,0,0,0,0,0,0,0,0,1,0,0,2,0,0,0,0
4697,791715,9,0,3,0,1,0,2,0,0,2,2,1,0,0,1,0,0
4697,790857,22,1,7,1,2,0,5,1,2,0,1,4,0,1,2,0,3
4698,780879,25,1,9,1,5,0,4,0,0,2,3,2,1,0,0,2,2
4698,775785,11,0,1,0,0,0,1,0,0,0,0,0,1,0,0,0,0
4698,790767,16,2,5,0,0,2,5,0,0,0,1,0,1,1,1,0,6
4698,790768,20,0,4,0,3,0,1,0,0,0,0,1,1,0,1,0,0
4698,780875,28,2,4,1,2,1,2,1,2,0,5,1,1,0,0,0,6
4698,796326,14,4,7,4,5,0,2,0,0,1,2,0,1,1,0,0,8
4698,785224,17,3,5,2,2,1,3,0,0,0,2,1,2,0,2,0,7
4698,796324,12,1,2,1,2,0,0,2,2,0,1,0,0,0,1,0,4
4698,790769,16,2,3,2,3,0,0,0,0,0,1,0,0,0,1,0,4
4698,785743,24,3,7,3,4,0,3,0,0,1,0,2,0,0,1,0,6
4698,785226,10,3,5,2,3,1,2,0,0,0,1,0,0,0,1,0,7
4698,796325,4,0,0,0,0,0,0,0,0,0,0,0,0,0,0,0,0
4698,792437,1,0,0,0,0,0,0,0,0,0,0,0,0,0,0,0,0
4698,785225,1,0,0,0,0,0,0,0,0,0,0,0,0,0,0,0,0
4698,796041,1,0,0,0,0,0,0,0,0,0,0,0,0,0,0,0,0
4699,775510,29,5,7,1,2,4,5,0,0,0,8,2,0,1,2,1,14
4699,774976,26,5,12,3,6,2,6,0,0,1,6,5,3,0,0,0,12
4699,797865,29,4,7,4,6,0,1,0,0,1,4,6,0,2,1,0,8
4699,786614,20,5,5,2,2,3,3,0,0,0,3,1,1,0,0,0,13
4699,786759,27,5,7,5,5,0,2,2,2,0,0,5,0,1,0,0,12
4699,792294,5,0,2,0,2,0,0,0,0,1,0,0,0,0,0,0,0
4699,786761,13,1,1,1,1,0,0,0,0,2,0,0,4,0,3,0,2
4699,792291,20,5,7,1,1,4,6,0,0,0,5,1,0,2,1,0,14
4699,797867,4,1,1,0,0,1,1,0,0,0,1,1,0,0,0,0,3
4699,797864,4,1,2,1,2,0,0,0,0,0,0,1,0,0,0,0,2
4699,792293,21,2,5,1,2,1,3,0,0,1,0,0,0,0,0,0,5
4699,792296,1,0,0,0,0,0,0,0,0,0,0,0,0,0,0,0,0
4699,780349,1,0,0,0,0,0,0,0,0,0,0,0,0,0,0,0,0
4700,775897,14,1,2,1,1,0,1,0,0,1,4,0,0,0,0,0,2
4700,780324,28,3,10,3,10,0,0,2,2,0,2,3,3,3,1,0,8
4700,791543,26,4,7,2,4,2,3,0,0,0,1,5,3,3,1,0,10
4700,786530,27,1,5,0,2,1,3,0,0,0,1,1,1,0,0,1,3
4700,780317,30,3,7,2,3,1,4,2,2,1,2,1,2,2,1,0,9
4700,791546,11,3,5,3,4,0,1,0,0,2,2,1,0,0,1,1,6
4700,797092,2,0,0,0,0,0,0,0,0,0,0,0,0,0,0,0,0
4700,797091,4,0,0,0,0,0,0,0,0,0,0,1,0,0,0,0,0
4700,791547,1,0,0,0,0,0,0,0,0,0,0,0,0,0,0,0,0
4700,791545,22,5,10,5,8,0,2,0,0,2,2,0,1,1,1,1,10
4700,786360,6,0,4,0,1,0,3,0,0,0,2,0,0,0,0,0,0
4700,784246,29,8,12,6,8,2,4,6,7,1,2,3,1,2,0,0,24
4701,791904,22,2,5,2,4,0,1,0,0,2,1,1,1,0,0,0,4
4701,781103,30,8,13,7,10,1,3,1,1,5,7,4,2,0,6,3,18
4701,797568,28,3,9,1,6,2,3,2,2,0,1,1,3,0,1,0,10
4701,797566,29,2,4,2,2,0,2,0,0,0,3,1,1,0,2,1,4
4701,781191,37,3,9,3,6,0,3,0,0,3,5,5,1,0,4,1,6
4701,797570,2,0,0,0,0,0,0,0,0,0,0,0,0,0,0,0,0
4701,791907,4,1,2,1,2,0,0,0,0,0,0,0,0,1,0,0,2
4701,791905,21,4,7,3,4,1,3,1,2,1,3,0,1,0,2,1,10
4701,781364,9,0,2,0,1,0,1,0,0,0,0,0,0,0,0,0,0
4701,791906,2,0,1,0,0,0,1,0,0,0,0,0,0,0,0,0,0
4701,781102,16,1,3,0,1,1,2,0,0,0,1,0,3,0,1,0,3
4702,786519,27,3,4,3,4,0,0,1,4,2,11,1,1,1,3,1,7
4702,797556,34,3,11,2,6,1,5,2,2,0,2,1,2,0,1,0,9
4702,797555,27,1,3,1,3,0,0,1,3,0,2,0,1,0,2,2,3
4702,791913,28,4,8,3,6,1,2,0,1,0,1,1,3,1,4,0,9
4702,786520,32,4,10,4,10,0,0,8,8,2,4,0,2,3,4,0,16
4702,797558,17,5,8,4,4,1,4,1,1,0,1,1,1,0,2,0,12
4702,791912,12,2,2,2,2,0,0,0,0,1,1,0,0,1,0,0,4
4702,797560,1,0,0,0,0,0,0,0,0,0,0,0,1,0,0,0,0
4702,797559,16,1,1,0,0,1,1,0,0,0,0,3,0,0,2,0,3
4702,797557,6,0,1,0,0,0,1,0,0,0,1,0,1,1,0,0,0
4703,775110,38,3,8,3,8,0,0,0,2,2,3,0,2,1,0,0,6
4703,791392,28,1,3,0,1,1,2,1,2,0,0,1,2,1,2,1,4
4703,785936,13,2,3,1,1,1,2,0,0,0,1,0,2,0,1,1,5
4703,780128,37,7,16,4,5,3,11,1,2,1,4,4,1,0,1,0,18
4703,775458,38,9,15,6,9,3,6,2,3,2,4,1,4,6,5,0,23
4703,797140,1,0,0,0,0,0,0,0,0,1,0,0,0,0,0,0,0
4703,797134,1,0,0,0,0,0,0,0,0,0,0,0,0,0,1,0,0
4703,797138,5,0,0,0,0,0,0,0,0,0,0,0,1,0,1,0,0
4703,797135,27,1,6,0,2,1,4,0,1,1,3,1,3,0,2,1,3
4703,785264,12,2,6,0,1,2,5,0,0,0,2,1,3,0,1,0,6
4704,786550,19,1,2,1,2,0,0,2,2,1,5,1,4,2,3,0,4
4704,776054,30,4,7,2,4,2,3,0,0,1,2,0,4,0,1,2,10
4704,792007,34,4,5,4,4,0,1,6,8,1,3,1,2,0,1,0,14
4704,792009,28,7,13,6,10,1,3,3,4,0,2,0,1,1,1,0,18
4704,792006,23,2,3,2,3,0,0,2,2,0,2,3,1,2,0,0,6
4704,792011,5,0,0,0,0,0,0,0,0,0,0,0,2,0,0,1,0
4704,780177,21,0,2,0,2,0,0,0,0,0,8,0,4,0,5,0,0
4704,792008,5,0,0,0,0,0,0,0,0,0,0,0,0,0,1,0,0
4704,791689,13,1,6,1,4,0,2,0,1,0,1,1,0,0,3,0,2
4704,786552,5,0,0,0,0,0,0,0,0,0,1,0,0,0,1,1,0
4704,776273,17,1,4,1,4,0,0,2,2,0,3,2,1,1,5,0,4
4705,791537,22,2,6,1,2,1,4,0,0,1,1,0,3,0,3,0,5
4705,786357,35,4,11,4,8,0,3,1,2,1,7,2,5,3,2,1,9
4705,780306,38,7,14,6,9,1,5,4,9,1,7,3,1,0,6,2,19
4705,797116,30,3,10,2,4,1,6,0,0,0,2,0,4,1,1,0,7
4705,780312,27,0,1,0,0,0,1,0,0,0,0,0,4,1,1,1,0
4705,786358,27,1,7,0,1,1,6,0,0,0,2,0,1,0,2,0,3
4705,775846,4,0,1,0,0,0,1,0,0,0,0,0,1,1,0,0,0
4705,775418,17,2,3,2,3,0,0,2,2,1,1,0,2,1,2,0,6
4706,785294,30,1,3,1,1,0,2,0,2,2,5,1,1,0,1,1,2
4706,796514,28,5,11,4,9,1,2,0,2,1,2,7,4,2,4,0,11
4706,791085,32,5,11,2,3,3,8,0,1,0,2,2,3,2,4,0,13
4706,791080,26,3,6,2,4,1,2,5,7,2,3,0,4,1,1,1,12
4706,785675,34,5,12,3,5,2,7,0,0,1,0,0,1,1,1,1,12
4706,791083,18,3,5,1,2,2,3,0,0,4,1,0,4,1,1,0,8
4706,786446,15,1,4,0,1,1,3,0,0,0,1,3,1,0,4,0,3
4706,796511,12,0,1,0,0,0,1,2,2,1,2,0,1,0,1,0,2
4706,791084,1,0,1,0,1,0,0,0,0,0,0,0,0,0,0,0,0
4706,791081,2,0,0,0,0,0,0,0,0,0,0,0,1,0,0,0,0
4706,796512,1,0,0,0,0,0,0,0,0,0,0,0,0,0,0,0,0
4706,796515,1,0,0,0,0,0,0,0,0,0,0,0,0,0,0,0,0
4707,796617,11,3,3,3,3,0,0,4,4,0,2,0,2,0,1,0,10
4707,775131,34,7,11,4,5,3,6,0,0,0,5,6,2,2,2,0,17
4707,796616,33,4,9,0,0,4,9,0,1,1,1,0,1,0,1,0,12
4707,796612,27,2,5,2,4,0,1,2,2,2,1,7,3,2,3,0,6
4707,785562,29,4,12,4,11,0,1,4,4,3,4,0,1,1,3,0,12
4707,792429,12,1,3,1,2,0,1,0,1,0,1,0,0,1,0,0,2
4707,796607,15,2,2,1,1,1,1,2,2,0,1,0,3,0,2,0,7
4707,796606,28,4,5,3,4,1,1,3,4,2,1,4,2,1,0,0,12
4707,796618,1,0,0,0,0,0,0,0,2,0,1,0,0,0,0,0,0
4707,799543,1,0,0,0,0,0,0,0,0,0,0,0,1,0,0,0,0
4707,796619,1,0,0,0,0,0,0,0,0,1,0,0,0,0,0,0,0
4707,796614,6,1,1,1,1,0,0,0,0,0,2,0,3,0,1,0,2
4707,796608,1,0,1,0,1,0,0,0,0,0,0,0,0,0,0,0,0
4707,796615,1,0,0,0,0,0,0,0,0,0,0,0,0,0,0,0,0
4708,786059,27,4,9,3,7,1,2,4,4,3,4,1,2,0,2,3,13
4708,776174,17,1,5,1,5,0,0,8,8,5,3,0,4,0,2,1,10
4708,791958,35,6,8,6,8,0,0,11,16,1,8,1,1,3,1,0,23
4708,791960,21,1,8,1,6,0,2,1,2,0,1,2,0,2,1,0,3
4708,785861,34,3,9,0,4,3,5,6,8,0,9,0,2,1,1,0,15
4708,786063,3,2,3,2,3,0,0,1,2,1,0,0,0,1,0,0,5
4708,781334,4,0,1,0,1,0,0,3,4,0,3,0,1,0,0,0,3
4708,797706,22,2,5,2,3,0,2,2,2,1,1,1,3,1,1,1,6
4708,797704,18,1,6,0,0,1,6,0,0,0,1,3,0,0,1,0,3
4708,791957,3,0,0,0,0,0,0,2,2,0,2,0,0,0,0,1,2
4708,791959,5,0,0,0,0,0,0,0,0,0,2,1,1,0,1,0,0
4708,781332,11,1,2,1,2,0,0,0,0,0,1,2,1,1,4,0,2
4709,785681,18,1,5,1,5,0,0,3,4,1,3,0,2,2,0,1,5
4709,796789,17,0,6,0,4,0,2,0,2,2,0,0,3,0,2,0,0
4709,791126,14,2,3,2,3,0,0,3,3,0,2,0,3,1,2,0,7
4709,791124,20,2,7,2,5,0,2,0,0,0,2,0,1,0,3,0,4
4709,780050,21,1,6,1,5,0,1,0,2,2,10,1,4,0,2,0,2
4709,784479,14,1,3,1,2,0,1,3,4,1,2,0,3,0,1,0,5
4709,796786,14,0,2,0,0,0,2,0,0,0,1,0,2,0,1,0,0
4709,796788,6,0,1,0,1,0,0,0,0,1,0,0,5,0,1,0,0
4709,775813,9,3,6,3,6,0,0,0,0,2,1,1,0,0,1,0,6
4709,796787,2,0,1,0,0,0,1,0,0,0,0,0,0,0,0,0,0
4709,796784,19,4,10,1,6,3,4,0,0,2,1,0,1,0,2,0,11
4709,796783,8,1,2,1,2,0,0,0,0,0,0,0,4,0,1,0,2
4709,796782,21,1,4,1,3,0,1,0,0,0,2,0,3,0,0,0,2
4709,792709,1,0,1,0,1,0,0,0,0,0,0,0,0,0,0,0,0
4709,792711,6,1,1,1,1,0,0,1,2,0,1,1,2,1,0,0,3
4709,791125,10,0,3,0,3,0,0,2,2,0,0,0,2,2,2,0,2
4710,791524,37,5,11,3,7,2,4,3,4,2,6,3,2,1,1,1,15
4710,797139,19,3,7,3,7,0,0,6,9,2,11,2,3,0,3,0,12
4710,775394,31,4,10,3,5,1,5,0,0,0,4,1,2,0,2,0,9
4710,791526,25,3,7,1,2,2,5,1,2,0,2,4,4,1,2,0,9
4710,780272,38,5,10,0,3,5,7,7,8,1,5,4,1,0,2,0,22
4710,785970,17,1,1,1,1,0,0,0,0,1,4,2,4,0,2,2,2
4710,791523,13,2,3,0,0,2,3,1,2,0,1,0,0,0,0,0,7
4710,780273,20,2,2,0,0,2,2,0,0,1,1,0,2,0,0,0,6
4711,792246,22,3,8,3,8,0,0,1,2,2,3,0,4,0,1,1,7
4711,791701,28,2,2,2,2,0,0,1,2,1,2,4,1,0,1,0,5
4711,792245,26,2,5,0,1,2,4,0,0,2,1,1,2,1,1,0,6
4711,781420,38,7,23,3,7,4,16,4,4,2,5,2,4,1,0,0,22
4711,781405,37,4,17,2,9,2,8,4,4,1,0,0,4,0,3,0,14
4711,792244,7,0,3,0,1,0,2,0,0,0,2,2,4,0,0,0,0
4711,780615,10,0,2,0,2,0,0,0,0,1,1,0,2,0,1,0,0
4711,781624,12,1,1,0,0,1,1,0,0,0,2,0,0,0,0,0,3
4711,797925,20,3,4,1,1,2,3,1,1,0,3,0,2,0,1,0,9
4712,791042,23,3,10,1,5,2,5,5,6,0,3,0,0,0,2,1,13
4712,774834,21,1,4,0,2,1,2,2,2,1,2,0,1,0,1,0,5
4712,796718,19,1,7,0,4,1,3,2,2,0,0,1,2,0,0,0,5
4712,791043,34,1,8,1,5,0,3,2,2,1,2,3,3,0,1,0,4
4712,776374,30,2,7,1,5,1,2,0,0,2,6,4,2,2,0,0,5
4712,796723,12,1,4,1,4,0,0,0,0,0,3,3,0,0,1,0,2
4712,785512,17,4,5,4,5,0,0,0,0,0,2,0,0,1,2,0,8
4712,796717,10,0,2,0,1,0,1,0,0,0,1,3,0,0,0,0,0
4712,796720,9,1,3,1,2,0,1,0,0,0,1,0,1,1,0,0,2
4712,775412,25,3,5,0,0,3,5,0,1,0,0,0,2,1,0,0,9
4713,776344,22,4,9,3,5,1,4,2,5,2,4,0,3,0,1,0,11
4713,775821,28,7,11,4,6,3,5,0,0,1,4,2,2,0,1,0,17
4713,792453,32,8,11,6,9,2,2,2,3,0,8,3,1,1,3,0,20
4713,785131,26,2,7,1,4,1,3,1,1,1,7,2,3,2,1,0,6
4713,781538,31,1,8,1,5,0,3,0,0,0,2,6,1,2,0,0,2
4713,798113,5,0,1,0,0,0,1,1,2,1,1,1,1,0,0,0,1
4713,785152,14,0,2,0,1,0,1,0,0,1,1,1,3,1,3,0,0
4713,798115,19,1,4,1,1,0,3,0,0,1,2,2,1,0,0,0,2
4713,776233,20,4,5,1,1,3,4,0,1,3,2,0,1,0,1,0,11
4713,792324,3,0,0,0,0,0,0,0,0,0,0,0,0,0,0,0,0
4714,791768,18,2,4,2,3,0,1,1,1,0,4,3,1,0,0,2,5
4714,786460,20,1,5,1,5,0,0,1,2,1,2,5,3,2,3,1,3
4714,791766,25,3,5,2,3,1,2,1,2,3,1,5,3,1,0,0,8
4714,780604,28,6,15,6,12,0,3,0,0,3,2,4,3,1,2,0,12
4714,780603,25,3,11,1,2,2,9,0,0,0,2,2,4,0,0,0,8
4714,786071,14,3,4,3,4,0,0,1,2,3,2,0,0,0,1,1,7
4714,786230,33,13,22,6,9,7,13,0,0,0,3,4,3,2,1,0,33
4714,780602,31,9,16,9,15,0,1,2,2,4,7,4,3,1,1,0,20
4714,797565,1,1,1,0,0,1,1,0,0,0,0,1,0,0,0,0,3
4714,780605,3,0,0,0,0,0,0,0,0,0,0,0,1,0,0,0,0
4714,797563,1,0,0,0,0,0,0,0,0,0,0,0,0,0,0,0,0
4714,797564,1,0,0,0,0,0,0,0,0,0,0,0,0,0,0,0,0
4715,796996,32,6,8,6,8,0,0,1,2,3,7,0,4,1,0,1,13
4715,780471,38,9,11,8,10,1,1,3,3,0,9,1,3,0,1,5,22
4715,791613,37,3,11,2,8,1,3,3,5,0,6,6,3,0,3,0,10
4715,791608,35,3,10,0,0,3,10,1,2,0,0,1,1,0,2,0,10
4715,776011,31,5,7,4,6,1,1,4,7,1,5,10,3,0,6,0,15
4715,786413,4,1,2,1,1,0,1,0,0,0,0,0,1,0,2,0,2
4715,792071,10,1,2,0,0,1,2,0,0,0,0,0,0,0,1,0,3
4715,796994,8,2,4,1,1,1,3,4,4,0,0,1,0,0,0,0,9
4715,791611,4,0,1,0,0,0,1,0,0,0,0,0,0,0,0,0,0
4715,780417,1,0,0,0,0,0,0,0,0,0,0,0,0,0,0,0,0
4716,797111,17,2,6,2,6,0,0,1,4,3,3,0,5,0,0,0,5
4716,797110,24,2,7,1,3,1,4,0,0,1,2,0,2,0,2,0,5
4716,791407,32,4,13,3,8,1,5,6,10,0,3,1,1,2,4,0,15
4716,785928,32,3,5,1,2,2,3,1,1,0,2,0,3,0,1,0,9
4716,785923,29,4,7,4,6,0,1,2,5,1,1,5,3,0,1,0,10
4716,797113,8,1,1,1,1,0,0,0,2,2,2,0,5,0,2,0,2
4716,797117,11,0,1,0,1,0,0,0,0,0,1,0,5,1,3,0,0
4716,797115,2,2,3,2,3,0,0,0,0,1,0,0,0,1,0,0,4
4716,797109,15,2,4,1,1,1,3,0,1,1,1,0,2,1,3,0,5
4716,791404,28,2,5,1,2,1,3,5,6,1,1,2,3,1,1,0,10
4716,800038,2,0,0,0,0,0,0,0,0,0,0,0,0,0,0,0,0
4717,792158,32,4,5,3,4,1,1,4,6,3,5,1,2,0,3,3,13
4717,792157,17,5,6,5,6,0,0,1,3,2,4,0,3,0,0,1,11
4717,792154,21,4,9,3,6,1,3,2,4,1,2,3,3,1,0,0,11
4717,792152,34,4,14,4,9,0,5,2,3,0,4,2,2,3,1,0,10
4717,780581,20,5,6,4,4,1,2,1,3,0,4,5,3,1,3,0,12
4717,797755,9,1,2,1,2,0,0,1,2,1,3,0,1,0,0,2,3
4717,780138,19,2,3,2,3,0,0,2,2,4,2,0,3,0,2,0,6
4717,797756,25,3,6,3,3,0,3,1,2,0,1,5,2,3,2,0,7
4717,792159,4,0,1,0,1,0,0,0,0,0,0,0,2,0,1,0,0
4717,786014,17,4,6,3,5,1,1,1,2,2,0,1,3,0,3,0,10
4717,792162,2,0,0,0,0,0,0,0,0,0,0,0,0,0,0,0,0
4718,785467,26,5,9,0,1,5,8,0,0,0,3,1,2,1,0,1,15
4718,779981,24,6,7,6,7,0,0,2,7,2,5,1,1,1,0,0,14
4718,785463,34,5,7,4,6,1,1,3,3,2,1,9,2,0,2,0,14
4718,779978,31,3,5,3,4,0,1,2,2,1,3,2,1,2,0,0,8
4718,776003,27,7,12,3,4,4,8,1,2,1,5,1,2,2,2,1,19
4718,790924,16,1,7,1,2,0,5,0,0,0,0,0,2,2,4,0,2
4718,779979,22,2,6,0,0,2,6,0,0,0,5,3,2,1,0,2,6
4718,779980,17,1,4,1,3,0,1,0,0,1,3,0,5,0,2,0,2
4718,785465,1,1,2,1,1,0,1,0,0,0,0,0,1,0,0,0,2
4718,789977,1,0,0,0,0,0,0,0,0,0,0,0,0,0,0,0,0
4718,800039,1,0,0,0,0,0,0,0,0,0,0,0,0,0,0,0,0
4719,796372,26,6,10,6,10,0,0,2,3,4,3,0,3,0,1,1,14
4719,790814,23,1,6,1,3,0,3,0,0,1,1,1,1,1,1,0,2
4719,796377,33,2,9,1,5,1,4,3,7,0,5,2,3,0,2,0,8
4719,796378,31,4,9,2,7,2,2,2,2,1,5,3,1,0,3,0,12
4719,780176,33,4,11,1,3,3,8,0,0,0,2,4,3,0,4,0,11
4719,796376,7,1,1,1,1,0,0,0,0,0,1,1,1,0,0,0,2
4719,790815,26,4,9,3,7,1,2,2,2,1,3,1,3,0,3,0,11
4719,796375,7,2,2,2,2,0,0,0,0,0,3,0,1,0,0,0,4
4719,796374,11,0,0,0,0,0,0,0,0,0,1,0,0,0,0,0,0
4719,790817,2,1,1,1,1,0,0,1,2,1,0,0,0,0,0,0,3
4719,796373,1,0,0,0,0,0,0,0,0,0,0,0,0,0,0,0,0
4720,790821,18,1,6,1,3,0,3,0,0,0,0,1,2,0,2,0,2
4720,775585,29,3,6,3,6,0,0,2,4,5,6,1,4,0,2,0,8
4720,790822,39,12,20,9,15,3,5,3,5,3,4,6,1,0,0,0,30
4720,790820,38,2,8,2,6,0,2,1,2,0,4,2,1,1,1,0,5
4720,780982,36,6,11,5,7,1,4,2,4,1,9,3,2,0,3,0,15
4720,796381,29,4,7,0,1,4,6,4,4,2,2,2,2,2,2,0,16
4720,780445,11,1,1,1,1,0,0,0,0,0,0,0,1,0,0,1,2
4721,791534,28,8,9,7,8,1,1,1,3,3,8,0,4,2,2,1,18
4721,797127,32,2,8,2,7,0,1,7,8,2,0,1,2,1,0,0,11
4721,791533,28,1,6,1,2,0,4,2,2,0,5,0,3,0,0,0,4
4721,791528,34,2,6,1,2,1,4,0,0,0,5,3,2,1,2,0,5
4721,775045,40,11,20,10,15,1,5,2,2,1,2,7,3,3,2,0,25
4721,791531,19,2,5,2,3,0,2,3,3,1,2,0,1,0,0,0,7
4721,791529,11,0,4,0,1,0,3,0,0,0,0,0,0,0,0,0,0
4721,797124,7,1,2,1,2,0,0,0,0,0,0,0,0,0,0,0,2
4721,797129,1,0,0,0,0,0,0,0,0,0,0,0,0,0,0,0,0
4722,786481,41,9,16,9,15,0,1,3,3,1,6,3,2,3,1,0,21
4722,797626,38,4,8,4,6,0,2,3,4,0,3,2,2,2,3,0,11
4722,797624,27,0,3,0,1,0,2,0,0,0,5,0,2,0,1,4,0
4722,786480,35,3,9,0,2,3,7,1,2,0,3,2,2,0,1,0,10
4722,781032,42,6,12,3,4,3,8,3,5,0,4,4,1,0,3,0,18
4722,797628,23,7,10,6,8,1,2,7,8,1,3,0,3,0,0,0,22
4722,791791,5,0,1,0,0,0,1,0,0,0,0,0,0,0,0,0,0
4722,797627,10,0,1,0,0,0,1,0,0,0,0,0,3,0,0,0,0
4722,785965,4,0,0,0,0,0,0,0,0,0,0,1,0,0,0,0,0
4723,781044,43,11,18,7,9,4,9,6,7,2,8,1,4,0,4,1,32
4723,791795,23,2,5,1,4,1,1,0,0,3,0,1,2,0,1,0,5
4723,786489,38,3,8,1,3,2,5,2,3,0,3,1,4,2,1,0,10
4723,786488,42,4,15,4,11,0,4,3,5,2,5,3,4,2,1,1,11
4723,781038,43,4,8,2,6,2,2,0,0,2,11,1,3,0,5,0,10
4723,797620,31,3,8,3,7,0,1,4,5,5,2,3,3,0,2,0,10
4723,786490,1,0,0,0,0,0,0,0,0,0,0,0,1,0,0,0,0
4723,797619,4,0,1,0,0,0,1,0,0,0,0,0,0,0,0,0,0
4723,797622,0,0,0,0,0,0,0,0,0,0,0,0,0,0,0,0,0
4724,797824,17,3,4,1,1,2,3,0,0,2,6,0,3,0,2,1,8
4724,797825,18,3,4,3,4,0,0,4,4,4,2,0,1,0,0,0,10
4724,797822,37,6,13,4,8,2,5,2,4,0,4,4,0,1,3,1,16
4724,792190,32,7,9,4,6,3,3,2,2,1,2,6,4,2,0,0,19
4724,786664,38,3,12,1,3,2,9,1,4,2,4,4,1,2,5,0,9
4724,792192,18,2,3,2,3,0,0,0,0,1,2,2,1,1,2,1,4
4724,775116,21,1,4,0,1,1,3,1,4,0,2,1,2,0,2,0,4
4724,792191,16,0,4,0,2,0,2,4,4,1,4,0,2,0,3,0,4
4724,791928,3,0,1,0,0,0,1,0,0,0,1,0,1,0,2,0,0
4725,792186,32,5,7,5,7,0,0,4,7,2,3,0,2,0,2,0,14
4725,781490,19,1,5,0,4,1,1,0,0,0,2,0,1,1,1,0,3
4725,797816,26,2,10,1,2,1,8,1,1,0,0,0,3,0,3,0,6
4725,792188,27,3,6,2,3,1,3,0,2,0,1,3,3,1,0,0,7
4725,792183,36,5,11,4,9,1,2,0,0,0,5,4,4,1,1,0,11
4725,797821,19,4,7,4,5,0,2,6,6,2,6,1,2,3,0,0,14
4725,781447,11,3,5,3,5,0,0,0,0,0,0,0,1,0,1,0,6
4725,780433,1,0,0,0,0,0,0,0,0,0,0,0,0,0,1,0,0
4725,792185,14,0,1,0,0,0,1,6,7,0,2,0,0,0,1,0,6
4725,786675,15,2,4,2,2,0,2,0,0,0,3,1,1,2,2,0,4
4726,790893,31,3,9,3,8,0,1,1,3,2,2,4,3,0,0,1,7
4726,796444,30,6,11,6,10,0,1,4,7,1,2,4,4,2,2,2,16
4726,786615,35,6,15,5,12,1,3,2,4,3,8,3,2,2,1,0,15
4726,786732,28,4,6,2,4,2,2,3,4,1,1,0,2,1,1,0,13
4726,775260,32,8,13,6,7,2,6,3,6,0,3,3,3,0,1,0,21
4726,775536,14,2,6,2,6,0,0,0,2,3,2,0,1,0,1,0,4
4726,790890,9,0,2,0,0,0,2,0,0,0,0,0,1,0,0,0,0
4726,790889,16,2,4,2,2,0,2,2,3,0,1,3,0,1,1,0,6
4726,780702,5,1,3,0,1,1,2,0,0,0,2,0,0,0,1,0,3
4727,797831,32,2,6,0,0,2,6,0,1,1,2,1,2,0,1,0,6
4727,797823,35,3,6,3,3,0,3,4,4,3,9,1,2,0,2,2,10
4727,797829,34,6,9,6,9,0,0,2,3,2,5,1,3,0,2,2,14
4727,792280,23,4,9,2,5,2,4,4,4,0,2,3,5,1,2,1,14
4727,780505,37,10,21,6,13,4,8,3,6,0,0,4,1,2,2,0,27
4727,797833,6,0,2,0,1,0,1,0,0,0,0,0,0,0,0,0,0
4727,785701,5,0,1,0,0,0,1,0,0,0,3,0,3,0,2,0,0
4727,792286,6,1,1,1,1,0,0,0,0,0,2,0,2,0,1,0,2
4727,797826,14,2,2,2,2,0,0,0,0,0,0,0,3,1,1,0,4
4727,785950,5,0,0,0,0,0,0,0,0,1,0,0,0,1,0,0,0
4727,799468,3,0,0,0,0,0,0,0,0,0,0,0,0,0,0,0,0
4728,785829,23,5,8,5,8,0,0,0,0,2,7,1,2,0,1,1,10
4728,775838,27,4,8,4,7,0,1,2,4,5,6,3,5,1,2,0,10
4728,796726,24,2,5,1,2,1,3,0,0,0,1,2,3,0,2,0,5
4728,791048,31,5,7,3,4,2,3,6,9,1,3,1,4,3,0,1,18
4728,786531,26,3,10,2,4,1,6,0,0,0,0,2,0,1,2,0,7
4728,796728,6,0,0,0,0,0,0,0,0,0,1,0,1,0,0,0,0
4728,791044,2,0,0,0,0,0,0,0,0,0,2,0,0,0,1,0,0
4728,796729,17,3,11,0,5,3,6,1,2,0,4,0,5,2,1,1,10
4728,796727,9,1,1,0,0,1,1,0,0,0,0,3,2,0,0,0,3
4728,796724,21,3,10,1,6,2,4,7,8,0,2,3,0,0,1,0,15
4728,785519,14,3,6,2,3,1,3,0,0,0,1,1,1,0,0,1,7
4729,796837,33,3,9,3,6,0,3,0,0,0,9,1,4,0,1,3,6
4729,791171,26,4,7,4,7,0,0,2,4,0,6,1,4,0,1,0,10
4729,785706,36,8,15,1,5,7,10,2,2,1,2,3,1,0,1,0,25
4729,785700,37,6,12,4,8,2,4,11,13,0,6,13,3,2,1,0,25
4729,786721,35,3,10,2,4,1,6,5,8,1,3,2,3,0,1,1,12
4729,780194,13,3,4,3,4,0,0,1,1,1,3,1,4,0,2,0,7
4729,796834,8,0,0,0,0,0,0,0,0,0,0,0,0,0,2,0,0
4729,796833,12,0,3,0,1,0,2,1,2,0,1,0,1,0,2,0,1
4730,796880,35,2,6,0,0,2,6,0,0,0,1,3,2,0,1,0,6
4730,791334,34,7,11,4,6,3,5,6,8,0,2,1,3,6,0,0,23
4730,791760,18,3,5,2,4,1,1,7,8,1,1,0,4,0,1,0,14
4730,796879,17,1,4,0,1,1,3,0,0,0,2,3,0,0,4,1,3
4730,780256,26,2,3,1,1,1,2,2,5,1,2,1,2,0,3,0,7
4730,791757,23,1,6,0,3,1,3,0,0,0,2,2,1,0,1,1,3
4730,785874,16,2,2,2,2,0,0,0,0,0,3,0,2,0,0,0,4
4730,796883,8,0,1,0,1,0,0,0,0,0,0,0,0,0,1,0,0
4730,791330,6,1,1,1,1,0,0,1,2,0,1,0,1,0,1,0,3
4730,796885,6,1,2,1,2,0,0,1,2,1,1,0,0,0,0,0,3
4730,781590,11,2,5,1,2,1,3,1,1,0,0,1,4,0,2,0,6
4731,775456,26,5,10,3,8,2,2,4,4,0,4,3,1,1,1,0,16
4731,781115,30,3,6,3,6,0,0,0,0,1,1,1,3,1,3,0,6
4731,785524,34,7,11,5,7,2,4,6,6,2,5,1,1,1,0,1,22
4731,775094,16,0,3,0,1,0,2,2,2,0,4,2,0,0,1,0,2
4731,791053,20,3,5,3,5,0,0,5,9,3,1,1,3,0,5,0,11
4731,790819,24,4,11,3,7,1,4,2,2,0,4,3,2,0,1,0,11
4731,780739,15,2,4,2,4,0,0,0,0,0,1,0,2,0,0,0,4
4731,791051,5,1,2,1,2,0,0,0,0,0,0,0,4,0,0,0,2
4731,796730,10,1,1,1,1,0,0,2,2,0,2,0,2,0,0,0,4
4731,796731,20,2,3,2,3,0,0,1,2,4,2,0,5,4,0,0,5
4738,796631,10,1,4,1,1,0,3,0,0,0,2,0,2,0,0,0,2
4738,790998,36,4,9,3,7,1,2,1,2,5,3,5,0,1,2,1,10
4738,790997,32,3,6,2,5,1,1,4,4,0,6,1,3,2,4,0,11
4738,790996,29,6,13,4,9,2,4,2,4,0,3,0,1,0,1,0,16
4738,785621,35,4,8,1,2,3,6,0,0,1,2,1,0,0,4,0,11
4738,766874,19,1,3,1,3,0,0,0,1,1,5,1,4,1,2,3,2
4738,790992,3,0,0,0,0,0,0,1,2,1,0,0,0,0,1,0,1
4738,790995,19,3,6,1,3,2,3,2,2,0,0,0,3,1,0,1,10
4738,786375,15,1,1,1,1,0,0,2,3,0,4,0,3,0,0,1,4
4738,781520,2,0,0,0,0,0,0,0,0,0,0,0,1,0,0,0,0
4739,791606,34,6,14,5,10,1,4,0,0,2,7,1,3,2,1,2,13
4739,786410,28,1,6,0,4,1,2,1,2,2,1,2,2,1,0,0,4
4739,775095,28,5,10,5,10,0,0,6,6,2,4,0,2,0,2,1,16
4739,786406,36,2,8,1,5,1,3,4,6,3,1,7,3,0,2,0,9
4739,780414,29,5,7,3,3,2,4,5,5,2,5,4,5,2,1,0,17
4739,797020,6,2,3,2,3,0,0,0,0,1,1,0,2,0,0,0,4
4739,797021,7,0,1,0,1,0,0,0,0,0,0,0,0,1,0,0,0
4739,791605,28,5,11,1,5,4,6,0,0,0,2,0,1,2,1,0,14
4739,791843,4,0,2,0,1,0,1,0,0,0,0,0,0,0,0,0,0
4740,780282,23,6,8,6,8,0,0,2,2,3,4,2,4,2,3,0,14
4740,780277,34,6,12,5,7,1,5,0,0,3,8,2,4,1,3,0,13
4740,791002,25,0,4,0,3,0,1,3,4,0,0,2,2,2,2,0,3
4740,785327,16,0,2,0,1,0,1,0,0,0,2,0,4,0,3,1,0
4740,780280,32,7,14,6,10,1,4,6,7,2,1,3,1,1,2,0,21
4740,785329,20,2,6,1,3,1,3,0,0,2,1,3,0,1,0,0,5
4740,796662,8,0,0,0,0,0,0,0,1,0,1,0,0,0,0,0,0
4740,791003,6,0,1,0,0,0,1,0,0,0,0,0,0,0,2,0,0
4740,785326,15,0,2,0,1,0,1,0,0,0,2,1,0,0,2,0,0
4740,780279,21,3,4,0,0,3,4,0,0,0,0,0,2,1,0,0,9
4741,796585,12,1,2,1,2,0,0,0,0,1,0,3,4,0,1,0,2
4741,780192,28,2,6,2,4,0,2,1,2,2,1,2,4,1,4,0,5
4741,798139,25,5,11,4,4,1,7,0,0,0,3,0,2,0,0,0,11
4741,786818,31,7,10,5,7,2,3,1,2,2,2,2,2,2,2,0,17
4741,780182,32,7,12,4,5,3,7,4,5,1,5,1,2,2,1,0,21
4741,780186,26,2,3,2,3,0,0,1,3,2,5,3,3,0,2,0,5
4741,798138,5,0,0,0,0,0,0,0,0,1,0,0,0,1,1,0,0
4741,786820,15,1,5,0,1,1,4,0,0,0,2,6,0,2,3,0,3
4741,780188,7,0,0,0,0,0,0,0,0,0,0,0,1,0,0,0,0
4741,780184,17,4,5,0,0,4,5,0,1,0,0,0,2,1,0,0,12
4741,796587,2,0,0,0,0,0,0,0,0,0,0,0,0,0,0,0,0
4742,792329,24,5,7,4,6,1,1,4,4,0,2,1,3,1,2,0,15
4742,786752,22,6,11,5,9,1,2,4,4,4,1,1,3,0,4,1,17
4742,781615,18,1,1,0,0,1,1,1,2,0,3,1,0,1,1,0,4
4742,786749,33,1,3,0,0,1,3,0,0,1,7,4,1,4,3,0,3
4742,776350,20,4,6,2,3,2,3,0,0,1,2,5,2,3,1,1,10
4742,797880,4,0,1,0,1,0,0,0,0,0,2,0,1,0,0,0,0
4742,792330,8,1,1,0,0,1,1,0,0,0,1,0,4,0,1,0,3
4742,785435,12,0,2,0,0,0,2,0,0,0,1,0,2,0,2,0,0
4742,781075,7,3,5,2,4,1,1,2,2,1,1,1,3,0,1,0,9
4742,792331,11,1,3,1,1,0,2,1,2,0,0,0,0,0,0,0,3
4742,792601,15,0,1,0,0,0,1,1,2,0,1,3,0,1,3,0,1
4742,781384,26,7,9,5,6,2,3,7,7,1,4,1,1,1,3,1,23
4743,791558,4,0,0,0,0,0,0,0,0,1,0,0,2,1,0,0,0
4743,786371,25,6,8,5,7,1,1,2,4,1,3,1,2,1,2,0,15
4743,797072,31,2,11,1,5,1,6,3,4,0,0,4,4,2,3,0,8
4743,791554,27,5,12,2,5,3,7,2,2,3,1,2,2,1,3,0,15
4743,791556,26,2,7,1,1,1,6,0,0,2,2,2,1,1,2,0,5
4743,797076,23,2,8,0,3,2,5,2,2,0,0,2,0,3,0,0,8
4743,786372,16,0,1,0,1,0,0,0,0,0,0,0,2,0,6,0,0
4743,786369,28,2,6,1,4,1,2,4,4,1,2,1,4,0,1,1,9
4743,797074,5,0,0,0,0,0,0,0,0,0,3,0,1,0,1,2,0
4743,791559,15,0,0,0,0,0,0,0,0,0,0,0,0,0,0,0,0
4744,796850,36,8,12,7,11,1,1,3,4,3,3,3,3,1,3,3,20
4744,774969,37,7,11,7,11,0,0,3,3,4,11,3,1,0,3,3,17
4744,796848,14,0,2,0,1,0,1,2,2,1,2,0,0,0,4,0,2
4744,791181,34,2,4,2,3,0,1,1,3,1,0,3,2,1,4,0,5
4744,781054,40,3,10,2,5,1,5,1,2,0,4,5,2,0,3,0,8
4744,780981,10,1,2,1,1,0,1,2,2,1,1,0,3,0,0,0,4
4744,791179,29,5,9,4,6,1,3,0,0,1,2,0,4,5,3,0,11
4745,791344,28,4,8,4,4,0,4,1,1,5,3,0,4,2,1,2,9
4745,781425,31,3,10,3,10,0,0,1,1,2,2,1,0,2,1,0,7
4745,791343,36,7,13,7,12,0,1,3,4,2,4,5,2,3,3,0,17
4745,781602,40,10,19,9,14,1,5,2,2,1,1,3,2,4,2,1,23
4745,775746,33,3,12,1,5,2,7,0,0,2,2,0,2,0,1,0,8
4745,781601,9,0,3,0,3,0,0,0,0,2,0,0,1,0,0,0,0
4745,776173,17,1,3,1,3,0,0,2,2,1,1,0,2,0,0,3,4
4745,797001,6,0,1,0,1,0,0,0,0,0,0,0,1,0,1,0,0
4746,791201,22,3,11,3,7,0,4,2,2,0,3,0,1,1,0,1,8
4746,791202,29,6,11,1,1,5,10,0,0,0,1,2,2,0,0,0,17
4746,775767,33,6,12,6,11,0,1,0,0,3,7,1,5,0,1,2,12
4746,785628,31,2,8,2,6,0,2,0,0,1,1,11,4,0,3,0,4
4746,785627,28,1,4,0,0,1,4,3,3,0,3,2,4,3,0,0,6
4746,796904,4,0,0,0,0,0,0,0,0,0,1,1,0,0,0,1,0
4746,781135,3,0,0,0,0,0,0,0,0,0,1,0,1,0,1,0,0
4746,796902,8,1,4,1,3,0,1,0,0,0,1,1,1,0,0,0,2
4746,796901,16,2,8,1,4,1,4,2,2,1,2,1,2,0,0,0,7
4746,785629,26,2,7,1,2,1,5,3,5,2,3,1,5,2,1,0,8
4747,792110,25,2,6,2,5,0,1,1,1,1,1,1,3,1,1,1,5
4747,786031,26,3,6,3,4,0,2,3,4,1,4,1,3,1,0,0,9
4747,797734,36,4,9,3,5,1,4,0,0,0,7,2,3,0,4,0,9
4747,797735,34,5,7,3,4,2,3,14,16,2,6,0,4,1,2,0,26
4747,781386,38,5,13,3,9,2,4,4,4,0,6,2,1,0,2,0,16
4747,786033,15,0,2,0,2,0,0,2,4,2,3,1,0,0,3,3,2
4747,792109,16,1,3,1,2,0,1,0,0,0,3,0,0,0,1,0,2
4747,792105,10,0,3,0,0,0,3,0,0,0,0,0,1,0,0,0,0
4748,776286,31,5,8,4,6,1,2,4,4,5,5,0,2,0,0,0,15
4748,775557,21,2,3,2,3,0,0,1,1,3,1,1,3,1,1,0,5
4748,791445,33,3,8,2,4,1,4,1,1,1,1,2,2,0,1,0,8
4748,785357,28,7,18,4,10,3,8,1,5,0,3,2,2,4,0,0,18
4748,775560,28,2,8,0,4,2,4,0,0,1,2,5,3,2,1,0,6
4748,785287,13,0,3,0,3,0,0,3,4,1,1,0,1,0,1,0,3
4748,797010,17,2,6,2,4,0,2,1,1,1,1,2,2,0,2,0,5
4748,791444,12,2,2,2,2,0,0,0,0,1,3,0,2,1,1,0,4
4748,785895,7,1,5,0,0,1,5,0,0,0,0,0,0,0,0,0,3
4748,797012,6,2,3,2,3,0,0,0,0,0,0,2,1,1,0,0,4
4748,797011,4,2,2,2,2,0,0,0,0,2,0,0,3,0,1,0,4
4749,790846,27,0,1,0,1,0,0,0,1,1,2,2,3,0,3,2,0
4749,780315,20,1,4,1,3,0,1,0,0,0,1,1,4,0,2,0,2
4749,791099,32,5,11,3,5,2,6,0,0,1,3,0,1,2,1,0,12
4749,785470,31,4,10,2,4,2,6,0,0,1,7,1,0,0,2,0,10
4749,785586,34,4,7,4,5,0,2,4,6,2,0,1,2,2,4,0,12
4749,796754,31,2,8,2,4,0,4,4,5,3,7,2,3,0,5,0,8
4749,796755,25,5,7,5,7,0,0,4,7,3,1,0,4,0,3,3,14
4750,797047,25,1,4,1,2,0,2,1,2,2,3,0,3,0,1,2,3
4750,775515,25,2,13,1,4,1,9,0,0,2,1,0,4,1,0,3,5
4750,791579,30,7,9,5,6,2,3,1,2,0,2,4,1,2,3,0,17
4750,786387,39,7,15,6,13,1,2,1,1,4,8,1,2,0,2,0,16
4750,780399,30,3,12,2,6,1,6,2,2,0,3,5,1,2,1,0,9
4750,786846,15,1,7,0,1,1,6,0,0,0,2,0,1,2,0,2,3
4750,780400,16,3,4,2,3,1,1,0,0,1,2,0,2,0,0,0,7
4750,791575,4,0,1,0,1,0,0,0,0,1,0,0,0,0,0,1,0
4750,797046,16,2,5,1,1,1,4,2,2,0,2,0,1,1,0,0,7
4751,776100,24,6,11,3,7,3,4,1,1,2,3,2,1,0,1,1,16
4751,785991,33,9,15,7,11,2,4,4,7,3,6,1,2,1,2,2,24
4751,797762,21,1,4,1,4,0,0,0,0,1,6,2,2,0,4,0,2
4751,781406,29,3,11,3,11,0,0,1,2,2,3,1,2,0,3,0,7
4751,781401,29,2,3,2,3,0,0,4,4,0,6,0,2,2,2,0,8
4751,797760,4,0,0,0,0,0,0,0,0,0,1,0,1,0,0,0,0
4751,792133,20,2,7,2,6,0,1,2,2,1,2,0,1,1,1,0,6
4751,781029,21,1,1,0,0,1,1,0,0,0,3,0,2,0,1,0,3
4751,775317,19,1,3,0,2,1,1,0,0,0,2,2,1,0,1,0,3
4752,791276,25,6,13,6,13,0,0,0,1,6,6,1,4,2,0,1,12
4752,796529,24,1,3,1,2,0,1,0,0,0,1,1,2,1,1,0,2
4752,791275,36,2,7,1,4,1,3,2,6,0,5,2,2,3,3,0,7
4752,785746,38,4,12,4,9,0,3,2,4,1,0,0,1,0,1,0,10
4752,785741,35,3,11,3,9,0,2,0,0,0,7,3,2,0,3,1,6
4752,785755,16,1,1,1,1,0,0,0,0,0,4,0,4,0,1,1,2
4752,796526,5,0,1,0,1,0,0,0,0,0,0,0,1,0,2,0,0
4752,785751,4,0,0,0,0,0,0,0,0,0,0,0,0,0,0,0,0
4752,785748,17,2,3,1,1,1,2,2,4,0,4,1,1,1,1,0,7
4753,797028,35,4,9,4,9,0,0,0,1,5,5,2,1,0,0,0,8
4753,785687,11,0,0,0,0,0,0,0,0,0,1,1,1,1,1,0,0
4753,791598,32,7,18,4,9,3,9,7,7,2,6,1,2,0,4,1,24
4753,792116,34,1,2,0,1,1,1,2,2,1,2,5,3,0,2,0,5
4753,780410,35,3,8,0,0,3,8,0,0,0,5,0,1,0,0,0,9
4753,775047,8,0,5,0,4,0,1,0,0,2,1,0,2,0,0,0,0
4753,797029,2,0,1,0,0,0,1,0,0,0,0,0,1,0,0,0,0
4753,797025,25,2,6,1,3,1,3,3,4,0,2,3,2,1,1,0,8
4753,791597,1,0,0,0,0,0,0,0,0,0,0,0,0,0,0,0,0
4753,791600,17,3,10,1,5,2,5,3,4,0,1,0,0,1,1,0,11
4754,791702,14,0,1,0,1,0,0,2,2,2,0,0,3,1,0,0,2
4754,797523,34,4,7,2,2,2,5,1,1,0,4,1,3,2,1,1,11
4754,785402,23,4,7,4,7,0,0,1,3,0,1,0,4,0,1,1,9
4754,792118,35,8,15,7,11,1,4,10,10,1,2,8,1,1,3,0,27
4754,782593,29,4,10,2,4,2,6,2,2,2,9,3,3,2,4,0,12
4754,785828,17,2,6,2,5,0,1,3,4,0,3,1,4,0,0,2,7
4754,797525,12,3,4,3,3,0,1,0,0,1,1,2,3,1,0,0,6
4754,791700,33,1,4,1,3,0,1,3,3,0,3,1,2,0,3,0,5
4754,797526,3,0,1,0,0,0,1,0,0,0,0,0,0,0,0,0,0
4755,791281,31,4,6,3,4,1,2,6,11,1,7,1,3,1,2,0,15
4755,785764,12,1,2,1,2,0,0,4,8,0,1,0,3,0,2,0,6
4755,792276,34,3,8,2,5,1,3,6,6,0,2,3,1,3,2,0,13
4755,786026,27,5,9,5,7,0,2,3,8,2,4,0,3,0,6,0,13
4755,785398,12,0,1,0,1,0,0,0,0,0,0,0,0,0,1,0,0
4755,796536,17,1,2,1,2,0,0,0,0,1,3,0,2,1,0,0,2
4755,796537,10,0,2,0,1,0,1,2,2,0,0,0,1,0,0,0,2
4755,796535,12,0,3,0,2,0,1,0,0,0,2,1,2,0,2,0,0
4755,785507,23,4,7,0,1,4,6,0,0,1,3,2,2,0,2,0,12
4755,775814,18,0,2,0,1,0,1,2,2,0,0,1,4,2,1,0,2
4755,796534,2,0,0,0,0,0,0,0,0,0,1,0,0,0,0,0,0
4755,785763,2,0,1,0,1,0,0,0,0,0,1,0,0,0,0,0,0
4756,791011,20,3,4,2,2,1,2,0,0,1,4,0,3,0,1,0,7
4756,780303,25,4,9,4,9,0,0,2,3,1,5,1,3,0,3,0,10
4756,791594,23,4,8,3,7,1,1,0,0,1,2,4,3,3,0,0,9
4756,791012,24,4,6,0,0,4,6,0,0,0,2,2,1,2,0,0,12
4756,781385,25,3,7,0,1,3,6,4,4,0,2,2,3,2,1,0,13
4756,796671,17,3,3,3,3,0,0,2,3,1,4,0,3,1,1,0,8
4756,785337,19,3,6,3,5,0,1,10,11,3,2,1,1,0,0,1,16
4756,796668,9,0,4,0,3,0,1,0,0,0,4,0,0,0,0,0,0
4756,791013,17,2,3,2,3,0,0,0,0,1,2,2,0,1,0,0,4
4756,786349,15,1,5,0,3,1,2,2,2,0,0,2,1,0,0,0,5
4756,796670,4,1,1,1,1,0,0,0,0,1,0,0,0,0,0,0,2
4756,796669,2,0,1,0,0,0,1,0,0,0,0,0,0,0,0,0,0
4757,781249,22,2,3,1,2,1,1,0,0,0,3,0,1,1,3,0,5
4757,775165,29,1,5,0,1,1,4,0,0,4,5,0,3,1,0,0,3
4757,785514,26,2,11,1,5,1,6,0,0,0,1,1,2,1,3,1,5
4757,785515,13,1,3,0,2,1,1,0,0,0,2,2,0,0,4,0,3
4757,781253,31,3,10,1,3,2,7,1,1,1,1,0,4,1,0,0,9
4757,796953,28,5,6,4,4,1,2,6,11,2,5,1,5,0,1,0,17
4757,796951,13,3,4,1,1,2,3,0,0,0,0,0,2,0,1,0,8
4757,796952,10,0,2,0,1,0,1,5,7,1,1,0,0,0,0,0,5
4757,791251,26,0,5,0,3,0,2,0,0,0,0,3,1,0,1,0,0
4757,776804,2,0,0,0,0,0,0,0,0,0,3,0,0,0,0,0,0
4758,791473,10,0,1,0,1,0,0,0,0,0,1,1,1,1,1,0,0
4758,786316,28,6,14,6,14,0,0,0,1,2,4,0,3,0,1,1,12
4758,791475,28,3,7,1,3,2,4,0,0,0,1,2,2,0,1,0,8
4758,791477,29,6,8,5,7,1,1,2,3,1,4,1,2,1,2,1,15
4758,780220,29,4,12,4,9,0,3,3,5,2,2,3,2,2,3,0,11
4758,797206,21,3,3,3,3,0,0,4,5,2,2,2,1,0,1,0,10
4758,797205,11,0,1,0,0,0,1,0,0,0,4,0,1,0,0,0,0
4758,786314,23,0,5,0,3,0,2,0,0,0,4,4,3,1,3,0,0
4758,797202,3,1,2,0,0,1,2,0,0,0,0,0,1,0,1,0,3
4758,791476,16,0,4,0,2,0,2,2,2,0,3,0,0,2,0,0,2
4758,791474,1,0,1,0,1,0,0,0,0,0,0,0,0,0,0,0,0
4758,797204,1,0,0,0,0,0,0,0,0,0,0,0,0,0,0,0,0
4759,780346,33,11,20,7,12,4,8,5,7,5,6,5,1,1,2,0,31
4759,780338,19,2,2,2,2,0,0,0,0,1,1,0,4,0,1,0,4
4759,791030,23,1,5,0,1,1,4,1,2,0,1,2,3,1,1,0,4
4759,785477,33,4,11,2,3,2,8,0,0,0,4,2,0,1,0,0,10
4759,785475,16,0,1,0,0,0,1,2,2,0,2,0,3,1,0,1,2
4759,791032,7,0,2,0,2,0,0,0,0,0,1,0,0,1,1,0,0
4759,796689,20,3,5,3,5,0,0,1,2,0,9,0,2,1,0,1,7
4759,796687,20,3,7,3,5,0,2,4,5,0,1,3,1,0,3,0,10
4759,786655,26,3,4,1,1,2,3,0,0,0,1,1,1,2,2,0,8
4759,791031,1,0,0,0,0,0,0,1,2,0,0,0,0,0,0,0,1
4759,796690,1,0,0,0,0,0,0,0,0,0,0,0,0,0,0,0,0
4759,791029,1,0,0,0,0,0,0,0,0,0,0,0,0,0,0,0,0
4760,781134,30,7,11,7,9,0,2,1,2,2,5,0,3,0,1,3,15
4760,774874,34,7,9,7,9,0,0,0,1,1,3,2,3,1,1,0,14
4760,796531,28,3,5,3,4,0,1,3,3,0,2,7,4,1,2,0,9
4760,786475,25,5,7,3,4,2,3,2,2,0,3,2,3,1,3,1,14
4760,785270,31,7,12,5,6,2,6,3,4,1,0,0,3,1,1,0,19
4760,780085,10,1,1,1,1,0,0,2,2,1,1,0,1,0,1,1,4
4760,790946,11,0,2,0,1,0,1,0,0,1,1,1,1,2,0,0,0
4760,780084,7,0,2,0,1,0,1,0,0,0,1,0,0,0,1,0,0
4760,775468,23,4,8,4,8,0,0,0,0,1,6,3,1,0,3,0,8
4760,776038,1,0,0,0,0,0,0,0,0,0,0,0,0,0,1,0,0
4761,785845,12,1,2,1,2,0,0,0,0,0,0,0,1,2,2,1,2
4761,780578,24,6,10,2,6,4,4,0,0,1,2,0,3,1,2,0,16
4761,797537,24,3,6,3,6,0,0,2,3,0,2,2,1,0,0,0,8
4761,797538,12,0,2,0,1,0,1,0,0,2,1,0,3,1,4,0,0
4761,780579,40,6,19,5,16,1,3,2,3,4,3,2,0,1,3,0,15
4761,797536,20,3,6,3,5,0,1,2,2,2,0,0,2,0,0,0,8
4761,785843,24,3,6,3,5,0,1,2,2,1,0,0,3,1,1,0,8
4761,785847,38,3,9,2,5,1,4,2,3,2,7,3,1,2,1,0,9
4761,797535,6,2,4,1,1,1,3,0,0,0,1,0,2,1,1,0,5
4762,775897,22,3,4,3,3,0,1,1,2,1,3,0,0,2,1,0,7
4762,780324,19,5,8,5,8,0,0,1,1,1,2,4,1,0,3,0,11
4762,791543,20,2,2,1,1,1,1,1,3,0,1,1,2,2,0,0,6
4762,786530,22,4,5,1,1,3,4,0,0,0,4,4,1,0,0,0,11
4762,780317,12,2,3,0,0,2,3,0,0,0,1,2,3,0,0,0,6
4762,791546,17,3,6,3,4,0,2,4,4,0,3,0,3,0,0,0,10
4762,791545,20,3,5,2,4,1,1,0,0,0,3,1,1,2,2,1,7
4762,784246,20,5,6,2,2,3,4,0,0,0,3,6,2,0,2,1,13
4762,786362,4,0,1,0,1,0,0,0,0,0,0,0,0,0,0,0,0
4762,797092,10,1,3,1,2,0,1,0,0,0,3,0,1,0,0,1,2
4762,791544,2,0,0,0,0,0,0,2,3,0,1,0,0,0,0,0,2
4762,797091,12,2,5,2,4,0,1,2,2,0,1,0,1,1,0,0,6
4762,791547,11,3,5,2,3,1,2,0,1,0,1,1,0,2,0,0,7
4762,786360,5,0,0,0,0,0,0,0,0,0,1,0,0,0,0,0,0
4762,775437,4,0,0,0,0,0,0,0,0,0,0,0,0,0,1,0,0
4763,791904,10,1,3,1,3,0,0,1,1,0,0,0,0,1,2,1,3
4763,781103,19,4,9,4,8,0,1,0,0,1,4,0,2,0,1,1,8
4763,797568,22,3,7,1,3,2,4,0,0,0,0,1,2,0,1,0,8
4763,797566,26,0,4,0,4,0,0,2,2,1,0,0,1,0,0,0,2
4763,781191,26,0,7,0,2,0,5,3,5,1,1,3,2,1,3,0,3
4763,791907,16,3,4,3,4,0,0,1,2,0,2,0,3,0,3,0,7
4763,791905,25,4,6,3,4,1,2,2,2,2,4,0,2,0,2,0,11
4763,781364,21,0,4,0,4,0,0,0,2,2,4,0,1,1,0,0,0
4763,781102,19,1,5,1,4,0,1,0,0,2,3,2,0,1,2,0,2
4763,797570,5,0,0,0,0,0,0,0,0,0,0,0,0,0,1,0,0
4763,791909,4,1,1,1,1,0,0,0,0,0,0,0,0,0,0,0,2
4763,791906,7,0,3,0,2,0,1,0,0,0,2,2,3,0,1,0,0
4764,790870,18,3,4,3,4,0,0,4,6,1,5,1,3,1,4,0,10
4764,780493,21,9,13,4,4,5,9,0,1,2,4,1,1,0,1,1,23
4764,790869,23,6,9,4,6,2,3,8,9,1,2,2,1,2,1,0,22
4764,780116,21,0,4,0,1,0,3,2,2,1,5,1,2,1,1,0,2
4764,790866,17,2,7,0,2,2,5,4,4,0,1,2,0,0,2,0,10
4764,796426,11,2,3,2,3,0,0,1,2,1,2,1,0,0,0,0,5
4764,796425,5,0,1,0,1,0,0,0,0,0,0,1,2,0,1,0,0
4764,780492,9,1,1,1,1,0,0,0,0,0,2,0,0,0,1,0,2
4764,796428,16,0,2,0,2,0,0,4,6,0,4,2,1,0,2,0,4
4764,796427,17,1,3,1,1,0,2,0,0,0,0,1,1,0,0,0,2
4764,796424,19,0,3,0,0,0,3,0,0,1,4,1,0,1,0,0,0
4764,796422,4,2,2,1,1,1,1,0,0,1,1,0,0,1,0,0,5
4764,796421,15,3,4,3,3,0,1,0,0,2,3,0,3,1,0,0,6
4764,783997,4,1,2,0,0,1,2,0,2,0,1,1,0,0,0,0,3
4766,790899,21,4,6,4,6,0,0,1,2,2,0,0,3,0,1,0,9
4766,785442,28,4,9,3,6,1,3,1,2,4,2,1,5,1,2,0,10
4766,790898,26,2,7,1,3,1,4,0,0,1,3,1,3,2,2,0,5
4766,785579,39,3,11,2,8,1,3,4,6,0,2,2,0,3,2,0,11
4766,775737,12,0,4,0,1,0,3,0,0,0,2,1,0,0,0,0,0
4766,796447,9,1,1,1,1,0,0,0,0,0,1,0,2,1,0,0,2
4766,799907,15,1,5,1,4,0,1,0,0,0,0,2,0,1,5,0,2
4766,775959,10,1,3,1,2,0,1,1,2,1,1,0,1,1,0,0,3
4766,790897,22,4,9,1,3,3,6,1,1,1,3,0,3,0,1,0,12
4766,785448,18,2,5,1,3,1,2,1,2,0,5,1,3,1,0,0,6
4767,781342,31,1,6,1,6,0,0,3,4,2,9,2,2,0,4,4,5
4767,781593,28,1,4,1,2,0,2,0,3,1,2,1,3,0,3,2,2
4767,790901,27,1,7,0,2,1,5,2,4,0,2,1,1,1,2,1,5
4767,785452,32,6,7,6,7,0,0,8,9,2,2,2,0,2,0,0,20
4767,781620,20,2,4,2,3,0,1,0,0,1,4,2,2,1,2,0,4
4767,790902,26,5,7,2,2,3,5,0,0,0,0,1,2,1,3,2,13
4767,790904,2,1,1,1,1,0,0,0,0,0,0,0,1,0,0,0,2
4767,790903,18,0,4,0,0,0,4,0,0,0,0,1,0,0,1,0,0
4767,796450,14,5,5,5,5,0,0,3,3,0,1,0,1,0,0,0,13
4767,796452,2,0,1,0,0,0,1,0,0,0,0,0,0,0,0,0,0
4768,785829,34,10,13,10,13,0,0,5,5,5,6,1,3,1,3,0,25
4768,775838,23,2,6,2,6,0,0,0,0,1,2,4,2,3,0,0,4
4768,786531,28,1,8,0,3,1,5,3,4,0,2,1,4,1,3,0,6
4768,796726,17,1,5,1,5,0,0,6,6,1,2,1,3,2,3,0,8
4768,791048,24,4,9,3,6,1,3,1,2,1,2,3,2,0,0,1,10
4768,796724,24,2,5,2,4,0,1,0,0,1,2,2,2,0,2,0,4
4768,796727,23,5,7,2,2,3,5,0,0,1,2,1,1,0,1,1,13
4768,791044,8,1,1,1,1,0,0,2,2,0,1,0,0,0,0,1,4
4768,796729,19,4,5,3,4,1,1,2,2,1,1,2,1,1,2,0,11
4769,791171,17,1,1,1,1,0,0,0,0,0,2,1,5,1,2,0,2
4769,796837,29,4,7,3,5,1,2,0,0,1,3,2,4,0,3,0,9
4769,785700,36,6,12,4,7,2,5,0,0,0,6,7,3,3,0,0,14
4769,786721,35,4,11,2,6,2,5,4,4,3,0,4,1,3,2,1,14
4769,785706,32,3,10,2,4,1,6,2,2,0,3,0,2,0,1,0,9
4769,796833,24,5,9,2,2,3,7,9,10,0,0,0,3,2,1,0,22
4769,796834,9,2,2,2,2,0,0,1,1,0,0,0,0,0,2,0,5
4769,796836,14,1,3,1,3,0,0,0,0,1,3,0,0,0,2,1,2
4769,796838,4,0,0,0,0,0,0,0,0,0,0,0,1,1,1,0,0
4774,791917,16,2,7,2,2,0,5,0,0,0,4,1,3,0,0,0,4
4774,786526,30,7,12,7,10,0,2,2,2,3,6,5,4,1,1,1,16
4774,786525,29,3,8,3,5,0,3,2,2,1,0,3,2,1,0,0,8
4774,791914,23,4,11,0,3,4,8,0,0,0,2,1,2,0,3,0,12
4774,786030,20,3,7,3,4,0,3,0,2,0,1,0,4,1,1,0,6
4774,781109,28,2,5,1,2,1,3,4,4,0,6,1,3,0,1,0,9
4774,797550,23,2,7,1,1,1,6,0,0,0,1,1,0,0,0,1,5
4774,786856,12,1,3,1,3,0,0,0,0,0,0,1,2,0,0,0,2
4774,786524,17,3,5,0,2,3,3,1,2,1,0,6,1,0,0,0,10
4774,797551,2,0,0,0,0,0,0,1,2,1,0,0,1,0,0,0,1
4775,780027,24,7,12,6,9,1,3,2,2,0,10,2,1,0,2,2,17
4775,786176,27,6,10,4,7,2,3,2,4,1,3,3,2,0,0,0,16
4775,786173,24,4,7,1,1,3,6,2,2,0,1,3,0,0,0,0,13
4775,780028,23,1,2,1,1,0,1,1,2,2,2,4,3,0,0,0,3
4775,774828,25,4,7,1,2,3,5,0,0,0,4,4,1,0,0,0,11
4775,797175,16,4,4,4,4,0,0,0,0,2,5,2,2,1,3,2,8
4775,780029,17,3,5,2,3,1,2,5,6,0,1,0,0,0,1,0,12
4775,791380,13,1,3,1,3,0,0,3,4,1,4,3,3,1,3,0,5
4775,791379,13,1,2,1,1,0,1,3,4,0,1,1,0,0,0,2,5
4775,797178,6,2,2,2,2,0,0,0,0,0,0,0,0,0,0,0,4
4775,797176,4,0,1,0,0,0,1,0,0,0,0,0,0,0,0,0,0
4775,797179,4,0,0,0,0,0,0,2,2,0,0,0,1,0,0,0,2
4775,780026,2,0,2,0,0,0,2,0,0,0,0,0,0,0,0,0,0
4775,786170,2,0,0,0,0,0,0,0,0,0,0,0,1,0,0,0,0
4776,792486,25,5,7,3,5,2,2,0,0,0,2,0,0,2,0,1,12
4776,785772,17,2,4,2,4,0,0,0,0,1,0,0,2,0,2,0,4
4776,785778,30,8,13,8,13,0,0,5,8,1,5,3,3,2,1,1,21
4776,785766,10,1,4,0,0,1,4,2,2,0,3,0,1,0,3,0,5
4776,780543,28,1,8,1,7,0,1,0,0,0,2,3,0,0,1,0,2
4776,792481,12,2,4,2,4,0,0,2,2,2,0,1,2,0,4,0,6
4776,792488,12,0,3,0,2,0,1,0,0,1,1,0,0,0,1,0,0
4776,780544,11,0,0,0,0,0,0,0,0,0,1,0,1,1,1,0,0
4776,797419,21,3,6,1,3,2,3,2,2,0,3,2,5,5,0,0,10
4776,792482,25,3,5,1,1,2,4,3,3,2,3,5,2,3,1,0,11
4776,792489,6,0,1,0,1,0,0,0,0,0,1,0,0,0,0,0,0
4776,797417,1,0,0,0,0,0,0,0,0,0,0,0,0,0,0,0,0
4776,792484,1,0,0,0,0,0,0,0,0,0,0,0,0,0,0,0,0
4776,785774,1,0,0,0,0,0,0,0,0,0,0,0,0,0,0,0,0
4777,796550,31,6,12,3,4,3,8,2,2,1,6,0,2,1,1,1,17
4777,785275,29,4,7,4,6,0,1,1,2,3,4,2,4,1,6,1,9
4777,790956,22,1,4,0,1,1,3,0,0,0,2,1,1,2,2,1,3
4777,785089,32,4,12,3,8,1,4,3,5,1,2,1,4,3,3,0,12
4777,780460,32,2,7,2,3,0,4,2,5,0,3,8,4,3,6,0,6
4777,796549,11,1,1,1,1,0,0,0,0,0,2,1,1,0,1,1,2
4777,796551,21,3,6,3,5,0,1,0,0,2,3,1,2,0,2,1,6
4777,796547,21,2,2,2,2,0,0,0,0,0,1,0,1,0,0,0,4
4777,785276,1,0,0,0,0,0,0,0,0,0,0,0,0,0,0,0,0
4778,791140,20,3,3,3,3,0,0,1,3,1,5,4,4,0,1,0,7
4778,791138,23,3,6,2,3,1,3,0,1,0,4,0,3,0,0,0,7
4778,786084,33,3,7,1,2,2,5,3,6,1,3,4,2,2,2,0,11
4778,780910,31,1,13,1,11,0,2,12,13,1,4,5,1,4,6,0,14
4778,780288,27,3,6,2,4,1,2,1,4,1,0,4,4,0,1,0,8
4778,796794,4,0,0,0,0,0,0,0,0,0,1,0,0,0,0,0,0
4778,796795,20,5,10,5,10,0,0,2,3,2,4,2,4,1,2,1,12
4778,780912,7,2,2,0,0,2,2,0,0,0,0,0,1,1,0,0,6
4778,780911,22,6,9,2,3,4,6,8,8,1,3,3,1,2,0,2,24
4778,781635,13,2,2,1,1,1,1,2,2,0,0,1,0,0,0,0,7
4779,786459,32,6,13,6,13,0,0,10,13,6,5,3,3,3,4,0,22
4779,781612,20,7,10,6,9,1,1,5,6,1,3,1,4,0,0,2,20
4779,797005,15,3,5,1,2,2,3,0,0,0,0,1,2,0,1,1,8
4779,797004,27,2,4,2,3,0,1,3,4,0,0,4,4,2,6,0,7
4779,781609,36,5,14,5,12,0,2,0,2,1,14,3,5,1,0,0,10
4779,797006,23,3,6,2,4,1,2,2,3,1,1,1,3,1,2,0,9
4779,791360,26,1,4,0,1,1,3,0,0,0,2,2,4,1,0,0,3
4779,797003,21,3,5,3,5,0,0,2,2,0,1,0,3,0,2,0,8
4780,781158,18,5,10,5,10,0,0,0,0,2,5,0,2,0,0,0,10
4780,781652,40,2,7,1,4,1,3,4,5,3,4,1,2,1,5,0,9
4780,791615,34,5,11,5,7,0,4,0,0,1,4,1,1,0,0,0,10
4780,786419,35,3,12,2,8,1,4,7,8,2,4,3,2,0,0,0,14
4780,781283,34,1,8,1,3,0,5,3,4,1,2,2,2,0,0,0,5
4780,781653,21,4,5,4,5,0,0,0,0,2,6,0,3,0,2,0,8
4780,785277,18,0,5,0,0,0,5,1,3,0,2,1,2,0,0,0,1
4781,792417,30,3,6,2,3,1,3,0,0,1,7,1,3,0,3,0,7
4781,786861,38,1,6,0,2,1,4,0,0,0,6,1,1,0,1,1,3
4781,786867,36,2,12,1,2,1,10,0,0,0,1,0,1,0,1,0,5
4781,780387,40,5,12,5,8,0,4,3,6,2,7,3,3,1,3,0,13
4781,767033,27,2,8,0,4,2,4,0,0,1,3,3,5,1,1,0,6
4781,796870,7,1,3,1,3,0,0,2,2,1,2,0,0,0,0,0,4
4781,792416,15,1,4,0,2,1,2,2,2,0,1,1,4,1,2,0,5
4781,786866,7,2,2,0,0,2,2,0,0,0,1,0,3,0,0,0,6
4782,775820,23,2,4,1,2,1,2,0,0,0,4,1,2,0,0,1,5
4782,775538,24,3,5,3,5,0,0,0,0,3,7,0,2,0,3,1,6
4782,791110,37,7,15,7,12,0,3,6,10,1,1,1,1,2,0,0,20
4782,785603,36,4,11,4,10,0,1,2,2,1,2,5,2,3,2,0,10
4782,776425,33,4,9,2,4,2,5,0,0,1,1,4,0,0,1,0,10
4782,796763,7,0,0,0,0,0,0,0,0,0,1,1,1,0,0,0,0
4782,791107,5,0,1,0,0,0,1,0,0,0,1,0,2,0,1,0,0
4782,791106,21,3,6,2,3,1,3,0,0,0,1,0,1,1,0,0,7
4782,786494,14,3,5,1,3,2,2,0,0,0,1,0,1,0,1,0,8
4783,797591,19,3,5,1,2,2,3,0,0,1,2,0,2,0,0,0,8
4783,781071,29,3,6,1,2,2,4,0,0,1,2,0,0,0,2,1,8
4783,791889,25,1,2,0,1,1,1,0,0,0,3,1,2,0,0,0,3
4783,791890,34,4,12,4,8,0,4,2,2,0,3,6,2,1,4,0,10
4783,780719,37,6,11,3,6,3,5,0,0,0,8,2,2,1,3,0,15
4783,785424,14,1,1,1,1,0,0,1,2,2,2,0,1,0,0,1,3
4783,780098,12,2,2,2,2,0,0,1,1,0,1,1,1,0,0,0,5
4783,797589,28,5,13,3,9,2,4,4,4,1,2,1,0,0,2,1,16
4783,797588,2,0,0,0,0,0,0,0,0,0,0,0,0,0,0,0,0
4784,790839,28,2,7,0,1,2,6,6,6,0,5,1,1,2,2,0,12
4784,785388,19,6,10,6,10,0,0,1,6,6,5,1,3,1,1,0,13
4784,790840,29,4,10,3,5,1,5,4,4,0,5,1,3,0,2,3,13
4784,785386,31,4,8,4,5,0,3,6,6,3,1,5,2,0,3,0,14
4784,780373,34,5,12,2,2,3,10,2,3,1,5,2,2,1,2,0,15
4784,796393,20,2,5,2,5,0,0,3,4,2,4,0,3,0,1,2,7
4784,780370,12,0,2,0,0,0,2,0,0,0,2,0,0,1,0,2,0
4784,796395,13,2,7,2,2,0,5,2,4,1,2,1,1,0,0,0,6
4784,790841,10,0,1,0,0,0,1,0,0,0,1,1,1,0,0,0,0
4784,796396,4,0,0,0,0,0,0,0,0,0,0,0,0,0,0,0,0
4785,792005,26,2,11,1,4,1,7,2,2,2,3,0,2,0,1,1,7
4785,781175,27,5,7,5,7,0,0,4,8,10,4,3,4,0,0,1,14
4785,786553,34,9,22,4,9,5,13,0,0,1,1,0,2,1,1,1,23
4785,780895,29,5,19,5,15,0,4,2,2,3,6,2,5,2,0,0,12
4785,781172,29,1,6,0,2,1,4,0,1,0,6,3,2,4,4,0,3
4785,786555,22,1,5,0,0,1,5,0,0,0,0,2,2,0,0,0,3
4785,781177,13,2,5,0,0,2,5,0,0,2,3,0,5,0,0,0,6
4785,785312,18,2,6,2,5,0,1,0,0,0,2,1,2,0,0,0,4
4785,797503,2,0,1,0,1,0,0,0,0,0,0,0,2,0,0,0,0
4786,788113,18,1,4,1,2,0,2,0,0,1,1,1,4,1,2,0,2
4786,776497,33,1,10,1,4,0,6,4,4,4,3,1,5,2,3,2,6
4786,785731,36,11,18,8,13,3,5,5,8,2,10,4,4,1,6,1,30
4786,785729,34,1,5,1,4,0,1,2,2,1,1,2,3,1,0,0,4
4786,780864,31,9,16,2,4,7,12,2,2,1,4,3,1,3,2,1,27
4786,799881,7,1,3,1,3,0,0,2,3,0,2,0,1,0,1,0,4
4786,792402,12,0,2,0,0,0,2,0,0,0,2,1,2,0,2,0,0
4786,796211,4,0,2,0,0,0,2,0,0,0,0,0,0,0,0,0,0
4786,786231,24,1,10,0,3,1,7,3,4,3,3,1,2,1,1,0,6
4786,785443,1,0,1,0,1,0,0,0,0,0,0,0,0,0,0,0,0
4787,791161,25,3,6,0,0,3,6,0,0,1,5,0,3,1,2,1,9
4787,786690,23,2,4,2,3,0,1,2,3,1,5,1,5,0,0,1,6
4787,780629,33,7,11,7,10,0,1,5,8,1,5,0,4,3,4,0,19
4787,774845,38,3,13,0,5,3,8,0,0,0,1,8,4,3,7,0,9
4787,775888,37,5,12,3,8,2,4,9,11,2,10,6,4,5,4,3,21
4787,796816,17,2,4,1,2,1,2,6,7,1,3,2,2,1,2,0,11
4787,785346,27,4,8,1,2,3,6,3,3,0,3,1,2,0,3,0,14
4788,792171,32,4,8,4,7,0,1,2,3,0,6,4,3,2,3,5,10
4788,785674,29,5,14,4,7,1,7,2,2,0,4,2,1,0,1,0,13
4788,797784,25,3,7,3,4,0,3,0,2,1,0,2,3,1,1,0,6
4788,789059,35,4,8,2,3,2,5,4,7,1,3,2,4,0,2,0,14
4788,780980,25,0,1,0,0,0,1,2,3,0,2,0,3,1,0,0,2
4788,797783,18,0,2,0,2,0,0,1,2,1,2,1,2,0,0,0,1
4788,780049,13,4,5,3,4,1,1,1,2,0,2,2,2,0,1,0,10
4788,792173,23,1,2,0,1,1,1,5,5,2,1,1,0,1,0,0,8
4789,785836,40,4,10,3,5,1,5,3,4,5,4,0,2,0,0,1,12
4789,785833,24,3,9,3,4,0,5,8,10,3,3,1,4,0,2,0,14
4789,785332,13,1,8,1,7,0,1,0,0,2,4,2,1,1,2,0,2
4789,791704,36,3,7,3,5,0,2,0,1,3,6,3,4,0,0,0,6
4789,785838,35,3,10,2,4,1,6,0,0,0,4,3,5,0,1,0,7
4789,775872,15,3,3,0,0,3,3,3,4,2,0,1,3,1,0,0,12
4789,797533,3,0,0,0,0,0,0,0,0,0,0,0,0,0,1,0,0
4789,791707,10,1,4,0,2,1,2,0,0,0,1,2,1,0,2,0,3
4789,785892,24,4,8,1,2,3,6,0,2,0,2,0,1,0,1,0,11
4790,792277,11,2,2,2,2,0,0,0,0,0,2,0,3,0,1,0,4
4790,786516,23,2,3,0,0,2,3,1,2,0,0,0,2,0,0,0,7
4790,781464,25,1,4,1,2,0,2,0,2,0,1,2,3,1,1,0,2
4790,781502,34,5,9,5,6,0,3,4,6,0,5,1,0,0,2,0,14
4790,780259,30,4,10,3,8,1,2,3,4,1,2,1,3,2,4,0,12
4790,785913,26,2,4,2,4,0,0,3,8,1,3,0,1,0,2,0,7
4790,798058,10,1,3,1,2,0,1,4,4,1,0,0,0,1,2,0,6
4790,785282,27,3,7,3,4,0,3,0,0,0,1,2,1,0,0,0,6
4790,781501,14,0,3,0,1,0,2,0,0,3,1,1,0,2,1,0,0
4791,790833,21,2,4,1,3,1,1,0,2,0,2,0,5,1,3,0,5
4791,785518,27,4,6,4,6,0,0,0,0,3,3,4,4,3,6,0,8
4791,796390,10,0,0,0,0,0,0,0,2,1,1,0,3,0,1,0,0
4791,790834,29,4,7,2,4,2,3,2,2,0,2,0,1,1,1,0,12
4791,785377,20,0,1,0,0,0,1,2,2,0,3,1,3,0,1,0,2
4791,780297,9,1,2,1,2,0,0,0,0,1,1,0,1,0,2,0,2
4791,790832,19,0,6,0,2,0,4,0,1,0,0,2,0,1,3,0,0
4791,785451,28,5,13,4,7,1,6,2,2,3,4,1,1,2,1,0,13
4791,790831,23,5,6,5,6,0,0,0,0,3,7,0,2,0,2,3,10
4791,785379,14,1,1,1,1,0,0,3,4,0,0,1,0,0,0,0,5
4792,797103,29,5,10,5,10,0,0,2,6,3,8,2,1,0,1,0,12
4792,791414,26,1,6,1,3,0,3,0,2,2,3,0,0,0,0,0,2
4792,791413,27,5,10,3,7,2,3,2,3,1,2,0,3,1,1,0,14
4792,791411,22,2,5,0,1,2,4,0,0,0,1,2,1,0,2,0,6
4792,785776,32,2,6,2,5,0,1,1,2,0,4,4,4,0,3,0,5
4792,797102,10,0,1,0,1,0,0,0,0,1,2,1,1,0,2,0,0
4792,785911,9,0,1,0,0,0,1,0,0,1,1,0,3,0,4,0,0
4792,797100,21,4,7,4,7,0,0,2,2,0,3,0,2,1,2,1,10
4792,781209,24,6,10,3,5,3,5,4,5,0,0,1,1,1,1,0,19
4793,791391,31,5,8,5,8,0,0,1,3,0,6,0,5,2,0,3,11
4793,791390,23,4,5,4,5,0,0,1,2,2,3,5,3,1,0,0,9
4793,776446,31,3,6,0,1,3,5,2,2,1,1,3,0,0,1,0,11
4793,780133,34,4,10,4,7,0,3,0,0,1,2,1,2,1,2,0,8
4793,780130,31,6,13,6,9,0,4,6,6,0,2,0,2,1,1,0,18
4793,797156,10,1,1,1,1,0,0,0,0,1,1,3,0,1,1,0,2
4793,791388,14,1,5,1,2,0,3,0,1,1,5,0,0,0,0,0,2
4793,775743,18,4,9,2,5,2,4,3,3,0,2,0,0,1,2,0,13
4793,797158,7,0,0,0,0,0,0,0,0,0,2,0,4,0,1,0,0
4793,780407,1,0,0,0,0,0,0,0,0,0,0,0,0,0,0,0,0
4794,785509,32,1,3,0,1,1,2,0,0,0,1,0,4,0,1,0,3
4794,791424,35,9,13,9,11,0,2,0,1,1,5,2,0,1,1,1,18
4794,797085,39,2,9,2,4,0,5,4,5,0,13,3,1,0,5,0,8
4794,791421,36,6,13,4,6,2,7,4,4,0,2,2,1,0,3,0,18
4794,785899,38,1,4,0,1,1,3,1,2,1,2,2,3,1,3,0,4
4794,791425,13,0,4,0,3,0,1,2,2,1,0,0,2,1,0,2,2
4794,797090,10,0,0,0,0,0,0,0,0,3,1,0,2,0,1,0,0
4794,797088,7,1,3,1,1,0,2,0,0,0,1,0,0,0,0,0,2
4794,797087,15,1,1,1,1,0,0,0,0,0,2,0,1,0,0,0,2
4795,798157,28,0,0,0,0,0,0,0,2,1,2,0,0,4,0,0,0
4795,786635,42,5,12,5,11,0,1,5,7,0,6,1,3,3,1,0,15
4795,781543,37,1,9,1,8,0,1,0,1,3,5,4,5,2,4,0,2
4795,781388,14,0,1,0,1,0,0,1,2,0,1,0,2,0,2,0,1
4795,780642,38,8,18,6,14,2,4,1,2,1,0,1,2,1,4,0,19
4795,797383,14,3,4,2,2,1,2,0,1,2,6,0,2,0,0,0,7
4795,791823,3,0,1,0,0,0,1,0,0,0,0,0,1,0,0,0,0
4795,791822,41,3,10,0,3,3,7,0,0,2,2,2,2,0,0,0,9
4795,786632,7,1,2,0,1,1,1,0,0,0,0,0,0,0,0,0,3
4795,791821,1,0,0,0,0,0,0,0,0,0,0,0,0,0,0,0,0
4796,791299,17,2,3,2,3,0,0,0,0,0,1,2,4,0,1,0,4
4796,786397,37,5,9,4,6,1,3,2,3,1,7,0,4,1,0,1,13
4796,775871,37,1,2,1,2,0,0,1,2,1,4,0,3,1,2,1,3
4796,796591,26,2,6,1,2,1,4,0,0,1,3,1,3,0,1,0,5
4796,791519,40,5,16,5,13,0,3,7,11,2,3,5,2,1,4,0,17
4796,792084,8,1,2,1,2,0,0,0,0,0,2,0,2,0,0,0,2
4796,786276,31,2,10,0,1,2,9,4,6,1,1,2,0,0,1,0,10
4796,796590,4,0,1,0,1,0,0,0,0,0,0,0,0,0,0,0,0
4797,799906,35,3,8,2,5,1,3,3,4,1,6,1,4,1,1,0,10
4797,775833,22,3,3,3,3,0,0,3,4,1,7,2,3,0,1,0,9
4797,785439,23,2,5,1,3,1,2,0,0,0,1,6,3,1,1,0,5
4797,781036,39,8,13,3,6,5,7,2,2,1,4,4,3,2,2,0,23
4797,774894,38,3,9,1,2,2,7,2,3,0,0,4,0,0,1,0,10
4797,796846,3,0,0,0,0,0,0,0,0,0,1,0,0,0,0,0,0
4797,796847,18,3,4,3,4,0,0,0,1,0,4,0,2,0,1,0,6
4797,791178,4,2,2,2,2,0,0,0,0,0,1,0,0,0,0,0,4
4797,796845,18,0,2,0,1,0,1,0,0,0,2,2,0,0,2,0,0
4798,788866,4,1,1,1,1,0,0,0,0,0,0,0,4,0,1,0,2
4798,781659,28,0,5,0,5,0,0,2,2,1,5,3,4,0,3,0,2
4798,796854,27,2,7,2,5,0,2,3,5,1,4,4,4,1,4,0,7
4798,782162,40,5,16,3,8,2,8,5,6,2,4,2,3,0,3,2,17
4798,796851,38,8,12,1,1,7,11,6,11,2,4,0,4,0,1,0,29
4798,790494,13,1,1,1,1,0,0,2,2,1,2,0,0,0,0,0,4
4798,781411,15,0,0,0,0,0,0,2,2,1,2,0,4,0,0,5,2
4798,796853,15,1,5,1,4,0,1,0,0,1,1,0,2,0,0,0,2
4798,792683,9,0,2,0,1,0,1,0,2,0,1,1,2,0,1,0,0
4798,780610,34,4,13,1,2,3,11,3,4,0,3,2,3,2,0,0,14
4798,796855,2,0,0,0,0,0,0,0,0,0,0,0,0,0,0,0,0
4799,791781,9,1,1,1,1,0,0,0,0,0,1,0,2,0,1,0,2
4799,791780,27,4,7,4,4,0,3,5,6,0,5,1,4,0,2,0,13
4799,791777,43,3,18,3,15,0,3,8,11,4,8,2,2,0,3,0,14
4799,781025,35,3,6,2,3,1,3,0,2,1,1,1,2,0,1,0,7
4799,786474,38,5,13,3,9,2,4,7,8,1,6,6,5,2,0,1,19
4799,786476,11,1,3,1,3,0,0,1,2,0,0,0,2,0,0,0,3
4799,776285,18,3,5,3,5,0,0,2,4,2,3,1,3,1,0,1,8
4799,791776,10,1,4,1,1,0,3,0,0,0,1,0,2,0,1,0,2
4799,791829,8,2,3,1,1,1,2,1,1,1,0,1,0,0,1,0,6
4799,775503,15,1,6,0,3,1,3,2,3,2,4,0,3,1,0,1,5
4799,791778,11,2,4,2,4,0,0,0,1,2,0,0,1,0,0,0,4
4800,785987,28,1,6,0,0,1,6,0,0,0,5,2,1,0,1,0,3
4800,776037,31,3,10,3,8,0,2,2,2,1,4,2,5,2,2,1,8
4800,780588,31,8,12,8,12,0,0,3,7,3,8,2,1,0,3,0,19
4800,786147,36,4,16,1,8,3,8,2,2,1,5,3,4,2,1,2,13
4800,775680,29,2,10,1,3,1,7,1,2,0,3,1,3,2,2,0,6
4800,781647,20,4,7,3,5,1,2,2,2,1,5,1,4,2,0,0,11
4800,791759,25,1,5,1,3,0,2,1,2,1,3,1,2,3,1,0,3
4801,786203,35,3,10,0,4,3,6,0,0,0,6,3,1,1,1,0,9
4801,786197,25,3,7,1,4,2,3,3,6,3,7,2,3,1,3,0,11
4801,780717,34,5,16,5,13,0,3,5,5,1,11,1,2,1,5,0,15
4801,791742,37,5,12,3,9,2,3,3,6,0,4,5,2,1,0,1,15
4801,776266,34,2,6,0,3,2,3,2,4,1,4,1,1,0,2,0,8
4801,776328,24,2,3,0,1,2,2,2,4,1,5,4,3,0,2,1,8
4801,791738,2,0,1,0,1,0,0,0,0,0,0,0,0,0,0,0,0
4801,791740,6,1,1,1,1,0,0,1,1,0,0,0,0,1,1,0,3
4801,791741,3,0,0,0,0,0,0,0,0,0,1,0,2,0,1,0,0
4802,791548,29,9,12,8,8,1,4,3,4,0,7,4,2,1,3,1,22
4802,791550,26,3,4,3,4,0,0,1,3,1,2,0,2,0,3,0,7
4802,797080,29,2,7,2,3,0,4,0,2,1,3,2,3,0,2,0,4
4802,786365,33,5,10,3,5,2,5,0,0,0,1,1,1,0,2,0,12
4802,786364,27,3,5,3,5,0,0,0,0,1,2,5,3,1,1,0,6
4802,797082,6,1,2,1,2,0,0,3,4,1,1,0,1,0,2,0,5
4802,786366,11,1,3,1,3,0,0,2,3,2,2,0,2,0,1,0,4
4802,780332,13,1,2,0,0,1,2,2,2,1,0,1,0,0,0,2,5
4802,791549,11,0,5,0,2,0,3,2,2,2,2,0,1,1,0,0,2
4802,780330,15,1,3,1,2,0,1,1,2,1,2,1,1,3,0,0,3
4803,791465,28,5,8,5,8,0,0,0,1,4,3,5,2,1,1,0,10
4803,780200,17,1,3,1,3,0,0,0,0,1,2,0,2,1,1,0,2
4803,791464,28,6,12,1,2,5,10,2,2,0,4,1,3,1,2,0,19
4803,786304,26,2,5,2,3,0,2,0,0,1,3,1,2,0,2,0,4
4803,780197,36,7,11,3,5,4,6,4,5,2,3,2,0,1,3,0,22
4803,798342,23,4,8,2,3,2,5,1,2,0,0,3,3,1,0,1,11
4803,786303,1,0,0,0,0,0,0,0,0,0,0,0,2,0,0,0,0
4803,780616,6,0,2,0,1,0,1,0,0,0,0,0,2,0,2,0,0
4803,798341,2,0,1,0,1,0,0,0,0,0,0,0,0,1,0,0,0
4803,798343,1,0,0,0,0,0,0,0,0,0,0,0,2,0,1,0,0
4803,780196,32,2,7,2,6,0,1,0,0,1,2,5,2,1,0,0,4
4804,787782,34,8,10,3,4,5,6,2,2,0,4,5,2,1,2,0,23
4804,776068,31,6,12,4,6,2,6,8,13,2,7,5,2,0,2,0,22
4804,791540,33,5,8,2,4,3,4,1,2,1,2,3,3,0,4,1,14
4804,783072,24,2,2,2,2,0,0,2,2,1,3,1,3,1,0,0,6
4804,774879,7,1,2,1,2,0,0,1,1,0,0,0,4,0,2,2,3
4804,797817,26,3,7,3,6,0,1,7,8,2,7,1,3,0,2,0,13
4804,792153,21,3,4,0,1,3,3,1,2,1,3,4,0,0,0,0,10
4804,793057,5,1,2,0,1,1,1,0,0,0,0,0,0,0,0,0,3
4804,781463,19,0,3,0,0,0,3,0,0,0,1,1,2,1,0,0,0
4805,797807,40,9,14,5,10,4,4,4,5,0,0,1,0,0,2,0,26
4805,797802,40,6,12,5,10,1,2,2,4,0,1,4,3,3,2,0,15
4805,797809,27,3,8,3,7,0,1,5,5,1,6,0,5,2,1,0,11
4805,795730,19,1,6,1,4,0,2,2,2,0,0,1,0,1,0,0,4
4805,786058,6,0,1,0,1,0,0,0,0,1,0,1,3,1,0,0,0
4805,792264,29,6,8,3,4,3,4,1,2,1,5,2,5,0,0,0,16
4805,797810,27,1,4,0,1,1,3,2,2,1,3,1,3,2,3,0,5
4805,797811,6,0,1,0,1,0,0,2,2,0,0,1,2,0,0,2,2
4805,797814,3,0,1,0,0,0,1,0,0,0,0,0,0,0,0,0,0
4805,797812,3,0,1,0,1,0,0,0,0,0,1,0,1,0,0,0,0
4810,796812,17,6,11,6,11,0,0,0,0,1,3,2,1,1,1,1,12
4810,780952,36,4,8,4,8,0,0,1,2,2,6,2,3,1,3,2,9
4810,786609,37,4,11,3,7,1,4,5,8,3,3,2,0,6,2,1,14
4810,785752,30,1,3,0,1,1,2,4,4,1,2,3,4,1,2,0,7
4810,796810,38,6,16,2,9,4,7,2,4,2,1,5,4,1,2,0,18
4810,780945,3,0,1,0,1,0,0,0,2,0,0,0,1,0,1,0,0
4810,780950,26,2,8,1,2,1,6,2,2,1,0,0,2,1,0,0,7
4810,791154,2,0,1,0,1,0,0,0,0,0,2,0,0,0,0,0,0
4810,791156,11,1,1,1,1,0,0,1,1,0,1,0,4,1,2,0,3
4811,786180,16,3,4,3,4,0,0,0,0,1,2,0,2,0,0,1,6
4811,792104,33,2,9,1,5,1,4,7,10,0,6,1,1,1,4,2,12
4811,797708,36,6,11,3,6,3,5,3,6,2,2,6,1,3,3,1,18
4811,786198,5,0,1,0,0,0,1,0,0,0,0,0,0,0,0,1,0
4811,775779,27,3,4,3,4,0,0,5,6,0,1,2,4,2,4,0,11
4811,776327,3,0,1,0,1,0,0,0,0,0,1,0,0,0,0,0,0
4811,797709,19,0,3,0,1,0,2,0,0,0,2,1,1,0,3,3,0
4811,797707,28,4,5,4,5,0,0,2,3,2,3,2,2,2,4,0,10
4811,786204,20,5,8,2,5,3,3,2,2,1,4,1,3,0,0,0,15
4811,785608,11,1,2,1,2,0,0,0,0,1,0,0,3,0,0,0,2
4811,792106,2,0,1,0,1,0,0,0,0,0,0,0,1,0,0,0,0
4812,785509,26,0,2,0,0,0,2,0,3,1,1,1,4,0,2,0,0
4812,791424,33,3,9,3,7,0,2,1,3,3,4,4,5,0,0,1,7
4812,797085,23,5,9,3,4,2,5,4,5,0,4,0,4,1,1,0,16
4812,791421,37,9,16,8,10,1,6,0,1,0,2,4,1,0,1,0,19
4812,785899,37,2,5,1,2,1,3,4,4,1,4,0,3,1,4,0,9
4812,791425,22,3,6,3,6,0,0,3,4,2,2,0,2,0,1,3,9
4812,797088,4,1,1,0,0,1,1,0,0,0,1,0,0,0,1,1,3
4812,797087,18,1,2,1,1,0,1,0,0,1,1,0,0,0,0,0,2
4813,798157,12,2,3,2,3,0,0,0,0,0,2,0,2,0,0,0,4
4813,786635,38,9,16,7,14,2,2,6,7,3,4,4,5,0,2,0,26
4813,791822,40,3,11,0,3,3,8,6,6,0,6,3,2,1,0,0,15
4813,781543,30,4,8,3,6,1,2,1,2,1,1,2,3,1,1,0,10
4813,780642,32,1,10,1,8,0,2,0,0,0,1,5,4,1,3,0,2
4813,797383,28,4,5,1,2,3,3,0,2,2,4,0,4,1,0,0,11
4813,791823,0,0,0,0,0,0,0,2,2,0,0,0,0,0,0,0,2
4813,797384,2,0,0,0,0,0,0,0,0,0,0,0,1,0,0,0,0
4813,786632,15,0,0,0,0,0,0,0,0,0,1,0,0,1,0,0,0
4813,781388,3,0,0,0,0,0,0,0,0,0,0,0,0,0,0,0,0
4814,796540,2,0,2,0,2,0,0,0,0,0,2,0,1,0,0,0,0
4814,790951,7,0,1,0,1,0,0,0,0,1,0,0,4,0,0,1,0
4814,786309,28,5,7,2,4,3,3,2,5,0,3,0,3,3,2,0,15
4814,780087,33,6,14,6,13,0,1,6,8,1,4,1,1,1,1,0,18
4814,776136,32,5,12,5,9,0,3,4,4,0,3,8,2,1,2,0,14
4814,796543,11,2,2,2,2,0,0,0,0,0,2,0,0,0,0,0,4
4814,775037,26,1,2,1,2,0,0,0,0,3,7,1,3,1,0,2,2
4814,796545,8,0,2,0,1,0,1,0,0,0,2,2,0,0,0,0,0
4814,796544,7,2,2,1,1,1,1,0,0,0,1,0,0,1,1,0,5
4814,798697,4,0,0,0,0,0,0,0,0,0,1,0,0,1,0,0,0
4814,796541,4,0,0,0,0,0,0,0,0,0,0,1,0,0,0,0,0
4814,790952,9,2,5,0,2,2,3,1,1,0,0,0,2,1,0,0,7
4814,786089,24,5,10,0,1,5,9,0,0,0,2,2,2,0,1,0,15
4814,781410,5,1,2,1,2,0,0,0,0,0,1,0,0,0,0,0,2
4815,792418,29,4,11,4,11,0,0,2,4,2,6,0,2,1,3,3,10
4815,782654,21,2,4,2,3,0,1,1,2,0,5,0,4,0,2,1,5
4815,796693,21,2,5,2,3,0,2,1,2,0,2,4,1,1,2,1,5
4815,792422,11,2,5,1,1,1,4,1,2,0,0,0,1,0,0,0,6
4815,789484,33,3,8,3,7,0,1,4,7,1,4,0,2,2,1,0,10
4815,796695,5,0,0,0,0,0,0,0,0,0,0,1,1,0,0,0,0
4815,792424,6,0,0,0,0,0,0,0,0,0,0,1,0,0,0,0,0
4815,792419,2,0,1,0,0,0,1,0,0,0,0,0,1,0,0,0,0
4815,792421,19,0,2,0,1,0,1,0,0,0,1,1,0,0,4,0,0
4815,796694,8,0,1,0,1,0,0,1,2,0,0,0,1,0,1,0,1
4815,796691,26,3,6,1,3,2,3,0,0,0,3,2,1,1,3,0,8
4815,792423,4,0,1,0,0,0,1,0,0,1,1,1,0,0,0,0,0
4815,796692,15,1,1,0,0,1,1,0,0,0,1,0,0,0,0,0,3
4816,791534,36,6,9,6,9,0,0,2,3,3,6,0,1,0,0,0,14
4816,797127,29,0,3,0,3,0,0,0,0,1,1,1,3,1,3,0,0
4816,791533,22,6,9,6,8,0,1,0,0,3,3,0,2,0,3,0,12
4816,791528,34,6,13,4,8,2,5,1,2,2,6,1,3,0,2,0,15
4816,775045,36,5,12,4,9,1,3,6,9,1,1,3,2,2,3,0,17
4816,791531,23,2,7,1,4,1,3,1,2,1,1,1,0,0,0,1,6
4816,797124,4,0,0,0,0,0,0,1,2,2,1,0,1,0,0,0,1
4816,791529,15,0,4,0,0,0,4,0,0,0,1,0,0,0,1,0,0
4816,797129,1,0,0,0,0,0,0,0,0,0,0,0,1,0,0,0,0
4817,781300,30,7,12,7,12,0,0,3,4,2,6,2,2,0,1,0,17
4817,790803,14,3,8,3,8,0,0,0,0,3,1,3,4,1,0,2,6
4817,781305,16,5,8,2,3,3,5,0,0,2,1,0,0,2,2,0,13
4817,790801,27,4,6,1,2,3,4,0,0,0,3,0,2,1,0,0,11
4817,781304,32,1,7,1,4,0,3,0,0,0,5,10,2,1,5,2,2
4817,780598,25,4,8,4,5,0,3,4,4,1,2,0,2,1,1,0,12
4817,796360,22,4,9,2,5,2,4,0,0,2,4,0,2,2,0,1,10
4817,796364,8,0,0,0,0,0,0,0,0,0,1,0,1,0,1,0,0
4817,796363,16,2,2,1,1,1,1,0,0,0,1,1,3,0,1,0,5
4817,790802,6,0,1,0,0,0,1,0,0,0,0,2,1,0,0,0,0
4817,796362,1,0,0,0,0,0,0,0,2,1,0,0,0,0,0,0,0
4817,781303,1,0,0,0,0,0,0,0,0,0,0,1,0,0,0,0,0
4817,776366,1,1,1,1,1,0,0,0,0,0,0,0,0,0,0,0,2
4817,776372,1,0,0,0,0,0,0,0,0,0,0,0,0,0,0,0,0
4818,791220,24,0,1,0,0,0,1,0,1,0,1,1,2,0,0,0,0
4818,791219,33,7,12,4,5,3,7,2,2,3,11,1,3,0,3,0,19
4818,776217,19,1,2,1,2,0,0,2,2,1,1,4,5,0,1,0,4
4818,786396,33,6,11,3,5,3,6,0,0,0,2,3,2,1,2,0,15
4818,780730,35,9,16,4,6,5,10,0,0,1,4,0,1,1,2,1,23
4818,786824,17,2,3,0,1,2,2,2,2,2,3,0,2,0,0,1,8
4818,791221,19,2,3,1,2,1,1,0,0,3,1,0,2,0,1,0,5
4818,796920,2,0,0,0,0,0,0,0,0,0,0,0,0,0,0,0,0
4818,790818,18,6,10,4,7,2,3,4,5,0,3,6,3,1,2,0,18
4819,786765,30,5,10,4,6,1,4,8,9,2,7,1,1,1,2,0,19
4819,797852,36,4,6,3,4,1,2,4,5,0,2,3,1,1,2,0,13
4819,792379,35,1,8,0,3,1,5,2,2,2,1,1,4,1,0,0,5
4819,792380,36,4,6,1,1,3,5,2,2,0,2,3,2,1,1,0,13
4819,781669,38,10,20,5,10,5,10,2,4,0,4,5,2,0,1,0,27
4819,781668,6,0,0,0,0,0,0,0,0,0,0,1,1,1,0,0,0
4819,797860,4,1,1,1,1,0,0,0,0,0,0,0,0,1,0,0,2
4819,797854,10,0,2,0,2,0,0,0,0,1,0,0,1,0,0,0,0
4819,781671,5,0,0,0,0,0,0,2,2,0,0,0,1,0,0,0,2
4820,785298,14,3,3,3,3,0,0,1,2,3,1,0,3,0,1,0,7
4820,775224,29,2,5,2,5,0,0,0,0,1,9,1,4,0,0,1,4
4820,778046,34,10,14,3,5,7,9,3,3,0,1,8,3,1,4,0,30
4820,782121,32,2,5,0,3,2,2,4,4,0,0,3,2,3,7,0,10
4820,775793,32,5,12,5,8,0,4,3,3,0,1,1,1,3,2,0,13
4820,786594,25,2,6,2,2,0,4,1,1,1,0,1,0,1,1,0,5
4820,785302,11,0,2,0,2,0,0,0,0,1,2,0,1,1,1,0,0
4820,785485,23,4,5,4,5,0,0,0,0,2,3,0,3,1,2,2,8
4821,790810,22,2,7,2,5,0,2,0,0,1,4,3,0,0,1,0,4
4821,785362,19,3,6,3,6,0,0,0,0,2,0,1,4,1,4,2,6
4821,790808,35,5,7,0,1,5,6,2,2,1,3,1,0,0,0,0,17
4821,785361,31,5,12,1,5,4,7,2,4,1,1,1,3,2,2,0,16
4821,779997,37,3,6,3,6,0,0,3,4,0,3,8,4,0,5,1,9
4821,774854,17,4,7,4,6,0,1,0,0,3,1,1,3,0,2,0,8
4821,790809,20,1,3,1,3,0,0,0,0,0,1,1,1,1,1,0,2
4821,790811,18,1,3,1,1,0,2,2,2,0,1,2,1,1,0,0,4
4821,779999,1,1,1,0,0,1,1,0,0,0,0,0,0,0,0,0,3
4822,796473,16,1,5,1,5,0,0,2,2,3,1,0,1,0,0,0,4
4822,781560,32,1,1,1,1,0,0,4,5,4,6,0,2,1,3,0,6
4822,791375,30,1,5,0,1,1,4,0,1,0,3,0,2,3,0,0,3
4822,785482,34,7,15,7,12,0,3,0,0,1,4,3,3,1,5,0,14
4822,780837,31,3,10,1,4,2,6,0,0,0,4,2,3,0,3,0,8
4822,796479,14,0,1,0,0,0,1,0,0,0,2,0,1,0,0,0,0
4822,796476,5,0,1,0,1,0,0,0,0,0,1,0,2,0,0,0,0
4822,786164,16,2,4,0,1,2,3,2,3,0,3,1,4,1,3,2,8
4822,796477,22,3,7,2,4,1,3,3,5,1,3,2,0,2,1,1,10
4823,797544,26,4,6,2,2,2,4,0,0,3,2,0,2,0,2,2,10
4823,797546,22,2,2,2,2,0,0,0,2,1,3,0,1,0,0,0,4
4823,797549,33,4,9,4,9,0,0,3,6,2,4,6,3,4,4,1,11
4823,797540,14,0,3,0,2,0,1,0,0,0,0,0,2,1,2,0,0
4823,780586,32,3,12,1,5,2,7,1,2,0,8,1,3,0,4,0,9
4823,780351,15,0,4,0,4,0,0,0,0,1,2,2,1,1,1,0,0
4823,797545,11,0,4,0,1,0,3,0,0,0,0,0,1,2,3,0,0
4823,791716,12,0,0,0,0,0,0,2,2,1,1,0,0,0,0,0,2
4823,791715,22,2,5,0,0,2,5,0,0,1,4,0,4,1,1,0,6
4823,790857,13,2,4,2,3,0,1,0,0,0,1,1,2,0,2,0,4
4826,786124,28,7,8,7,8,0,0,0,0,3,6,0,3,0,3,0,14
4826,780877,18,2,6,2,6,0,0,2,2,2,5,1,1,1,1,1,6
4826,786122,30,3,7,2,4,1,3,0,0,0,2,0,2,0,1,1,7
4826,780308,13,0,4,0,2,0,2,0,0,0,1,2,3,0,1,0,0
4826,776284,34,8,19,8,14,0,5,5,6,0,4,2,4,0,2,0,21
4826,797980,7,0,0,0,0,0,0,0,0,1,1,0,2,0,0,0,0
4826,792261,27,3,3,3,3,0,0,4,8,1,8,1,1,3,2,1,10
4826,792258,27,2,6,2,4,0,2,6,6,0,2,1,2,1,1,0,10
4826,786113,3,0,0,0,0,0,0,0,0,0,0,0,0,0,1,0,0
4826,786331,13,2,4,2,2,0,2,0,0,0,1,0,3,0,1,0,4
4827,791356,28,1,7,1,5,0,2,0,1,1,4,1,2,0,1,1,2
4827,791680,28,6,12,4,9,2,3,0,0,2,2,0,4,1,1,1,14
4827,785815,34,3,14,3,10,0,4,13,16,1,3,2,3,1,5,0,19
4827,785812,31,1,1,1,1,0,0,5,5,1,2,1,5,0,4,0,7
4827,780104,37,6,16,3,9,3,7,3,4,2,5,2,4,2,1,0,18
4827,791682,7,0,0,0,0,0,0,0,0,0,1,0,1,0,0,1,0
4827,797431,30,3,7,2,4,1,3,2,2,2,1,1,0,0,0,0,9
4827,791684,5,0,0,0,0,0,0,0,0,0,0,0,0,0,0,0,0
4828,786578,22,6,10,2,3,4,7,1,2,2,5,1,3,1,2,1,17
4828,797358,30,4,9,3,5,1,4,2,2,1,1,3,3,2,3,0,11
4828,785669,32,2,8,0,2,2,6,4,5,0,4,8,3,4,1,0,10
4828,785416,31,8,12,8,12,0,0,3,4,2,5,2,2,1,1,0,19
4828,775195,8,0,2,0,1,0,1,0,0,1,1,1,2,1,0,0,0
4828,786140,2,0,0,0,0,0,0,0,0,0,0,0,0,0,0,1,0
4828,786136,16,4,10,4,10,0,0,3,4,3,3,0,3,0,0,0,11
4828,775747,8,0,3,0,3,0,0,3,4,1,1,0,2,1,0,1,3
4828,797357,27,3,6,3,4,0,2,2,3,0,2,2,3,1,4,0,8
4828,797359,7,0,1,0,0,0,1,0,0,0,0,0,2,0,1,0,0
4828,776236,17,1,1,0,0,1,1,0,0,1,1,1,2,2,1,0,3
4829,792140,31,4,7,4,7,0,0,10,11,3,1,1,4,0,2,0,18
4829,786596,36,6,10,5,8,1,2,2,3,1,10,1,3,1,5,0,15
4829,792144,19,0,2,0,0,0,2,0,0,0,3,2,2,2,3,1,0
4829,781429,37,4,8,0,1,4,7,1,2,0,5,1,4,0,2,0,13
4829,776092,35,8,16,7,10,1,6,7,10,1,3,5,4,1,5,0,24
4829,792146,9,1,1,1,1,0,0,0,1,0,1,1,3,0,0,0,2
4829,792148,11,0,2,0,1,0,1,0,0,0,3,0,2,1,2,0,0
4829,785976,22,2,6,0,1,2,5,0,0,0,1,2,1,0,0,0,6
4830,786299,27,12,13,12,12,0,1,0,1,5,1,1,1,1,2,1,24
4830,797215,31,3,7,2,5,1,2,3,4,0,2,2,1,3,0,0,10
4830,791461,27,4,7,4,7,0,0,0,3,2,3,5,1,2,2,1,8
4830,780792,18,3,6,3,6,0,0,0,1,1,1,2,2,2,2,0,6
4830,775598,25,3,5,0,1,3,4,0,0,0,5,1,1,1,3,0,9
4830,780122,13,1,4,1,4,0,0,0,0,1,2,1,1,0,0,1,2
4830,797214,19,6,11,6,11,0,0,3,3,1,2,1,1,1,2,1,15
4830,791460,20,1,3,1,1,0,2,7,10,0,1,4,1,1,2,0,9
4830,786295,20,3,7,2,4,1,3,0,0,0,4,2,2,3,1,0,7
4831,797715,34,5,16,4,10,1,6,0,0,0,7,11,2,3,4,0,11
4831,780937,27,6,9,3,4,3,5,2,2,2,2,1,4,0,3,0,17
4831,791149,29,9,10,5,5,4,5,3,3,0,3,2,2,2,3,1,25
4831,791950,32,3,9,2,5,1,4,0,0,1,3,2,2,0,4,0,7
4831,792113,19,2,4,2,4,0,0,2,2,1,1,1,0,1,0,0,6
4831,797717,16,2,2,2,2,0,0,0,2,0,1,0,2,0,0,1,4
4831,792115,26,3,9,2,6,1,3,1,2,1,2,2,2,1,3,0,8
4831,780779,2,0,0,0,0,0,0,0,0,0,0,1,0,0,0,0,0
4831,780938,15,2,2,2,2,0,0,1,1,0,3,1,2,1,1,1,5
4832,792059,31,4,6,3,4,1,2,3,3,0,7,4,1,3,1,0,12
4832,775523,16,3,5,2,3,1,2,5,6,3,6,0,4,0,2,0,12
4832,792067,26,2,5,2,4,0,1,5,5,1,0,5,0,0,2,0,9
4832,789053,16,2,6,0,2,2,4,2,2,0,1,2,0,1,0,0,8
4832,792058,16,2,5,2,5,0,0,3,3,0,1,0,2,1,0,0,7
4832,797649,15,7,9,4,5,3,4,1,1,1,6,1,2,1,1,1,18
4832,789028,28,6,7,6,6,0,1,0,0,1,1,7,4,2,2,1,12
4832,790779,19,4,5,4,5,0,0,2,4,3,7,0,1,0,1,1,10
4832,775323,15,2,6,0,2,2,4,4,6,0,5,0,1,0,1,0,10
4832,789029,9,1,4,1,1,0,3,0,0,0,0,0,0,2,1,0,2
4832,786836,4,1,3,1,3,0,0,0,0,0,0,0,0,0,1,0,2
4832,792056,5,0,0,0,0,0,0,0,0,0,0,0,2,0,0,1,0
4833,792634,37,9,20,5,8,4,12,1,3,1,2,1,3,1,6,0,23
4833,799129,40,5,15,2,5,3,10,2,3,0,4,7,2,1,5,0,15
4833,799134,23,4,11,1,4,3,7,0,0,0,3,1,5,0,1,0,11
4833,800005,19,2,4,2,4,0,0,0,2,1,0,0,4,1,0,1,4
4833,799136,20,0,0,0,0,0,0,1,2,1,1,0,3,0,0,1,1
4833,799133,36,2,5,2,3,0,2,1,2,0,4,4,0,1,1,1,5
4833,799128,20,0,4,0,2,0,2,2,2,0,1,2,2,0,2,0,2
4833,799135,5,0,0,0,0,0,0,0,0,0,0,0,0,0,0,0,0
4834,785800,25,3,7,2,3,1,4,0,0,1,2,0,3,1,0,1,7
4834,785799,26,6,8,6,8,0,0,0,2,7,4,0,4,0,0,1,12
4834,791676,25,3,8,3,7,0,1,2,4,1,0,5,2,0,3,0,8
4834,780554,27,5,10,4,7,1,3,2,2,1,1,0,2,1,0,1,13
4834,780553,31,15,25,15,24,0,1,0,0,2,10,3,1,4,1,2,30
4834,797426,6,0,0,0,0,0,0,2,2,0,1,0,1,0,0,0,2
4834,791678,6,0,1,0,0,0,1,0,0,0,1,0,1,0,0,0,0
4834,785807,11,1,1,0,0,1,1,0,0,0,2,0,2,1,0,0,3
4834,780760,10,1,4,1,1,0,3,0,1,0,0,1,2,0,2,1,2
4834,797427,20,3,8,1,2,2,6,0,0,0,1,1,1,1,0,1,8
4834,791677,13,1,1,1,1,0,0,0,0,0,2,1,0,0,0,0,2
4835,792249,7,1,1,1,1,0,0,0,0,0,0,1,1,0,1,0,2
4835,781430,37,5,9,5,6,0,3,4,6,1,5,2,3,0,1,0,14
4835,792248,31,3,9,1,2,2,7,1,1,0,2,0,2,0,1,0,9
4835,781445,33,4,14,0,0,4,14,0,0,1,5,1,0,0,1,0,12
4835,768845,22,1,4,0,2,1,2,0,0,0,3,2,1,1,3,0,3
4835,792253,14,3,7,3,7,0,0,2,2,3,2,0,0,0,1,1,8
4835,781448,20,3,4,3,4,0,0,2,2,1,3,2,4,0,1,0,8
4835,797941,18,2,5,2,3,0,2,2,4,1,1,0,3,0,0,1,6
4835,792250,18,4,8,2,3,2,5,1,3,0,2,1,0,1,2,0,11
4836,781081,10,2,2,2,2,0,0,0,0,0,1,0,1,0,1,0,4
4836,791864,37,4,9,3,7,1,2,2,3,0,9,1,0,1,2,0,11
4836,791863,31,2,6,2,6,0,0,3,3,3,6,2,2,0,2,0,7
4836,797472,32,2,7,1,2,1,5,2,2,1,2,3,1,1,1,0,7
4836,780965,36,5,10,5,7,0,3,5,9,0,4,6,2,1,3,0,15
4836,797473,11,1,2,1,2,0,0,0,0,0,2,0,2,0,1,4,2
4836,786791,13,3,3,3,3,0,0,0,0,0,3,0,4,0,3,1,6
4836,797470,22,3,7,3,3,0,4,1,2,0,1,3,4,1,3,0,7
4836,776447,8,0,0,0,0,0,0,0,0,0,0,0,0,0,0,0,0
4837,796637,17,1,2,1,2,0,0,0,0,0,2,0,0,2,2,0,2
4837,792627,30,4,9,4,7,0,2,0,1,0,1,1,2,3,3,0,8
4837,792626,37,4,13,3,9,1,4,3,3,2,3,3,0,2,1,1,12
4837,781491,18,1,4,0,2,1,2,2,2,0,2,1,4,2,4,0,5
4837,780250,36,4,7,3,3,1,4,2,3,0,6,1,4,0,4,0,11
4837,796634,8,0,1,0,1,0,0,0,0,0,1,0,1,0,0,0,0
4837,792632,11,1,3,1,3,0,0,1,4,0,2,0,3,0,1,0,3
4837,796638,21,0,3,0,2,0,1,1,2,0,2,0,0,1,0,0,1
4837,796645,16,3,7,3,6,0,1,2,4,1,3,1,2,0,2,0,8
4837,792629,3,0,0,0,0,0,0,0,0,0,0,0,0,0,0,0,0
4837,792631,3,0,0,0,0,0,0,0,0,0,0,0,2,0,0,0,0
4838,792473,29,8,11,7,8,1,3,2,4,0,6,2,3,0,2,2,19
4838,780043,24,2,3,2,2,0,1,3,6,0,1,1,3,0,1,1,7
4838,799276,36,2,6,2,4,0,2,2,3,3,6,5,2,0,5,0,6
4838,785249,35,6,11,6,9,0,2,1,1,0,4,0,3,2,0,0,13
4838,780035,30,0,5,0,4,0,1,0,0,1,2,2,3,2,1,0,0
4838,792471,2,1,1,1,1,0,0,0,0,1,0,0,0,0,0,0,2
4838,799650,2,0,0,0,0,0,0,0,0,0,0,0,0,0,0,0,0
4838,799281,3,1,1,1,1,0,0,0,0,0,0,0,0,1,0,0,2
4838,792477,14,1,3,1,1,0,2,0,1,0,1,2,0,0,1,0,2
4838,785253,1,0,1,0,1,0,0,0,0,0,0,0,0,0,0,0,0
4838,780036,24,2,4,2,3,0,1,3,4,0,1,1,2,0,1,0,7
4839,780844,32,1,2,0,0,1,2,0,0,3,7,2,2,0,1,0,3
4839,797699,23,4,9,2,5,2,4,0,1,0,0,3,5,1,3,0,10
4839,791954,27,3,5,3,4,0,1,3,3,3,2,2,4,1,3,0,9
4839,791956,29,4,7,2,3,2,4,3,4,0,3,1,1,1,1,1,13
4839,780846,27,3,6,1,3,2,3,3,4,0,6,4,2,0,2,0,11
4839,797698,9,0,1,0,1,0,0,0,0,0,1,0,4,1,0,0,0
4839,797693,2,0,1,0,0,0,1,0,0,0,0,0,0,0,0,0,0
4839,797694,20,4,8,0,0,4,8,0,0,0,4,2,0,0,0,0,12
4839,797692,31,6,12,1,3,5,9,2,4,0,1,1,4,0,1,0,19
4846,781558,27,4,9,3,8,1,1,3,3,3,4,1,3,0,4,0,12
4846,780993,34,7,12,7,12,0,0,2,2,2,0,1,3,1,2,0,16
4846,775248,24,2,7,2,5,0,2,2,2,1,6,1,4,1,2,1,6
4846,791452,25,1,5,1,4,0,1,2,2,0,2,3,3,0,3,0,4
4846,797224,36,7,13,5,9,2,4,7,8,0,3,3,0,3,0,0,23
4846,797230,11,4,5,4,5,0,0,0,0,3,0,0,2,0,1,0,8
4846,797225,29,2,9,1,7,1,2,4,4,1,6,6,1,3,1,0,9
4846,791449,14,2,5,2,4,0,1,2,3,3,2,0,1,0,0,0,6
4847,785495,35,8,19,5,11,3,8,1,3,3,5,2,3,0,3,0,20
4847,785958,35,7,16,7,16,0,0,8,11,2,4,2,3,7,3,1,22
4847,775377,27,5,7,5,7,0,0,0,0,6,2,0,3,0,3,2,10
4847,785494,37,8,14,6,9,2,5,1,1,0,2,3,4,0,4,0,19
4847,780698,35,2,12,2,6,0,6,1,2,2,4,6,3,0,0,1,5
4847,785659,12,1,2,1,2,0,0,0,0,4,3,0,5,0,2,1,2
4847,791034,3,0,0,0,0,0,0,0,0,0,0,0,1,0,0,0,0
4847,791130,11,1,3,0,0,1,3,0,0,0,1,0,1,1,0,0,3
4847,780427,5,0,0,0,0,0,0,0,0,0,1,0,1,0,0,0,0
4848,785432,25,6,9,6,9,0,0,0,1,1,3,2,1,2,0,5,12
4848,790882,24,5,8,4,6,1,2,2,2,0,0,2,0,1,0,0,13
4848,790876,31,6,11,4,6,2,5,2,2,1,3,2,0,1,1,0,16
4848,785699,31,2,5,0,3,2,2,2,2,2,11,6,2,3,2,0,8
4848,774987,32,3,9,3,7,0,2,2,5,0,4,7,1,3,2,0,8
4848,790877,15,2,4,2,2,0,2,2,4,1,1,0,1,3,0,1,6
4848,790879,3,0,1,0,1,0,0,0,2,1,0,0,1,0,0,0,0
4848,779985,11,2,6,1,3,1,3,1,2,1,0,0,2,0,0,1,6
4848,796434,8,1,4,1,3,0,1,0,1,0,0,0,1,0,0,0,2
4848,781062,20,2,6,1,3,1,3,0,0,2,1,0,1,0,2,0,5
4849,796372,21,1,5,1,5,0,0,0,0,1,3,0,1,0,0,0,2
4849,796377,31,5,10,5,8,0,2,1,2,3,4,2,1,1,5,0,11
4849,796378,26,1,6,1,5,0,1,0,0,1,2,2,1,0,0,0,2
4849,790815,33,6,14,5,11,1,3,0,0,3,3,1,4,2,4,0,13
4849,780176,29,1,9,0,4,1,5,0,0,0,2,1,4,0,4,0,3
4849,796376,5,0,0,0,0,0,0,0,0,0,1,0,0,0,1,0,0
4849,796375,4,1,3,1,3,0,0,1,2,0,3,0,1,0,0,0,3
4849,790814,23,2,3,2,2,0,1,0,0,2,9,2,2,0,1,0,4
4849,786013,11,3,6,3,6,0,0,1,2,0,3,1,3,0,1,2,7
4849,796373,1,0,1,0,0,0,1,0,0,0,0,0,0,0,0,0,0
4849,796374,15,2,4,1,2,1,2,0,0,1,2,1,2,0,1,0,5
4849,790817,1,0,0,0,0,0,0,0,0,0,0,0,0,0,0,0,0
4850,791194,33,1,8,1,3,0,5,0,0,1,1,0,1,5,3,2,2
4850,780384,23,2,4,2,4,0,0,0,0,4,4,0,1,0,0,1,4
4850,780159,20,2,8,2,7,0,1,2,6,3,4,2,1,0,1,0,6
4850,786738,24,1,9,1,6,0,3,0,0,0,4,2,0,0,3,0,2
4850,774827,25,3,9,2,2,1,7,4,5,0,2,2,3,1,3,0,11
4850,791193,17,3,3,3,3,0,0,2,4,0,2,0,2,1,1,0,8
4850,775694,24,2,6,1,3,1,3,0,0,0,2,2,4,1,1,0,5
4850,796863,22,4,8,3,5,1,3,3,4,0,1,2,1,1,0,0,12
4850,796865,12,1,2,0,0,1,2,0,0,1,0,0,0,0,0,0,3
4851,785498,25,4,5,3,3,1,2,1,2,2,3,0,2,0,2,0,10
4851,776469,35,3,5,3,5,0,0,0,1,1,13,3,1,0,3,0,6
4851,796708,27,4,8,2,2,2,6,0,0,0,1,4,2,0,3,0,10
4851,780701,34,4,7,4,7,0,0,0,2,1,4,4,3,1,3,0,8
4851,776322,35,7,17,2,5,5,12,2,2,1,5,2,3,1,0,0,21
4851,791036,3,0,0,0,0,0,0,0,0,0,0,0,2,0,0,0,0
4851,796705,25,4,11,2,4,2,7,0,0,1,0,3,5,1,2,0,10
4851,796706,16,1,1,1,1,0,0,0,0,1,3,0,1,1,1,0,2
4852,792186,35,7,12,7,12,0,0,4,4,2,4,1,4,0,3,1,18
4852,780433,19,2,3,2,3,0,0,1,4,1,3,0,3,0,3,0,5
4852,797816,33,4,9,3,4,1,5,3,4,0,3,1,3,0,2,0,12
4852,792188,29,5,11,5,7,0,4,2,4,3,6,2,4,2,0,0,12
4852,792183,36,4,14,4,12,0,2,0,1,1,4,4,2,1,1,0,8
4852,797821,14,0,2,0,1,0,1,3,6,2,3,0,3,2,1,0,3
4852,781447,5,0,2,0,2,0,0,0,0,1,0,0,4,0,2,0,0
4852,781490,13,0,1,0,1,0,0,1,2,0,1,0,0,0,0,0,1
4852,792185,12,0,2,0,1,0,1,0,0,0,3,1,0,1,0,0,0
4852,786675,4,0,0,0,0,0,0,0,0,0,0,0,0,0,1,0,0
4853,775913,18,1,2,1,2,0,0,6,8,1,2,1,3,0,2,0,8
4853,797331,30,2,5,0,0,2,5,2,4,0,1,0,0,0,1,0,8
4853,791737,32,4,8,1,2,3,6,0,2,0,7,2,4,2,4,0,11
4853,783524,33,3,8,2,4,1,4,10,12,0,5,3,2,0,3,0,17
4853,780561,16,1,8,1,3,0,5,0,0,0,5,1,2,1,0,0,2
4853,781516,15,3,3,3,3,0,0,4,6,1,5,0,5,0,3,3,10
4853,797332,5,0,1,0,1,0,0,0,0,0,1,0,2,1,0,0,0
4853,797333,20,1,2,1,2,0,0,0,0,4,1,1,3,0,1,0,2
4853,786223,17,0,2,0,0,0,2,0,2,0,0,1,2,1,0,0,0
4853,786220,14,2,7,2,7,0,0,1,1,2,0,0,0,2,1,0,5
4854,791062,52,6,18,4,13,2,5,4,5,1,1,2,2,4,3,1,18
4854,791063,38,5,7,2,3,3,4,0,1,3,10,5,3,0,4,0,13
4854,796735,29,3,6,3,5,0,1,1,3,0,1,3,4,2,1,1,7
4854,785542,45,3,4,3,4,0,0,0,0,0,2,2,4,3,1,0,6
4854,780743,53,9,17,4,8,5,9,5,7,0,1,5,5,0,4,0,28
4854,785548,17,4,7,2,3,2,4,0,0,0,3,2,2,0,1,0,10
4854,796737,2,0,0,0,0,0,0,2,2,1,0,0,0,0,0,0,2
4854,791064,39,2,9,0,1,2,8,1,2,0,1,2,4,0,2,0,7
4855,785622,38,7,13,5,6,2,7,0,0,1,3,1,5,0,0,1,16
4855,781058,36,5,7,5,6,0,1,0,0,3,10,2,5,2,1,0,10
4855,780327,45,7,9,7,9,0,0,1,3,6,3,1,3,2,2,0,15
4855,797458,33,2,4,1,3,1,1,3,3,0,3,2,1,0,4,0,8
4855,797451,46,5,14,3,7,2,7,0,1,1,1,9,1,4,8,0,12
4855,791848,8,0,0,0,0,0,0,0,2,0,4,1,0,0,0,0,0
4855,797455,10,5,7,5,7,0,0,4,5,1,4,0,1,0,1,1,14
4855,797456,11,0,1,0,0,0,1,6,6,0,3,0,0,0,0,0,6
4855,797452,7,0,1,0,1,0,0,0,0,0,0,0,1,0,2,0,0
4855,791849,6,0,1,0,0,0,1,1,2,0,0,0,1,1,2,0,1
4855,786607,31,6,12,5,5,1,7,2,2,1,2,2,5,1,2,0,15
4855,791847,4,0,0,0,0,0,0,0,0,0,0,0,0,0,0,0,0
4856,786434,13,1,3,1,3,0,0,3,4,2,3,0,2,1,1,1,5
4856,780440,23,6,14,4,9,2,5,3,4,3,1,1,3,1,0,2,17
4856,791621,26,3,7,2,4,1,3,2,2,0,0,2,2,2,0,0,9
4856,786432,30,1,5,0,2,1,3,2,2,0,3,2,2,1,1,0,5
4856,786431,33,1,5,1,3,0,2,10,14,1,2,5,2,2,1,1,12
4856,781125,24,6,10,6,9,0,1,5,7,4,7,1,2,1,4,1,17
4856,775620,2,0,0,0,0,0,0,0,0,0,0,0,2,0,1,0,0
4856,781088,29,3,8,1,3,2,5,2,3,0,3,1,2,1,0,0,10
4856,775622,20,2,4,0,1,2,3,0,2,0,1,2,0,1,0,0,6
4857,780406,21,2,5,0,0,2,5,0,0,1,5,0,5,0,4,0,6
4857,790985,18,2,4,2,4,0,0,0,0,1,2,0,2,0,2,1,4
4857,790984,35,2,6,0,2,2,4,2,2,0,2,5,2,0,0,0,8
4857,780212,34,5,11,4,7,1,4,6,6,0,2,2,3,1,5,2,17
4857,767245,32,4,9,4,9,0,0,9,9,3,7,2,3,2,3,0,17
4857,780214,12,3,3,0,0,3,3,0,0,1,0,0,2,0,0,0,9
4857,780215,20,2,3,2,3,0,0,0,0,0,4,1,5,0,2,2,4
4857,785297,5,0,0,0,0,0,0,0,0,0,1,0,1,0,0,0,0
4857,785296,19,2,10,2,7,0,3,2,2,1,2,3,3,0,1,0,6
4857,796596,4,0,0,0,0,0,0,0,0,0,0,1,0,0,0,0,0
4858,797466,32,5,11,5,9,0,2,4,4,1,5,1,2,1,1,0,14
4858,791858,33,3,8,1,1,2,7,2,2,0,1,1,1,0,0,0,10
4858,797463,37,5,16,3,10,2,6,5,6,0,3,2,2,1,6,0,17
4858,791109,16,0,3,0,3,0,0,0,0,0,1,1,5,1,3,0,0
4858,785625,24,3,4,2,2,1,2,2,2,3,2,0,4,2,2,0,9
4858,797464,26,3,5,3,4,0,1,2,2,0,4,1,1,0,0,2,8
4858,797469,7,0,2,0,1,0,1,0,0,0,0,0,1,0,1,0,0
4858,791854,21,0,2,0,1,0,1,0,0,0,2,3,2,0,3,0,0
4858,797467,2,0,0,0,0,0,0,0,0,0,1,0,0,0,0,0,0
4858,797465,2,0,0,0,0,0,0,0,0,0,0,0,0,0,0,0,0
4859,785459,12,4,5,4,5,0,0,2,4,0,0,1,3,0,1,0,10
4859,792063,13,1,1,0,0,1,1,0,0,1,1,2,0,2,2,0,3
4859,789101,22,2,5,2,3,0,2,0,0,0,6,1,4,0,4,0,4
4859,781371,12,0,1,0,0,0,1,0,0,1,2,1,4,0,1,0,0
4859,781367,23,4,7,3,4,1,3,1,2,1,4,3,0,3,2,0,10
4859,797731,18,6,7,6,7,0,0,0,0,2,1,1,2,2,2,0,12
4859,792066,23,1,2,1,1,0,1,1,1,1,3,0,1,0,0,1,3
4859,792064,11,1,3,0,1,1,2,0,0,0,1,0,1,0,0,0,3
4859,792061,12,0,2,0,1,0,1,0,0,0,3,0,3,0,0,1,0
4859,788037,22,3,11,2,5,1,6,2,3,0,0,1,1,1,0,0,9
4859,789102,31,5,7,4,6,1,1,7,8,0,4,5,2,0,4,0,18
4859,797730,1,0,0,0,0,0,0,0,0,0,0,0,0,0,0,0,0
4860,790863,26,4,9,4,7,0,2,0,4,2,2,3,2,1,2,0,8
4860,780021,32,8,11,8,11,0,0,3,5,2,8,2,3,3,2,3,19
4860,785412,19,0,3,0,3,0,0,2,4,1,1,2,2,0,5,0,2
4860,780099,37,5,9,2,2,3,7,5,6,0,2,1,3,1,3,0,18
4860,776214,25,5,6,3,3,2,3,4,4,0,4,3,3,0,2,1,16
4860,775686,17,1,1,1,1,0,0,2,2,2,3,0,2,1,0,0,4
4860,785413,18,4,7,4,6,0,1,0,0,0,3,1,3,0,2,0,8
4860,776221,18,1,2,1,2,0,0,4,5,0,1,4,4,2,2,0,6
4860,785411,8,0,0,0,0,0,0,0,0,0,0,0,0,0,0,0,0
4861,790914,12,1,4,1,4,0,0,0,0,1,1,0,3,0,1,0,2
4861,780798,37,4,11,2,5,2,6,0,2,6,5,5,4,1,0,1,10
4861,785455,32,2,12,1,6,1,6,1,3,1,2,5,1,0,5,0,6
4861,785453,25,2,9,1,3,1,6,0,1,0,2,1,2,0,0,0,5
4861,774940,17,1,5,1,3,0,2,0,0,0,1,1,2,2,3,0,2
4861,790911,24,7,9,5,6,2,3,1,3,3,2,2,4,0,0,0,17
4861,785458,28,8,12,8,11,0,1,3,6,3,2,1,1,0,2,2,19
4861,790913,15,0,5,0,4,0,1,3,4,2,0,0,3,1,1,0,3
4861,785454,10,2,3,0,0,2,3,0,0,0,0,0,3,1,1,0,6
4862,792181,35,8,10,8,9,0,1,2,2,2,6,1,0,1,0,1,18
4862,780986,27,0,1,0,1,0,0,0,0,2,2,3,4,1,0,1,0
4862,785902,16,2,8,1,3,1,5,0,0,0,3,0,0,1,1,1,5
4862,792179,39,8,15,3,6,5,9,2,2,0,2,4,2,1,2,0,23
4862,786662,35,9,16,5,8,4,8,1,1,0,1,3,2,0,1,0,23
4862,797796,20,3,6,3,5,0,1,1,2,1,1,8,0,5,2,1,7
4862,792177,23,2,4,2,4,0,0,3,4,0,6,0,4,2,2,1,7
4862,786661,1,0,1,0,0,0,1,0,0,0,1,0,0,0,0,0,0
4862,792178,1,0,0,0,0,0,0,0,0,0,1,0,0,0,0,0,0
4862,797795,1,0,0,0,0,0,0,0,0,0,0,0,0,0,0,0,0
4862,792182,1,0,0,0,0,0,0,0,0,0,0,0,0,0,0,0,0
4862,797792,1,0,0,0,0,0,0,0,0,0,0,0,0,0,0,0,0
4863,790821,22,5,9,5,8,0,1,3,4,1,4,0,1,1,0,1,13
4863,775585,27,3,6,3,6,0,0,0,0,5,1,0,1,0,2,0,6
4863,790822,32,5,16,2,4,3,12,3,5,0,4,0,2,0,1,0,16
4863,790820,17,1,5,1,3,0,2,1,2,1,2,3,0,2,6,0,3
4863,780982,29,2,5,2,2,0,3,0,0,1,4,1,3,0,2,1,4
4863,796380,23,2,5,2,5,0,0,0,0,0,1,1,2,2,4,0,4
4863,774980,20,3,6,2,2,1,4,2,2,0,0,1,0,0,1,0,9
4863,780445,9,0,0,0,0,0,0,0,0,0,3,1,1,0,1,1,0
4863,796381,19,0,3,0,0,0,3,0,0,0,1,2,2,1,0,2,0
4863,785365,2,1,1,1,1,0,0,0,0,0,1,0,0,0,0,0,2
4864,781579,21,4,6,4,6,0,0,0,0,2,5,1,0,0,0,0,8
4864,786731,33,6,9,6,9,0,0,6,9,4,8,2,2,1,3,3,18
4864,798023,29,2,6,2,4,0,2,4,6,0,2,9,2,1,3,0,8
4864,781584,29,6,13,0,3,6,10,2,2,2,2,1,4,0,1,0,20
4864,780347,32,2,8,2,8,0,0,4,5,1,2,3,3,1,3,1,8
4864,775696,18,4,8,2,5,2,3,2,2,0,3,0,1,2,1,0,12
4864,776481,4,0,1,0,1,0,0,1,2,2,2,0,1,1,0,0,1
4864,798008,24,1,5,0,2,1,3,2,2,0,5,4,2,1,0,0,5
4864,792358,6,1,1,0,0,1,1,0,0,1,1,0,0,0,1,0,3
4864,798017,1,0,0,0,0,0,0,0,0,0,0,0,2,0,1,0,0
4864,798021,1,0,0,0,0,0,0,0,0,0,0,0,0,0,0,0,0
4864,798026,1,0,0,0,0,0,0,0,0,0,0,0,0,0,0,0,0
4864,798018,1,0,0,0,0,0,0,0,0,0,0,0,0,0,0,0,0
4865,791144,20,2,6,1,3,1,3,0,0,1,1,3,4,0,1,1,5
4865,785782,31,4,6,2,3,2,3,4,4,0,2,0,4,0,2,1,14
4865,791145,30,2,6,2,5,0,1,5,8,3,5,4,2,1,4,1,9
4865,791146,37,7,13,5,7,2,6,0,0,0,5,4,2,1,3,0,16
4865,785777,29,3,9,1,2,2,7,0,0,0,4,1,1,1,3,0,8
4865,791147,11,3,5,1,2,2,3,0,0,0,1,1,4,0,1,0,8
4865,796804,7,0,1,0,1,0,0,0,0,0,1,0,1,1,1,0,0
4865,786748,13,0,1,0,0,0,1,4,5,0,0,2,1,1,0,0,4
4865,791148,22,0,5,0,2,0,3,0,1,0,0,1,2,0,0,0,0
4866,791537,26,2,11,1,6,1,5,0,0,0,2,0,3,1,0,0,5
4866,786357,41,8,10,7,7,1,3,2,2,2,7,0,3,1,2,1,19
4866,780306,36,8,12,8,11,0,1,4,6,2,5,6,4,0,3,1,20
4866,797116,19,1,3,0,2,1,1,0,0,0,3,2,0,1,3,2,3
4866,780312,45,4,6,1,1,3,5,4,5,1,4,1,2,0,2,0,15
4866,791535,2,0,0,0,0,0,0,0,0,0,1,0,0,0,0,0,0
4866,786358,30,2,7,1,3,1,4,3,4,0,4,7,1,2,1,0,8
4866,775846,6,0,1,0,1,0,0,0,0,0,0,0,1,0,1,0,0
4866,775418,20,1,6,1,6,0,0,0,0,1,5,0,1,0,3,1,2
4867,785987,38,4,9,3,5,1,4,0,1,2,5,5,4,1,0,0,9
4867,776037,25,5,10,4,9,1,1,2,2,1,3,1,4,1,3,0,13
4867,780588,41,6,20,6,20,0,0,1,4,1,9,0,2,1,0,0,13
4867,786147,37,2,4,2,3,0,1,2,2,0,1,4,5,1,3,0,6
4867,775680,40,4,17,1,5,3,12,0,0,0,6,3,0,0,1,0,11
4867,781647,24,5,9,3,5,2,4,0,0,2,1,1,1,2,1,1,12
4867,791759,20,2,3,2,2,0,1,1,2,0,0,3,2,0,0,0,5
4867,797355,0,0,0,0,0,0,0,0,0,0,0,0,0,0,0,0,0
4868,791981,38,3,12,2,7,1,5,1,2,0,1,2,2,0,3,0,8
4868,786756,24,3,5,1,2,2,3,1,2,1,4,2,3,0,0,0,9
4868,786755,19,3,6,2,4,1,2,0,0,1,0,2,2,3,0,0,7
4868,791982,35,4,10,4,7,0,3,2,4,0,5,7,2,0,2,0,10
4868,780342,31,7,11,4,8,3,3,3,4,1,8,1,1,2,0,0,20
4868,781493,12,0,1,0,0,0,1,0,0,2,1,0,4,0,0,0,0
4868,791984,2,0,0,0,0,0,0,0,0,0,0,0,1,0,1,0,0
4868,780333,39,6,10,4,5,2,5,8,8,0,0,1,3,0,2,0,22
4869,780765,35,8,14,5,8,3,6,4,7,1,8,5,2,1,7,0,23
4869,781301,19,1,1,1,1,0,0,0,0,0,0,1,2,0,0,0,2
4869,786255,36,8,13,5,6,3,7,0,0,0,4,4,0,1,0,0,19
4869,780762,30,4,6,3,4,1,2,2,3,0,4,1,1,1,1,0,11
4869,780768,30,4,9,3,5,1,4,2,2,0,2,3,5,1,1,0,11
4869,776241,10,0,3,0,2,0,1,0,0,0,2,2,0,0,0,0,0
4869,780755,18,2,3,2,3,0,0,0,0,1,3,0,2,0,1,0,4
4869,791729,22,2,3,2,3,0,0,0,0,0,1,1,4,1,2,0,4
4874,786124,25,5,5,5,5,0,0,2,2,3,4,1,4,0,1,0,12
4874,780877,10,1,2,1,2,0,0,0,0,3,2,0,3,0,3,1,2
4874,786122,21,2,10,1,5,1,5,2,2,1,5,0,0,0,1,0,7
4874,780308,17,0,1,0,1,0,0,0,0,0,3,1,4,0,1,0,0
4874,776284,35,9,15,7,9,2,6,4,5,1,5,5,2,0,1,0,24
4874,797980,5,0,2,0,2,0,0,0,0,0,1,0,0,0,0,0,0
4874,792261,34,5,8,5,8,0,0,7,8,2,4,0,3,0,1,2,17
4874,792258,27,3,5,1,2,2,3,2,2,0,1,1,2,1,3,0,10
4874,786331,23,2,5,2,4,0,1,2,2,0,4,0,1,0,0,0,6
4874,786113,3,0,0,0,0,0,0,0,0,0,0,0,0,0,0,0,0
4875,791356,37,4,11,4,9,0,2,3,3,4,6,2,3,0,0,1,11
4875,791680,23,1,5,1,4,0,1,0,0,1,1,0,3,0,1,1,2
4875,785815,27,2,9,2,5,0,4,0,0,0,3,1,0,0,0,0,4
4875,785812,25,1,6,0,2,1,4,4,4,1,1,0,4,0,2,0,7
4875,780104,36,7,14,6,10,1,4,10,12,0,1,4,4,1,0,0,25
4875,791682,11,2,4,2,4,0,0,0,0,1,2,0,2,0,0,0,4
4875,797431,31,6,14,1,5,5,9,4,4,1,1,0,2,1,1,0,21
4875,791684,10,0,1,0,0,0,1,0,0,0,0,1,2,0,0,0,0
4876,797174,27,0,5,0,0,0,5,0,0,0,2,3,2,0,3,1,0
4876,791510,16,0,3,0,1,0,2,0,0,1,4,0,4,0,0,0,0
4876,786699,21,0,0,0,0,0,0,3,4,1,1,0,2,0,1,0,3
4876,797168,27,5,9,3,5,2,4,3,3,0,3,2,1,1,1,0,15
4876,785593,21,4,9,3,3,1,6,3,5,0,3,1,3,1,1,0,12
4876,791506,1,0,0,0,0,0,0,0,0,0,0,0,0,0,0,0,0
4876,791507,18,3,3,3,3,0,0,1,2,1,2,1,3,1,1,1,7
4876,798345,1,0,0,0,0,0,0,1,2,0,0,0,0,0,0,0,1
4876,791508,1,0,0,0,0,0,0,0,0,0,1,0,0,0,0,0,0
4876,791504,27,4,7,2,4,2,3,1,1,0,1,4,3,0,1,0,11
4876,791505,10,2,4,1,1,1,3,0,0,0,2,0,1,0,0,0,5
4876,775357,29,7,9,1,1,6,8,1,1,0,2,4,3,2,3,0,21
4876,791509,1,0,0,0,0,0,0,0,0,0,0,0,0,0,0,0,0
4877,791337,22,1,1,1,1,0,0,0,0,3,2,0,3,1,2,0,2
4877,797877,21,1,3,1,3,0,0,0,0,2,3,1,1,0,1,0,2
4877,797872,33,4,11,4,8,0,3,1,5,1,3,2,3,2,4,0,9
4877,791338,25,1,2,1,2,0,0,1,2,0,2,5,2,2,1,0,3
4877,791339,33,7,19,4,10,3,9,10,10,0,4,0,1,1,2,0,27
4877,791335,19,3,7,1,3,2,4,0,0,0,1,0,4,0,0,0,8
4877,781599,19,0,0,0,0,0,0,3,5,0,2,1,1,0,1,0,3
4877,797875,7,0,0,0,0,0,0,0,0,0,2,0,2,0,2,0,0
4877,797874,17,0,2,0,0,0,2,0,0,0,0,0,1,0,0,0,0
4877,781595,4,0,0,0,0,0,0,0,0,0,0,0,1,0,0,1,0
4878,790873,30,3,7,2,3,1,4,4,7,3,4,0,3,1,1,0,11
4878,785429,34,3,9,0,0,3,9,3,3,0,4,0,3,0,0,0,12
4878,780054,31,2,8,0,4,2,4,2,2,2,2,1,1,0,1,0,8
4878,781140,28,3,7,2,4,1,3,0,0,2,3,3,2,0,1,1,7
4878,786851,33,7,14,1,5,6,9,1,2,0,3,6,3,0,5,0,21
4878,796433,10,1,2,1,2,0,0,1,2,1,0,0,3,0,0,0,3
4878,776245,16,1,2,0,0,1,2,0,0,0,1,0,2,1,1,0,3
4878,799973,12,0,2,0,0,0,2,0,1,0,1,0,0,0,0,0,0
4878,796432,4,0,1,0,0,0,1,0,0,0,0,1,0,0,0,1,0
4878,781139,2,0,1,0,0,0,1,0,0,0,0,0,1,0,0,0,0
4879,790839,16,0,0,0,0,0,0,0,0,1,0,0,5,0,1,0,0
4879,785388,21,7,13,7,12,0,1,2,4,2,5,1,2,1,2,0,16
4879,790840,17,0,2,0,0,0,2,0,0,0,0,0,1,1,1,0,0
4879,785386,33,3,9,2,6,1,3,1,2,1,3,0,2,1,1,0,8
4879,780373,28,5,9,4,4,1,5,4,4,0,4,0,1,2,2,0,15
4879,780370,24,1,2,1,1,0,1,0,0,1,4,1,4,0,1,0,2
4879,796393,19,3,5,3,5,0,0,2,4,1,4,0,2,0,0,1,8
4879,796395,27,6,12,4,6,2,6,1,3,1,3,2,1,0,2,0,15
4879,796396,3,0,0,0,0,0,0,0,0,0,2,0,0,0,0,0,0
4879,790841,12,1,2,0,0,1,2,0,0,0,1,0,0,0,0,0,3
4880,790794,27,4,5,4,5,0,0,1,2,5,4,1,1,0,0,5,9
4880,780281,17,2,4,1,2,1,2,0,0,0,3,1,3,1,3,0,5
4880,790793,27,6,11,6,11,0,0,0,0,1,3,3,2,1,3,1,12
4880,785246,35,5,13,3,7,2,6,2,3,1,2,1,3,1,1,0,14
4880,780886,27,5,9,3,5,2,4,1,2,0,4,7,2,3,3,0,13
4880,796351,12,2,2,2,2,0,0,0,0,4,2,1,4,0,1,0,4
4880,796350,7,0,1,0,0,0,1,0,0,0,0,0,1,0,1,0,0
4880,790790,13,1,3,1,3,0,0,0,0,1,2,0,3,1,0,1,2
4880,790789,15,4,7,3,5,1,2,1,2,0,0,1,2,3,1,0,10
4880,796353,18,2,7,2,4,0,3,2,2,0,5,0,1,1,0,0,6
4880,790791,1,0,1,0,0,0,1,0,0,0,0,0,0,0,0,0,0
4880,796352,1,0,0,0,0,0,0,0,0,0,0,0,0,0,0,0,0
4881,775954,28,6,9,6,9,0,0,3,3,3,1,5,3,1,3,0,15
4881,781006,26,2,7,1,5,1,2,0,0,1,3,0,3,0,1,1,5
4881,796194,23,2,8,1,2,1,6,2,2,0,3,1,1,3,1,0,7
4881,796464,31,3,10,3,9,0,1,2,7,0,2,3,1,0,3,0,8
4881,790917,31,2,8,1,5,1,3,0,0,3,2,0,3,0,2,2,5
4881,790918,7,0,2,0,2,0,0,0,2,2,1,0,0,0,0,0,0
4881,785238,5,0,0,0,0,0,0,0,1,0,1,0,0,0,0,0,0
4881,780648,14,1,2,1,2,0,0,0,0,3,1,1,1,1,1,0,2
4881,790916,10,0,0,0,0,0,0,3,4,2,3,0,1,1,1,0,3
4881,781157,23,1,12,1,6,0,6,2,6,1,1,1,1,0,5,0,4
4881,790919,2,0,0,0,0,0,0,0,0,0,0,0,0,0,0,0,0
4882,790854,13,1,3,1,3,0,0,0,0,0,2,1,1,0,2,1,2
4882,796404,17,1,6,1,6,0,0,1,2,0,4,0,3,2,0,0,3
4882,790850,35,3,8,1,3,2,5,5,5,0,1,0,1,0,1,0,13
4882,781164,27,2,6,0,1,2,5,0,0,0,3,6,2,0,1,0,6
4882,781163,37,5,11,4,8,1,3,2,3,0,4,2,1,2,1,1,13
4882,790853,15,6,7,6,7,0,0,0,0,1,2,1,4,0,0,0,12
4882,790849,22,0,1,0,1,0,0,0,0,0,1,4,2,0,1,0,0
4882,785434,17,1,3,0,1,1,2,0,0,0,3,1,2,0,1,0,3
4882,796406,17,1,3,1,3,0,0,4,4,0,3,0,2,1,1,0,6
4883,790893,30,2,5,2,4,0,1,2,6,3,5,1,2,0,0,0,6
4883,796444,35,5,8,5,7,0,1,2,2,2,11,2,0,0,2,2,12
4883,786615,28,3,9,1,4,2,5,2,2,1,0,2,3,0,5,1,10
4883,786732,17,2,6,1,2,1,4,0,0,1,1,2,3,1,3,1,5
4883,775260,32,3,9,2,6,1,3,0,0,0,3,0,2,0,0,0,7
4883,790889,15,1,2,0,0,1,2,0,0,0,2,1,3,0,1,0,3
4883,790890,22,1,4,0,2,1,2,2,3,0,2,4,4,0,1,0,5
4883,775536,15,3,3,3,3,0,0,2,5,1,1,0,1,0,1,0,8
4883,780702,6,0,2,0,0,0,2,0,0,0,1,0,0,0,0,0,0
4884,797972,30,5,8,5,7,0,1,3,4,3,1,2,1,0,0,4,13
4884,797967,34,2,10,2,8,0,2,6,8,2,3,4,2,1,1,2,10
4884,797970,32,11,14,9,11,2,3,1,2,3,4,4,2,0,3,0,25
4884,781453,34,5,13,2,4,3,9,2,2,0,6,9,0,4,3,1,15
4884,774869,35,5,12,1,3,4,9,0,0,2,3,1,3,2,0,0,14
4884,792254,13,3,4,3,3,0,1,1,1,0,1,0,0,0,0,0,7
4884,797962,4,0,0,0,0,0,0,0,0,0,1,0,1,0,2,1,0
4884,786098,16,2,7,2,3,0,4,1,2,0,4,1,3,0,2,0,5
4884,792256,1,0,0,0,0,0,0,0,0,0,0,0,1,0,0,0,0
4884,786106,1,0,0,0,0,0,0,0,0,0,0,0,0,1,0,0,0
4885,796761,28,6,9,6,9,0,0,1,2,5,6,1,3,1,2,1,13
4885,796758,33,9,15,9,15,0,0,2,2,6,4,3,1,0,2,0,20
4885,791101,36,10,18,8,15,2,3,5,6,4,3,0,0,2,1,0,27
4885,791105,33,2,12,1,6,1,6,2,2,1,3,4,3,1,4,0,7
4885,780794,22,0,10,0,2,0,8,0,0,1,1,0,3,2,1,0,0
4885,780109,19,1,5,0,1,1,4,0,0,1,1,0,2,0,2,0,3
4885,796757,20,1,5,1,2,0,3,0,0,0,4,3,5,0,3,0,2
4885,785597,7,0,1,0,0,0,1,0,0,0,0,0,0,0,0,0,0
4885,791103,1,0,0,0,0,0,0,0,0,0,0,0,0,0,0,0,0
4885,796760,1,0,0,0,0,0,0,0,0,0,0,0,0,0,1,0,0
4886,780291,34,7,16,7,12,0,4,0,0,4,4,2,2,2,2,1,14
4886,785607,8,0,2,0,2,0,0,0,0,1,0,0,3,0,0,0,0
4886,796665,26,5,12,1,4,4,8,0,0,0,2,1,3,0,1,0,14
4886,785333,30,1,5,1,2,0,3,0,0,1,2,2,3,0,1,0,2
4886,796663,11,0,1,0,1,0,0,0,0,1,2,0,1,0,2,1,0
4886,791004,22,2,6,1,2,1,4,0,0,0,4,2,0,1,1,0,5
4886,791006,4,1,2,1,2,0,0,0,0,0,0,0,0,0,1,0,2
4886,796666,10,0,2,0,2,0,0,0,1,2,3,0,2,1,1,1,0
4886,796664,19,3,7,2,3,1,4,0,0,1,3,0,2,1,1,0,7
4886,775305,36,4,16,2,11,2,5,3,4,1,4,6,2,1,2,0,13
4887,790935,28,2,7,1,4,1,3,5,6,0,5,3,1,0,2,2,10
4887,792442,20,3,6,3,6,0,0,4,4,7,7,0,3,0,3,1,10
4887,780933,34,7,13,3,5,4,8,0,0,0,4,0,1,2,1,0,18
4887,775340,36,4,12,3,8,1,4,7,7,0,6,6,0,0,4,1,16
4887,774826,19,0,3,0,0,0,3,0,0,0,2,1,1,0,2,0,0
4887,796491,6,0,2,0,1,0,1,0,0,1,2,1,3,1,0,0,0
4887,796190,7,0,0,0,0,0,0,0,0,0,0,1,0,1,1,0,0
4887,790937,20,4,7,4,7,0,0,0,0,1,5,0,3,1,1,3,8
4887,785445,4,2,3,0,1,2,2,0,0,0,0,0,0,0,0,0,6
4887,790938,19,0,4,0,2,0,2,1,2,1,3,0,1,0,2,0,1
4887,796492,7,0,2,0,1,0,1,0,0,0,0,0,1,0,0,0,0
4888,791289,17,1,6,1,6,0,0,0,0,0,3,1,2,1,1,3,2
4888,785786,31,1,3,1,2,0,1,0,0,2,3,2,2,0,0,4,2
4888,796574,28,4,10,2,6,2,4,3,4,2,0,4,3,0,0,1,13
4888,796571,33,4,7,1,2,3,5,3,4,1,2,3,4,2,0,0,14
4888,781346,24,4,9,2,4,2,5,1,2,2,2,3,5,0,4,0,11
4888,796576,29,7,12,4,4,3,8,2,3,0,3,2,3,1,1,0,19
4888,791290,10,0,1,0,1,0,0,0,0,0,1,1,0,0,2,0,0
4888,791288,3,0,1,0,1,0,0,0,0,0,0,0,0,0,1,0,0
4888,796572,25,6,8,6,8,0,0,2,5,4,0,1,3,0,0,1,14
4889,775606,31,5,7,5,7,0,0,1,3,4,7,2,3,0,2,3,11
4889,791672,24,2,2,2,2,0,0,3,3,1,2,2,2,0,1,0,7
4889,780552,33,5,9,2,2,3,7,5,7,1,5,0,2,1,0,1,18
4889,780550,25,8,12,6,9,2,3,3,5,1,3,2,4,0,3,0,21
4889,780538,25,1,5,1,3,0,2,1,2,0,2,3,4,1,4,0,3
4889,785791,17,1,1,0,0,1,1,0,0,0,0,0,2,0,1,0,3
4889,785793,3,0,1,0,1,0,0,0,0,1,0,0,0,0,0,0,0
4889,791674,25,2,8,1,6,1,2,5,6,2,3,2,1,1,1,0,10
4889,785787,17,2,8,2,6,0,2,2,2,1,2,2,2,1,2,0,6
4890,780012,29,5,8,1,3,4,5,6,6,0,5,3,2,1,0,0,20
4890,796309,21,1,3,1,3,0,0,1,2,2,4,1,2,1,1,3,3
4890,790824,30,5,9,4,8,1,1,4,4,1,5,3,2,1,1,1,15
4890,780011,22,2,5,1,2,1,3,2,2,0,4,5,2,1,2,0,7
4890,775667,32,4,10,1,5,3,5,0,0,0,3,6,3,1,1,0,11
4890,781524,23,2,5,0,0,2,5,0,0,0,3,1,4,0,0,0,6
4890,785370,13,4,6,3,4,1,2,2,2,2,2,0,2,0,2,0,11
4890,774895,10,4,5,4,5,0,0,1,4,0,0,0,3,1,1,1,9
4890,796382,8,0,2,0,0,0,2,0,0,0,1,1,0,0,1,0,0
4890,785367,3,0,1,0,0,0,1,0,0,0,0,0,0,0,0,0,0
4890,780016,3,0,0,0,0,0,0,0,0,0,0,0,1,0,0,0,0
4890,796383,3,2,2,2,2,0,0,0,0,0,1,0,1,0,0,0,4
4890,796384,3,0,0,0,0,0,0,1,2,0,1,0,0,0,0,0,1
4891,791585,30,4,10,3,5,1,5,4,8,1,0,0,1,2,1,0,13
4891,780062,21,1,3,1,3,0,0,0,0,0,1,0,2,0,0,0,2
4891,791581,27,1,2,0,0,1,2,1,3,1,3,3,2,0,2,0,4
4891,786394,30,3,8,3,6,0,2,5,7,0,4,1,0,0,3,0,11
4891,780404,27,4,9,4,8,0,1,0,1,0,4,2,4,1,0,0,8
4891,785228,13,2,3,1,1,1,2,5,7,0,2,1,3,0,1,0,10
4891,786395,31,5,10,4,6,1,4,1,2,0,4,0,1,1,2,1,12
4891,791582,1,0,0,0,0,0,0,0,0,1,0,0,0,0,0,0,0
4891,797041,9,0,2,0,1,0,1,0,0,0,0,1,1,0,1,0,0
4891,799920,4,0,2,0,0,0,2,0,0,0,1,1,1,0,0,0,0
4891,797037,2,0,0,0,0,0,0,1,2,0,0,0,0,0,0,0,1
4891,797042,3,1,2,1,2,0,0,0,0,0,0,0,0,0,0,0,2
4891,780403,2,0,0,0,0,0,0,0,0,0,0,0,0,0,0,0,0
4892,791416,26,6,10,6,10,0,0,9,13,5,7,1,3,0,2,4,21
4892,781614,15,1,3,1,3,0,0,1,1,2,2,3,3,1,3,0,3
4892,797096,25,3,8,0,1,3,7,0,0,0,4,1,1,0,1,0,9
4892,785906,32,6,12,6,8,0,4,1,2,0,1,5,1,1,2,0,13
4892,780096,33,4,10,1,3,3,7,2,4,0,3,2,3,3,1,0,13
4892,797097,1,0,1,0,0,0,1,0,0,0,0,0,0,0,0,0,0
4892,797093,20,3,7,3,6,0,1,0,0,0,1,4,4,0,3,0,6
4892,797094,14,1,4,0,1,1,3,2,2,0,1,0,2,0,0,3,5
4892,785907,12,2,2,2,2,0,0,2,2,0,2,0,0,0,0,0,6
4892,780100,20,0,0,0,0,0,0,3,4,0,5,2,3,2,2,1,3
4892,767484,1,0,0,0,0,0,0,0,0,0,0,0,1,0,0,0,0
4892,791415,1,0,0,0,0,0,0,0,0,0,0,0,0,0,0,0,0
4893,781177,6,1,2,1,2,0,0,0,0,0,0,0,5,0,2,0,2
4893,781175,25,1,5,1,5,0,0,0,2,4,5,0,2,0,0,0,2
4893,786553,34,6,13,3,9,3,4,5,6,0,3,1,0,2,1,0,20
4893,780895,20,2,8,2,7,0,1,2,2,1,3,3,4,1,3,0,6
4893,781172,21,2,5,2,5,0,0,0,0,0,2,1,3,1,2,0,4
4893,792005,24,3,9,1,5,2,4,5,5,0,5,1,4,2,4,0,13
4893,786555,12,2,3,0,0,2,3,0,0,1,1,1,1,0,0,0,6
4893,785312,24,0,6,0,3,0,3,0,0,0,1,0,1,1,3,0,0
4893,797503,14,2,4,2,4,0,0,0,0,4,3,0,2,2,0,0,4
4893,786557,10,1,2,1,2,0,0,3,5,1,1,1,0,1,0,0,5
4893,797502,7,1,4,1,2,0,2,1,1,1,0,0,4,0,0,0,3
4893,792004,3,0,1,0,0,0,1,0,0,0,0,0,0,0,0,0,0
4894,797142,19,3,4,3,3,0,1,0,0,1,2,0,0,0,0,1,6
4894,791522,31,4,11,4,8,0,3,3,5,2,6,3,1,1,2,2,11
4894,786351,15,2,5,2,3,0,2,0,0,3,1,1,3,0,2,0,4
4894,797146,31,6,17,5,11,1,6,8,8,0,1,1,0,2,5,0,21
4894,797143,31,4,14,0,6,4,8,0,0,0,1,4,0,2,1,0,12
4894,785816,19,3,3,3,3,0,0,0,0,4,2,1,3,1,1,1,6
4894,797147,8,0,4,0,3,0,1,0,0,0,0,0,0,2,0,0,0
4894,785479,15,2,4,2,2,0,2,2,6,2,3,0,1,2,1,0,6
4894,786348,12,3,4,3,3,0,1,0,0,0,2,0,0,0,0,0,6
4894,797144,13,1,6,1,4,0,2,1,1,0,1,0,0,1,0,0,3
4894,786826,3,0,1,0,1,0,0,0,0,0,1,0,1,0,0,0,0
4894,797148,3,0,1,0,1,0,0,0,2,2,1,0,0,0,0,0,0
4895,780059,25,4,6,3,3,1,3,4,4,1,2,5,2,1,2,0,13
4895,780058,16,2,3,2,2,0,1,0,0,1,3,0,2,0,0,0,4
4895,796494,19,8,10,2,2,6,8,0,0,1,3,0,0,1,0,0,22
4895,790944,27,3,8,3,5,0,3,0,0,1,1,8,2,1,2,0,6
4895,780061,26,8,11,0,1,8,10,0,0,0,4,2,2,3,1,0,24
4895,796496,13,0,5,0,3,0,2,1,2,1,3,0,0,1,0,0,1
4895,786754,20,8,11,2,4,6,7,0,0,0,1,1,0,0,2,0,22
4895,790941,8,0,0,0,0,0,0,0,0,1,2,1,2,0,3,0,0
4895,790943,13,0,0,0,0,0,0,0,0,0,7,1,2,0,0,3,0
4895,796497,9,1,1,1,1,0,0,0,0,0,1,2,2,0,1,0,2
4895,796495,9,3,8,1,2,2,6,1,2,0,1,0,1,0,4,0,9
4895,796499,7,1,3,1,2,0,1,0,1,0,3,0,2,0,1,1,2
4895,788853,4,0,1,0,0,0,1,0,0,1,0,0,2,0,0,0,0
4895,785097,4,0,1,0,0,0,1,0,0,1,0,0,0,0,0,0,0
4896,791876,39,12,15,8,8,4,7,3,6,2,12,1,1,2,2,5,31
4896,791877,25,2,4,2,4,0,0,2,3,2,5,0,5,0,0,0,6
4896,785667,33,2,5,2,2,0,3,0,0,0,1,4,2,1,2,0,4
4896,786572,39,4,13,3,8,1,5,13,17,3,8,1,2,2,4,0,22
4896,786570,35,2,9,1,6,1,3,4,5,0,3,11,3,1,4,0,9
4896,780436,7,1,2,0,0,1,2,0,0,0,0,1,0,0,0,0,3
4896,797486,12,0,1,0,1,0,0,0,4,0,3,3,1,0,0,0,0
4896,781205,10,1,3,1,3,0,0,2,2,0,0,0,1,0,0,2,4
4897,796321,3,0,2,0,0,0,2,0,0,0,1,0,2,0,0,0,0
4897,790764,30,5,12,3,7,2,5,1,2,2,4,4,3,0,0,1,13
4897,796319,35,2,8,0,1,2,7,0,0,1,5,2,0,2,2,0,6
4897,796320,38,5,15,5,9,0,6,1,4,2,2,3,5,2,4,0,11
4897,779993,9,2,3,2,3,0,0,0,0,0,0,0,3,0,0,0,4
4897,796318,33,8,15,7,14,1,1,7,10,6,10,7,5,2,0,4,24
4897,790761,31,5,10,2,4,3,6,2,3,0,3,3,2,1,0,0,15
4897,785219,9,0,2,0,1,0,1,0,0,0,2,0,1,1,3,0,0
4897,796322,2,0,0,0,0,0,0,0,0,0,0,0,1,0,0,0,0
4897,775668,10,0,3,0,3,0,0,0,0,3,1,1,2,0,2,0,0
4898,785999,30,4,10,4,10,0,0,2,2,1,5,2,4,0,2,0,10
4898,775654,35,1,5,1,5,0,0,2,2,4,5,1,0,1,1,3,4
4898,775171,17,1,5,0,2,1,3,0,0,0,3,0,0,1,1,1,3
4898,791639,34,3,10,3,8,0,2,1,2,0,6,3,1,1,2,0,7
4898,785389,37,7,16,4,8,3,8,1,2,1,2,0,0,0,3,0,18
4898,785255,9,1,1,1,1,0,0,0,2,1,1,1,0,2,0,1,2
4898,796398,15,0,0,0,0,0,0,0,0,0,0,2,2,1,2,0,0
4898,796399,23,1,5,1,4,0,1,0,0,0,1,3,2,0,1,0,2
4899,786447,32,4,10,3,8,1,2,0,0,1,4,5,2,2,1,1,9
4899,775074,18,1,1,1,1,0,0,0,0,0,3,0,4,0,1,1,2
4899,786448,26,3,6,3,4,0,2,0,0,2,6,1,2,2,0,1,6
4899,780731,36,4,12,4,9,0,3,4,4,0,5,2,0,2,0,2,12
4899,780462,33,8,13,5,8,3,5,3,4,0,3,1,0,3,4,0,22
4899,776365,16,1,6,1,4,0,2,0,0,3,2,1,3,0,0,0,2
4899,775121,14,3,4,2,2,1,2,0,0,1,2,0,0,1,3,0,7
4899,786132,9,1,2,1,2,0,0,0,0,1,0,0,1,0,0,0,2
4899,791632,5,0,1,0,0,0,1,0,0,1,0,0,0,0,0,0,0
4899,796971,11,1,2,1,1,0,1,0,0,0,0,0,0,0,0,0,2
4916,796347,18,2,4,1,2,1,2,1,2,3,4,1,1,1,1,0,6
4916,785243,29,4,10,4,5,0,5,1,2,1,8,1,3,0,4,2,9
4916,790788,23,4,9,4,6,0,3,0,0,0,1,3,2,0,2,1,8
4916,781028,35,8,10,1,1,7,9,1,3,0,7,2,0,1,1,0,24
4916,781026,28,2,9,1,3,1,6,3,4,0,3,0,1,0,1,0,8
4916,790787,3,0,0,0,0,0,0,0,0,0,0,0,0,0,0,0,0
4916,785242,19,1,2,1,1,0,1,3,4,1,1,1,0,0,1,2,5
4916,781027,11,0,0,0,0,0,0,2,2,0,2,2,0,0,0,0,2
4916,796346,2,0,1,0,1,0,0,0,0,1,1,0,0,0,0,0,0
4916,796348,15,2,3,2,3,0,0,0,0,1,1,3,1,1,0,0,4
4916,796349,17,2,3,1,1,1,2,2,3,0,0,3,2,1,0,0,7
4917,791276,28,4,10,4,10,0,0,0,1,1,2,0,2,0,3,0,8
4917,796529,29,5,11,1,4,4,7,0,0,0,5,2,3,0,1,0,14
4917,791275,34,0,2,0,0,0,2,0,0,0,2,2,2,2,1,1,0
4917,785746,40,6,13,2,5,4,8,3,3,0,2,1,4,1,1,0,19
4917,785741,39,3,9,2,4,1,5,0,0,0,4,7,2,1,2,1,7
4917,785755,12,2,4,2,4,0,0,0,0,1,1,0,4,0,1,0,4
4917,785751,1,0,0,0,0,0,0,0,0,0,0,0,0,0,0,0,0
4917,785748,17,1,4,0,2,1,2,3,3,0,3,1,2,0,1,0,6
4918,792249,6,0,1,0,1,0,0,0,0,0,0,0,0,0,0,0,0
4918,781430,27,7,15,4,9,3,6,4,6,2,7,2,3,0,4,1,21
4918,792248,30,0,1,0,0,0,1,2,2,0,5,2,1,0,2,0,2
4918,781445,32,5,17,2,5,3,12,3,3,1,6,0,0,0,1,0,16
4918,768845,27,1,7,0,5,1,2,0,0,1,3,6,0,0,1,1,3
4918,792253,15,4,7,4,7,0,0,2,2,2,1,0,4,0,2,1,10
4918,781448,25,2,4,2,4,0,0,0,0,3,4,1,0,0,1,1,4
4918,797941,11,1,5,1,2,0,3,1,2,0,0,0,2,0,1,0,3
4918,792250,15,1,4,0,1,1,3,0,0,1,0,1,0,0,1,0,3
4918,797957,3,0,1,0,1,0,0,0,0,1,0,1,0,0,1,0,0
4918,792251,3,0,0,0,0,0,0,1,3,0,0,0,0,0,0,0,1
4918,786076,3,0,1,0,1,0,0,0,0,0,0,0,0,0,0,0,0
4918,797944,3,0,0,0,0,0,0,0,0,0,1,0,0,0,0,1,0
4919,780797,28,4,8,1,1,3,7,0,0,0,5,3,2,1,0,0,11
4919,776418,27,7,11,7,11,0,0,1,4,0,6,0,3,0,1,3,15
4919,785505,32,6,13,5,9,1,4,0,0,0,4,7,2,2,0,1,13
4919,780555,31,2,6,0,0,2,6,0,0,0,0,5,2,1,2,0,6
4919,775604,24,6,10,5,6,1,4,0,0,0,1,1,3,2,1,0,13
4919,796981,23,10,14,9,13,1,1,2,2,0,8,3,1,2,1,0,23
4919,791618,11,0,1,0,1,0,0,0,0,0,1,0,1,1,0,0,0
4919,796985,1,0,0,0,0,0,0,0,0,0,0,0,0,1,0,0,0
4919,796986,11,0,0,0,0,0,0,0,0,0,1,0,0,0,0,0,0
4919,791617,2,0,1,0,1,0,0,0,0,0,0,0,1,0,1,0,0
4919,780432,2,1,2,1,1,0,1,0,0,0,1,0,1,0,0,0,2
4919,796984,3,0,1,0,1,0,0,0,0,0,0,0,1,0,0,0,0
4919,796982,1,0,0,0,0,0,0,0,0,0,0,0,0,0,0,0,0
4919,786429,3,0,0,0,0,0,0,0,0,0,0,0,0,0,0,0,0
4919,786430,1,0,0,0,0,0,0,0,0,0,0,0,0,0,0,0,0
4920,775357,33,5,10,1,3,4,7,0,0,0,0,3,2,0,0,0,14
4920,797174,30,3,6,0,2,3,4,0,0,0,6,2,3,0,0,0,9
4920,785593,25,2,8,1,5,1,3,1,2,0,1,1,0,0,0,0,6
4920,786699,22,1,2,1,2,0,0,0,0,1,1,0,2,0,0,0,2
4920,791510,19,1,5,1,3,0,2,0,0,2,2,0,3,1,3,0,2
4920,797168,25,8,11,5,7,3,4,1,1,0,8,3,1,1,3,0,20
4920,791504,19,4,6,4,6,0,0,2,3,0,1,2,2,0,2,1,10
4920,791507,18,1,3,1,3,0,0,0,1,0,0,0,1,0,0,0,2
4920,791505,9,1,2,1,1,0,1,0,0,0,0,1,2,1,0,0,2
4921,791339,38,7,15,3,7,4,8,3,5,0,2,3,2,2,0,0,21
4921,797877,34,4,6,4,6,0,0,6,8,2,4,0,2,1,3,3,14
4921,797872,37,4,7,3,4,1,3,0,0,0,3,0,3,0,3,0,9
4921,791337,23,0,3,0,3,0,0,2,2,1,2,0,2,0,1,0,2
4921,791338,20,0,1,0,0,0,1,0,0,0,2,3,1,0,2,1,0
4921,781595,24,2,6,1,2,1,4,0,0,0,0,3,0,0,0,0,5
4921,781599,17,1,1,1,1,0,0,1,3,1,3,1,1,0,1,2,3
4921,791335,6,0,1,0,1,0,0,0,0,1,0,1,2,0,2,0,0
4921,797874,1,0,0,0,0,0,0,0,0,0,0,0,0,0,1,0,0
4922,786118,38,6,10,1,4,5,6,2,2,1,4,0,4,2,3,1,19
4922,797673,35,6,16,5,10,1,6,5,9,4,5,3,2,3,0,1,18
4922,786117,40,4,9,4,8,0,1,4,5,0,2,3,2,2,3,0,12
4922,786123,40,4,8,4,8,0,0,1,3,2,7,4,2,2,3,2,9
4922,780437,35,4,11,4,10,0,1,1,1,2,3,3,3,0,0,0,9
4922,797672,6,1,2,1,2,0,0,1,2,1,1,0,0,2,1,0,3
4922,792093,6,0,3,0,3,0,0,0,0,2,0,1,1,0,0,0,0
4922,797675,0,0,0,0,0,0,0,0,0,0,0,0,0,0,0,0,0
4923,792376,36,5,14,1,7,4,7,2,3,0,4,2,4,2,5,0,16
4923,786746,34,4,11,1,4,3,7,0,0,2,1,2,4,0,2,0,11
4923,780178,18,4,9,4,9,0,0,0,0,4,3,2,1,0,1,2,8
4923,775075,18,1,3,1,3,0,0,0,0,2,5,1,1,0,1,2,2
4923,797883,20,0,2,0,2,0,0,0,0,1,0,2,3,0,2,0,0
4923,792378,21,3,7,3,7,0,0,2,2,7,3,0,3,0,2,3,8
4923,792374,20,2,4,1,2,1,2,1,2,0,0,3,0,2,3,1,6
4923,786747,15,0,4,0,2,0,2,2,2,0,1,0,1,0,1,1,2
4923,797890,14,0,3,0,2,0,1,1,2,1,1,0,2,0,2,0,1
4923,797888,4,0,2,0,2,0,0,0,0,0,2,0,0,0,0,0,0
4924,792373,25,6,10,6,9,0,1,0,0,0,3,0,2,0,0,0,12
4924,792370,37,3,11,3,6,0,5,0,0,0,2,3,0,0,1,2,6
4924,797960,22,0,1,0,0,0,1,0,0,2,0,1,3,0,2,0,0
4924,786739,27,1,5,1,4,0,1,0,0,0,4,3,1,2,6,0,2
4924,775303,31,3,7,1,3,2,4,6,9,0,5,0,0,0,2,0,14
4924,797958,15,1,4,0,0,1,4,0,0,0,2,1,0,0,0,0,3
4924,781598,6,0,3,0,1,0,2,0,0,0,1,0,4,0,0,0,0
4924,797951,19,1,5,1,3,0,2,0,0,0,1,1,2,0,2,1,2
4924,790499,13,0,3,0,3,0,0,0,0,0,2,1,3,1,3,1,0
4924,781597,5,0,0,0,0,0,0,0,0,0,1,0,0,0,0,0,0
4925,775897,16,2,2,2,2,0,0,0,0,0,1,0,3,0,1,0,4
4925,780324,21,7,8,7,8,0,0,1,2,0,5,3,0,1,0,0,15
4925,791543,21,1,3,0,1,1,2,0,0,0,3,2,1,1,1,0,3
4925,786530,28,1,3,0,0,1,3,0,0,0,2,2,1,3,1,0,3
4925,780317,27,4,10,3,6,1,4,2,4,2,3,3,1,2,0,0,11
4925,791546,21,3,4,3,3,0,1,3,3,0,3,6,0,0,0,0,9
4925,791545,15,2,4,2,3,0,1,4,4,1,4,0,2,1,2,0,8
4925,786360,9,2,4,1,1,1,3,0,0,0,0,1,0,0,0,0,5
4925,784246,19,5,10,5,8,0,2,0,1,1,3,1,1,2,2,1,10
4925,786362,2,0,0,0,0,0,0,0,0,0,0,0,0,1,0,0,0
4925,797092,5,1,3,1,3,0,0,0,0,0,2,0,1,0,0,1,2
4925,797091,9,0,2,0,2,0,0,0,0,0,1,1,2,0,1,0,0
4925,791547,5,2,3,1,1,1,2,0,0,1,1,0,0,0,1,0,5
4925,775437,2,0,0,0,0,0,0,0,0,0,0,0,0,0,0,0,0
4926,781462,38,9,15,7,13,2,2,1,2,3,0,3,2,2,0,2,21
4926,780876,28,8,12,3,4,5,8,0,0,0,4,3,0,1,2,0,21
4926,785353,37,8,12,2,5,6,7,0,0,0,4,6,2,3,1,0,22
4926,781673,39,0,3,0,1,0,2,1,2,1,1,3,3,0,0,0,1
4926,781457,34,3,7,2,2,1,5,1,2,0,4,4,3,5,3,0,8
4926,791305,4,0,0,0,0,0,0,0,0,0,0,0,2,0,1,0,0
4926,790895,17,2,4,1,2,1,2,2,2,0,1,2,0,0,2,0,7
4926,796365,1,1,1,0,0,1,1,0,0,0,0,0,1,0,1,0,3
4926,792435,1,0,0,0,0,0,0,0,0,0,0,0,0,0,0,0,0
4926,790806,1,0,0,0,0,0,0,0,0,0,0,0,0,0,0,0,0
4926,776275,0,0,0,0,0,0,0,0,0,0,0,0,0,0,0,0,0
4926,792434,0,0,0,0,0,0,0,0,0,0,0,0,0,0,0,0,0
4926,790805,0,0,0,0,0,0,0,0,0,0,0,0,0,0,0,0,0
4927,780879,32,9,13,9,13,0,0,1,1,3,2,3,3,2,4,0,19
4927,775785,18,0,3,0,2,0,1,0,0,1,3,4,3,1,2,1,0
4927,790768,18,1,4,0,0,1,4,0,0,0,3,1,2,0,3,0,3
4927,785226,29,5,8,3,6,2,2,0,0,3,1,2,3,0,1,0,12
4927,780875,32,6,9,4,7,2,2,0,0,1,6,1,0,0,2,2,14
4927,785224,5,0,2,0,1,0,1,2,2,1,0,0,0,0,1,0,2
4927,790769,12,0,2,0,0,0,2,0,0,0,0,1,0,0,1,0,0
4927,785743,26,3,5,0,1,3,4,1,2,0,0,2,0,1,1,0,10
4927,796326,7,0,0,0,0,0,0,2,2,0,0,0,2,0,2,0,2
4927,790767,20,1,2,0,0,1,2,0,0,0,2,2,1,2,2,0,3
4927,796324,1,0,0,0,0,0,0,0,0,0,0,0,1,0,0,0,0
4928,785714,15,6,6,6,6,0,0,0,1,1,3,0,3,0,3,1,12
4928,775894,36,9,13,8,9,1,4,7,12,1,2,1,4,3,1,0,26
4928,785711,36,4,11,1,4,3,7,6,6,3,1,3,3,1,1,0,17
4928,780985,36,1,4,1,1,0,3,0,0,0,0,3,1,1,1,0,2
4928,775266,32,1,10,1,5,0,5,3,5,0,4,0,3,1,1,0,5
4928,796829,19,3,3,3,3,0,0,0,0,3,2,0,3,0,0,1,6
4928,779994,10,0,5,0,2,0,3,0,0,0,3,1,0,0,1,0,0
4928,791167,5,0,0,0,0,0,0,0,0,0,1,0,1,0,0,0,0
4928,785378,11,1,6,1,5,0,1,0,0,0,4,0,3,1,0,0,2
4929,785384,21,3,8,2,4,1,4,3,4,2,1,1,4,0,1,1,10
4929,780025,34,12,19,12,19,0,0,5,8,2,4,0,1,0,2,0,29
4929,796391,34,4,5,2,3,2,2,5,8,0,6,3,4,0,1,0,15
4929,785385,36,1,8,1,4,0,4,0,0,1,7,3,2,0,1,0,2
4929,785383,36,2,11,0,4,2,7,6,6,2,4,5,4,1,5,0,12
4929,790837,24,2,3,2,2,0,1,0,0,0,7,2,1,1,2,0,4
4929,781046,10,1,1,1,1,0,0,0,0,2,0,0,4,0,0,0,2
4929,786297,4,0,1,0,1,0,0,0,0,1,0,0,1,0,0,0,0
4929,792180,1,0,0,0,0,0,0,0,0,0,0,0,0,0,0,0,0
4930,791302,28,2,4,2,4,0,0,2,4,3,6,0,2,2,3,0,6
4930,781622,25,3,6,1,2,2,4,0,0,0,1,0,3,0,0,0,8
4930,791309,35,4,15,4,13,0,2,2,2,1,1,7,1,0,2,0,10
4930,785835,25,3,8,3,7,0,1,0,0,1,3,2,1,0,2,0,6
4930,776334,30,3,12,3,8,0,4,1,1,1,4,3,0,5,0,2,7
4930,796601,22,3,9,1,4,2,5,2,2,1,4,0,4,1,2,0,10
4930,775862,27,8,12,8,12,0,0,0,0,6,0,0,3,1,1,0,16
4930,796604,5,0,0,0,0,0,0,0,0,0,1,0,0,1,0,0,0
4930,796603,3,0,1,0,1,0,0,0,0,1,0,0,1,0,0,0,0
4931,797223,4,0,0,0,0,0,0,0,0,0,1,0,0,0,1,0,0
4931,781526,30,3,9,3,8,0,1,0,0,3,10,2,3,1,2,1,6
4931,797217,30,0,6,0,5,0,1,3,5,2,3,4,2,2,5,1,3
4931,791453,23,1,3,1,1,0,2,1,2,1,2,1,0,1,2,0,3
4931,775697,30,2,7,2,3,0,4,0,0,0,2,2,2,0,2,0,4
4931,791454,15,3,8,2,6,1,2,5,6,2,1,1,2,0,0,0,12
4931,797218,33,9,17,9,14,0,3,0,1,4,3,0,2,1,1,0,18
4931,797222,21,6,6,6,6,0,0,0,0,2,2,0,0,0,1,4,12
4931,791846,14,0,1,0,1,0,0,4,4,1,0,1,0,0,1,0,4
4932,792154,31,10,15,8,10,2,5,4,5,1,1,0,2,0,1,0,26
4932,780138,28,9,10,9,10,0,0,4,6,2,6,1,4,3,4,0,22
4932,792152,38,5,11,3,6,2,5,2,2,0,0,3,0,0,3,0,14
4932,780581,29,3,6,2,5,1,1,3,4,1,7,11,1,0,2,1,10
4932,792158,18,4,6,4,6,0,0,2,2,2,1,2,4,2,2,0,10
4932,797755,16,1,1,1,1,0,0,0,0,0,0,0,1,1,0,0,2
4932,786014,15,1,2,1,2,0,0,0,0,0,2,0,1,1,2,0,2
4932,792157,18,0,3,0,3,0,0,0,6,3,2,2,1,1,1,0,0
4932,797756,7,0,1,0,0,0,1,0,0,0,1,3,1,1,1,0,0
4933,791923,32,7,11,7,10,0,1,4,4,0,2,0,3,0,5,0,18
4933,791925,30,3,8,3,7,0,1,0,0,1,1,2,1,2,0,1,6
4933,791926,12,1,9,0,4,1,5,0,0,1,0,1,0,0,2,0,3
4933,781112,17,1,2,1,2,0,0,0,0,0,0,3,0,0,1,0,2
4933,781122,10,1,1,1,1,0,0,0,0,0,0,0,4,0,1,0,2
4933,797541,23,5,6,5,6,0,0,5,5,0,7,2,2,2,2,1,15
4933,797542,28,4,10,3,4,1,6,0,0,0,2,11,2,3,3,0,9
4933,786527,16,2,3,1,1,1,2,4,4,0,1,0,3,0,1,0,9
4933,791927,14,3,3,2,2,1,1,0,0,0,0,0,3,0,0,0,7
4933,797543,2,1,1,0,0,1,1,0,0,0,0,0,0,0,0,0,3
4933,786529,10,0,0,0,0,0,0,0,0,0,1,0,2,0,0,1,0
4933,791922,4,0,0,0,0,0,0,0,0,0,1,0,0,0,0,0,0
4933,786858,2,0,0,0,0,0,0,0,0,0,0,0,0,0,0,0,0
4934,781378,31,6,10,2,4,4,6,1,1,2,5,0,1,1,3,2,17
4934,797016,21,5,11,3,6,2,5,3,3,2,1,0,3,2,0,0,15
4934,775267,29,3,8,0,0,3,8,0,0,1,3,3,1,2,2,0,9
4934,797019,21,3,6,3,4,0,2,3,4,0,2,8,2,0,5,0,9
4934,791440,28,3,4,3,4,0,0,2,3,1,5,0,4,0,4,0,8
4934,797013,16,5,9,4,6,1,3,0,0,0,2,1,3,1,2,0,11
4934,791441,19,4,6,2,3,2,3,0,1,0,0,6,1,2,5,1,10
4934,791443,16,0,2,0,1,0,1,2,4,0,1,0,2,0,0,1,2
4934,797015,12,0,6,0,4,0,2,2,2,0,1,0,0,0,0,0,2
4934,781629,7,0,0,0,0,0,0,0,0,1,2,0,3,0,2,0,0
4935,797601,34,10,15,4,5,6,10,1,4,0,5,4,2,0,2,0,27
4935,775563,28,7,10,7,10,0,0,1,1,1,4,2,3,4,5,0,15
4935,797604,28,3,6,3,5,0,1,0,0,1,3,3,3,6,0,0,6
4935,781011,12,2,2,2,2,0,0,0,0,1,0,1,5,0,1,0,4
4935,775119,25,8,14,8,12,0,2,7,9,0,5,3,4,3,4,0,23
4935,786466,13,2,3,2,3,0,0,0,0,1,1,0,2,0,1,0,4
4935,775188,24,1,2,1,2,0,0,0,0,0,4,4,1,2,1,0,2
4935,797602,1,0,1,0,1,0,0,0,0,0,0,0,0,0,0,0,0
4935,781012,35,2,7,1,3,1,4,6,7,1,3,2,0,2,5,0,11
4936,797358,29,4,9,1,3,3,6,0,0,2,4,4,3,0,3,1,11
4936,785416,28,3,5,3,5,0,0,2,2,0,8,4,1,0,3,0,8
4936,786578,20,3,9,2,4,1,5,0,0,1,3,0,3,0,1,3,7
4936,797357,30,2,5,2,4,0,1,1,1,0,2,5,1,2,3,0,5
4936,785669,26,1,2,1,2,0,0,0,0,0,2,1,2,1,4,0,2
4936,786136,17,5,8,5,8,0,0,3,6,1,2,0,3,1,1,1,13
4936,776236,28,5,10,4,7,1,3,1,1,0,4,1,3,2,1,0,12
4936,775195,17,2,6,0,1,2,5,0,0,0,2,0,2,0,2,0,6
4936,797359,3,0,0,0,0,0,0,0,0,0,1,0,0,0,1,0,0
4936,775747,2,0,1,0,1,0,0,0,0,0,0,0,1,0,0,0,0
4936,786140,0,0,0,0,0,0,0,0,0,0,0,0,1,0,0,0,0
4937,786066,35,5,12,4,10,1,2,5,6,3,6,2,1,2,3,0,16
4937,780167,34,3,8,3,7,0,1,6,6,1,4,2,3,1,2,1,12
4937,775574,29,5,13,3,8,2,5,0,2,0,2,2,2,2,5,0,12
4937,780890,19,2,3,0,1,2,2,2,3,1,3,0,1,1,1,0,8
4937,775757,14,1,2,1,2,0,0,0,2,0,1,0,1,0,0,0,2
4937,785636,29,3,5,1,1,2,4,2,2,0,3,3,2,1,2,0,10
4937,786646,20,2,7,2,4,0,3,2,2,1,6,1,2,2,0,0,6
4937,791123,20,2,6,2,3,0,3,0,0,1,0,2,0,0,0,0,4
4938,790930,30,5,7,3,4,2,3,2,3,0,6,2,2,0,0,0,14
4938,775011,26,1,6,0,1,1,5,0,0,0,4,2,3,1,0,0,3
4938,776004,17,4,6,2,3,2,3,0,0,0,2,0,1,0,1,0,10
4938,780357,34,3,8,0,2,3,6,2,2,0,0,3,1,1,0,0,11
4938,775018,34,4,11,2,5,2,6,2,2,0,2,4,2,0,2,0,12
4938,780358,22,2,8,2,5,0,3,2,2,1,4,1,2,2,3,1,6
4938,796480,22,3,6,3,6,0,0,2,2,3,3,2,1,1,1,1,8
4938,776270,10,2,3,2,2,0,1,0,0,0,2,0,0,0,0,0,4
4938,796485,1,0,0,0,0,0,0,0,0,0,2,0,1,0,0,0,0
4938,796486,1,0,0,0,0,0,0,0,0,0,0,0,0,0,1,0,0
4938,796483,1,0,0,0,0,0,0,0,0,0,0,0,0,0,0,0,0
4938,796482,1,0,0,0,0,0,0,0,0,0,0,0,0,0,0,0,0
4938,785491,1,0,0,0,0,0,0,0,0,0,0,0,0,0,0,0,0
4939,791917,22,1,7,1,2,0,5,0,0,0,1,1,2,0,1,0,2
4939,786526,28,3,7,2,5,1,2,1,2,1,11,2,2,0,1,0,8
4939,786525,31,4,8,4,6,0,2,2,2,0,1,0,2,0,1,0,10
4939,791914,33,4,11,3,4,1,7,0,0,0,0,5,3,1,4,0,9
4939,786030,29,6,12,2,7,4,5,0,1,1,2,0,3,2,1,1,16
4939,781109,27,2,2,1,1,1,1,0,0,0,5,0,1,0,1,0,5
4939,786856,11,0,1,0,1,0,0,0,0,0,1,1,1,0,0,1,0
4939,786524,6,1,1,1,1,0,0,0,0,0,1,0,2,0,1,0,2
4939,797550,11,0,1,0,0,0,1,0,0,0,1,1,1,0,0,0,0
4939,797551,1,0,1,0,1,0,0,0,2,0,0,0,0,0,0,0,0
4939,797552,1,0,0,0,0,0,0,0,0,0,0,0,0,0,0,0,0
4940,781174,35,4,9,4,8,0,1,1,1,5,3,0,3,1,0,0,9
4940,781159,32,5,12,4,7,1,5,4,5,3,8,3,1,0,1,0,15
4940,791001,22,1,4,1,3,0,1,2,2,0,1,1,4,0,1,0,4
4940,781215,29,7,13,5,8,2,5,1,1,2,4,2,3,3,0,0,17
4940,775255,36,7,16,4,9,3,7,4,4,1,3,4,1,0,2,0,21
4940,785320,10,1,3,1,1,0,2,0,0,1,1,0,0,1,1,0,2
4940,785231,18,0,5,0,3,0,2,3,4,0,2,0,2,2,2,0,3
4940,779972,15,1,5,1,3,0,2,0,0,1,3,2,0,0,1,0,2
4940,796644,3,0,0,0,0,0,0,0,0,0,0,0,0,0,0,0,0
4941,791281,32,6,16,6,16,0,0,5,7,1,8,1,4,1,1,2,17
4941,785764,12,2,4,2,4,0,0,0,0,2,0,0,2,0,0,0,4
4941,792276,31,1,10,0,5,1,5,0,0,0,3,3,0,0,2,0,3
4941,785507,24,2,5,1,1,1,4,0,0,0,6,0,4,0,2,0,5
4941,785398,24,2,4,2,3,0,1,4,4,1,5,1,0,0,4,0,8
4941,796534,22,1,2,1,1,0,1,0,0,1,0,0,3,1,1,0,2
4941,796536,9,0,0,0,0,0,0,0,0,0,1,0,0,0,0,0,0
4941,796535,23,2,3,1,2,1,1,1,3,0,1,1,2,1,3,0,6
4941,775814,19,3,6,3,5,0,1,0,0,0,1,0,1,3,2,0,6
4941,785763,2,0,0,0,0,0,0,0,0,0,0,0,0,0,0,0,0
4941,796537,2,0,0,0,0,0,0,0,0,0,0,0,0,0,0,0,0
4942,785536,9,1,3,1,2,0,1,0,0,0,3,0,0,0,0,0,2
4942,780119,27,5,11,5,11,0,0,0,0,4,1,2,2,0,1,0,10
4942,796559,32,2,9,2,5,0,4,1,2,1,4,2,2,1,2,1,5
4942,780149,11,0,5,0,3,0,2,2,2,0,1,0,0,1,2,1,2
4942,776097,34,6,10,4,6,2,4,0,1,1,3,5,5,4,5,1,14
4942,796558,20,5,9,5,9,0,0,0,0,2,2,2,4,0,3,0,10
4942,785280,32,7,12,7,11,0,1,8,10,0,3,2,3,1,1,0,22
4942,796560,28,3,4,2,3,1,1,0,0,2,5,2,3,1,1,2,7
4942,785285,2,0,0,0,0,0,0,0,0,0,0,0,1,0,0,0,0
4942,775679,5,1,2,0,0,1,2,0,0,0,0,1,0,0,0,0,3
4943,796699,25,3,8,2,5,1,3,5,6,2,3,0,2,3,3,2,12
4943,790983,23,1,5,1,3,0,2,0,0,1,3,2,2,0,0,2,2
4943,790979,24,2,7,2,3,0,4,3,4,0,4,1,4,4,4,0,7
4943,796697,37,9,19,7,13,2,6,5,6,1,3,4,2,0,4,0,25
4943,788820,24,3,6,1,3,2,3,1,2,1,2,0,4,0,0,0,9
4943,796701,11,2,2,2,2,0,0,0,0,1,0,0,2,0,2,1,4
4943,790976,10,1,1,1,1,0,0,0,1,2,2,0,0,0,1,2,2
4943,790978,23,0,3,0,0,0,3,1,2,0,1,2,1,0,1,0,1
4943,790980,11,3,4,1,2,2,2,0,0,1,3,0,1,0,1,2,8
4943,796698,12,1,3,1,3,0,0,1,3,2,1,1,0,0,0,0,3
4944,797367,32,2,6,2,6,0,0,3,4,6,6,2,3,3,2,2,7
4944,797369,35,2,3,2,2,0,1,0,0,1,4,2,3,0,1,0,4
4944,797366,26,0,2,0,2,0,0,2,5,4,3,3,2,1,1,1,2
4944,786130,36,5,15,4,9,1,6,3,8,3,9,1,2,1,6,0,14
4944,797364,7,1,2,1,2,0,0,0,0,0,2,0,4,0,2,0,2
4944,797363,21,2,6,2,6,0,0,1,2,0,1,3,2,0,4,0,5
4944,791808,7,0,0,0,0,0,0,0,0,0,0,0,1,0,0,0,0
4944,797371,1,0,0,0,0,0,0,0,0,0,0,0,0,0,0,0,0
4944,791807,35,9,19,4,9,5,10,7,7,1,4,1,0,0,0,0,30
4945,786805,24,3,10,3,9,0,1,0,1,4,3,1,4,0,3,1,6
4945,774936,19,6,8,6,8,0,0,0,0,1,4,3,2,0,2,1,12
4945,790933,35,3,8,3,5,0,3,1,2,0,1,5,4,2,1,0,7
4945,781345,39,1,11,0,5,1,6,3,4,3,4,7,4,3,1,1,6
4945,786803,36,3,9,3,7,0,2,1,3,0,1,2,0,0,1,0,7
4945,790934,20,6,10,5,8,1,2,3,5,2,1,1,4,0,1,0,16
4945,786804,16,0,3,0,0,0,3,0,0,1,3,0,1,1,1,0,0
4945,796487,4,0,0,0,0,0,0,0,0,0,0,0,0,0,1,0,0
4945,790931,6,1,2,0,0,1,2,0,0,0,1,1,1,0,0,0,3
4945,780033,1,0,0,0,0,0,0,0,0,0,0,1,0,0,0,0,0
4962,792140,27,6,11,6,11,0,0,1,2,3,2,2,2,0,1,1,13
4962,776092,37,4,13,4,9,0,4,1,2,1,4,4,3,2,4,0,9
4962,786596,25,1,5,1,2,0,3,2,2,0,6,1,4,0,2,0,4
4962,792144,28,1,5,0,1,1,4,0,2,4,7,1,1,0,3,3,3
4962,781431,4,0,0,0,0,0,0,3,4,0,1,0,0,0,0,0,3
4962,785976,22,1,5,1,1,0,4,0,0,0,0,2,2,0,2,0,2
4962,792146,13,0,3,0,3,0,0,2,4,1,4,0,1,0,0,0,2
4962,792148,5,0,0,0,0,0,0,0,0,0,2,0,3,0,0,0,0
4962,781429,39,3,12,0,1,3,11,3,3,0,1,0,2,1,2,0,12
4963,780730,23,7,15,6,10,1,5,0,0,0,3,0,2,1,1,0,15
4963,791219,36,3,10,2,5,1,5,2,3,3,10,0,2,1,0,0,9
4963,791220,28,3,5,2,4,1,1,2,2,1,4,3,4,0,3,0,9
4963,786396,22,1,6,1,4,0,2,0,0,1,4,0,1,0,2,0,2
4963,776217,24,0,0,0,0,0,0,0,0,0,3,0,4,3,1,1,0
4963,790818,30,4,11,3,9,1,2,3,4,2,0,5,1,1,3,0,12
4963,786824,24,4,7,4,6,0,1,4,6,1,6,1,1,2,0,0,12
4963,791221,9,0,1,0,0,0,1,0,0,0,2,0,2,0,1,0,0
4963,796920,2,0,1,0,1,0,0,0,0,0,0,0,0,0,0,0,0
4963,796923,2,0,0,0,0,0,0,0,1,0,0,0,1,0,1,0,0
4964,797463,37,7,16,6,12,1,4,1,1,0,4,4,0,0,3,1,16
4964,791858,39,4,6,1,1,3,5,0,1,2,5,5,3,0,1,0,11
4964,791109,34,3,6,2,4,1,2,4,7,0,4,4,4,1,5,0,11
4964,797466,22,4,8,4,7,0,1,1,5,0,3,0,2,1,1,0,9
4964,785625,23,1,1,0,0,1,1,3,4,0,1,0,3,0,3,0,6
4964,797464,19,4,6,4,6,0,0,3,4,2,5,1,4,0,4,0,11
4964,797465,18,1,3,1,1,0,2,0,0,1,1,0,2,1,0,0,2
4964,797469,8,0,1,0,1,0,0,0,0,0,0,0,0,0,0,0,0
4965,789102,30,7,12,4,8,3,4,3,4,0,4,6,2,2,0,0,20
4965,781371,23,3,6,0,2,3,4,3,5,2,2,3,4,0,0,0,12
4965,789101,30,3,9,3,6,0,3,0,0,3,2,1,2,0,1,0,6
4965,785459,14,2,5,2,5,0,0,0,0,1,2,0,1,2,1,0,4
4965,781367,13,1,3,1,1,0,2,0,0,0,0,0,2,0,4,0,2
4965,788037,22,5,10,4,8,1,2,3,4,1,7,0,2,1,1,0,14
4965,797731,19,4,7,4,7,0,0,1,2,1,0,1,3,1,3,0,9
4965,792064,16,3,4,0,0,3,4,0,0,0,0,1,0,0,0,0,9
4965,792066,19,1,2,1,1,0,1,0,0,0,2,1,3,0,1,3,2
4965,792063,14,0,3,0,1,0,2,0,0,0,0,1,2,0,0,0,0
4966,796912,34,6,7,1,2,5,5,2,2,0,2,5,1,3,1,0,19
4966,774964,24,7,9,7,9,0,0,1,2,3,7,1,3,0,2,3,15
4966,775626,28,3,11,3,8,0,3,6,7,0,4,1,1,1,0,2,12
4966,774962,31,3,5,1,1,2,4,1,2,0,2,5,1,0,5,0,9
4966,796907,19,0,2,0,1,0,1,0,0,0,2,1,3,1,1,0,0
4966,796910,17,3,5,3,5,0,0,1,2,0,0,3,2,0,1,0,7
4966,785606,7,2,4,2,4,0,0,0,0,1,1,0,1,1,0,0,4
4966,796906,18,1,5,0,2,1,3,0,0,0,1,2,3,0,1,1,3
4966,775566,16,1,3,1,2,0,1,0,0,0,2,0,2,1,2,0,2
4966,796908,3,0,1,0,0,0,1,0,0,0,1,0,0,0,0,0,0
4966,785609,3,0,0,0,0,0,0,0,0,0,0,0,1,0,1,0,0
4967,791583,29,7,13,7,13,0,0,2,4,6,5,2,3,0,2,3,16
4967,780580,30,3,14,2,8,1,6,6,6,0,4,6,2,1,4,0,13
4967,781407,25,5,6,5,5,0,1,0,0,1,3,1,4,0,1,0,10
4967,776150,28,4,10,3,7,1,3,0,2,2,3,2,1,1,2,0,9
4967,786110,25,1,4,0,1,1,3,2,2,1,1,2,2,1,2,0,5
4967,797448,17,1,4,0,0,1,4,2,2,1,0,0,0,0,0,2,5
4967,797445,12,0,2,0,1,0,1,4,4,1,2,1,1,0,0,0,4
4967,786659,11,1,4,1,4,0,0,1,2,2,2,0,1,0,2,0,3
4967,785623,13,1,4,1,3,0,1,0,0,1,1,1,1,2,0,1,2
4967,786608,10,1,2,1,1,0,1,0,0,1,0,1,1,1,0,0,2
4968,791062,23,5,9,5,7,0,2,2,2,1,2,1,5,1,3,1,12
4968,791063,27,3,6,2,2,1,4,0,0,0,7,3,1,1,1,0,7
4968,796735,25,0,4,0,1,0,3,0,0,0,1,2,4,1,1,0,0
4968,785542,35,4,6,3,4,1,2,0,0,0,1,3,2,2,0,1,9
4968,780743,36,8,12,5,6,3,6,1,1,0,2,3,1,0,3,0,20
4968,796741,3,1,1,1,1,0,0,0,0,0,0,0,1,0,0,0,2
4968,785548,17,0,2,0,0,0,2,0,0,0,2,0,1,0,2,0,0
4968,791064,31,4,11,1,4,3,7,0,0,0,1,4,0,1,1,0,11
4968,796737,3,0,0,0,0,0,0,0,0,0,0,0,1,0,0,0,0
4969,785622,33,4,11,3,5,1,6,7,8,4,5,0,3,1,4,0,16
4969,781058,22,5,8,5,8,0,0,1,2,3,4,0,3,0,2,0,11
4969,780327,26,3,4,3,4,0,0,4,6,3,6,1,2,1,2,0,10
4969,797458,29,2,4,1,2,1,2,2,2,0,4,2,0,1,2,0,7
4969,797451,28,1,5,1,3,0,2,0,0,0,2,2,1,1,4,0,2
4969,791848,8,0,1,0,0,0,1,0,0,0,2,1,0,0,0,0,0
4969,797455,14,3,4,3,4,0,0,0,0,0,1,0,0,0,0,0,6
4969,791849,17,3,7,1,1,2,6,1,1,0,0,2,0,2,0,0,9
4969,786607,14,1,5,0,1,1,4,0,0,2,0,2,2,1,2,0,3
4969,797453,1,0,0,0,0,0,0,0,0,0,0,0,0,0,0,0,0
4969,797456,8,1,1,0,0,1,1,0,0,0,0,0,0,0,0,0,3
4970,791295,29,6,14,6,14,0,0,2,3,8,5,1,4,1,2,1,14
4970,776345,30,5,13,5,13,0,0,4,12,4,0,0,4,0,3,6,14
4970,796579,40,2,7,0,2,2,5,2,2,1,5,2,4,1,3,0,8
4970,785794,48,7,18,6,12,1,6,2,3,2,4,2,0,0,0,1,17
4970,781373,43,9,17,7,13,2,4,5,7,0,9,2,2,4,2,0,25
4970,781379,5,0,0,0,0,0,0,0,0,0,2,0,0,0,1,0,0
4970,791293,23,2,4,2,3,0,1,0,0,0,3,1,0,0,2,0,4
4970,796580,10,0,1,0,0,0,1,0,0,0,0,2,1,0,0,0,0
4970,785792,14,2,2,1,1,1,1,0,0,0,0,0,0,2,1,0,5
4970,791292,8,0,0,0,0,0,0,0,0,0,3,0,0,1,1,0,0
4971,797715,34,1,8,1,2,0,6,0,0,0,5,11,3,1,4,0,2
4971,780937,46,6,13,2,3,4,10,3,4,2,7,1,2,1,3,1,19
4971,780938,17,0,1,0,0,0,1,0,0,1,1,1,2,2,2,0,0
4971,791149,41,4,15,2,9,2,6,3,6,0,9,1,4,3,1,0,13
4971,791950,19,3,5,1,1,2,4,0,0,0,0,2,2,0,3,0,8
4971,797716,7,2,3,2,3,0,0,0,0,0,0,0,2,0,3,0,4
4971,797717,29,8,10,6,7,2,3,0,0,2,4,0,4,1,1,0,18
4971,792115,27,3,5,3,4,0,1,4,5,1,2,2,3,2,1,0,10
4971,792113,9,2,3,1,2,1,1,0,0,0,0,0,0,0,0,0,5
4971,780779,21,2,6,0,0,2,6,0,0,1,1,0,2,0,0,0,6
4972,790856,22,8,10,8,10,0,0,2,4,0,6,3,4,2,2,0,18
4972,780452,33,3,11,3,10,0,1,4,6,2,5,1,3,1,1,0,10
4972,796413,25,3,8,2,4,1,4,0,0,0,4,2,1,1,2,0,7
4972,796408,32,7,12,5,9,2,3,4,7,1,3,3,3,2,3,2,20
4972,796407,30,3,5,3,4,0,1,2,2,2,4,8,2,2,1,0,8
4972,780450,8,0,1,0,1,0,0,0,0,0,0,0,1,0,1,0,0
4972,796410,22,1,6,1,6,0,0,2,2,1,5,0,2,2,1,0,4
4972,796409,17,4,7,4,7,0,0,5,6,1,1,0,2,2,1,1,13
4972,796411,3,0,1,0,1,0,0,0,0,0,0,0,1,0,0,0,0
4972,790858,7,0,1,0,1,0,0,0,0,1,0,1,0,0,0,0,0
4972,796412,1,0,0,0,0,0,0,0,0,0,0,0,0,0,0,0,0
4973,790899,20,2,6,2,6,0,0,4,4,5,2,2,4,1,1,0,8
4973,790897,26,0,4,0,1,0,3,0,0,1,4,0,2,1,1,0,0
4973,785442,30,9,16,2,4,7,12,2,3,2,5,1,0,0,3,1,27
4973,785579,37,8,15,5,9,3,6,8,10,0,3,5,1,2,3,0,27
4973,775737,25,1,5,0,1,1,4,0,0,0,2,2,3,0,1,0,3
4973,796447,15,1,2,1,2,0,0,0,0,0,4,0,2,0,0,0,2
4973,790898,11,0,2,0,1,0,1,0,0,0,0,2,2,0,4,0,0
4973,799907,7,0,2,0,1,0,1,0,0,0,1,0,1,0,5,0,0
4973,785448,6,0,1,0,0,0,1,0,0,0,1,1,0,0,0,0,0
4973,775959,23,2,6,0,0,2,6,0,0,0,3,1,1,1,1,1,6
4974,791289,13,2,3,2,3,0,0,0,0,0,0,0,3,1,1,1,4
4974,785786,26,2,3,2,2,0,1,2,2,3,4,3,2,0,2,6,6
4974,796574,25,3,5,2,3,1,2,3,4,0,3,2,1,0,1,0,10
4974,796571,31,4,7,2,4,2,3,1,3,3,4,1,3,2,0,0,11
4974,781346,28,3,9,2,7,1,2,2,4,1,3,4,0,1,1,0,9
4974,796576,28,6,14,2,8,4,6,0,0,0,1,3,1,1,0,0,16
4974,791290,20,3,3,1,1,2,2,2,2,0,4,2,4,1,4,1,10
4974,791288,8,0,1,0,1,0,0,0,0,1,2,1,0,0,1,0,0
4974,796572,18,8,11,8,10,0,1,2,2,4,2,1,1,0,2,0,18
4974,791287,3,0,0,0,0,0,0,0,0,0,0,0,0,0,0,1,0
4974,796575,0,0,0,0,0,0,0,0,0,0,0,0,0,0,0,0,0
4975,775606,24,1,4,1,4,0,0,3,6,0,2,0,2,0,0,0,5
4975,791672,19,1,3,1,3,0,0,0,0,0,0,0,2,0,1,0,2
4975,780552,28,2,6,1,2,1,4,0,0,0,1,0,3,1,1,1,5
4975,780550,18,1,2,1,1,0,1,6,7,0,2,2,1,0,1,0,8
4975,780538,15,1,2,1,1,0,1,0,0,0,0,2,1,0,4,0,2
4975,785791,20,2,3,1,1,1,2,0,0,0,0,0,3,0,0,0,5
4975,785793,2,0,0,0,0,0,0,0,0,0,1,0,0,0,0,0,0
4975,791674,27,3,8,3,7,0,1,0,0,0,4,3,0,2,1,2,6
4975,785787,23,9,14,7,10,2,4,0,1,0,1,0,2,3,0,0,20
4975,797425,4,0,0,0,0,0,0,0,0,0,1,0,1,0,1,0,0
4975,797424,9,0,2,0,2,0,0,0,0,0,0,0,1,0,1,0,0
4975,797423,5,1,1,1,1,0,0,0,0,0,1,0,1,1,1,0,2
4975,800021,0,0,0,0,0,0,0,0,0,0,0,0,0,0,0,0,0
4975,791765,3,1,1,1,1,0,0,0,0,0,0,0,0,0,0,0,2
4975,785790,3,0,1,0,0,0,1,0,0,0,0,0,0,0,0,0,0
4976,786765,36,5,8,4,6,1,2,4,6,3,11,2,1,0,5,2,15
4976,797852,30,4,9,2,5,2,4,3,6,0,3,1,2,1,0,0,13
4976,792379,34,4,8,0,2,4,6,0,0,0,2,2,0,0,1,0,12
4976,792380,35,2,9,0,1,2,8,0,0,1,4,2,4,1,3,0,6
4976,781669,36,8,15,6,11,2,4,6,6,0,2,4,2,2,2,1,24
4976,781668,0,0,0,0,0,0,0,0,0,0,0,0,0,0,1,0,0
4976,797854,7,0,1,0,0,0,1,0,0,0,2,1,0,0,0,0,0
4976,781672,17,1,1,1,1,0,0,1,2,0,1,0,1,0,1,0,3
4976,797860,4,0,0,0,0,0,0,1,2,3,0,2,0,0,0,0,1
4976,781671,1,0,0,0,0,0,0,0,0,0,0,0,0,0,0,0,0
4977,785775,30,7,11,3,6,4,5,0,0,4,10,1,4,5,0,0,18
4977,781335,32,5,13,4,8,1,5,1,2,3,4,4,0,1,0,0,12
4977,776351,32,1,13,1,6,0,7,0,0,4,1,0,2,0,1,1,2
4977,785770,30,5,12,3,6,2,6,2,2,3,0,1,4,3,3,0,14
4977,781341,31,2,9,0,1,2,8,3,3,1,2,7,0,0,0,0,9
4977,796542,8,1,3,1,3,0,0,0,0,0,2,1,2,1,2,0,2
4977,796538,8,1,2,0,0,1,2,0,0,0,0,1,1,0,0,0,3
4977,791283,16,2,4,2,3,0,1,1,2,1,3,1,3,0,0,0,5
4977,785767,10,3,6,1,1,2,5,0,0,0,0,0,2,1,1,0,8
4977,791285,3,0,0,0,0,0,0,0,0,0,0,0,0,0,0,0,0
4978,776011,34,8,11,7,9,1,2,4,6,2,5,12,3,1,4,0,21
4978,796996,29,9,10,9,10,0,0,1,2,1,1,1,1,0,1,0,19
4978,791608,36,5,9,0,2,5,7,1,1,1,4,0,4,0,3,0,16
4978,780471,37,2,5,2,5,0,0,6,6,0,4,2,5,0,2,3,10
4978,791613,31,1,4,1,3,0,1,2,4,0,1,2,4,3,2,0,4
4978,796994,14,5,7,3,4,2,3,0,0,0,0,3,0,1,1,0,12
4978,792071,16,2,4,1,1,1,3,1,1,1,1,1,1,0,1,0,6
4978,780417,3,0,0,0,0,0,0,0,0,0,0,0,0,0,0,0,0
4979,786338,34,10,16,6,10,4,6,2,4,3,3,3,2,2,0,1,26
4979,775601,36,6,12,5,7,1,5,9,11,1,4,3,4,0,2,0,22
4979,785347,34,4,11,2,4,2,7,0,0,1,1,2,2,1,4,0,10
4979,792050,24,3,4,2,2,1,2,3,4,2,0,4,4,1,3,0,10
4979,791512,18,2,3,2,3,0,0,0,0,0,2,0,3,0,0,0,4
4979,792047,27,4,7,3,5,1,2,3,3,0,5,1,2,0,0,0,12
4979,792052,17,2,4,1,2,1,2,0,0,1,0,2,0,0,0,0,5
4979,792051,10,1,2,0,0,1,2,0,0,0,0,2,0,1,0,0,3
4980,776286,23,1,3,1,3,0,0,1,3,4,7,1,0,0,0,0,3
4980,775557,22,2,2,2,2,0,0,1,4,3,2,0,3,3,1,2,5
4980,791445,26,8,15,2,3,6,12,4,5,0,3,1,2,2,2,0,26
4980,785357,26,5,12,1,4,4,8,4,4,2,5,5,2,2,1,0,18
4980,775560,25,4,8,4,7,0,1,0,0,3,2,5,2,1,6,0,8
4980,785287,11,2,2,2,2,0,0,0,0,1,0,0,5,0,0,1,4
4980,797010,19,4,9,2,5,2,4,1,2,2,4,0,1,3,3,0,11
4980,791444,16,2,3,2,3,0,0,0,0,5,2,2,0,0,0,0,4
4980,785895,13,1,6,0,0,1,6,0,0,2,0,0,1,0,0,0,3
4980,797012,10,0,5,0,5,0,0,2,2,0,1,1,0,1,1,0,2
4980,797011,7,0,2,0,2,0,0,0,0,2,1,1,1,0,1,0,0
4980,797009,1,0,1,0,0,0,1,0,0,0,0,0,0,0,0,0,0
4980,781626,1,0,0,0,0,0,0,2,2,0,0,0,0,0,0,0,2
4981,792277,16,3,3,3,3,0,0,0,0,1,2,0,1,0,0,0,6
4981,786516,7,1,2,0,0,1,2,0,0,0,0,0,1,0,0,0,3
4981,781464,34,1,6,0,1,1,5,2,2,0,5,2,3,1,2,1,5
4981,781502,27,3,7,1,3,2,4,1,1,0,3,3,2,1,1,0,9
4981,780259,25,6,13,4,8,2,5,4,8,1,2,3,4,2,5,0,18
4981,785913,7,0,1,0,1,0,0,0,0,0,0,0,0,0,1,0,0
4981,781501,24,1,1,1,1,0,0,1,2,1,0,0,2,0,2,0,3
4981,798058,20,2,6,2,4,0,2,6,6,0,0,0,0,1,3,0,10
4981,785282,28,1,9,0,5,1,4,0,0,2,0,0,3,0,1,0,3
4981,792274,4,0,1,0,1,0,0,0,0,0,1,0,1,0,1,0,0
4981,798051,6,1,2,1,2,0,0,0,0,1,1,0,1,0,1,2,2
4981,798056,2,0,0,0,0,0,0,0,0,0,0,0,0,0,0,0,0
4982,780602,32,5,10,5,8,0,2,5,6,1,10,3,3,3,3,0,15
4982,791766,31,6,9,5,5,1,4,1,1,0,1,1,2,3,0,0,14
4982,780604,30,6,13,5,11,1,2,0,0,0,4,5,1,1,1,0,13
4982,780603,27,4,7,2,3,2,4,2,2,0,0,4,2,1,1,0,12
4982,786460,27,4,6,4,6,0,0,2,4,2,8,3,1,2,1,2,10
4982,786071,11,4,8,4,8,0,0,0,0,2,4,2,1,2,0,2,8
4982,786230,24,2,8,1,5,1,3,1,2,0,1,1,3,0,3,0,6
4982,791768,12,3,4,3,4,0,0,0,0,0,1,0,5,1,1,1,6
4982,797564,1,0,1,0,1,0,0,2,2,0,0,0,0,0,0,0,2
4982,780605,2,0,0,0,0,0,0,1,2,0,0,0,0,0,0,0,1
4982,791767,1,0,0,0,0,0,0,0,0,0,0,0,0,0,0,0,0
4982,797565,1,0,0,0,0,0,0,0,0,0,1,0,0,0,0,0,0
4982,797563,1,0,0,0,0,0,0,0,0,0,0,0,0,0,1,0,0
4983,786262,38,6,12,3,3,3,9,0,0,0,6,1,1,1,2,0,15
4983,792208,24,4,10,4,10,0,0,2,3,1,5,2,2,0,4,0,10
4983,797859,19,2,5,1,2,1,3,1,2,0,1,1,0,0,1,1,6
4983,776018,22,2,6,2,6,0,0,0,1,1,0,2,3,0,0,3,4
4983,781317,12,0,2,0,1,0,1,1,2,0,1,2,3,0,1,0,1
4983,781314,26,4,7,2,4,2,3,1,2,2,6,1,2,3,4,0,11
4983,797861,24,4,10,4,10,0,0,0,1,0,3,2,3,0,2,0,8
4983,797858,14,2,4,2,4,0,0,4,4,2,1,3,1,1,0,0,8
4983,797863,13,1,4,0,2,1,2,0,0,3,2,2,2,0,4,1,3
4983,786983,4,1,2,1,2,0,0,0,2,1,0,0,0,0,1,0,2
4983,797856,4,0,0,0,0,0,0,0,0,0,0,0,0,0,0,0,0
4984,774806,18,4,4,4,4,0,0,1,2,0,3,2,0,0,2,2,9
4984,775823,21,7,12,7,10,0,2,0,0,1,3,4,1,1,0,0,14
4984,791041,23,6,11,4,7,2,4,1,2,3,6,4,3,0,1,0,15
4984,791038,24,6,6,2,2,4,4,2,2,0,4,6,1,0,0,0,18
4984,789023,23,3,8,2,3,1,5,2,2,0,3,5,1,1,1,0,9
4984,796716,13,1,3,1,2,0,1,1,2,1,4,0,0,1,3,1,3
4984,796715,5,0,1,0,1,0,0,0,0,0,2,0,0,0,0,0,0
4984,796714,14,1,1,1,1,0,0,0,0,2,6,0,4,0,2,1,2
4984,786689,5,1,1,1,1,0,0,0,0,0,2,0,0,0,0,0,2
4984,796712,3,1,1,0,0,1,1,0,0,1,0,0,0,0,0,0,3
4984,796711,10,1,3,1,2,0,1,0,0,0,1,4,0,1,2,0,2
4984,796710,10,2,3,2,3,0,0,0,0,0,1,0,0,1,0,0,4
4984,791346,10,1,3,1,2,0,1,3,3,2,0,1,1,1,2,0,5
4984,775205,21,1,7,0,1,1,6,0,0,1,3,2,3,1,0,1,3
4986,797103,27,3,8,3,8,0,0,2,3,3,6,2,1,0,0,1,8
4986,791414,20,0,0,0,0,0,0,0,0,1,7,0,2,1,0,1,0
4986,791413,32,3,9,3,7,0,2,5,5,1,3,1,0,0,3,0,11
4986,791411,28,9,16,4,7,5,9,0,0,0,5,0,3,0,2,0,23
4986,785776,31,5,15,3,7,2,8,2,2,0,2,2,0,4,0,0,14
4986,797102,12,0,1,0,1,0,0,0,2,0,1,0,2,2,0,0,0
4986,785911,4,0,0,0,0,0,0,0,0,1,1,1,1,0,1,0,0
4986,797104,1,0,0,0,0,0,0,0,0,0,1,0,0,0,0,0,0
4986,797100,25,3,5,3,4,0,1,1,2,0,4,4,0,3,4,0,7
4986,781209,18,3,6,1,2,2,4,0,0,0,0,1,0,0,0,0,8
4986,797101,1,0,0,0,0,0,0,0,0,0,0,0,0,0,0,0,0
4986,797099,1,0,0,0,0,0,0,0,0,0,0,0,0,0,0,0,0
4987,791011,22,4,9,4,8,0,1,0,0,1,4,1,1,1,1,1,8
4987,780303,34,7,16,7,16,0,0,0,0,4,7,1,1,0,0,2,14
4987,791594,25,3,7,2,4,1,3,0,0,1,5,3,2,1,3,0,7
4987,791012,27,1,7,1,2,0,5,1,2,0,2,2,0,0,0,0,3
4987,781385,32,3,9,0,1,3,8,0,2,0,4,4,3,0,4,1,9
4987,796670,7,0,1,0,1,0,0,0,0,0,1,1,1,0,0,0,0
4987,796671,16,4,5,4,5,0,0,1,4,2,3,0,1,0,1,0,9
4987,796668,11,1,4,0,0,1,4,0,0,0,0,0,3,0,2,0,3
4987,791013,11,0,0,0,0,0,0,0,0,0,0,1,0,0,2,0,0
4987,786349,15,1,2,0,0,1,2,0,0,0,1,3,0,0,1,1,3
4988,786772,27,1,1,1,1,0,0,2,2,3,4,0,2,0,0,0,4
4988,781484,22,2,5,0,0,2,5,1,2,1,3,1,4,0,2,0,7
4988,786769,38,5,8,3,5,2,3,2,2,1,2,1,0,0,1,2,14
4988,786024,31,6,16,3,8,3,8,2,2,2,5,2,5,0,2,0,17
4988,780002,36,3,9,2,6,1,3,4,5,0,2,5,1,1,1,0,11
4988,791967,27,9,13,5,7,4,6,5,5,0,1,0,2,0,1,0,27
4988,786773,13,2,3,2,3,0,0,0,0,1,1,0,1,0,2,2,4
4988,790823,6,0,2,0,2,0,0,0,0,0,1,0,1,0,1,1,0
4989,780919,30,8,12,8,11,0,1,2,3,2,4,0,3,0,0,1,18
4989,775816,27,8,14,7,11,1,3,7,8,2,4,1,1,1,1,0,24
4989,785803,28,2,2,2,2,0,0,0,0,2,0,1,1,4,0,3,4
4989,780920,31,4,12,4,8,0,4,4,6,2,3,6,3,0,1,0,12
4989,780914,25,1,6,1,3,0,3,0,0,2,2,3,4,0,3,0,2
4989,796797,11,3,6,3,5,0,1,0,0,2,3,0,3,0,0,0,6
4989,775640,12,2,6,2,6,0,0,2,2,0,1,0,0,0,0,0,6
4989,791142,23,2,7,2,3,0,4,0,0,1,2,0,3,0,0,0,4
4989,791141,13,2,4,2,2,0,2,0,0,0,0,1,1,0,0,2,4
4992,785495,35,10,16,9,13,1,3,3,4,2,4,5,1,1,2,0,24
4992,785958,19,2,6,2,6,0,0,0,0,1,6,5,3,1,3,0,4
4992,791130,19,2,4,0,0,2,4,2,2,0,1,4,1,1,0,0,8
4992,785494,32,5,7,0,0,5,7,4,4,2,4,2,3,1,3,0,19
4992,780698,36,6,9,6,6,0,3,0,1,0,5,2,2,1,3,0,12
4992,785490,3,1,1,1,1,0,0,0,0,0,0,0,0,0,0,0,2
4992,785659,25,4,4,4,4,0,0,5,7,1,1,5,2,2,2,2,13
4992,791034,5,0,1,0,0,0,1,0,0,0,1,0,0,0,0,0,0
4992,780427,26,4,7,4,5,0,2,2,4,2,2,4,5,1,2,0,10
4992,791033,0,0,0,0,0,0,0,0,0,0,0,0,0,0,0,0,0
4993,776209,33,5,10,4,7,1,3,1,1,1,4,5,2,0,3,0,12
4993,796938,34,4,13,1,4,3,9,9,9,2,0,2,2,1,3,0,20
4993,791235,35,3,7,3,7,0,0,0,0,1,3,0,2,1,0,0,6
4993,791237,33,8,14,8,14,0,0,2,3,3,8,0,2,2,4,0,18
4993,791351,23,3,12,2,7,1,5,2,2,0,0,4,2,1,2,0,9
4993,788124,11,0,0,0,0,0,0,0,0,0,1,0,3,0,1,1,0
4993,781227,3,0,0,0,0,0,0,0,0,0,0,0,1,0,0,0,0
4993,774875,2,0,0,0,0,0,0,0,0,0,0,0,0,0,0,0,0
4993,791240,22,5,7,5,7,0,0,2,2,0,0,2,4,3,3,0,12
4993,791238,4,0,1,0,1,0,0,0,0,0,1,0,1,0,0,0,0
4994,786434,19,5,7,5,7,0,0,0,0,1,2,1,5,0,1,0,10
4994,780440,31,7,10,5,6,2,4,1,1,3,8,4,1,0,1,1,17
4994,791621,37,9,16,4,7,5,9,4,5,0,2,5,3,3,1,0,27
4994,786432,19,3,4,0,0,3,4,2,2,0,2,0,4,0,0,0,11
4994,786431,34,6,11,6,10,0,1,4,6,1,4,5,2,1,2,0,16
4994,781125,6,2,4,2,4,0,0,0,0,2,2,0,4,0,2,0,4
4994,775620,14,2,4,2,4,0,0,0,0,3,3,0,3,0,2,1,4
4994,781088,29,2,4,1,1,1,3,0,0,0,0,4,3,0,0,0,5
4994,775622,10,1,3,1,1,0,2,0,0,0,0,1,0,0,0,0,2
4994,791619,1,0,0,0,0,0,0,0,0,0,0,0,0,0,0,0,0
4995,780291,37,8,18,5,11,3,7,2,5,2,2,0,2,0,1,3,21
4995,785607,3,0,2,0,1,0,1,0,0,0,0,0,0,0,0,0,0
4995,796665,25,0,4,0,0,0,4,1,2,1,0,1,3,1,0,0,1
4995,785333,23,1,2,0,1,1,1,0,2,1,1,2,1,0,1,0,3
4995,775305,37,4,13,4,10,0,3,12,12,0,2,3,2,1,5,0,20
4995,791004,29,5,10,5,8,0,2,6,8,7,4,2,2,1,1,0,16
4995,791006,18,2,2,1,1,1,1,0,0,1,2,1,2,0,0,0,5
4995,796666,7,0,1,0,0,0,1,0,0,1,1,0,2,0,1,0,0
4995,796664,21,5,7,4,5,1,2,0,0,1,1,0,5,0,1,0,11
4996,788113,13,2,4,2,2,0,2,0,0,0,0,1,1,1,1,0,4
4996,785443,35,8,16,6,13,2,3,2,7,2,6,9,0,2,1,0,20
4996,786231,22,10,13,7,8,3,5,0,0,2,1,2,1,1,1,0,23
4996,785731,30,8,14,8,13,0,1,0,2,6,5,2,2,4,2,1,16
4996,785729,25,3,6,1,3,2,3,0,0,1,3,5,2,1,1,0,8
4996,799881,6,1,2,1,2,0,0,0,0,1,2,0,0,1,0,1,2
4996,792407,9,1,2,1,2,0,0,0,0,0,1,0,0,0,0,0,2
4996,792405,8,0,2,0,2,0,0,0,0,0,0,1,0,0,0,0,0
4996,776497,23,4,7,3,4,1,3,1,2,0,1,4,1,1,0,0,10
4996,792402,10,3,5,2,4,1,1,1,2,1,2,0,0,1,0,0,8
4996,796211,6,1,2,1,2,0,0,2,2,2,2,0,0,0,0,0,4
4996,780864,13,1,3,1,1,0,2,0,0,1,1,4,3,0,3,0,2
4998,785518,25,4,7,3,6,1,1,1,2,1,2,5,4,0,2,0,10
4998,796390,23,6,9,6,9,0,0,0,0,2,8,1,3,0,0,3,12
4998,785451,25,5,9,1,4,4,5,2,2,1,6,3,3,1,3,0,16
4998,790834,35,3,8,2,4,1,4,0,0,2,3,2,4,1,1,0,7
4998,785379,10,0,4,0,3,0,1,0,0,1,0,2,0,0,1,1,0
4998,790831,7,0,2,0,2,0,0,0,0,1,0,1,0,0,2,0,0
4998,790833,21,2,7,1,6,1,1,0,0,0,10,2,2,0,3,0,5
4998,790832,13,1,4,0,2,1,2,0,0,1,0,0,0,0,2,1,3
4998,790830,14,2,5,1,4,1,1,0,0,0,1,0,2,0,0,1,5
4998,785377,25,4,5,2,2,2,3,2,2,1,3,6,1,1,2,1,12
4998,780297,2,1,1,1,1,0,0,0,0,0,0,0,0,0,0,0,2
4999,786029,23,5,7,5,7,0,0,0,1,2,1,0,3,1,3,0,10
4999,781398,21,2,5,1,2,1,3,0,0,2,3,1,1,1,0,0,5
4999,792114,36,1,12,1,7,0,5,1,2,0,3,2,1,0,1,0,3
4999,786018,27,1,8,1,4,0,4,2,2,1,5,1,1,1,3,0,4
4999,775678,25,4,11,3,6,1,5,0,0,0,1,4,1,2,2,0,9
4999,786022,12,1,1,1,1,0,0,0,0,1,2,0,3,0,0,2,2
4999,797740,23,4,11,4,10,0,1,5,7,3,4,0,0,0,0,0,13
4999,797746,4,0,2,0,2,0,0,0,0,0,0,0,0,0,0,0,0
4999,797737,15,2,7,2,5,0,2,1,2,2,3,0,0,0,1,1,5
4999,792112,5,0,1,0,0,0,1,0,0,0,1,0,0,0,0,0,0
4999,797744,5,0,2,0,1,0,1,0,2,0,0,0,0,0,0,0,0
4999,797745,2,0,1,0,0,0,1,1,2,0,0,0,0,0,0,0,1
4999,797743,2,0,0,0,0,0,0,0,0,0,0,0,0,0,0,0,0
5000,785577,22,4,7,4,6,0,1,1,2,2,3,1,3,1,2,0,9
5000,791094,32,1,7,0,5,1,2,1,2,1,6,4,1,2,1,0,4
5000,791091,12,0,1,0,0,0,1,2,2,0,1,0,4,0,1,0,2
5000,791093,26,1,5,1,4,0,1,0,0,3,3,1,3,1,1,1,2
5000,785569,26,5,11,3,5,2,6,0,0,0,0,1,1,0,0,0,12
5000,791089,10,2,3,2,3,0,0,0,0,1,0,0,0,0,0,1,4
5000,791097,8,1,2,1,2,0,0,0,0,1,1,0,0,0,1,0,2
5000,796753,18,1,5,1,1,0,4,0,0,0,1,0,2,3,0,0,2
5000,796752,28,2,7,1,5,1,2,3,3,0,2,3,4,1,2,0,8
5000,791090,18,5,11,3,5,2,6,0,1,0,1,0,2,1,3,0,12
5001,785740,30,6,9,6,9,0,0,0,1,5,4,1,1,0,4,1,12
5001,785809,37,4,9,2,6,2,3,0,2,0,4,2,2,6,2,0,10
5001,780530,29,1,3,0,0,1,3,1,2,2,7,3,3,0,2,3,4
5001,797402,35,5,11,2,4,3,7,0,0,0,1,2,0,1,3,0,13
5001,785738,31,4,9,3,5,1,4,11,12,0,4,4,2,1,3,0,20
5001,797396,4,1,1,1,1,0,0,0,0,0,0,0,1,0,0,0,2
5001,785739,9,0,0,0,0,0,0,0,0,0,1,0,1,0,0,0,0
5001,797399,24,2,3,0,1,2,2,0,0,0,3,2,3,0,2,2,6
5001,791664,1,0,0,0,0,0,0,0,0,0,0,0,0,0,0,0,0
5002,797290,32,5,8,3,5,2,3,5,8,0,4,4,2,2,1,2,17
5002,797292,24,6,9,6,9,0,0,2,6,1,9,0,2,0,4,1,14
5002,780509,33,5,8,5,7,0,1,1,5,1,4,3,3,0,1,0,11
5002,797291,30,2,9,2,7,0,2,5,6,0,3,3,4,1,1,0,9
5002,786064,33,2,6,0,1,2,5,1,2,2,5,3,1,1,2,1,7
5002,791660,27,4,7,1,4,3,3,4,6,0,0,3,1,1,2,1,15
5002,791658,12,1,1,1,1,0,0,1,2,0,1,0,3,0,0,0,3
5002,785658,7,0,0,0,0,0,0,0,0,0,1,0,0,0,0,0,0
5002,791663,2,0,0,0,0,0,0,0,0,0,0,0,1,0,0,0,0
5002,797294,0,0,0,0,0,0,0,0,0,0,0,0,0,0,0,0,0
5003,791737,36,5,9,2,4,3,5,4,7,1,3,3,1,1,2,0,17
5003,775913,22,5,6,5,6,0,0,3,6,0,6,2,3,0,0,0,13
5003,783524,29,1,12,0,4,1,8,7,8,0,3,2,4,0,1,0,10
5003,780561,27,2,8,1,1,1,7,2,2,1,7,2,3,2,2,0,7
5003,797331,22,2,6,0,1,2,5,0,0,0,0,3,1,0,0,0,6
5003,786223,26,3,8,3,6,0,2,0,0,3,2,0,3,2,1,0,6
5003,797333,13,1,2,1,1,0,1,0,0,0,2,1,5,0,1,0,2
5003,781516,10,0,1,0,1,0,0,2,4,0,2,0,3,0,1,0,2
5003,797332,7,1,2,1,2,0,0,0,0,0,1,0,0,0,1,0,2
5003,786220,8,0,0,0,0,0,0,0,0,0,0,0,2,0,0,0,0
5004,782133,19,3,7,3,4,0,3,1,1,0,2,4,0,0,0,0,7
5004,785123,14,4,5,4,5,0,0,2,2,0,3,0,1,0,1,0,10
5004,790990,27,4,7,3,3,1,4,0,0,0,4,3,0,2,1,0,9
5004,789219,33,4,9,2,4,2,5,2,3,0,0,3,1,2,1,0,12
5004,785059,28,2,4,2,4,0,0,0,0,2,7,6,0,3,0,0,4
5004,796624,9,1,4,1,3,0,1,2,2,0,0,1,0,0,0,2,4
5004,790989,5,1,2,1,1,0,1,0,0,0,0,0,0,0,1,0,2
5004,785305,6,0,1,0,1,0,0,0,0,0,2,0,0,1,0,0,0
5004,796622,12,3,7,3,7,0,0,1,1,1,1,0,0,0,0,1,7
5004,796623,19,7,12,5,8,2,4,1,2,1,1,1,4,3,1,0,17
5004,790988,7,1,2,1,1,0,1,0,0,2,0,1,0,0,1,0,2
5004,785303,5,0,1,0,0,0,1,0,0,0,0,0,0,1,0,0,0
5004,785122,16,2,2,1,1,1,1,0,0,0,0,0,2,2,0,0,5
5005,775324,24,9,12,9,12,0,0,2,3,5,5,0,3,0,3,1,20
5005,791223,20,0,1,0,1,0,0,0,0,3,1,1,2,1,1,0,0
5005,796929,29,3,7,1,1,2,6,0,0,1,1,2,0,1,3,0,8
5005,791224,30,5,14,3,12,2,2,2,2,3,7,3,1,0,4,0,14
5005,785571,27,4,8,2,5,2,3,0,0,0,6,3,0,1,3,0,10
5005,796927,18,0,4,0,1,0,3,0,0,0,1,0,0,0,1,0,0
5005,791811,13,1,4,1,4,0,0,0,0,1,3,0,3,0,0,0,2
5005,796926,15,1,1,0,0,1,1,0,0,0,2,1,1,0,1,0,3
5005,791222,14,2,6,1,4,1,2,0,0,0,0,0,1,0,1,0,5
5005,786436,10,1,3,1,2,0,1,2,2,1,0,0,2,0,0,0,4
5006,797587,27,2,3,2,3,0,0,4,4,3,1,1,4,1,6,0,8
5006,786501,21,2,5,2,3,0,2,0,0,1,2,0,2,0,1,0,4
5006,781078,33,1,7,1,4,0,3,1,1,2,2,2,2,2,0,1,3
5006,791895,27,2,6,2,5,0,1,1,3,1,3,0,3,0,2,0,5
5006,786502,38,10,20,7,15,3,5,1,2,2,4,5,4,1,5,0,24
5006,797586,0,0,0,0,0,0,0,0,0,0,0,0,0,0,0,0,0
5006,791891,11,1,1,1,1,0,0,0,0,0,2,0,4,0,0,0,2
5006,791894,0,0,0,0,0,0,0,0,0,0,0,0,0,0,0,0,0
5006,797584,6,0,0,0,0,0,0,0,0,0,0,0,0,0,0,0,0
5006,791892,0,0,0,0,0,0,0,0,0,0,0,0,0,0,0,0,0
5006,797583,0,0,0,0,0,0,0,0,0,0,0,1,0,0,0,0,0
5006,781561,4,0,0,0,0,0,0,0,0,0,0,0,0,0,0,0,0
5006,781080,33,2,8,2,5,0,3,1,2,0,2,0,1,0,0,0,5
5007,791652,27,4,5,4,5,0,0,6,8,3,4,0,3,1,2,2,14
5007,786495,21,1,4,1,4,0,0,2,2,2,3,1,3,0,0,2,4
5007,797285,21,1,4,0,0,1,4,0,0,0,2,0,2,0,2,0,3
5007,791650,38,3,8,2,6,1,2,2,3,2,6,3,0,3,4,0,9
5007,776384,34,5,9,5,7,0,2,2,4,0,3,3,3,2,1,0,12
5007,791653,19,2,5,1,2,1,3,0,0,1,1,0,0,0,2,0,5
5007,775705,14,1,1,1,1,0,0,0,0,1,0,1,1,0,0,0,2
5007,797289,0,0,0,0,0,0,0,0,0,0,0,0,0,0,0,0,0
5007,797286,13,3,5,1,2,2,3,0,0,0,1,1,0,1,2,0,8
5007,797283,13,2,6,1,1,1,5,0,0,1,2,0,2,0,0,0,5
5008,798157,12,0,0,0,0,0,0,0,0,1,1,1,0,0,1,0,0
5008,786635,35,8,17,8,14,0,3,8,12,3,9,2,3,1,4,1,24
5008,791822,38,3,10,1,3,2,7,0,0,0,4,0,2,1,0,1,8
5008,781543,33,5,9,4,6,1,3,0,1,1,1,2,4,0,2,1,11
5008,780642,35,5,8,4,6,1,2,2,2,2,2,4,2,3,3,0,13
5008,797383,16,1,2,1,1,0,1,0,0,1,1,0,3,0,0,0,2
5008,791823,4,1,1,1,1,0,0,0,0,0,1,0,1,0,0,0,2
5008,797384,3,0,2,0,1,0,1,0,0,0,0,0,1,0,0,0,0
5008,786182,1,1,1,1,1,0,0,1,2,1,0,0,1,0,0,0,3
5008,786632,12,1,2,0,0,1,2,0,0,0,0,1,0,0,0,0,3
5008,781388,11,0,1,0,1,0,0,0,0,1,0,1,3,0,1,0,0
5009,797281,15,0,3,0,3,0,0,3,4,2,3,0,3,0,0,0,3
5009,786195,21,2,7,2,7,0,0,0,0,1,6,0,4,1,1,0,4
5009,791649,19,1,6,1,3,0,3,0,0,0,0,2,0,0,1,0,2
5009,797280,25,3,7,3,5,0,2,8,10,0,2,2,2,0,1,0,14
5009,785697,15,0,0,0,0,0,0,0,0,0,2,0,3,0,2,0,0
5009,791648,34,8,13,5,8,3,5,3,4,2,0,1,1,2,0,0,22
5009,785694,16,5,5,5,5,0,0,2,2,2,0,0,5,1,0,1,12
5009,797279,23,3,6,2,3,1,3,10,10,1,3,1,0,0,3,0,17
5009,786640,32,2,2,2,2,0,0,0,0,0,5,7,2,0,1,0,4
5010,791306,37,6,9,5,6,1,3,1,3,3,4,0,5,1,2,0,14
5010,780210,38,11,21,10,18,1,3,1,2,6,4,4,3,0,1,1,24
5010,792432,31,4,8,2,4,2,4,0,0,2,0,6,4,2,3,0,10
5010,792427,39,5,14,3,8,2,6,0,0,1,2,4,4,1,1,1,12
5010,792433,36,4,9,2,3,2,6,0,0,0,4,2,4,1,0,0,10
5010,796594,6,0,2,0,1,0,1,0,0,0,0,1,0,0,0,0,0
5010,786422,13,1,1,1,1,0,0,0,0,1,0,1,3,0,1,0,2
5011,797824,17,2,2,1,1,1,1,1,2,0,1,0,5,0,0,0,6
5011,797825,19,1,1,1,1,0,0,1,2,0,3,0,4,1,1,0,3
5011,797822,34,9,13,6,7,3,6,1,2,2,4,1,2,2,3,0,22
5011,792190,38,2,6,2,3,0,3,2,2,1,3,4,1,0,5,0,6
5011,786664,38,8,16,4,6,4,10,9,12,1,2,2,1,0,2,0,29
5011,792192,13,1,1,1,1,0,0,1,2,2,2,0,0,0,1,0,3
5011,775116,27,0,2,0,0,0,2,0,0,1,5,1,2,1,2,1,0
5011,792191,14,0,0,0,0,0,0,0,0,0,2,0,0,0,1,0,0
5012,792186,5,0,0,0,0,0,0,0,0,0,1,0,0,0,2,0,0
5012,780433,11,0,1,0,1,0,0,0,1,1,0,0,4,0,1,5,0
5012,781490,25,1,4,1,3,0,1,0,0,1,2,4,3,0,3,0,2
5012,797816,36,11,17,8,13,3,4,7,8,0,6,2,3,3,5,0,32
5012,792188,29,2,6,2,5,0,1,1,2,1,1,1,4,0,3,0,5
5012,797821,31,6,11,4,6,2,5,4,4,2,9,0,4,2,1,0,18
5012,797820,3,0,1,0,1,0,0,0,0,0,0,0,0,0,0,0,0
5012,797819,9,1,3,1,3,0,0,0,2,2,0,0,0,0,1,0,2
5012,781447,23,1,1,1,1,0,0,4,4,1,3,1,4,0,3,0,6
5012,792187,5,0,0,0,0,0,0,0,0,0,0,0,0,0,0,0,0
5012,792185,6,0,5,0,1,0,4,0,0,0,0,0,0,1,2,0,0
5012,786675,17,0,3,0,1,0,2,0,0,1,3,0,3,1,2,1,0
5013,791723,15,2,6,2,6,0,0,1,2,2,0,0,3,0,1,0,5
5013,797310,35,2,12,1,6,1,6,1,5,2,2,2,3,0,3,1,6
5013,785580,21,1,3,0,1,1,2,0,0,0,2,3,3,2,5,0,3
5013,791724,29,7,15,7,10,0,5,0,0,5,4,0,4,1,0,2,14
5013,781617,34,6,14,3,8,3,6,3,8,3,5,0,2,1,4,1,18
5013,797312,9,2,4,2,3,0,1,5,5,3,1,0,1,0,1,1,9
5013,786285,10,2,4,2,3,0,1,1,1,0,0,0,0,1,1,0,5
5013,797308,25,0,2,0,1,0,1,0,2,1,0,2,2,1,1,0,0
5013,780706,22,3,6,2,4,1,2,0,0,2,4,3,3,1,1,0,7
5014,783072,34,10,13,8,10,2,3,3,7,2,9,2,1,1,3,1,25
5014,774879,12,3,6,2,2,1,4,5,6,0,3,0,5,0,1,4,12
5014,791540,33,2,5,1,2,1,3,2,2,1,4,4,1,0,2,0,7
5014,787782,18,1,4,0,2,1,2,0,0,0,2,2,4,1,3,0,3
5014,776068,31,7,13,5,8,2,5,6,7,0,4,7,4,0,0,0,22
5014,797817,12,1,2,1,2,0,0,2,3,1,5,1,2,0,3,0,4
5014,785647,1,1,1,1,1,0,0,0,0,0,0,0,0,0,0,0,2
5014,781463,27,4,6,1,1,3,5,0,0,0,2,3,3,1,1,2,11
5014,792153,24,2,4,2,3,0,1,1,1,2,1,1,2,2,2,0,5
5014,781202,8,0,0,0,0,0,0,0,0,1,0,0,1,1,0,0,0
5015,775738,16,2,5,2,4,0,1,2,3,4,1,2,1,1,1,0,6
5015,786091,29,7,13,6,9,1,4,0,0,2,1,0,4,0,1,0,15
5015,786728,20,0,7,0,6,0,1,0,0,1,4,2,2,2,4,0,0
5015,785904,27,3,10,2,4,1,6,2,2,0,5,0,2,0,3,0,9
5015,780892,32,4,7,1,2,3,5,1,2,0,3,2,2,1,1,0,12
5015,786350,3,0,1,0,1,0,0,0,0,1,0,0,2,0,0,0,0
5015,797669,10,1,1,1,1,0,0,0,0,1,1,0,3,0,0,0,2
5015,797666,14,1,3,1,1,0,2,3,4,1,2,5,2,1,0,0,5
5015,792087,2,0,1,0,1,0,0,0,0,0,0,0,0,0,0,0,0
5015,785734,8,2,4,1,1,1,3,2,3,0,0,0,0,1,0,0,7
5015,786788,3,1,1,1,1,0,0,0,0,0,0,0,2,1,1,0,2
5015,786096,22,2,8,2,7,0,1,5,6,0,4,0,1,0,1,0,9
5015,781030,14,0,5,0,1,0,4,0,0,0,0,0,1,0,0,0,0
5016,780027,35,10,22,9,18,1,4,7,9,6,6,3,2,1,4,2,28
5016,786176,33,6,10,3,5,3,5,1,3,2,10,2,2,2,2,0,16
5016,786173,13,0,2,0,1,0,1,0,0,1,0,1,0,0,0,0,0
5016,780028,30,2,5,1,3,1,2,0,0,1,1,4,5,1,0,0,5
5016,774828,33,0,9,0,1,0,8,0,0,0,5,2,1,0,1,0,0
5016,780029,14,2,4,2,3,0,1,1,1,3,2,1,4,0,2,0,5
5016,797175,14,2,4,2,2,0,2,4,4,2,3,0,4,0,1,1,8
5016,791379,13,0,4,0,4,0,0,0,0,1,1,0,1,0,0,0,0
5016,797178,6,0,1,0,1,0,0,0,0,0,1,0,1,0,0,0,0
5016,791380,8,2,2,2,2,0,0,3,4,0,0,1,4,1,0,0,7
5016,797179,0,0,0,0,0,0,0,0,0,0,0,0,1,0,0,0,0
5016,797176,1,0,0,0,0,0,0,0,0,0,0,0,0,0,0,0,0
5017,791401,28,9,14,9,14,0,0,5,10,4,3,1,4,0,2,1,23
5017,780125,21,0,3,0,3,0,0,1,2,2,3,4,4,0,1,0,1
5017,791400,37,3,10,1,6,2,4,3,4,0,6,1,4,2,3,0,11
5017,785931,32,6,12,2,5,4,7,2,4,0,2,3,2,3,0,2,18
5017,780118,33,2,6,1,2,1,4,9,10,0,5,3,2,0,0,0,14
5017,797132,14,2,2,1,1,1,1,0,0,1,1,2,1,0,0,0,5
5017,786837,21,1,3,1,2,0,1,0,2,0,0,0,1,0,2,1,2
5017,797126,10,3,3,3,3,0,0,1,3,0,1,1,2,0,0,0,7
5017,797130,4,0,0,0,0,0,0,0,0,0,0,0,0,1,0,0,0
5018,796343,14,1,3,1,3,0,0,0,0,0,0,0,3,0,1,0,2
5018,796344,32,3,8,0,1,3,7,0,0,1,5,1,2,1,3,1,9
5018,790785,31,4,8,3,6,1,2,3,4,2,4,4,2,0,4,0,12
5018,796340,32,6,11,3,7,3,4,3,6,1,4,0,2,3,3,1,18
5018,780037,34,4,11,1,7,3,4,7,7,0,3,6,2,1,4,0,18
5018,790781,25,4,7,4,7,0,0,2,6,1,1,0,3,2,0,3,10
5018,780040,9,1,2,1,1,0,1,2,2,0,0,0,1,1,0,1,4
5018,796339,4,0,0,0,0,0,0,0,0,0,0,1,0,0,1,0,0
5018,781232,19,2,4,1,1,1,3,4,4,1,4,4,1,0,0,0,9
5019,796334,29,4,8,4,8,0,0,0,0,2,5,4,2,0,5,1,8
5019,790776,16,2,4,2,4,0,0,0,0,1,3,0,5,1,1,3,4
5019,796330,36,5,11,3,4,2,7,1,1,0,5,2,3,0,1,0,13
5019,785813,36,8,17,3,8,5,9,3,3,0,1,3,2,1,3,0,24
5019,796337,33,3,6,2,5,1,1,7,8,1,4,6,2,2,2,0,14
5019,785827,19,1,4,1,4,0,0,2,3,1,3,1,2,1,1,0,4
5019,779975,9,2,4,2,4,0,0,0,0,1,2,0,3,1,0,0,4
5019,796332,22,4,7,1,4,3,3,2,2,1,3,1,4,0,0,1,13
5020,786197,27,1,2,1,2,0,0,0,0,0,7,0,1,0,2,2,2
5020,780717,29,4,11,3,8,1,3,2,2,1,3,1,0,0,3,0,11
5020,776328,33,4,7,2,5,2,2,3,6,0,3,2,2,1,5,0,13
5020,791742,34,5,10,4,8,1,2,4,4,2,4,3,2,3,5,0,15
5020,776266,29,1,5,1,5,0,0,1,2,1,1,2,2,0,2,0,3
5020,791738,13,0,0,0,0,0,0,0,0,0,1,0,2,0,1,2,0
5020,797337,3,0,0,0,0,0,0,0,0,0,0,0,2,0,1,0,0
5020,797334,5,0,1,0,1,0,0,0,0,0,0,1,0,0,1,0,0
5020,791740,15,0,2,0,0,0,2,1,2,0,0,0,1,2,1,0,1
5020,791741,12,1,2,0,1,1,1,2,2,0,2,0,1,0,2,0,5
5021,791750,32,4,9,2,3,2,6,0,0,1,5,3,3,1,2,0,10
5021,786177,28,6,10,4,4,2,6,1,1,1,5,1,3,1,1,0,15
5021,780244,29,3,5,1,2,2,3,0,1,6,5,1,3,0,2,0,8
5021,786179,31,8,16,4,10,4,6,2,3,1,3,2,1,5,1,0,22
5021,780238,35,5,15,5,11,0,4,3,4,1,0,4,3,4,5,0,13
5021,791749,2,0,1,0,0,0,1,0,0,0,0,0,0,1,0,0,0
5021,791752,5,0,0,0,0,0,0,0,0,0,1,0,1,0,0,0,0
5021,785909,12,0,0,0,0,0,0,0,0,0,1,0,0,0,1,1,0
5021,797346,4,1,1,1,1,0,0,1,1,0,0,0,0,0,0,0,3
5021,790773,13,0,4,0,1,0,3,0,0,2,2,2,3,0,0,0,0
5021,781500,9,1,2,1,1,0,1,0,0,0,0,0,2,0,1,0,2
5022,781579,31,4,10,4,7,0,3,0,0,1,5,2,1,2,1,0,8
5022,786731,27,5,5,5,5,0,0,3,3,1,4,3,4,2,3,2,13
5022,798023,27,4,7,2,3,2,4,2,2,3,1,5,1,2,3,0,12
5022,781584,32,4,10,0,0,4,10,2,3,0,2,0,3,0,0,0,14
5022,780347,26,2,9,2,7,0,2,2,5,2,4,2,5,0,2,0,6
5022,775696,13,4,7,3,5,1,2,1,4,3,0,0,3,0,1,0,10
5022,776481,9,1,1,1,1,0,0,1,2,3,1,0,2,0,0,0,3
5022,798008,28,3,14,2,5,1,9,3,3,0,2,5,4,0,4,0,10
5022,792358,7,0,1,0,0,0,1,0,0,0,0,0,0,0,0,0,0
5023,791144,22,2,7,2,6,0,1,1,2,0,4,1,4,1,2,1,5
5023,785782,31,3,4,1,1,2,3,0,0,0,0,0,3,0,1,2,8
5023,791145,26,6,8,5,7,1,1,2,2,4,3,4,4,0,3,1,15
5023,791146,39,3,11,2,9,1,2,11,13,0,8,8,1,4,3,0,18
5023,785777,35,4,7,3,3,1,4,7,8,0,4,4,2,2,2,0,16
5023,791147,15,5,8,2,3,3,5,2,2,0,2,0,4,1,1,0,15
5023,791148,21,1,2,0,0,1,2,0,0,0,6,0,4,0,1,0,3
5023,786748,7,1,3,1,1,0,2,2,2,0,0,1,1,1,0,0,4
5023,796804,4,0,0,0,0,0,0,0,0,0,0,0,0,0,0,0,0
5026,797549,28,2,9,2,9,0,0,1,2,2,2,5,1,1,1,0,5
5026,780351,32,6,10,6,10,0,0,3,4,1,3,0,2,1,1,0,15
5026,780586,36,10,14,8,9,2,5,3,3,1,5,3,4,4,4,0,25
5026,797544,20,3,8,3,6,0,2,0,0,0,4,0,1,1,0,2,6
5026,791716,24,2,3,2,2,0,1,1,1,2,4,0,3,1,0,0,5
5026,797545,12,1,4,0,1,1,3,2,2,0,3,3,2,1,1,0,5
5026,797546,14,3,8,3,8,0,0,0,1,2,1,0,0,1,0,1,6
5026,791715,25,0,5,0,1,0,4,0,0,1,4,0,1,0,0,0,0
5026,790857,4,0,0,0,0,0,0,0,0,0,0,1,0,0,1,0,0
5026,797540,5,0,2,0,0,0,2,0,0,0,0,0,0,0,0,0,0
5027,797340,25,4,13,2,6,2,7,0,0,0,4,0,0,1,2,0,10
5027,791746,38,3,6,3,5,0,1,1,2,0,4,0,4,2,4,0,7
5027,791747,13,1,3,1,2,0,1,1,2,1,4,1,0,0,1,0,3
5027,797343,7,0,1,0,0,0,1,0,0,1,0,0,0,0,1,0,0
5027,791743,35,6,10,6,10,0,0,2,3,2,3,1,4,1,2,1,14
5027,780711,29,1,3,0,0,1,3,4,5,1,5,1,2,2,2,0,7
5027,797341,24,3,6,3,5,0,1,0,3,1,5,1,3,0,3,0,6
5027,797342,3,0,0,0,0,0,0,0,0,0,0,0,1,0,0,0,0
5027,797345,2,0,0,0,0,0,0,0,0,0,0,0,0,0,0,0,0
5027,786193,24,2,8,2,2,0,6,0,0,0,1,1,0,0,0,0,4
5028,790935,25,3,8,2,3,1,5,0,0,2,2,3,0,1,1,0,7
5028,792442,25,5,7,5,7,0,0,0,0,1,11,0,2,0,2,4,10
5028,780933,33,8,15,1,1,7,14,2,2,0,1,0,3,3,2,0,25
5028,775340,34,4,10,3,7,1,3,4,4,0,3,10,2,0,3,0,13
5028,774826,25,4,6,1,2,3,4,0,0,1,3,0,3,0,0,0,11
5028,796491,6,0,0,0,0,0,0,0,0,0,0,1,0,1,1,0,0
5028,796190,6,0,0,0,0,0,0,0,0,0,0,1,1,0,0,0,0
5028,790937,14,3,4,3,4,0,0,3,4,1,2,0,5,0,1,1,9
5028,785497,1,0,0,0,0,0,0,0,0,0,1,0,0,0,0,0,0
5028,785445,6,1,2,1,1,0,1,1,2,1,0,0,1,0,1,0,3
5028,790938,16,1,3,1,3,0,0,1,1,1,0,0,3,0,1,0,3
5028,796492,7,0,4,0,2,0,2,0,0,0,1,3,1,0,0,0,0
5028,790936,1,0,0,0,0,0,0,0,0,0,0,0,0,0,0,0,0
5028,796493,1,0,0,0,0,0,0,0,0,0,0,0,0,0,0,0,0
5029,796761,21,1,4,1,4,0,0,0,0,2,1,0,4,0,3,3,2
5029,796758,34,9,15,9,15,0,0,5,7,1,2,0,1,0,2,1,23
5029,791101,37,5,14,4,13,1,1,6,7,4,2,0,3,1,1,1,17
5029,791105,37,4,8,4,7,0,1,4,5,0,3,3,2,3,2,0,12
5029,780794,25,1,3,1,1,0,2,2,2,0,5,0,2,0,2,0,4
5029,780109,22,0,2,0,1,0,1,3,4,1,3,0,1,1,0,0,3
5029,796757,17,3,6,3,5,0,1,0,0,1,2,1,4,0,3,0,6
5029,785597,3,0,1,0,1,0,0,0,0,0,0,0,0,0,0,0,0
5029,791103,3,0,0,0,0,0,0,0,0,0,0,0,0,0,0,0,0
5029,796760,1,0,0,0,0,0,0,0,0,0,0,0,0,0,0,0,0
5030,792005,32,6,13,4,6,2,7,2,4,3,7,2,4,3,1,0,16
5030,781175,32,4,5,4,5,0,0,0,0,4,7,1,1,1,2,1,8
5030,786553,26,4,10,2,4,2,6,7,9,0,1,3,2,0,3,0,17
5030,780895,37,6,15,6,14,0,1,5,8,2,1,2,0,2,4,0,17
5030,781172,35,1,3,1,2,0,1,1,2,1,4,6,1,1,2,0,3
5030,781177,16,2,3,1,1,1,2,0,1,1,3,0,2,0,1,1,5
5030,785312,22,4,6,3,4,1,2,0,0,1,3,2,1,3,1,0,9
5031,780634,22,7,9,7,9,0,0,0,0,2,5,2,2,1,0,2,14
5031,786785,31,7,15,5,9,2,6,2,2,1,2,1,1,1,0,0,18
5031,786784,27,3,12,3,9,0,3,2,4,2,2,2,4,2,1,0,8
5031,780633,28,3,6,1,3,2,3,1,2,0,0,2,5,1,3,0,9
5031,776009,21,3,8,3,7,0,1,1,1,1,1,2,2,1,4,0,7
5031,786783,14,1,5,0,4,1,1,0,0,0,0,2,0,1,2,0,3
5031,797387,5,0,1,0,0,0,1,0,0,0,0,1,2,0,1,0,0
5031,797389,18,1,3,1,3,0,0,0,0,1,4,0,1,1,1,0,2
5031,791826,30,2,2,0,0,2,2,0,2,0,4,5,1,0,0,0,6
5031,797388,4,0,0,0,0,0,0,0,0,0,1,1,0,0,0,0,0
5032,792583,32,6,12,1,2,5,10,2,2,2,2,2,0,0,0,0,19
5032,792593,35,5,8,5,8,0,0,1,3,2,8,3,3,1,3,3,11
5032,792595,37,3,8,3,5,0,3,4,4,0,4,1,2,1,2,0,10
5032,792588,30,3,5,1,1,2,4,0,0,0,2,2,0,3,1,0,8
5032,792594,30,3,11,3,3,0,8,0,0,1,6,3,3,1,0,1,6
5032,792591,20,2,2,2,2,0,0,1,2,0,5,0,0,1,2,0,5
5032,796989,5,1,1,1,1,0,0,0,0,1,0,0,3,0,0,1,2
5032,796987,9,0,2,0,1,0,1,1,2,0,0,0,2,0,1,0,1
5032,792586,2,0,1,0,0,0,1,0,0,0,1,1,1,0,1,0,0
5033,796960,28,4,9,4,9,0,0,3,4,3,3,0,5,0,1,0,11
5033,791258,31,3,6,2,4,1,2,0,0,0,6,2,1,2,4,0,7
5033,781270,38,2,15,1,11,1,4,0,0,2,3,0,0,0,1,0,5
5033,791261,33,2,7,1,3,1,4,0,0,0,3,1,0,1,2,0,5
5033,791260,19,1,6,1,6,0,0,0,0,1,0,1,0,1,1,1,2
5033,785501,29,4,9,3,4,1,5,6,7,2,5,1,2,1,0,0,15
5033,796958,7,2,3,2,2,0,1,0,1,2,0,0,0,3,0,0,4
5033,785503,7,1,3,1,3,0,0,0,0,1,0,0,2,0,0,0,2
5033,785502,8,0,1,0,1,0,0,0,0,0,1,0,3,0,0,1,0
5034,797380,28,0,5,0,2,0,3,2,2,1,0,1,4,0,1,0,2
5034,789043,18,2,7,2,7,0,0,0,0,3,6,0,5,0,1,0,4
5034,797377,24,3,6,2,2,1,4,0,0,0,2,2,1,2,0,0,7
5034,791818,39,9,22,6,12,3,10,7,7,1,3,1,0,1,3,0,28
5034,780646,29,1,6,1,4,0,2,0,0,0,1,2,3,0,1,1,2
5034,797382,12,0,2,0,0,0,2,0,0,0,3,0,3,0,1,0,0
5034,797379,22,3,7,3,5,0,2,1,2,4,5,3,0,1,0,1,7
5034,797378,12,3,5,3,5,0,0,0,0,1,0,0,0,0,0,0,6
5034,786636,16,1,4,1,1,0,3,0,0,0,1,0,0,0,0,0,2
5035,785884,14,2,5,1,2,1,3,0,0,0,1,0,4,0,2,0,5
5035,780904,22,3,5,3,5,0,0,2,3,1,4,0,1,0,1,0,8
5035,797688,36,6,10,4,8,2,2,0,0,1,3,0,2,1,3,0,14
5035,786145,19,3,6,0,1,3,5,2,2,0,0,1,1,0,1,0,11
5035,786128,28,4,9,2,5,2,4,2,2,0,6,5,3,0,1,0,12
5035,797684,1,0,0,0,0,0,0,2,2,0,0,0,0,0,0,0,2
5035,792100,20,5,8,5,8,0,0,1,3,1,9,2,2,0,0,0,11
5035,797685,32,2,6,2,4,0,2,2,2,2,4,5,2,0,1,1,6
5035,797686,12,1,2,1,1,0,1,0,0,0,1,0,0,0,1,0,2
5035,792098,1,0,0,0,0,0,0,0,0,0,0,0,0,0,0,0,0
5035,792096,5,1,2,0,0,1,2,0,0,0,0,0,0,0,0,0,3
5035,780906,1,0,0,0,0,0,0,0,0,0,0,0,0,0,0,0,0
5035,775251,9,1,2,1,1,0,1,0,0,1,3,0,2,0,1,0,2
5036,796932,23,10,16,6,10,4,6,1,1,0,2,4,2,2,2,0,25
5036,791230,29,9,10,4,4,5,6,0,0,0,1,0,2,1,1,1,23
5036,791228,22,7,9,4,5,3,4,2,3,3,1,1,3,5,3,0,19
5036,785624,24,3,10,1,4,2,6,0,0,2,3,6,3,1,2,0,8
5036,791227,32,2,8,1,3,1,5,2,2,1,1,5,4,1,0,0,7
5036,796933,28,6,7,3,3,3,4,4,4,2,3,0,4,0,1,0,19
5036,781198,23,3,5,1,2,2,3,0,0,1,3,2,3,1,2,0,8
5036,791229,7,2,2,2,2,0,0,0,0,1,0,0,0,0,0,0,4
5036,781211,12,0,3,0,0,0,3,0,0,0,1,3,2,1,1,0,0
5037,797842,33,4,12,4,11,0,1,12,16,8,5,7,4,2,4,0,20
5037,786079,27,4,9,4,7,0,2,2,2,0,1,2,3,2,2,0,10
5037,781537,32,3,5,3,4,0,1,0,0,1,6,1,1,1,2,3,6
5037,797849,15,2,3,1,2,1,1,0,0,0,1,0,2,0,6,0,5
5037,792202,17,2,3,2,2,0,1,0,0,0,0,0,1,0,1,0,4
5037,797846,25,6,12,6,10,0,2,4,4,1,2,1,3,0,3,0,16
5037,797836,11,3,7,2,4,1,3,1,2,2,0,0,0,0,0,0,8
5037,797835,14,1,3,1,1,0,2,0,0,2,0,0,0,1,1,0,2
5037,792201,6,0,1,0,0,0,1,2,2,1,0,0,1,0,0,0,2
5037,797838,14,0,2,0,2,0,0,0,0,0,1,0,0,0,2,1,0
5037,797847,6,0,2,0,2,0,0,0,0,1,0,0,0,0,0,0,0
5038,791537,18,2,3,2,3,0,0,0,0,0,4,2,4,1,1,0,4
5038,786357,31,5,10,4,7,1,3,1,5,0,9,0,4,0,5,0,12
5038,780306,37,8,17,7,16,1,1,11,11,5,7,3,3,1,5,0,28
5038,797116,31,1,3,1,1,0,2,0,0,0,0,2,3,0,3,1,2
5038,780312,30,1,4,0,1,1,3,0,0,0,1,1,4,0,3,0,3
5038,791535,1,0,0,0,0,0,0,0,0,0,0,0,0,0,0,0,0
5038,786358,28,2,5,2,3,0,2,0,0,0,2,3,4,2,4,0,4
5038,775846,2,0,0,0,0,0,0,0,0,0,0,0,1,0,1,0,0
5038,775418,22,1,2,1,2,0,0,6,6,5,5,0,2,0,3,1,8
5039,792121,39,2,5,0,1,2,4,1,2,1,6,1,4,3,0,0,7
5039,786257,27,8,15,8,13,0,2,2,4,0,2,2,5,1,1,2,18
5039,786263,37,4,8,2,3,2,5,6,8,1,1,1,4,1,1,0,16
5039,785661,38,4,7,4,6,0,1,3,5,0,1,5,2,3,4,0,11
5039,775825,34,3,8,3,7,0,1,5,8,0,2,4,3,2,3,0,11
5039,797721,3,0,1,0,1,0,0,0,0,0,0,0,0,0,0,0,0
5039,797725,13,1,3,1,3,0,0,0,2,0,0,0,3,1,1,2,2
5039,786249,9,0,1,0,0,0,1,0,2,0,0,0,1,1,2,0,0
5040,796473,19,1,4,1,4,0,0,3,4,4,4,1,5,2,1,0,5
5040,781560,21,10,17,10,17,0,0,2,3,3,8,0,2,1,0,2,22
5040,796477,24,7,12,6,9,1,3,0,0,0,5,7,0,1,0,1,15
5040,791375,26,2,5,2,2,0,3,0,0,0,5,4,0,0,0,0,4
5040,780837,23,8,15,4,10,4,5,0,0,0,3,2,2,0,0,0,20
5040,796479,24,4,7,3,5,1,2,2,2,2,6,0,4,1,0,1,11
5040,796478,5,0,1,0,1,0,0,0,0,0,1,0,0,0,0,0,0
5040,796476,25,4,5,4,5,0,0,0,1,3,1,1,1,0,0,3,8
5040,786164,24,3,7,1,2,2,5,3,3,0,6,2,3,1,0,0,11
5040,796472,6,1,5,1,3,0,2,1,2,1,0,0,1,2,1,0,3
5040,790928,3,0,0,0,0,0,0,0,0,0,0,1,0,0,0,0,0
5042,786509,25,2,5,2,5,0,0,3,4,2,2,0,2,2,4,0,7
5042,786508,28,4,10,2,4,2,6,0,1,1,4,0,4,1,1,1,10
5042,786505,35,5,12,0,4,5,8,0,0,0,0,6,1,0,2,0,15
5042,785796,34,9,16,5,9,4,7,0,0,1,3,0,3,2,2,0,22
5042,797576,37,8,13,6,8,2,5,4,4,1,4,4,2,1,2,0,22
5042,797579,13,0,2,0,1,0,1,0,2,1,0,2,1,0,0,0,0
5042,797577,14,1,1,1,1,0,0,0,0,3,3,0,2,0,0,0,2
5042,786507,14,0,4,0,1,0,3,0,0,1,3,0,2,0,1,0,0
5043,791243,26,3,5,3,4,0,1,1,1,0,1,5,1,1,3,0,7
5043,791245,24,5,13,4,10,1,3,5,6,1,4,1,2,0,1,0,16
5043,781243,35,4,8,4,5,0,3,0,0,2,5,4,1,1,2,0,8
5043,776205,32,4,11,3,7,1,4,2,2,1,1,0,4,0,1,1,11
5043,781244,26,7,10,7,8,0,2,6,6,1,9,2,3,0,0,1,20
5043,785537,22,0,2,0,2,0,0,1,2,0,1,1,1,1,1,0,1
5043,781237,10,1,3,0,0,1,3,0,0,0,1,0,1,0,0,0,3
5043,791241,22,5,7,5,7,0,0,0,0,2,1,0,2,1,3,0,10
5043,785529,2,0,0,0,0,0,0,0,0,0,0,0,0,0,0,0,0
5043,796943,1,0,0,0,0,0,0,0,0,0,0,0,0,0,0,0,0
5044,791669,27,1,3,1,3,0,0,1,2,0,0,1,1,0,0,1,3
5044,785762,37,7,15,3,8,4,7,1,2,4,7,0,4,1,2,0,19
5044,797407,16,1,3,1,1,0,2,0,2,0,1,6,4,0,1,0,2
5044,785760,20,2,5,1,1,1,4,2,3,1,1,0,0,0,0,0,7
5044,780531,39,4,13,1,3,3,10,3,6,0,3,6,0,5,0,0,14
5044,797414,7,0,0,0,0,0,0,0,0,1,0,0,1,1,0,0,0
5044,797411,4,0,0,0,0,0,0,0,0,0,1,0,2,1,1,0,0
5044,780534,4,3,3,3,3,0,0,1,2,1,1,0,1,1,0,2,7
5044,797409,23,4,10,3,5,1,5,0,0,0,0,3,1,1,1,0,9
5044,791666,22,7,11,3,4,4,7,3,4,0,2,1,3,1,0,0,21
5044,780535,1,0,0,0,0,0,0,0,0,0,0,0,0,0,0,0,0
5045,791352,24,3,6,1,2,2,4,0,0,0,5,0,2,0,1,0,8
5045,780455,22,7,9,7,9,0,0,2,5,1,7,0,2,0,0,1,16
5045,797251,29,2,5,2,2,0,3,0,0,1,2,1,0,0,4,0,4
5045,797247,36,5,11,4,8,1,3,4,4,1,9,6,2,1,3,0,15
5045,776297,36,2,7,2,5,0,2,6,6,1,2,2,1,0,2,0,10
5045,791355,10,0,2,0,0,0,2,2,2,0,0,0,2,0,0,0,2
5045,791354,2,0,0,0,0,0,0,0,0,0,0,0,1,0,0,0,0
5045,785837,23,6,7,3,4,3,3,2,3,3,3,2,3,0,0,1,17
5045,786227,0,0,0,0,0,0,0,0,0,0,0,0,0,0,0,0,0
5045,797249,4,0,1,0,1,0,0,0,0,0,0,0,0,0,2,0,0
5045,797248,14,4,4,1,1,3,3,2,2,0,1,0,3,0,2,0,13
5046,785126,12,1,2,1,2,0,0,0,0,1,1,1,3,0,0,0,2
5046,779857,21,9,9,8,8,1,1,4,4,2,4,1,1,1,2,3,23
5046,791014,21,3,8,0,0,3,8,0,0,0,3,3,2,0,2,0,9
5046,779976,31,3,7,1,3,2,4,2,2,0,8,6,1,1,1,0,10
5046,774990,23,5,9,3,7,2,2,0,0,0,3,4,2,0,3,0,12
5046,796673,9,1,2,0,0,1,2,0,0,0,0,1,1,0,1,0,3
5046,796672,3,0,1,0,0,0,1,0,0,0,0,0,0,0,0,0,0
5046,780142,2,0,1,0,0,0,1,0,0,1,0,1,0,0,0,0,0
5046,796674,25,4,6,4,5,0,1,1,2,1,5,6,1,1,2,0,9
5046,781586,16,5,5,5,5,0,0,2,4,2,4,0,3,1,2,0,12
5046,785961,15,2,8,0,0,2,8,0,0,1,1,3,1,0,0,0,6
5046,785339,18,3,5,0,0,3,5,0,0,0,4,2,0,0,0,1,9
5046,787090,3,0,0,0,0,0,0,0,0,0,2,0,0,0,0,0,0
5046,791016,1,0,0,0,0,0,0,0,0,0,0,0,0,0,0,0,0
5047,797482,35,3,11,2,8,1,3,0,0,2,1,6,4,1,3,0,7
5047,797485,18,1,2,0,0,1,2,0,0,0,4,1,5,0,1,0,3
5047,797481,28,7,13,3,6,4,7,3,4,0,2,1,1,0,2,0,21
5047,797479,17,1,5,0,1,1,4,0,0,0,2,0,0,1,0,0,3
5047,785944,31,4,12,1,4,3,8,1,1,1,0,4,3,0,3,0,12
5047,797478,23,3,9,3,6,0,3,0,0,0,1,0,0,0,0,0,6
5047,791875,13,1,2,1,2,0,0,0,0,0,3,3,0,1,1,0,2
5047,781217,12,1,3,0,0,1,3,4,4,0,2,0,1,0,1,0,7
5047,797483,20,3,7,3,4,0,3,0,1,2,2,0,0,2,1,2,6
5047,797484,3,0,0,0,0,0,0,0,0,0,0,0,1,0,0,0,0
5048,786566,36,11,18,5,9,6,9,9,9,3,8,1,2,2,3,1,37
5048,781204,20,3,7,2,4,1,3,0,0,2,0,3,4,1,1,0,7
5048,786568,13,2,4,2,4,0,0,0,1,2,1,1,0,1,2,1,4
5048,791993,21,0,4,0,3,0,1,0,0,0,6,2,2,2,3,0,0
5048,781188,29,1,5,1,4,0,1,5,6,2,1,11,3,0,3,0,7
5048,791997,10,2,7,0,2,2,5,0,0,0,3,1,2,0,0,0,6
5048,797493,5,1,2,1,2,0,0,0,1,0,0,0,1,0,0,0,2
5048,797494,14,0,1,0,1,0,0,2,2,1,1,2,1,0,3,0,2
5048,791995,4,0,2,0,1,0,1,0,0,0,2,0,0,0,0,0,0
5048,786562,22,4,5,2,2,2,3,1,2,2,2,1,3,2,0,0,11
5048,781189,26,4,6,3,5,1,1,0,0,0,1,3,3,1,3,0,9
5049,786550,19,2,8,2,4,0,4,0,0,2,4,2,4,4,1,1,4
5049,776054,24,3,5,2,4,1,1,0,0,2,5,1,2,1,1,1,7
5049,792007,18,2,6,1,4,1,2,2,2,1,1,0,2,1,2,1,7
5049,792009,20,1,2,1,1,0,1,0,1,0,2,1,0,2,3,1,2
5049,792006,24,7,8,7,8,0,0,5,6,0,0,3,4,1,3,0,19
5049,792011,9,2,3,2,2,0,1,0,2,0,1,1,3,1,0,0,4
5049,780177,9,1,1,1,1,0,0,1,2,0,1,0,1,0,0,1,3
5049,792008,15,0,1,0,1,0,0,0,0,0,2,0,2,0,0,1,0
5049,797506,13,1,3,0,0,1,3,0,0,0,1,0,1,1,3,0,3
5049,791689,14,2,6,2,4,0,2,0,1,0,1,1,0,0,3,0,4
5049,786552,22,5,7,2,2,3,5,2,2,1,2,1,0,0,1,0,15
5049,776273,13,0,5,0,3,0,2,0,0,1,1,3,2,1,3,0,0
5050,785532,25,3,5,3,5,0,0,0,0,0,3,0,3,0,0,0,6
5050,780063,35,8,11,3,6,5,5,0,0,0,3,3,2,1,2,0,21
5050,791055,28,1,3,0,2,1,1,0,0,0,1,2,3,2,2,0,3
5050,775573,25,2,8,0,1,2,7,2,2,1,1,1,2,1,3,0,8
5050,775926,33,1,10,0,4,1,6,2,4,0,7,2,0,0,1,0,5
5050,796733,2,0,0,0,0,0,0,0,0,0,0,1,0,1,0,0,0
5050,791058,15,1,3,1,3,0,0,0,0,0,2,1,1,0,0,2,2
5050,796734,7,1,3,0,2,1,1,0,0,1,1,0,2,0,1,0,3
5050,791280,25,4,10,4,8,0,2,1,1,0,0,2,0,0,1,0,9
5050,791057,5,0,0,0,0,0,0,0,0,0,0,0,0,0,0,0,0
5051,780283,21,6,10,6,10,0,0,1,2,1,5,1,1,1,3,1,13
5051,790925,38,3,8,3,7,0,1,1,2,4,3,0,2,3,0,0,7
5051,791456,31,3,12,2,7,1,5,2,2,1,3,0,0,0,1,2,9
5051,785476,32,3,6,3,6,0,0,1,2,0,1,6,3,1,4,0,7
5051,785474,29,3,6,2,4,1,2,4,4,2,5,1,1,0,2,0,11
5051,780292,19,3,6,3,6,0,0,0,0,1,7,1,1,0,1,1,6
5051,790926,12,2,2,1,1,1,1,0,0,0,2,0,2,0,2,0,5
5051,796470,7,0,0,0,0,0,0,0,0,0,1,0,1,0,0,0,0
5051,785480,11,1,2,0,1,1,1,0,0,0,0,1,0,0,1,0,3
5052,780505,32,1,8,1,5,0,3,2,3,0,3,2,2,3,4,0,4
5052,792280,34,6,11,3,7,3,4,2,2,1,1,5,1,4,2,0,17
5052,797831,25,0,5,0,1,0,4,0,0,1,5,2,3,0,1,0,0
5052,797823,31,3,7,2,5,1,2,5,5,3,2,0,2,2,2,0,12
5052,792286,7,1,1,1,1,0,0,0,0,0,0,1,0,0,1,0,2
5052,797829,18,2,5,2,5,0,0,0,0,1,1,1,1,0,0,2,4
5052,785701,12,1,5,1,5,0,0,0,2,2,1,1,1,0,1,0,2
5052,799468,18,2,4,0,1,2,3,0,0,0,1,0,0,1,1,0,6
5052,785950,5,1,2,1,2,0,0,0,0,0,0,1,0,0,0,0,2
5052,797826,6,1,1,1,1,0,0,0,0,0,0,0,3,0,1,0,2
5052,792283,10,1,3,0,0,1,3,0,0,0,1,0,1,1,0,0,3
5052,792287,2,1,1,1,1,0,0,0,0,0,0,0,0,0,0,0,2
5053,792352,34,2,6,1,3,1,3,0,0,0,3,10,2,1,2,0,5
5053,798060,28,1,3,0,2,1,1,2,2,0,1,3,4,1,2,0,5
5053,786723,30,4,7,4,7,0,0,5,5,2,4,2,2,0,5,0,13
5053,792351,18,4,6,4,5,0,1,2,2,0,2,0,0,1,0,0,10
5053,792349,35,7,12,7,12,0,0,0,0,3,7,1,2,0,4,2,14
5053,786724,16,5,7,3,4,2,3,0,0,1,3,0,4,0,0,0,12
5053,792355,26,5,9,3,4,2,5,0,0,0,2,1,1,1,2,0,12
5053,792348,8,0,1,0,0,0,1,0,0,0,1,2,0,0,1,0,0
5053,798059,1,0,0,0,0,0,0,0,0,0,0,0,0,0,0,0,0
5053,798061,1,0,0,0,0,0,0,0,0,0,0,0,0,0,0,0,0
5053,786726,3,0,0,0,0,0,0,0,0,0,0,0,0,0,0,0,0
5054,790784,31,3,6,2,4,1,2,4,5,1,4,1,3,1,0,0,11
5054,786548,24,4,10,4,10,0,0,6,7,3,3,0,5,2,3,1,14
5054,797475,30,3,6,1,4,2,2,0,2,0,0,2,3,2,0,0,8
5054,786229,27,2,3,0,0,2,3,0,0,0,2,2,1,1,0,0,6
5054,775229,31,3,11,2,9,1,2,1,2,0,2,2,4,1,2,0,8
5054,776219,9,0,3,0,2,0,1,0,0,0,1,0,0,2,0,0,0
5054,786235,16,1,5,1,5,0,0,0,0,1,2,1,2,1,0,1,2
5054,786581,6,0,0,0,0,0,0,0,0,1,0,0,0,0,1,0,0
5054,786770,20,3,12,3,8,0,4,2,2,3,2,3,1,1,1,1,8
5054,781518,6,0,0,0,0,0,0,0,1,1,0,0,1,0,1,0,0
5055,785509,15,1,2,0,0,1,2,0,0,0,1,0,2,0,0,0,3
5055,791424,32,1,2,1,1,0,1,0,0,0,2,2,4,0,6,1,2
5055,797085,32,2,11,1,6,1,5,4,4,2,6,4,3,0,1,0,9
5055,791421,33,6,12,5,9,1,3,4,7,0,4,4,2,1,4,0,17
5055,785899,36,3,6,0,0,3,6,4,6,1,5,0,0,0,1,0,13
5055,797079,6,0,0,0,0,0,0,0,0,0,0,3,1,0,1,0,0
5055,791425,27,4,6,4,6,0,0,0,0,3,5,1,2,1,1,1,8
5055,797086,0,0,0,0,0,0,0,0,0,0,1,0,0,0,0,0,0
5055,797090,1,0,0,0,0,0,0,0,0,0,0,0,3,0,1,1,0
5055,797088,18,4,4,0,0,4,4,0,0,0,0,0,3,0,1,0,12
5062,775110,22,3,6,3,6,0,0,0,0,1,6,0,3,0,1,0,6
5062,791392,29,2,6,1,4,1,2,2,2,0,1,2,0,1,0,0,7
5062,785264,16,2,10,2,6,0,4,1,1,1,1,0,3,1,1,0,5
5062,785936,22,0,5,0,2,0,3,1,2,2,1,3,2,0,1,1,1
5062,780128,29,7,17,4,8,3,9,0,0,0,1,2,0,1,2,0,17
5062,797134,5,0,1,0,1,0,0,0,0,1,0,0,1,0,0,0,0
5062,791394,6,0,0,0,0,0,0,0,2,1,1,0,0,0,0,1,0
5062,786062,5,0,1,0,1,0,0,0,0,1,0,0,3,0,0,0,0
5062,781353,4,1,3,1,3,0,0,0,0,1,0,0,3,0,0,0,2
5062,797138,27,4,10,4,8,0,2,2,2,2,3,2,1,0,3,0,10
5062,797135,18,1,2,0,0,1,2,0,0,0,5,0,2,0,1,0,3
5062,775458,17,6,9,5,6,1,3,1,1,0,2,1,0,1,1,0,14
5063,786059,26,8,11,8,10,0,1,8,8,1,7,4,1,4,2,0,24
5063,776174,24,8,15,8,15,0,0,0,3,3,8,2,0,0,1,1,16
5063,791958,30,6,7,5,6,1,1,2,3,2,3,1,1,0,1,0,15
5063,791960,29,4,11,2,4,2,7,2,2,0,3,4,0,1,1,0,12
5063,785861,30,5,11,5,7,0,4,1,2,2,2,1,2,3,0,0,11
5063,781334,5,2,3,1,2,1,1,0,0,0,0,0,1,0,0,0,5
5063,797706,7,1,1,1,1,0,0,2,2,0,1,3,0,1,2,0,4
5063,797704,13,1,3,0,1,1,2,0,0,0,1,1,2,0,0,0,3
5063,791957,3,0,0,0,0,0,0,0,0,0,1,0,1,0,0,0,0
5063,791959,4,0,0,0,0,0,0,0,0,0,1,1,1,0,1,0,0
5063,781332,26,2,3,1,1,1,2,0,0,0,5,1,0,0,0,0,5
5063,786063,3,0,0,0,0,0,0,0,0,0,0,0,0,0,0,0,0
5064,792593,31,7,11,7,10,0,1,6,8,5,8,5,5,0,3,3,20
5064,792594,16,1,7,1,3,0,4,0,0,0,2,2,5,0,2,1,2
5064,792588,38,4,9,2,2,2,7,0,1,0,4,0,1,2,1,0,10
5064,792595,36,7,11,7,11,0,0,4,6,1,5,6,1,3,6,0,18
5064,792583,35,5,10,2,3,3,7,0,0,0,0,0,2,1,1,0,13
5064,796989,5,1,3,1,2,0,1,0,0,0,0,0,2,0,0,1,2
5064,796987,9,0,0,0,0,0,0,1,2,0,0,1,1,1,1,0,1
5064,792591,30,2,6,2,3,0,3,6,6,0,7,1,0,0,0,0,10
5065,796960,34,1,7,1,7,0,0,1,2,2,6,2,3,2,2,0,3
5065,796958,25,2,6,2,6,0,0,1,2,1,6,0,0,1,1,0,5
5065,791258,30,3,7,0,1,3,6,1,2,0,4,2,1,1,0,2,10
5065,785501,29,2,10,1,5,1,5,3,4,0,3,5,5,2,2,0,8
5065,781270,36,7,13,6,10,1,3,4,5,1,2,1,2,1,5,0,19
5065,791260,11,4,5,4,5,0,0,0,0,1,1,0,4,0,2,0,8
5065,785503,7,0,1,0,1,0,0,2,2,0,0,0,1,0,0,0,2
5065,785502,1,0,0,0,0,0,0,0,0,0,0,0,2,0,0,0,0
5065,791261,27,6,8,2,3,4,5,0,0,0,3,1,1,0,1,0,16
5066,780377,34,3,9,0,1,3,8,3,5,1,2,1,1,0,1,0,12
5066,791852,29,2,3,2,3,0,0,5,8,2,5,0,3,0,0,3,9
5066,797460,34,4,12,3,5,1,7,0,1,1,6,0,1,0,3,1,9
5066,786601,31,5,17,3,8,2,9,1,1,2,5,4,4,0,2,0,13
5066,786600,26,2,9,2,7,0,2,0,1,1,6,4,1,1,2,0,4
5066,791851,17,1,2,1,1,0,1,1,1,0,3,1,0,0,1,0,3
5066,797461,18,2,5,2,4,0,1,2,3,0,3,1,3,3,1,1,6
5066,797459,3,0,0,0,0,0,0,0,0,0,0,0,1,0,0,0,0
5066,786602,3,0,1,0,1,0,0,0,0,0,0,0,1,0,0,0,0
5066,786599,5,0,2,0,1,0,1,0,0,0,1,0,1,0,0,0,0
5067,790232,37,7,18,4,14,3,4,1,2,1,3,2,2,2,4,0,18
5067,780614,26,4,4,4,4,0,0,1,1,1,8,1,3,3,2,3,9
5067,780093,25,3,7,3,6,0,1,3,6,6,7,1,4,0,1,1,9
5067,789066,39,4,15,3,8,1,7,3,4,0,9,4,1,0,1,0,12
5067,785806,23,1,4,1,2,0,2,0,0,0,4,0,2,0,1,0,2
5067,780255,5,0,1,0,1,0,0,0,0,0,1,0,4,0,1,0,0
5067,792411,19,1,2,0,0,1,2,0,0,0,2,0,0,0,0,0,3
5067,786463,26,3,12,3,10,0,2,0,0,1,4,1,2,2,0,0,6
5068,796657,16,2,3,2,3,0,0,3,3,0,4,1,0,2,4,0,7
5068,796651,13,1,1,1,1,0,0,0,0,0,1,0,0,1,1,0,2
5068,791323,28,1,2,0,0,1,2,0,0,1,3,5,2,2,0,0,3
5068,791320,33,4,12,4,10,0,2,0,0,1,3,0,3,5,3,1,8
5068,781511,34,5,10,2,5,3,5,0,0,0,2,5,1,2,3,1,13
5068,796650,24,8,12,7,10,1,2,1,3,5,4,0,0,1,1,0,18
5068,796656,10,2,3,2,3,0,0,0,0,2,3,1,0,0,1,0,4
5068,796653,2,0,1,0,1,0,0,0,0,0,1,0,1,0,0,0,0
5068,796654,1,1,1,1,1,0,0,0,0,0,2,0,0,0,1,0,2
5068,796652,1,0,0,0,0,0,0,0,0,0,0,0,0,0,0,0,0
5068,796655,1,0,0,0,0,0,0,0,0,0,0,0,0,0,0,0,0
5068,791321,12,1,2,1,2,0,0,2,2,0,0,1,2,0,0,0,4
5068,785912,25,5,14,1,4,4,10,2,2,2,1,2,0,1,3,1,16
5069,780521,26,3,6,1,2,2,4,0,0,0,0,0,2,1,1,2,8
5069,775163,23,2,4,2,4,0,0,1,2,3,2,0,1,0,5,1,5
5069,791370,26,3,7,3,5,0,2,0,1,0,3,1,1,1,0,0,6
5069,786199,30,3,9,3,7,0,2,0,0,1,5,2,1,4,6,0,6
5069,780991,31,5,11,4,7,1,4,0,0,1,2,2,1,2,4,1,11
5069,780145,12,1,2,1,2,0,0,0,0,0,1,0,3,1,0,0,2
5069,781611,5,1,2,1,2,0,0,0,1,2,0,0,3,0,1,1,2
5069,797271,20,3,6,2,2,1,4,0,0,0,6,1,0,1,3,0,7
5069,743593,15,3,7,3,6,0,1,4,4,0,0,0,0,1,2,0,10
5069,797268,2,0,1,0,1,0,0,0,0,0,0,0,1,0,0,0,0
5069,791371,10,1,3,1,2,0,1,0,0,0,0,1,0,0,0,0,2
5070,780832,27,2,4,2,4,0,0,3,6,1,4,0,3,2,1,0,7
5070,790961,32,4,5,4,5,0,0,4,5,3,1,4,3,1,2,0,12
5070,786240,24,1,4,1,2,0,2,0,0,0,0,1,1,0,1,2,2
5070,785278,32,6,13,3,6,3,7,2,2,0,4,2,1,2,3,0,17
5070,780146,32,8,13,6,9,2,4,5,7,0,3,0,1,4,4,0,23
5070,796556,8,0,1,0,0,0,1,0,0,1,1,0,1,1,0,0,0
5070,796554,4,0,0,0,0,0,0,0,0,0,0,0,0,0,0,0,0
5070,796557,9,1,2,0,1,1,1,0,0,1,0,0,1,0,0,0,3
5070,796555,7,1,2,0,0,1,2,0,0,0,0,0,0,0,0,1,3
5070,775860,25,3,6,0,0,3,6,4,6,0,2,3,1,1,1,0,13
5071,791316,27,3,7,3,7,0,0,0,0,1,5,1,1,0,1,2,6
5071,796625,25,5,6,4,5,1,1,0,0,1,3,1,2,2,2,1,11
5071,781079,26,4,9,4,8,0,1,0,0,0,0,3,1,3,2,0,8
5071,785380,4,0,0,0,0,0,0,0,0,0,0,0,1,0,1,0,0
5071,775822,33,4,11,2,4,2,7,0,0,1,3,3,3,0,2,0,10
5071,796626,2,0,0,0,0,0,0,0,0,0,0,0,0,0,0,0,0
5071,780870,25,6,8,6,8,0,0,3,3,5,3,0,3,0,2,0,15
5071,796621,12,1,5,1,3,0,2,0,0,0,1,2,0,0,1,0,2
5071,785831,20,1,3,1,3,0,0,3,4,1,1,1,5,2,2,0,5
5071,781443,26,5,10,4,7,1,3,3,4,0,3,3,2,1,2,0,14
5072,790839,23,1,1,1,1,0,0,1,2,2,4,2,1,1,3,1,3
5072,785388,27,6,19,6,19,0,0,2,4,8,3,2,4,1,1,0,14
5072,790840,27,2,8,0,6,2,2,0,0,0,1,0,1,0,2,1,6
5072,796395,31,3,14,3,9,0,5,6,7,3,2,5,4,1,3,0,12
5072,785386,34,4,12,4,10,0,2,0,0,1,0,2,0,2,1,0,8
5072,780370,17,1,5,1,2,0,3,0,0,0,4,0,2,0,1,1,2
5072,796393,14,1,2,1,2,0,0,2,2,3,5,0,1,1,1,3,4
5072,796396,16,0,1,0,1,0,0,0,0,0,1,0,2,0,1,0,0
5072,790841,11,2,3,2,3,0,0,0,0,1,1,0,1,0,1,0,4
5073,780012,39,7,14,4,9,3,5,5,6,1,9,3,1,0,1,2,22
5073,796309,23,3,7,3,7,0,0,2,3,2,1,0,4,0,6,0,8
5073,790824,29,2,10,2,7,0,3,4,4,0,7,5,3,3,2,1,8
5073,780011,32,5,8,4,5,1,3,0,0,1,4,0,2,2,0,2,11
5073,775667,29,2,5,1,4,1,1,0,0,1,2,3,0,0,2,0,5
5073,796383,5,0,1,0,0,0,1,0,0,0,1,0,0,0,0,0,0
5073,785370,12,1,2,1,2,0,0,2,2,1,0,1,2,1,0,0,4
5073,774895,7,3,6,3,6,0,0,0,0,2,0,1,4,0,1,0,6
5073,781524,24,1,2,0,0,1,2,1,2,0,5,1,2,0,2,0,4
5074,780631,21,1,5,1,1,0,4,1,2,0,1,1,1,0,1,0,3
5074,791827,36,10,16,10,16,0,0,7,8,2,4,5,1,2,0,0,27
5074,797391,26,4,8,1,2,3,6,2,2,1,3,1,0,0,0,0,13
5074,786625,32,3,4,0,0,3,4,0,0,0,3,6,2,1,2,0,9
5074,780625,29,4,10,1,1,3,9,2,2,0,1,3,2,1,1,0,13
5074,797397,6,1,1,1,1,0,0,0,0,1,0,0,2,1,0,0,2
5074,785481,17,0,5,0,5,0,0,3,4,2,4,1,2,0,2,0,3
5074,797395,22,3,7,3,5,0,2,0,0,1,2,0,0,0,0,0,6
5074,797394,5,0,0,0,0,0,0,0,0,0,0,1,2,0,1,0,0
5074,786630,6,0,1,0,1,0,0,0,0,0,0,0,0,0,1,0,0
5075,786519,24,6,7,6,7,0,0,0,1,2,1,0,1,0,0,0,12
5075,797556,35,8,12,5,8,3,4,1,2,0,2,3,2,1,3,1,20
5075,797555,11,0,1,0,1,0,0,2,2,1,1,0,1,0,1,0,2
5075,791913,34,3,5,2,2,1,3,2,2,0,7,5,0,1,2,0,9
5075,786520,33,7,12,4,7,3,5,1,2,0,2,5,2,0,2,0,18
5075,797558,26,6,11,4,5,2,6,2,3,0,5,3,3,0,2,0,16
5075,791911,6,0,2,0,0,0,2,0,0,0,0,0,2,0,2,0,0
5075,797560,16,1,1,1,1,0,0,0,0,1,4,0,1,0,0,0,2
5075,797559,6,0,2,0,0,0,2,0,2,1,1,0,0,1,0,0,0
5075,781105,9,1,2,1,1,0,1,0,0,1,0,0,0,0,0,0,2
5076,796524,6,1,1,1,1,0,0,0,0,0,1,1,1,0,2,0,2
5076,797879,21,3,8,2,3,1,5,0,0,1,2,0,2,0,1,0,7
5076,796522,24,2,8,0,1,2,7,0,0,1,0,0,2,2,1,0,6
5076,791270,27,4,6,1,1,3,5,0,0,0,1,1,3,3,1,0,11
5076,791265,32,4,12,1,4,3,8,0,0,0,3,7,3,0,1,0,11
5076,791266,20,5,6,5,6,0,0,1,2,3,4,2,3,2,2,2,11
5076,796523,14,2,4,0,1,2,3,0,0,0,4,0,1,1,1,0,6
5076,796525,4,0,2,0,0,0,2,1,2,0,1,1,0,0,1,0,1
5076,791271,14,1,2,1,2,0,0,0,0,1,3,1,2,0,1,0,2
5076,785685,32,4,17,3,11,1,6,0,0,3,5,4,2,1,5,0,9
5076,781313,6,0,0,0,0,0,0,0,0,0,0,1,0,0,1,0,0
5077,797047,25,6,8,6,7,0,1,0,0,1,4,0,1,0,1,1,12
5077,775515,26,3,7,2,2,1,5,0,0,0,1,0,0,0,0,1,7
5077,791579,35,7,13,7,12,0,1,2,2,1,9,1,1,3,4,0,16
5077,786387,37,3,12,3,11,0,1,4,5,0,7,4,1,1,1,1,10
5077,780399,33,5,8,4,5,1,3,5,8,0,4,6,0,4,1,0,16
5077,786846,7,0,0,0,0,0,0,0,0,0,2,0,0,0,0,0,0
5077,780400,13,6,8,5,6,1,2,2,4,0,1,0,1,2,1,0,15
5077,791575,12,1,1,1,1,0,0,1,2,1,3,1,1,1,1,0,3
5077,797046,12,0,1,0,1,0,0,0,0,0,0,1,1,0,1,0,0
5078,781417,19,0,0,0,0,0,0,0,0,1,1,0,3,0,3,0,0
5078,792246,29,5,9,5,9,0,0,1,3,2,9,1,2,0,0,5,11
5078,791701,22,3,5,3,5,0,0,2,2,0,3,0,1,0,2,0,8
5078,781420,37,5,13,2,5,3,8,5,5,2,6,2,0,0,4,1,18
5078,781405,37,6,15,4,8,2,7,11,13,0,4,4,2,1,2,0,25
5078,780615,10,0,1,0,1,0,0,0,0,0,1,0,2,0,0,0,0
5078,781624,21,0,2,0,1,0,1,0,1,1,3,2,2,2,0,0,0
5078,797925,25,3,8,1,4,2,4,0,0,1,1,3,1,0,2,0,8
5079,797662,25,2,5,2,3,0,2,1,2,2,5,2,0,1,1,0,5
5079,792082,27,3,8,2,3,1,5,0,0,0,1,2,1,1,0,0,7
5079,786067,36,8,18,8,18,0,0,7,8,2,8,0,3,0,1,0,23
5079,797661,35,4,12,2,7,2,5,0,0,0,1,3,4,2,0,0,10
5079,780258,29,3,8,1,3,2,5,0,0,0,3,1,3,1,3,0,8
5079,792078,18,1,2,1,2,0,0,4,4,2,0,1,2,0,1,0,6
5079,797659,2,0,1,0,1,0,0,0,0,0,0,0,1,0,0,0,0
5079,797660,11,1,3,1,3,0,0,0,0,0,0,0,1,1,0,1,2
5079,792083,17,1,5,0,4,1,1,0,0,0,3,2,2,1,2,0,3
5079,792079,0,0,0,0,0,0,0,0,0,0,0,0,0,1,0,0,0
5080,786623,15,4,4,4,4,0,0,0,0,1,2,0,5,0,0,0,8
5080,791834,36,5,9,2,5,3,4,0,0,0,1,5,0,1,0,2,13
5080,791833,24,1,6,1,6,0,0,0,0,1,4,4,3,0,0,0,2
5080,785920,38,9,15,5,7,4,8,0,0,0,7,5,1,2,3,0,22
5080,785698,25,2,8,1,2,1,6,3,4,0,8,1,0,1,2,0,8
5080,797413,2,0,1,0,0,0,1,0,0,0,0,0,0,0,1,0,0
5080,797410,3,0,0,0,0,0,0,0,0,0,0,0,0,0,0,0,0
5080,786624,21,3,8,3,8,0,0,2,2,2,1,2,2,1,1,0,8
5080,797404,8,1,1,0,0,1,1,0,0,0,1,2,3,1,1,0,3
5080,784077,28,5,9,3,4,2,5,0,0,0,2,1,0,1,0,0,12
5081,797058,17,1,4,1,2,0,2,0,0,0,3,1,1,0,1,0,2
5081,775549,20,4,5,4,5,0,0,2,3,1,4,0,2,2,1,6,10
5081,797056,25,4,12,4,8,0,4,0,1,2,1,3,1,0,4,0,8
5081,797055,22,2,8,1,4,1,4,0,0,0,3,1,0,0,1,0,5
5081,786381,28,3,6,1,1,2,5,1,1,1,7,1,2,0,1,0,9
5081,791564,16,0,1,0,0,0,1,0,0,0,0,2,1,0,2,0,0
5081,791566,6,0,0,0,0,0,0,0,0,0,1,0,1,0,0,1,0
5081,780425,19,1,4,1,4,0,0,1,2,1,2,0,1,0,3,1,3
5081,797054,27,8,13,7,8,1,5,0,0,0,2,4,0,1,1,0,17
5081,791568,20,5,6,5,5,0,1,0,2,0,1,0,0,1,0,1,10
5082,791511,15,1,2,1,2,0,0,0,0,1,1,0,2,0,1,1,2
5082,778442,27,1,6,0,3,1,3,2,2,0,3,1,2,1,3,0,5
5082,791514,13,0,2,0,1,0,1,0,0,0,1,1,0,1,0,0,0
5082,786637,37,3,8,2,5,1,3,0,2,1,3,3,2,2,1,0,7
5082,791513,24,1,7,0,3,1,4,5,6,0,1,2,2,0,1,1,8
5082,797151,19,0,0,0,0,0,0,0,0,0,3,0,2,0,1,3,0
5082,791515,7,1,1,1,1,0,0,0,0,0,0,0,3,0,2,0,2
5082,797152,3,0,0,0,0,0,0,0,0,0,0,0,1,0,2,0,0
5082,797150,28,7,11,5,8,2,3,2,4,1,5,0,0,3,4,0,18
5082,780946,27,2,4,1,2,1,2,0,0,0,2,3,2,1,4,0,5
5083,792227,27,5,8,4,6,1,2,4,6,0,6,2,2,0,0,1,15
5083,781352,22,3,7,3,7,0,0,1,3,2,2,2,0,0,4,2,7
5083,792223,29,4,9,2,4,2,5,1,2,1,7,1,1,2,0,1,11
5083,785935,35,3,7,3,7,0,0,2,2,1,2,3,1,0,3,0,8
5083,781340,34,1,2,1,1,0,1,0,0,0,3,2,2,2,1,0,2
5083,797881,13,1,4,1,4,0,0,1,2,1,1,0,4,3,2,0,3
5083,797889,5,0,2,0,2,0,0,0,0,0,2,0,1,0,2,0,0
5083,781351,13,3,5,2,3,1,2,0,0,0,0,0,1,1,2,1,7
5083,776128,22,2,3,2,3,0,0,0,0,0,2,3,0,1,2,0,4
5084,796455,45,3,5,3,5,0,0,4,6,3,3,1,3,0,2,2,10
5084,790907,28,0,3,0,3,0,0,0,0,2,2,0,4,0,3,1,0
5084,787175,28,2,8,0,0,2,8,0,0,0,7,0,1,1,1,0,6
5084,781393,41,10,29,5,12,5,17,7,9,0,3,3,2,2,4,0,32
5084,775351,33,2,4,2,3,0,1,2,2,0,2,0,1,3,1,0,6
5084,782126,15,2,5,1,3,1,2,0,0,1,4,0,0,0,1,1,5
5084,790909,35,5,8,2,4,3,4,3,4,3,2,2,5,2,2,0,16
5085,785664,23,3,4,3,4,0,0,2,2,1,5,0,3,1,0,0,8
5085,785841,37,2,7,2,6,0,1,0,0,2,7,3,1,1,0,0,4
5085,796611,11,1,5,0,1,1,4,0,0,0,1,1,0,0,0,1,3
5085,792869,27,5,9,2,4,3,5,5,5,0,1,0,1,0,1,0,18
5085,796613,21,5,8,2,3,3,5,0,0,0,3,2,3,0,1,0,13
5085,791312,12,0,0,0,0,0,0,0,0,0,2,1,3,2,3,0,0
5085,796609,17,2,3,0,0,2,3,0,0,0,4,3,0,2,3,0,6
5085,786685,28,7,10,5,8,2,2,1,2,2,1,4,1,0,2,3,17
5085,766623,9,0,0,0,0,0,0,0,1,0,1,0,1,1,1,0,0
5085,781504,40,5,12,2,6,3,6,2,3,0,3,4,2,1,2,0,15
5086,796837,18,0,4,0,3,0,1,0,0,0,4,0,2,0,1,0,0
5086,791171,14,2,2,2,2,0,0,0,0,1,1,0,2,0,1,0,4
5086,785706,20,0,3,0,1,0,2,1,2,1,1,2,2,0,4,1,1
5086,785700,37,1,4,1,2,0,2,0,0,0,2,3,3,1,1,0,2
5086,786721,15,1,5,0,2,1,3,0,0,2,0,0,2,1,2,0,3
5086,796838,16,1,3,1,3,0,0,0,0,2,3,0,3,0,2,1,2
5086,796836,2,0,0,0,0,0,0,0,0,0,0,0,0,0,0,0,0
5086,791170,30,5,14,4,9,1,5,0,0,0,0,0,1,0,1,1,11
5086,796833,15,2,6,0,0,2,6,0,0,2,0,0,1,0,2,0,6
5086,780269,33,10,19,8,13,2,6,7,8,0,5,0,1,3,3,0,29
5087,786704,20,4,5,4,5,0,0,3,5,2,8,1,1,0,2,0,11
5087,785395,21,3,6,2,4,1,2,0,0,0,2,1,0,0,0,0,7
5087,775840,22,2,5,0,2,2,3,2,2,1,2,7,1,3,0,0,8
5087,775955,26,6,10,1,2,5,8,4,4,0,4,3,1,4,1,1,21
5087,775811,13,2,3,2,2,0,1,0,0,1,1,2,2,1,0,0,4
5087,792327,8,2,3,2,3,0,0,3,4,2,2,0,1,0,2,0,7
5087,786706,12,6,7,6,7,0,0,2,2,2,1,0,1,1,0,1,14
5087,786703,7,0,1,0,1,0,0,0,2,0,2,1,0,0,0,0,0
5087,775287,12,2,3,2,3,0,0,0,0,0,0,1,2,0,0,0,4
5087,798110,2,0,0,0,0,0,0,0,0,0,1,0,0,0,0,0,0
5087,786702,16,1,3,1,3,0,0,0,0,3,2,2,1,0,1,0,2
5087,790921,17,6,9,6,9,0,0,2,2,0,3,2,2,5,0,0,14
5087,786551,24,5,9,2,4,3,5,0,2,1,1,2,1,1,3,0,13
5088,776344,26,4,13,4,12,0,1,2,4,2,6,1,2,1,3,2,10
5088,775821,29,2,7,2,5,0,2,4,4,2,4,1,0,0,3,1,8
5088,792453,34,6,12,5,11,1,1,0,0,0,9,3,3,1,4,0,13
5088,785131,27,1,3,1,1,0,2,2,3,2,4,1,1,1,3,0,4
5088,781538,34,0,4,0,0,0,4,2,2,0,5,3,1,1,2,0,2
5088,798113,2,1,1,1,1,0,0,0,0,0,0,1,1,0,0,0,2
5088,785152,15,0,1,0,1,0,0,0,0,0,1,0,1,0,0,0,0
5088,798115,19,2,7,0,1,2,6,0,0,1,2,0,1,0,0,0,6
5088,776233,14,0,3,0,1,0,2,0,0,0,1,0,5,1,1,0,0
5089,791053,21,2,6,2,6,0,0,0,0,0,5,0,2,0,1,0,4
5089,785524,34,2,9,0,4,2,5,0,0,1,2,1,1,0,1,0,6
5089,781115,32,1,5,1,4,0,1,0,0,1,6,3,2,0,0,0,2
5089,775094,23,2,8,2,6,0,2,2,3,2,4,0,1,0,0,0,6
5089,775456,22,6,13,4,11,2,2,0,0,0,4,1,3,1,2,1,14
5089,796731,6,0,1,0,0,0,1,0,0,1,1,0,2,0,0,0,0
5089,796730,14,1,3,0,0,1,3,0,0,0,1,1,0,0,1,0,3
5089,791051,18,1,3,1,3,0,0,2,3,2,1,0,0,0,1,4,4
5089,790819,16,2,10,2,8,0,2,2,4,0,1,2,2,1,3,0,6
5089,786310,8,0,0,0,0,0,0,2,2,0,0,0,1,0,0,0,2
5089,780739,6,0,1,0,1,0,0,0,0,0,0,0,0,0,1,0,0
5090,792288,24,1,9,1,6,0,3,1,2,0,3,1,1,2,0,1,3
5090,785227,34,3,5,3,5,0,0,2,2,1,5,2,3,0,3,3,8
5090,786237,26,5,7,5,7,0,0,4,5,1,1,2,4,1,1,0,14
5090,786232,33,6,11,3,6,3,5,1,2,2,5,4,0,1,0,0,16
5090,780287,36,9,17,7,12,2,5,1,2,0,4,1,1,2,0,0,21
5090,798067,6,0,0,0,0,0,0,0,0,1,1,0,1,0,1,0,0
5090,792278,25,4,8,2,4,2,4,0,0,0,0,5,0,1,0,0,10
5090,776309,16,2,7,1,4,1,3,1,2,2,5,1,1,1,2,0,6
5091,791839,25,2,4,2,4,0,0,0,0,1,8,4,1,0,4,0,4
5091,785322,26,0,4,0,0,0,4,0,0,0,3,1,1,0,3,1,0
5091,791842,32,5,12,0,2,5,10,2,2,1,4,0,3,0,2,0,17
5091,786616,33,6,11,3,6,3,5,0,1,0,1,5,1,0,2,0,15
5091,786736,7,0,2,0,1,0,1,0,0,0,1,0,0,0,1,0,0
5091,797443,15,4,5,4,5,0,0,2,3,2,2,1,4,0,1,1,10
5091,797444,19,3,6,3,5,0,1,0,0,2,0,1,2,1,1,0,6
5091,797442,20,2,6,1,3,1,3,1,1,0,2,0,0,0,0,0,6
5091,786613,18,3,6,1,1,2,5,2,2,0,3,1,0,1,1,1,10
5091,776341,5,0,0,0,0,0,0,0,0,0,0,0,1,0,1,0,0
5092,785829,30,7,10,7,10,0,0,0,1,2,4,2,2,0,0,0,14
5092,775838,21,1,3,0,2,1,1,0,0,0,4,1,3,1,3,0,3
5092,796726,23,2,7,2,4,0,3,3,4,0,2,2,3,2,1,0,7
5092,791048,21,0,2,0,1,0,1,0,0,0,3,2,1,0,0,1,0
5092,786531,37,8,12,3,5,5,7,2,3,0,2,2,2,2,0,1,23
5092,791044,14,6,10,6,10,0,0,1,1,2,2,0,2,1,0,0,13
5092,780723,9,0,0,0,0,0,0,0,0,0,1,1,1,0,0,0,0
5092,796729,27,5,10,2,4,3,6,7,7,0,4,2,1,1,2,0,20
5092,796727,8,0,0,0,0,0,0,0,0,0,1,0,0,1,0,0,0
5092,796724,10,1,2,1,2,0,0,1,3,0,1,3,2,1,1,0,3
5093,791760,18,4,8,4,7,0,1,1,2,1,2,0,0,0,0,0,9
5093,780256,28,2,7,2,5,0,2,2,2,1,3,1,3,0,2,0,6
5093,796879,31,4,11,3,7,1,4,0,0,6,3,4,3,1,3,1,9
5093,796880,26,4,10,2,4,2,6,2,2,0,5,3,5,0,1,0,12
5093,791334,37,7,14,2,6,5,8,1,2,0,6,3,1,0,1,0,20
5093,785876,1,0,0,0,0,0,0,0,0,0,0,0,0,0,0,0,0
5093,785874,21,2,5,1,4,1,1,0,0,4,3,0,2,1,1,0,5
5093,796885,6,0,2,0,1,0,1,0,0,1,1,0,1,0,1,0,0
5093,796883,13,1,3,1,3,0,0,0,0,0,0,4,2,1,1,0,2
5093,791331,1,0,0,0,0,0,0,0,0,0,0,0,0,0,0,0,0
5093,781590,18,1,4,1,2,0,2,2,2,0,1,1,1,0,0,0,4
5094,780844,28,2,8,0,0,2,8,0,0,1,4,2,5,2,0,0,6
5094,797699,36,3,11,3,6,0,5,7,8,0,5,5,4,0,3,0,13
5094,791954,27,4,7,2,4,2,3,5,6,0,4,1,2,2,2,0,15
5094,791956,27,5,8,2,2,3,6,2,2,3,4,0,1,1,0,1,15
5094,780846,34,3,9,2,5,1,4,1,2,0,5,5,2,1,2,2,8
5094,797698,5,0,2,0,1,0,1,0,0,1,1,0,0,1,0,1,0
5094,797695,9,0,2,0,2,0,0,0,0,0,3,1,5,1,4,0,0
5094,797694,10,0,2,0,0,0,2,0,0,0,1,0,1,0,0,0,0
5094,797692,24,5,9,1,1,4,8,0,0,1,2,1,1,0,1,0,14
5095,791702,19,2,3,2,3,0,0,0,2,0,9,0,2,0,1,0,4
5095,797523,25,4,10,2,3,2,7,1,1,0,1,2,2,2,0,0,11
5095,785402,24,8,11,8,11,0,0,5,8,5,4,0,0,0,4,0,21
5095,792118,36,2,16,2,10,0,6,4,4,1,5,4,2,1,1,0,8
5095,782593,36,4,12,2,4,2,8,6,7,1,2,2,2,1,2,2,16
5095,785828,16,0,4,0,4,0,0,2,2,2,4,0,0,0,1,2,2
5095,797525,3,0,0,0,0,0,0,0,0,0,0,0,1,0,1,1,0
5095,797524,10,0,0,0,0,0,0,0,0,0,1,2,5,0,2,0,0
5095,797526,7,1,1,1,1,0,0,0,0,1,0,0,0,1,1,0,2
5095,791700,24,0,5,0,1,0,4,0,0,1,3,0,3,0,1,0,0
5096,792035,18,4,8,4,8,0,0,4,4,3,1,2,4,0,1,0,12
5096,780833,18,2,3,2,3,0,0,0,0,1,1,1,2,0,1,1,4
5096,792034,30,3,7,1,2,2,5,2,2,0,10,4,2,0,3,0,10
5096,792033,31,8,14,2,5,6,9,2,2,0,2,3,2,1,2,0,24
5096,780830,28,3,4,1,2,2,2,4,4,0,3,5,4,0,1,0,12
5096,797645,22,6,8,6,8,0,0,3,6,0,3,1,3,0,3,2,15
5096,785982,3,0,0,0,0,0,0,0,0,0,1,0,0,0,0,1,0
5096,797644,3,0,0,0,0,0,0,0,0,0,0,0,0,0,0,0,0
5096,791688,11,2,2,1,1,1,1,0,0,0,1,1,2,0,2,0,5
5096,785980,11,2,2,0,0,2,2,1,2,0,0,3,1,0,0,0,7
5096,785381,25,1,3,0,0,1,3,0,0,1,3,1,1,1,2,0,3
5097,786481,26,5,10,5,10,0,0,4,5,2,2,0,3,0,2,1,14
5097,797626,30,6,13,4,10,2,3,0,0,4,4,5,2,1,2,0,14
5097,797624,27,2,5,1,2,1,3,5,6,2,1,2,1,3,0,0,10
5097,786480,31,1,5,1,2,0,3,2,4,1,1,4,3,1,1,0,4
5097,781032,24,2,7,0,2,2,5,2,2,0,3,2,3,0,1,0,8
5097,797628,18,1,5,1,3,0,2,1,3,0,3,1,3,1,2,0,3
5097,797625,5,0,2,0,1,0,1,0,0,0,0,0,0,0,0,0,0
5097,791793,9,2,3,2,2,0,1,1,1,0,1,0,3,0,2,0,5
5097,791791,10,1,1,1,1,0,0,2,2,1,0,1,2,2,0,0,4
5097,797627,5,0,0,0,0,0,0,1,2,0,0,0,1,0,0,0,1
5097,785965,15,4,8,2,6,2,2,0,0,0,0,0,0,1,1,0,10
5098,785681,30,1,3,1,3,0,0,0,2,1,3,1,1,1,1,2,2
5098,796789,30,4,15,3,3,1,12,0,0,0,6,2,1,2,4,0,9
5098,791126,24,4,5,4,4,0,1,2,2,2,6,4,4,0,1,1,10
5098,791124,33,8,10,4,5,4,5,5,6,1,5,4,2,2,1,0,25
5098,780050,31,4,10,1,4,3,6,2,4,0,6,5,2,1,2,0,13
5098,784479,8,1,1,1,1,0,0,0,0,1,2,0,2,0,0,0,2
5098,796786,8,0,1,0,0,0,1,0,0,0,0,0,2,0,2,0,0
5098,796788,1,0,0,0,0,0,0,0,0,0,0,0,1,0,0,0,0
5098,796784,18,1,4,0,0,1,4,0,0,0,2,1,4,1,0,0,3
5098,796783,5,0,0,0,0,0,0,0,0,0,0,0,2,0,1,0,0
5098,796782,12,0,3,0,1,0,2,0,0,0,1,0,2,1,0,0,0
5099,797728,25,4,5,1,1,3,4,0,0,0,4,0,0,0,0,1,11
5099,792036,21,0,2,0,1,0,1,0,0,0,1,1,4,0,1,0,0
5099,786266,34,7,20,6,10,1,10,5,5,3,4,1,0,0,0,0,20
5099,792040,32,2,8,2,7,0,1,0,4,1,3,2,1,0,2,0,4
5099,775028,34,3,12,3,9,0,3,10,14,2,5,2,4,2,5,0,16
5099,786039,16,1,5,1,5,0,0,0,1,4,4,0,4,0,1,1,2
5099,797723,11,0,2,0,1,0,1,0,0,0,1,0,2,0,0,0,0
5099,797719,5,0,1,0,1,0,0,0,0,0,1,0,0,0,0,0,0
5099,797718,4,0,1,0,0,0,1,0,0,0,0,1,0,0,0,0,0
5099,792043,18,0,2,0,0,0,2,0,0,4,4,0,1,2,3,0,0
5100,796892,14,3,7,3,7,0,0,0,0,0,1,1,3,0,0,0,6
5100,796886,34,2,4,1,3,1,1,3,6,1,7,2,1,0,1,1,8
5100,796884,29,3,5,2,3,1,2,0,0,0,2,2,4,0,2,0,7
5100,796887,17,0,3,0,2,0,1,0,0,0,1,3,0,1,1,0,0
5100,796882,36,7,17,5,11,2,6,6,6,1,5,3,0,1,4,0,22
5100,796891,27,10,16,7,12,3,4,0,0,3,3,2,5,1,1,0,23
5100,796890,2,0,1,0,0,0,1,0,0,0,0,1,2,0,1,0,0
5100,796896,21,1,4,0,0,1,4,0,0,1,3,1,4,2,1,0,3
5100,796888,5,0,1,0,0,0,1,0,0,0,1,0,0,0,0,0,0
5100,790447,15,2,4,2,3,0,1,1,2,0,1,3,0,1,0,1,5
5101,776279,28,2,5,0,0,2,5,0,0,0,2,3,3,1,1,2,6
5101,781505,24,5,10,4,7,1,3,0,2,2,4,2,4,0,2,1,11
5101,780353,31,5,7,5,7,0,0,6,7,4,6,0,4,2,5,1,16
5101,791317,34,6,20,3,12,3,8,0,0,0,5,3,1,1,2,0,15
5101,777573,28,5,10,4,6,1,4,6,6,1,1,1,0,0,0,0,17
5101,786222,25,2,3,2,3,0,0,1,3,4,5,1,2,0,3,0,5
5101,796649,7,0,1,0,0,0,1,0,0,0,0,0,0,0,0,0,0
5101,790851,13,1,2,1,2,0,0,0,1,2,2,0,0,0,2,0,2
5101,796648,10,1,4,0,2,1,2,2,2,0,3,1,0,2,1,0,5
5108,797380,21,2,4,2,3,0,1,2,2,2,1,0,0,1,1,0,6
5108,789043,22,3,6,3,6,0,0,1,2,2,8,0,2,0,2,0,7
5108,797377,31,3,5,1,1,2,4,1,1,0,3,6,1,2,0,1,9
5108,791818,33,9,16,8,12,1,4,0,2,1,3,2,3,2,2,0,19
5108,780646,21,2,8,2,4,0,4,1,2,0,1,2,4,0,1,0,5
5108,797382,12,1,2,1,2,0,0,0,0,3,2,0,2,0,1,0,2
5108,797379,18,2,2,2,2,0,0,4,6,0,5,1,2,0,1,0,8
5108,797378,12,1,1,1,1,0,0,1,2,0,3,2,1,0,2,0,3
5108,786636,30,6,14,3,5,3,9,8,8,0,2,2,2,0,6,1,23
5109,785884,24,3,6,3,5,0,1,3,4,3,2,0,2,0,0,1,9
5109,780904,22,3,4,3,4,0,0,4,4,3,5,4,5,0,1,1,10
5109,797688,34,5,14,3,10,2,4,0,0,0,2,2,3,0,4,0,12
5109,786145,20,1,4,1,2,0,2,0,0,0,2,0,1,0,2,0,2
5109,786128,36,6,21,6,15,0,6,6,8,2,6,5,3,3,2,0,18
5109,792100,18,2,3,2,3,0,0,2,2,3,2,1,2,2,1,0,6
5109,797685,25,3,10,2,7,1,3,4,4,1,2,2,2,0,2,0,11
5109,797686,13,1,3,1,2,0,1,0,0,0,0,0,3,2,0,0,2
5109,792096,5,0,1,0,0,0,1,0,0,0,0,0,0,0,0,0,0
5109,775251,3,0,1,0,1,0,0,0,0,0,1,0,2,0,1,0,0
5110,785577,17,1,2,1,2,0,0,3,3,3,2,0,4,0,1,0,5
5110,791094,34,3,7,2,4,1,3,0,2,1,7,1,0,2,2,0,7
5110,791091,13,1,4,1,2,0,2,1,1,1,1,1,4,0,0,0,3
5110,791093,27,4,11,4,9,0,2,4,4,1,4,0,3,1,2,1,12
5110,785569,26,5,7,3,4,2,3,1,1,0,2,0,1,1,1,0,13
5110,791089,23,3,5,1,3,2,2,0,1,1,5,1,1,1,0,1,8
5110,791097,2,1,1,1,1,0,0,0,0,0,0,0,0,0,0,0,2
5110,796753,20,3,7,1,2,2,5,0,0,1,0,0,1,0,1,0,8
5110,796752,28,3,5,2,3,1,2,0,1,0,2,4,2,1,0,1,7
5110,791090,10,0,5,0,2,0,3,0,0,1,0,1,1,0,2,0,0
5111,785809,28,1,5,0,2,1,3,0,1,0,1,1,3,0,1,0,3
5111,785740,33,6,10,6,10,0,0,2,6,7,4,1,4,0,0,1,14
5111,780530,37,2,8,2,4,0,4,0,1,2,10,0,3,0,4,1,4
5111,797402,38,2,9,0,3,2,6,0,0,1,4,0,3,0,0,0,6
5111,785738,40,10,19,7,13,3,6,7,8,0,3,7,2,2,3,1,30
5111,797396,12,2,2,1,1,1,1,0,0,1,0,0,1,0,1,0,5
5111,785739,7,1,1,1,1,0,0,0,0,0,0,0,0,0,0,0,2
5111,797399,3,0,1,0,0,0,1,0,0,0,0,0,0,0,0,0,0
5111,791664,2,0,0,0,0,0,0,0,0,0,0,0,0,0,1,0,0
5112,780686,32,9,21,9,21,0,0,2,7,4,5,1,2,0,4,0,20
5112,780683,23,5,7,5,5,0,2,3,3,4,7,1,2,0,0,0,13
5112,797681,37,3,8,2,5,1,3,2,2,0,5,3,2,0,1,0,9
5112,797680,27,3,10,2,6,1,4,2,2,0,4,0,2,1,1,0,9
5112,780688,20,2,5,2,4,0,1,2,4,0,1,1,2,1,3,0,6
5112,797682,2,0,1,0,1,0,0,0,0,0,0,0,0,0,0,1,0
5112,797679,5,0,4,0,3,0,1,0,0,0,0,0,0,0,0,0,0
5112,791942,31,3,7,3,6,0,1,0,1,1,6,2,3,3,0,0,6
5112,780689,23,1,2,0,0,1,2,0,0,0,3,0,0,1,0,0,3
5113,785916,27,5,10,2,6,3,4,2,2,2,5,1,4,0,3,0,15
5113,780105,37,6,14,6,10,0,4,0,1,1,9,3,4,1,5,1,12
5113,785637,38,3,11,0,5,3,6,0,0,0,4,1,2,0,0,0,9
5113,785915,38,2,6,0,0,2,6,0,0,0,3,4,3,0,1,0,6
5113,781131,37,6,14,4,6,2,8,1,3,1,9,5,3,1,4,1,15
5113,791408,13,5,8,5,8,0,0,0,0,2,2,1,0,0,1,0,10
5113,780106,6,0,2,0,1,0,1,0,0,0,2,0,3,0,1,0,0
5113,791409,4,0,0,0,0,0,0,0,0,0,0,0,0,0,0,0,0
5114,791135,17,1,6,1,6,0,0,1,3,1,0,3,0,0,0,2,3
5114,791132,22,3,7,1,2,2,5,0,3,4,1,1,3,1,1,1,8
5114,786090,35,9,11,5,7,4,4,8,8,1,7,6,3,3,2,0,30
5114,786088,36,3,6,3,5,0,1,4,8,1,8,6,3,1,1,0,10
5114,774921,24,5,12,3,9,2,3,0,0,0,2,5,4,0,0,0,12
5114,791133,23,5,6,5,6,0,0,0,1,4,1,1,3,0,0,1,10
5114,791131,20,1,3,1,2,0,1,2,2,0,2,2,1,1,1,1,4
5114,785541,6,1,3,0,1,1,2,0,0,0,0,0,1,0,1,0,3
5114,796791,17,4,8,2,4,2,4,0,0,1,3,0,2,0,2,0,10
5115,792265,36,3,7,1,4,2,3,0,0,1,5,4,3,0,1,2,8
5115,792266,18,2,6,1,2,1,4,2,2,1,3,3,1,1,2,0,7
5115,786152,34,5,10,5,9,0,1,6,8,4,8,0,4,0,1,0,16
5115,798009,31,7,16,3,7,4,9,3,3,1,2,5,3,1,3,0,21
5115,798006,24,5,8,3,3,2,5,2,2,3,2,4,2,0,0,0,14
5115,798007,7,0,2,0,2,0,0,0,0,0,0,0,1,0,1,0,0
5115,798002,0,0,0,0,0,0,0,0,0,0,0,0,0,0,0,0,0
5115,798005,2,0,0,0,0,0,0,0,0,0,0,0,1,0,0,0,0
5115,798003,23,2,8,1,6,1,2,2,4,1,3,2,2,2,1,0,7
5115,792267,25,3,8,1,2,2,6,0,0,1,1,1,5,0,3,1,8
5116,791882,22,4,8,4,7,0,1,1,1,0,7,1,0,0,4,0,9
5116,786493,35,6,12,4,7,2,5,2,4,4,6,1,4,1,1,0,16
5116,786491,32,2,3,2,3,0,0,3,4,0,5,3,3,2,4,2,7
5116,791881,30,0,6,0,2,0,4,2,2,2,1,0,4,0,3,0,2
5116,786420,23,7,10,7,9,0,1,3,6,0,6,4,2,2,1,0,17
5116,797618,3,0,0,0,0,0,0,0,0,0,0,0,1,0,0,0,0
5116,797616,25,5,6,3,4,2,2,0,2,3,2,1,2,1,4,3,12
5116,797613,2,0,0,0,0,0,0,0,0,0,0,0,0,0,0,0,0
5116,781258,3,0,0,0,0,0,0,0,1,0,1,0,0,0,0,0,0
5116,781052,25,2,4,0,0,2,4,0,0,0,1,0,2,0,1,0,6
5117,797233,16,2,4,2,4,0,0,0,0,0,2,2,3,0,1,1,4
5117,791368,25,0,4,0,3,0,1,0,2,2,3,2,3,1,2,0,0
5117,797232,33,4,16,3,11,1,5,0,0,2,4,2,3,0,1,1,9
5117,797237,31,4,8,2,3,2,5,1,2,1,0,2,2,1,1,0,11
5117,797239,34,5,12,2,5,3,7,1,2,0,0,3,2,0,4,0,14
5117,797235,19,2,5,2,5,0,0,2,3,1,3,0,1,0,1,0,6
5117,797238,3,0,0,0,0,0,0,0,0,0,0,0,1,0,0,0,0
5117,786535,15,3,4,2,3,1,1,1,2,2,4,0,2,0,1,0,8
5117,785446,9,1,3,1,2,0,1,0,0,0,2,1,0,1,0,0,2
5117,791367,9,0,2,0,2,0,0,0,0,0,0,1,0,1,0,0,0
5117,797234,6,0,1,0,1,0,0,0,0,1,0,0,3,0,0,0,0
5118,792334,30,3,10,3,8,0,2,2,2,1,7,2,2,2,4,1,8
5118,786575,30,10,13,10,13,0,0,4,4,2,8,0,2,1,0,3,24
5118,798094,23,0,3,0,0,0,3,0,0,0,0,4,3,0,4,0,0
5118,792338,32,5,12,5,9,0,3,0,1,2,1,0,4,3,0,0,10
5118,781666,33,9,14,6,7,3,7,5,7,0,3,3,1,0,0,0,26
5118,798097,10,1,4,1,4,0,0,1,1,2,2,0,3,0,0,0,3
5118,785531,6,0,0,0,0,0,0,0,0,1,0,1,0,0,0,0,0
5118,798095,9,0,1,0,0,0,1,4,4,0,1,0,1,0,0,0,4
5118,799842,17,2,6,2,5,0,1,0,0,2,2,0,1,0,0,0,4
5118,791636,10,1,4,1,2,0,2,0,0,1,0,1,2,0,0,0,2
5119,796566,28,6,12,6,12,0,0,1,2,4,6,0,4,1,0,0,13
5119,790971,20,0,1,0,1,0,0,0,0,3,1,0,2,0,3,0,0
5119,790969,30,1,7,1,6,0,1,7,8,0,4,4,1,2,0,0,9
5119,780166,29,4,12,3,9,1,3,6,6,0,0,4,4,1,3,0,15
5119,775107,18,1,4,0,1,1,3,4,4,0,1,1,4,0,2,0,7
5119,796568,13,1,2,1,2,0,0,2,2,0,5,0,1,0,0,0,4
5119,781380,13,0,0,0,0,0,0,0,0,0,0,0,1,0,0,0,0
5119,796569,14,2,5,2,4,0,1,0,0,0,1,0,1,0,0,0,4
5119,796563,11,2,4,2,4,0,0,1,2,0,0,0,1,2,1,0,5
5119,790968,4,0,1,0,0,0,1,0,0,0,1,0,0,0,0,0,0
5119,790967,20,2,7,0,1,2,6,5,7,0,3,0,0,0,1,0,11
5120,797529,34,3,6,3,6,0,0,0,2,1,2,0,5,0,1,3,6
5120,797527,26,2,3,1,2,1,1,3,3,3,4,3,3,2,1,0,8
5120,791936,36,7,11,7,11,0,0,4,7,2,3,2,2,0,3,0,18
5120,797532,40,5,11,2,6,3,5,5,7,0,11,14,1,2,6,0,18
5120,785688,28,2,11,0,0,2,11,0,0,0,2,1,0,0,2,0,6
5120,797528,2,0,0,0,0,0,0,0,0,0,0,0,0,0,0,0,0
5120,791932,10,0,2,0,0,0,2,2,2,0,1,3,1,0,0,0,2
5120,791933,2,0,0,0,0,0,0,0,0,0,0,0,0,0,0,0,0
5120,785988,22,9,10,0,1,9,9,1,2,0,3,1,2,0,1,0,28
5121,786795,12,1,2,1,1,0,1,0,0,0,1,2,1,0,2,0,2
5121,792414,16,1,6,1,5,0,1,4,4,3,4,3,5,0,3,0,6
5121,789020,40,5,12,0,1,5,11,0,1,0,2,4,4,2,1,0,15
5121,786787,40,10,21,4,7,6,14,4,4,1,1,6,3,2,2,0,30
5121,774954,23,3,7,3,7,0,0,1,1,2,5,2,2,0,1,0,7
5121,786792,23,0,0,0,0,0,0,0,0,1,4,1,4,2,0,0,0
5121,781497,9,1,4,1,4,0,0,4,4,1,0,0,1,0,0,1,6
5121,792091,10,0,3,0,1,0,2,0,0,0,3,1,1,1,0,1,0
5121,781456,27,6,10,5,7,1,3,2,2,3,0,1,2,0,0,1,15
5121,774815,0,0,0,0,0,0,0,0,0,0,0,0,0,0,0,0,0
5122,776253,33,3,14,1,8,2,6,0,0,0,4,3,1,2,2,1,8
5122,775651,26,5,10,5,8,0,2,0,1,1,2,3,1,0,3,0,10
5122,791070,22,2,3,2,2,0,1,0,2,0,3,1,1,2,1,0,4
5122,791627,39,5,12,3,8,2,4,0,0,2,2,2,1,0,3,0,12
5122,785665,35,8,15,3,4,5,11,0,0,0,5,1,1,2,2,0,21
5122,796505,3,0,0,0,0,0,0,0,0,0,0,0,0,0,0,0,0
5122,791071,10,0,0,0,0,0,0,0,0,0,1,1,1,0,0,2,0
5122,785660,6,2,5,2,5,0,0,0,0,3,0,0,1,2,0,0,4
5122,796504,1,0,0,0,0,0,0,0,0,0,1,0,0,0,0,0,0
5122,796502,6,0,1,0,1,0,0,0,0,1,2,0,0,0,0,0,0
5122,796501,15,1,5,0,2,1,3,0,0,3,2,1,1,0,3,0,3
5122,776178,29,1,2,0,1,1,1,1,2,0,9,1,2,0,2,0,4
5123,780824,19,1,3,1,3,0,0,0,0,3,1,0,2,1,2,0,2
5123,791117,40,3,9,2,4,1,5,0,2,0,9,0,2,2,1,1,7
5123,791118,42,8,23,4,14,4,9,2,3,0,4,0,2,1,6,0,22
5123,785676,43,3,7,2,4,1,3,0,0,2,9,1,2,0,3,1,7
5123,774974,42,5,12,5,10,0,2,3,3,1,2,3,0,3,1,1,13
5123,796771,6,0,1,0,0,0,1,0,0,0,0,3,0,0,0,0,0
5123,791115,19,0,0,0,0,0,0,0,0,1,2,0,4,0,3,1,0
5123,800022,2,0,0,0,0,0,0,0,0,0,0,0,0,0,0,0,0
5123,796768,8,0,1,0,0,0,1,0,0,0,0,0,0,0,1,0,0
5123,794654,1,0,0,0,0,0,0,0,0,0,0,0,0,0,0,0,0
5123,785947,3,1,3,1,3,0,0,0,0,1,0,0,1,0,0,0,2
5124,791787,35,5,10,2,6,3,4,3,4,2,12,2,5,1,3,1,16
5124,789048,22,2,5,2,5,0,0,3,6,3,7,1,4,0,2,1,7
5124,789046,35,4,7,2,2,2,5,3,4,2,2,4,5,0,3,0,13
5124,797630,32,1,6,1,3,0,3,0,1,1,1,2,3,1,1,0,2
5124,789041,35,6,13,2,3,4,10,0,3,0,3,1,4,0,2,0,16
5124,791785,16,1,3,0,1,1,2,2,2,0,0,0,2,0,0,1,5
5124,785540,30,4,9,4,9,0,0,11,12,4,2,0,1,0,6,1,19
5124,797631,4,0,0,0,0,0,0,1,2,0,0,1,1,0,0,0,1
5124,797629,8,0,0,0,0,0,0,0,0,0,3,1,1,0,1,0,0
5124,789044,8,1,2,0,1,1,1,0,0,0,0,0,1,0,0,0,3
5125,786080,26,2,9,2,3,0,6,0,0,1,2,2,5,0,1,0,4
5125,786216,33,5,10,5,10,0,0,3,7,1,2,0,3,0,2,1,13
5125,791348,39,3,6,2,4,1,2,8,11,3,4,2,4,1,2,0,15
5125,786218,43,10,18,8,13,2,5,3,8,4,9,3,3,2,3,0,25
5125,780663,26,5,11,1,5,4,6,1,2,0,3,2,3,0,1,0,15
5125,797258,3,0,1,0,1,0,0,0,0,1,0,0,2,0,1,0,0
5125,791350,32,3,9,2,5,1,4,0,0,0,3,1,5,2,0,0,7
5125,781645,17,1,1,1,1,0,0,0,0,0,1,0,3,0,1,0,2
5125,780150,6,0,0,0,0,0,0,0,0,0,0,0,1,0,0,0,0
5126,796617,16,1,3,1,3,0,0,0,0,0,1,1,3,1,1,1,2
5126,775131,33,5,12,2,6,3,6,1,2,0,2,1,3,0,3,4,14
5126,796616,31,5,9,1,2,4,7,2,2,1,5,2,2,0,0,0,16
5126,796612,32,3,7,3,7,0,0,2,2,2,6,1,3,0,2,0,8
5126,785562,32,5,10,5,7,0,3,3,5,2,5,4,0,1,0,0,13
5126,792429,5,1,2,1,1,0,1,0,0,0,0,0,0,1,0,0,2
5126,796614,6,2,2,2,2,0,0,0,0,0,0,0,1,0,0,0,4
5126,796607,17,3,5,3,5,0,0,0,0,1,2,0,0,0,1,0,6
5126,796606,28,0,2,0,2,0,0,2,2,1,2,2,1,0,1,0,2
5127,792167,21,2,4,2,4,0,0,1,1,2,2,0,2,1,2,2,5
5127,797767,30,2,3,1,2,1,1,4,4,0,2,4,3,0,0,0,9
5127,791372,23,2,7,1,2,1,5,0,0,1,1,1,4,0,0,0,5
5127,792164,34,4,15,3,8,1,7,1,2,0,2,1,1,1,3,0,10
5127,780974,35,6,14,2,8,4,6,1,2,2,5,3,1,1,1,0,17
5127,797766,13,3,6,3,5,0,1,0,1,2,3,0,1,0,1,0,6
5127,797772,15,2,3,2,2,0,1,0,0,1,2,1,1,0,1,0,4
5127,792163,20,2,3,2,2,0,1,0,0,0,2,0,3,0,0,1,4
5127,797764,9,1,2,1,1,0,1,0,0,1,1,1,0,0,0,0,2
5128,797895,8,1,3,0,2,1,1,0,0,3,2,0,2,0,2,0,3
5128,789058,26,2,6,1,2,1,4,1,2,1,8,0,1,1,1,1,6
5128,797898,34,5,21,3,12,2,9,2,2,2,0,5,1,7,2,0,14
5128,792240,17,2,6,0,1,2,5,0,0,0,1,1,1,1,2,0,6
5128,792237,22,3,9,1,3,2,6,0,0,0,0,1,0,0,1,0,8
5128,792238,8,0,0,0,0,0,0,0,0,1,1,0,0,0,0,1,0
5128,787239,30,0,0,0,0,0,0,2,2,4,10,1,2,0,0,2,2
5128,785818,10,0,1,0,0,0,1,0,0,0,1,0,5,0,2,1,0
5128,785286,17,2,7,0,4,2,3,4,6,0,2,1,1,0,6,0,10
5128,797897,4,0,1,0,0,0,1,0,0,0,0,1,1,0,0,0,0
5128,792236,19,3,8,3,7,0,1,4,5,1,3,1,2,0,1,0,10
5128,792359,4,0,1,0,0,0,1,0,0,0,0,1,0,0,0,0,0
5128,785986,1,0,1,0,0,0,1,0,0,0,0,0,0,0,0,0,0
5129,791493,36,4,10,4,10,0,0,4,8,3,11,0,3,0,1,5,12
5129,789036,28,6,9,5,7,1,2,1,2,1,7,1,4,1,1,1,14
5129,797191,16,2,4,2,3,0,1,0,0,1,1,2,1,3,1,0,4
5129,791495,18,1,2,0,0,1,2,0,0,0,2,0,0,2,0,1,3
5129,776494,21,0,7,0,3,0,4,0,0,1,1,4,0,0,3,0,0
5129,781307,16,3,5,3,5,0,0,0,0,2,2,0,2,0,0,0,6
5129,791492,22,5,11,2,2,3,9,1,2,0,3,3,1,2,1,0,14
5129,786324,25,4,10,1,3,3,7,0,0,1,2,5,2,5,7,0,11
5129,778888,18,0,2,0,0,0,2,2,3,0,2,1,0,0,1,0,2
5130,791728,15,1,6,1,6,0,0,4,6,1,4,0,2,1,0,1,6
5130,791726,34,7,12,3,4,4,8,3,3,0,1,2,1,2,3,0,21
5130,786273,32,1,6,0,2,1,4,5,7,2,2,7,1,1,0,0,8
5130,780773,36,7,13,3,7,4,6,0,0,1,8,1,1,0,1,0,18
5130,775228,35,1,8,0,2,1,6,2,3,1,1,0,4,1,0,0,5
5130,797313,16,0,1,0,0,0,1,0,0,0,2,0,4,2,3,0,0
5130,786569,18,2,5,2,5,0,0,0,0,0,3,0,2,0,0,0,4
5130,780274,4,0,0,0,0,0,0,0,0,0,1,0,2,0,1,1,0
5130,797317,10,0,2,0,1,0,1,0,0,1,0,0,3,0,3,1,0
5131,792131,27,5,8,4,7,1,1,2,2,3,2,1,0,1,2,1,13
5131,786838,30,6,11,6,11,0,0,4,6,0,7,0,3,0,1,6,16
5131,797736,19,0,2,0,1,0,1,0,0,1,1,0,2,0,1,0,0
5131,792132,25,3,8,1,5,2,3,3,4,0,4,2,3,0,6,0,11
5131,792127,33,3,9,1,5,2,4,3,3,1,4,1,4,2,2,0,11
5131,799273,1,0,0,0,0,0,0,0,0,0,1,0,1,0,0,0,0
5131,792128,21,0,4,0,3,0,1,3,6,2,2,0,3,0,1,0,3
5131,799908,21,1,2,1,2,0,0,0,0,1,1,0,1,0,0,0,2
5131,797739,18,4,7,2,5,2,2,2,2,2,2,0,0,1,1,0,12
5131,791668,5,0,1,0,1,0,0,0,0,0,3,0,0,0,0,0,0
5132,780913,28,9,12,6,9,3,3,0,0,2,5,5,3,0,2,0,21
5132,798119,26,3,6,2,3,1,3,0,0,0,3,1,0,0,2,0,7
5132,798117,33,1,1,1,1,0,0,0,0,0,2,10,4,4,6,0,2
5132,780594,30,10,13,3,3,7,10,2,4,0,3,3,3,1,5,0,29
5132,775664,31,1,5,1,2,0,3,1,1,0,7,4,0,0,0,0,3
5132,798127,2,0,0,0,0,0,0,0,0,0,0,0,0,0,1,0,0
5132,798123,19,5,8,5,6,0,2,3,3,0,2,1,1,2,1,2,13
5132,769332,1,0,0,0,0,0,0,0,0,0,0,1,0,0,0,0,0
5132,786398,1,0,0,0,0,0,0,0,0,0,0,0,1,0,0,0,0
5132,798126,1,1,1,1,1,0,0,0,0,0,0,0,1,0,1,0,2
5132,798124,24,6,7,6,7,0,0,0,0,0,4,2,3,1,3,0,12
5132,798121,3,0,0,0,0,0,0,0,0,0,0,1,1,0,0,0,0
5132,798120,1,0,0,0,0,0,0,0,0,0,0,0,0,0,0,0,0
5133,792299,17,2,4,2,2,0,2,0,0,2,2,2,2,0,1,0,4
5133,792304,30,5,12,2,8,3,4,0,1,1,1,0,0,3,1,0,13
5133,792301,30,4,14,4,13,0,1,3,3,0,2,2,0,1,2,0,11
5133,786278,24,3,8,3,6,0,2,1,2,0,3,2,2,1,1,0,7
5133,786275,29,5,14,4,11,1,3,6,8,4,0,4,1,0,1,0,17
5133,792302,3,0,1,0,1,0,0,0,0,1,1,0,0,0,1,0,0
5133,786181,24,4,7,4,7,0,0,1,2,3,5,0,2,0,2,0,9
5133,798093,1,0,0,0,0,0,0,4,4,0,0,0,0,0,0,0,4
5133,792295,8,1,2,1,2,0,0,0,0,1,0,1,2,2,2,0,2
5133,786286,21,0,3,0,0,0,3,0,0,0,2,0,1,0,2,0,0
5133,786280,13,1,1,1,1,0,0,0,2,0,1,0,2,1,1,0,2
5134,786296,26,4,8,2,3,2,5,4,4,0,2,0,2,3,2,0,14
5134,781530,27,5,11,5,10,0,1,5,5,2,4,3,0,3,0,0,15
5134,776423,22,4,7,4,7,0,0,4,4,4,4,1,2,0,4,2,12
5134,792307,32,3,5,2,3,1,2,1,2,1,4,2,2,1,1,0,8
5134,792319,27,0,3,0,0,0,3,0,0,1,1,2,2,2,1,1,0
5134,792316,5,0,0,0,0,0,0,0,0,0,0,0,1,0,0,0,0
5134,792314,14,1,6,1,6,0,0,3,6,1,2,0,4,1,1,0,5
5134,792320,12,1,2,1,2,0,0,2,2,3,4,0,1,0,1,0,4
5134,792309,18,2,7,1,4,1,3,1,2,0,0,1,1,3,1,0,6
5134,792321,17,2,5,2,4,0,1,0,2,1,4,0,1,0,0,0,4
5135,791042,20,4,11,3,7,1,4,0,2,2,3,0,2,0,2,0,9
5135,774834,15,0,1,0,1,0,0,0,0,1,0,1,4,2,3,0,0
5135,791043,26,2,10,2,9,0,1,2,3,0,3,3,3,1,1,0,6
5135,776374,27,3,4,1,2,2,2,0,0,0,0,0,0,0,1,0,8
5135,775412,26,2,3,0,0,2,3,1,1,0,1,1,4,0,1,0,7
5135,796723,9,0,1,0,1,0,0,0,0,0,1,1,0,1,1,0,0
5135,796719,15,2,4,1,1,1,3,0,0,1,5,0,2,0,4,0,5
5135,785512,27,2,5,2,5,0,0,1,4,0,1,0,2,0,1,3,5
5135,796718,9,0,2,0,1,0,1,0,0,0,1,0,1,0,2,0,0
5135,796717,11,1,2,0,1,1,1,0,0,0,3,0,2,0,2,0,3
5135,796720,15,2,5,2,3,0,2,2,2,0,2,0,1,1,2,0,6
5136,797779,38,7,17,4,9,3,8,4,6,0,2,0,4,0,0,1,21
5136,785568,35,2,4,2,4,0,0,2,2,5,5,1,1,0,1,1,6
5136,797769,37,1,9,1,7,0,2,0,0,0,9,4,3,1,1,1,2
5136,786256,39,6,10,6,9,0,1,7,8,1,2,2,2,0,3,0,19
5136,775106,20,0,5,0,3,0,2,0,0,0,1,2,2,0,1,0,0
5136,797770,19,3,7,2,4,1,3,2,2,0,3,0,3,0,0,2,9
5136,797778,7,1,3,0,0,1,3,0,0,0,3,0,0,0,0,0,3
5136,797774,0,0,0,0,0,0,0,0,0,0,0,0,1,0,0,0,0
5136,797768,5,0,4,0,3,0,1,0,0,0,0,0,0,0,0,0,0
5137,792029,27,7,12,6,7,1,5,0,0,0,4,2,5,0,2,0,15
5137,761149,31,5,8,4,7,1,1,3,3,1,6,0,1,0,0,0,14
5137,792032,35,3,13,2,9,1,4,6,6,0,3,4,4,2,1,1,13
5137,792031,17,2,2,1,1,1,1,0,0,0,0,1,4,0,1,1,5
5137,780828,19,2,10,2,7,0,3,0,0,1,4,1,3,0,3,0,4
5137,797641,15,0,1,0,1,0,0,1,3,0,3,1,0,0,1,2,1
5137,797640,25,2,3,2,2,0,1,1,1,1,7,1,0,1,0,0,5
5137,797637,22,1,3,0,1,1,2,2,2,0,2,0,0,0,0,0,5
5137,792030,9,1,1,0,0,1,1,0,0,0,1,1,3,0,0,0,3
5138,780229,31,7,8,7,8,0,0,0,2,1,8,1,3,1,3,1,14
5138,795572,35,8,14,7,11,1,3,5,6,3,5,2,3,0,4,1,22
5138,791483,35,2,7,1,5,1,2,2,2,1,0,6,4,0,3,2,7
5138,786322,30,2,8,0,3,2,5,0,1,2,7,0,4,0,0,0,6
5138,780228,30,1,8,1,3,0,5,1,1,0,1,3,1,1,0,0,3
5138,791487,3,0,2,0,1,0,1,0,0,0,1,0,0,0,0,0,0
5138,781592,20,4,10,2,7,2,3,5,5,1,3,1,2,0,1,0,15
5138,791488,5,1,2,1,2,0,0,0,0,1,1,0,1,0,0,0,2
5138,791485,4,0,2,0,1,0,1,0,0,0,0,0,1,0,0,0,0
5138,797193,7,0,0,0,0,0,0,0,0,0,0,0,0,0,0,0,0
5139,791083,21,4,8,2,2,2,6,1,2,0,0,0,3,0,0,2,11
5139,785294,16,1,3,1,2,0,1,0,1,1,1,1,2,0,2,0,2
5139,791085,27,2,9,2,8,0,1,4,4,1,2,1,3,1,1,0,8
5139,791080,33,8,10,6,7,2,3,4,6,2,7,0,0,1,4,1,22
5139,785675,34,4,11,0,3,4,8,2,2,0,2,1,1,2,1,0,14
5139,796511,24,3,8,1,2,2,6,0,0,3,9,1,4,1,2,2,8
5139,791081,17,2,3,2,3,0,0,0,1,4,3,0,4,0,0,2,4
5139,796515,9,1,6,1,1,0,5,0,0,0,0,1,1,0,0,0,2
5139,786446,19,2,3,1,1,1,2,3,4,1,2,7,0,0,0,0,8
5140,797620,26,1,5,1,4,0,1,0,0,1,3,1,1,1,0,2,2
5140,781044,32,5,11,5,9,0,2,11,12,2,8,1,2,0,3,0,21
5140,786489,34,4,9,2,4,2,5,6,6,0,1,0,4,1,1,0,16
5140,786488,36,5,10,4,8,1,2,2,3,0,4,1,0,2,3,0,13
5140,781038,36,4,9,2,5,2,4,0,0,3,6,2,0,0,1,0,10
5140,786490,8,1,3,1,3,0,0,0,0,2,0,0,0,0,0,0,2
5140,797619,17,1,2,1,2,0,0,4,5,2,0,1,1,0,1,0,6
5140,786487,11,0,3,0,1,0,2,0,0,1,1,0,2,0,0,0,0
5141,796860,34,3,11,3,11,0,0,3,4,2,5,0,0,0,0,0,9
5141,791183,21,0,1,0,1,0,0,1,2,0,2,4,4,1,0,0,1
5141,791185,36,7,15,5,7,2,8,0,0,2,6,2,1,1,2,1,16
5141,796861,22,4,6,2,2,2,4,0,0,0,1,1,5,0,2,0,10
5141,785650,33,4,10,1,5,3,5,0,0,0,2,1,3,0,2,0,11
5141,775208,15,2,3,2,3,0,0,0,0,0,1,0,3,0,1,0,4
5141,796857,12,0,1,0,0,0,1,0,0,0,2,0,1,0,0,0,0
5141,791184,27,3,5,3,4,0,1,1,2,0,1,3,4,0,1,0,7
5142,792473,19,3,4,2,2,1,2,2,3,0,1,0,5,1,5,1,9
5142,780043,12,0,0,0,0,0,0,0,0,0,0,0,5,0,1,0,0
5142,799276,29,1,5,0,1,1,4,3,4,0,3,2,2,2,4,0,6
5142,785249,36,6,10,3,6,3,4,2,4,1,2,2,0,1,4,0,17
5142,780035,32,1,4,0,0,1,4,0,0,0,3,3,2,4,4,0,3
5142,792471,11,2,3,2,3,0,0,0,0,0,1,1,0,0,0,0,4
5142,799281,9,1,2,1,2,0,0,0,0,1,0,3,0,0,1,0,2
5142,792477,22,3,4,1,1,2,3,0,1,0,1,0,1,0,1,0,8
5142,780036,30,5,8,4,4,1,4,1,1,0,2,2,4,1,3,0,12
5143,786157,16,5,6,5,6,0,0,3,5,3,4,0,4,1,3,0,13
5143,791756,22,0,2,0,1,0,1,0,0,2,3,6,0,2,1,0,0
5143,797348,25,2,6,1,4,1,2,2,2,2,2,5,4,3,6,0,7
5143,780992,27,1,8,0,2,1,6,0,0,0,0,4,2,4,1,0,3
5143,780677,25,7,13,4,7,3,6,1,2,2,0,1,0,1,0,0,18
5143,797350,9,1,1,0,0,1,1,0,0,0,2,0,0,0,2,0,3
5143,791730,3,1,1,1,1,0,0,1,1,0,0,0,0,0,0,0,3
5143,791754,19,3,5,3,4,0,1,0,2,2,4,2,2,0,1,0,6
5143,786150,10,5,5,5,5,0,0,4,6,2,0,0,1,3,0,1,14
5143,775533,9,1,3,1,3,0,0,2,4,3,2,1,5,0,1,0,4
5143,791753,3,0,0,0,0,0,0,0,0,0,0,1,0,1,1,0,0
5143,797349,13,5,9,2,3,3,6,0,0,1,0,2,0,0,0,0,13
5143,780673,19,5,7,1,1,4,6,0,2,0,0,5,0,0,0,0,14
5144,780095,32,2,3,2,3,0,0,0,0,0,0,2,2,0,1,1,4
5144,776321,37,12,21,10,16,2,5,2,3,0,4,1,3,0,1,2,28
5144,786081,35,4,7,2,3,2,4,3,6,3,2,6,4,1,1,0,13
5144,785431,36,2,6,1,1,1,5,0,0,1,6,6,4,2,2,0,5
5144,780232,34,7,17,4,8,3,9,7,9,1,11,4,3,2,3,1,24
5144,785356,11,2,3,0,0,2,3,1,1,0,2,0,3,0,0,0,7
5144,789040,15,0,2,0,2,0,0,1,2,0,2,1,3,1,0,0,1
5145,791524,28,3,11,1,4,2,7,2,2,1,5,2,4,1,2,2,10
5145,797139,26,8,14,8,14,0,0,4,5,6,7,0,3,1,2,0,20
5145,775394,33,3,6,1,1,2,5,7,10,4,3,1,4,0,1,0,15
5145,791526,29,2,11,2,9,0,2,5,7,1,3,1,2,0,2,0,9
5145,780272,34,1,10,0,5,1,5,8,10,1,5,3,1,0,2,0,11
5145,786354,3,0,0,0,0,0,0,0,0,0,0,0,1,0,0,0,0
5145,785970,10,0,4,0,4,0,0,0,0,2,0,0,0,0,0,1,0
5145,791523,19,3,6,0,1,3,5,0,0,1,4,0,0,0,1,0,9
5145,780273,18,0,1,0,1,0,0,0,0,1,3,0,2,1,0,0,0
5145,797141,0,0,0,0,0,0,0,0,0,0,0,0,0,0,0,0,0
5168,797972,30,5,8,3,4,2,4,2,2,0,3,4,4,0,1,1,14
5168,797967,36,3,9,3,6,0,3,1,2,0,6,3,4,1,3,0,7
5168,797970,26,5,8,4,6,1,2,5,5,1,4,1,5,1,3,0,16
5168,781453,38,12,22,7,10,5,12,2,2,2,1,5,2,4,0,1,31
5168,774869,36,3,5,3,3,0,2,0,0,1,1,0,3,1,0,1,6
5168,792254,16,1,2,1,2,0,0,0,0,1,3,1,0,0,1,0,2
5168,797962,2,0,0,0,0,0,0,0,0,0,0,0,0,0,1,0,0
5168,786098,16,0,5,0,2,0,3,0,0,0,3,0,3,0,2,0,0
5169,781558,32,5,7,5,7,0,0,6,6,5,2,1,3,1,2,0,16
5169,780993,22,2,5,2,5,0,0,0,2,1,6,0,2,0,0,0,4
5169,775248,29,6,17,5,12,1,5,4,7,3,9,4,3,1,7,1,17
5169,791452,37,1,5,0,1,1,4,0,0,1,3,4,1,4,1,0,3
5169,797224,34,6,14,2,5,4,9,3,3,0,3,1,3,2,2,0,19
5169,791446,3,0,0,0,0,0,0,0,0,0,0,0,1,0,0,0,0
5169,797231,2,1,1,0,0,1,1,0,0,0,1,0,2,0,0,0,3
5169,797225,25,3,5,3,4,0,1,3,3,2,0,2,2,0,1,1,9
5169,791449,16,1,7,1,4,0,3,1,2,1,1,1,1,0,0,0,3
5170,797591,11,1,1,1,1,0,0,0,0,0,4,0,2,0,2,0,2
5170,781071,25,2,5,1,2,1,3,2,2,0,2,1,0,0,1,0,7
5170,791889,29,1,2,0,1,1,1,0,0,0,3,4,2,1,4,0,3
5170,791890,36,4,12,2,6,2,6,2,2,0,3,5,2,5,2,0,12
5170,780719,37,5,11,2,5,3,6,2,2,1,10,4,2,3,2,1,15
5170,785424,20,5,6,5,6,0,0,0,0,4,6,1,2,0,1,1,10
5170,780098,3,0,1,0,1,0,0,0,0,0,0,0,2,0,3,0,0
5170,797589,28,9,16,7,8,2,8,3,3,1,4,1,1,1,2,1,23
5170,797588,7,0,1,0,1,0,0,0,1,0,1,0,0,0,0,0,0
5170,791888,4,0,0,0,0,0,0,0,0,0,0,0,0,0,2,0,0
5171,797241,24,2,5,1,4,1,1,0,0,1,4,1,2,2,0,0,5
5171,791366,25,3,4,1,1,2,3,1,2,0,2,1,1,1,2,1,9
5171,797244,22,1,5,1,5,0,0,1,2,2,2,1,1,0,2,0,3
5171,785742,18,1,10,0,6,1,4,0,0,0,1,1,2,1,3,0,3
5171,780163,33,6,15,5,11,1,4,1,2,1,5,2,1,0,0,0,14
5171,791361,15,2,5,1,3,1,2,0,0,1,5,0,0,0,1,0,5
5171,780170,15,2,6,2,5,0,1,0,2,1,0,2,2,1,2,0,4
5171,797243,11,1,3,1,2,0,1,1,2,1,0,0,1,0,1,0,3
5171,791363,11,0,1,0,0,0,1,0,0,0,0,2,1,0,3,0,0
5171,786340,24,6,9,5,6,1,3,1,3,0,1,1,2,0,0,1,14
5171,797242,2,1,2,0,0,1,2,0,0,0,0,0,0,1,0,0,3
5172,790957,27,2,10,2,8,0,2,1,1,1,4,0,4,1,0,1,5
5172,785275,30,5,9,5,9,0,0,3,5,2,2,1,0,3,0,1,13
5172,790956,18,1,3,1,2,0,1,4,4,0,2,1,2,0,2,0,6
5172,785089,32,3,8,2,6,1,2,1,2,0,3,2,2,0,4,1,8
5172,780460,37,6,11,2,3,4,8,7,8,2,2,1,1,1,3,0,23
5172,796550,29,4,8,2,4,2,4,0,0,0,7,1,2,1,1,2,10
5172,796549,10,2,4,2,4,0,0,0,0,1,3,0,2,1,1,1,4
5172,796551,10,1,4,1,3,0,1,0,0,1,1,1,2,1,0,0,2
5172,796547,7,0,1,0,1,0,0,0,0,0,0,0,2,0,0,0,0
5173,791548,30,10,17,9,14,1,3,4,5,2,8,3,2,2,3,2,25
5173,791550,23,3,8,3,8,0,0,2,2,2,4,4,4,1,3,0,8
5173,797080,22,2,3,2,2,0,1,0,0,0,1,0,2,0,4,0,4
5173,786365,34,1,8,0,3,1,5,0,0,1,1,1,1,2,2,0,3
5173,786364,35,4,12,3,9,1,3,4,5,3,7,4,3,0,2,0,13
5173,797082,9,1,1,1,1,0,0,0,0,0,4,0,1,0,1,0,2
5173,786366,8,0,1,0,1,0,0,1,2,0,2,0,2,1,0,0,1
5173,780332,12,1,4,1,3,0,1,2,2,0,1,0,2,1,1,1,4
5173,780330,27,4,5,4,5,0,0,2,3,1,1,0,0,1,1,0,10
5174,785930,28,6,7,6,7,0,0,3,6,3,5,0,2,0,2,0,15
5174,780996,10,0,2,0,2,0,0,0,0,0,0,1,0,0,1,0,0
5174,780995,30,2,5,1,1,1,4,0,0,1,3,3,3,1,0,0,5
5174,796468,34,3,8,3,5,0,3,1,2,3,1,6,2,1,1,0,7
5174,790920,28,1,10,1,8,0,2,3,5,0,4,1,1,1,3,0,5
5174,775709,23,1,4,1,2,0,2,0,0,0,2,1,0,0,1,0,2
5174,791035,33,4,15,1,7,3,8,3,5,0,6,2,3,0,2,0,14
5174,785461,7,0,1,0,1,0,0,0,0,1,2,0,3,0,1,1,0
5174,796467,2,1,1,0,0,1,1,0,0,0,0,0,0,0,0,0,3
5174,796466,3,0,0,0,0,0,0,0,0,0,0,0,0,0,0,0,0
5174,785492,2,0,0,0,0,0,0,0,0,0,0,0,0,0,0,0,0
5175,776286,29,5,7,4,4,1,3,3,4,4,6,0,4,0,2,0,14
5175,775557,25,1,5,1,5,0,0,0,0,0,2,1,3,1,1,2,2
5175,791445,32,6,9,3,6,3,3,0,0,0,2,3,3,1,2,0,15
5175,785357,37,6,13,3,6,3,7,0,0,1,8,3,3,0,2,0,15
5175,775560,30,4,12,3,8,1,4,0,0,0,6,6,3,2,1,1,9
5175,785287,12,1,2,1,2,0,0,4,4,1,0,1,1,0,2,1,6
5175,791444,11,0,0,0,0,0,0,0,0,0,1,0,0,1,1,0,0
5175,797010,17,2,4,1,2,1,2,0,0,0,2,2,1,1,0,0,5
5175,797011,2,0,1,0,1,0,0,0,0,0,0,0,0,0,0,0,0
5175,797012,2,1,2,1,1,0,1,0,0,0,0,0,0,0,1,0,2
5175,785895,3,0,0,0,0,0,0,0,0,1,0,0,0,0,0,0,0
5176,785714,18,2,5,2,5,0,0,4,6,1,1,1,5,0,2,1,8
5176,775894,31,3,7,3,5,0,2,7,8,1,4,1,2,0,3,0,13
5176,785711,38,5,10,4,5,1,5,4,5,1,1,2,2,2,0,0,15
5176,780985,36,3,7,1,1,2,6,0,1,0,4,3,3,0,1,0,8
5176,775266,35,8,14,5,7,3,7,1,3,0,3,1,1,1,0,0,20
5176,791167,11,0,1,0,1,0,0,0,0,0,2,0,1,0,2,0,0
5176,785378,9,0,0,0,0,0,0,0,2,0,2,0,1,1,1,1,0
5176,796829,22,3,3,3,3,0,0,4,7,0,4,0,2,0,0,0,10
5177,796812,20,5,9,5,9,0,0,3,4,3,2,0,5,1,5,0,13
5177,780952,37,4,13,2,9,2,4,0,0,2,7,2,3,0,2,3,10
5177,786609,33,4,7,3,5,1,2,2,2,3,2,1,5,0,1,0,11
5177,785752,27,2,9,0,4,2,5,0,0,4,5,2,4,0,1,0,6
5177,796810,38,4,10,4,7,0,3,6,7,1,3,5,2,1,2,0,14
5177,780945,10,2,5,2,5,0,0,2,2,3,1,1,4,1,1,0,6
5177,791156,18,2,6,0,1,2,5,0,0,0,2,2,0,0,0,0,6
5177,780950,17,0,4,0,0,0,4,0,0,0,1,0,3,0,0,1,0
5178,797912,14,1,3,1,1,0,2,2,3,0,0,0,0,1,1,0,4
5178,776424,22,2,4,2,3,0,1,0,1,1,1,0,4,0,2,0,4
5178,792300,28,2,6,2,4,0,2,2,2,1,4,1,2,1,2,1,6
5178,792303,29,6,14,6,12,0,2,3,4,1,2,5,1,1,4,0,15
5178,780456,30,6,10,3,4,3,6,1,1,0,4,0,3,1,3,0,16
5178,797914,23,1,5,0,1,1,4,0,0,0,1,1,2,2,3,0,3
5178,790813,16,1,3,1,3,0,0,1,3,0,0,3,0,1,0,1,3
5178,781603,20,5,8,3,3,2,5,2,3,1,4,1,1,2,0,0,14
5178,781605,18,2,5,2,5,0,0,2,2,4,3,0,2,0,1,0,6
5179,785536,18,2,3,1,1,1,2,0,0,0,3,1,0,0,1,1,5
5179,780119,26,5,8,5,8,0,0,2,3,5,2,2,2,1,1,1,12
5179,796559,35,10,16,9,12,1,4,5,5,3,5,2,2,0,2,1,26
5179,785280,23,3,6,3,4,0,2,1,2,0,3,4,4,1,1,0,7
5179,776097,37,9,15,6,10,3,5,4,7,2,3,8,2,4,1,1,25
5179,796560,9,0,0,0,0,0,0,0,0,0,1,1,0,1,1,0,0
5179,796558,14,3,3,3,3,0,0,0,1,0,2,1,2,1,2,1,6
5179,780149,21,2,10,1,6,1,4,0,0,0,5,2,2,0,1,0,5
5179,775679,17,2,2,0,0,2,2,0,1,1,2,1,1,1,1,0,6
5180,791356,38,3,5,3,5,0,0,0,3,2,8,1,2,3,0,0,6
5180,797431,16,1,5,1,3,0,2,0,0,0,1,0,4,1,1,0,2
5180,791680,34,4,11,2,6,2,5,3,4,1,3,0,3,1,1,2,13
5180,785812,37,5,11,3,4,2,7,2,2,0,1,2,2,1,1,0,14
5180,780104,38,7,13,7,12,0,1,6,8,1,5,6,3,0,1,0,20
5180,791682,5,0,1,0,1,0,0,0,1,1,0,0,0,0,0,2,0
5180,785815,32,10,14,8,11,2,3,0,0,0,4,1,1,0,1,0,22
5181,796850,37,5,8,4,6,1,2,0,0,1,7,1,2,0,1,3,11
5181,774969,32,8,13,8,13,0,0,7,7,5,14,0,3,1,2,0,23
5181,796848,11,0,1,0,0,0,1,1,2,0,1,0,2,0,0,0,1
5181,791181,19,0,4,0,2,0,2,2,2,1,1,2,3,0,3,0,2
5181,781054,37,6,10,5,7,1,3,1,1,1,1,4,4,0,7,0,14
5181,785670,2,0,0,0,0,0,0,0,0,0,0,0,1,0,0,0,0
5181,780981,6,0,1,0,0,0,1,0,0,1,1,1,1,0,0,0,0
5181,791179,26,4,6,3,4,1,2,1,2,0,0,1,1,0,0,0,10
5181,781053,30,3,13,2,7,1,6,2,2,1,2,2,3,1,4,0,9
5182,792197,23,1,4,1,2,0,2,0,2,0,4,1,4,1,1,0,2
5182,797517,28,7,7,7,7,0,0,4,5,0,8,0,3,1,3,1,18
5182,781132,25,4,6,2,3,2,3,1,2,1,5,3,4,1,4,0,11
5182,786534,38,3,16,3,11,0,5,5,6,3,7,11,3,3,2,0,11
5182,791940,29,5,10,4,7,1,3,6,6,3,1,0,2,0,0,1,17
5182,791938,14,1,3,0,1,1,2,0,0,1,0,1,1,0,0,1,3
5182,797518,24,5,10,4,5,1,5,8,10,4,1,2,3,1,2,0,19
5182,797519,3,0,1,0,1,0,0,0,0,0,0,0,0,0,0,0,0
5182,786539,7,0,2,0,0,0,2,0,1,1,1,0,0,0,0,0,0
5182,797522,9,1,4,1,4,0,0,2,3,3,1,1,0,0,0,0,4
5183,775087,17,1,5,1,5,0,0,2,2,1,2,1,2,0,1,0,4
5183,780214,6,1,4,1,3,0,1,0,0,2,0,0,2,0,0,0,2
5183,767245,26,3,8,3,8,0,0,3,3,0,2,1,2,1,3,0,9
5183,790984,33,4,8,1,2,3,6,0,0,0,1,1,3,2,3,1,11
5183,780212,33,6,15,1,6,5,9,4,4,0,4,5,1,0,4,0,21
5183,780406,10,1,4,1,2,0,2,0,1,0,2,1,5,1,0,0,2
5183,796596,11,1,2,0,1,1,1,0,0,0,1,4,2,0,1,0,3
5183,785296,24,3,6,2,3,1,3,0,0,0,2,2,2,0,4,0,7
5183,785297,18,3,5,1,1,2,4,2,2,2,3,2,3,1,0,0,10
5183,790985,9,1,2,1,2,0,0,1,2,2,2,2,1,0,0,0,3
5183,780215,13,1,2,1,2,0,0,3,5,2,3,0,4,0,0,1,5
5184,776462,32,2,6,2,4,0,2,3,3,3,7,0,3,1,1,1,7
5184,785635,22,2,6,1,3,1,3,1,2,1,1,0,5,0,1,3,6
5184,786440,30,0,6,0,2,0,4,1,2,0,1,3,2,1,2,0,1
5184,786720,22,0,4,0,0,0,4,1,2,1,2,1,1,0,1,0,1
5184,781199,40,8,14,5,8,3,6,6,12,0,7,0,3,3,4,0,25
5184,791628,11,0,1,0,0,0,1,0,0,0,1,0,0,0,0,1,0
5184,775642,13,0,2,0,2,0,0,0,0,1,2,1,3,0,1,0,0
5184,791629,7,0,2,0,2,0,0,0,0,0,0,0,1,0,0,0,0
5184,796974,23,2,5,1,2,1,3,4,4,0,1,3,3,0,1,1,9
5185,791585,36,3,7,0,1,3,6,6,8,3,8,2,1,0,0,0,15
5185,791581,19,0,2,0,0,0,2,5,5,1,2,1,3,1,1,3,5
5185,786395,39,8,14,5,8,3,6,2,4,1,3,0,2,3,2,1,21
5185,786394,36,3,8,3,5,0,3,2,4,1,9,4,4,1,3,0,8
5185,780404,32,2,6,2,4,0,2,0,4,0,5,2,5,0,3,1,4
5185,785228,24,2,5,0,1,2,4,1,2,0,2,2,2,0,1,0,7
5185,780062,12,1,3,1,3,0,0,1,2,0,0,1,3,0,1,0,3
5185,797041,2,0,0,0,0,0,0,0,0,0,0,0,0,0,0,0,0
5185,780403,0,0,0,0,0,0,0,0,0,0,0,0,0,0,0,0,0
5186,791302,32,4,5,4,4,0,1,3,7,0,3,5,2,1,1,0,11
5186,781622,29,1,7,1,1,0,6,0,0,2,0,1,1,0,0,0,2
5186,791309,27,3,9,3,8,0,1,4,4,1,0,10,2,0,4,0,10
5186,785835,19,4,6,4,6,0,0,0,0,2,4,0,2,0,3,0,8
5186,776334,34,5,10,1,3,4,7,0,1,0,4,3,2,3,1,0,14
5186,796603,10,2,2,0,0,2,2,0,0,0,2,0,0,0,0,0,6
5186,796602,2,0,0,0,0,0,0,0,0,0,0,0,2,0,0,0,0
5186,775862,21,8,9,8,9,0,0,1,2,3,2,1,4,0,2,0,17
5186,796604,4,0,0,0,0,0,0,0,0,0,0,0,1,0,0,0,0
5186,796601,22,5,11,4,5,1,6,5,10,1,1,2,4,1,2,0,16
5187,790794,26,5,5,5,5,0,0,0,0,4,5,0,3,1,0,2,10
5187,780281,21,3,6,3,5,0,1,0,0,4,2,2,3,0,1,1,6
5187,790793,39,7,16,5,10,2,6,8,10,0,6,4,1,2,5,0,24
5187,785246,37,6,12,2,2,4,10,0,0,0,2,2,2,2,2,0,16
5187,780886,29,5,11,4,10,1,1,3,6,0,3,3,3,4,1,1,14
5187,796351,15,3,3,3,3,0,0,0,0,3,2,0,5,0,2,0,6
5187,785368,18,7,9,7,9,0,0,0,1,2,1,3,1,1,2,1,14
5187,790789,12,1,3,1,3,0,0,0,0,0,1,0,1,0,1,0,2
5187,796353,3,0,0,0,0,0,0,0,0,0,0,0,0,0,0,0,0
5188,786459,37,10,17,10,17,0,0,3,5,2,8,3,1,2,2,1,23
5188,797004,37,5,9,2,4,3,5,4,4,0,1,8,3,0,2,0,17
5188,781612,25,5,11,4,9,1,2,3,5,2,4,0,5,0,1,1,14
5188,781609,39,5,8,5,8,0,0,1,1,1,6,1,3,1,7,0,11
5188,797006,27,2,6,1,4,1,2,0,1,1,0,3,3,1,0,0,5
5188,791360,23,1,6,1,1,0,5,0,0,0,0,0,4,1,0,0,2
5188,797003,10,0,1,0,0,0,1,0,0,0,1,0,3,0,1,1,0
5188,797005,2,0,0,0,0,0,0,0,0,0,0,0,2,0,1,0,0
5189,791477,33,6,10,5,9,1,1,1,2,2,8,3,3,1,3,0,14
5189,786316,18,4,10,4,10,0,0,2,2,1,4,1,4,0,1,1,10
5189,780220,19,2,4,0,0,2,4,3,6,0,0,1,2,2,2,0,9
5189,791475,15,0,2,0,1,0,1,0,0,0,0,2,0,0,2,0,0
5189,797205,10,0,2,0,1,0,1,0,0,1,1,0,0,0,2,0,0
5189,786314,26,6,14,5,11,1,3,2,4,1,3,3,3,0,0,0,15
5189,791476,28,4,7,2,3,2,4,4,5,1,2,2,1,2,0,0,14
5189,797206,26,3,4,3,4,0,0,0,0,2,3,5,3,0,0,1,6
5189,797202,24,2,3,2,3,0,0,1,2,0,2,1,0,1,1,0,5
5189,791473,1,1,1,1,1,0,0,0,0,0,0,0,0,0,0,0,2
5190,796439,32,5,9,5,9,0,0,3,3,5,5,1,3,2,4,1,13
5190,791635,36,3,11,0,4,3,7,2,2,0,1,3,1,2,4,3,11
5190,790884,28,10,15,10,15,0,0,1,2,3,4,1,3,1,0,1,21
5190,790883,37,3,9,3,7,0,2,2,2,1,4,0,4,1,5,1,8
5190,785436,34,1,8,1,8,0,0,7,12,2,4,7,0,0,2,0,9
5190,790885,15,1,2,0,1,1,1,0,2,1,2,0,0,0,1,0,3
5190,796442,11,0,0,0,0,0,0,1,2,0,1,0,2,0,0,0,1
5190,790520,7,0,0,0,0,0,0,0,0,0,1,0,0,0,0,0,0
5191,785298,9,0,0,0,0,0,0,2,2,0,1,0,4,0,1,0,2
5191,775224,27,8,9,8,9,0,0,3,6,3,2,1,3,2,0,2,19
5191,778046,35,8,13,2,6,6,7,0,0,0,1,6,2,1,2,0,22
5191,782121,37,3,9,2,4,1,5,1,2,1,2,9,1,1,1,1,8
5191,775793,32,4,10,4,8,0,2,0,0,2,1,1,3,1,0,2,8
5191,785485,17,2,4,2,4,0,0,0,0,1,3,0,1,0,2,4,4
5191,785302,11,2,8,2,5,0,3,1,2,2,5,0,2,2,3,0,5
5191,786594,25,3,8,1,5,2,3,2,2,0,3,2,3,3,0,0,10
5191,796598,7,1,4,0,0,1,4,0,0,0,0,0,0,0,0,0,3
5192,780797,29,8,14,4,7,4,7,3,4,0,4,0,2,0,1,0,23
5192,775604,39,7,13,4,5,3,8,5,6,0,1,2,2,0,0,0,22
5192,780555,33,2,6,0,2,2,4,0,0,0,5,5,3,0,0,0,6
5192,776418,13,2,5,2,5,0,0,2,2,0,2,2,1,1,0,0,6
5192,785505,25,0,1,0,1,0,0,0,0,1,3,1,2,2,4,0,0
5192,796981,29,7,12,6,10,1,2,3,4,0,2,1,2,0,1,2,18
5192,791618,18,2,5,1,2,1,3,0,0,1,2,2,0,0,0,1,5
5192,791616,7,1,1,1,1,0,0,1,2,2,1,0,1,0,1,0,3
5192,786429,7,0,0,0,0,0,0,0,0,0,1,1,0,0,0,0,0
5193,781669,38,10,21,8,15,2,6,4,4,2,0,2,0,1,0,0,26
5193,786765,32,5,11,4,7,1,4,1,2,1,3,2,2,0,1,1,12
5193,797852,32,5,7,4,6,1,1,0,0,1,5,1,4,1,2,0,11
5193,792379,30,3,10,1,3,2,7,0,0,0,6,0,1,1,0,0,8
5193,792380,36,3,6,3,5,0,1,1,2,0,2,1,1,0,1,0,7
5193,781672,15,3,6,3,6,0,0,5,5,1,5,1,4,1,2,0,11
5193,797854,9,1,1,0,0,1,1,0,0,0,1,1,1,0,1,0,3
5193,797860,8,1,2,1,2,0,0,0,0,1,0,0,0,0,0,0,2
5194,785685,30,7,13,6,7,1,6,3,3,1,7,6,2,0,4,0,18
5194,791265,36,2,8,0,3,2,5,2,2,0,4,4,2,1,3,0,8
5194,791270,25,2,6,1,1,1,5,0,0,0,0,1,3,0,1,0,5
5194,791266,25,1,3,1,3,0,0,2,6,7,3,0,0,2,1,1,4
5194,797879,11,0,3,0,0,0,3,0,0,0,2,0,0,0,0,0,0
5194,796522,24,7,12,1,1,6,11,0,0,0,2,2,3,0,2,0,20
5194,791271,14,4,4,4,4,0,0,0,0,0,1,1,1,0,2,0,8
5194,796525,13,3,5,2,3,1,2,0,0,0,2,1,0,0,2,0,7
5194,796523,21,1,4,1,1,0,3,0,0,0,1,1,4,0,1,0,2
5194,788872,1,0,0,0,0,0,0,0,0,0,0,0,0,0,0,0,0
5195,786387,37,8,22,7,17,1,5,5,6,4,8,3,1,1,0,0,22
5195,791579,32,9,13,9,11,0,2,2,2,3,3,2,1,0,1,0,20
5195,797047,24,3,7,3,6,0,1,2,2,0,3,1,3,2,1,0,8
5195,780399,32,2,8,2,6,0,2,3,4,0,2,1,0,2,0,0,7
5195,775515,16,2,3,0,0,2,3,0,0,2,1,1,1,0,0,0,6
5195,797046,21,5,7,3,5,2,2,2,2,2,1,3,3,2,0,0,14
5195,780400,22,3,5,1,3,2,2,2,2,2,2,2,1,1,1,2,10
5195,786846,4,1,2,1,1,0,1,0,0,0,2,1,0,0,1,0,2
5195,791575,12,0,4,0,4,0,0,0,0,2,0,0,1,0,0,0,0
5196,786091,27,6,11,5,8,1,3,11,13,1,2,0,5,0,0,0,24
5196,785904,35,4,13,0,2,4,11,5,7,0,3,0,2,0,2,0,17
5196,786728,38,3,6,3,6,0,0,2,2,2,4,8,2,0,4,2,8
5196,780892,31,1,5,0,1,1,4,0,0,0,8,3,1,0,4,0,3
5196,775738,22,0,0,0,0,0,0,0,0,1,4,2,4,0,0,0,0
5196,786096,22,5,10,4,7,1,3,7,7,1,1,0,3,2,2,1,18
5196,781030,6,1,3,0,1,1,2,2,2,0,0,0,0,0,0,0,5
5196,792087,3,1,1,1,1,0,0,0,0,0,0,0,0,1,0,0,2
5196,797666,13,0,2,0,0,0,2,0,0,0,4,1,0,1,0,0,0
5196,797669,3,0,0,0,0,0,0,0,0,0,0,0,0,0,0,0,0
5197,783072,20,2,9,2,7,0,2,0,2,0,5,0,2,0,1,1,4
5197,776068,38,11,17,9,10,2,7,2,2,1,5,1,3,2,2,0,26
5197,774879,20,1,7,1,5,0,2,5,5,3,1,1,4,1,2,0,7
5197,791540,34,3,7,1,2,2,5,0,0,0,2,1,3,0,1,0,8
5197,787782,35,4,10,2,6,2,4,2,2,0,2,1,2,0,4,1,12
5197,781463,17,2,5,0,0,2,5,0,0,1,3,1,3,0,0,0,6
5197,792153,11,0,3,0,2,0,1,0,0,0,1,2,1,0,0,0,0
5197,797817,25,3,8,3,7,0,1,3,5,6,3,2,4,1,0,0,9
5198,786635,40,7,17,7,14,0,3,12,14,3,6,3,3,1,3,1,26
5198,780642,45,7,21,5,14,2,7,9,15,5,5,6,1,0,3,0,25
5198,791822,50,3,8,0,2,3,6,0,0,0,6,0,1,0,0,0,9
5198,781543,32,2,6,1,4,1,2,2,2,3,2,3,3,2,1,0,7
5198,798157,15,0,2,0,2,0,0,0,0,2,5,0,1,0,0,1,0
5198,786182,12,3,3,1,1,2,2,2,4,0,1,0,2,3,0,0,10
5198,781388,27,4,7,4,6,0,1,0,0,2,0,3,5,1,0,1,8
5198,786632,13,1,4,0,0,1,4,1,2,0,1,0,0,0,0,0,4
5198,797383,16,0,1,0,0,0,1,0,0,1,3,0,3,0,0,2,0
5199,797280,49,13,23,12,20,1,3,1,2,2,3,1,2,1,4,0,28
5199,791648,36,4,7,2,5,2,2,4,5,1,6,2,5,0,1,0,14
5199,791649,33,3,11,2,6,1,5,0,0,0,2,1,0,0,0,0,7
5199,786195,13,1,1,1,1,0,0,3,3,0,4,0,5,0,2,0,5
5199,785697,12,1,3,1,2,0,1,0,0,0,3,0,3,0,2,0,2
5199,786640,36,8,16,6,12,2,4,2,2,1,4,5,2,0,0,0,20
5199,785694,27,2,5,2,5,0,0,0,0,4,6,0,5,0,0,1,4
5199,797279,28,0,5,0,4,0,1,3,5,1,1,1,3,1,0,0,3
5199,797281,16,0,1,0,1,0,0,0,0,1,1,0,3,0,1,0,0
5200,791837,40,3,6,1,1,2,5,8,8,4,8,1,4,1,1,1,16
5200,780613,35,3,10,3,9,0,1,6,6,1,2,3,3,3,2,0,12
5200,775097,34,8,12,6,10,2,2,4,4,2,4,4,3,0,2,1,22
5200,780609,39,2,8,1,3,1,5,0,0,0,1,4,3,3,4,0,5
5200,776395,27,6,16,3,5,3,11,6,6,0,2,0,4,1,1,0,21
5200,786621,6,0,0,0,0,0,0,0,0,0,0,1,0,0,0,0,0
5200,786619,5,0,1,0,1,0,0,0,0,0,1,1,0,0,0,1,0
5200,797437,4,0,1,0,0,0,1,0,0,0,0,0,2,0,0,0,0
5200,786622,10,1,2,1,2,0,0,0,0,0,0,0,2,1,0,0,2
5201,780122,11,0,4,0,3,0,1,2,2,1,0,0,2,0,1,0,2
5201,797215,28,3,8,3,5,0,3,4,5,1,3,3,3,2,3,0,10
5201,791461,32,4,7,3,5,1,2,2,3,2,6,2,1,1,1,0,11
5201,791460,33,5,6,3,3,2,3,5,6,0,2,4,0,1,2,0,17
5201,775598,19,3,4,0,0,3,4,1,2,0,0,0,4,0,2,0,10
5201,786299,29,5,5,5,5,0,0,2,3,1,8,3,3,0,2,2,12
5201,797214,18,3,5,2,4,1,1,0,0,0,2,0,2,1,4,0,7
5201,786295,21,4,8,3,6,1,2,1,1,2,2,0,4,0,0,0,10
5201,780792,9,1,2,0,1,1,1,2,2,0,1,0,1,0,2,0,5
5202,781300,11,4,5,3,4,1,1,2,2,1,2,1,3,0,1,0,11
5202,790803,23,5,6,5,6,0,0,3,4,3,7,1,2,0,3,2,13
5202,781305,18,1,4,1,1,0,3,0,0,0,1,2,3,1,1,2,2
5202,790801,18,2,6,1,2,1,4,0,0,2,1,0,1,0,0,0,5
5202,781304,17,4,6,2,3,2,3,0,0,0,3,3,2,0,0,0,10
5202,796360,24,2,5,1,3,1,2,2,4,0,4,7,0,0,3,0,7
5202,780598,24,3,6,1,2,2,4,0,0,0,4,0,1,2,0,1,8
5202,796363,17,4,7,0,2,4,5,1,1,0,1,0,1,1,1,0,13
5202,796364,12,1,2,1,1,0,1,2,2,0,3,0,4,0,0,2,4
5202,790802,22,2,5,1,1,1,4,0,0,0,1,1,3,2,4,0,5
5202,796362,5,1,2,1,2,0,0,0,1,0,0,1,3,0,1,0,2
5202,781303,3,0,4,0,3,0,1,0,0,0,0,1,0,0,0,0,0
5202,776372,3,0,2,0,2,0,0,0,0,1,0,0,0,0,0,0,0
5202,776366,3,0,0,0,0,0,0,0,0,0,0,0,0,0,0,0,0
5203,780879,25,1,3,1,2,0,1,3,4,3,2,1,3,0,2,0,5
5203,775785,19,1,5,0,1,1,4,2,2,0,3,0,1,0,0,1,5
5203,790768,26,2,11,1,4,1,7,2,2,1,3,0,0,1,2,0,7
5203,785226,23,3,5,2,2,1,3,5,5,1,3,1,2,0,2,0,12
5203,780875,27,3,7,2,4,1,3,0,1,0,5,0,1,0,1,0,7
5203,796326,12,2,5,2,4,0,1,0,0,0,1,0,2,0,0,0,4
5203,785224,9,0,3,0,1,0,2,2,4,2,2,1,0,1,1,0,2
5203,790769,16,4,7,3,3,1,4,0,0,0,0,0,2,3,1,0,9
5203,785743,21,0,5,0,3,0,2,6,6,1,1,3,2,1,2,0,6
5203,796324,10,0,1,0,0,0,1,0,0,0,0,0,0,0,0,0,0
5203,790767,9,0,3,0,1,0,2,0,0,0,0,0,1,0,1,0,0
5203,796325,3,1,1,1,1,0,0,2,2,0,1,0,0,0,0,0,4
5204,791988,23,8,11,8,11,0,0,3,4,2,3,2,3,1,1,0,19
5204,792443,28,2,5,2,5,0,0,3,3,1,3,1,1,1,2,3,7
5204,796507,23,1,5,0,0,1,5,0,0,0,2,2,4,0,2,1,3
5204,791989,36,10,17,3,6,7,11,0,0,0,4,3,0,1,3,0,27
5204,791987,34,2,10,1,7,1,3,3,4,0,3,5,2,1,2,0,8
5204,796509,25,0,1,0,0,0,1,2,5,3,6,0,1,0,2,0,2
5204,780077,2,0,0,0,0,0,0,0,0,0,0,0,1,0,0,0,0
5204,796506,5,0,0,0,0,0,0,0,0,0,2,1,3,0,0,0,0
5204,796508,11,0,4,0,0,0,4,0,0,0,1,0,1,1,0,0,0
5204,796503,13,0,3,0,1,0,2,2,2,1,1,1,4,1,4,0,2
5205,792067,30,1,2,1,2,0,0,4,4,0,1,3,3,2,3,1,6
5205,775523,29,8,14,8,13,0,1,5,10,5,5,3,1,2,2,0,21
5205,792059,15,3,8,2,6,1,2,0,0,1,3,0,2,0,0,1,7
5205,792058,14,0,3,0,3,0,0,1,2,2,1,0,0,0,0,0,1
5205,789053,17,1,3,1,2,0,1,0,0,0,1,0,3,0,0,0,2
5205,792055,10,1,6,1,6,0,0,0,2,0,1,1,0,0,1,0,2
5205,790779,10,1,2,1,2,0,0,1,2,0,2,0,0,0,1,0,3
5205,797649,14,1,6,1,4,0,2,0,0,0,2,0,2,0,2,0,2
5205,789028,29,2,4,2,4,0,0,3,3,0,3,4,3,2,2,0,7
5205,789029,8,2,3,1,1,1,2,0,0,0,1,0,1,0,0,1,5
5205,775323,24,1,4,1,2,0,2,0,2,1,1,1,2,3,2,0,2
5206,790784,28,4,6,4,4,0,2,6,7,1,5,2,1,3,2,1,14
5206,786548,21,5,7,5,7,0,0,0,3,3,3,0,4,1,3,1,10
5206,797475,16,0,4,0,1,0,3,0,0,0,1,3,4,0,0,0,0
5206,786229,28,2,6,1,1,1,5,0,0,2,2,1,2,1,2,0,5
5206,775229,32,5,15,4,13,1,2,3,3,0,3,2,0,1,3,0,14
5206,786583,2,1,1,0,0,1,1,0,0,0,1,0,0,0,0,0,3
5206,776219,18,3,4,3,3,0,1,0,0,3,3,0,4,0,1,0,6
5206,786235,7,5,6,5,6,0,0,1,1,0,0,0,5,0,2,1,11
5206,797476,2,0,0,0,0,0,0,0,0,0,0,0,0,0,0,0,0
5206,791871,8,0,1,0,1,0,0,0,0,0,1,2,0,0,1,0,0
5206,786581,8,0,2,0,1,0,1,0,0,0,0,0,0,1,0,0,0
5206,786770,17,0,5,0,5,0,0,4,4,3,3,1,4,2,1,0,4
5206,781518,13,1,1,1,1,0,0,0,0,0,2,0,2,0,0,0,2
5207,785509,20,1,2,1,1,0,1,0,0,0,3,0,2,1,1,0,2
5207,791424,24,4,10,4,10,0,0,2,5,2,2,2,5,0,2,1,10
5207,797085,36,1,9,1,5,0,4,8,10,1,4,1,0,1,3,0,10
5207,791421,31,4,13,2,9,2,4,0,0,0,4,0,2,1,5,0,10
5207,785899,37,1,4,0,1,1,3,1,2,0,2,1,3,1,1,0,4
5207,797079,2,0,1,0,1,0,0,1,2,0,0,0,0,0,1,0,1
5207,797081,1,0,0,0,0,0,0,0,0,0,0,0,0,0,0,0,0
5207,791425,19,1,3,1,3,0,0,1,1,2,0,1,3,1,0,1,3
5207,797086,2,0,0,0,0,0,0,0,0,0,0,0,0,0,0,0,0
5207,797090,13,1,4,1,4,0,0,1,2,1,2,0,3,0,1,1,3
5207,797084,1,0,1,0,1,0,0,0,0,0,0,0,0,0,0,0,0
5207,797083,2,0,0,0,0,0,0,0,0,0,1,0,0,0,0,0,0
5207,797088,12,0,0,0,0,0,0,0,0,0,3,0,0,0,2,0,0
5208,797292,22,5,10,5,10,0,0,3,3,5,3,0,1,1,1,4,13
5208,780509,27,4,10,4,8,0,2,4,6,3,1,2,3,0,3,1,12
5208,797290,28,5,10,2,3,3,7,0,0,2,4,2,3,0,1,0,13
5208,797291,27,2,7,1,5,1,2,3,4,0,7,6,1,2,3,0,8
5208,786064,24,2,7,2,2,0,5,3,4,0,1,1,3,1,1,0,7
5208,791663,3,0,0,0,0,0,0,0,0,0,1,0,0,0,1,1,0
5208,791661,7,1,1,0,0,1,1,0,2,1,3,0,1,0,1,0,3
5208,785658,13,2,3,2,3,0,0,0,1,0,2,0,1,0,1,1,4
5208,797295,8,2,3,1,1,1,2,0,0,0,1,1,0,0,2,0,5
5208,797294,2,0,0,0,0,0,0,0,0,0,0,0,0,0,0,0,0
5208,791660,24,2,4,1,1,1,3,0,0,1,3,2,2,0,0,1,5
5208,791658,15,2,3,2,3,0,0,2,2,1,1,1,2,1,2,1,6
5209,797842,29,5,15,4,13,1,2,5,9,5,0,2,3,3,2,0,16
5209,797849,18,2,4,2,2,0,2,0,1,0,2,0,4,2,4,1,4
5209,781537,17,2,5,2,4,0,1,0,0,1,2,0,4,0,0,0,4
5209,786079,29,0,5,0,3,0,2,0,0,1,4,3,4,1,3,0,0
5209,792202,30,1,6,1,3,0,3,1,2,0,5,1,0,0,1,0,3
5209,797848,24,2,4,2,4,0,0,0,0,0,1,0,2,1,1,1,4
5209,792201,6,0,0,0,0,0,0,0,0,0,1,0,1,1,0,1,0
5209,797847,18,2,5,0,2,2,3,0,0,0,1,0,0,0,3,0,6
5209,797838,4,0,3,0,2,0,1,0,0,0,1,0,0,0,0,0,0
5209,797846,25,3,10,2,5,1,5,0,0,1,1,1,2,1,2,0,7
5210,791531,19,1,3,0,0,1,3,1,2,0,0,0,3,1,0,0,4
5210,791534,27,5,6,5,6,0,0,3,5,3,4,0,3,0,3,0,13
5210,797127,31,4,7,3,4,1,3,2,3,0,2,2,3,1,5,0,11
5210,791528,40,4,13,1,5,3,8,1,2,3,5,5,3,2,2,1,12
5210,775045,40,6,15,5,13,1,2,11,12,0,3,5,1,2,3,0,24
5210,797124,13,0,1,0,1,0,0,0,0,0,4,0,0,0,0,1,0
5210,791533,21,3,5,3,5,0,0,0,0,1,6,0,1,0,0,0,6
5210,774880,9,0,0,0,0,0,0,0,0,2,0,0,1,0,0,0,0
5211,796318,21,4,8,4,6,0,2,1,2,1,3,0,4,0,6,0,9
5211,790761,34,4,10,3,5,1,5,0,0,1,3,3,3,0,2,0,9
5211,790764,35,9,13,5,8,4,5,2,3,2,6,0,5,0,3,0,24
5211,796319,29,4,8,3,4,1,4,4,4,0,2,0,3,1,2,1,13
5211,796320,26,0,3,0,1,0,2,0,0,1,3,2,4,0,2,0,0
5211,785219,17,1,5,0,1,1,4,0,0,0,2,1,1,1,0,0,3
5211,796323,5,0,0,0,0,0,0,0,0,0,0,0,1,0,0,0,0
5211,779993,27,2,5,1,2,1,3,0,0,1,0,1,2,2,0,0,5
5211,796321,5,1,2,1,2,0,0,0,0,0,0,0,0,0,0,0,2
5211,775668,1,0,0,0,0,0,0,0,0,0,0,0,0,0,0,0,0
5212,780832,32,7,11,7,11,0,0,8,10,8,6,0,3,3,0,1,22
5212,790961,31,5,7,5,7,0,0,4,4,2,4,0,3,1,3,0,14
5212,786240,27,0,2,0,2,0,0,3,4,1,2,1,2,0,1,0,3
5212,785278,27,2,8,1,3,1,5,2,2,0,4,2,3,1,0,1,7
5212,780146,32,4,14,2,7,2,7,3,5,1,2,2,2,1,3,0,13
5212,796556,7,1,1,1,1,0,0,0,0,1,0,0,1,0,0,0,2
5212,796554,6,0,0,0,0,0,0,0,0,1,2,0,0,0,0,0,0
5212,796557,4,0,1,0,0,0,1,0,0,0,0,0,0,0,0,1,0
5212,796555,9,0,3,0,2,0,1,0,0,1,0,0,2,0,0,0,0
5212,775860,25,5,12,2,4,3,8,0,0,0,4,2,3,0,1,0,13
5213,791316,29,5,8,5,8,0,0,0,0,0,3,1,4,0,1,1,10
5213,780870,28,2,4,2,4,0,0,2,4,5,7,0,4,0,4,2,6
5213,781079,30,6,11,4,6,2,5,4,4,0,4,1,1,0,2,0,18
5213,781443,31,1,11,1,6,0,5,2,2,0,0,4,2,0,1,1,4
5213,775822,32,6,13,5,7,1,6,6,7,0,2,3,3,1,2,0,19
5213,796626,5,0,0,0,0,0,0,0,0,0,2,0,1,0,0,2,0
5213,796189,0,0,0,0,0,0,0,0,0,0,0,0,0,0,0,0,0
5213,796625,17,0,2,0,2,0,0,2,2,3,1,1,3,1,1,0,2
5213,796621,14,0,1,0,0,0,1,0,0,0,2,0,2,0,1,0,0
5213,796202,0,0,0,0,0,0,0,0,0,0,0,0,0,0,0,0,0
5213,791314,1,0,0,0,0,0,0,0,0,0,0,0,0,0,0,0,0
5213,785380,11,1,2,1,2,0,0,0,0,0,0,0,2,0,1,0,2
5213,785831,2,0,0,0,0,0,0,0,0,0,0,0,0,0,0,0,0
5214,786180,19,2,4,2,4,0,0,0,0,4,3,0,2,2,0,4,4
5214,792104,26,7,16,5,10,2,6,3,3,1,2,1,0,1,0,2,19
5214,797709,23,4,9,1,4,3,5,4,4,1,1,1,2,0,0,1,15
5214,797708,34,8,15,6,9,2,6,2,2,2,0,2,2,3,2,0,20
5214,775779,33,4,7,4,7,0,0,3,3,0,6,4,0,2,1,0,11
5214,785608,14,5,7,5,6,0,1,3,4,3,3,1,1,0,0,0,13
5214,792106,9,0,1,0,1,0,0,0,0,0,0,3,1,1,0,0,0
5214,797707,20,3,7,2,4,1,3,0,0,0,0,2,2,2,0,0,7
5214,786204,15,3,8,2,4,1,4,0,0,0,0,0,1,1,1,0,7
5214,776327,6,0,2,0,2,0,0,0,0,0,1,0,1,1,0,0,0
5214,799162,1,0,0,0,0,0,0,0,0,0,0,0,0,0,0,0,0
5215,781454,31,7,12,6,10,1,2,2,5,0,5,1,3,0,3,1,17
5215,786424,28,4,9,4,9,0,0,2,2,3,10,1,1,0,5,0,10
5215,792366,30,7,12,7,11,0,1,4,5,2,1,3,2,0,5,0,18
5215,791015,19,0,1,0,1,0,0,0,0,1,2,1,1,0,2,0,0
5215,785483,34,10,14,7,9,3,5,0,1,0,5,4,2,0,1,1,23
5215,797979,15,2,2,2,2,0,0,0,0,0,0,1,1,0,1,0,4
5215,797988,18,1,2,1,2,0,0,0,0,0,0,3,1,0,1,0,2
5215,785959,5,1,1,1,1,0,0,0,0,0,0,0,1,0,1,0,2
5215,797991,6,0,0,0,0,0,0,0,0,0,2,1,0,0,0,0,0
5215,792279,14,1,2,1,1,0,1,0,0,0,2,0,0,1,3,0,2
5216,800005,28,1,1,1,1,0,0,0,0,0,4,0,1,1,2,1,2
5216,799129,40,6,16,4,7,2,9,1,1,0,3,2,2,1,7,0,15
5216,799128,30,0,1,0,1,0,0,0,0,0,2,1,1,0,7,0,0
5216,799133,34,1,3,0,1,1,2,1,2,0,2,2,3,0,3,0,4
5216,792634,37,4,11,2,4,2,7,0,1,0,3,0,1,0,7,0,10
5216,799135,12,0,0,0,0,0,0,0,0,0,2,0,1,0,1,0,0
5216,799136,19,0,1,0,1,0,0,0,0,0,1,0,2,1,1,0,0
5217,786791,20,3,6,3,6,0,0,0,0,1,6,0,0,1,1,0,6
5217,791864,23,5,8,5,7,0,1,0,0,0,0,2,1,2,0,0,10
5217,791863,29,0,3,0,1,0,2,2,2,3,2,5,1,3,1,0,2
5217,797472,25,7,12,4,4,3,8,2,2,0,2,1,2,2,0,0,19
5217,780965,32,5,9,4,6,1,3,1,2,2,1,9,1,2,1,0,12
5217,797473,14,3,5,3,5,0,0,1,2,1,0,0,1,2,0,0,7
5217,781081,12,4,8,4,8,0,0,2,2,3,0,0,1,0,0,1,10
5217,797470,20,2,5,1,1,1,4,0,0,0,0,1,2,0,1,1,5
5217,791865,10,0,2,0,1,0,1,0,0,0,4,1,4,3,2,0,0
5217,776447,15,3,6,3,5,0,1,0,0,0,3,2,0,2,1,0,6
5218,791220,27,0,4,0,2,0,2,0,0,4,3,2,1,2,2,1,0
5218,791219,33,8,14,2,6,6,8,0,0,2,6,0,1,0,0,0,22
5218,776217,35,4,9,4,9,0,0,6,8,2,7,0,1,1,2,0,14
5218,786396,19,0,3,0,1,0,2,0,0,0,1,1,0,0,0,1,0
5218,780730,28,6,11,3,4,3,7,2,4,0,3,4,3,1,4,0,17
5218,786824,24,2,4,2,2,0,2,2,2,1,4,1,2,1,1,0,6
5218,791221,5,1,2,0,0,1,2,0,0,1,0,0,0,0,0,0,3
5218,796920,2,0,1,0,0,0,1,0,0,0,0,0,0,0,0,0,0
5218,790818,27,3,6,3,6,0,0,3,4,0,2,5,4,1,4,0,9
5219,785775,24,0,3,0,2,0,1,0,2,1,1,3,4,0,2,0,0
5219,781335,32,6,12,5,8,1,4,0,1,1,2,3,5,1,2,0,13
5219,776351,36,8,17,5,6,3,11,2,2,3,9,2,1,1,0,1,21
5219,785770,38,6,17,3,8,3,9,2,2,1,1,1,4,1,2,0,17
5219,781341,35,3,6,2,2,1,4,0,0,1,3,4,2,0,2,0,7
5219,796542,6,2,2,2,2,0,0,0,0,2,0,0,1,0,0,0,4
5219,796538,22,0,2,0,0,0,2,0,0,0,1,1,2,0,1,0,0
5219,791284,1,0,1,0,1,0,0,0,0,0,0,0,0,1,0,0,0
5219,791283,4,0,0,0,0,0,0,0,0,0,0,0,0,0,1,0,0
5219,785767,2,0,0,0,0,0,0,0,0,0,0,0,0,0,0,0,0
5220,796372,25,2,3,2,3,0,0,0,0,2,3,0,3,0,1,0,4
5220,796378,23,2,5,2,3,0,2,0,0,1,4,0,2,1,5,0,4
5220,796377,29,3,7,2,4,1,3,3,4,1,4,3,3,0,3,0,10
5220,790815,32,2,10,2,7,0,3,0,2,2,2,2,4,1,5,0,4
5220,780176,36,4,9,2,4,2,5,5,6,0,4,3,2,0,6,0,15
5220,790814,16,0,3,0,1,0,2,0,0,1,2,0,3,0,2,0,0
5220,796374,11,0,1,0,1,0,0,1,2,1,0,1,1,0,3,0,1
5220,786013,20,2,3,2,3,0,0,3,5,0,4,0,2,0,2,0,7
5220,796373,2,1,1,1,1,0,0,0,0,0,0,0,0,0,0,0,2
5220,796375,2,0,0,0,0,0,0,0,0,0,0,0,0,0,0,0,0
5220,796376,2,0,0,0,0,0,0,0,0,0,0,0,0,0,0,0,0
5220,790817,2,0,0,0,0,0,0,0,0,0,0,0,0,0,0,0,0
5221,791980,16,5,6,4,4,1,2,1,2,1,0,0,1,2,0,1,12
5221,785967,21,2,8,2,8,0,0,4,7,0,4,0,5,0,1,1,8
5221,791976,28,2,6,0,2,2,4,4,4,0,2,2,1,2,0,0,10
5221,791978,37,7,12,3,5,4,7,0,0,2,1,5,0,4,1,0,18
5221,785973,23,1,5,0,2,1,3,5,6,0,2,5,1,2,1,0,8
5221,785972,9,2,3,2,2,0,1,0,0,0,2,0,1,0,2,0,4
5221,797801,8,1,1,1,1,0,0,0,0,0,1,0,4,0,1,0,2
5221,791977,20,0,6,0,3,0,3,3,3,0,0,0,1,1,1,0,3
5221,797800,15,1,2,1,2,0,0,0,0,0,3,0,2,1,0,0,2
5221,780160,21,1,1,1,1,0,0,0,0,2,3,5,4,1,4,0,2
5221,797803,2,0,0,0,0,0,0,0,0,0,0,0,0,0,0,0,0
5222,786746,24,3,7,2,3,1,4,0,0,2,2,1,3,0,1,0,7
5222,780178,12,3,4,3,4,0,0,0,0,3,3,0,1,0,2,0,6
5222,775075,15,1,4,1,4,0,0,0,1,2,1,0,2,1,1,1,2
5222,792376,29,9,17,4,6,5,11,5,5,0,5,3,1,2,2,0,28
5222,797883,25,0,3,0,2,0,1,0,1,2,2,5,0,1,3,0,0
5222,797890,18,0,2,0,2,0,0,4,4,1,3,1,3,2,2,1,4
5222,792378,18,3,3,3,3,0,0,0,0,1,5,1,2,0,1,5,6
5222,797888,16,1,3,1,2,0,1,0,0,1,4,0,0,0,0,2,2
5222,792375,1,0,2,0,1,0,1,0,0,0,0,0,0,0,0,0,0
5222,792374,15,3,6,3,4,0,2,0,0,0,0,3,3,0,1,0,6
5222,797885,5,0,2,0,1,0,1,0,0,0,1,0,0,0,0,0,0
5222,786747,22,2,7,1,5,1,2,0,0,0,3,1,2,1,0,0,5
5223,799906,22,0,8,0,3,0,5,0,0,1,0,0,1,1,1,0,0
5223,775833,24,5,6,5,6,0,0,0,0,1,4,0,0,0,0,0,10
5223,785439,21,0,2,0,0,0,2,2,4,1,3,4,2,2,4,0,2
5223,781036,30,2,7,2,5,0,2,0,0,0,2,2,3,0,2,1,4
5223,774894,33,2,10,1,6,1,4,0,0,0,3,1,1,1,2,1,5
5223,796846,8,3,6,3,5,0,1,1,2,2,1,0,1,1,1,1,7
5223,796847,23,4,10,3,8,1,2,1,2,2,0,0,1,0,2,0,10
5223,791178,6,0,1,0,1,0,0,2,2,1,4,0,0,0,0,0,2
5223,796844,6,0,1,0,1,0,0,0,2,0,0,0,1,2,1,1,0
5223,796845,27,1,4,0,0,1,4,0,0,1,4,1,2,0,0,1,3
5224,797821,28,3,6,3,5,0,1,1,2,3,5,1,2,0,4,0,7
5224,780433,19,2,6,2,6,0,0,2,2,2,3,0,3,0,3,3,6
5224,797816,33,4,14,2,9,2,5,5,6,1,3,1,1,0,3,0,15
5224,792188,28,4,6,4,4,0,2,0,0,0,6,1,2,1,5,0,8
5224,786675,17,2,6,0,2,2,4,0,0,0,2,0,0,1,0,0,6
5224,797819,17,2,3,2,3,0,0,2,2,1,5,0,0,1,0,0,6
5224,781447,28,3,4,3,4,0,0,3,6,0,5,0,3,1,4,1,9
5224,781490,30,3,4,3,3,0,1,2,3,0,2,1,1,1,2,0,8
5225,796927,21,1,4,0,1,1,3,0,0,1,1,0,4,0,1,1,3
5225,791223,16,1,4,1,4,0,0,0,0,1,0,1,0,1,0,0,2
5225,796929,33,4,11,0,0,4,11,0,0,0,1,0,0,0,0,0,12
5225,791224,30,6,17,5,12,1,5,3,3,0,5,1,2,5,2,0,16
5225,785571,32,4,15,4,10,0,5,0,0,0,6,4,3,2,3,0,8
5225,791811,18,3,5,3,5,0,0,2,2,3,3,0,1,0,3,0,8
5225,791222,26,1,4,1,3,0,1,0,0,0,1,0,3,0,1,0,2
5225,786436,24,1,4,1,3,0,1,1,1,1,1,4,2,0,0,1,3
5226,791306,33,8,10,7,9,1,1,0,2,2,4,0,1,0,1,0,17
5226,780210,40,6,11,3,5,3,6,4,4,4,2,2,0,0,1,1,19
5226,792432,38,2,6,1,4,1,2,4,4,0,2,6,4,3,4,0,9
5226,792427,38,8,15,7,8,1,7,1,2,0,0,3,1,0,5,1,18
5226,792433,34,2,8,2,2,0,6,0,0,2,3,5,5,1,1,0,4
5226,796592,7,0,0,0,0,0,0,0,0,0,0,0,1,0,1,0,0
5226,796594,1,0,0,0,0,0,0,0,0,0,0,0,1,0,0,0,0
5226,786422,9,1,1,0,0,1,1,0,0,0,0,0,1,0,2,0,3
5227,791352,30,3,5,3,3,0,2,0,0,1,4,1,2,1,0,1,6
5227,780455,27,9,13,9,13,0,0,2,2,1,3,0,2,0,2,0,20
5227,797251,16,1,2,1,1,0,1,0,0,1,2,1,3,0,3,0,2
5227,797247,38,4,8,3,6,1,2,2,2,0,2,5,2,2,3,0,11
5227,776297,36,8,12,4,5,4,7,2,2,1,2,6,1,1,1,0,22
5227,791355,4,0,1,0,0,0,1,0,0,0,0,0,0,0,0,0,0
5227,791354,9,2,2,2,2,0,0,0,0,1,1,0,0,0,1,0,4
5227,785837,22,3,3,3,3,0,0,0,0,0,0,3,3,1,3,0,6
5227,786227,0,0,0,0,0,0,0,0,0,0,0,0,0,0,0,0,0
5227,797249,2,0,0,0,0,0,0,0,0,0,0,0,0,0,0,0,0
5227,797248,16,1,3,0,0,1,3,2,2,0,2,0,1,0,2,0,5
5228,791882,18,3,7,2,6,1,1,1,3,0,4,1,3,0,3,0,8
5228,786493,34,3,10,3,5,0,5,7,8,2,3,1,2,4,1,1,13
5228,786491,33,3,5,3,4,0,1,1,2,1,6,1,4,1,2,2,7
5228,791881,28,3,4,1,1,2,3,2,2,0,3,3,4,1,4,0,10
5228,786420,32,7,12,7,9,0,3,1,1,0,5,3,2,0,5,0,15
5228,797618,3,0,0,0,0,0,0,0,0,0,1,0,1,0,1,2,0
5228,797616,21,2,3,2,3,0,0,5,6,1,7,0,4,0,1,1,9
5228,797613,7,1,2,0,0,1,2,0,0,0,0,0,0,0,1,0,3
5228,781052,24,1,2,0,0,1,2,0,0,0,2,0,1,0,1,0,3
5229,797235,30,2,8,2,8,0,0,0,0,2,7,0,2,0,1,0,4
5229,797233,3,0,0,0,0,0,0,0,0,0,0,0,2,0,2,0,0
5229,797232,33,4,13,3,8,1,5,4,6,1,2,1,2,0,2,0,13
5229,797237,29,0,6,0,2,0,4,0,0,1,1,3,1,1,0,0,0
5229,797239,38,7,18,3,7,4,11,3,4,1,3,0,2,2,0,0,21
5229,791368,16,0,1,0,1,0,0,1,2,0,0,0,2,0,1,0,1
5229,786535,9,1,5,1,4,0,1,0,0,0,0,1,1,0,2,0,2
5229,786251,5,2,2,2,2,0,0,0,0,1,1,0,2,0,1,0,4
5229,785446,9,2,3,2,3,0,0,6,7,0,2,1,2,0,0,0,10
5229,791367,11,1,2,1,2,0,0,0,1,1,1,0,0,2,2,0,2
5229,797234,17,2,3,1,2,1,1,3,4,3,2,1,5,2,1,0,8
5230,797482,31,2,8,2,5,0,3,4,6,1,2,3,4,1,2,0,8
5230,797485,29,2,5,2,3,0,2,0,0,0,4,0,3,0,3,0,4
5230,797481,31,6,11,6,10,0,1,2,2,0,4,0,4,3,0,1,14
5230,797479,11,0,1,0,0,0,1,0,0,0,0,0,0,0,1,0,0
5230,785944,38,10,14,4,7,6,7,6,7,3,3,1,1,1,4,0,32
5230,797483,7,1,1,1,1,0,0,0,1,0,0,0,0,1,0,1,2
5230,797478,15,1,4,0,1,1,3,0,0,0,1,1,0,0,2,0,3
5230,791873,27,0,3,0,1,0,2,2,3,0,2,5,4,2,3,0,2
5230,781217,11,2,4,1,1,1,3,0,0,0,3,0,2,0,0,0,5
5231,785987,31,2,8,1,4,1,4,1,1,2,5,4,3,0,2,3,6
5231,776037,29,9,11,9,11,0,0,2,2,3,5,1,4,2,3,1,20
5231,780588,27,5,7,5,7,0,0,0,0,0,2,0,3,1,4,0,10
5231,791759,29,4,9,4,8,0,1,3,5,0,1,2,1,2,1,0,11
5231,786147,34,4,7,2,4,2,3,0,0,0,2,5,3,2,3,0,10
5231,781647,23,4,5,3,3,1,2,0,0,0,5,0,2,1,1,0,9
5231,780667,27,3,8,2,5,1,3,5,6,0,1,2,3,1,0,0,12
5232,780913,27,3,4,2,2,1,2,0,2,1,6,1,4,0,1,1,7
5232,798119,26,7,9,5,5,2,4,0,1,0,0,3,1,1,2,0,16
5232,798117,37,6,12,5,7,1,5,5,5,2,2,4,4,1,5,0,18
5232,780594,35,2,7,1,2,1,5,2,2,0,5,0,1,1,2,1,7
5232,775664,33,3,10,2,5,1,5,1,2,3,1,1,3,2,2,1,8
5232,798123,20,2,7,2,7,0,0,5,9,2,3,1,4,0,3,0,9
5232,798124,22,2,3,2,2,0,1,2,3,0,3,1,3,0,6,0,6
5233,792299,22,2,5,0,3,2,2,7,10,2,4,1,3,0,3,1,13
5233,792304,33,9,15,7,9,2,6,0,0,1,2,1,3,3,3,0,20
5233,792301,35,5,12,4,9,1,3,0,1,0,2,6,4,2,4,1,11
5233,786278,24,6,9,4,6,2,3,4,4,1,4,1,3,1,4,0,18
5233,786275,31,0,5,0,3,0,2,2,2,2,2,6,1,2,2,2,2
5233,786181,18,1,3,1,3,0,0,2,2,1,1,0,4,0,2,0,4
5233,786286,22,2,4,0,0,2,4,0,0,1,2,0,2,1,0,0,6
5233,786280,15,1,2,1,2,0,0,2,2,1,3,1,2,0,0,0,4
5234,787239,32,2,2,2,2,0,0,1,2,2,6,1,2,0,1,4,5
5234,789058,25,0,4,0,2,0,2,1,2,0,3,2,5,1,0,1,1
5234,785286,33,6,18,4,10,2,8,2,3,4,6,2,1,0,3,2,16
5234,797898,32,5,12,4,8,1,4,0,0,0,1,5,1,1,3,0,11
5234,792237,24,6,13,3,7,3,6,2,2,0,3,2,0,1,0,0,17
5234,792238,5,0,1,0,1,0,0,0,0,0,0,1,0,0,0,0,0
5234,785818,15,2,5,0,1,2,4,0,0,0,1,0,2,0,0,1,6
5234,792236,23,3,4,3,4,0,0,2,2,0,2,4,3,1,2,0,8
5234,792240,11,1,1,1,1,0,0,0,0,1,2,1,2,1,0,0,2
5235,791493,37,4,9,4,9,0,0,1,4,5,14,0,1,1,3,4,9
5235,789036,32,2,10,2,10,0,0,9,10,5,3,2,3,0,1,1,13
5235,797191,17,1,2,1,2,0,0,0,0,2,3,3,2,0,3,0,2
5235,791495,6,0,2,0,0,0,2,0,0,0,0,0,0,0,1,0,0
5235,776494,30,2,10,1,2,1,8,0,0,2,4,4,2,0,1,2,5
5235,781307,11,2,4,2,4,0,0,0,0,0,0,1,0,0,2,0,4
5235,791492,26,3,9,2,4,1,5,2,2,2,0,1,3,1,0,0,9
5235,786324,28,6,13,2,5,4,8,3,3,1,2,3,4,0,4,0,19
5235,778888,13,0,2,0,0,0,2,0,0,0,0,1,1,1,1,0,0
5236,792334,18,3,8,3,7,0,1,0,0,3,3,0,3,0,0,0,6
5236,786575,25,6,8,6,8,0,0,1,3,3,6,4,5,1,5,1,13
5236,798094,21,0,1,0,0,0,1,0,0,0,3,6,1,0,4,1,0
5236,792338,33,5,12,5,11,0,1,2,2,0,2,5,0,3,2,0,12
5236,781666,36,5,10,1,4,4,6,0,2,1,5,1,1,0,1,0,14
5236,798097,12,1,3,1,3,0,0,2,2,0,1,0,1,1,0,2,4
5236,792336,2,0,0,0,0,0,0,0,0,0,0,0,0,0,0,0,0
5236,785531,20,5,5,1,1,4,4,0,0,0,0,0,3,0,1,0,14
5236,799842,17,3,4,1,2,2,2,3,4,0,0,1,0,1,2,0,11
5236,791636,16,1,5,0,4,1,1,0,0,1,3,1,3,1,2,0,3
5237,796566,28,6,16,6,16,0,0,3,3,4,9,0,2,1,2,1,15
5237,781380,22,4,8,4,8,0,0,0,1,2,2,0,2,1,1,2,8
5237,796563,12,0,0,0,0,0,0,0,0,0,0,0,0,0,1,1,0
5237,790969,25,3,7,3,5,0,2,1,2,0,3,3,1,2,2,0,7
5237,780166,26,3,8,3,6,0,2,4,5,0,1,7,3,1,2,0,10
5237,796568,12,1,3,1,3,0,0,0,0,1,0,0,0,1,3,0,2
5237,790971,12,0,3,0,3,0,0,1,2,3,1,0,1,2,1,0,1
5237,796569,20,2,4,2,4,0,0,2,2,1,1,0,3,1,0,0,6
5237,790967,21,4,8,2,6,2,2,0,0,0,0,2,0,0,1,0,10
5237,775107,22,5,7,2,3,3,4,2,2,0,0,0,3,1,0,0,15
5238,780631,27,5,12,3,8,2,4,0,0,0,2,1,2,3,1,0,12
5238,791827,40,6,13,6,13,0,0,7,10,4,6,3,4,1,2,0,19
5238,797391,31,4,8,1,3,3,5,0,0,1,2,1,0,0,1,0,11
5238,786625,37,1,4,1,2,0,2,0,0,1,1,6,5,1,2,0,2
5238,780625,29,4,5,1,1,3,4,0,2,0,5,4,2,0,2,0,11
5238,785481,17,3,4,3,4,0,0,4,6,1,2,0,0,0,0,0,10
5238,791830,3,0,0,0,0,0,0,0,0,0,0,0,0,0,0,0,0
5238,797395,24,1,7,1,5,0,2,3,4,0,1,1,1,2,3,0,5
5238,797394,14,1,3,1,3,0,0,2,4,2,1,0,1,0,1,0,4
5238,786630,3,0,0,0,0,0,0,0,0,0,0,0,0,0,0,0,0
5239,786519,30,5,5,5,5,0,0,3,6,2,7,1,5,0,1,1,13
5239,797556,36,7,16,5,9,2,7,1,1,4,1,3,3,1,3,0,17
5239,797555,2,0,0,0,0,0,0,0,0,0,0,0,0,0,0,0,0
5239,791913,29,5,8,4,4,1,4,2,2,0,2,2,0,0,4,0,13
5239,786520,34,3,14,1,7,2,7,10,10,0,0,5,1,2,1,0,18
5239,797558,6,0,1,0,1,0,0,0,0,0,0,0,3,0,0,0,0
5239,791911,25,4,10,0,0,4,10,0,0,1,2,0,1,0,0,0,12
5239,797560,15,0,1,0,1,0,0,0,0,1,1,0,2,0,1,0,0
5239,797559,16,2,2,2,2,0,0,0,0,0,3,3,0,3,1,0,4
5239,781105,32,1,4,1,2,0,2,0,0,3,3,1,3,3,0,2,2
5240,797529,22,0,1,0,1,0,0,4,4,1,3,1,2,1,2,0,4
5240,797527,34,3,7,3,5,0,2,0,0,1,7,2,3,4,0,0,6
5240,791936,35,4,7,4,7,0,0,1,3,1,4,3,3,2,1,0,9
5240,797532,40,10,18,8,14,2,4,1,1,0,2,11,1,1,5,0,23
5240,785688,29,8,16,2,3,6,13,2,2,0,0,0,0,0,1,0,24
5240,791932,22,2,4,0,1,2,3,0,0,1,0,1,0,2,0,0,6
5240,785988,18,0,4,0,1,0,3,0,0,1,7,1,1,0,3,0,0
5241,786792,10,0,0,0,0,0,0,0,0,0,0,1,5,0,0,0,0
5241,792414,33,7,11,3,3,4,8,0,1,0,8,1,4,0,4,2,18
5241,789020,40,4,11,2,5,2,6,0,0,1,8,5,2,1,3,1,10
5241,786787,40,9,15,4,5,5,10,4,4,0,1,7,0,1,3,0,27
5241,781456,34,6,11,6,9,0,2,4,5,2,1,0,1,1,3,0,16
5241,786795,3,0,0,0,0,0,0,0,0,1,0,0,0,0,0,0,0
5241,792091,20,3,7,1,2,2,5,0,0,1,3,1,2,2,1,0,8
5241,774954,20,1,2,1,2,0,0,1,1,1,3,6,2,0,0,0,3
5242,792626,28,3,8,3,7,0,1,5,10,3,5,5,5,1,4,1,11
5242,792627,26,3,5,3,5,0,0,1,2,0,3,1,0,2,1,0,7
5242,780250,31,2,6,2,4,0,2,0,0,0,3,1,4,0,3,1,4
5242,781491,33,4,7,2,4,2,3,0,0,2,2,5,2,0,3,0,10
5242,796637,24,6,9,6,9,0,0,1,3,2,4,1,1,0,1,0,13
5242,796645,23,2,6,2,5,0,1,5,8,2,1,2,2,1,2,1,9
5242,792632,18,2,4,2,4,0,0,1,2,2,2,0,2,0,0,2,5
5242,796638,12,1,4,1,2,0,2,0,0,0,0,1,1,0,0,0,2
5242,796634,1,0,2,0,2,0,0,0,0,0,0,0,0,0,0,0,0
5242,792629,4,0,2,0,1,0,1,0,0,0,0,0,0,0,1,0,0
5243,776089,30,2,5,1,3,1,2,0,0,0,0,5,0,1,1,1,5
5243,789177,32,6,11,6,11,0,0,2,2,5,11,2,5,1,2,3,14
5243,780227,28,3,7,3,7,0,0,6,8,2,5,0,3,1,3,0,12
5243,791340,25,5,9,5,9,0,0,0,0,0,0,4,2,1,1,0,10
5243,780181,34,9,17,6,10,3,7,3,3,1,2,2,4,0,3,0,24
5243,775758,10,0,1,0,1,0,0,0,0,0,2,0,1,0,0,1,0
5243,789178,11,0,1,0,0,0,1,0,0,0,2,0,1,0,0,1,0
5243,791336,30,2,9,2,7,0,2,6,8,1,3,1,2,2,0,0,10
5244,792288,17,3,7,3,6,0,1,0,0,1,1,0,2,1,0,0,6
5244,785227,21,0,0,0,0,0,0,1,2,1,1,0,3,0,1,2,1
5244,786237,37,13,22,13,22,0,0,6,7,3,8,5,1,2,0,1,32
5244,786232,34,5,8,1,3,4,5,4,4,0,2,2,2,3,1,1,18
5244,780287,29,3,11,3,8,0,3,3,3,0,3,3,1,1,0,0,9
5244,798067,15,2,4,2,4,0,0,0,0,2,3,0,4,2,2,1,4
5244,792278,21,1,6,1,1,0,5,4,6,0,1,1,1,1,0,0,6
5244,776309,24,4,7,2,2,2,5,0,0,0,2,1,3,1,1,0,10
5244,798072,2,0,0,0,0,0,0,0,0,0,0,0,0,0,0,0,0
5245,791839,32,6,9,6,9,0,0,0,0,2,8,2,0,2,3,0,12
5245,785322,32,4,8,1,1,3,7,4,6,1,3,0,1,0,1,0,15
5245,797444,35,2,4,1,2,1,2,3,4,3,4,2,3,0,0,0,8
5245,791842,25,6,11,4,7,2,4,7,8,0,4,4,5,0,3,0,21
5245,786613,21,4,10,3,8,1,2,0,0,0,2,1,2,0,2,0,9
5245,797443,14,1,3,1,2,0,1,3,3,1,2,0,1,0,3,1,5
5245,797442,30,1,7,0,3,1,4,0,0,0,2,2,2,0,4,0,3
5245,776341,11,0,0,0,0,0,0,1,2,0,3,1,1,0,1,0,1
5246,792158,22,4,5,4,5,0,0,4,4,1,3,1,3,1,1,2,12
5246,780138,29,6,9,6,9,0,0,5,5,2,3,2,1,2,2,0,17
5246,792154,30,8,12,5,7,3,5,2,2,0,3,4,1,1,1,0,21
5246,792152,29,6,9,3,3,3,6,2,2,0,4,5,4,1,2,0,17
5246,780581,25,6,10,5,7,1,3,0,0,1,2,5,2,0,3,0,13
5246,797755,12,1,3,1,2,0,1,0,0,2,1,0,0,1,0,2,2
5246,792162,3,1,3,1,2,0,1,0,0,0,0,0,0,0,0,0,2
5246,792157,15,1,2,1,2,0,0,2,2,2,3,0,4,0,3,1,4
5246,797759,3,0,0,0,0,0,0,0,0,0,0,0,0,0,0,0,0
5246,797756,13,1,2,1,2,0,0,2,2,0,0,1,3,1,2,0,4
5246,786014,19,3,7,1,3,2,4,2,2,0,3,1,2,1,1,0,10
5247,780201,28,2,7,2,7,0,0,4,6,1,1,1,1,1,2,0,8
5247,791469,36,4,5,4,5,0,0,1,3,6,7,0,4,2,0,2,9
5247,797210,26,4,11,3,10,1,1,3,3,1,0,4,3,0,3,0,12
5247,797208,35,5,10,5,9,0,1,2,4,1,0,0,1,2,5,0,12
5247,791467,29,4,11,3,8,1,3,0,0,1,1,2,2,1,0,0,9
5247,798344,7,1,4,1,4,0,0,2,2,0,3,0,3,1,1,0,4
5247,797209,3,1,1,1,1,0,0,0,0,1,1,0,0,0,0,0,2
5247,791470,8,2,3,2,3,0,0,3,3,0,1,1,1,1,1,0,7
5247,791471,2,1,1,1,1,0,0,0,0,0,0,0,0,0,0,0,2
5247,775516,26,3,11,3,9,0,2,1,2,1,1,5,1,3,2,0,7
5248,792418,32,2,8,2,7,0,1,6,6,1,3,0,0,2,3,2,10
5248,782654,9,0,1,0,1,0,0,0,0,0,1,1,4,0,0,0,0
5248,796693,31,4,15,2,8,2,7,4,4,0,3,2,2,1,5,0,14
5248,796691,20,3,4,1,2,2,2,0,0,0,2,0,3,0,0,0,8
5248,789484,36,3,10,2,6,1,4,6,6,0,8,4,3,1,5,1,13
5248,796695,1,1,1,1,1,0,0,0,0,1,0,0,0,0,0,0,2
5248,792424,20,0,0,0,0,0,0,0,0,2,2,1,2,1,1,1,0
5248,792419,8,0,0,0,0,0,0,0,0,0,2,0,0,0,0,0,0
5248,792421,18,3,6,1,1,2,5,0,0,0,1,0,2,0,3,0,8
5248,792422,18,1,2,1,1,0,1,0,1,1,2,0,2,0,0,0,2
5248,792423,7,0,0,0,0,0,0,0,0,1,0,0,0,1,0,0,0
5249,792399,22,5,9,5,9,0,0,0,1,4,5,0,1,0,2,0,10
5249,785471,25,2,5,2,5,0,0,2,4,2,2,0,3,1,3,1,6
5249,780263,32,6,13,6,10,0,3,2,2,2,6,1,3,3,1,1,14
5249,786697,36,4,9,4,6,0,3,2,3,0,1,4,1,0,1,1,10
5249,775628,29,5,7,4,4,1,3,2,6,0,3,3,4,3,1,0,13
5249,799000,9,3,7,3,7,0,0,0,0,0,3,0,4,0,1,0,6
5249,775198,29,1,3,1,2,0,1,2,2,2,0,1,1,4,2,0,4
5249,775547,3,0,3,0,3,0,0,0,0,2,0,0,0,0,1,0,0
5249,792397,0,0,0,0,0,0,0,0,0,0,0,0,0,0,0,0,0
5249,786695,2,0,0,0,0,0,0,0,0,0,0,0,0,0,0,0,0
5249,780571,13,1,3,0,1,1,2,0,0,0,1,1,0,0,0,0,3
5250,797050,31,1,4,0,2,1,2,0,0,0,6,1,2,0,3,2,3
5250,780394,32,3,7,1,1,2,6,0,0,0,1,2,1,0,1,0,8
5250,780391,27,2,7,2,7,0,0,0,0,2,6,1,3,0,1,2,4
5250,790871,35,7,13,3,3,4,10,5,7,0,3,3,4,1,3,0,23
5250,776473,25,3,9,1,3,2,6,0,0,0,3,1,4,1,3,0,8
5250,797048,22,3,11,3,10,0,1,0,0,3,5,1,3,0,1,0,6
5250,780392,12,2,5,2,2,0,3,2,2,0,1,0,1,1,1,0,6
5250,791573,16,1,6,0,1,1,5,0,0,0,1,3,1,1,1,0,3
5251,791194,29,1,5,1,2,0,3,0,0,0,6,0,1,1,1,0,2
5251,780384,21,1,3,1,3,0,0,0,3,1,5,0,1,0,1,0,2
5251,780159,24,3,5,3,5,0,0,2,5,2,5,2,3,3,2,0,8
5251,786738,37,6,14,4,9,2,5,5,5,2,4,1,2,2,1,0,19
5251,774827,30,5,13,4,7,1,6,10,10,0,3,3,1,2,4,0,21
5251,796863,20,3,7,2,4,1,3,0,0,0,2,3,0,1,0,0,7
5251,775694,16,2,6,2,5,0,1,0,0,1,0,1,2,0,2,0,4
5251,791193,18,1,2,1,2,0,0,0,1,1,1,0,2,0,0,5,2
5251,796865,5,1,1,0,0,1,1,0,0,0,1,0,0,0,0,0,3
5252,791454,30,5,8,4,7,1,1,4,4,2,7,1,4,0,0,2,15
5252,781526,12,3,5,3,5,0,0,7,8,3,2,0,4,0,2,0,13
5252,797217,33,0,5,0,0,0,5,0,1,0,3,4,2,0,1,0,0
5252,797218,34,7,17,5,10,2,7,2,2,2,4,3,2,1,0,1,18
5252,775697,34,2,11,0,4,2,7,5,8,1,2,3,2,1,2,0,11
5252,797222,16,2,5,2,5,0,0,2,2,4,11,0,3,0,1,1,6
5252,791453,15,2,6,0,1,2,5,0,0,0,1,2,1,1,0,0,6
5252,791846,9,3,4,3,3,0,1,0,0,0,2,2,0,0,1,0,6
5252,797223,17,3,3,3,3,0,0,1,1,1,1,0,2,0,0,0,7
5253,797142,24,2,2,2,2,0,0,0,0,0,2,0,4,0,0,1,4
5253,791522,39,10,20,8,15,2,5,4,5,3,7,2,2,2,3,1,26
5253,786351,29,2,6,2,5,0,1,0,1,1,3,0,5,0,1,1,4
5253,797146,36,6,20,5,12,1,8,5,8,2,0,0,1,0,0,0,18
5253,797143,36,2,11,1,4,1,7,1,2,1,3,3,2,0,1,0,6
5253,797147,13,1,3,1,2,0,1,4,4,0,1,1,4,0,0,1,6
5253,785479,10,1,2,1,1,0,1,0,0,2,0,0,1,1,0,0,2
5253,785816,13,1,1,1,1,0,0,1,2,0,2,0,4,0,0,0,3
5254,791440,25,6,7,6,7,0,0,5,5,2,3,0,3,1,0,3,17
5254,797019,18,1,3,1,3,0,0,0,0,0,3,5,0,0,1,0,2
5254,797016,28,6,12,2,4,4,8,0,0,0,1,5,2,0,3,0,16
5254,781378,32,5,11,1,5,4,6,2,2,0,4,6,2,2,3,1,16
5254,775267,27,2,7,1,1,1,6,0,0,0,3,3,2,2,2,0,5
5254,791443,11,1,4,1,2,0,2,0,0,0,3,0,2,1,0,0,2
5254,781629,0,0,0,0,0,0,0,0,0,0,0,0,0,0,0,0,0
5254,775739,15,1,2,1,2,0,0,0,0,0,1,0,0,1,1,1,2
5254,797015,7,1,2,1,2,0,0,0,0,1,2,0,1,3,3,0,2
5254,797013,17,3,8,2,3,1,5,0,0,0,0,0,3,0,2,0,7
5254,791441,6,0,2,0,1,0,1,0,0,1,0,0,0,1,1,1,0
5254,774959,14,1,1,1,1,0,0,0,1,2,0,1,0,0,1,1,2
5255,796996,35,6,9,6,9,0,0,5,5,6,2,1,3,2,2,0,17
5255,780471,29,5,10,5,10,0,0,0,0,3,6,1,3,1,4,0,10
5255,791613,12,1,2,1,2,0,0,0,0,0,0,0,2,0,1,0,2
5255,791608,34,5,11,2,3,3,8,2,2,0,1,3,2,1,1,0,15
5255,776011,29,6,10,5,8,1,2,0,1,0,6,6,2,2,4,0,13
5255,796994,19,1,4,1,3,0,1,0,0,0,0,3,1,2,2,0,2
5255,792071,18,2,6,0,0,2,6,0,0,0,3,0,1,1,2,0,6
5255,785680,24,3,8,2,4,1,4,2,2,0,2,1,0,1,1,0,9
5256,786623,10,1,4,1,4,0,0,4,5,2,0,0,1,0,1,1,6
5256,791834,38,8,15,5,9,3,6,1,2,1,2,0,3,1,2,1,20
5256,791833,16,0,2,0,2,0,0,2,4,0,4,2,3,1,1,0,2
5256,785920,38,8,16,8,14,0,2,0,0,2,8,7,2,1,1,0,16
5256,785698,13,0,4,0,1,0,3,1,2,0,3,1,1,0,1,0,1
5256,797413,5,0,1,0,1,0,0,0,0,0,0,0,0,1,0,0,0
5256,797410,7,0,0,0,0,0,0,0,0,0,1,0,1,0,0,0,0
5256,786624,21,1,3,1,3,0,0,0,1,1,2,0,4,1,1,1,2
5256,797404,23,5,9,2,2,3,7,0,1,1,2,1,4,0,1,0,13
5256,797403,3,0,2,0,0,0,2,0,0,0,0,0,0,0,0,1,0
5256,784077,26,2,9,1,6,1,3,2,2,0,4,0,1,2,1,0,7
5257,791564,19,5,6,2,2,3,4,2,2,1,2,2,2,1,1,1,15
5257,775549,19,2,9,2,9,0,0,4,6,1,2,0,5,1,4,3,8
5257,797054,31,3,9,2,7,1,2,0,2,0,4,2,2,0,0,0,7
5257,791568,20,1,4,1,2,0,2,1,2,0,2,1,2,1,1,1,3
5257,786381,34,0,0,0,0,0,0,3,5,0,8,4,3,0,0,0,3
5257,797058,13,2,5,0,0,2,5,0,1,0,6,1,1,0,1,0,6
5257,780425,21,2,4,2,4,0,0,0,0,2,4,2,2,1,1,0,4
5257,797056,26,8,14,4,7,4,7,2,2,0,5,3,4,0,5,0,22
5257,797055,17,2,5,0,1,2,4,2,2,0,1,1,0,0,1,0,8
5258,796912,30,1,9,1,3,0,6,2,2,1,1,2,2,0,1,1,4
5258,775626,33,3,9,3,8,0,1,4,7,3,2,2,3,1,2,1,10
5258,774964,35,7,11,7,11,0,0,1,2,4,8,3,3,0,1,1,15
5258,796907,24,3,6,2,3,1,3,0,0,2,3,1,3,0,2,2,7
5258,774962,34,5,12,2,6,3,6,5,5,0,3,1,2,1,4,0,18
5258,796910,10,0,2,0,1,0,1,0,0,1,1,0,3,0,0,0,0
5258,796906,10,1,3,1,2,0,1,0,0,0,0,0,1,1,1,0,2
5258,775566,22,2,7,1,2,1,5,0,0,0,2,1,1,1,0,0,5
5258,785606,2,0,1,0,1,0,0,0,0,1,0,0,2,0,0,0,0
5259,786123,24,2,3,2,3,0,0,2,2,2,2,3,2,1,2,3,6
5259,797673,35,3,14,3,9,0,5,2,3,2,8,0,2,1,3,0,8
5259,792093,14,0,3,0,3,0,0,1,2,0,0,0,1,0,0,0,1
5259,786118,40,5,8,2,3,3,5,1,2,1,8,4,3,1,5,0,14
5259,786117,35,6,14,6,11,0,3,5,7,0,2,5,3,1,1,0,17
5259,780437,36,4,11,4,11,0,0,4,5,5,5,2,1,0,1,2,12
5259,797675,16,2,3,2,3,0,0,3,4,2,1,0,2,1,3,0,7
5260,786569,26,3,5,3,5,0,0,3,5,4,3,1,3,0,4,1,9
5260,791726,33,4,9,2,4,2,5,2,3,0,2,0,1,1,2,0,12
5260,786273,34,3,13,2,7,1,6,4,5,0,5,5,1,1,2,1,11
5260,780773,37,4,11,3,8,1,3,3,4,2,11,2,3,0,6,0,12
5260,775228,34,0,1,0,0,0,1,0,2,1,2,1,2,0,0,0,0
5260,797313,21,1,3,1,2,0,1,0,0,0,6,0,2,1,2,0,2
5260,791728,1,0,2,0,2,0,0,0,0,0,1,0,0,0,0,0,0
5260,797317,14,0,2,0,1,0,1,1,2,0,0,1,1,0,0,0,1
5261,792131,19,0,3,0,2,0,1,2,2,1,3,1,0,2,1,0,2
5261,786838,34,3,9,2,7,1,2,0,2,2,6,3,3,2,3,7,7
5261,797736,23,1,5,0,2,1,3,0,0,1,2,0,3,0,2,0,3
5261,792132,28,3,8,3,7,0,1,0,0,0,2,0,3,1,1,0,6
5261,792127,34,3,16,1,11,2,5,1,2,2,3,2,3,0,1,1,9
5261,799273,6,0,1,0,1,0,0,0,0,0,2,0,0,1,1,0,0
5261,792128,21,2,8,1,5,1,3,1,2,3,5,0,1,1,1,0,6
5261,799908,11,0,1,0,1,0,0,0,0,0,0,0,0,0,1,0,0
5261,797739,18,3,5,2,3,1,2,0,0,0,1,1,3,3,1,0,7
5261,791668,6,0,0,0,0,0,0,0,0,0,1,0,1,0,2,0,0
5262,786296,32,5,8,2,4,3,4,2,2,0,1,0,2,4,0,0,15
5262,781530,18,7,10,6,8,1,2,3,3,0,2,1,2,1,0,0,18
5262,776423,24,4,8,4,8,0,0,4,4,1,6,2,1,0,1,1,12
5262,792307,27,2,9,1,5,1,4,0,0,0,4,1,3,1,0,0,5
5262,792319,26,0,4,0,3,0,1,6,6,1,2,1,1,1,1,0,6
5262,792316,5,0,1,0,1,0,0,1,2,1,0,0,0,0,0,0,1
5262,792314,19,1,6,1,6,0,0,1,2,1,6,0,1,1,0,0,3
5262,792320,13,0,3,0,3,0,0,1,2,2,2,0,3,0,2,0,1
5262,792309,21,2,6,2,5,0,1,0,0,1,3,3,2,0,3,1,4
5262,792321,15,1,5,1,5,0,0,0,0,1,1,0,1,1,1,0,2
5263,791042,22,3,9,2,6,1,3,3,4,2,5,2,1,1,2,0,10
5263,774834,14,0,2,0,0,0,2,0,0,0,1,0,1,0,1,2,0
5263,791043,28,2,9,0,5,2,4,2,3,0,2,1,3,1,4,0,8
5263,776374,20,0,1,0,1,0,0,0,0,0,2,1,3,1,3,0,0
5263,775412,14,0,1,0,0,0,1,0,0,0,1,0,0,2,1,0,0
5263,796723,15,3,5,2,4,1,1,2,2,0,1,1,2,1,1,1,9
5263,796719,22,1,5,1,2,0,3,0,0,1,4,0,2,1,0,0,2
5263,785512,18,0,1,0,1,0,0,4,6,0,2,0,1,0,1,0,4
5263,796718,13,0,2,0,1,0,1,0,1,0,1,1,0,0,2,0,0
5263,796717,16,1,3,0,1,1,2,1,2,2,3,1,3,0,2,0,4
5263,796720,18,2,5,2,3,0,2,3,4,0,2,0,0,0,1,1,7
5264,791750,34,3,9,0,4,3,5,2,2,5,1,1,2,0,2,0,11
5264,786177,32,0,3,0,0,0,3,0,0,1,5,0,3,0,0,3,0
5264,780244,37,3,5,0,1,3,4,0,0,1,10,1,2,2,0,1,9
5264,786179,33,5,13,3,8,2,5,4,7,1,2,1,2,1,3,0,16
5264,780238,40,9,22,8,18,1,4,2,5,2,5,4,3,1,2,0,21
5264,785909,6,1,1,1,1,0,0,0,0,0,0,0,0,0,0,0,2
5264,797346,4,0,0,0,0,0,0,0,0,0,0,0,0,0,0,0,0
5264,790773,12,2,3,2,3,0,0,0,0,1,0,0,2,0,0,0,4
5264,781500,2,0,1,0,1,0,0,0,0,0,0,0,0,0,0,0,0
5265,792121,40,3,9,2,5,1,4,0,0,1,8,1,4,1,1,2,7
5265,786257,37,4,7,3,6,1,1,0,0,1,6,2,2,2,2,0,9
5265,786263,40,4,9,2,4,2,5,1,3,0,3,0,2,0,0,0,11
5265,785661,36,10,15,10,13,0,2,0,0,0,4,3,4,0,1,1,20
5265,775825,40,4,7,3,6,1,1,9,9,0,2,3,2,1,3,0,18
5265,797725,3,0,0,0,0,0,0,0,0,0,0,0,2,0,0,0,0
5265,786249,4,0,1,0,0,0,1,2,2,0,2,0,0,0,0,0,2
5266,785829,26,2,3,2,3,0,0,1,2,0,4,1,0,0,2,0,5
5266,775838,21,2,5,2,4,0,1,3,6,1,4,1,4,0,2,0,7
5266,796726,26,2,5,0,1,2,4,0,0,0,3,0,0,1,2,0,6
5266,791048,21,0,1,0,1,0,0,1,2,0,1,2,3,1,0,1,1
5266,786531,31,5,11,3,5,2,6,0,0,0,1,1,3,0,0,0,12
5266,796728,4,0,1,0,0,0,1,0,0,0,0,0,0,0,0,0,0
5266,791044,14,4,4,4,4,0,0,0,2,0,4,1,3,0,2,0,8
5266,780723,9,1,3,1,1,0,2,0,0,0,1,0,0,0,0,0,2
5266,796729,25,2,6,2,4,0,2,5,6,0,1,4,0,2,0,0,9
5266,796724,14,1,4,1,3,0,1,1,1,1,0,1,1,0,1,0,3
5266,796727,8,0,1,0,0,0,1,0,0,0,0,0,0,0,0,0,0
5266,791045,1,0,1,0,0,0,1,0,0,0,0,0,0,0,0,0,0
5267,791760,19,6,7,6,7,0,0,1,2,2,0,0,1,0,2,0,13
5267,780256,30,5,8,4,5,1,3,1,1,2,5,1,3,3,0,0,12
5267,796879,31,2,13,0,8,2,5,0,0,4,3,4,1,0,0,0,6
5267,796880,35,6,14,4,8,2,6,0,1,2,3,1,1,0,4,0,14
5267,791334,27,5,10,4,6,1,4,1,2,0,7,3,4,0,1,0,12
5267,785874,21,2,5,2,4,0,1,1,3,5,6,2,2,0,0,0,5
5267,796883,26,2,5,2,4,0,1,0,0,1,1,5,2,1,2,0,4
5267,781590,8,3,5,1,2,2,3,0,0,1,4,0,1,0,0,0,8
5267,785876,1,0,0,0,0,0,0,0,0,0,1,0,0,0,0,0,0
5267,796885,1,0,0,0,0,0,0,0,0,0,0,0,0,0,0,0,0
5267,791331,1,1,1,1,1,0,0,0,0,0,0,0,0,0,0,0,2
5268,780229,26,3,6,3,6,0,0,1,4,3,6,5,2,0,5,3,7
5268,795572,33,6,12,4,10,2,2,1,2,2,5,0,3,2,1,2,15
5268,791483,29,2,5,1,3,1,2,8,8,0,4,0,2,0,1,0,13
5268,786322,31,2,3,1,1,1,2,1,2,1,3,2,4,0,1,1,6
5268,780228,24,0,5,0,1,0,4,0,0,1,3,1,0,1,1,0,0
5268,791487,5,0,1,0,0,0,1,0,0,1,0,0,0,0,0,0,0
5268,781592,29,4,9,3,7,1,2,11,14,1,5,1,1,0,0,3,20
5268,797195,5,0,1,0,0,0,1,1,2,0,1,0,0,0,1,0,1
5268,797193,18,4,4,3,3,1,1,0,2,0,2,2,1,2,1,0,9
5269,791083,22,0,5,0,1,0,4,0,0,2,1,0,1,0,1,1,0
5269,785294,27,1,7,1,7,0,0,0,0,2,6,2,2,1,1,1,2
5269,791085,34,6,14,6,8,0,6,1,2,1,1,1,2,0,2,0,13
5269,791080,34,9,13,7,9,2,4,2,2,1,4,2,3,1,1,0,22
5269,785675,32,6,20,3,10,3,10,0,0,4,2,0,3,2,1,0,15
5269,796511,24,0,4,0,1,0,3,0,0,3,5,1,2,0,2,0,0
5269,791081,4,0,0,0,0,0,0,0,0,1,0,0,4,0,0,1,0
5269,796515,9,0,3,0,0,0,3,0,0,0,0,0,0,0,0,0,0
5269,786446,14,2,7,2,4,0,3,0,0,0,0,0,5,0,2,0,4
5270,797831,29,1,6,1,3,0,3,0,0,1,6,2,1,0,0,0,2
5270,797823,23,1,4,0,2,1,2,2,2,1,5,0,2,0,1,1,5
5270,797829,29,4,6,4,6,0,0,2,3,1,3,0,3,0,0,1,10
5270,792280,34,6,11,2,5,4,6,0,0,1,2,2,4,3,2,0,16
5270,780505,37,8,20,7,17,1,3,4,5,0,1,3,1,2,3,0,21
5270,792283,16,1,3,1,2,0,1,0,0,1,2,2,3,1,2,0,2
5270,785701,6,0,0,0,0,0,0,0,0,0,1,0,0,0,0,0,0
5270,785950,4,0,0,0,0,0,0,0,0,0,1,0,0,0,1,0,0
5270,792286,11,0,0,0,0,0,0,0,0,1,1,0,2,0,2,0,0
5270,799468,4,0,1,0,1,0,0,0,0,0,0,0,0,0,0,0,0
5270,792284,7,1,1,0,0,1,1,0,0,0,0,0,1,0,2,0,3
5271,775640,17,3,4,3,4,0,0,0,0,1,0,1,1,0,0,0,6
5271,780919,30,6,11,6,11,0,0,4,4,0,5,0,3,1,2,1,16
5271,785803,26,0,2,0,2,0,0,0,0,0,2,2,3,0,0,4,0
5271,780920,26,5,9,5,7,0,2,2,2,0,7,5,0,0,4,1,12
5271,780914,35,4,8,3,5,1,3,2,3,1,1,2,1,2,1,0,11
5271,796797,15,3,3,2,2,1,1,2,4,0,2,0,1,0,1,0,9
5271,775816,18,1,4,0,2,1,2,2,2,0,3,3,2,1,2,0,5
5271,796801,3,0,1,0,1,0,0,0,0,0,0,1,1,0,0,0,0
5271,791142,19,2,6,0,1,2,5,0,0,0,1,1,1,0,1,0,6
5271,791141,11,2,4,1,3,1,1,0,0,0,0,0,0,0,0,0,5
5272,786547,28,2,4,1,2,1,2,0,0,1,6,0,1,0,1,1,5
5272,786544,24,4,11,4,9,0,2,4,5,2,6,1,5,0,5,0,12
5272,797507,33,2,4,1,1,1,3,0,0,1,0,1,1,0,5,0,5
5272,792012,40,7,15,4,7,3,8,4,6,0,0,1,2,2,1,0,21
5272,775084,37,7,11,5,7,2,4,1,1,0,2,1,0,0,3,0,17
5272,797512,10,0,1,0,1,0,0,0,0,0,1,0,2,0,1,0,0
5272,786860,17,0,1,0,0,0,1,0,0,0,1,1,2,0,0,1,0
5272,786546,10,0,0,0,0,0,0,0,0,0,1,1,1,1,0,1,0
5272,797509,1,0,0,0,0,0,0,0,0,0,0,0,0,0,0,0,0
5273,792340,18,4,5,3,4,1,1,2,4,0,0,0,3,1,1,0,11
5273,792341,27,2,3,2,2,0,1,1,2,1,1,0,1,1,0,0,5
5273,792342,40,3,9,2,6,1,3,1,1,0,5,3,2,0,2,0,8
5273,792346,39,1,6,0,5,1,1,2,4,4,6,1,4,2,5,0,5
5273,781552,40,9,15,8,11,1,4,1,2,1,3,3,2,0,4,0,20
5273,798080,1,0,0,0,0,0,0,0,0,0,1,0,0,0,0,0,0
5273,792344,4,0,1,0,1,0,0,0,0,1,0,0,2,0,0,0,0
5273,775599,31,4,9,3,5,1,4,0,0,0,4,0,3,3,2,1,9
5274,775954,26,3,7,3,7,0,0,1,1,2,4,0,3,0,5,0,7
5274,796194,38,1,3,0,2,1,1,0,4,1,2,4,1,1,4,0,3
5274,796464,25,3,5,2,2,1,3,1,2,2,0,3,3,0,3,0,8
5274,790917,29,4,12,2,7,2,5,2,3,2,3,1,4,1,1,1,12
5274,781006,35,6,11,3,3,3,8,5,5,2,3,0,4,0,1,2,20
5274,781157,32,4,7,2,4,2,3,2,2,0,1,3,2,2,2,0,12
5274,790916,8,0,1,0,0,0,1,2,4,0,1,0,2,0,0,1,2
5274,790918,2,0,1,0,1,0,0,0,0,0,1,0,0,0,0,0,0
5274,780648,3,0,0,0,0,0,0,0,0,0,1,0,1,0,0,0,0
5274,790919,2,0,1,0,0,0,1,0,0,0,0,1,0,0,0,0,0
5275,790863,21,1,2,0,0,1,2,5,6,3,4,1,5,2,1,0,8
5275,780021,30,3,8,3,8,0,0,3,6,3,2,1,4,1,1,2,9
5275,785412,30,10,14,7,11,3,3,4,4,1,3,2,2,3,5,0,27
5275,780099,28,2,8,2,4,0,4,2,2,1,1,1,3,3,1,0,6
5275,776214,36,7,18,4,9,3,9,1,2,0,4,2,3,1,0,0,18
5275,776221,7,0,1,0,1,0,0,0,0,0,0,3,0,0,0,0,0
5275,775686,25,0,1,0,1,0,0,0,0,1,4,0,1,0,1,0,0
5275,785413,23,2,5,1,4,1,1,0,0,1,3,1,1,0,2,0,5
5276,797620,29,4,9,3,6,1,3,2,3,0,3,0,2,1,1,1,11
5276,781044,22,6,8,3,4,3,4,2,2,1,5,1,2,2,3,1,17
5276,786489,29,6,9,4,5,2,4,0,0,0,3,0,1,1,0,1,14
5276,786488,27,1,3,1,2,0,1,0,0,0,2,5,1,2,1,0,2
5276,781038,29,6,7,4,4,2,3,1,2,0,4,4,1,0,1,1,15
5276,797619,18,2,3,2,3,0,0,4,4,0,2,2,2,1,1,0,8
5276,786487,20,4,7,3,4,1,3,3,3,1,5,1,2,2,2,0,12
5276,791796,8,0,1,0,1,0,0,0,0,0,0,0,2,0,1,0,0
5276,797623,6,1,1,1,1,0,0,0,0,0,2,1,0,0,1,0,2
5276,786490,9,1,2,1,2,0,0,1,2,2,0,0,1,0,2,0,3
5276,797622,3,0,0,0,0,0,0,0,0,0,0,0,1,0,0,1,0
5277,796860,26,3,9,3,7,0,2,0,1,1,3,1,3,0,2,0,6
5277,791183,27,3,5,3,5,0,0,4,4,0,2,1,2,0,2,0,10
5277,791185,28,3,9,2,4,1,5,1,2,2,2,0,2,1,3,0,8
5277,785650,26,3,6,0,2,3,4,0,0,0,1,1,2,0,1,0,9
5277,785649,27,5,11,5,8,0,3,0,0,1,2,1,0,0,2,0,10
5277,775208,13,1,2,1,2,0,0,0,0,0,2,0,2,1,1,0,2
5277,796861,11,0,3,0,2,0,1,0,0,0,1,0,1,0,0,0,0
5277,791184,18,0,2,0,1,0,1,1,2,0,1,2,2,0,2,0,1
5277,796857,14,3,5,2,2,1,3,0,0,1,1,0,1,0,0,0,7
5277,796858,2,1,2,1,2,0,0,0,1,0,0,0,0,0,0,0,2
5277,796862,2,0,0,0,0,0,0,0,0,0,0,1,0,0,1,0,0
5277,793803,3,1,2,0,0,1,2,0,0,1,0,0,0,0,0,0,3
5277,796859,3,0,0,0,0,0,0,0,0,0,0,0,0,0,0,0,0
5278,796892,20,2,6,2,6,0,0,1,2,1,1,1,2,0,0,0,5
5278,796886,25,1,6,1,5,0,1,1,2,0,3,2,2,2,4,0,3
5278,796884,29,2,7,1,2,1,5,1,2,0,1,2,5,0,1,0,6
5278,796882,29,5,8,5,7,0,1,4,4,1,4,0,1,2,2,0,14
5278,790447,23,2,5,2,5,0,0,2,2,0,1,0,1,0,1,1,6
5278,796891,19,2,4,2,3,0,1,1,2,0,3,0,4,0,1,0,5
5278,796890,3,0,2,0,1,0,1,0,0,1,1,0,3,0,2,0,0
5278,796896,14,0,1,0,1,0,0,0,1,0,1,2,3,0,1,0,0
5278,796894,3,0,0,0,0,0,0,0,0,0,0,0,1,0,0,0,0
5278,796888,12,0,1,0,1,0,0,1,2,1,2,0,1,0,0,0,1
5278,796887,14,2,3,1,1,1,2,0,0,0,1,0,1,1,5,1,5
5278,796881,6,0,0,0,0,0,0,1,2,0,2,1,0,0,0,0,1
5278,776336,3,0,2,0,1,0,1,0,0,0,0,0,2,1,1,0,0
5279,776279,21,2,7,2,3,0,4,1,2,0,0,5,1,1,1,0,5
5279,781505,25,6,10,5,7,1,3,0,0,0,6,2,2,0,1,0,13
5279,780353,27,6,6,6,6,0,0,4,5,2,7,0,4,2,2,1,16
5279,791317,22,4,9,2,6,2,3,0,0,0,3,2,2,1,1,1,10
5279,777573,21,2,5,1,2,1,3,2,2,0,0,0,0,0,0,0,7
5279,791318,3,1,1,1,1,0,0,0,0,0,3,0,0,0,0,0,2
5279,786222,19,2,4,2,3,0,1,2,2,4,8,0,4,1,0,0,6
5279,785966,5,0,0,0,0,0,0,4,4,0,0,0,0,0,0,0,4
5279,796646,5,0,0,0,0,0,0,3,4,0,0,0,2,0,2,0,3
5279,796647,2,0,1,0,0,0,1,1,2,0,1,1,1,0,0,0,1
5279,796649,18,4,8,2,3,2,5,1,1,0,0,1,3,0,0,0,11
5279,790851,16,0,3,0,3,0,0,0,2,0,2,1,0,2,1,0,0
5279,796648,14,1,3,0,1,1,2,0,0,2,0,2,2,0,2,0,3
5279,788965,1,0,0,0,0,0,0,0,0,0,0,0,0,0,0,0,0
5279,791319,1,0,0,0,0,0,0,0,0,0,0,0,0,0,0,0,0
5280,790799,16,4,7,4,5,0,2,0,0,0,4,0,1,1,0,1,8
5280,790798,24,8,11,7,10,1,1,5,7,2,5,2,1,1,2,1,22
5280,780140,23,5,12,2,6,3,6,3,3,1,6,0,2,0,2,0,16
5280,796355,30,3,10,2,6,1,4,2,2,2,9,8,1,1,4,0,9
5280,780137,28,3,6,1,2,2,4,4,4,3,1,2,1,1,0,1,12
5280,785245,15,3,5,1,2,2,3,1,2,0,1,2,1,1,0,0,9
5280,775553,11,0,1,0,1,0,0,2,4,0,2,1,1,1,0,0,2
5280,790796,13,0,1,0,1,0,0,0,0,1,2,1,1,0,1,1,0
5280,796359,12,3,3,1,1,2,2,3,3,1,2,1,2,0,0,0,11
5280,796354,14,1,4,1,1,0,3,1,2,0,3,0,2,0,0,0,3
5280,799892,6,1,1,0,0,1,1,0,0,0,2,1,3,0,2,0,3
5280,790800,3,0,1,0,1,0,0,0,0,1,0,0,2,0,0,0,0
5280,794905,1,0,0,0,0,0,0,0,0,0,0,0,0,0,0,0,0
5280,790795,4,0,1,0,1,0,0,0,0,0,0,1,0,0,0,0,0
5281,786550,29,1,5,1,4,0,1,0,0,0,4,0,2,2,2,0,2
5281,776054,25,3,9,3,7,0,2,0,0,2,5,0,3,0,0,0,6
5281,792007,19,1,9,1,5,0,4,0,2,2,4,0,4,0,0,2,2
5281,792009,35,7,15,6,12,1,3,2,3,3,1,0,1,1,5,0,17
5281,792006,21,4,13,4,12,0,1,3,4,1,2,1,1,0,2,0,11
5281,792008,9,0,0,0,0,0,0,0,0,0,0,0,2,0,0,1,0
5281,792011,16,1,4,1,4,0,0,4,8,6,1,0,3,1,1,0,6
5281,776273,9,0,4,0,3,0,1,0,0,0,0,0,0,0,0,0,0
5281,786552,15,1,4,1,3,0,1,0,0,0,2,0,0,0,1,0,2
5281,791689,12,0,0,0,0,0,0,0,0,0,0,2,3,0,1,0,0
5281,797506,10,1,5,0,2,1,3,0,0,0,1,0,1,1,0,1,3
5282,790844,23,0,2,0,2,0,0,1,2,0,1,0,1,0,1,0,1
5282,780094,36,3,10,2,3,1,7,4,6,1,2,2,4,0,0,0,11
5282,775142,35,5,16,4,9,1,7,4,7,3,6,2,3,0,2,0,15
5282,796914,21,5,7,2,3,3,4,0,0,0,0,0,4,1,0,0,13
5282,781563,37,2,9,1,4,1,5,0,0,0,2,3,3,0,1,0,5
5282,799986,6,1,1,1,1,0,0,3,4,0,1,0,2,1,0,0,5
5282,792125,22,4,6,3,3,1,3,1,1,0,3,1,1,2,2,0,10
5282,790847,12,1,2,0,0,1,2,1,2,0,2,0,1,0,1,2,4
5282,781161,3,0,1,0,0,0,1,0,0,0,1,0,0,0,0,0,0
5282,796915,5,0,0,0,0,0,0,0,1,0,0,0,0,1,0,0,0
5283,790854,19,3,3,3,3,0,0,2,2,0,1,0,4,0,1,0,8
5283,796404,23,7,10,7,10,0,0,0,0,7,9,0,3,1,1,2,14
5283,790850,31,4,10,1,4,3,6,2,2,0,1,0,0,1,2,0,13
5283,781164,29,3,6,3,3,0,3,2,2,0,7,4,0,0,1,0,8
5283,781163,34,3,11,2,8,1,3,12,14,0,2,2,1,0,2,0,19
5283,790849,22,2,5,1,4,1,1,2,2,0,3,3,0,1,2,0,7
5283,790853,4,0,0,0,0,0,0,0,0,0,0,0,3,0,1,0,0
5283,790848,6,0,0,0,0,0,0,0,0,0,1,1,2,0,0,0,0
5283,785434,20,1,5,1,2,0,3,2,2,0,4,0,2,0,2,0,4
5283,796406,9,1,2,1,2,0,0,0,0,2,2,0,3,0,0,0,2
5283,781223,3,0,1,0,1,0,0,0,0,0,0,0,1,0,0,0,0
5304,785432,17,3,7,3,6,0,1,0,0,2,5,0,0,0,1,1,6
5304,790882,18,1,2,1,2,0,0,0,0,0,1,3,2,0,1,0,2
5304,790876,35,7,14,3,5,4,9,4,4,0,4,2,1,0,0,0,22
5304,785699,23,2,3,1,1,1,2,2,4,0,7,3,5,3,2,0,7
5304,774987,39,3,11,3,7,0,4,10,11,0,3,4,2,1,3,1,16
5304,790877,18,2,4,1,2,1,2,2,2,1,2,0,2,0,0,0,7
5304,779985,21,2,5,1,2,1,3,0,0,1,4,0,0,1,2,0,5
5304,781062,25,4,7,2,4,2,3,0,1,1,2,2,0,1,1,0,10
5304,790879,4,0,0,0,0,0,0,0,0,0,2,0,1,0,0,0,0
5305,790810,31,5,7,3,4,2,3,1,3,0,0,0,2,1,3,1,13
5305,785362,16,4,10,4,10,0,0,1,1,0,2,4,2,1,0,1,9
5305,790808,33,0,5,0,2,0,3,2,2,0,1,1,2,1,0,0,2
5305,785361,33,3,8,1,2,2,6,2,4,1,2,2,2,0,4,0,10
5305,779997,37,8,12,5,7,3,5,2,2,0,12,1,4,1,3,0,21
5305,774854,12,3,4,3,4,0,0,0,0,1,2,0,3,0,0,0,6
5305,790811,12,0,3,0,1,0,2,2,2,0,0,0,2,1,1,0,2
5305,796368,5,0,2,0,0,0,2,0,0,0,2,0,0,0,0,0,0
5305,790809,21,2,3,1,2,1,1,0,0,0,2,4,3,1,0,0,5
5306,780890,22,3,6,1,3,2,3,0,0,1,2,0,1,0,3,0,8
5306,775757,7,0,2,0,2,0,0,0,0,0,1,0,3,0,1,1,0
5306,786066,32,5,7,3,4,2,3,0,0,2,4,1,3,0,4,0,12
5306,780167,36,6,12,6,9,0,3,6,6,0,4,3,2,1,0,1,18
5306,775574,34,5,12,2,6,3,6,0,0,0,1,5,1,1,0,0,13
5306,786646,29,3,10,3,5,0,5,3,4,1,2,1,3,1,0,0,9
5306,791123,11,1,2,1,2,0,0,0,0,0,1,0,2,0,1,0,2
5306,785636,29,2,4,2,3,0,1,0,0,0,2,2,1,2,0,1,4
5307,785800,27,5,10,2,3,3,7,4,4,1,4,1,0,2,2,0,17
5307,785799,20,2,8,2,8,0,0,1,2,5,3,1,2,1,1,0,5
5307,791676,29,4,11,4,6,0,5,1,1,0,0,4,1,0,1,0,9
5307,780554,28,4,8,4,6,0,2,2,2,2,5,1,2,0,0,0,10
5307,780553,27,4,9,4,9,0,0,0,0,1,5,2,4,0,2,0,8
5307,797426,13,5,6,3,4,2,2,0,0,1,2,0,0,0,0,0,12
5307,791678,8,2,2,2,2,0,0,0,0,0,1,0,1,0,1,0,4
5307,785807,7,0,0,0,0,0,0,0,0,0,1,0,1,0,0,0,0
5307,780760,20,4,6,4,5,0,1,1,2,1,2,1,2,0,0,2,9
5307,797427,15,0,4,0,1,0,3,0,0,0,1,1,1,1,0,0,0
5307,791677,6,0,0,0,0,0,0,0,0,0,0,2,0,0,0,0,0
5308,775110,26,1,6,1,6,0,0,2,2,2,8,1,4,0,1,0,4
5308,791392,26,2,5,1,2,1,3,0,0,0,1,4,4,1,2,0,5
5308,785936,20,1,6,1,3,0,3,0,0,1,1,1,3,1,2,0,2
5308,780128,30,5,12,3,6,2,6,0,0,0,0,4,2,1,2,0,12
5308,775458,32,13,20,12,17,1,3,5,5,1,4,1,2,3,1,1,32
5308,797134,2,0,0,0,0,0,0,0,0,0,0,0,0,0,1,0,0
5308,791394,5,0,0,0,0,0,0,0,0,0,0,1,1,1,0,0,0
5308,786062,6,0,0,0,0,0,0,0,0,0,0,0,0,0,0,0,0
5308,781353,2,0,1,0,1,0,0,0,0,0,0,0,0,0,0,0,0
5308,797138,14,1,3,0,2,1,1,0,2,0,0,2,1,1,3,0,3
5308,797135,19,2,4,1,2,1,2,0,0,0,3,0,2,0,0,0,5
5308,785264,18,4,7,4,5,0,2,1,2,0,0,0,2,0,1,0,9
5309,786059,29,7,8,4,5,3,3,3,4,2,4,2,0,0,1,2,20
5309,776174,24,5,11,5,11,0,0,3,5,2,6,2,1,0,4,0,13
5309,791958,33,5,10,5,8,0,2,6,6,2,5,4,0,2,2,0,16
5309,791960,30,4,9,2,3,2,6,0,0,0,2,6,3,0,2,0,10
5309,785861,30,6,9,2,4,4,5,0,0,1,5,3,1,3,3,0,16
5309,786063,4,0,0,0,0,0,0,2,2,0,1,0,0,0,0,0,2
5309,781334,4,0,1,0,0,0,1,3,4,0,1,0,0,0,0,0,3
5309,797706,4,0,0,0,0,0,0,0,0,0,0,0,0,0,1,0,0
5309,797704,11,1,4,0,0,1,4,0,0,0,2,1,2,0,0,0,3
5309,791957,3,0,0,0,0,0,0,0,0,0,0,0,0,0,0,0,0
5309,791959,4,2,2,2,2,0,0,0,0,1,1,0,1,0,0,0,4
5309,781332,24,4,7,1,1,3,6,2,2,1,1,3,2,1,0,0,13
5310,790914,21,1,3,1,3,0,0,2,2,4,6,0,1,2,4,1,4
5310,780798,31,3,7,3,4,0,3,0,0,3,3,3,3,1,0,1,6
5310,785455,33,4,16,3,11,1,5,7,10,1,4,6,3,0,4,0,16
5310,785453,34,6,10,0,2,6,8,5,9,1,1,2,2,1,0,0,23
5310,774940,15,1,5,1,4,0,1,2,2,0,0,1,2,2,0,0,4
5310,785458,28,9,17,8,15,1,2,5,6,1,4,0,3,2,3,1,24
5310,790911,4,0,1,0,0,0,1,0,0,0,0,0,0,0,0,0,0
5310,790913,14,3,5,2,3,1,2,0,0,2,1,1,1,0,1,1,7
5310,785454,9,0,3,0,1,0,2,0,0,0,0,1,1,0,0,0,0
5310,785456,7,1,1,1,1,0,0,0,0,0,0,0,0,1,0,0,2
5310,800055,4,0,0,0,0,0,0,0,0,0,0,0,0,0,1,0,0
5311,796699,23,5,10,4,8,1,2,3,3,3,4,0,2,0,0,2,14
5311,790983,23,8,12,6,9,2,3,0,0,2,5,2,2,0,1,0,18
5311,790979,32,7,12,3,6,4,6,6,6,2,4,4,3,1,4,1,24
5311,796697,27,4,10,2,7,2,3,6,7,1,5,12,4,0,3,2,16
5311,788820,26,2,8,1,4,1,4,0,0,0,1,0,2,1,0,0,5
5311,796701,11,4,7,4,7,0,0,0,0,2,0,0,1,0,2,0,8
5311,790978,18,4,8,2,3,2,5,0,0,1,2,0,1,1,0,0,10
5311,790976,11,1,2,1,2,0,0,0,0,0,2,0,1,1,0,1,2
5311,790980,12,2,3,2,3,0,0,0,0,1,2,0,1,0,2,0,4
5311,796698,9,1,1,1,1,0,0,0,0,1,0,1,2,0,0,0,2
5311,790977,5,2,4,0,0,2,4,0,0,0,1,0,0,0,0,0,6
5311,789457,3,0,0,0,0,0,0,0,0,0,0,2,0,0,1,0,0
5312,792181,34,6,11,5,9,1,2,7,9,3,6,1,4,0,1,1,20
5312,780986,40,5,9,5,9,0,0,8,8,2,4,1,2,0,2,0,18
5312,785902,37,7,11,6,8,1,3,0,1,3,7,1,2,2,1,7,15
5312,792179,33,2,5,2,3,0,2,1,2,0,5,4,1,3,0,0,5
5312,786662,39,3,13,2,8,1,5,0,0,0,3,3,1,2,1,0,7
5312,797796,15,5,6,4,5,1,1,2,2,0,1,1,3,0,1,0,13
5312,792177,2,0,0,0,0,0,0,0,0,0,0,0,1,0,0,0,0
5313,781342,24,1,10,1,9,0,1,0,0,3,1,4,4,0,1,0,2
5313,781593,29,3,5,3,5,0,0,3,4,1,7,3,3,0,2,0,9
5313,790901,34,6,17,1,7,5,10,3,3,1,3,1,0,1,0,0,20
5313,785452,31,4,7,3,5,1,2,1,2,4,3,1,2,0,2,0,10
5313,781620,14,0,2,0,0,0,2,0,0,0,0,0,1,0,0,0,0
5313,796450,14,4,5,4,5,0,0,2,4,0,1,1,4,0,0,0,10
5313,790903,20,1,9,0,1,1,8,0,0,0,0,1,1,0,0,0,3
5313,790902,28,1,5,0,0,1,5,3,4,0,2,4,2,1,4,0,6
5313,796452,3,0,1,0,0,0,1,0,0,0,0,1,0,0,0,0,0
5313,790904,3,0,0,0,0,0,0,0,0,0,0,0,1,0,0,0,0
5314,797715,34,6,10,3,6,3,4,0,2,2,5,7,0,0,2,0,15
5314,797716,6,1,1,1,1,0,0,0,0,0,0,1,0,0,1,0,2
5314,780937,32,9,20,6,10,3,10,0,0,4,1,1,4,1,1,1,21
5314,791149,23,4,8,4,8,0,0,0,0,1,5,0,1,0,1,0,8
5314,791950,32,1,12,0,4,1,8,2,2,0,3,0,1,1,1,0,5
5314,797717,17,1,5,1,3,0,2,1,2,0,2,1,5,1,1,0,3
5314,792115,23,1,7,1,7,0,0,2,2,2,1,2,2,2,0,0,4
5314,792113,16,1,3,1,3,0,0,0,0,1,2,0,0,2,0,0,2
5314,780779,17,1,5,1,3,0,2,0,2,0,1,1,0,0,0,0,2
5315,791295,19,6,7,6,6,0,1,0,2,4,2,1,1,0,2,1,12
5315,776345,8,1,3,1,3,0,0,0,0,0,2,0,0,0,0,1,2
5315,796579,30,3,6,2,2,1,4,2,3,0,6,2,0,2,0,0,9
5315,785794,38,7,16,6,13,1,3,3,4,2,3,1,3,0,3,1,18
5315,781373,28,4,8,0,2,4,6,1,2,0,8,4,4,1,3,0,13
5315,781379,4,0,0,0,0,0,0,0,0,0,1,0,0,0,0,0,0
5315,796577,4,0,2,0,1,0,1,0,0,0,4,1,1,0,0,0,0
5315,791292,22,2,3,2,3,0,0,3,4,1,1,4,0,1,2,1,7
5315,791293,26,2,2,1,1,1,1,2,2,0,3,2,3,1,3,1,7
5315,796580,15,0,2,0,1,0,1,0,0,0,3,2,1,0,1,0,0
5315,785792,6,1,3,0,0,1,3,0,0,0,0,0,1,0,0,0,3
5316,792110,18,2,4,2,3,0,1,0,0,2,0,0,5,1,0,0,4
5316,786031,29,4,8,4,6,0,2,4,6,0,3,1,1,0,3,0,12
5316,797734,34,5,13,4,10,1,3,0,0,2,1,1,0,1,2,0,11
5316,797735,32,2,6,1,2,1,4,3,4,1,2,3,5,1,1,1,8
5316,781386,37,5,17,4,11,1,6,4,4,1,2,0,0,2,2,0,15
5316,786033,18,3,6,3,6,0,0,0,0,3,3,2,2,0,1,2,6
5316,792109,14,1,2,1,2,0,0,0,0,2,1,0,1,0,0,1,2
5316,792105,18,2,5,0,0,2,5,0,0,0,0,1,2,0,0,0,6
5317,791201,18,4,7,4,7,0,0,0,0,2,6,3,3,0,0,0,8
5317,791202,30,5,10,3,3,2,7,0,0,1,2,1,1,1,2,0,12
5317,775767,30,7,8,7,8,0,0,7,8,2,3,1,2,1,0,2,21
5317,785628,37,8,12,7,9,1,3,2,2,0,2,4,1,0,5,0,19
5317,785627,22,3,5,1,2,2,3,0,1,0,5,2,2,0,2,3,8
5317,781135,8,1,1,1,1,0,0,0,0,0,4,0,1,0,0,1,2
5317,796902,2,0,0,0,0,0,0,0,0,0,0,1,0,0,0,0,0
5317,796901,22,3,8,2,3,1,5,0,0,0,1,2,1,1,1,0,7
5317,785629,29,0,1,0,0,0,1,2,2,0,1,3,2,1,0,0,2
5317,796904,2,0,0,0,0,0,0,0,0,0,0,0,0,0,0,0,0
5317,796903,0,0,0,0,0,0,0,0,0,0,0,0,0,0,0,0,0
5318,774845,35,4,9,2,4,2,5,10,10,0,7,6,1,0,2,0,20
5318,791161,29,5,13,1,1,4,12,0,0,0,9,1,3,0,0,1,14
5318,775888,35,4,6,4,5,0,1,4,7,0,8,3,3,2,4,3,12
5318,780629,27,4,8,2,4,2,4,1,2,0,5,1,2,1,4,0,11
5318,786690,16,2,5,2,3,0,2,1,1,2,1,1,4,1,5,1,5
5318,785346,29,4,8,1,2,3,6,0,0,2,5,1,1,1,4,0,11
5318,796816,17,1,3,0,2,1,1,4,5,0,4,2,1,1,1,1,7
5318,796815,6,0,1,0,0,0,1,1,4,0,2,0,0,0,1,0,1
5318,796817,2,0,1,0,0,0,1,0,0,0,0,0,1,0,0,0,0
5318,796819,2,0,0,0,0,0,0,0,0,0,1,0,1,0,2,0,0
5318,791159,2,0,0,0,0,0,0,0,0,0,0,0,1,0,0,0,0
5319,786474,37,8,17,8,11,0,6,5,5,0,3,2,1,1,4,0,21
5319,791777,25,3,12,2,10,1,2,4,4,0,2,3,3,1,2,1,11
5319,781025,26,4,7,4,5,0,2,2,5,2,3,2,3,1,2,0,10
5319,776285,22,2,7,2,7,0,0,1,2,3,8,0,3,0,1,0,5
5319,791780,19,0,4,0,1,0,3,0,0,2,2,0,3,2,0,0,0
5319,791829,23,4,12,4,9,0,3,2,7,2,4,1,2,3,1,0,10
5319,775503,14,3,9,1,2,2,7,0,0,0,3,0,3,1,2,0,8
5319,780488,9,1,4,0,1,1,3,0,0,0,0,0,2,0,0,0,3
5319,791776,8,1,2,0,0,1,2,0,0,0,1,1,1,1,0,0,3
5319,786476,12,0,1,0,1,0,0,0,0,0,2,0,1,0,0,0,0
5319,791781,4,0,0,0,0,0,0,0,0,0,0,0,0,0,1,0,0
5319,797612,1,0,0,0,0,0,0,0,0,0,1,0,0,0,0,0,0
5320,785843,16,1,2,1,1,0,1,1,1,0,2,0,3,0,0,0,3
5320,780578,22,3,9,2,6,1,3,1,3,1,5,1,1,0,0,0,8
5320,797537,16,0,1,0,0,0,1,0,2,1,2,0,1,0,2,1,0
5320,797538,25,2,11,1,5,1,6,2,2,0,2,2,1,1,2,0,7
5320,780579,37,8,14,5,9,3,5,6,8,1,1,2,1,0,0,0,25
5320,797536,18,4,4,2,2,2,2,2,2,0,3,0,2,0,1,0,12
5320,785845,24,1,2,1,2,0,0,2,2,0,5,1,4,0,1,2,4
5320,785293,22,4,6,2,4,2,2,0,0,1,2,2,1,0,1,0,10
5320,785847,20,2,7,2,5,0,2,1,1,0,2,2,0,0,0,0,5
5321,792171,32,4,8,3,6,1,2,1,2,1,10,1,1,1,2,2,10
5321,785674,27,1,9,1,4,0,5,0,0,1,4,2,4,0,1,0,2
5321,780049,31,13,20,13,19,0,1,3,3,1,6,1,1,0,1,1,29
5321,797784,38,6,15,5,8,1,7,1,1,0,1,6,4,1,3,0,14
5321,789059,24,1,6,1,4,0,2,1,3,3,3,1,3,0,3,0,3
5321,797783,6,0,0,0,0,0,0,0,0,1,0,0,0,0,0,0,0
5321,792173,18,1,2,1,1,0,1,0,0,1,3,0,1,0,1,2,2
5321,780527,12,1,3,0,1,1,2,0,0,0,1,0,2,0,0,0,3
5321,780980,12,1,1,1,1,0,0,0,0,0,0,0,0,0,0,0,2
5322,790846,25,3,7,3,7,0,0,4,6,3,1,0,1,0,0,1,10
5322,796754,33,4,12,3,7,1,5,0,0,3,1,2,1,1,2,1,9
5322,791099,30,2,8,1,3,1,5,0,0,1,4,0,2,0,0,0,5
5322,785470,31,4,12,0,5,4,7,1,2,1,3,0,2,1,1,0,13
5322,785586,24,4,7,4,7,0,0,0,0,1,2,2,2,0,2,0,8
5322,780298,36,5,12,3,7,2,5,2,2,0,5,7,4,1,2,1,14
5322,780315,13,2,4,2,4,0,0,2,2,1,0,1,1,0,0,0,6
5322,796755,8,0,1,0,1,0,0,0,0,1,1,0,1,0,1,0,0
5323,786041,27,3,4,3,3,0,1,5,5,1,7,2,0,1,2,0,11
5323,780881,19,3,5,3,4,0,1,0,0,0,4,1,1,2,1,0,6
5323,780275,18,1,4,1,4,0,0,0,0,1,4,0,0,0,2,1,2
5323,792075,25,3,5,1,3,2,2,3,4,2,1,1,4,0,0,0,11
5323,786686,36,7,13,6,9,1,4,6,6,0,5,9,2,1,3,0,21
5323,785437,22,5,7,5,6,0,1,2,2,1,1,1,3,1,0,4,12
5323,775222,19,2,7,1,4,1,3,0,0,0,1,1,1,0,1,2,5
5323,792074,10,1,3,0,1,1,2,0,0,0,0,1,0,0,0,0,3
5323,780052,24,3,4,2,3,1,1,0,0,0,2,0,1,0,0,0,7
5324,797544,30,12,20,11,18,1,2,0,0,4,3,1,2,1,3,4,25
5324,797549,31,7,9,7,9,0,0,0,3,0,2,11,4,1,1,1,14
5324,780351,34,4,8,4,8,0,0,2,3,5,2,4,5,0,2,0,10
5324,780586,35,2,11,1,4,1,7,1,1,0,6,6,4,0,3,0,6
5324,791716,19,2,3,1,1,1,2,0,0,0,6,1,1,0,0,1,5
5324,797546,11,2,2,2,2,0,0,1,2,1,1,0,1,0,1,0,5
5324,791715,22,1,5,0,2,1,3,0,0,1,3,0,3,0,2,0,3
5324,797545,9,1,4,0,1,1,3,0,0,0,0,3,1,1,2,0,3
5324,797540,9,0,0,0,0,0,0,0,0,0,2,0,1,0,0,0,0
5325,786193,40,6,12,2,4,4,8,0,0,0,0,0,0,1,1,0,16
5325,791743,33,7,14,7,14,0,0,2,4,3,4,1,4,3,2,0,16
5325,797340,32,5,13,3,6,2,7,4,6,1,5,3,0,0,0,0,16
5325,791746,40,7,9,7,9,0,0,0,6,3,7,5,2,3,3,0,14
5325,780711,24,1,5,1,1,0,4,3,4,2,1,2,2,1,1,0,5
5325,797341,24,5,5,1,1,4,4,2,3,0,2,3,5,2,0,0,16
5325,797345,6,0,0,0,0,0,0,0,0,0,0,0,2,0,0,0,0
5325,797342,1,0,0,0,0,0,0,0,0,0,0,0,0,0,0,0,0
5326,790856,28,8,12,8,12,0,0,1,4,2,6,1,1,2,0,1,17
5326,780452,22,2,5,2,5,0,0,0,0,0,4,1,5,0,2,2,4
5326,796413,23,3,6,1,1,2,5,0,0,0,1,4,1,1,1,0,8
5326,796408,28,6,15,6,13,0,2,3,4,0,2,5,1,1,5,1,15
5326,796407,34,2,3,2,3,0,0,0,0,0,5,2,1,1,0,0,4
5326,796410,24,8,13,8,13,0,0,0,1,3,7,0,1,0,2,0,16
5326,796409,16,3,6,2,5,1,1,3,5,1,1,3,1,0,2,0,10
5326,780450,8,0,1,0,0,0,1,0,0,1,0,2,0,0,0,0,0
5326,790858,11,4,5,3,3,1,2,1,2,1,1,0,3,1,1,0,10
5326,796411,6,1,2,1,2,0,0,0,2,2,1,0,1,0,0,0,2
5327,785408,24,5,11,4,8,1,3,0,0,3,4,1,3,0,2,1,11
5327,785407,24,4,9,4,9,0,0,6,9,2,2,0,3,0,0,0,14
5327,780539,34,5,10,3,6,2,4,0,0,0,0,4,1,5,3,0,12
5327,780560,28,2,9,2,5,0,4,2,2,0,3,1,3,2,0,0,6
5327,776484,39,9,16,6,11,3,5,0,0,0,5,2,3,2,2,1,21
5327,796416,15,1,4,1,3,0,1,0,1,0,1,0,1,0,1,0,2
5327,785409,30,5,6,5,6,0,0,0,1,2,4,0,2,1,1,7,10
5327,796415,4,0,1,0,0,0,1,0,0,0,0,1,1,0,1,0,0
5327,796417,2,0,0,0,0,0,0,0,0,0,0,0,0,0,0,0,0
5328,781602,38,5,14,3,8,2,6,4,4,1,2,3,3,3,2,0,16
5328,791344,32,6,9,2,4,4,5,0,0,5,0,1,2,1,0,0,16
5328,775746,37,4,12,2,4,2,8,2,2,3,6,0,3,0,1,1,12
5328,781425,33,5,12,5,12,0,0,2,2,5,7,1,2,1,1,0,12
5328,791343,33,3,8,2,5,1,3,0,1,1,2,9,4,1,3,0,7
5328,776173,8,2,2,0,0,2,2,2,2,0,3,1,2,0,0,0,8
5328,797001,12,0,2,0,1,0,1,0,0,0,1,0,0,1,0,0,0
5328,781601,7,0,0,0,0,0,0,0,1,1,1,0,1,1,0,0,0
5329,776284,33,7,17,7,13,0,4,3,4,0,1,4,3,1,2,0,17
5329,786122,27,4,10,2,4,2,6,0,1,0,2,1,1,0,0,0,10
5329,786124,22,3,6,3,6,0,0,0,0,0,5,0,4,0,2,0,6
5329,780877,20,0,3,0,3,0,0,0,0,3,3,1,0,0,0,0,0
5329,780308,9,0,1,0,1,0,0,0,0,0,0,1,1,0,1,1,0
5329,792258,31,5,8,3,3,2,5,0,0,0,0,1,3,1,4,0,12
5329,792261,24,3,4,3,4,0,0,3,3,3,1,1,4,1,0,3,9
5329,786331,20,1,5,1,5,0,0,2,4,4,2,1,0,1,2,0,4
5329,786113,10,0,2,0,2,0,0,0,0,0,2,1,1,1,0,0,0
5329,797980,4,0,1,0,1,0,0,0,0,1,1,0,0,0,0,0,0
5330,785836,33,5,10,4,7,1,3,0,0,2,7,1,3,0,3,3,11
5330,785833,36,7,15,2,7,5,8,6,6,0,7,3,3,0,3,0,25
5330,785332,3,0,0,0,0,0,0,0,0,0,1,0,1,0,0,2,0
5330,785838,27,0,5,0,4,0,1,0,0,0,1,3,4,0,2,1,0
5330,775872,16,1,4,0,0,1,4,1,2,2,0,0,2,0,0,0,4
5330,797533,2,0,2,0,1,0,1,0,0,0,0,0,0,0,0,0,0
5330,791707,23,1,2,1,2,0,0,4,6,2,4,1,3,1,3,0,6
5330,785892,22,3,8,3,5,0,3,1,2,0,3,2,4,1,2,0,7
5330,791705,0,0,0,0,0,0,0,0,0,0,0,0,0,0,0,0,0
5330,791704,38,8,15,7,13,1,2,1,5,4,6,4,1,2,1,0,18
5331,781134,27,3,4,3,4,0,0,3,3,0,1,0,5,2,0,0,9
5331,774874,30,3,6,3,6,0,0,1,3,1,4,0,5,1,3,2,7
5331,796531,32,6,11,5,9,1,2,6,6,0,1,2,2,2,2,0,19
5331,786475,25,4,12,4,7,0,5,3,6,2,6,1,4,1,2,1,11
5331,785270,33,3,12,3,7,0,5,4,4,0,3,0,4,0,1,0,10
5331,780085,5,0,0,0,0,0,0,0,0,0,0,0,1,0,0,0,0
5331,790946,18,1,2,1,2,0,0,2,2,1,4,0,2,0,0,0,4
5331,780084,13,1,5,0,3,1,2,0,0,0,3,0,0,0,1,0,3
5331,775468,17,0,4,0,3,0,1,1,2,0,2,0,0,0,1,0,1
5332,797576,35,9,15,6,10,3,5,2,2,1,3,3,3,2,2,0,23
5332,785796,31,7,16,5,9,2,7,0,0,0,4,1,2,0,1,1,16
5332,786508,39,5,10,4,5,1,5,2,3,0,4,0,2,3,2,1,13
5332,786509,27,5,8,5,8,0,0,1,2,0,4,0,3,1,1,1,11
5332,786505,35,0,5,0,2,0,3,0,0,0,2,1,2,0,3,0,0
5332,797579,10,3,3,1,1,2,2,0,0,0,0,0,2,0,1,0,8
5332,786507,10,1,4,0,1,1,3,0,0,0,4,2,4,0,3,0,3
5332,797577,13,1,2,1,2,0,0,0,0,3,1,0,1,0,1,1,2
5333,781243,34,5,10,5,9,0,1,7,9,1,7,4,0,1,1,1,17
5333,781244,30,7,9,7,9,0,0,1,2,2,8,1,2,0,4,0,15
5333,785537,32,2,8,2,7,0,1,5,5,1,2,1,1,0,1,0,9
5333,791241,18,3,8,2,4,1,4,0,0,2,2,2,2,0,2,0,7
5333,791243,23,3,8,3,6,0,2,0,0,1,1,0,1,1,1,0,6
5333,776205,21,4,10,3,7,1,3,2,2,1,4,1,2,2,2,0,11
5333,791245,14,3,6,2,4,1,2,2,2,1,1,2,0,0,1,0,9
5333,781237,19,3,3,1,1,2,2,0,0,0,1,1,2,3,1,0,8
5333,785529,4,0,3,0,1,0,2,0,0,0,0,0,0,0,0,0,0
5333,796940,3,0,0,0,0,0,0,0,0,0,0,0,0,0,0,0,0
5333,796943,2,0,1,0,1,0,0,0,0,1,0,0,0,0,0,0,0
5334,786502,37,9,21,9,19,0,2,4,6,2,3,4,3,4,7,0,22
5334,781078,32,3,6,3,5,0,1,2,2,0,3,0,1,0,1,0,8
5334,797587,31,2,5,2,5,0,0,2,4,2,5,1,3,1,1,1,6
5334,791895,26,2,5,2,4,0,1,0,1,1,1,1,4,3,2,0,4
5334,786501,19,1,6,1,5,0,1,2,2,0,7,0,0,0,1,0,4
5334,781080,33,3,4,2,2,1,2,0,0,0,2,1,2,2,1,0,7
5334,797586,12,1,1,1,1,0,0,0,2,1,2,1,4,0,0,1,2
5334,797584,10,0,2,0,2,0,0,0,0,0,2,0,0,0,0,0,0
5334,791891,0,0,0,0,0,0,0,0,0,0,0,0,0,0,0,0,0
5335,791650,36,9,14,8,13,1,1,2,2,0,6,1,2,3,4,0,21
5335,776384,25,4,10,2,7,2,3,0,0,0,3,6,4,0,0,0,10
5335,797285,26,3,8,1,1,2,7,0,0,0,1,1,1,1,0,0,8
5335,791652,17,3,3,3,3,0,0,0,2,0,3,1,3,0,4,1,6
5335,786495,23,1,2,0,0,1,2,0,2,0,7,2,2,0,1,0,3
5335,797286,21,1,7,1,3,0,4,4,4,0,0,2,1,0,0,0,6
5335,791653,22,2,4,2,3,0,1,0,0,1,3,0,0,0,1,0,4
5335,775705,14,0,0,0,0,0,0,0,1,1,2,0,3,0,2,0,0
5335,797283,13,0,1,0,0,0,1,0,0,0,1,0,0,0,1,0,0
5335,791654,3,0,1,0,1,0,0,0,0,0,0,0,1,0,0,0,0
5336,785778,37,4,10,4,10,0,0,9,11,4,8,5,2,1,2,1,17
5336,780543,23,4,11,4,9,0,2,3,3,0,3,0,3,2,1,0,11
5336,785772,26,5,6,5,6,0,0,0,0,0,1,1,0,0,0,1,10
5336,792486,19,1,4,1,2,0,2,0,0,3,1,1,3,1,1,0,2
5336,785766,8,0,3,0,1,0,2,1,2,0,2,1,1,0,3,0,1
5336,792482,27,4,5,1,1,3,4,2,2,1,7,1,3,2,1,0,13
5336,792488,21,2,2,0,0,2,2,4,4,2,1,1,1,0,4,0,10
5336,797419,22,2,6,2,4,0,2,1,2,0,1,1,3,0,1,0,5
5336,780544,14,0,2,0,2,0,0,0,2,1,2,1,0,1,0,0,0
5336,792489,3,0,3,0,1,0,2,0,0,0,2,0,0,0,0,0,0
5337,780182,33,7,12,4,6,3,6,1,3,1,7,4,1,2,1,1,18
5337,798139,26,5,12,5,9,0,3,1,2,0,1,0,1,2,3,0,11
5337,786818,26,4,8,4,8,0,0,0,0,1,2,0,5,1,1,0,8
5337,780192,33,3,8,3,4,0,4,0,0,0,1,0,4,0,1,0,6
5337,796585,14,1,3,1,3,0,0,0,0,0,3,0,2,0,2,0,2
5337,780184,21,4,7,1,1,3,6,2,2,0,0,1,2,0,0,0,13
5337,798138,5,1,1,1,1,0,0,0,1,0,1,0,2,1,2,0,2
5337,780186,24,0,1,0,1,0,0,1,2,3,4,3,2,2,0,0,1
5337,780188,3,0,0,0,0,0,0,1,2,1,0,0,0,0,0,0,1
5337,786820,15,0,6,0,3,0,3,0,0,0,1,2,3,0,0,0,0
5338,791981,36,4,11,4,7,0,4,1,2,0,5,1,3,3,2,2,9
5338,780342,31,3,9,3,7,0,2,4,5,5,5,4,1,1,0,0,10
5338,791982,37,6,14,5,8,1,6,2,2,2,3,5,1,2,5,1,15
5338,780333,35,5,14,2,8,3,6,2,2,1,4,6,1,0,1,0,15
5338,781493,26,3,9,1,4,2,5,4,4,0,2,1,4,0,1,0,12
5338,786756,18,2,3,1,1,1,2,0,0,1,6,2,1,0,0,0,5
5338,791984,5,1,2,1,2,0,0,1,3,0,1,0,1,0,0,0,3
5338,786755,12,0,1,0,1,0,0,2,4,1,0,0,1,0,0,0,2
5339,785384,22,4,6,3,5,1,1,0,0,1,1,0,4,0,3,1,9
5339,780025,35,5,10,5,10,0,0,2,4,1,1,1,4,0,4,0,12
5339,796391,39,5,9,3,6,2,3,6,7,2,9,4,3,0,1,0,18
5339,785385,34,1,4,0,0,1,4,2,2,3,2,0,3,1,1,0,5
5339,785383,37,4,17,3,11,1,6,1,1,0,11,4,4,0,6,1,10
5339,790837,16,1,3,1,3,0,0,0,0,0,1,1,2,0,3,0,2
5339,786297,4,0,1,0,1,0,0,0,0,0,0,0,0,0,1,0,0
5339,781046,7,0,1,0,0,0,1,0,0,0,1,0,0,0,0,0,0
5339,792180,6,0,1,0,0,0,1,0,0,0,3,1,0,0,0,0,0
5339,785382,0,0,0,0,0,0,0,0,0,0,0,0,0,0,0,0,0
5339,780024,0,0,0,0,0,0,0,0,0,0,0,0,0,0,0,0,0
5340,791135,14,3,6,3,6,0,0,0,2,1,1,0,2,0,2,1,6
5340,791132,25,1,3,0,0,1,3,0,3,4,5,3,4,1,4,0,3
5340,786090,35,4,12,3,8,1,4,8,9,0,3,2,2,5,2,0,17
5340,786088,30,4,5,2,2,2,3,2,2,0,7,4,1,2,5,0,12
5340,774921,33,5,8,3,4,2,4,2,3,0,1,4,4,2,2,0,14
5340,791133,19,1,3,1,3,0,0,1,2,2,4,1,2,0,1,1,3
5340,791134,5,1,1,1,1,0,0,1,2,0,0,0,0,0,1,0,3
5340,791131,15,0,4,0,1,0,3,0,0,0,1,1,0,1,1,0,0
5340,786097,0,0,0,0,0,0,0,0,0,0,1,0,0,0,0,0,0
5340,796791,23,4,9,1,3,3,6,1,1,2,3,0,1,1,1,2,12
5340,786092,1,0,1,0,1,0,0,0,0,0,0,0,0,0,0,0,0
5341,792265,26,0,6,0,4,0,2,1,2,3,5,1,2,0,4,0,1
5341,786152,36,4,10,4,9,0,1,0,0,2,11,0,2,2,2,2,8
5341,798003,18,2,3,1,2,1,1,2,2,0,0,1,5,2,1,0,7
5341,798009,37,10,19,6,10,4,9,4,4,0,2,2,2,0,4,0,28
5341,792267,32,3,12,1,3,2,9,3,6,0,0,2,2,0,2,0,11
5341,798007,14,1,4,1,4,0,0,0,0,2,2,0,0,1,0,0,2
5341,798002,3,0,0,0,0,0,0,0,0,0,0,1,0,1,0,0,0
5341,798005,1,0,0,0,0,0,0,0,0,0,0,0,1,0,0,0,0
5341,792266,12,1,1,1,1,0,0,2,2,0,4,0,2,0,2,0,4
5341,798006,21,2,4,2,2,0,2,0,0,0,1,0,3,0,0,0,4
5342,797111,21,3,5,2,3,1,2,2,2,2,3,2,4,0,0,0,9
5342,797110,29,5,9,0,1,5,8,0,0,2,6,0,2,0,0,0,15
5342,791407,23,4,12,4,7,0,5,5,7,0,2,3,4,1,0,0,13
5342,785928,24,2,5,1,3,1,2,2,2,0,2,1,3,2,2,0,7
5342,785923,32,1,3,1,2,0,1,2,2,1,5,6,2,1,0,0,4
5342,797112,1,0,0,0,0,0,0,0,0,0,0,0,1,0,0,0,0
5342,797113,13,2,4,2,2,0,2,0,0,0,4,1,0,0,1,1,4
5342,797117,9,0,1,0,1,0,0,1,2,0,0,0,1,0,0,0,1
5342,797115,3,0,0,0,0,0,0,0,0,0,1,0,1,0,1,0,0
5342,800038,6,1,1,0,0,1,1,0,0,0,1,0,0,0,1,0,3
5342,797114,18,2,4,1,1,1,3,3,5,0,1,1,1,1,1,0,8
5342,791404,21,3,8,1,1,2,7,0,0,1,3,4,1,0,2,0,8
5343,797861,26,2,6,2,6,0,0,4,4,1,5,2,1,0,2,0,8
5343,776018,22,1,3,1,3,0,0,2,2,3,3,0,3,0,1,0,4
5343,786262,34,1,5,0,1,1,4,1,2,0,3,1,3,1,1,0,4
5343,781317,27,3,6,0,1,3,5,0,1,0,1,2,2,0,2,0,9
5343,781314,35,4,14,4,10,0,4,1,2,0,5,2,4,0,2,0,9
5343,797858,10,1,2,1,1,0,1,0,1,1,2,1,1,1,1,0,2
5343,797856,10,0,0,0,0,0,0,0,2,0,0,0,2,0,0,0,0
5343,792206,2,0,0,0,0,0,0,0,0,0,0,0,0,0,0,0,0
5343,792208,34,6,13,6,12,0,1,5,9,2,2,1,1,0,2,0,17
5344,775074,25,1,1,1,1,0,0,7,8,1,2,1,0,0,2,3,9
5344,780462,34,6,15,3,7,3,8,2,2,0,4,4,1,2,3,0,17
5344,786447,31,3,6,3,6,0,0,0,2,2,3,1,3,0,4,1,6
5344,786448,19,0,1,0,0,0,1,0,0,0,4,1,1,0,2,1,0
5344,780731,33,7,11,6,8,1,3,6,7,3,4,0,1,1,2,0,21
5344,796971,20,2,5,1,2,1,3,1,4,0,0,1,1,2,1,0,6
5344,786132,8,0,1,0,1,0,0,2,2,0,1,2,0,3,0,0,2
5344,776365,14,0,1,0,1,0,0,0,0,1,3,0,0,2,0,0,0
5344,775121,5,0,1,0,0,0,1,0,0,0,0,1,1,0,1,0,0
5344,791631,6,0,0,0,0,0,0,0,0,0,0,1,1,0,0,0,0
5344,791632,1,0,1,0,0,0,1,0,0,0,1,0,0,0,0,0,0
5344,791630,2,0,0,0,0,0,0,0,2,0,0,0,1,0,0,0,0
5344,791634,1,0,0,0,0,0,0,0,2,0,1,0,0,0,0,0,0
5344,786449,1,0,0,0,0,0,0,0,0,0,0,0,0,0,0,0,0
5345,780266,10,0,3,0,0,0,3,0,0,0,1,0,1,0,0,0,0
5345,792565,35,8,14,8,14,0,0,2,3,3,8,3,2,0,1,0,18
5345,798134,31,2,7,1,4,1,3,1,3,1,5,0,4,0,3,1,6
5345,792560,12,1,2,1,2,0,0,0,0,2,1,1,5,0,2,2,2
5345,792561,25,3,8,2,4,1,4,0,0,0,2,0,2,1,6,0,7
5345,776333,20,3,4,3,4,0,0,2,2,2,2,1,1,2,2,0,8
5345,792563,19,0,4,0,1,0,3,0,0,0,1,3,0,0,1,0,0
5345,798133,15,2,5,0,0,2,5,0,0,0,0,1,0,1,2,0,6
5345,780270,14,0,1,0,0,0,1,0,0,0,1,3,3,1,1,0,0
5345,798132,9,1,2,0,0,1,2,0,0,0,1,2,0,0,0,0,3
5345,798135,5,0,1,0,1,0,0,0,0,0,0,0,1,0,0,0,0
5345,785472,5,0,0,0,0,0,0,0,0,0,0,0,0,0,0,0,0
5346,791465,18,5,10,5,10,0,0,2,2,2,5,3,3,0,0,2,12
5346,791464,21,2,5,1,2,1,3,0,0,1,1,1,1,3,1,1,5
5346,780200,23,0,0,0,0,0,0,0,0,4,0,4,1,1,1,0,0
5346,786304,32,5,7,4,5,1,2,1,2,0,4,2,4,1,3,0,12
5346,780197,33,6,14,4,7,2,7,6,6,0,3,1,1,1,3,0,20
5346,798342,30,4,9,2,5,2,4,2,2,4,2,3,2,1,1,0,12
5346,786303,7,0,0,0,0,0,0,0,0,0,1,2,0,0,0,1,0
5346,780616,2,0,1,0,0,0,1,0,0,0,0,0,0,0,0,0,0
5346,798343,5,1,2,1,2,0,0,0,0,0,0,0,0,0,0,0,2
5346,780196,29,6,14,6,12,0,2,1,2,0,2,2,2,1,2,0,13
5347,780282,21,4,7,4,7,0,0,1,2,5,4,3,2,0,3,2,9
5347,780277,30,5,14,5,9,0,5,4,6,3,0,1,2,2,1,1,14
5347,791002,24,2,3,0,1,2,2,1,2,0,0,3,3,1,0,0,7
5347,785327,28,4,5,0,0,4,5,0,0,0,2,1,3,3,1,0,12
5347,780280,29,5,13,4,9,1,4,5,5,1,8,3,1,0,2,1,16
5347,785329,19,5,8,2,5,3,3,0,0,1,5,2,1,0,1,0,13
5347,791003,13,1,3,1,2,0,1,0,0,1,1,0,1,0,3,0,2
5347,785330,10,2,3,2,3,0,0,0,0,1,2,0,0,0,0,0,4
5347,785326,15,1,2,1,2,0,0,2,2,0,1,3,1,0,1,0,4
5347,780279,11,0,2,0,0,0,2,0,0,0,0,0,1,0,0,0,0
5348,776004,22,4,9,4,5,0,4,3,5,1,3,0,3,1,2,1,11
5348,790930,17,2,6,2,5,0,1,0,0,0,4,0,4,1,1,1,4
5348,775011,28,4,10,0,2,4,8,1,2,2,5,1,0,2,2,1,13
5348,780357,33,1,7,0,1,1,6,0,0,0,0,2,3,2,2,0,3
5348,775018,38,4,8,2,3,2,5,2,4,0,4,8,4,0,2,0,12
5348,780358,20,5,9,5,6,0,3,1,1,0,3,0,1,0,0,1,11
5348,796480,31,2,6,2,5,0,1,1,2,2,3,2,3,1,0,0,5
5348,776270,11,1,2,1,2,0,0,1,1,0,0,1,1,0,0,0,3
5349,790873,32,7,12,6,9,1,3,5,7,0,7,0,2,1,1,1,20
5349,785429,26,3,5,0,0,3,5,0,0,0,5,0,3,1,0,0,9
5349,780054,26,4,8,4,8,0,0,0,1,0,2,1,2,1,3,0,8
5349,781140,25,3,4,3,4,0,0,2,2,2,2,1,2,0,1,0,8
5349,786851,33,1,9,0,4,1,5,6,6,0,3,4,1,0,2,0,9
5349,796433,6,1,1,1,1,0,0,0,0,1,4,0,2,0,1,0,2
5349,776357,24,3,6,3,5,0,1,2,2,0,2,3,2,1,2,0,8
5349,776245,16,5,8,5,6,0,2,0,0,0,2,0,2,1,0,0,10
5349,796432,9,0,0,0,0,0,0,0,0,0,1,0,0,1,1,0,0
5349,799973,3,0,0,0,0,0,0,0,0,0,0,0,0,0,0,1,0
5350,780377,34,2,5,0,1,2,4,5,5,0,3,2,1,0,1,1,11
5350,791852,30,5,5,5,5,0,0,5,6,3,5,3,2,1,1,2,15
5350,797460,35,1,8,0,4,1,4,5,6,1,3,5,1,1,3,0,8
5350,786601,13,0,2,0,1,0,1,0,0,0,1,1,2,0,2,0,0
5350,786600,24,4,9,3,6,1,3,0,1,1,1,1,2,0,3,0,9
5350,791851,26,5,9,3,5,2,4,7,8,3,7,0,0,1,1,0,19
5350,791853,5,3,3,3,3,0,0,1,2,0,1,0,4,0,1,0,7
5350,797461,33,3,8,2,3,1,5,2,2,0,4,5,2,0,0,0,9
5351,790232,35,6,13,5,10,1,3,7,10,0,1,3,4,0,0,0,20
5351,780614,33,5,9,5,5,0,4,0,0,3,2,0,2,1,1,1,10
5351,780093,15,0,1,0,1,0,0,0,0,2,4,1,0,0,1,0,0
5351,789066,40,8,16,6,9,2,7,4,5,1,5,1,4,0,2,0,22
5351,785806,19,4,6,4,6,0,0,0,0,0,1,1,0,0,1,0,8
5351,780255,7,0,1,0,1,0,0,0,0,0,2,0,3,0,0,0,0
5351,792411,23,0,4,0,1,0,3,0,0,0,1,1,2,1,1,0,0
5351,786463,28,4,10,3,7,1,3,0,0,0,2,1,5,1,0,0,9
5352,776253,7,1,3,0,2,1,1,0,0,0,1,0,0,0,0,1,3
5352,775651,26,4,8,4,7,0,1,9,10,4,4,1,4,0,0,0,17
5352,791070,27,4,9,3,4,1,5,5,5,2,4,1,4,2,1,0,14
5352,791627,34,3,8,2,4,1,4,0,0,0,1,2,4,0,4,0,7
5352,785665,38,5,11,4,5,1,6,3,3,0,3,2,1,2,2,0,14
5352,796505,7,1,2,1,2,0,0,0,0,0,0,1,1,0,0,1,2
5352,791071,5,0,0,0,0,0,0,0,0,0,0,0,5,0,2,2,0
5352,785660,2,0,0,0,0,0,0,0,0,1,0,0,1,0,2,0,0
5352,796504,15,3,5,2,3,1,2,0,0,2,1,0,0,0,1,0,7
5352,796502,10,1,1,1,1,0,0,0,0,1,0,1,1,0,1,0,2
5352,796501,8,0,0,0,0,0,0,0,0,1,2,0,1,0,1,0,0
5352,791073,0,0,0,0,0,0,0,0,0,0,0,0,1,0,0,0,0
5352,776178,21,2,5,2,4,0,1,1,2,0,2,2,5,1,1,0,5
5353,780824,8,0,0,0,0,0,0,0,0,0,1,0,2,0,0,1,0
5353,791117,34,4,6,4,5,0,1,0,0,1,0,2,4,0,0,0,8
5353,791118,37,5,11,3,7,2,4,13,16,2,2,1,1,0,0,0,25
5353,785676,37,3,7,1,2,2,5,2,2,0,3,1,2,1,3,0,10
5353,774974,34,5,9,5,8,0,1,9,10,0,2,2,2,2,3,0,19
5353,796771,7,0,2,0,1,0,1,0,0,0,1,0,1,0,0,2,0
5353,791115,24,1,1,1,1,0,0,5,8,1,0,0,4,0,1,0,7
5353,800022,1,0,0,0,0,0,0,0,0,0,0,0,0,0,0,0,0
5353,785947,18,0,2,0,2,0,0,5,6,0,4,1,2,1,0,0,5
5354,786805,25,4,8,4,7,0,1,3,4,1,4,0,1,1,2,0,11
5354,774936,21,7,9,7,9,0,0,2,4,2,1,4,1,1,0,3,16
5354,790933,19,1,6,1,2,0,4,1,2,0,5,3,3,1,1,0,3
5354,781345,20,4,4,3,3,1,1,0,0,0,1,6,3,0,2,0,9
5354,786803,26,2,5,0,0,2,5,0,0,0,2,5,1,4,3,0,6
5354,796490,8,2,4,2,3,0,1,0,0,0,0,0,2,0,2,1,4
5354,796488,11,3,3,1,1,2,2,2,3,1,4,2,3,0,0,0,10
5354,790934,7,0,1,0,0,0,1,2,2,1,0,0,1,0,1,1,2
5354,786804,9,3,6,2,5,1,1,0,0,1,1,3,0,0,1,0,7
5354,796489,3,0,1,0,0,0,1,0,0,0,0,0,0,0,0,0,0
5354,796487,26,4,11,0,1,4,10,0,0,0,3,0,2,0,0,0,12
5354,780033,20,3,5,2,2,1,3,1,1,2,2,6,1,3,0,1,8
5354,780030,5,1,1,0,0,1,1,2,2,0,0,0,0,1,0,0,5
5355,780758,14,1,2,1,2,0,0,1,1,1,1,1,2,0,0,0,3
5355,775489,25,2,6,2,6,0,0,0,0,3,4,0,1,2,2,0,4
5355,785560,17,1,5,1,2,0,3,2,2,0,0,1,2,0,4,0,4
5355,785561,24,4,6,3,5,1,1,2,3,0,2,0,5,0,4,1,11
5355,780313,26,3,10,2,7,1,3,1,2,2,2,2,4,2,4,0,8
5355,781208,9,0,1,0,1,0,0,1,2,0,0,0,1,0,0,0,1
5355,796751,5,0,0,0,0,0,0,0,0,0,4,0,0,0,0,0,0
5355,791087,8,0,0,0,0,0,0,0,0,1,1,1,3,0,0,0,0
5355,796750,3,1,1,1,1,0,0,0,0,0,2,0,0,0,0,0,2
5355,796749,3,0,1,0,1,0,0,0,0,0,0,0,1,0,0,0,0
5355,791088,17,2,5,2,5,0,0,1,2,1,1,0,0,0,3,0,5
5355,791069,26,4,11,2,4,2,7,2,2,0,1,0,2,1,4,0,12
5355,785563,21,3,6,3,6,0,0,2,2,0,4,1,2,1,2,0,8
5355,796748,2,0,0,0,0,0,0,0,0,0,0,0,0,0,1,0,0
5356,781417,17,0,0,0,0,0,0,0,0,1,0,1,2,1,0,0,0
5356,792246,26,6,11,6,11,0,0,1,2,2,6,0,2,0,0,2,13
5356,791701,15,1,3,1,2,0,1,0,0,1,3,2,4,0,0,0,2
5356,781420,39,4,19,1,7,3,12,1,2,0,5,4,1,0,0,0,12
5356,781405,37,8,18,2,8,6,10,2,4,1,3,6,3,3,4,0,24
5356,792244,4,0,2,0,0,0,2,0,0,1,0,0,0,0,0,0,0
5356,780615,14,2,2,2,2,0,0,0,0,1,3,0,4,0,1,0,4
5356,781624,19,3,6,2,2,1,4,2,3,0,4,1,1,1,0,0,9
5356,797925,27,3,8,0,3,3,5,5,6,4,0,0,1,1,2,0,14
5356,792245,2,0,0,0,0,0,0,0,0,0,0,0,0,0,0,0,0
5357,797662,32,3,7,3,5,0,2,6,6,1,6,2,4,0,3,2,12
5357,792082,24,2,6,2,5,0,1,1,1,0,4,1,3,0,1,0,5
5357,786067,40,5,9,5,9,0,0,5,8,2,8,1,1,1,2,0,15
5357,797661,32,4,8,3,7,1,1,3,4,0,4,2,3,2,3,1,12
5357,780258,36,7,13,2,3,5,10,0,0,0,7,1,3,0,2,0,19
5357,792078,8,0,1,0,1,0,0,1,2,0,1,0,0,0,0,0,1
5357,797660,13,2,3,2,3,0,0,2,3,0,1,0,2,0,1,0,6
5357,792083,15,0,2,0,0,0,2,2,2,0,2,1,0,0,1,0,2
5357,792079,0,0,0,0,0,0,0,0,0,0,0,0,1,0,0,0,0
5358,797712,22,3,3,3,3,0,0,2,2,1,3,2,0,0,0,3,8
5358,791964,26,4,7,2,3,2,4,5,5,0,5,1,4,1,1,0,15
5358,786056,20,3,6,1,4,2,2,0,0,0,3,1,4,1,2,0,8
5358,781339,36,8,12,6,6,2,6,0,0,0,3,2,3,0,1,0,18
5358,781337,38,10,17,6,7,4,10,4,5,1,1,4,0,0,1,0,28
5358,797713,5,0,0,0,0,0,0,0,0,0,0,0,1,0,2,0,0
5358,792041,13,2,3,1,1,1,2,0,0,1,3,2,2,1,1,1,5
5358,799737,17,2,3,0,0,2,3,0,0,0,1,0,0,0,1,0,6
5358,797711,9,0,0,0,0,0,0,1,2,0,0,0,5,0,0,0,1
5358,797710,12,0,2,0,0,0,2,2,2,0,1,1,0,0,0,0,2
5358,791966,1,0,0,0,0,0,0,0,0,0,0,0,0,0,0,0,0
5358,791963,1,0,0,0,0,0,0,0,0,0,0,0,0,0,0,0,0
5359,792140,29,6,10,6,10,0,0,1,2,1,1,5,1,0,0,0,13
5359,786596,15,6,8,6,8,0,0,3,4,1,2,0,5,3,4,0,15
5359,792144,32,2,2,2,2,0,0,0,0,2,3,3,3,0,0,0,4
5359,781429,38,6,16,1,1,5,15,2,2,0,0,1,2,0,1,0,19
5359,776092,39,2,4,1,1,1,3,2,2,0,7,8,1,0,2,0,7
5359,797791,11,3,6,3,6,0,0,0,2,1,1,1,0,0,0,0,6
5359,797793,4,0,1,0,0,0,1,0,0,0,0,0,0,0,0,0,0
5359,785976,8,0,2,0,1,0,1,0,0,1,1,1,0,0,1,0,0
5359,781431,23,6,11,5,10,1,1,1,1,1,1,0,1,1,0,0,14
5359,792146,1,0,0,0,0,0,0,0,0,0,0,0,0,0,0,0,0
5360,791512,22,4,5,4,5,0,0,4,4,5,2,0,4,0,2,1,12
5360,786338,36,6,16,2,5,4,11,4,5,3,3,0,2,2,3,0,20
5360,792050,28,1,5,1,3,0,2,0,0,0,2,3,4,0,0,0,2
5360,785347,33,3,13,3,8,0,5,2,2,1,4,2,2,3,3,0,8
5360,775601,39,4,12,2,7,2,5,6,6,4,3,3,3,2,8,0,16
5360,792045,3,0,0,0,0,0,0,0,0,0,0,0,0,0,1,0,0
5360,797648,5,1,2,1,2,0,0,0,0,0,4,0,0,1,0,0,2
5360,792052,18,2,5,1,1,1,4,1,1,0,4,0,0,0,2,0,6
5360,792047,10,1,3,1,2,0,1,0,0,2,1,0,3,0,0,0,2
5360,792051,6,0,1,0,0,0,1,0,0,0,0,0,0,0,0,0,0
5361,791923,21,4,9,4,9,0,0,1,1,1,4,1,3,0,2,0,9
5361,781122,18,6,9,6,8,0,1,2,2,1,3,0,2,0,3,0,14
5361,791925,34,6,8,6,7,0,1,1,2,0,2,7,2,2,2,3,13
5361,786527,25,4,7,1,2,3,5,0,0,1,3,0,1,1,1,0,11
5361,781112,13,0,2,0,1,0,1,1,3,0,1,3,2,0,1,0,1
5361,791922,0,0,0,0,0,0,0,0,0,0,0,0,0,0,0,0,0
5361,786529,6,0,0,0,0,0,0,0,0,0,1,1,0,0,0,0,0
5361,797541,24,5,9,5,9,0,0,2,3,1,7,0,1,1,2,4,12
5361,797542,26,3,5,1,2,2,3,0,0,0,2,2,3,1,2,1,8
5361,791927,12,0,1,0,0,0,1,0,0,0,1,0,4,1,2,0,0
5361,786858,21,2,4,2,3,0,1,1,2,0,1,2,0,1,0,0,5
5362,782133,14,4,8,2,3,2,5,2,2,0,3,1,0,1,0,0,12
5362,785123,16,2,3,2,3,0,0,4,4,0,4,2,1,0,3,1,8
5362,790990,25,6,10,2,4,4,6,2,2,1,2,4,2,4,2,0,18
5362,789219,23,7,10,5,5,2,5,2,2,1,1,5,1,2,0,0,18
5362,785059,26,5,6,3,3,2,3,2,2,0,2,6,2,4,0,1,14
5362,796624,10,1,5,1,5,0,0,0,0,2,3,1,0,0,0,0,2
5362,790989,12,1,1,1,1,0,0,0,0,1,0,2,0,0,0,0,2
5362,785305,8,3,3,2,2,1,1,0,0,0,2,0,2,0,0,0,7
5362,796622,11,2,4,2,3,0,1,0,0,0,2,0,2,0,1,2,4
5362,796623,16,4,7,1,3,3,4,0,0,0,0,3,2,1,0,0,11
5362,790988,17,2,4,1,2,1,2,3,3,0,4,1,0,2,3,0,8
5362,785303,15,3,4,1,1,2,3,0,0,1,1,1,3,0,1,0,8
5362,785122,7,1,2,1,1,0,1,0,0,0,0,3,0,1,0,0,2
5363,791723,22,3,7,3,7,0,0,0,1,1,2,0,1,1,2,2,6
5363,797310,26,4,7,4,6,0,1,0,0,0,3,3,0,2,7,0,8
5363,785580,28,1,7,1,6,0,1,2,5,3,2,2,0,0,2,0,4
5363,791724,30,3,9,1,4,2,5,1,4,2,3,2,3,2,2,1,9
5363,781617,21,3,5,2,3,1,2,0,0,0,3,1,4,0,1,0,7
5363,797312,13,0,1,0,0,0,1,3,3,1,0,0,0,0,1,0,3
5363,780956,22,4,7,4,5,0,2,1,3,1,1,0,0,0,6,1,9
5363,797308,12,0,1,0,0,0,1,0,0,0,1,0,0,0,1,0,0
5363,780706,21,3,8,0,3,3,5,3,4,1,2,1,0,0,2,0,12
5363,800056,5,1,1,1,1,0,0,2,2,0,0,1,0,1,0,0,4
5364,792143,38,4,8,2,2,2,6,3,3,0,6,0,1,3,1,1,13
5364,786302,33,4,6,4,6,0,0,1,2,5,2,2,3,2,1,0,9
5364,786293,39,6,14,5,11,1,3,6,8,0,4,4,2,2,2,1,19
5364,780953,41,8,15,7,12,1,3,9,9,2,3,4,2,1,3,0,26
5364,797751,18,0,2,0,0,0,2,1,2,0,2,0,0,0,1,0,1
5364,792147,3,0,0,0,0,0,0,0,0,0,0,0,1,0,1,0,0
5364,797750,41,2,8,1,4,1,4,0,0,0,3,5,3,2,0,0,5
5364,797748,9,0,0,0,0,0,0,0,0,0,2,0,0,0,2,0,0
5364,797742,3,0,0,0,0,0,0,0,0,0,0,0,0,0,0,0,0
5365,780283,26,1,3,1,3,0,0,1,2,0,2,0,4,1,2,0,3
5365,790925,38,5,13,3,6,2,7,2,2,2,2,1,2,1,4,2,14
5365,791456,43,11,19,6,11,5,8,0,0,0,4,1,4,3,2,0,27
5365,785476,36,4,12,4,11,0,1,5,5,1,2,4,2,1,2,0,13
5365,785474,15,0,2,0,0,0,2,2,2,3,1,0,3,0,1,0,2
5365,780292,19,1,1,1,1,0,0,1,1,0,2,2,1,0,0,1,3
5365,785480,13,0,2,0,0,0,2,0,0,0,1,1,0,0,1,0,0
5365,796470,11,0,3,0,2,0,1,2,2,2,2,0,1,2,0,0,2
5365,790926,24,3,5,1,1,2,4,0,0,0,3,2,3,2,1,0,8
5366,796455,30,0,1,0,1,0,0,1,2,2,1,1,1,0,1,2,1
5366,787175,34,3,10,0,1,3,9,0,0,0,11,0,4,2,0,1,9
5366,790909,38,5,14,3,8,2,6,7,8,2,6,2,2,2,2,0,19
5366,781393,36,3,11,1,3,2,8,2,2,0,10,3,4,1,7,0,10
5366,775351,40,6,13,6,13,0,0,3,5,2,2,1,2,1,1,0,15
5366,790907,6,0,1,0,1,0,0,0,0,0,0,0,1,0,1,0,0
5366,782126,16,3,6,1,3,2,3,0,0,2,4,0,1,0,0,0,8
5367,785664,15,2,3,2,3,0,0,0,0,1,1,0,1,1,0,1,4
5367,785841,31,5,9,3,4,2,5,4,4,1,7,5,1,0,3,0,16
5367,796611,18,1,8,0,0,1,8,0,0,0,4,0,2,0,0,0,3
5367,792869,28,1,3,1,1,0,2,0,0,2,0,0,3,1,2,0,2
5367,781504,34,4,17,1,8,3,9,2,3,2,4,3,3,1,2,2,13
5367,796613,23,1,5,0,1,1,4,0,0,0,3,0,0,2,1,0,3
5367,792232,10,2,5,1,3,1,2,0,0,1,4,1,1,0,0,1,5
5367,791312,9,0,0,0,0,0,0,0,0,2,1,0,2,0,1,0,0
5367,786685,26,1,8,1,3,0,5,0,1,0,4,0,3,0,2,1,2
5367,766623,6,0,2,0,1,0,1,0,0,0,0,0,0,0,0,0,0
5368,786003,26,2,6,2,3,0,3,1,2,1,4,1,3,0,1,0,5
5368,775455,31,10,17,10,15,0,2,2,3,1,3,4,0,0,1,0,22
5368,797749,28,0,4,0,3,0,1,2,2,0,1,0,0,0,0,0,2
5368,786005,17,4,7,3,5,1,2,2,2,0,0,2,3,1,3,0,11
5368,781397,18,1,3,1,3,0,0,0,0,2,2,0,2,0,2,0,2
5368,792119,7,0,0,0,0,0,0,1,2,0,0,0,3,0,0,0,1
5368,786009,17,2,6,2,4,0,2,0,0,2,1,1,3,1,1,0,4
5368,797747,18,3,5,1,3,2,2,0,0,0,1,0,5,0,1,0,8
5368,786002,24,2,4,2,3,0,1,0,0,0,1,1,3,0,3,0,4
5368,786008,14,3,4,1,1,2,3,1,1,1,0,1,1,1,1,0,9
5369,790935,25,1,4,1,1,0,3,2,2,0,2,1,0,0,1,0,4
5369,792442,29,4,4,4,4,0,0,1,4,1,9,0,2,1,0,0,9
5369,780933,28,2,8,0,0,2,8,0,0,0,2,0,2,2,1,0,6
5369,775340,35,8,17,5,10,3,7,13,14,1,1,6,2,2,3,0,32
5369,774826,22,1,7,0,1,1,6,0,0,0,2,1,1,1,2,0,3
5369,796491,4,0,1,0,0,0,1,1,2,0,0,0,0,0,0,0,1
5369,796190,19,5,6,2,2,3,4,0,0,1,2,0,0,1,0,0,13
5369,790937,11,0,0,0,0,0,0,2,2,1,2,0,5,0,2,0,2
5369,785445,3,0,0,0,0,0,0,1,2,0,0,0,1,0,0,0,1
5369,790938,18,1,1,1,1,0,0,1,3,1,2,1,1,0,1,0,3
5369,796492,6,1,1,0,0,1,1,2,2,0,1,1,1,0,0,0,5
5370,791515,20,2,5,2,3,0,2,0,0,2,2,3,0,1,0,0,4
5370,791511,22,3,5,3,5,0,0,0,0,1,3,0,3,2,2,1,6
5370,797150,34,6,9,3,6,3,3,1,5,1,6,4,1,0,0,0,16
5370,780946,34,2,5,0,2,2,3,2,2,0,1,3,3,2,2,0,8
5370,786637,36,1,5,1,1,0,4,0,0,0,1,3,1,0,1,0,2
5370,797151,3,0,0,0,0,0,0,0,0,0,1,0,1,0,0,0,0
5370,778442,34,8,23,3,9,5,14,0,0,0,6,4,1,0,1,1,21
5370,791513,17,3,6,3,4,0,2,0,0,1,1,0,1,0,0,0,6
5371,792227,26,8,9,4,5,4,4,0,0,1,7,4,3,0,0,0,20
5371,781352,24,3,5,3,5,0,0,2,5,1,2,3,1,0,1,0,8
5371,792223,28,3,8,1,4,2,4,0,0,0,4,5,1,1,2,0,8
5371,785935,32,4,8,3,5,1,3,2,3,0,4,4,2,1,2,0,11
5371,781340,33,2,4,2,4,0,0,0,0,1,2,2,0,0,0,0,4
5371,797881,6,1,2,1,2,0,0,0,0,0,1,0,0,0,1,0,2
5371,797889,10,1,3,1,3,0,0,0,0,0,3,0,0,1,0,1,2
5371,781351,14,4,9,3,6,1,3,0,2,3,1,0,0,0,0,0,9
5371,776128,27,2,4,1,3,1,1,0,0,0,4,2,1,0,1,0,5
5372,796617,10,1,2,1,2,0,0,0,0,1,1,0,2,0,3,0,2
5372,775131,37,7,13,5,7,2,6,3,5,0,2,4,1,1,0,0,19
5372,796616,35,5,7,2,2,3,5,1,2,0,1,3,1,0,0,0,14
5372,796612,36,6,10,6,9,0,1,0,0,0,5,3,2,1,1,0,12
5372,785562,32,7,13,5,9,2,4,1,1,4,8,4,0,1,1,1,17
5372,792429,3,1,2,0,0,1,2,0,0,0,0,0,1,0,0,0,3
5372,796614,6,1,1,1,1,0,0,0,0,0,0,1,0,0,0,0,2
5372,796607,17,1,7,1,7,0,0,1,2,3,1,2,2,0,1,0,3
5372,796606,24,2,3,2,3,0,0,0,0,1,2,2,4,0,2,0,4
5373,792167,12,1,3,1,3,0,0,1,2,0,2,0,5,0,4,0,3
5373,797767,31,2,6,2,5,0,1,0,0,1,1,2,2,0,2,0,4
5373,791372,35,7,11,3,3,4,8,4,4,1,0,2,0,1,0,0,22
5373,792164,33,0,7,0,2,0,5,0,0,2,3,2,1,1,2,0,0
5373,780974,29,2,5,1,2,1,3,4,4,1,3,3,0,1,1,0,9
5373,797766,28,8,10,4,5,4,5,4,5,2,7,1,2,0,0,1,24
5373,797772,10,0,2,0,1,0,1,0,0,0,2,2,1,1,0,0,0
5373,792163,15,1,6,0,1,1,5,0,0,1,0,0,0,0,1,0,3
5373,797764,7,0,0,0,0,0,0,0,0,0,1,1,2,0,1,0,0
5374,796657,16,2,3,2,2,0,1,0,0,3,1,0,1,0,0,1,4
5374,796651,12,0,2,0,0,0,2,0,0,0,1,0,3,1,1,0,0
5374,791323,34,6,7,4,4,2,3,0,1,0,1,5,0,1,2,1,14
5374,791320,34,5,16,3,10,2,6,6,6,0,5,5,1,1,1,2,18
5374,781511,18,3,5,1,2,2,3,0,0,0,2,1,4,0,3,1,8
5374,796650,27,1,5,0,4,1,1,2,2,5,4,3,2,3,1,2,5
5374,796655,2,0,0,0,0,0,0,0,0,0,0,0,0,0,0,0,0
5374,796653,1,0,0,0,0,0,0,0,0,0,0,0,0,0,0,0,0
5374,796654,2,0,0,0,0,0,0,0,0,0,0,0,0,1,0,0,0
5374,796652,1,0,0,0,0,0,0,2,2,0,0,0,1,0,1,0,2
5374,796656,14,0,2,0,2,0,0,0,0,1,2,1,1,0,0,0,0
5374,791321,12,6,7,6,7,0,0,3,3,2,1,0,3,0,1,0,15
5374,785912,27,7,14,4,7,3,7,4,4,1,2,4,3,1,0,0,21
5375,780521,24,1,3,0,1,1,2,4,4,0,3,0,2,2,3,0,7
5375,775163,17,3,6,3,6,0,0,2,3,1,4,0,2,0,2,1,8
5375,791370,28,4,10,4,6,0,4,0,2,1,4,1,2,1,1,0,8
5375,786199,27,4,8,2,5,2,3,5,5,0,3,2,0,0,2,0,15
5375,780991,28,6,11,5,9,1,2,3,5,2,1,4,2,0,1,0,16
5375,797269,4,1,1,1,1,0,0,0,0,0,0,0,0,0,0,0,2
5375,780145,10,0,0,0,0,0,0,0,0,0,0,0,2,1,2,0,0
5375,781611,9,1,1,1,1,0,0,3,4,3,0,0,0,0,0,1,5
5375,797271,20,0,6,0,3,0,3,1,2,0,2,1,2,1,0,0,1
5375,797270,4,1,1,0,0,1,1,0,0,0,0,0,0,0,0,0,3
5375,743593,19,0,3,0,1,0,2,0,0,1,1,2,5,0,1,0,0
5375,791371,10,2,2,2,2,0,0,3,3,0,1,0,2,0,1,0,7
5376,780686,36,10,23,10,23,0,0,3,4,4,5,4,0,0,1,0,23
5376,780683,36,3,6,0,1,3,5,4,5,2,7,0,1,0,1,0,13
5376,797681,25,1,3,1,3,0,0,8,8,0,0,4,0,3,2,0,10
5376,797680,30,3,7,3,6,0,1,0,0,0,0,0,1,1,0,0,6
5376,780688,32,6,12,6,9,0,3,0,1,5,5,1,3,2,1,0,12
5376,797683,2,0,0,0,0,0,0,0,0,0,0,0,1,0,0,0,0
5376,797679,4,0,0,0,0,0,0,0,0,0,0,0,2,0,0,0,0
5376,791942,30,6,13,4,7,2,6,5,7,1,0,3,2,0,3,0,19
5376,780689,3,1,1,1,1,0,0,0,0,1,0,0,1,0,0,0,2
5376,797682,2,0,0,0,0,0,0,0,0,0,0,0,0,0,0,0,0
5377,785916,19,2,6,1,2,1,4,1,1,1,3,1,5,0,4,3,6
5377,780105,24,3,6,3,5,0,1,4,4,0,4,2,4,1,2,0,10
5377,785637,38,6,9,0,0,6,9,0,0,0,1,1,3,1,0,0,18
5377,785915,38,2,8,0,0,2,8,3,3,0,2,4,3,1,0,0,9
5377,781131,34,7,11,5,9,2,2,0,0,0,7,5,3,1,6,1,16
5377,791408,17,6,7,6,7,0,0,0,2,2,4,1,3,0,3,0,12
5377,785914,2,0,1,0,1,0,0,0,0,0,1,1,0,0,0,0,0
5377,780106,16,3,5,3,4,0,1,0,0,1,1,0,2,0,3,0,6
5377,791409,12,0,1,0,0,0,1,0,0,0,1,0,1,0,1,0,0
5378,785681,30,4,7,4,7,0,0,1,2,2,5,1,4,1,1,0,9
5378,796789,33,5,14,1,6,4,8,0,0,1,7,2,1,0,2,1,14
5378,791126,40,5,10,5,10,0,0,3,6,2,3,1,4,0,1,1,13
5378,791124,38,2,5,1,3,1,2,5,6,0,2,4,1,1,3,0,10
5378,780050,41,6,16,6,12,0,4,6,7,2,8,5,1,1,2,0,18
5378,784479,15,5,6,2,2,3,4,0,2,2,1,1,4,0,2,0,13
5378,796786,3,0,0,0,0,0,0,0,0,0,1,0,1,0,0,0,0
5378,796784,15,1,3,1,3,0,0,0,0,1,1,0,5,1,1,0,2
5378,796783,0,0,0,0,0,0,0,0,0,0,0,0,0,0,0,0,0
5378,796782,6,0,2,0,1,0,1,0,0,0,3,0,2,0,0,0,0
5378,792711,4,0,0,0,0,0,0,1,2,1,0,0,2,1,0,0,1
5379,797728,17,1,4,0,1,1,3,0,0,0,2,1,2,0,1,0,3
5379,792036,31,3,6,3,5,0,1,2,2,3,2,0,4,0,1,0,8
5379,786266,42,6,13,4,9,2,4,7,8,0,7,3,1,0,2,0,21
5379,792040,22,1,5,0,2,1,3,0,0,0,2,2,1,1,1,0,3
5379,775028,39,11,19,8,12,3,7,6,6,1,9,5,4,2,3,1,31
5379,786039,14,1,2,1,2,0,0,3,6,0,1,1,2,1,0,0,5
5379,797723,15,0,3,0,1,0,2,0,0,0,3,0,3,0,1,0,0
5379,797719,12,0,2,0,1,0,1,0,0,0,0,0,2,0,0,0,0
5379,797718,15,1,3,1,1,0,2,8,8,0,1,0,5,0,0,0,10
5379,792043,18,0,2,0,0,0,2,0,0,1,2,0,2,0,0,0,0
5380,796979,28,2,7,2,6,0,1,0,0,0,3,0,5,1,0,0,4
5380,776200,28,3,7,3,7,0,0,0,0,1,1,2,3,3,2,0,6
5380,791624,30,5,11,2,4,3,7,1,2,0,6,0,4,2,1,0,14
5380,780925,1,0,0,0,0,0,0,0,0,0,0,0,0,0,0,0,0
5380,781034,34,6,10,6,7,0,3,0,0,1,2,0,2,0,6,0,12
5380,796980,12,1,2,1,2,0,0,2,2,0,1,1,1,0,2,0,4
5380,791625,12,0,0,0,0,0,0,0,0,0,2,0,0,0,2,1,0
5380,791637,6,0,1,0,0,0,1,0,0,0,0,1,0,0,0,0,0
5380,786437,21,3,7,0,3,3,4,0,0,0,1,1,4,2,0,0,9
5380,785620,28,5,10,3,4,2,6,6,6,0,0,3,3,1,1,0,18
5381,776100,34,3,7,3,5,0,2,9,11,2,6,2,2,2,0,0,15
5381,785991,30,7,12,6,11,1,1,1,2,5,7,1,2,0,4,4,16
5381,797762,29,0,3,0,3,0,0,3,4,0,3,4,1,1,3,0,3
5381,781406,29,4,5,2,3,2,2,5,5,0,2,2,1,1,3,0,15
5381,781401,33,3,4,2,2,1,2,2,2,2,2,1,1,3,4,1,9
5381,797760,4,0,1,0,0,0,1,0,0,0,1,0,0,0,0,0,0
5381,792133,13,3,5,1,2,2,3,2,2,0,1,0,1,0,2,0,10
5381,781029,17,4,8,0,0,4,8,2,3,0,1,1,1,0,0,0,14
5381,775317,11,0,2,0,1,0,1,0,0,1,2,0,3,1,1,0,0
5382,796516,27,2,5,2,5,0,0,2,5,5,5,0,3,3,3,3,6
5382,792318,35,4,8,4,8,0,0,9,13,3,7,0,1,1,1,1,17
5382,796519,10,0,2,0,1,0,1,0,0,0,1,1,1,0,0,0,0
5382,786717,26,1,5,1,3,0,2,0,2,0,1,0,4,1,6,1,2
5382,780753,29,2,10,2,3,0,7,3,4,1,1,3,2,2,3,0,7
5382,796520,23,4,11,1,3,3,8,1,1,0,1,0,0,1,1,0,12
5382,796517,24,3,6,3,6,0,0,0,0,1,2,2,3,0,1,0,6
5382,792315,5,0,0,0,0,0,0,0,0,0,1,0,1,0,1,0,0
5382,775329,21,0,5,0,2,0,3,2,2,0,4,0,2,0,4,0,2
5383,796540,34,2,12,2,10,0,2,2,2,2,9,0,2,1,1,0,6
5383,790951,22,2,2,2,2,0,0,1,2,1,4,0,5,0,0,2,5
5383,786309,18,0,4,0,1,0,3,0,0,0,3,0,3,1,2,0,0
5383,780087,35,8,15,7,13,1,2,2,2,2,4,0,2,2,7,0,19
5383,776136,36,4,10,3,7,1,3,5,6,1,0,6,1,1,3,0,14
5383,796543,2,0,1,0,1,0,0,0,0,1,0,0,0,0,1,0,0
5383,775037,14,2,3,2,3,0,0,0,0,1,0,0,1,0,0,0,4
5383,796545,13,0,1,0,0,0,1,0,0,0,1,0,3,1,5,0,0
5383,796544,6,1,1,0,0,1,1,0,0,1,1,1,0,0,0,0,3
5383,790952,9,0,2,0,1,0,1,0,0,0,0,0,2,2,0,0,0
5383,786089,11,2,7,0,2,2,5,0,0,0,2,0,5,1,0,0,6
5384,776209,23,2,6,1,3,1,3,3,4,0,5,0,2,0,1,0,8
5384,796938,38,2,7,2,4,0,3,4,4,2,1,2,3,1,2,0,8
5384,791235,18,1,4,1,4,0,0,2,2,0,1,0,2,0,2,0,4
5384,791237,32,4,15,3,9,1,6,0,0,4,4,1,2,0,3,0,9
5384,791351,24,3,16,1,7,2,9,3,4,1,2,3,0,3,1,0,11
5384,788124,10,1,1,1,1,0,0,0,0,1,0,0,3,0,2,0,2
5384,781227,15,4,7,4,6,0,1,0,1,3,2,0,1,0,0,0,8
5384,791240,18,1,1,1,1,0,0,2,2,0,1,1,4,1,0,1,4
5384,791238,22,3,6,2,4,1,2,2,2,0,3,2,5,2,1,1,9
5385,786434,21,4,5,4,5,0,0,1,1,2,3,2,1,1,1,2,9
5385,780440,29,4,9,3,5,1,4,7,10,1,6,1,2,0,0,0,16
5385,791621,29,10,15,4,8,6,7,2,2,1,5,2,2,0,1,0,28
5385,786432,18,2,7,2,6,0,1,0,0,0,2,0,0,0,0,0,4
5385,786431,35,3,5,2,3,1,2,0,0,0,4,2,4,0,2,0,7
5385,796975,2,0,1,0,0,0,1,0,0,0,0,0,0,0,0,0,0
5385,791619,2,0,0,0,0,0,0,0,0,0,1,0,1,0,1,0,0
5385,791620,5,0,2,0,1,0,1,0,0,0,2,0,0,0,1,0,0
5385,781125,15,1,2,1,2,0,0,4,4,2,1,0,3,0,0,0,6
5385,780442,2,0,1,0,1,0,0,0,0,0,0,0,0,0,0,0,0
5385,775620,3,0,1,0,1,0,0,0,0,0,1,0,0,0,0,0,0
5385,796976,2,0,0,0,0,0,0,0,0,1,0,0,1,0,0,0,0
5385,796977,2,0,0,0,0,0,0,4,4,0,1,0,0,0,0,0,4
5385,786433,2,0,0,0,0,0,0,0,0,0,0,0,0,0,1,0,0
5385,781088,26,2,4,2,2,0,2,2,2,0,3,3,1,1,3,0,6
5385,775622,7,2,3,2,2,0,1,1,2,0,0,0,0,1,2,0,5
5386,790899,19,2,4,2,4,0,0,3,4,5,5,2,3,0,0,0,7
5386,790897,34,10,14,2,4,8,10,3,4,1,3,0,4,2,3,0,31
5386,785442,17,0,3,0,2,0,1,0,0,0,2,1,2,0,2,1,0
5386,785579,35,4,10,3,6,1,4,0,0,0,2,8,3,2,6,0,9
5386,775737,22,5,8,1,1,4,7,1,2,0,1,1,2,0,1,0,15
5386,796447,14,0,0,0,0,0,0,0,0,0,2,0,2,0,0,2,0
5386,775959,27,4,9,2,3,2,6,0,0,0,3,1,2,2,0,2,10
5386,790898,9,0,1,0,0,0,1,2,2,0,1,1,0,0,0,0,2
5386,799907,21,1,6,1,4,0,2,0,0,0,2,4,4,0,3,0,2
5386,785448,2,0,1,0,0,0,1,0,0,0,0,0,0,0,0,0,0
5387,791876,38,7,12,5,9,2,3,1,3,0,8,2,1,5,0,0,17
5387,791877,25,4,6,3,5,1,1,6,7,3,1,0,4,2,1,1,15
5387,785667,18,1,5,1,3,0,2,0,0,0,2,2,0,0,1,0,2
5387,786572,37,5,11,4,10,1,1,0,0,3,4,3,2,1,1,0,11
5387,786570,32,6,15,6,11,0,4,2,3,1,2,8,2,2,5,0,14
5387,780436,15,1,2,0,1,1,1,0,0,0,2,0,1,0,0,0,3
5387,781205,15,1,3,1,3,0,0,2,2,1,1,0,4,0,1,1,4
5387,797486,20,2,5,2,5,0,0,5,8,1,0,1,1,1,2,0,9
5388,797103,31,6,10,6,10,0,0,3,5,3,2,1,2,2,2,0,15
5388,791414,16,1,2,1,2,0,0,0,0,0,1,0,1,1,0,0,2
5388,791413,31,4,9,3,6,1,3,1,1,0,6,2,0,0,2,0,10
5388,791411,33,6,16,2,8,4,8,3,4,0,1,1,2,2,0,0,19
5388,785776,34,3,11,2,8,1,3,0,0,0,3,2,4,0,3,2,7
5388,797102,8,0,1,0,0,0,1,0,0,1,1,0,1,0,1,0,0
5388,785911,5,0,1,0,1,0,0,0,0,0,0,0,0,0,0,2,0
5388,797105,2,0,0,0,0,0,0,0,0,0,0,0,0,0,0,0,0
5388,797100,32,1,5,1,4,0,1,0,0,0,10,4,3,2,1,0,2
5388,781209,8,2,4,1,2,1,2,0,0,0,1,0,3,0,1,0,5
5389,792373,23,1,4,1,4,0,0,2,2,2,2,0,3,0,3,1,4
5389,792370,39,10,20,10,17,0,3,0,1,4,8,2,3,1,2,2,20
5389,797960,32,4,9,0,0,4,9,0,0,0,3,0,3,2,0,0,12
5389,786739,37,2,5,2,2,0,3,0,0,1,3,8,1,0,2,0,4
5389,775303,34,4,11,1,2,3,9,3,4,0,10,5,1,3,2,1,14
5389,797958,4,0,1,0,1,0,0,0,1,1,0,0,1,0,0,0,0
5389,781598,13,2,5,2,5,0,0,0,0,0,1,0,1,0,0,0,4
5389,797951,15,2,5,0,0,2,5,3,3,0,1,1,1,0,1,1,9
5389,781597,3,0,0,0,0,0,0,2,2,1,0,2,0,0,0,0,2
5390,780058,28,4,8,3,3,1,5,2,2,0,4,1,2,0,3,0,11
5390,780059,37,5,8,3,4,2,4,5,7,1,4,7,1,4,3,3,17
5390,796494,23,6,9,2,4,4,5,0,0,1,2,0,4,0,1,0,16
5390,790944,28,5,11,3,6,2,5,0,0,2,2,3,0,2,3,0,12
5390,780061,32,4,12,0,2,4,10,0,0,1,2,2,2,2,1,1,12
5390,796497,10,2,2,2,2,0,0,0,0,0,3,0,0,1,0,0,4
5390,796496,13,1,2,0,0,1,2,0,0,1,3,2,1,3,1,2,3
5390,790941,6,0,2,0,2,0,0,2,2,0,0,1,1,0,0,0,2
5390,786754,23,1,7,1,4,0,3,2,2,1,2,5,1,1,2,0,4
5391,785999,32,4,6,4,6,0,0,0,0,4,5,2,3,3,4,0,8
5391,775171,4,0,0,0,0,0,0,0,0,0,0,0,1,0,1,0,0
5391,775654,32,3,3,3,3,0,0,0,0,0,1,0,0,1,0,3,6
5391,791639,35,5,19,4,15,1,4,8,8,0,2,1,0,3,1,0,19
5391,785389,33,9,21,7,15,2,6,7,7,0,3,2,2,4,3,1,27
5391,796399,16,2,4,1,2,1,2,0,0,1,1,2,3,0,3,0,5
5391,796398,32,3,6,3,4,0,2,0,0,2,5,0,1,2,2,0,6
5391,791640,3,0,0,0,0,0,0,0,0,0,1,0,1,0,1,0,0
5391,785255,13,1,2,1,2,0,0,0,2,2,2,0,1,0,0,1,2
5392,775563,22,3,12,3,12,0,0,0,0,0,6,0,3,0,5,1,6
5392,781011,23,9,15,9,14,0,1,5,6,9,4,1,2,1,0,1,23
5392,797601,33,6,10,2,3,4,7,2,2,0,5,2,0,3,1,1,18
5392,781012,29,2,8,1,3,1,5,2,2,1,0,2,4,1,2,0,7
5392,775119,26,2,9,2,9,0,0,0,0,1,6,3,2,1,1,0,4
5392,797602,8,0,1,0,0,0,1,0,0,0,1,0,0,1,0,1,0
5392,775806,8,2,3,1,1,1,2,0,0,0,1,0,0,0,1,0,5
5392,775188,15,3,3,3,3,0,0,0,2,5,3,1,1,1,1,0,6
5392,797604,21,7,9,4,6,3,3,0,0,1,5,1,2,0,1,0,17
5392,791770,2,0,1,0,0,0,1,0,0,0,0,0,0,0,0,0,0
5392,786466,13,0,2,0,1,0,1,0,0,0,0,0,0,0,0,0,0
5393,786460,11,0,2,0,2,0,0,0,0,0,2,0,2,0,1,0,0
5393,791766,27,4,6,3,4,1,2,0,0,1,0,0,1,0,2,0,9
5393,780604,32,5,10,4,9,1,1,3,7,0,5,1,1,1,4,0,14
5393,780603,26,0,5,0,2,0,3,0,0,0,2,4,2,0,1,0,0
5393,780602,36,6,17,5,15,1,2,3,7,3,5,3,2,0,2,1,16
5393,786071,18,4,6,4,5,0,1,1,2,1,3,0,1,1,0,0,9
5393,797565,3,0,0,0,0,0,0,0,0,0,0,0,0,0,0,0,0
5393,791768,12,0,2,0,1,0,1,0,0,0,1,0,2,0,3,0,0
5393,797563,1,0,0,0,0,0,0,0,0,0,0,0,0,0,0,0,0
5393,797564,3,0,0,0,0,0,0,0,0,0,0,0,0,0,1,0,0
5393,791767,3,0,0,0,0,0,0,0,0,0,0,0,0,1,1,0,0
5393,786230,25,5,14,1,6,4,8,0,0,2,1,1,1,0,0,0,14
5393,780605,3,0,1,0,0,0,1,0,0,0,1,0,0,0,0,0,0
5394,792005,35,5,14,3,6,2,8,4,4,2,5,2,4,2,2,1,16
5394,781175,28,2,4,2,4,0,0,2,5,5,5,0,4,0,1,2,6
5394,786553,36,5,10,2,5,3,5,2,3,4,4,3,2,3,3,0,15
5394,780895,36,6,13,6,12,0,1,9,9,0,4,2,1,2,2,0,21
5394,781172,35,2,4,0,1,2,3,2,2,0,4,4,0,2,5,0,8
5394,781177,5,1,1,0,0,1,1,0,0,0,0,0,3,0,0,0,3
5394,785312,18,5,8,4,6,1,2,1,3,1,3,1,0,1,3,0,12
5394,797503,6,0,1,0,1,0,0,0,0,0,0,0,1,0,0,1,0
5394,786557,1,0,0,0,0,0,0,0,0,0,0,0,0,0,0,0,0
5395,791917,20,2,2,1,1,1,1,0,0,1,2,2,4,2,1,1,5
5395,786526,23,7,14,5,8,2,6,1,1,1,6,2,2,1,1,1,17
5395,786525,33,5,11,2,5,3,6,6,6,0,2,2,2,0,4,0,19
5395,791914,32,7,12,3,6,4,6,0,0,0,1,4,2,2,2,0,18
5395,786030,21,2,10,2,6,0,4,0,0,0,1,3,4,1,2,0,4
5395,786856,20,4,6,4,6,0,0,2,2,0,5,1,1,0,2,0,10
5395,786524,8,0,1,0,0,0,1,0,0,0,0,0,2,0,1,0,0
5395,781109,28,1,2,1,1,0,1,0,3,1,2,2,3,1,1,0,2
5395,797550,15,1,1,0,0,1,1,0,0,0,1,0,0,1,0,0,3
5396,791787,27,6,14,5,11,1,3,5,6,1,11,0,3,1,1,0,18
5396,789048,31,3,6,3,6,0,0,2,2,2,9,0,3,2,6,0,8
5396,789046,19,2,3,0,0,2,3,0,0,1,3,3,3,1,0,0,6
5396,797630,25,3,5,3,3,0,2,3,3,0,0,1,1,0,0,0,9
5396,789041,25,2,8,1,2,1,6,0,0,1,2,2,1,1,0,0,5
5396,799762,6,0,4,0,1,0,3,0,0,0,4,0,0,0,1,0,0
5396,791785,20,5,7,2,3,3,4,2,2,1,2,3,1,1,0,1,15
5396,785540,13,1,4,1,3,0,1,0,0,1,1,0,3,0,1,1,2
5396,797633,1,0,0,0,0,0,0,2,2,0,0,0,0,0,0,0,2
5396,797631,14,2,6,1,5,1,1,0,0,0,2,1,2,1,2,0,5
5396,797629,11,1,3,1,3,0,0,0,0,0,1,0,1,1,1,0,2
5396,789044,6,2,3,2,2,0,1,0,0,1,1,0,2,1,1,0,4
5396,797632,2,0,0,0,0,0,0,0,0,0,0,0,0,0,0,0,0
5397,786080,29,4,11,2,4,2,7,9,11,0,3,1,2,2,0,0,19
5397,786216,28,0,4,0,4,0,0,0,0,2,5,0,4,3,4,0,0
5397,791348,32,3,9,2,5,1,4,0,0,0,4,0,1,0,6,0,7
5397,791350,21,2,4,0,0,2,4,0,0,0,5,0,1,0,1,0,6
5397,786218,33,3,14,3,8,0,6,4,7,1,3,2,1,0,0,0,10
5397,797258,7,0,1,0,0,0,1,0,0,0,2,0,2,0,1,0,0
5397,797256,2,2,2,1,1,1,1,0,0,0,1,0,0,0,0,0,5
5397,781645,23,1,6,0,4,1,2,2,4,2,3,0,2,2,3,0,5
5397,780156,12,0,1,0,0,0,1,2,2,0,0,1,0,0,0,0,2
5397,780150,11,0,3,0,0,0,3,0,0,0,0,0,1,1,0,0,0
5397,797259,1,0,0,0,0,0,0,0,0,0,0,0,0,0,0,0,0
5397,786221,1,0,0,0,0,0,0,0,0,0,0,0,0,0,0,0,0
5398,776344,30,5,9,4,7,1,2,3,4,2,3,0,3,1,3,1,14
5398,775821,25,4,9,2,7,2,2,4,4,1,4,2,2,0,2,1,14
5398,792453,32,3,12,3,8,0,4,0,0,1,2,3,1,1,2,0,6
5398,785131,31,4,9,4,6,0,3,3,4,1,3,3,4,2,2,0,11
5398,781538,33,2,5,0,0,2,5,4,4,0,4,2,1,1,1,0,10
5398,798113,15,1,2,1,2,0,0,0,1,2,4,0,1,0,0,1,2
5398,785152,10,1,1,1,1,0,0,1,2,1,1,1,2,0,0,0,3
5398,798115,24,3,7,0,1,3,6,1,2,0,2,2,0,1,0,0,10
5399,791053,18,4,8,4,8,0,0,1,1,1,3,0,3,0,2,0,9
5399,785524,19,2,5,0,1,2,4,0,0,0,0,0,3,1,2,0,6
5399,781115,25,0,1,0,1,0,0,0,0,1,4,3,1,0,3,0,0
5399,775094,19,2,5,2,3,0,2,0,0,1,5,2,1,0,1,0,4
5399,775456,27,4,12,2,9,2,3,3,4,3,3,5,0,2,2,0,13
5399,796731,12,2,5,2,5,0,0,0,0,2,3,1,1,1,1,0,4
5399,796730,6,2,3,2,2,0,1,0,0,0,0,0,3,0,0,0,4
5399,791051,20,2,3,2,3,0,0,0,0,1,4,0,3,0,0,3,4
5399,790819,19,2,8,2,7,0,1,2,3,0,0,2,3,0,1,0,6
5399,786310,8,1,2,0,0,1,2,0,0,0,0,0,1,0,0,0,3
5399,780739,27,4,6,4,6,0,0,2,4,2,4,1,0,0,0,0,10
5400,796837,16,2,6,2,3,0,3,0,0,0,2,0,1,0,0,1,4
5400,791171,21,0,2,0,2,0,0,3,4,1,5,3,2,0,2,0,3
5400,791170,26,2,5,0,2,2,3,0,0,0,2,1,1,0,1,0,6
5400,785700,38,5,6,4,4,1,2,1,1,0,5,5,2,0,1,0,12
5400,780269,37,8,19,6,13,2,6,6,10,1,2,2,2,0,3,0,24
5400,796838,19,4,5,4,5,0,0,1,1,1,2,1,5,3,1,1,9
5400,790511,25,4,10,4,10,0,0,0,0,1,2,0,4,0,1,0,8
5400,796833,9,0,2,0,1,0,1,0,0,0,0,0,1,1,1,0,0
5400,785706,9,0,0,0,0,0,0,0,0,0,0,0,1,0,0,0,0
5401,786704,32,6,10,6,10,0,0,5,5,1,13,0,1,0,0,1,17
5401,785395,28,4,9,3,5,1,4,0,0,1,2,3,1,0,0,0,9
5401,775840,28,1,4,1,2,0,2,2,2,1,0,3,3,1,1,0,4
5401,775955,25,10,11,9,10,1,1,4,4,0,4,1,2,0,3,0,25
5401,775811,17,0,0,0,0,0,0,2,2,0,1,1,2,0,0,0,2
5401,786706,8,0,1,0,1,0,0,2,4,1,1,0,3,0,0,0,2
5401,775287,12,2,3,0,0,2,3,0,0,0,0,1,2,0,0,0,6
5401,786702,5,0,0,0,0,0,0,0,0,0,2,0,3,0,2,0,0
5401,790921,14,2,2,2,2,0,0,0,0,0,1,0,1,0,0,0,4
5401,786551,31,2,10,0,4,2,6,5,6,0,2,4,2,1,2,0,11
5402,791537,20,6,11,3,6,3,5,0,0,2,2,0,4,1,4,1,15
5402,786358,29,0,6,0,3,0,3,0,0,1,3,1,5,0,2,1,0
5402,775846,35,4,7,2,4,2,3,0,0,3,3,0,4,0,0,2,10
5402,780306,35,7,16,6,14,1,2,5,7,4,7,3,3,1,2,0,20
5402,797116,38,2,14,2,9,0,5,5,6,3,2,9,0,0,1,1,9
5402,791535,20,1,3,1,1,0,2,1,2,0,1,1,3,0,1,0,3
5402,775418,22,2,2,2,2,0,0,8,11,2,5,0,4,1,1,1,12
5402,791538,1,0,0,0,0,0,0,0,0,0,0,0,0,0,0,0,0
5403,786203,37,1,9,1,3,0,6,2,4,0,1,3,2,0,1,1,4
5403,786197,25,5,8,4,6,1,2,2,3,0,1,0,4,0,2,3,13
5403,780717,38,8,11,5,6,3,5,5,5,0,12,3,1,2,2,2,24
5403,791742,38,5,10,5,8,0,2,8,9,0,2,4,3,0,2,0,18
5403,776266,31,1,3,1,3,0,0,0,0,0,2,1,3,1,0,0,2
5403,791738,8,0,1,0,1,0,0,0,0,0,1,1,5,0,1,0,0
5403,797337,9,0,1,0,1,0,0,4,4,0,1,0,3,0,0,0,4
5403,791740,9,2,4,1,2,1,2,0,0,0,1,0,2,0,0,0,5
5403,791741,5,1,3,1,2,0,1,0,0,0,0,1,0,0,1,0,2
5404,780095,24,0,2,0,2,0,0,0,0,0,4,1,5,0,0,0,0
5404,776321,23,2,7,2,6,0,1,4,4,0,1,0,5,0,4,0,8
5404,786081,36,1,4,1,3,0,1,0,0,0,4,0,3,0,3,0,2
5404,785431,34,3,8,3,5,0,3,0,0,0,3,3,1,1,5,1,6
5404,780232,38,6,15,4,8,2,7,9,10,0,1,0,3,5,0,0,23
5404,785356,15,2,5,0,1,2,4,0,0,2,6,0,4,0,1,0,6
5404,797918,4,1,1,0,0,1,1,0,0,0,0,2,0,0,0,0,3
5404,789040,21,1,6,0,2,1,4,1,1,1,4,0,4,0,3,1,4
5404,781328,5,1,1,1,1,0,0,1,2,1,0,0,1,0,0,0,3
5405,791524,33,8,12,4,7,4,5,5,11,2,6,1,1,2,1,1,25
5405,797139,20,4,8,4,8,0,0,3,6,3,4,1,3,0,3,1,11
5405,775394,28,4,9,4,8,0,1,2,3,1,6,0,1,0,3,0,10
5405,791526,32,1,4,1,2,0,2,4,4,0,3,3,4,1,3,0,6
5405,780272,32,2,7,2,4,0,3,4,4,1,3,2,0,1,3,0,8
5405,785970,10,2,4,2,4,0,0,0,0,2,3,0,0,0,0,1,4
5405,791523,14,2,2,1,1,1,1,0,0,0,2,0,2,3,1,0,5
5405,780273,21,1,4,0,0,1,4,0,0,0,1,0,1,0,1,0,3
5405,786354,7,0,2,0,2,0,0,0,1,0,0,0,2,0,0,0,0
5405,797141,1,0,0,0,0,0,0,1,2,0,0,0,0,0,0,0,1
5405,791525,1,0,0,0,0,0,0,0,0,0,0,0,0,0,0,0,0
5405,797137,1,0,0,0,0,0,0,0,0,0,0,0,0,0,0,0,0
5406,785532,24,2,5,2,5,0,0,2,4,2,4,1,5,0,2,2,6
5406,780063,32,5,10,4,8,1,2,4,4,1,1,3,1,1,3,0,15
5406,791280,20,2,5,1,1,1,4,1,1,0,1,3,2,0,0,0,6
5406,775573,16,1,3,0,1,1,2,2,2,1,0,0,1,1,0,0,5
5406,775926,26,2,10,1,5,1,5,2,2,1,1,2,0,0,0,0,7
5406,791058,2,0,0,0,0,0,0,0,0,1,0,0,3,0,0,0,0
5406,791057,2,0,1,0,0,0,1,0,0,0,0,0,1,0,0,0,0
5406,791055,30,6,8,4,6,2,2,1,2,2,5,1,0,1,0,0,15
5406,785530,24,5,14,4,8,1,6,0,0,0,2,0,4,0,1,0,11
5406,791059,18,1,2,1,2,0,0,1,3,2,4,0,5,0,2,4,3
5406,796734,6,0,0,0,0,0,0,0,0,0,1,0,1,0,1,0,0
5407,790893,32,3,9,3,9,0,0,1,1,3,7,0,3,0,3,2,7
5407,796444,35,6,13,5,11,1,2,12,15,5,3,3,1,2,2,2,25
5407,786615,24,1,8,1,5,0,3,1,2,1,2,2,3,0,0,0,3
5407,786732,16,2,4,2,3,0,1,0,0,0,2,1,4,1,1,0,4
5407,775260,33,5,8,2,4,3,4,5,6,2,1,1,0,1,0,0,18
5407,775536,12,2,2,2,2,0,0,0,0,0,1,1,3,0,1,0,4
5407,790890,27,4,11,2,8,2,3,1,1,0,3,3,3,1,2,0,11
5407,790889,16,1,3,0,1,1,2,0,0,3,3,1,0,0,1,0,3
5407,780702,5,0,0,0,0,0,0,1,2,0,0,0,0,0,0,0,1
5408,775510,35,9,12,5,7,4,5,0,1,0,6,0,1,1,2,1,22
5408,774976,30,7,11,5,8,2,3,2,2,1,4,2,1,0,2,5,18
5408,797865,39,2,5,2,5,0,0,2,2,0,5,3,2,1,1,1,6
5408,786614,25,1,4,0,1,1,3,0,0,0,1,0,1,0,0,0,3
5408,786759,33,1,10,1,7,0,3,0,0,1,2,8,1,0,3,0,2
5408,786761,9,1,1,1,1,0,0,2,2,2,1,0,0,0,0,0,4
5408,792291,1,0,1,0,0,0,1,0,0,0,0,0,0,0,1,0,0
5408,792293,28,4,8,3,5,1,3,0,0,0,4,1,2,0,0,0,9
5409,781462,37,6,17,5,15,1,2,0,0,1,3,2,2,0,1,5,13
5409,780876,38,7,11,5,7,2,4,3,4,0,6,1,1,1,0,3,19
5409,785353,26,1,8,0,5,1,3,0,0,0,2,1,1,0,1,0,3
5409,781673,40,1,2,0,1,1,1,0,0,0,5,0,2,1,0,0,3
5409,781457,39,7,12,3,7,4,5,2,2,0,1,8,4,6,2,0,20
5409,785355,12,2,2,2,2,0,0,0,0,0,2,0,0,0,1,0,4
5409,790895,8,0,1,0,1,0,0,0,0,0,1,0,1,0,1,0,0
5410,797779,36,4,10,1,3,3,7,2,2,1,1,4,3,0,1,0,13
5410,785568,28,2,5,1,4,1,1,1,2,0,4,1,4,1,1,0,6
5410,797778,21,3,10,2,6,1,4,0,0,2,2,0,1,1,0,0,7
5410,797769,21,2,4,2,3,0,1,0,0,0,1,0,3,1,3,1,4
5410,786256,36,4,13,4,13,0,0,3,4,5,7,4,3,1,3,1,11
5410,797770,16,1,4,1,3,0,1,0,0,0,4,1,1,0,1,1,2
5410,797768,2,0,1,0,0,0,1,0,0,0,0,0,1,0,0,0,0
5410,775106,5,1,3,1,2,0,1,2,2,0,1,0,1,0,0,0,4
5410,797780,9,1,5,0,3,1,2,4,4,0,0,1,1,0,0,0,7
5410,797774,16,6,8,3,4,3,4,2,2,0,1,1,5,0,0,0,17
5410,797771,10,1,1,0,0,1,1,0,0,0,1,0,2,0,0,0,3
5411,792029,24,8,12,8,11,0,1,5,5,0,1,1,4,0,1,0,21
5411,761149,31,5,7,4,4,1,3,0,0,0,5,2,2,2,1,1,11
5411,792032,32,2,6,2,4,0,2,7,8,0,4,2,4,1,2,0,11
5411,792031,28,4,8,2,4,2,4,2,2,1,4,1,3,1,1,0,12
5411,780828,31,6,15,6,14,0,1,2,3,0,11,5,1,0,2,1,14
5411,797641,14,1,4,1,4,0,0,0,0,1,3,0,3,0,1,1,2
5411,797640,10,1,1,1,1,0,0,2,3,1,0,1,1,0,0,0,4
5411,797637,26,1,2,0,0,1,2,4,4,0,3,0,4,0,1,0,7
5411,792030,4,1,1,1,1,0,0,0,0,1,0,0,0,0,0,0,2
5412,792035,34,10,16,10,16,0,0,3,9,3,3,3,3,0,1,1,23
5412,780833,28,3,5,3,5,0,0,2,2,1,7,1,2,0,3,0,8
5412,792034,32,5,9,4,7,1,2,3,3,1,10,5,1,3,1,0,14
5412,792033,29,2,7,1,3,1,4,0,0,0,0,2,4,0,1,2,5
5412,780830,34,5,10,3,8,2,2,4,4,0,5,3,3,0,1,0,16
5412,797645,6,2,2,2,2,0,0,1,1,0,0,2,4,0,0,0,5
5412,785381,23,4,8,0,1,4,7,0,0,0,3,0,0,1,0,0,12
5412,791688,4,0,1,0,1,0,0,0,0,0,1,0,0,0,0,0,0
5412,785980,10,1,2,1,1,0,1,0,0,0,1,0,1,2,0,0,2
5413,786481,36,5,11,4,10,1,1,4,6,2,6,0,4,0,3,1,15
5413,797626,33,6,10,3,6,3,4,2,2,1,2,5,3,0,2,0,17
5413,797624,12,1,3,1,1,0,2,0,0,1,0,0,2,0,1,0,2
5413,786480,21,1,7,1,4,0,3,4,7,0,4,0,3,2,1,1,6
5413,781032,38,3,9,1,3,2,6,0,0,0,4,3,2,1,0,0,8
5413,797628,29,4,10,4,8,0,2,2,2,0,6,1,4,0,1,0,10
5413,785965,24,7,11,5,6,2,5,0,0,1,0,2,1,0,0,0,16
5413,791791,3,0,1,0,0,0,1,0,0,0,0,0,0,0,0,0,0
5413,791793,3,0,0,0,0,0,0,0,0,0,0,0,0,0,0,0,0
5413,797627,1,0,0,0,0,0,0,0,0,0,0,0,0,0,0,0,0
5414,791669,25,3,6,3,6,0,0,0,0,1,2,1,2,0,3,2,6
5414,785762,28,6,11,5,9,1,2,2,4,2,7,0,5,0,0,0,15
5414,797407,26,2,7,2,3,0,4,2,2,0,3,9,1,0,1,1,6
5414,785760,22,1,4,0,0,1,4,0,0,2,1,1,2,0,0,1,3
5414,780531,39,7,14,1,2,6,12,2,2,0,5,5,0,1,2,1,22
5414,780534,18,2,2,2,2,0,0,0,0,3,3,0,1,1,0,0,4
5414,797409,11,1,5,0,0,1,5,1,2,0,0,3,1,0,0,0,4
5414,791666,24,2,7,1,4,1,3,4,5,0,3,2,2,0,0,0,9
5414,797411,3,1,2,0,0,1,2,0,0,0,0,0,1,0,0,0,3
5414,797414,4,0,0,0,0,0,0,0,0,0,0,0,0,0,0,0,0
5415,797824,24,2,3,1,1,1,2,0,0,0,4,0,1,0,0,0,5
5415,797825,7,0,0,0,0,0,0,0,0,0,1,0,2,1,0,0,0
5415,797822,31,1,6,1,1,0,5,0,0,1,1,1,1,0,3,1,2
5415,792190,36,6,16,6,12,0,4,0,0,2,2,4,1,0,1,1,12
5415,786664,34,5,12,4,6,1,6,4,6,3,6,3,3,1,2,0,15
5415,792192,18,1,3,1,3,0,0,2,2,2,4,0,2,1,1,0,4
5415,775116,30,5,13,1,3,4,10,3,6,0,5,1,3,0,1,0,17
5415,792191,20,1,3,1,2,0,1,6,8,1,2,0,1,0,0,0,8
5416,774806,33,10,15,10,15,0,0,6,9,5,11,4,2,0,5,2,26
5416,789023,40,5,10,1,4,4,6,8,12,0,1,8,3,3,4,0,22
5416,791041,40,6,8,3,3,3,5,3,3,2,4,4,4,1,4,0,18
5416,775823,19,2,3,2,3,0,0,4,5,2,2,1,4,2,0,0,8
5416,791038,26,1,7,1,3,0,4,0,0,0,4,0,4,0,1,0,2
5416,775205,34,4,6,0,1,4,5,4,4,0,2,3,3,2,0,0,16
5416,796714,8,0,1,0,1,0,0,4,7,0,2,0,2,0,1,1,4
5416,796711,0,0,0,0,0,0,0,0,0,0,0,0,0,0,0,0,0
5416,796712,0,0,0,0,0,0,0,0,0,0,0,0,0,0,0,0,0
5417,781486,28,5,6,3,4,2,2,4,7,1,1,3,5,1,1,0,16
5417,780461,29,5,9,3,6,2,3,2,2,0,3,5,2,0,2,0,14
5417,791497,28,3,8,2,5,1,3,3,5,0,3,2,3,1,5,1,10
5417,791498,16,4,7,4,7,0,0,0,2,1,1,0,2,2,1,1,8
5417,797180,18,2,5,1,1,1,4,0,0,0,3,1,1,1,1,0,5
5417,791499,14,2,2,1,1,1,1,2,4,0,0,1,3,0,1,0,7
5417,780240,27,2,4,2,4,0,0,2,2,0,3,0,3,0,1,0,6
5417,776379,13,1,3,1,2,0,1,2,2,0,0,1,1,0,0,0,4
5417,791503,15,1,2,0,0,1,2,0,0,0,2,0,1,1,1,0,3
5417,774812,7,1,3,1,2,0,1,0,0,0,1,1,5,0,1,0,2
5417,791502,5,0,1,0,0,0,1,0,0,0,1,0,1,0,0,0,0
5417,786842,0,0,0,0,0,0,0,0,0,0,0,0,1,0,0,0,0
5418,785126,21,5,7,5,6,0,1,0,0,0,3,0,1,0,1,0,10
5418,779857,21,2,6,2,6,0,0,2,3,1,2,0,0,0,0,4,6
5418,791014,24,4,8,0,1,4,7,0,0,0,2,1,0,0,0,0,12
5418,779976,27,0,7,0,2,0,5,4,4,0,2,6,3,1,2,0,4
5418,774990,25,6,11,5,8,1,3,2,2,1,5,5,3,1,4,0,15
5418,796673,16,2,7,1,4,1,3,2,4,1,4,0,0,0,1,0,7
5418,796674,15,0,2,0,1,0,1,0,0,0,4,0,3,0,0,0,0
5418,781586,18,2,5,2,5,0,0,3,6,4,5,0,2,0,2,0,7
5418,785961,7,0,1,0,0,0,1,2,2,0,1,0,2,0,1,0,2
5418,785339,25,0,2,0,0,0,2,0,0,1,9,3,3,1,0,0,0
5418,780142,1,0,0,0,0,0,0,2,2,0,0,0,0,0,0,0,2
5419,786566,31,4,13,3,8,1,5,2,4,1,9,0,3,0,1,0,11
5419,781204,34,1,10,0,7,1,3,0,0,1,9,1,3,0,0,0,3
5419,786568,10,2,3,2,3,0,0,0,0,2,2,0,3,0,2,0,4
5419,791993,26,2,7,2,6,0,1,3,3,0,2,1,2,1,1,0,7
5419,781188,38,7,16,6,12,1,4,6,6,1,1,4,1,3,2,1,21
5419,786562,17,0,2,0,2,0,0,0,0,0,1,2,3,0,0,0,0
5419,781189,21,3,7,1,4,2,3,0,0,1,1,0,3,1,0,0,8
5419,791997,9,0,4,0,0,0,4,0,0,0,1,1,0,0,1,0,0
5419,797494,9,0,4,0,2,0,2,0,0,1,0,0,0,0,0,0,0
5419,797493,5,0,0,0,0,0,0,0,1,0,0,0,2,0,0,1,0
5430,791401,33,4,10,4,10,0,0,5,7,1,6,0,1,2,4,2,13
5430,780125,31,5,9,5,8,0,1,1,1,0,2,0,2,1,1,0,11
5430,791400,34,4,11,1,7,3,4,3,4,1,2,3,4,0,3,0,14
5430,785931,26,2,7,1,4,1,3,2,2,0,3,5,1,1,1,0,7
5430,780118,31,3,8,1,5,2,3,0,0,2,3,2,2,0,0,0,8
5430,786837,12,3,6,1,3,2,3,1,3,0,1,0,1,1,0,0,9
5430,797132,16,0,1,0,1,0,0,0,0,0,3,3,0,0,2,0,0
5430,797126,6,1,1,1,1,0,0,0,0,1,0,1,2,1,0,0,2
5430,797130,11,2,3,0,1,2,2,0,0,0,0,0,0,0,0,0,6
5431,780634,27,4,4,4,4,0,0,0,0,2,6,0,3,3,2,5,8
5431,791826,36,3,7,1,2,2,5,1,2,1,0,3,3,1,2,0,9
5431,786785,37,4,10,3,5,1,5,6,8,1,11,2,2,0,1,1,15
5431,786783,26,3,6,2,4,1,2,0,0,1,3,2,4,2,0,0,7
5431,780633,37,7,15,3,6,4,9,1,2,0,1,5,1,1,1,0,19
5431,797389,12,3,4,3,4,0,0,2,2,0,3,1,2,0,0,0,8
5431,786784,3,0,0,0,0,0,0,0,0,0,0,0,0,0,1,1,0
5431,776009,22,3,7,3,6,0,1,2,3,0,1,2,1,1,1,0,8
5432,791890,37,10,19,6,9,4,10,6,9,0,2,5,0,5,6,0,30
5432,780719,37,6,11,5,7,1,4,3,3,0,6,4,5,2,2,0,16
5432,791889,37,2,5,1,1,1,4,0,0,0,3,2,0,0,0,1,5
5432,781071,18,2,6,1,1,1,5,0,0,0,4,0,0,0,1,0,5
5432,797591,8,0,0,0,0,0,0,0,0,0,2,0,1,0,0,0,0
5432,797589,33,3,7,1,1,2,6,2,2,0,6,2,4,0,2,0,10
5432,780098,25,2,2,2,2,0,0,2,2,1,3,0,5,1,3,0,6
5432,797588,5,0,1,0,0,0,1,0,0,1,0,0,0,0,0,0,0
5432,791888,0,0,0,0,0,0,0,0,0,0,1,0,1,0,0,0,0
5432,797590,0,0,0,0,0,0,0,0,0,0,0,0,0,0,0,0,0
5433,785742,32,10,18,5,7,5,11,5,7,0,1,2,2,1,1,0,30
5433,780163,33,3,12,1,7,2,5,8,12,0,3,2,0,1,0,0,16
5433,797241,34,5,7,4,6,1,1,0,0,1,4,1,1,2,3,0,11
5433,791366,19,4,8,2,5,2,3,0,0,1,1,3,2,1,0,0,10
5433,797244,31,2,2,1,1,1,1,0,0,0,11,3,3,2,2,0,5
5433,791363,13,1,2,1,1,0,1,2,2,0,0,2,2,0,0,0,4
5433,791361,14,1,2,0,0,1,2,0,0,1,0,0,4,0,3,0,3
5433,786340,12,0,1,0,0,0,1,0,0,0,1,0,1,0,0,0,0
5433,780170,6,0,0,0,0,0,0,0,2,1,2,1,0,0,1,0,0
5433,797243,6,0,0,0,0,0,0,0,0,0,1,2,0,0,1,0,0
5434,786690,21,8,12,6,9,2,3,0,1,2,6,1,4,0,1,0,18
5434,791161,30,2,10,0,0,2,10,0,1,0,4,0,1,0,0,0,6
5434,780629,36,4,7,3,4,1,3,3,4,1,6,1,3,0,2,0,12
5434,774845,39,6,10,4,6,2,4,8,9,0,1,9,2,2,2,0,22
5434,775888,38,4,7,1,2,3,5,2,4,0,11,5,4,1,6,2,13
5434,796816,19,4,5,2,3,2,2,0,0,0,4,1,1,0,1,1,10
5434,785346,17,0,2,0,0,0,2,0,0,0,1,0,2,1,0,0,0
5435,776285,7,2,4,2,4,0,0,1,1,2,3,1,3,0,0,0,5
5435,791780,19,1,5,0,3,1,2,0,0,0,3,0,2,0,1,0,3
5435,791777,26,6,14,5,9,1,5,2,2,0,2,1,0,3,0,1,15
5435,781025,20,5,11,4,6,1,5,0,0,1,2,1,0,0,1,1,11
5435,786474,28,1,7,1,6,0,1,2,2,0,2,4,2,1,1,0,4
5435,791778,1,0,0,0,0,0,0,0,0,0,0,1,0,0,1,0,0
5435,786476,32,3,5,3,5,0,0,2,4,4,5,0,3,0,1,0,8
5435,791776,22,4,6,2,2,2,4,1,1,1,1,0,1,3,0,0,11
5435,791829,21,4,12,3,9,1,3,0,1,0,2,1,1,1,1,0,9
5435,780488,11,3,6,1,3,2,3,2,3,0,0,3,3,0,0,0,10
5435,775503,13,0,3,0,1,0,2,1,2,2,2,1,2,1,0,0,1
5436,796574,25,6,10,2,2,4,8,0,0,1,2,4,4,1,0,0,16
5436,791289,22,5,8,5,8,0,0,3,4,3,8,1,0,0,1,2,13
5436,781346,25,3,8,0,2,3,6,0,0,1,2,7,1,2,1,0,9
5436,796571,32,3,9,3,4,0,5,0,0,0,4,8,1,2,3,0,6
5436,785786,23,1,3,1,1,0,2,1,2,3,4,0,1,0,2,1,3
5436,796576,29,7,13,2,5,5,8,2,4,0,4,1,4,3,1,0,21
5436,796572,18,2,4,1,3,1,1,1,2,0,2,0,1,1,3,1,6
5436,791290,16,0,5,0,3,0,2,0,0,2,1,1,1,0,0,0,0
5436,791288,7,0,1,0,1,0,0,0,0,1,0,0,2,0,1,0,0
5436,791287,3,0,0,0,0,0,0,0,2,0,1,0,0,0,0,0,0
5437,780812,38,10,18,7,9,3,9,9,10,1,6,3,3,4,3,1,32
5437,796766,20,3,8,2,3,1,5,0,0,2,0,0,4,0,1,0,7
5437,796765,34,2,5,0,0,2,5,0,0,1,4,3,2,2,3,0,6
5437,796767,27,1,7,1,4,0,3,0,0,0,2,3,1,1,3,2,2
5437,791113,16,0,4,0,3,0,1,0,0,0,2,0,1,0,0,0,0
5437,785614,22,2,4,2,4,0,0,3,3,1,3,0,5,0,2,0,7
5437,785618,25,2,5,0,0,2,5,0,0,0,3,0,0,0,0,1,6
5437,780813,18,1,4,1,2,0,2,0,1,0,3,1,0,1,4,0,2
5438,786459,36,9,15,9,15,0,0,9,11,3,1,0,1,2,2,1,27
5438,781612,26,4,11,4,10,0,1,1,2,3,3,0,4,2,1,3,9
5438,797006,21,3,8,2,6,1,2,0,0,0,2,2,3,0,1,0,7
5438,797004,33,3,7,3,5,0,2,2,2,1,2,6,3,0,1,0,8
5438,781609,32,4,15,3,8,1,7,4,4,2,5,0,2,2,0,0,13
5438,797005,11,1,3,0,1,1,2,0,0,0,2,0,2,1,0,0,3
5438,797008,3,0,0,0,0,0,0,0,0,0,0,0,0,0,0,0,0
5438,791360,23,2,6,1,2,1,4,2,2,0,0,0,2,0,1,0,7
5438,797003,15,0,3,0,1,0,2,0,0,0,1,0,4,2,1,0,0
5439,797205,11,1,2,0,0,1,2,0,0,0,1,1,2,0,2,2,3
5439,786316,14,5,8,5,8,0,0,0,0,2,0,1,4,0,0,0,10
5439,791475,19,1,5,0,2,1,3,0,0,0,2,0,0,1,2,0,3
5439,791477,31,6,9,5,6,1,3,3,4,0,11,0,0,0,1,1,16
5439,780220,34,8,15,8,12,0,3,4,6,1,4,4,3,1,2,0,20
5439,797206,26,2,4,2,4,0,0,2,2,1,6,0,4,2,0,1,6
5439,786314,28,4,7,3,6,1,1,5,8,2,3,0,1,0,3,0,14
5439,797202,21,1,2,0,0,1,2,2,2,1,2,9,1,0,3,0,5
5439,791476,16,2,4,1,2,1,2,0,0,0,1,0,4,0,2,0,5
5440,785836,27,3,5,3,3,0,2,0,0,1,3,2,3,1,2,3,6
5440,785833,30,2,8,2,6,0,2,2,3,1,3,0,2,0,2,1,6
5440,775872,8,0,0,0,0,0,0,0,0,1,1,0,0,0,1,0,0
5440,791704,22,1,6,1,5,0,1,0,0,1,6,0,1,0,1,1,2
5440,785838,34,6,14,4,7,2,7,0,0,1,3,3,1,0,2,0,14
5440,791705,23,3,8,2,6,1,2,2,2,2,4,1,2,0,1,1,9
5440,797534,9,0,0,0,0,0,0,0,0,0,1,2,4,0,0,0,0
5440,797533,11,2,5,0,3,2,2,0,0,0,0,0,2,1,1,0,6
5440,791707,26,6,9,5,7,1,2,1,1,0,2,1,3,1,2,0,14
5440,785892,10,3,5,2,4,1,1,0,1,1,0,0,0,0,1,0,7
5441,781134,31,2,6,2,6,0,0,8,8,1,7,2,1,2,0,0,12
5441,774874,32,2,4,2,4,0,0,4,8,1,7,2,1,1,3,0,8
5441,796531,37,5,12,4,8,1,4,0,0,0,4,2,2,2,1,1,11
5441,786475,30,7,8,4,4,3,4,6,9,0,2,1,2,1,1,0,23
5441,785270,25,5,8,3,3,2,5,4,5,1,1,0,2,2,0,0,16
5441,780085,5,0,0,0,0,0,0,0,0,1,0,0,0,0,0,0,0
5441,780083,2,0,0,0,0,0,0,0,0,0,0,0,0,0,1,0,0
5441,796533,2,0,2,0,1,0,1,0,0,0,0,0,1,0,0,0,0
5441,790946,11,0,3,0,1,0,2,0,0,0,2,1,0,0,1,0,0
5441,780084,2,0,0,0,0,0,0,0,0,0,1,0,0,0,0,0,0
5441,775468,23,6,9,5,7,1,2,0,0,1,1,1,1,2,1,0,13
5442,785791,36,3,13,0,2,3,11,0,0,2,2,0,3,2,0,0,9
5442,775606,24,2,4,2,4,0,0,1,2,2,7,1,2,1,0,1,5
5442,791672,18,1,5,1,5,0,0,0,2,2,0,1,3,1,0,0,2
5442,791674,28,3,7,3,6,0,1,4,4,0,1,3,4,1,1,0,10
5442,780552,39,4,10,0,2,4,8,0,0,2,4,1,1,2,1,1,12
5442,785787,30,10,16,5,10,5,6,1,1,0,2,0,2,2,0,0,26
5442,780550,25,1,7,1,7,0,0,7,8,1,1,2,3,2,4,0,9
5442,780538,25,1,4,0,3,1,1,0,0,0,0,4,1,1,2,0,3
5443,781058,37,5,10,4,9,1,1,3,3,1,8,0,1,1,1,1,14
5443,780327,32,3,5,3,5,0,0,1,1,2,5,1,2,0,2,1,7
5443,797458,37,4,8,4,6,0,2,6,9,2,7,2,4,0,6,1,14
5443,791847,33,2,6,1,2,1,4,3,4,0,4,1,1,0,3,1,8
5443,791849,38,4,10,1,2,3,8,4,6,0,3,3,0,2,4,0,15
5443,791848,12,2,3,2,3,0,0,0,0,2,1,0,2,0,1,0,4
5443,797455,8,3,4,3,4,0,0,0,0,0,0,0,2,0,0,0,6
5443,797456,17,0,1,0,0,0,1,0,0,0,0,1,3,0,2,0,0
5443,797452,11,0,1,0,0,0,1,0,0,0,0,0,1,0,2,0,0
5444,776150,35,6,10,3,4,3,6,1,2,1,8,2,1,3,2,0,16
5444,797445,25,3,8,2,6,1,2,5,6,3,4,1,2,1,4,0,12
5444,786110,25,2,9,1,4,1,5,0,0,2,1,0,1,0,2,0,5
5444,791583,28,2,7,2,7,0,0,0,0,1,8,2,1,0,3,4,4
5444,786659,18,2,5,2,4,0,1,1,2,0,3,0,3,0,2,1,5
5444,785623,24,1,3,1,2,0,1,0,0,1,3,1,2,0,2,1,2
5444,786608,12,1,3,1,3,0,0,0,0,2,0,0,0,0,0,0,2
5444,797448,12,1,6,1,3,0,3,0,0,1,2,1,0,0,1,0,2
5444,781407,21,2,3,2,3,0,0,0,0,0,5,1,0,0,0,0,4
5445,785741,37,5,14,4,9,1,5,0,2,1,5,3,2,0,0,0,11
5445,796529,35,3,8,1,4,2,4,0,0,1,1,5,4,3,2,0,8
5445,791276,29,4,11,4,11,0,0,0,0,3,4,2,4,0,2,1,8
5445,785746,38,1,7,0,1,1,6,2,2,0,1,1,2,3,3,1,5
5445,791275,34,1,7,0,2,1,5,0,0,0,5,1,3,1,4,0,3
5445,785748,13,3,7,2,3,1,4,0,0,1,2,1,0,0,0,0,7
5445,785755,12,0,1,0,1,0,0,0,2,0,0,0,2,0,0,0,0
5445,796526,2,0,1,0,0,0,1,0,0,0,0,0,0,0,0,0,0
5445,785751,0,0,0,0,0,0,0,0,0,0,0,0,0,0,0,0,0
5446,780303,35,7,16,6,14,1,2,3,5,1,7,0,2,1,2,1,18
5446,791012,37,5,9,4,4,1,5,1,1,1,1,1,2,0,1,0,12
5446,791594,35,5,13,5,12,0,1,2,2,2,3,2,3,0,2,0,12
5446,791011,25,2,5,2,2,0,3,0,0,0,3,3,4,0,0,1,4
5446,781385,13,1,1,1,1,0,0,0,0,1,1,0,5,2,4,0,2
5446,786349,25,2,4,2,4,0,0,1,2,0,2,1,1,0,4,1,5
5446,796668,2,1,1,1,1,0,0,0,0,0,0,0,0,0,0,0,2
5446,791013,9,0,1,0,1,0,0,1,3,0,1,0,0,0,0,0,1
5446,796671,10,0,0,0,0,0,0,0,0,1,2,0,2,0,2,1,0
5446,796670,7,0,1,0,1,0,0,0,0,0,0,1,1,0,0,0,0
5446,796669,2,0,0,0,0,0,0,0,0,0,0,0,0,0,0,0,0
5447,780324,29,8,10,8,10,0,0,3,5,1,5,3,1,3,3,0,19
5447,775897,31,5,7,4,5,1,2,2,3,3,5,1,2,2,3,0,13
5447,791543,25,3,7,1,3,2,4,0,0,0,0,1,3,0,1,0,8
5447,780317,28,1,4,1,2,0,2,0,1,2,6,2,1,2,2,0,2
5447,786530,23,1,3,1,2,0,1,0,0,0,5,4,3,0,1,0,2
5447,784246,27,5,8,5,7,0,1,1,1,0,0,0,0,1,1,0,11
5447,791545,21,2,4,2,3,0,1,4,5,0,2,2,4,1,2,0,8
5447,791546,13,3,7,3,4,0,3,0,0,0,1,0,2,0,2,0,6
5447,786360,3,0,0,0,0,0,0,0,0,0,0,2,0,0,0,0,0
5448,785589,39,4,12,4,12,0,0,2,2,3,8,2,2,0,3,0,10
5448,791216,27,3,10,3,7,0,3,5,6,1,2,1,3,0,2,0,11
5448,791209,22,1,3,1,2,0,1,0,3,3,2,0,3,0,0,1,2
5448,791215,34,6,15,3,7,3,8,0,0,2,2,3,3,1,3,0,15
5448,791214,34,3,14,3,9,0,5,4,4,1,4,3,2,2,4,0,10
5448,791212,11,0,1,0,1,0,0,0,0,1,0,1,0,0,1,1,0
5448,796917,11,1,4,1,3,0,1,0,0,0,1,1,0,0,2,0,2
5448,776313,16,0,3,0,1,0,2,0,0,1,1,2,3,1,0,0,0
5448,791211,6,1,2,0,0,1,2,0,0,0,0,0,1,0,0,0,3
5449,785518,24,3,5,2,3,1,2,3,3,1,6,4,3,0,2,1,10
5449,796390,24,7,13,7,13,0,0,1,4,3,6,0,5,0,2,1,15
5449,785451,23,2,7,1,2,1,5,0,0,0,7,3,1,2,5,0,5
5449,790834,23,2,5,0,1,2,4,2,4,0,4,2,3,0,2,0,8
5449,785379,12,2,4,1,2,1,2,0,0,0,1,1,1,0,0,0,5
5449,790833,22,3,7,1,3,2,4,0,2,1,2,0,2,2,2,0,8
5449,790831,16,4,4,4,4,0,0,0,0,1,3,2,2,1,2,2,8
5449,785377,19,0,2,0,1,0,1,2,2,1,1,5,1,0,2,0,2
5449,790832,19,3,6,1,1,2,5,3,4,0,2,2,0,0,0,0,11
5449,790830,18,3,5,1,3,2,2,0,0,1,0,1,0,0,0,0,8
5450,797103,23,3,4,3,4,0,0,2,3,1,2,2,1,0,3,0,8
5450,797100,28,3,6,0,3,3,3,0,0,1,5,0,4,0,1,0,9
5450,791413,34,6,14,5,11,1,3,5,7,1,4,3,1,0,0,0,18
5450,791411,34,8,14,6,11,2,3,2,2,0,4,3,3,5,2,1,20
5450,785776,19,1,7,1,4,0,3,0,0,0,2,0,2,0,1,0,2
5450,791414,8,0,2,0,2,0,0,0,0,0,1,0,1,0,1,1,0
5450,785911,17,1,4,1,4,0,0,0,0,2,0,1,1,1,1,2,2
5450,797105,18,3,4,2,3,1,1,0,0,1,5,0,1,1,0,0,7
5450,781209,19,0,5,0,1,0,4,0,0,1,2,0,0,0,1,0,0
5451,792373,33,12,20,12,20,0,0,1,2,9,6,0,2,0,0,2,25
5451,792370,37,3,7,3,6,0,1,3,5,3,5,1,2,1,5,2,9
5451,797960,30,1,5,0,1,1,4,0,0,1,2,3,3,1,0,0,3
5451,786739,36,6,14,5,10,1,4,3,3,0,3,8,1,2,2,0,16
5451,775303,35,2,9,0,1,2,8,3,4,1,6,1,1,1,1,0,9
5451,797958,0,0,0,0,0,0,0,0,0,0,0,0,0,0,0,0,0
5451,781598,7,1,2,0,0,1,2,0,0,0,2,0,0,1,0,0,3
5451,797951,15,1,6,0,2,1,4,0,0,1,0,0,1,1,0,0,3
5451,781597,0,0,0,0,0,0,0,2,2,0,0,0,0,0,0,0,2
5451,776491,7,0,2,0,2,0,0,0,0,0,0,0,1,0,2,0,0
5452,796381,28,0,5,0,1,0,4,0,0,1,3,1,0,0,0,0,0
5452,775585,24,3,5,3,5,0,0,0,0,2,1,0,3,1,1,1,6
5452,790822,39,6,17,5,9,1,8,3,4,1,3,3,3,0,1,0,16
5452,780982,34,4,10,4,7,0,3,2,2,0,5,0,2,4,2,1,10
5452,774980,34,8,15,6,10,2,5,2,2,0,3,3,3,2,3,0,20
5452,780445,19,3,6,3,6,0,0,0,0,3,2,0,1,3,1,1,6
5452,790820,19,0,3,0,2,0,1,0,0,0,1,2,1,1,2,0,0
5452,785365,3,0,1,0,0,0,1,1,2,0,0,0,0,0,0,0,1
5453,796431,4,0,3,0,3,0,0,0,0,0,2,0,0,0,0,0,0
5453,796429,4,0,1,0,1,0,0,0,0,1,0,0,0,0,0,0,0
5453,793801,4,0,1,0,0,0,1,0,0,0,0,0,0,0,0,0,0
5453,786298,23,1,3,0,0,1,3,2,2,0,0,2,1,2,0,0,5
5453,774957,17,2,3,1,1,1,2,0,0,0,1,0,1,1,1,0,5
5453,775676,26,6,10,6,10,0,0,4,6,3,2,2,2,1,0,1,16
5453,785423,33,7,10,6,8,1,2,1,2,0,10,1,0,1,2,1,16
5453,785425,27,3,4,2,3,1,1,0,0,1,5,2,2,0,1,0,7
5453,786210,26,2,5,1,3,1,2,0,0,0,5,3,1,2,4,0,5
5453,785422,36,7,12,2,5,5,7,0,1,1,2,9,1,1,7,0,19
5454,786547,21,2,3,1,1,1,2,2,4,3,1,1,2,0,1,0,7
5454,786544,27,5,12,4,10,1,2,2,2,2,5,0,3,0,4,0,13
5454,797507,18,1,2,1,1,0,1,0,0,0,1,3,1,0,1,0,2
5454,792012,40,8,15,4,9,4,6,4,4,0,3,1,4,2,1,0,24
5454,775084,36,3,8,2,3,1,5,5,6,0,1,3,1,0,0,0,12
5454,786860,15,2,3,2,3,0,0,0,0,1,2,0,1,0,0,0,4
5454,797510,7,1,2,1,2,0,0,0,0,1,0,0,1,0,0,0,2
5454,792013,13,2,2,1,1,1,1,2,5,0,2,1,1,2,0,0,7
5454,787622,3,0,0,0,0,0,0,0,0,0,0,0,1,0,0,0,0
5454,786546,17,2,3,1,1,1,2,0,2,0,1,0,2,2,1,1,5
5454,797512,2,0,0,0,0,0,0,0,0,0,0,0,0,0,0,0,0
5454,797508,1,0,0,0,0,0,0,0,0,0,0,0,0,0,0,0,0
5455,792340,33,7,9,6,8,1,1,2,3,0,5,3,5,1,0,0,17
5455,792341,11,1,3,0,1,1,2,0,0,0,0,0,0,0,0,0,3
5455,792342,32,3,6,2,4,1,2,2,2,0,1,4,2,0,2,0,9
5455,792346,38,3,5,3,4,0,1,4,6,2,3,3,2,1,3,1,10
5455,781552,39,10,13,8,10,2,3,2,4,0,3,2,4,2,5,0,24
5455,775599,29,2,4,1,2,1,2,4,4,0,5,1,0,0,1,1,9
5455,792344,18,3,4,0,1,3,3,0,0,0,0,1,3,0,0,1,9
5466,791598,34,6,18,5,15,1,3,3,6,3,6,4,2,1,1,2,16
5466,792116,35,4,7,3,3,1,4,6,6,0,5,2,2,2,2,0,15
5466,780410,36,1,7,0,1,1,6,2,2,0,4,2,1,1,1,0,5
5466,797028,31,1,7,0,3,1,4,1,2,0,3,1,1,1,2,0,4
5466,785687,12,0,1,0,1,0,0,0,0,1,0,1,3,0,1,0,0
5466,791600,22,6,10,2,5,4,5,0,0,0,2,0,2,0,1,0,16
5466,797025,19,1,3,1,3,0,0,0,0,0,1,1,2,0,1,0,2
5466,775047,11,1,3,1,3,0,0,0,0,1,0,1,1,0,0,0,2
5467,781028,38,8,11,5,6,3,5,3,5,0,6,5,1,1,1,1,22
5467,796347,26,5,11,4,7,1,4,0,0,1,7,2,1,0,2,0,11
5467,790788,36,2,6,2,5,0,1,4,4,1,4,4,3,1,2,1,8
5467,781026,21,3,7,3,5,0,2,2,2,0,3,2,1,0,3,0,8
5467,785243,19,4,6,4,4,0,2,0,0,0,1,0,5,0,1,1,8
5467,785242,22,3,5,2,2,1,3,1,1,1,4,2,3,1,1,3,8
5467,781027,12,2,3,2,2,0,1,0,0,0,2,0,0,0,0,0,4
5467,796348,16,0,3,0,3,0,0,0,0,0,0,2,3,2,0,0,0
5467,796349,10,0,0,0,0,0,0,0,0,1,0,1,1,0,1,0,0
5468,785812,40,3,10,2,4,1,6,7,7,1,2,0,3,0,0,0,14
5468,791356,31,5,8,5,8,0,0,2,2,4,4,1,3,2,2,0,12
5468,791680,32,3,9,2,3,1,6,3,5,1,2,1,3,1,2,0,10
5468,780104,38,2,11,2,8,0,3,2,2,0,2,3,4,4,2,0,6
5468,797431,18,2,3,1,1,1,2,1,2,0,1,1,3,1,1,0,6
5468,785815,33,4,16,4,13,0,3,4,4,2,4,3,3,1,1,0,12
5468,791682,7,1,1,1,1,0,0,0,0,1,2,1,3,0,0,0,2
5468,791681,1,0,0,0,0,0,0,0,0,0,0,0,0,0,0,0,0
5469,781054,38,10,17,9,12,1,5,4,7,0,3,2,3,1,4,0,25
5469,774969,36,4,8,4,8,0,0,7,10,3,12,2,4,1,5,3,15
5469,781053,38,3,6,1,2,2,4,1,3,0,5,2,3,1,4,0,9
5469,796850,25,1,2,1,2,0,0,4,4,1,0,0,3,0,1,0,6
5469,791179,19,1,3,0,0,1,3,3,3,0,1,0,3,0,0,0,6
5469,796848,12,1,2,1,2,0,0,0,0,0,1,0,1,0,1,0,2
5469,780981,4,1,1,1,1,0,0,0,0,0,1,0,0,0,0,0,2
5469,791181,23,0,0,0,0,0,0,1,2,1,1,0,1,1,2,0,1
5469,785670,5,0,1,0,0,0,1,1,2,2,0,0,2,0,0,0,1
5470,785843,23,2,5,0,1,2,4,0,0,2,4,1,3,0,0,0,6
5470,780578,22,2,3,2,3,0,0,1,2,0,2,1,5,0,1,0,5
5470,797537,11,2,5,2,4,0,1,2,4,0,0,1,0,0,0,0,6
5470,797538,32,4,13,0,3,4,10,0,0,2,2,4,1,1,3,0,12
5470,780579,35,1,13,1,9,0,4,2,3,1,5,2,2,1,3,0,4
5470,797536,17,1,5,0,2,1,3,1,2,0,2,1,3,0,1,0,4
5470,791709,1,0,0,0,0,0,0,0,0,0,0,0,1,0,0,0,0
5470,785845,17,0,0,0,0,0,0,0,0,0,1,0,1,1,1,4,0
5470,797535,7,1,4,1,3,0,1,0,0,0,1,0,0,1,0,0,2
5470,785293,15,0,4,0,3,0,1,0,0,1,1,1,2,0,1,0,0
5470,785847,20,2,3,1,1,1,2,0,0,0,2,0,2,0,0,0,5
5471,792171,28,2,5,2,5,0,0,5,5,3,11,0,2,0,2,2,9
5471,785674,30,4,11,3,4,1,7,2,2,0,5,2,2,1,2,0,11
5471,780049,27,2,7,2,6,0,1,2,5,1,7,2,0,1,2,1,6
5471,797784,31,7,18,7,14,0,4,2,3,2,4,0,1,1,3,0,16
5471,789059,28,2,7,2,5,0,2,2,6,5,3,0,1,1,2,0,6
5471,797783,5,0,0,0,0,0,0,0,0,1,0,0,0,0,0,0,0
5471,792173,16,0,1,0,0,0,1,0,0,1,2,0,2,0,0,0,0
5471,780527,17,1,6,1,3,0,3,4,4,1,0,0,2,0,1,0,6
5471,780980,18,1,5,1,4,0,1,0,1,2,2,2,3,0,1,0,2
5472,788113,31,5,10,5,6,0,4,7,8,2,3,1,2,1,0,0,17
5472,776497,28,8,13,7,11,1,2,0,0,0,4,2,4,1,2,3,17
5472,785731,33,7,10,7,9,0,1,1,2,3,3,6,2,4,1,1,15
5472,785729,31,5,7,5,5,0,2,4,4,2,2,8,2,2,3,1,14
5472,780864,22,0,3,0,0,0,3,0,0,0,1,2,2,0,5,0,0
5472,799881,1,0,0,0,0,0,0,0,0,0,0,0,1,0,1,0,0
5472,792405,1,0,0,0,0,0,0,0,0,0,0,0,0,0,0,0,0
5472,792402,8,0,2,0,0,0,2,0,0,0,0,1,0,0,0,0,0
5472,796211,1,0,0,0,0,0,0,0,0,0,0,0,0,0,0,0,0
5472,786231,29,11,20,5,9,6,11,8,8,1,3,2,1,2,2,1,36
5472,785443,15,0,1,0,0,0,1,0,0,0,4,3,3,0,2,0,0
5473,781005,21,2,4,1,1,1,3,0,0,0,4,0,2,0,1,0,5
5473,790494,10,0,1,0,0,0,1,2,2,0,1,1,0,0,1,0,2
5473,781659,14,0,1,0,1,0,0,0,0,1,0,1,0,1,0,0,0
5473,782162,24,7,17,5,10,2,7,3,3,3,2,1,4,1,1,0,19
5473,796851,37,3,9,1,5,2,4,0,0,1,3,4,3,2,6,0,8
5473,796855,12,0,2,0,2,0,0,0,2,0,2,0,2,1,2,1,0
5473,781411,18,2,2,2,2,0,0,2,5,2,2,1,2,0,3,2,6
5473,796853,13,4,5,2,2,2,3,1,2,0,1,0,1,1,1,0,11
5473,792683,17,3,5,2,3,1,2,0,0,0,2,0,1,0,0,0,7
5473,792684,14,3,6,3,4,0,2,7,7,1,0,1,0,3,2,0,13
5473,780610,20,4,10,3,5,1,5,3,4,1,2,0,2,0,4,0,12
5474,791344,30,3,5,2,3,1,2,4,4,1,4,2,3,0,1,0,11
5474,781425,33,5,8,5,8,0,0,0,0,1,6,3,2,0,3,0,10
5474,791343,29,1,3,1,2,0,1,0,0,0,2,6,1,1,4,0,2
5474,781602,39,6,21,3,12,3,9,1,1,2,2,7,2,1,2,1,16
5474,775746,37,8,12,1,3,7,9,3,3,1,2,0,2,2,2,3,26
5474,781601,7,0,1,0,1,0,0,0,0,1,2,0,2,0,1,0,0
5474,776173,9,1,3,1,2,0,1,0,0,1,0,1,0,0,0,1,2
5474,797001,16,3,5,2,3,1,2,0,0,0,0,1,2,0,0,0,7
5475,786124,13,4,5,4,5,0,0,1,1,3,2,0,3,0,2,0,9
5475,780877,20,1,4,1,4,0,0,3,4,2,5,1,2,1,0,1,5
5475,792258,32,1,5,0,2,1,3,0,0,0,0,3,3,0,0,0,3
5475,786122,31,4,9,2,3,2,6,5,6,3,4,0,0,1,4,0,15
5475,776284,40,6,14,6,9,0,5,5,5,1,2,7,1,2,0,0,17
5475,792261,22,3,6,3,6,0,0,0,0,1,1,0,4,3,2,0,6
5475,797982,5,1,1,1,1,0,0,0,0,0,0,0,0,0,0,0,2
5475,786113,20,3,8,3,7,0,1,2,2,1,2,0,0,0,0,0,8
5475,786331,16,2,6,2,5,0,1,0,0,1,3,0,3,0,1,1,4
5475,780308,1,0,1,0,0,0,1,0,0,0,0,0,0,0,0,0,0
5476,791337,17,3,7,3,7,0,0,1,1,2,4,0,2,2,1,0,7
5476,797877,25,5,5,5,5,0,0,1,2,4,7,2,3,1,3,3,11
5476,797872,33,7,9,4,5,3,4,3,7,2,0,4,1,2,3,0,20
5476,791338,15,0,3,0,3,0,0,0,0,0,0,2,5,1,2,0,0
5476,791339,30,6,13,5,10,1,3,6,8,2,1,8,0,3,0,0,19
5476,797873,10,2,3,2,3,0,0,2,2,0,3,1,2,0,0,0,6
5476,791335,15,0,3,0,2,0,1,1,2,0,1,1,4,2,1,1,1
5476,781599,12,1,1,1,1,0,0,0,0,0,1,0,4,0,1,1,2
5476,797875,14,3,6,3,4,0,2,1,3,2,1,0,0,0,0,0,7
5476,797874,6,0,1,0,0,0,1,0,0,0,0,0,2,0,2,0,0
5476,785882,3,0,0,0,0,0,0,0,0,2,0,0,0,0,0,0,0
5476,781595,19,2,5,0,0,2,5,2,2,0,1,1,0,0,1,0,8
5476,792444,1,0,1,0,0,0,1,0,0,0,0,0,0,0,0,0,0
5477,791858,33,4,8,3,3,1,5,2,4,1,3,0,4,1,2,2,11
5477,797464,30,1,7,1,6,0,1,1,1,1,4,3,3,1,5,0,3
5477,797463,7,0,0,0,0,0,0,0,0,0,1,0,1,0,2,0,0
5477,791109,36,2,6,2,6,0,0,10,16,1,1,3,3,2,5,0,14
5477,785625,8,0,1,0,0,0,1,0,0,0,0,2,2,0,1,1,0
5477,797468,9,1,2,1,2,0,0,0,0,0,1,0,3,0,2,2,2
5477,797466,34,6,8,6,8,0,0,4,5,3,3,0,2,0,1,1,16
5477,797469,22,3,6,1,4,2,2,1,3,0,1,1,5,1,1,0,9
5477,797465,13,0,1,0,0,0,1,2,2,0,1,1,3,2,0,0,2
5477,791854,8,0,0,0,0,0,0,0,0,0,0,1,0,0,1,0,0
5478,796979,21,2,5,1,2,1,3,2,2,1,1,0,5,0,2,0,7
5478,776200,34,2,9,2,9,0,0,2,2,3,6,0,0,1,4,1,6
5478,791624,23,2,9,2,5,0,4,0,0,0,2,0,3,0,1,0,4
5478,785620,35,3,11,3,8,0,3,3,4,1,2,5,3,1,2,0,9
5478,781034,35,3,13,1,6,2,7,1,2,3,1,1,0,1,0,0,9
5478,796980,18,3,6,2,5,1,1,0,0,3,1,0,5,1,1,0,7
5478,791625,5,0,2,0,1,0,1,0,0,0,1,0,0,0,0,0,0
5478,791637,4,0,2,0,0,0,2,0,0,0,0,0,0,0,0,1,0
5478,786437,25,3,6,2,4,1,2,3,4,0,7,1,1,1,0,0,10
5479,776100,27,3,6,2,4,1,2,1,2,2,3,2,2,0,1,0,8
5479,785991,35,9,13,9,11,0,2,5,6,0,14,2,1,0,4,5,23
5479,797762,17,0,3,0,3,0,0,0,2,1,2,2,1,0,1,0,0
5479,781406,26,1,5,1,3,0,2,6,6,0,2,1,1,0,3,1,8
5479,781401,30,4,10,3,7,1,3,0,0,0,9,3,3,1,2,0,9
5479,797763,1,0,0,0,0,0,0,0,0,0,0,0,0,0,0,0,0
5479,797760,4,0,1,0,0,0,1,0,0,0,1,0,0,0,0,0,0
5479,792133,23,5,8,5,6,0,2,0,0,0,0,1,1,1,2,0,10
5479,781029,14,0,2,0,0,0,2,1,2,0,2,0,0,0,0,0,1
5479,775317,23,2,2,1,1,1,1,4,4,0,0,2,2,1,0,0,9
5480,780543,42,4,19,2,12,2,7,3,3,2,4,6,5,1,1,1,13
5480,785772,29,6,9,6,9,0,0,1,2,5,2,0,5,0,0,2,13
5480,792482,26,5,11,2,4,3,7,0,0,0,7,1,5,1,2,0,13
5480,785778,39,4,10,4,10,0,0,0,2,3,6,7,4,0,4,2,8
5480,792486,20,2,8,2,6,0,2,3,4,1,2,0,1,1,0,0,7
5480,792489,25,4,9,1,2,3,7,0,0,0,5,0,1,1,2,0,11
5480,785774,7,2,3,0,0,2,3,0,0,1,1,1,0,1,1,0,6
5480,792488,11,2,5,2,3,0,2,0,0,1,1,1,3,0,1,0,4
5480,780544,15,1,1,1,1,0,0,1,1,1,2,1,1,0,0,0,3
5480,797419,11,0,3,0,1,0,2,0,0,0,0,1,3,0,1,0,0
5481,780182,37,5,12,2,3,3,9,6,8,0,6,0,3,0,1,0,19
5481,798139,25,5,10,4,6,1,4,7,7,0,3,4,1,0,0,0,18
5481,786818,34,4,7,3,6,1,1,6,10,1,4,1,2,0,5,0,15
5481,780192,33,4,12,4,8,0,4,1,2,1,10,2,4,1,1,0,9
5481,796585,16,2,2,2,2,0,0,0,0,1,3,0,3,0,1,0,4
5481,780186,29,4,7,4,7,0,0,2,3,2,5,1,2,0,1,0,10
5481,780184,16,2,5,0,1,2,4,2,2,0,0,0,2,0,0,0,8
5481,786820,22,0,4,0,1,0,3,4,4,0,0,3,2,0,2,0,4
5481,798138,13,0,0,0,0,0,0,0,0,0,0,1,0,0,0,0,0
5482,797699,29,7,11,4,7,3,4,11,13,0,1,3,4,0,3,0,28
5482,791954,27,4,7,2,3,2,4,3,6,2,5,2,3,1,3,0,13
5482,791956,19,4,9,2,3,2,6,1,1,1,1,1,2,0,1,0,11
5482,780846,27,3,7,3,4,0,3,2,3,2,5,4,4,1,2,0,8
5482,780844,18,0,3,0,0,0,3,0,0,0,2,3,5,0,0,1,0
5482,797695,22,7,10,7,10,0,0,4,7,3,3,1,5,2,0,1,18
5482,797692,33,5,8,2,2,3,6,0,0,1,2,0,4,0,0,0,13
5482,797698,4,1,1,1,1,0,0,0,0,0,0,0,1,0,0,0,2
5482,797694,21,0,5,0,0,0,5,0,0,0,7,2,1,0,0,0,0
5483,792118,34,6,13,5,7,1,6,13,14,0,1,4,3,1,1,0,26
5483,782593,34,6,14,5,10,1,4,3,4,0,5,1,3,0,1,0,16
5483,785402,23,3,6,3,6,0,0,7,8,6,6,0,3,1,1,0,13
5483,797523,25,2,9,1,3,1,6,2,2,1,3,1,2,0,1,1,7
5483,791702,17,0,1,0,1,0,0,0,0,1,2,1,3,2,0,0,0
5483,791700,25,4,5,2,2,2,3,0,0,1,1,0,1,0,1,0,10
5483,797524,23,3,6,2,3,1,3,1,2,0,3,2,5,0,2,0,8
5483,785828,14,2,4,2,3,0,1,4,8,1,3,0,3,0,1,0,8
5483,797526,5,0,2,0,1,0,1,0,0,0,0,0,0,0,0,0,0
5484,786772,27,2,4,2,4,0,0,0,2,5,2,2,4,0,2,0,4
5484,781484,17,2,4,1,1,1,3,0,0,0,2,0,3,0,2,1,5
5484,786769,39,10,11,6,7,4,4,4,5,0,5,2,1,4,0,1,28
5484,786024,37,6,16,4,9,2,7,4,5,1,3,3,1,2,1,0,18
5484,780002,33,7,14,3,9,4,5,2,2,2,2,5,4,0,6,0,20
5484,791967,14,1,4,1,3,0,1,3,8,1,0,0,0,0,1,0,5
5484,790823,3,0,0,0,0,0,0,0,0,0,1,0,1,0,0,0,0
5484,791970,20,1,4,0,0,1,4,0,0,0,1,0,3,3,0,0,3
5484,786773,10,0,0,0,0,0,0,0,0,0,3,0,1,0,0,0,0
5485,792351,21,2,2,2,2,0,0,0,0,1,2,1,0,0,1,0,4
5485,786723,34,5,15,5,13,0,2,5,7,1,6,10,2,1,4,1,15
5485,792349,27,8,13,7,12,1,1,1,1,3,2,0,2,0,0,2,18
5485,798060,19,1,3,0,1,1,2,0,0,0,1,2,1,1,4,0,3
5485,792352,20,1,3,0,0,1,3,0,0,0,2,1,4,0,1,0,3
5485,798061,25,4,6,4,6,0,0,0,0,0,5,3,4,1,2,0,8
5485,786726,1,0,0,0,0,0,0,0,0,0,0,0,2,0,0,0,0
5485,786724,28,5,8,2,3,3,5,2,2,1,2,2,0,1,1,0,15
5485,792355,22,5,11,4,6,1,5,2,2,0,1,0,2,1,3,0,13
5485,792348,3,0,0,0,0,0,0,0,0,0,1,1,0,0,0,0,0
5486,791548,49,8,16,7,12,1,4,3,7,0,12,5,0,1,6,2,20
5486,791550,39,7,12,7,12,0,0,2,11,2,4,2,4,2,1,0,16
5486,786365,26,2,2,1,1,1,1,0,0,0,1,0,2,1,1,0,5
5486,786364,49,8,13,8,11,0,2,6,8,3,3,3,2,4,2,0,22
5486,780330,43,2,5,2,4,0,1,4,6,2,0,1,1,3,0,0,8
5486,797082,10,1,3,1,2,0,1,0,0,0,1,0,2,0,2,0,2
5486,786366,6,0,0,0,0,0,0,0,0,0,0,0,1,0,1,0,0
5486,780332,13,1,5,1,2,0,3,0,0,1,1,0,1,0,1,1,2
5486,797080,40,2,7,2,5,0,2,0,0,0,2,2,1,2,2,0,4
5487,790957,49,3,10,2,5,1,5,0,0,1,6,3,4,6,3,0,7
5487,785275,36,6,8,6,8,0,0,1,3,1,3,2,5,2,3,1,13
5487,790956,17,0,3,0,1,0,2,0,0,0,3,0,0,1,0,0,0
5487,785089,42,3,13,2,11,1,2,3,4,3,2,1,3,0,4,2,10
5487,780460,53,11,17,2,2,9,15,2,3,0,2,3,3,1,4,0,33
5487,796550,40,4,11,3,7,1,4,3,4,2,4,0,4,0,4,0,12
5487,796549,19,3,3,3,3,0,0,0,0,2,2,0,1,0,0,0,6
5487,796551,9,0,2,0,1,0,1,0,0,0,2,0,2,1,0,0,0
5487,796547,10,0,1,0,1,0,0,0,0,0,2,1,0,0,1,0,0
5488,791465,29,4,7,4,7,0,0,1,2,3,6,3,3,0,1,2,9
5488,791464,20,1,7,0,3,1,4,1,2,1,2,0,4,0,1,0,4
5488,780200,13,0,3,0,2,0,1,0,0,1,2,0,3,0,0,5,0
5488,786304,35,6,10,5,6,1,4,0,1,2,5,0,0,1,1,0,13
5488,780197,37,4,15,2,9,2,6,4,4,0,2,2,0,1,1,0,14
5488,798342,27,1,6,1,2,0,4,2,4,1,2,2,3,0,0,1,4
5488,780616,11,0,2,0,0,0,2,0,0,0,5,2,3,0,0,0,0
5488,798343,3,0,1,0,0,0,1,0,0,0,0,0,0,0,0,0,0
5488,780196,25,5,11,5,7,0,4,7,7,0,7,1,5,0,2,0,17
5489,780282,27,5,11,5,11,0,0,2,2,3,5,3,1,1,0,2,12
5489,780277,31,3,9,2,3,1,6,6,11,1,7,0,2,0,3,0,13
5489,785327,25,2,8,2,3,0,5,2,2,0,5,1,3,0,0,0,6
5489,785326,13,0,1,0,0,0,1,2,2,0,0,2,2,0,0,0,2
5489,780280,29,4,12,3,9,1,3,5,7,2,2,1,3,1,0,1,14
5489,785329,15,1,4,1,2,0,2,1,1,1,6,1,2,1,2,0,3
5489,796662,4,0,0,0,0,0,0,0,0,0,0,0,1,0,1,0,0
5489,791003,12,2,4,2,4,0,0,0,1,0,2,0,1,0,0,0,4
5489,791002,24,2,6,0,2,2,4,1,2,0,3,0,1,0,0,1,7
5489,785330,10,1,1,1,1,0,0,0,0,3,3,1,2,0,1,0,2
5489,780279,10,0,2,0,0,0,2,1,2,0,1,0,1,0,0,0,1
5490,792473,24,7,11,6,8,1,3,2,4,1,1,1,5,2,3,1,17
5490,780043,33,1,6,1,2,0,4,2,2,0,1,2,2,1,1,0,4
5490,799276,31,1,3,1,2,0,1,1,2,0,1,2,0,2,2,0,3
5490,785249,36,2,6,1,3,1,3,0,1,0,5,3,1,1,2,0,5
5490,780035,30,5,10,3,6,2,4,1,3,0,2,4,2,0,1,0,13
5490,792471,2,0,0,0,0,0,0,1,2,0,0,0,1,0,1,0,1
5490,799281,16,1,2,1,1,0,1,2,2,0,3,1,3,0,0,1,4
5490,792477,7,2,2,0,0,2,2,0,0,0,1,0,1,0,0,0,6
5490,792476,2,0,0,0,0,0,0,0,0,1,0,0,0,0,0,0,0
5490,780036,19,2,5,0,2,2,3,0,0,0,1,3,5,0,1,0,6
5491,786157,14,1,2,1,2,0,0,3,5,1,2,0,1,0,4,1,5
5491,791756,25,3,5,3,4,0,1,0,0,1,3,1,2,0,2,0,6
5491,797348,16,1,3,1,2,0,1,0,0,0,3,1,2,0,0,0,2
5491,780992,26,5,9,0,0,5,9,0,0,1,2,6,2,0,0,0,15
5491,780677,28,8,17,2,4,6,13,2,2,0,2,3,1,0,1,0,24
5491,797350,4,0,1,0,1,0,0,0,0,0,0,0,0,0,0,0,0
5491,791730,2,2,3,2,3,0,0,0,2,2,0,0,0,0,0,0,4
5491,791754,16,0,2,0,2,0,0,2,2,2,5,3,1,1,2,1,2
5491,786150,12,2,4,2,4,0,0,2,2,3,0,0,3,0,1,0,6
5491,780676,14,2,4,0,2,2,2,4,4,2,5,3,2,0,1,0,10
5491,775533,17,3,3,3,3,0,0,0,0,2,0,1,1,0,0,1,6
5491,791753,2,0,0,0,0,0,0,0,0,0,0,0,1,0,1,0,0
5491,797349,5,1,3,1,2,0,1,0,0,0,0,1,0,2,0,0,2
5491,780673,19,3,4,0,1,3,3,0,1,0,4,2,2,1,0,0,9
5496,785791,27,2,3,0,1,2,2,0,0,0,1,0,4,0,1,0,6
5496,775606,17,4,6,4,6,0,0,0,0,2,2,1,3,0,0,0,8
5496,791672,18,2,7,2,7,0,0,0,0,2,1,1,1,0,2,1,4
5496,791674,22,2,6,2,4,0,2,0,0,2,2,1,0,0,2,1,4
5496,780552,36,2,7,1,3,1,4,2,2,1,4,2,0,1,1,0,7
5496,797423,1,0,0,0,0,0,0,0,0,0,0,0,1,0,0,0,0
5496,785787,28,5,11,2,7,3,4,3,3,1,1,0,3,2,2,0,16
5496,780550,24,3,6,3,6,0,0,2,4,0,1,1,4,1,4,0,8
5496,780538,27,2,9,2,8,0,1,6,8,0,3,5,3,4,0,0,10
5497,781058,29,4,8,4,7,0,1,0,0,1,7,1,3,1,4,0,8
5497,780327,27,6,6,6,6,0,0,0,0,2,3,1,4,0,1,1,12
5497,797458,32,3,5,2,4,1,1,7,7,0,2,2,0,0,4,0,14
5497,791847,21,4,7,2,4,2,3,1,2,2,3,0,2,1,2,0,11
5497,791849,21,1,6,0,2,1,4,5,9,1,5,1,1,0,1,0,8
5497,797455,12,4,5,4,5,0,0,1,2,3,0,1,1,0,0,0,9
5497,785622,12,0,5,0,3,0,2,0,0,1,2,0,0,0,1,1,0
5497,791848,9,1,2,1,1,0,1,0,0,0,2,0,1,1,0,0,2
5497,797456,9,1,6,0,2,1,4,0,0,0,2,0,0,0,1,0,3
5497,797451,19,3,6,3,5,0,1,0,2,1,0,4,1,2,1,0,6
5497,786607,9,0,2,0,2,0,0,0,0,0,0,2,1,0,0,0,0
5498,797483,19,1,1,1,1,0,0,0,0,0,1,0,2,0,1,3,2
5498,797482,38,4,9,2,3,2,6,1,2,0,3,0,2,2,2,0,11
5498,797481,30,6,9,5,7,1,2,0,0,0,2,3,0,3,2,0,13
5498,791873,17,1,8,1,8,0,0,0,0,0,2,5,0,0,0,0,2
5498,781217,23,2,6,1,1,1,5,0,0,0,2,0,2,1,1,0,5
5498,786579,2,0,1,0,0,0,1,0,0,0,0,0,0,0,0,0,0
5498,797485,21,4,7,2,3,2,4,0,0,0,0,1,1,0,0,0,10
5498,797480,12,1,4,1,3,0,1,0,0,0,1,0,3,1,0,0,2
5498,797478,14,1,2,0,0,1,2,0,0,0,0,2,0,0,0,0,3
5498,791875,22,1,4,1,4,0,0,0,0,1,1,3,1,0,1,1,2
5498,786574,2,0,0,0,0,0,0,0,0,0,0,0,0,0,0,0,0
5499,791537,16,0,5,0,4,0,1,0,0,1,3,1,3,0,2,0,0
5499,786358,35,6,10,2,2,4,8,0,0,0,2,0,0,1,0,0,16
5499,775846,14,0,3,0,0,0,3,0,0,0,2,1,0,0,2,0,0
5499,780306,32,3,6,3,6,0,0,1,2,2,2,7,2,1,3,0,7
5499,797116,35,3,6,0,1,3,5,0,0,1,4,7,2,0,2,0,9
5499,791535,12,2,3,0,1,2,2,0,0,0,2,1,1,0,0,0,6
5499,775418,27,10,12,10,12,0,0,5,7,5,8,0,1,0,2,3,25
5499,780312,29,4,6,0,0,4,6,0,0,0,3,3,1,0,2,0,12
5500,791337,27,1,1,0,0,1,1,4,4,6,5,1,3,0,1,4,7
5500,797877,35,4,11,4,10,0,1,2,2,1,4,1,2,1,1,1,10
5500,797872,35,0,7,0,4,0,3,6,8,1,5,2,4,0,4,1,6
5500,791338,16,0,2,0,1,0,1,0,2,0,0,2,1,2,0,0,0
5500,791339,35,7,18,5,11,2,7,6,8,1,3,0,4,4,3,0,22
5500,797873,6,1,1,1,1,0,0,0,0,1,0,0,2,0,1,0,2
5500,791335,7,1,2,1,1,0,1,0,0,1,0,1,1,0,0,0,2
5500,781599,5,0,1,0,1,0,0,0,0,1,0,0,1,0,1,2,0
5500,797875,10,1,1,1,1,0,0,1,2,0,0,0,1,0,5,0,3
5500,797874,5,0,1,0,0,0,1,0,0,0,0,0,0,0,0,0,0
5500,781595,19,2,4,2,3,0,1,0,0,0,3,1,1,0,2,0,4
5501,797466,27,6,9,4,7,2,2,0,0,4,2,1,4,2,4,0,14
5501,791858,25,1,2,0,0,1,2,2,2,1,3,1,3,2,1,0,5
5501,797463,34,5,17,4,11,1,6,5,9,3,0,2,2,3,4,0,16
5501,791109,22,0,2,0,2,0,0,0,0,0,3,3,5,0,3,1,0
5501,785625,29,7,14,5,9,2,5,2,2,5,4,0,5,1,2,0,18
5501,797468,3,0,0,0,0,0,0,0,0,0,0,0,1,0,0,0,0
5501,797464,21,4,6,3,5,1,1,0,0,0,3,0,3,1,1,0,9
5501,797467,12,0,1,0,1,0,0,0,0,1,3,2,1,0,1,0,0
5501,799688,0,1,1,1,1,0,0,0,0,1,0,0,0,0,0,0,2
5501,797469,22,2,5,1,1,1,4,2,4,0,1,4,1,0,0,0,7
5501,797465,3,0,1,0,1,0,0,0,0,0,0,0,1,0,0,0,0
5501,791854,2,0,0,0,0,0,0,0,0,0,0,0,0,0,0,0,0
5501,791859,0,0,0,0,0,0,0,0,0,0,0,0,0,0,0,0,0
5501,789074,0,0,0,0,0,0,0,0,0,0,0,0,0,0,0,0,0
5502,792418,12,0,0,0,0,0,0,1,2,1,4,1,2,0,2,0,1
5502,782654,39,2,7,2,7,0,0,5,7,3,5,1,2,1,3,0,9
5502,796693,31,3,12,0,4,3,8,3,4,1,0,2,0,0,4,0,12
5502,796691,34,5,14,5,8,0,6,3,4,0,3,4,1,0,1,0,13
5502,789484,29,4,8,3,5,1,3,1,2,3,1,0,2,2,3,1,10
5502,796692,9,1,2,1,2,0,0,0,0,1,1,1,0,0,0,0,2
5502,792424,12,2,3,2,3,0,0,1,1,2,0,0,2,0,0,0,5
5502,792419,4,0,1,0,0,0,1,0,0,0,0,0,0,0,0,0,0
5502,792422,18,2,4,2,4,0,0,0,1,1,0,0,0,0,2,0,4
5502,792423,12,0,3,0,2,0,1,0,0,0,4,0,0,1,0,0,0
5503,786791,12,1,1,1,1,0,0,0,0,0,2,0,4,0,2,0,2
5503,791864,19,2,6,1,2,1,4,4,4,0,3,2,3,0,1,0,9
5503,791863,29,2,5,2,5,0,0,1,1,1,2,3,0,2,1,0,5
5503,797472,31,8,14,2,4,6,10,1,1,1,1,3,2,1,1,0,23
5503,780965,38,2,9,2,4,0,5,0,0,0,2,9,2,3,2,0,4
5503,797473,16,3,3,3,3,0,0,2,2,1,1,0,4,2,0,0,8
5503,781081,30,5,7,5,7,0,0,0,0,4,8,4,4,1,1,1,10
5503,797470,22,4,7,3,5,1,2,3,3,0,0,1,2,1,2,1,12
5503,791865,3,0,1,0,1,0,0,0,0,0,1,0,0,0,0,0,0
5504,791391,32,6,8,5,7,1,1,0,0,4,2,1,4,1,3,1,13
5504,791390,34,5,6,4,4,1,2,5,6,3,2,2,3,2,4,0,16
5504,776446,19,2,5,2,4,0,1,1,2,0,2,4,2,1,1,0,5
5504,780133,35,5,9,3,4,2,5,0,0,0,7,1,0,0,2,0,12
5504,780130,35,7,14,6,11,1,3,8,9,2,5,2,1,2,0,1,23
5504,797158,1,0,0,0,0,0,0,0,0,0,0,0,1,0,1,0,0
5504,797156,17,0,3,0,2,0,1,0,0,0,2,2,2,0,2,0,0
5504,791388,6,0,1,0,0,0,1,0,0,0,2,0,0,0,1,0,0
5504,775743,15,0,4,0,2,0,2,0,0,0,1,0,1,0,1,0,0
5504,780407,6,0,0,0,0,0,0,0,0,0,1,1,0,0,0,0,0
5505,784640,26,1,3,1,3,0,0,0,0,1,1,2,4,2,1,0,2
5505,797655,19,6,7,6,7,0,0,0,1,2,2,1,4,0,1,0,12
5505,797657,35,4,8,1,2,3,6,0,0,0,2,1,2,1,1,0,11
5505,792072,35,1,5,0,0,1,5,0,0,0,3,4,2,0,2,0,3
5505,792069,35,9,17,6,9,3,8,4,5,2,3,3,3,3,7,0,25
5505,797652,13,1,4,1,4,0,0,0,0,1,0,1,3,2,0,0,2
5505,785572,26,4,10,3,7,1,3,0,0,0,4,1,0,1,2,0,9
5505,774844,11,1,1,1,1,0,0,0,0,0,1,0,1,0,0,1,2
5506,786164,36,4,8,2,3,2,5,0,0,2,4,2,2,1,0,1,10
5506,781560,34,2,7,2,7,0,0,0,0,4,7,1,3,4,2,2,4
5506,791375,24,3,8,0,2,3,6,0,0,0,3,0,3,1,0,0,9
5506,785482,35,4,16,0,8,4,8,2,2,1,4,8,4,5,7,0,14
5506,780837,36,4,13,2,8,2,5,4,5,1,4,0,1,0,3,0,14
5506,796477,25,3,8,1,3,2,5,0,0,0,4,3,1,2,4,0,8
5506,796473,5,0,0,0,0,0,0,0,0,1,1,0,2,0,1,0,0
5506,796479,5,0,1,0,0,0,1,0,0,0,1,0,0,0,1,0,0
5507,781579,27,4,11,4,9,0,2,2,2,2,4,0,2,1,3,0,10
5507,786731,33,3,9,3,9,0,0,2,2,4,7,3,0,0,3,6,8
5507,798023,29,4,10,3,5,1,5,0,1,1,2,1,5,2,2,0,9
5507,781584,30,2,3,0,0,2,3,1,1,1,1,1,2,0,0,0,7
5507,780347,29,5,15,3,9,2,6,6,6,2,7,3,0,2,1,0,18
5507,775696,12,0,6,0,2,0,4,0,0,2,1,1,1,1,2,0,0
5507,798008,20,0,3,0,2,0,1,0,0,1,3,1,1,0,5,0,0
5507,776481,5,0,0,0,0,0,0,0,0,0,1,0,1,1,0,1,0
5507,792358,14,2,4,2,3,0,1,0,0,0,0,1,0,1,1,0,4
5507,798017,1,0,0,0,0,0,0,0,0,0,0,0,0,0,0,0,0
5508,791980,19,5,8,2,4,3,4,0,1,2,3,0,3,0,0,2,13
5508,785967,18,4,8,4,8,0,0,2,6,3,6,1,2,0,2,0,10
5508,791976,29,3,5,2,4,1,1,3,4,0,1,1,0,0,0,0,10
5508,791978,33,7,12,4,8,3,4,7,8,0,7,6,3,1,3,0,24
5508,785973,24,3,4,2,3,1,1,3,5,0,3,2,0,1,3,0,10
5508,780160,20,0,0,0,0,0,0,0,2,0,3,2,2,0,2,1,0
5508,791977,22,5,9,2,2,3,7,0,0,0,0,0,3,0,1,0,13
5508,785972,21,2,5,2,4,0,1,1,1,0,3,2,0,0,0,0,5
5508,797800,12,1,1,0,0,1,1,0,0,0,3,0,1,0,1,0,3
5508,797801,2,0,0,0,0,0,0,0,0,0,0,0,0,0,0,1,0
5509,780323,16,4,5,4,5,0,0,1,2,1,1,0,4,0,0,0,9
5509,797894,17,2,4,2,4,0,0,2,2,2,0,1,5,0,0,0,6
5509,792229,33,1,8,1,6,0,2,0,0,1,7,4,4,2,0,0,2
5509,785954,28,3,9,1,5,2,4,0,0,0,3,0,0,2,0,0,8
5509,785811,34,11,21,7,14,4,7,4,5,0,0,3,2,2,1,0,30
5509,792233,30,6,13,5,10,1,3,2,2,4,4,2,2,1,1,1,15
5509,792230,16,1,2,1,1,0,1,1,1,0,1,3,1,0,0,0,3
5509,792234,7,1,2,1,2,0,0,0,0,0,1,0,1,0,0,0,2
5509,786016,17,4,7,3,4,1,3,0,0,1,4,1,0,0,0,0,9
5509,797891,2,1,2,0,1,1,1,0,0,1,0,0,1,0,0,0,3
5510,796334,32,7,9,7,8,0,1,2,2,2,10,0,1,0,5,1,16
5510,790776,21,0,2,0,2,0,0,2,3,0,2,2,1,0,2,3,2
5510,796330,15,3,6,3,5,0,1,2,2,0,7,1,0,1,0,0,8
5510,785813,37,3,10,2,8,1,2,9,11,0,2,6,3,1,1,0,16
5510,796337,35,4,9,3,7,1,2,9,10,0,4,3,5,4,3,0,18
5510,796332,28,2,2,2,2,0,0,4,10,1,2,0,3,0,4,3,8
5510,785827,18,3,3,3,3,0,0,2,3,0,4,0,2,3,1,0,8
5510,779975,10,1,2,1,2,0,0,2,2,0,0,0,0,1,0,0,4
5510,796333,4,0,0,0,0,0,0,0,0,0,2,1,0,0,0,0,0
5511,796343,10,0,1,0,1,0,0,0,0,0,1,0,0,0,0,1,0
5511,796344,26,3,7,2,2,1,5,0,0,2,1,1,5,0,2,0,7
5511,790785,24,2,6,2,5,0,1,1,1,0,1,2,4,0,3,1,5
5511,780037,31,8,19,3,7,5,12,3,4,0,2,3,1,0,3,0,24
5511,790781,29,6,9,6,9,0,0,2,2,5,6,0,2,1,0,2,14
5511,780040,17,1,6,1,5,0,1,0,0,1,3,1,5,0,1,1,2
5511,796339,17,3,7,1,1,2,6,0,0,0,0,3,3,0,3,0,8
5511,781232,17,1,6,1,3,0,3,0,0,0,1,0,4,0,0,0,2
5511,796340,29,1,8,1,5,0,3,3,4,0,4,1,5,2,0,0,5
5516,791289,28,2,4,2,4,0,0,2,6,1,2,2,3,0,0,0,6
5516,785786,19,1,3,1,1,0,2,0,0,0,1,1,2,0,1,0,2
5516,796574,28,3,10,2,5,1,5,2,2,0,3,3,2,6,1,0,9
5516,796571,28,5,12,2,7,3,5,0,1,2,3,0,0,1,1,0,13
5516,781346,34,8,12,3,4,5,8,0,0,1,4,5,2,0,2,0,21
5516,796576,30,6,10,3,5,3,5,3,4,1,3,2,1,0,0,0,18
5516,791290,5,1,2,0,0,1,2,0,0,0,0,1,0,0,0,0,3
5516,796572,28,4,6,4,6,0,0,0,2,4,6,2,3,0,0,0,8
5517,796766,22,4,10,1,1,3,9,0,0,0,7,0,2,0,2,1,11
5517,785614,22,2,3,2,3,0,0,0,0,2,3,3,5,0,0,0,4
5517,796767,34,8,14,6,7,2,7,0,0,0,2,1,0,1,1,0,18
5517,796765,28,4,10,0,3,4,7,0,0,1,0,4,4,1,2,0,12
5517,780812,38,1,11,1,6,0,5,6,6,3,4,5,0,1,2,2,8
5517,791113,18,0,0,0,0,0,0,0,1,0,4,0,0,0,0,0,0
5517,785618,16,3,5,1,1,2,4,0,0,0,0,0,2,0,1,0,8
5517,780813,22,4,5,2,2,2,3,0,0,1,5,3,2,0,1,0,10
5518,791763,29,6,10,4,5,2,5,6,8,2,4,1,1,0,0,1,20
5518,775910,23,2,5,0,0,2,5,2,4,3,3,1,2,1,4,1,8
5518,797554,24,1,4,1,4,0,0,0,0,0,1,2,2,0,6,0,2
5518,780020,24,1,7,1,2,0,5,2,2,0,2,2,3,0,0,0,4
5518,781387,21,3,6,2,4,1,2,5,5,0,3,2,0,1,1,0,12
5518,786456,23,2,4,2,4,0,0,1,2,4,4,0,2,1,0,0,5
5518,797561,20,2,4,2,4,0,0,1,2,1,3,1,0,0,1,0,5
5518,793065,11,0,5,0,1,0,4,0,0,1,1,0,2,0,0,0,0
5518,786457,11,1,5,0,0,1,5,0,0,0,0,0,0,0,0,0,3
5518,800084,14,4,7,3,4,1,3,2,3,2,1,1,2,2,0,0,11
5520,775510,38,7,16,0,3,7,13,0,0,1,6,3,3,1,1,1,21
5520,774976,32,8,11,7,10,1,1,4,4,2,10,2,2,1,3,2,21
5520,797865,34,2,3,1,2,1,1,5,6,1,4,5,1,2,2,0,10
5520,786614,31,6,14,2,4,4,10,0,0,0,7,2,2,1,2,2,16
5520,786759,36,2,6,2,5,0,1,0,0,1,3,9,0,2,2,0,4
5520,786761,8,1,2,1,2,0,0,0,1,1,1,0,0,0,0,0,2
5520,792293,7,3,5,2,2,1,3,0,0,0,2,0,0,0,1,0,7
5520,792291,9,0,1,0,0,0,1,0,0,0,1,2,0,0,2,0,0
5520,797864,2,0,1,0,0,0,1,0,0,0,0,0,0,0,0,0,0
5520,792294,2,0,0,0,0,0,0,0,0,0,0,0,0,0,0,0,0
5520,797867,1,0,0,0,0,0,0,0,0,0,0,0,0,0,0,0,0
5521,792181,37,6,16,6,14,0,2,3,3,2,5,0,1,3,1,0,15
5521,785902,36,4,11,3,6,1,5,4,5,1,7,2,2,1,0,0,13
5521,780986,40,3,6,3,6,0,0,2,2,0,6,3,1,3,1,0,8
5521,792179,26,3,7,1,1,2,6,0,0,0,1,2,0,0,2,0,8
5521,786662,34,4,12,3,5,1,7,0,0,0,1,2,1,2,5,0,9
5521,797796,20,1,3,1,3,0,0,0,0,0,2,1,3,0,3,2,2
5521,786661,7,1,3,0,0,1,3,0,0,0,1,0,2,0,0,0,3
5522,791905,23,5,10,5,6,0,4,3,3,1,7,1,0,1,3,0,13
5522,781103,28,2,3,2,3,0,0,0,0,2,3,4,2,1,2,2,4
5522,797568,32,4,10,2,5,2,5,0,0,0,1,2,1,0,1,0,10
5522,797566,38,6,10,3,3,3,7,3,3,1,4,4,1,3,3,1,18
5522,781191,32,7,15,3,8,4,7,0,0,0,7,3,0,3,3,1,18
5522,797570,2,0,1,0,0,0,1,0,0,0,0,0,0,0,0,0,0
5522,791909,2,0,1,0,1,0,0,0,0,0,0,0,0,0,0,0,0
5522,791907,11,2,3,2,3,0,0,0,0,0,1,1,0,0,1,0,4
5522,781364,18,0,3,0,1,0,2,1,2,2,2,0,0,0,0,0,1
5522,791906,14,1,2,1,1,0,1,0,2,0,2,1,1,0,0,1,2
5524,791011,30,2,6,2,3,0,3,1,2,5,6,1,3,1,3,0,5
5524,780303,22,5,11,3,6,2,5,0,0,1,6,1,4,0,3,0,12
5524,791594,34,2,9,2,8,0,1,1,2,1,3,4,2,2,4,0,5
5524,791012,32,2,8,1,2,1,6,0,0,0,1,1,2,1,1,0,5
5524,781385,30,5,8,3,3,2,5,5,6,0,3,2,5,0,3,0,17
5524,796670,1,0,0,0,0,0,0,0,0,0,0,0,0,0,0,0,0
5524,796671,16,2,5,2,3,0,2,0,0,2,2,1,2,0,1,1,4
5524,796668,11,2,2,1,1,1,1,0,0,1,2,0,2,0,0,0,5
5524,791013,5,0,1,0,1,0,0,0,0,0,0,1,1,0,0,0,0
5524,786349,19,2,4,2,4,0,0,1,2,0,1,0,1,0,1,0,5
5525,775897,29,0,3,0,1,0,2,0,0,0,4,1,0,2,0,1,0
5525,780324,27,3,5,3,5,0,0,1,2,2,1,2,1,0,3,0,7
5525,791543,30,4,8,0,1,4,7,3,4,0,3,2,2,0,2,0,15
5525,786530,30,2,7,0,0,2,7,1,2,0,2,2,2,2,2,0,7
5525,780317,18,0,5,0,0,0,5,2,2,0,2,1,1,1,2,0,2
5525,791546,12,1,4,0,2,1,2,3,6,2,2,1,0,0,2,1,6
5525,791545,21,5,9,4,6,1,3,7,8,3,6,2,2,3,2,0,18
5525,786360,10,1,2,0,0,1,2,2,3,0,1,0,0,0,0,0,5
5525,784246,23,2,5,2,4,0,1,1,1,1,2,0,4,1,1,0,5
5526,796516,27,4,6,4,6,0,0,2,4,5,2,2,3,1,2,1,10
5526,792318,29,4,11,4,11,0,0,0,1,2,1,0,4,1,2,0,8
5526,796519,12,0,1,0,0,0,1,0,2,1,0,0,1,1,0,0,0
5526,786717,29,3,7,3,5,0,2,10,13,4,10,0,2,0,2,0,16
5526,780753,26,1,7,0,3,1,4,0,2,1,1,2,2,0,1,0,3
5526,792308,7,0,1,0,1,0,0,0,0,0,0,1,1,0,0,1,0
5526,796520,29,5,16,2,7,3,9,1,2,0,3,0,0,0,3,0,14
5526,796518,4,0,1,0,1,0,0,0,0,0,1,0,1,0,0,0,0
5526,796517,15,1,3,1,3,0,0,1,2,0,2,1,1,2,1,0,3
5526,792315,2,0,1,0,1,0,0,0,0,0,0,0,1,0,0,0,0
5526,775329,20,3,5,0,2,3,3,3,3,1,4,0,3,1,0,1,12
5527,792067,18,3,3,2,2,1,1,1,2,0,2,0,2,0,1,0,8
5527,775523,19,1,5,1,4,0,1,0,0,0,7,1,5,0,0,0,2
5527,792059,21,2,2,2,2,0,0,2,4,2,2,1,1,0,4,0,6
5527,792058,4,0,2,0,2,0,0,1,2,0,0,0,1,0,1,0,1
5527,789028,26,2,3,2,3,0,0,0,1,0,2,5,4,1,2,0,4
5527,792055,22,4,10,4,10,0,0,2,2,3,4,1,2,0,3,0,10
5527,790779,21,1,2,1,2,0,0,0,2,0,6,0,2,1,1,1,2
5527,797649,15,2,6,1,2,1,4,0,0,0,1,0,2,1,1,0,5
5527,789053,12,1,2,1,1,0,1,5,7,1,2,1,0,0,0,0,7
5527,789029,12,4,7,3,4,1,3,2,2,0,1,0,2,1,1,0,11
5527,775323,30,3,9,3,7,0,2,2,2,0,2,1,3,0,2,0,8
5528,786185,16,3,7,3,7,0,0,0,0,1,2,0,4,0,2,0,6
5528,797182,33,1,10,0,6,1,4,2,4,2,2,1,3,0,1,1,5
5528,797273,34,3,6,2,3,1,3,1,2,0,2,2,1,3,1,2,8
5528,786558,38,6,13,5,10,1,3,6,7,1,3,2,2,3,2,0,19
5528,797272,40,6,17,3,7,3,10,3,3,0,0,0,2,4,3,0,18
5528,797181,20,1,4,0,3,1,1,1,2,0,2,0,3,0,0,0,4
5528,791377,19,0,1,0,0,0,1,0,0,0,1,0,1,3,3,0,0
5529,796439,33,11,17,11,17,0,0,0,2,6,6,2,2,1,4,1,22
5529,790884,21,7,7,7,7,0,0,1,1,1,7,1,3,0,3,2,15
5529,791635,22,1,2,1,1,0,1,2,5,0,1,2,0,1,4,1,4
5529,790883,27,5,10,4,7,1,3,0,0,1,2,5,1,1,5,0,11
5529,785436,28,3,6,3,6,0,0,1,1,1,8,4,1,1,2,0,7
5529,796442,16,1,1,1,1,0,0,0,0,1,3,0,2,0,1,0,2
5529,796438,31,7,12,3,4,4,8,2,5,0,3,1,2,3,1,0,20
5529,790885,13,0,4,0,2,0,2,0,0,1,3,0,2,0,2,0,0
5529,790520,9,0,0,0,0,0,0,0,0,0,1,0,1,1,2,0,0
5536,785930,16,5,6,5,6,0,0,0,0,1,5,0,5,0,2,0,10
5536,780996,27,6,7,5,6,1,1,4,6,1,2,0,3,0,1,0,17
5536,780995,30,2,7,1,3,1,4,0,0,1,6,0,4,1,0,0,5
5536,796468,36,1,4,1,3,0,1,4,4,0,1,8,3,1,2,0,6
5536,790920,18,3,9,3,9,0,0,4,8,0,2,1,5,0,2,0,10
5536,775709,27,1,4,0,0,1,4,0,0,0,2,0,0,0,0,0,3
5536,785461,8,0,0,0,0,0,0,0,0,0,1,0,1,0,1,0,0
5536,791035,32,6,10,3,4,3,6,7,8,0,11,3,2,0,5,0,22
5536,796467,6,1,2,0,0,1,2,0,0,0,1,0,0,0,0,0,3
5537,792277,6,1,2,1,2,0,0,0,0,1,0,1,0,0,0,0,2
5537,781464,34,3,4,0,0,3,4,0,0,0,3,1,1,1,2,1,9
5537,785282,25,1,8,0,5,1,3,0,0,0,4,0,1,1,0,0,3
5537,781502,27,3,6,1,2,2,4,7,8,0,3,2,4,1,4,0,15
5537,780259,37,4,13,3,7,1,6,3,6,0,2,4,5,1,2,0,12
5537,798051,11,2,2,2,2,0,0,0,1,1,1,0,1,0,0,0,4
5537,785913,22,7,11,7,11,0,0,6,8,2,2,2,3,0,0,0,20
5537,786516,13,0,2,0,0,0,2,0,0,0,0,1,0,0,0,0,0
5537,781501,20,1,4,1,2,0,2,0,0,1,3,2,4,0,2,0,2
5537,798058,4,0,3,0,3,0,0,0,0,0,0,0,1,0,1,0,0
5537,792274,1,0,0,0,0,0,0,0,0,0,0,0,0,0,0,0,0
5538,797717,22,3,7,1,3,2,4,1,2,3,2,1,0,1,2,0,9
5538,780937,34,3,11,1,3,2,8,2,2,1,3,0,1,0,1,1,10
5538,780938,24,1,2,1,2,0,0,0,0,1,3,1,1,1,2,1,2
5538,792115,24,1,5,1,5,0,0,2,2,0,4,1,0,0,2,0,4
5538,792113,30,3,6,3,4,0,2,0,0,0,3,1,4,0,1,0,6
5538,797715,29,6,13,3,7,3,6,2,2,0,3,3,2,2,5,0,17
5538,797716,4,0,0,0,0,0,0,0,0,0,0,0,0,0,1,0,0
5538,791950,29,2,6,0,2,2,4,2,2,0,4,2,1,0,2,1,8
5538,780779,4,0,0,0,0,0,0,0,0,0,1,0,1,0,2,0,0
5539,791837,33,10,13,7,7,3,6,2,3,1,4,1,2,3,1,2,25
5539,780613,30,4,11,4,11,0,0,3,3,2,1,5,2,0,2,0,11
5539,775097,26,4,11,4,9,0,2,0,0,0,7,3,1,0,1,0,8
5539,780609,37,1,4,1,1,0,3,0,0,0,4,7,0,2,0,0,2
5539,776395,34,7,12,4,6,3,6,1,1,0,4,3,2,2,0,0,18
5539,786621,13,3,5,1,1,2,4,2,2,0,0,2,3,0,1,0,10
5539,786619,11,1,3,0,2,1,1,0,0,1,1,1,3,0,1,0,3
5539,780617,1,0,0,0,0,0,0,0,0,0,0,1,0,1,0,0,0
5539,797439,2,0,0,0,0,0,0,0,0,0,0,0,0,1,1,0,0
5539,797437,6,0,0,0,0,0,0,0,0,0,1,0,1,1,0,0,0
5539,786622,6,1,2,1,1,0,1,0,0,0,1,0,1,0,2,0,2
5539,780618,1,0,0,0,0,0,0,0,0,0,0,0,0,0,0,0,0
5539,791836,0,0,0,0,0,0,0,0,0,0,0,0,0,0,0,0,0
5540,786434,9,1,1,1,1,0,0,0,0,0,0,0,0,0,0,2,2
5540,780440,35,6,9,6,7,0,2,0,0,3,4,2,1,2,2,0,12
5540,791621,32,5,14,3,9,2,5,2,2,1,3,2,0,0,1,0,14
5540,786432,32,4,6,1,2,3,4,0,0,0,1,1,4,0,0,0,11
5540,786431,30,8,17,7,11,1,6,0,0,0,0,5,4,1,3,0,17
5540,781125,19,4,7,4,7,0,0,2,4,2,4,0,2,0,2,0,10
5540,775620,11,3,3,3,3,0,0,0,0,0,1,0,4,3,1,1,6
5540,781088,25,3,6,1,1,2,5,1,1,0,2,3,1,0,1,0,9
5540,775622,7,0,0,0,0,0,0,0,0,0,0,0,1,0,1,0,0
5541,797972,26,11,11,6,6,5,5,6,7,1,2,0,2,1,1,1,33
5541,797967,33,5,8,4,5,1,3,0,0,1,1,2,2,1,0,0,11
5541,797970,30,5,12,4,8,1,4,2,2,2,3,6,3,3,4,0,13
5541,781453,33,3,9,2,4,1,5,2,2,0,5,6,3,1,5,1,9
5541,774869,38,3,6,1,2,2,4,0,0,0,1,2,2,0,0,0,8
5541,792254,18,5,9,4,7,1,2,2,2,2,3,1,1,1,1,1,13
5541,797962,2,0,1,0,1,0,0,0,0,2,0,0,0,0,0,0,0
5541,786098,20,1,1,1,1,0,0,1,2,0,2,1,1,1,1,0,3
5542,796469,31,5,12,4,8,1,4,3,3,2,6,0,5,1,2,0,14
5542,790923,37,5,11,4,9,1,2,4,6,4,6,3,3,2,5,2,15
5542,779980,15,3,4,2,3,1,1,0,1,2,3,2,5,0,0,1,7
5542,779978,23,6,9,5,7,1,2,0,0,2,2,4,5,0,2,0,13
5542,776003,38,3,13,3,6,0,7,7,8,1,7,4,2,0,2,1,13
5542,785467,12,1,2,0,0,1,2,0,0,1,1,0,4,0,1,1,3
5542,790924,20,5,10,5,8,0,2,1,1,0,2,2,4,1,0,0,11
5542,779979,24,1,5,0,0,1,5,0,0,0,3,0,1,0,0,0,3
5542,785465,0,0,0,0,0,0,0,0,0,0,0,0,0,0,1,0,0
5543,785432,17,1,1,1,1,0,0,0,0,3,3,1,3,0,1,2,2
5543,790882,19,2,6,1,4,1,2,0,0,2,2,0,0,1,0,0,5
5543,790876,29,6,10,5,5,1,5,0,2,1,5,1,2,1,7,0,13
5543,785699,22,3,9,3,5,0,4,5,8,0,4,2,4,3,0,0,11
5543,774987,39,7,15,5,9,2,6,7,8,1,5,4,0,0,2,0,23
5543,781062,33,4,11,4,6,0,5,4,6,2,2,1,2,2,0,0,12
5543,790877,20,3,4,0,1,3,3,0,2,1,1,0,3,1,0,0,9
5543,779985,8,0,5,0,3,0,2,1,2,0,0,0,1,0,0,0,1
5543,790879,13,0,0,0,0,0,0,4,6,2,3,0,5,0,0,2,4
5543,796434,0,0,0,0,0,0,0,0,0,0,0,0,0,0,0,0,0
5544,791876,36,7,9,3,4,4,5,5,6,4,6,2,4,0,1,2,23
5544,791877,29,3,7,3,7,0,0,1,2,2,3,2,3,1,2,2,7
5544,785667,34,4,11,2,6,2,5,2,2,0,4,2,0,0,1,0,12
5544,786572,33,3,10,3,7,0,3,2,2,1,1,3,0,1,1,0,8
5544,786570,36,2,8,2,7,0,1,3,4,0,1,7,2,1,4,1,7
5544,780436,8,0,1,0,0,0,1,0,0,0,0,0,0,0,0,0,0
5544,781205,11,1,4,1,4,0,0,0,0,1,0,0,3,0,1,0,2
5544,797486,11,3,5,3,5,0,0,0,1,0,1,1,1,0,1,0,6
5544,797492,2,0,0,0,0,0,0,0,0,0,0,0,0,0,0,0,0
5545,790856,31,8,10,8,9,0,1,5,6,4,6,2,1,0,2,3,21
5545,780452,32,8,11,8,11,0,0,0,0,2,4,2,4,0,3,1,16
5545,796413,26,4,8,2,3,2,5,0,0,0,0,2,1,0,1,0,10
5545,796408,26,3,10,2,5,1,5,1,4,1,1,5,5,1,1,0,8
5545,796407,31,2,5,2,4,0,1,1,2,3,3,2,0,3,1,0,5
5545,796410,16,3,5,3,5,0,0,0,2,0,7,4,3,1,1,1,6
5545,796409,21,2,7,1,4,1,3,0,0,0,0,3,1,0,2,0,5
5545,790858,7,1,2,1,1,0,1,0,0,0,0,1,0,0,0,0,2
5545,780450,9,1,3,1,2,0,1,0,0,3,0,1,0,0,0,0,2
5545,796411,1,0,0,0,0,0,0,0,0,0,0,0,0,1,0,1,0
5546,786131,34,7,17,5,12,2,5,3,4,5,2,3,4,0,1,0,19
5546,780904,24,2,3,2,3,0,0,8,11,2,6,4,4,1,0,1,12
5546,797688,41,3,5,2,3,1,2,0,0,0,3,1,4,1,3,0,7
5546,786145,37,7,14,5,7,2,7,0,0,0,0,3,1,1,3,1,16
5546,786128,44,7,17,6,12,1,5,5,9,0,5,4,4,5,6,1,20
5546,792100,13,3,3,3,3,0,0,1,2,2,4,1,3,0,0,0,7
5546,785884,16,3,6,3,6,0,0,1,1,2,1,1,2,0,1,0,7
5546,797685,9,0,2,0,1,0,1,0,0,0,1,0,2,0,1,0,0
5546,792096,4,0,0,0,0,0,0,0,0,1,0,0,0,0,0,0,0
5546,775251,3,1,1,1,1,0,0,2,2,1,0,1,1,0,1,0,4
5547,796960,15,3,6,3,6,0,0,4,6,3,2,1,5,0,0,1,10
5547,781272,41,11,17,8,14,3,3,3,5,2,5,3,3,2,3,5,28
5547,791261,26,3,6,2,3,1,3,0,0,0,2,1,1,1,2,0,7
5547,785501,39,4,12,2,7,2,5,1,1,4,2,2,3,3,2,0,11
5547,781270,33,5,11,2,7,3,4,4,5,0,2,1,0,4,5,0,17
5547,796959,7,1,1,1,1,0,0,0,0,1,0,0,1,0,0,1,2
5547,785502,4,0,0,0,0,0,0,0,0,0,0,1,2,0,0,0,0
5547,796958,31,3,8,3,7,0,1,4,8,4,6,3,4,0,1,0,10
5547,791258,26,3,7,1,2,2,5,1,2,1,0,2,3,1,2,0,9
5547,799825,3,0,0,0,0,0,0,0,0,0,0,0,0,0,0,0,0
5548,796927,21,1,4,1,2,0,2,0,0,0,2,1,4,0,0,0,2
5548,796929,31,1,5,1,1,0,4,0,0,0,1,2,0,1,1,0,2
5548,791222,26,5,8,4,4,1,4,0,2,0,3,0,3,0,2,0,11
5548,791224,35,12,19,10,16,2,3,2,5,2,4,4,4,2,4,0,28
5548,785571,37,7,14,6,9,1,5,5,8,1,2,4,1,2,2,0,20
5548,791811,20,5,5,5,5,0,0,0,1,3,1,0,3,2,1,1,10
5548,786436,30,0,3,0,2,0,1,1,2,0,1,1,2,0,0,0,1
5549,791723,19,3,4,3,4,0,0,0,0,2,2,0,4,0,3,0,6
5549,797310,31,2,4,2,4,0,0,2,2,1,3,3,2,2,1,0,6
5549,785580,34,5,9,5,8,0,1,8,9,3,3,4,2,1,2,0,18
5549,791724,28,5,10,5,7,0,3,2,2,2,3,3,1,1,1,0,12
5549,781617,32,7,13,4,6,3,7,0,2,4,8,1,3,0,1,0,17
5549,780956,19,5,10,5,8,0,2,3,4,1,3,2,3,0,2,2,13
5549,786285,23,5,10,4,6,1,4,2,2,0,2,1,2,0,1,0,13
5549,797308,4,0,0,0,0,0,0,0,0,0,1,0,0,0,0,0,0
5549,780706,10,1,2,1,2,0,0,0,0,0,0,2,0,0,0,0,2
5550,796812,20,4,7,4,7,0,0,0,0,1,5,1,3,1,2,1,8
5550,780952,33,3,9,3,8,0,1,0,2,0,5,1,0,1,3,7,6
5550,786609,31,7,9,5,6,2,3,4,4,1,5,1,1,0,0,1,20
5550,785752,29,0,3,0,1,0,2,2,4,0,1,2,2,1,0,0,2
5550,796810,29,4,7,3,5,1,2,2,2,1,3,5,3,2,3,0,11
5550,780950,21,3,7,1,3,2,4,0,0,0,4,1,0,0,0,0,8
5550,780945,10,1,3,1,3,0,0,0,0,0,6,0,2,0,1,0,2
5550,791156,27,2,3,0,1,2,2,0,0,0,0,3,0,1,1,0,6
5551,785498,29,6,14,1,7,5,7,2,2,2,2,1,3,1,3,1,19
5551,776469,32,1,11,1,9,0,2,0,0,3,6,3,1,0,1,0,2
5551,796708,25,3,6,2,3,1,3,0,0,0,2,2,4,1,0,0,7
5551,780701,34,4,9,4,9,0,0,0,0,1,2,2,2,1,0,0,8
5551,776322,33,3,12,2,4,1,8,0,0,0,4,1,0,0,2,0,7
5551,796706,22,2,2,2,2,0,0,2,2,0,1,2,2,0,1,0,6
5551,796705,23,1,4,1,3,0,1,0,0,0,4,2,1,1,1,1,2
5551,791036,2,0,0,0,0,0,0,0,0,0,0,0,0,0,0,0,0
5552,796318,24,7,11,7,10,0,1,4,6,0,6,2,2,3,3,2,18
5552,790761,29,1,5,1,5,0,0,2,2,1,4,3,3,0,4,0,4
5552,790764,38,6,11,5,7,1,4,4,6,2,6,1,0,0,2,0,17
5552,796319,38,5,12,2,6,3,6,6,6,1,4,3,1,1,0,1,19
5552,796320,16,0,3,0,0,0,3,0,0,0,1,0,3,1,2,0,0
5552,779993,35,4,7,3,6,1,1,2,2,1,3,7,1,2,1,0,11
5552,796322,13,3,6,3,6,0,0,0,0,3,3,0,0,1,0,0,6
5552,796321,2,0,1,0,1,0,0,0,0,1,1,0,0,0,0,0,0
5552,785219,2,0,2,0,1,0,1,0,0,0,0,0,0,0,1,0,0
5552,796323,3,0,0,0,0,0,0,0,0,0,1,0,0,0,0,0,0
5553,781462,40,6,17,6,15,0,2,0,0,2,12,6,4,1,1,3,12
5553,785353,23,2,9,2,6,0,3,0,0,0,3,1,2,1,2,0,4
5553,781673,26,2,4,0,0,2,4,0,0,0,1,0,4,0,0,0,6
5553,780876,34,4,9,3,5,1,4,0,0,1,1,1,2,3,4,0,9
5553,781457,40,10,15,7,10,3,5,3,3,1,3,5,2,3,3,0,26
5553,785355,27,3,7,1,1,2,6,1,2,0,2,0,1,0,1,2,9
5553,790895,10,1,3,1,3,0,0,0,0,0,1,2,2,0,0,0,2
5554,796699,28,4,9,1,4,3,5,1,2,0,5,0,1,0,1,4,12
5554,790983,22,0,4,0,3,0,1,3,4,0,7,3,4,1,0,2,3
5554,790979,25,3,8,3,5,0,3,5,6,0,4,3,3,0,3,0,11
5554,796697,28,5,12,5,10,0,2,18,21,1,7,7,4,0,3,0,28
5554,788820,26,0,7,0,3,0,4,0,0,0,3,0,1,0,1,1,0
5554,796701,19,1,2,1,2,0,0,6,7,0,3,1,4,0,1,1,8
5554,790976,8,1,1,1,1,0,0,1,2,1,3,0,2,1,2,5,3
5554,790978,27,3,5,3,3,0,2,2,2,1,4,0,1,0,1,1,8
5554,796698,14,4,4,1,1,3,3,0,0,1,0,0,0,0,0,0,11
5554,790980,3,2,3,2,2,0,1,0,0,0,0,0,1,0,0,0,4
5555,790863,23,1,6,1,2,0,4,2,2,3,5,2,4,0,0,0,4
5555,780021,35,9,14,9,14,0,0,3,11,6,4,1,3,2,3,6,21
5555,785412,23,2,11,2,7,0,4,3,4,2,4,4,5,0,3,0,7
5555,776214,34,5,13,2,9,3,4,8,8,0,4,3,5,3,2,0,21
5555,780099,31,2,11,1,5,1,6,2,2,0,2,0,5,1,1,0,7
5555,775686,16,2,5,1,2,1,3,0,0,1,3,0,2,1,0,1,5
5555,796420,3,1,1,1,1,0,0,0,0,0,0,0,1,0,0,0,2
5555,785413,26,6,10,5,8,1,2,0,0,2,3,1,4,0,0,0,13
5555,776221,4,1,3,1,3,0,0,0,0,0,0,1,1,0,0,0,2
5555,785411,5,0,2,0,0,0,2,0,0,0,0,0,1,0,0,0,0
5556,797849,37,9,12,7,8,2,4,0,0,1,3,1,0,1,1,0,20
5556,781537,22,4,6,4,5,0,1,5,6,2,5,0,4,2,2,0,13
5556,786079,35,0,4,0,3,0,1,2,2,0,4,9,2,2,2,0,2
5556,797846,29,3,10,2,7,1,3,1,2,0,2,1,3,2,1,0,8
5556,792202,31,3,4,0,0,3,4,0,0,0,2,2,0,2,3,0,9
5556,797848,11,0,1,0,1,0,0,0,0,0,2,0,3,0,1,1,0
5556,792201,9,0,1,0,1,0,0,0,0,0,0,0,3,0,0,0,0
5556,797847,17,4,9,1,5,3,4,1,1,0,1,1,1,1,0,0,12
5556,797838,9,2,3,1,2,1,1,0,0,0,0,1,1,0,1,0,5
5557,775913,20,3,5,3,5,0,0,2,4,1,1,0,2,0,1,0,8
5557,797331,23,0,5,0,0,0,5,0,0,0,1,3,0,1,1,0,0
5557,791737,31,2,4,2,4,0,0,1,2,1,8,6,2,1,2,0,5
5557,783524,29,4,7,1,1,3,6,1,1,0,2,4,1,0,5,0,12
5557,780561,28,7,11,3,4,4,7,0,0,1,6,0,2,0,1,0,18
5557,791734,9,1,3,1,2,0,1,3,3,0,1,0,1,0,0,0,5
5557,781516,4,0,1,0,1,0,0,0,0,0,0,0,1,0,1,0,0
5557,797332,6,2,4,2,4,0,0,1,3,1,0,0,1,0,0,0,5
5557,797333,15,1,1,0,0,1,1,0,0,1,0,3,0,0,0,0,3
5557,795372,3,0,0,0,0,0,0,0,0,0,0,0,0,1,0,0,0
5557,786223,19,3,5,3,3,0,2,0,2,1,2,0,1,0,2,0,6
5557,786220,13,1,3,1,2,0,1,2,2,0,1,1,2,2,1,0,4
5564,791391,37,5,8,5,7,0,1,0,0,1,3,1,4,1,2,2,10
5564,791390,30,6,8,5,7,1,1,7,9,4,2,3,2,0,3,0,20
5564,776446,5,0,1,0,1,0,0,0,0,0,0,0,0,0,0,0,0
5564,780133,31,3,9,1,5,2,4,3,4,1,6,1,4,0,1,0,11
5564,780130,32,2,7,1,3,1,4,2,4,0,2,4,1,2,3,0,7
5564,797156,22,3,5,1,2,2,3,2,2,0,2,2,3,0,1,0,10
5564,791388,17,1,3,1,2,0,1,0,0,1,3,0,1,1,0,0,2
5564,775743,22,3,5,1,1,2,4,3,7,0,6,1,2,0,2,0,11
5564,780407,4,0,1,0,1,0,0,0,0,0,0,0,0,0,0,0,0
5565,784640,21,4,7,3,4,1,3,0,2,0,5,0,3,0,1,0,9
5565,797655,30,4,5,4,5,0,0,2,4,6,3,3,1,0,3,0,10
5565,797657,32,2,9,2,5,0,4,2,2,0,5,2,4,1,1,0,6
5565,792072,36,4,9,0,0,4,9,1,2,0,2,2,1,3,0,0,13
5565,792069,35,3,11,2,5,1,6,3,5,1,1,2,3,0,2,0,10
5565,786025,5,1,1,1,1,0,0,0,0,1,2,0,0,0,0,0,2
5565,797652,18,0,3,0,1,0,2,0,0,1,0,2,5,1,3,1,0
5565,797653,1,0,0,0,0,0,0,0,0,0,0,0,1,0,0,0,0
5565,785572,20,2,8,0,3,2,5,2,2,2,1,2,2,0,1,0,8
5565,774844,2,0,0,0,0,0,0,1,2,0,1,0,1,0,0,0,1
5566,792197,27,3,8,2,2,1,6,1,1,0,4,1,2,0,0,0,8
5566,781132,26,4,11,1,4,3,7,0,0,0,5,1,2,1,0,0,11
5566,797517,27,9,12,9,12,0,0,1,1,2,6,0,0,0,2,0,19
5566,791940,18,4,8,3,3,1,5,2,2,3,0,2,2,1,0,0,11
5566,786534,29,3,9,3,7,0,2,0,1,2,8,5,1,3,2,1,6
5566,797519,8,0,3,0,0,0,3,0,0,0,1,0,0,0,0,2,0
5566,797522,7,0,2,0,2,0,0,0,0,1,1,0,4,0,1,0,0
5566,786539,10,1,2,1,2,0,0,0,0,0,2,0,3,0,0,0,2
5566,797520,8,0,2,0,2,0,0,1,2,1,0,0,0,0,0,0,1
5566,797518,23,8,12,6,9,2,3,3,3,1,1,6,0,3,1,0,21
5566,791938,11,1,2,1,2,0,0,0,0,0,1,1,0,0,0,0,2
5566,797516,3,0,0,0,0,0,0,0,2,0,0,0,0,0,0,0,0
5566,789070,3,0,1,0,1,0,0,0,0,0,0,1,0,0,0,0,0
5567,786003,27,2,6,1,2,1,4,0,0,0,2,2,1,0,1,0,5
5567,775455,27,7,12,6,9,1,3,2,2,0,7,2,2,0,3,0,17
5567,786002,20,2,4,1,2,1,2,4,4,0,2,4,2,0,2,0,9
5567,786005,13,0,2,0,0,0,2,0,0,0,0,1,1,0,1,0,0
5567,781397,12,2,3,2,3,0,0,0,0,0,0,0,0,0,0,0,4
5567,792119,6,0,1,0,1,0,0,0,1,0,2,0,0,0,0,0,0
5567,786009,15,1,4,1,3,0,1,0,1,0,6,2,2,2,3,0,2
5567,797749,32,3,7,0,2,3,5,0,0,0,3,0,0,0,1,2,9
5567,797747,19,2,6,1,3,1,3,2,4,0,0,2,5,0,2,0,7
5567,792123,19,1,5,0,1,1,4,0,0,1,0,2,1,0,3,0,3
5567,786008,10,1,2,1,1,0,1,0,0,1,1,2,0,0,0,0,2
5568,775954,29,1,3,1,2,0,1,2,3,2,2,2,2,0,1,1,4
5568,781006,22,6,9,6,7,0,2,1,1,1,1,0,5,0,0,1,13
5568,796194,31,2,8,0,1,2,7,2,2,1,6,2,2,4,3,0,8
5568,796464,24,3,6,3,6,0,0,2,4,0,1,2,0,3,2,2,8
5568,790917,28,2,7,1,1,1,6,0,0,1,2,1,2,1,0,0,5
5568,790918,13,2,4,2,4,0,0,1,2,3,1,1,2,0,0,0,5
5568,796459,25,3,7,3,7,0,0,3,4,2,2,5,3,0,4,1,9
5568,781157,15,0,5,0,2,0,3,2,2,0,0,2,0,0,1,1,2
5568,780648,13,1,5,1,5,0,0,0,0,0,3,0,2,0,0,0,2
5569,785999,24,0,3,0,3,0,0,5,6,2,4,0,5,1,5,0,5
5569,775654,32,2,5,2,5,0,0,2,5,7,5,0,1,1,4,1,6
5569,796398,32,1,3,1,2,0,1,2,5,0,2,0,2,1,2,1,4
5569,791639,24,6,12,4,9,2,3,2,2,0,3,1,3,1,2,0,16
5569,785389,36,4,13,4,11,0,2,3,3,0,0,1,3,1,1,0,11
5569,785255,5,0,1,0,1,0,0,0,0,0,1,0,2,0,1,0,0
5569,796399,23,2,9,2,6,0,3,2,2,1,3,5,3,1,2,0,6
5569,791640,16,2,4,1,2,1,2,0,0,3,7,0,1,2,1,2,5
5569,775171,8,0,2,0,0,0,2,0,0,0,1,0,0,1,0,0,0
5570,780058,21,1,4,0,1,1,3,0,0,1,3,0,1,0,0,0,3
5570,780059,33,2,8,2,8,0,0,9,10,2,7,8,2,2,4,2,13
5570,796494,30,4,6,2,2,2,4,0,0,0,2,1,0,0,2,2,10
5570,790944,36,5,13,4,7,1,6,10,10,1,4,1,1,1,0,0,21
5570,780061,32,3,7,2,4,1,3,3,4,0,4,3,3,1,2,0,10
5570,790941,16,3,6,3,5,0,1,0,2,0,3,0,2,1,1,1,6
5570,796496,12,1,2,1,1,0,1,0,0,1,1,0,3,1,2,0,2
5570,786754,17,1,5,0,3,1,2,2,2,1,1,1,1,0,3,0,5
5570,790943,2,0,0,0,0,0,0,0,0,0,0,0,2,0,0,0,0
5570,796497,1,0,0,0,0,0,0,0,0,0,0,0,0,0,0,0,0
5571,791454,17,2,7,2,6,0,1,0,0,1,2,1,4,1,1,0,4
5571,781526,25,4,10,4,9,0,1,4,5,0,4,0,3,2,1,1,12
5571,797217,24,0,2,0,2,0,0,2,2,0,1,2,4,1,1,0,2
5571,797218,31,2,9,2,9,0,0,4,4,1,5,1,3,0,2,0,8
5571,775697,35,5,11,3,6,2,5,0,0,2,3,4,3,1,4,1,12
5571,797222,16,2,4,2,4,0,0,2,2,1,4,1,4,1,2,2,6
5571,791453,24,4,9,0,2,4,7,0,0,1,1,2,2,2,3,1,12
5571,797223,7,0,1,0,1,0,0,3,4,1,0,0,1,0,1,0,3
5571,791846,21,0,1,0,1,0,0,0,0,0,5,0,1,1,1,0,0
5572,785518,25,3,7,1,4,2,3,2,4,2,2,3,4,1,2,1,10
5572,796390,21,5,7,5,7,0,0,0,3,4,6,0,1,1,0,4,10
5572,785451,25,4,7,1,2,3,5,1,1,0,1,3,4,1,4,0,12
5572,790834,29,2,7,1,4,1,3,3,6,1,7,0,1,0,1,0,8
5572,785379,12,1,3,0,1,1,2,0,0,1,0,0,0,0,0,1,3
5572,790833,20,5,7,3,4,2,3,0,0,0,2,0,0,1,0,1,12
5572,790832,19,2,7,1,3,1,4,0,0,0,1,1,0,1,0,0,5
5572,785377,27,4,6,4,5,0,1,6,11,0,2,5,1,0,4,1,14
5572,790830,14,0,1,0,1,0,0,0,0,0,0,1,1,0,1,0,0
5572,790831,8,1,1,1,1,0,0,0,0,0,0,0,1,1,0,0,2
5573,786041,29,5,11,5,9,0,2,0,0,1,4,2,2,1,1,1,10
5573,780881,22,3,8,1,4,2,4,0,0,1,2,4,1,0,1,0,8
5573,780275,18,1,2,1,2,0,0,1,1,2,4,1,4,0,2,0,3
5573,792075,32,4,8,1,3,3,5,2,2,0,3,1,0,0,2,0,13
5573,786686,38,4,14,4,9,0,5,0,0,1,3,6,2,1,6,0,8
5573,785437,15,2,2,1,1,1,1,2,2,0,1,0,5,1,1,3,7
5573,780052,12,0,2,0,1,0,1,0,0,0,0,0,1,0,0,0,0
5573,775222,21,6,8,3,3,3,5,0,1,1,2,1,5,1,1,0,15
5573,780882,3,1,1,0,0,1,1,0,0,0,1,0,1,0,1,0,3
5573,786051,3,1,1,1,1,0,0,0,0,0,0,0,1,0,1,0,2
5573,792074,7,1,1,0,0,1,1,0,0,0,0,0,0,0,1,0,3
5574,790935,21,4,5,4,4,0,1,5,6,0,4,5,3,0,0,0,13
5574,792442,17,5,5,5,5,0,0,0,1,0,9,1,2,1,1,1,10
5574,780933,23,4,10,0,0,4,10,0,0,0,6,0,3,0,2,0,12
5574,775340,31,3,11,3,9,0,2,3,4,0,1,3,1,0,3,0,9
5574,774826,25,5,10,1,2,4,8,0,0,0,4,3,1,1,0,0,14
5574,796491,2,0,0,0,0,0,0,0,0,0,1,0,0,0,0,0,0
5574,796190,15,2,9,1,4,1,5,0,0,3,1,0,1,0,0,0,5
5574,790937,21,2,5,2,5,0,0,0,0,3,7,0,3,0,4,0,4
5574,790936,2,1,1,0,0,1,1,0,0,0,0,0,0,0,0,0,3
5574,785497,2,1,2,1,2,0,0,0,0,0,0,0,0,0,0,0,2
5574,785445,17,3,5,3,4,0,1,2,2,3,1,5,3,0,0,0,8
5574,796493,2,0,0,0,0,0,0,0,0,0,1,0,0,0,0,0,0
5574,790938,13,3,4,3,3,0,1,0,0,0,1,2,0,1,1,0,6
5574,796492,9,0,2,0,2,0,0,0,0,0,1,3,2,0,0,0,0
5575,776209,37,9,16,8,13,1,3,9,10,2,9,1,3,1,1,0,28
5575,796938,34,7,15,2,3,5,12,1,1,0,4,4,2,1,5,0,20
5575,791237,30,1,6,0,1,1,5,0,1,0,2,1,3,1,2,0,3
5575,791351,21,4,11,2,6,2,5,0,1,0,1,1,2,1,2,0,10
5575,791238,30,1,8,1,5,0,3,1,2,0,4,0,0,0,3,0,3
5575,788124,4,0,0,0,0,0,0,0,0,0,1,0,2,0,1,0,0
5575,781227,14,0,1,0,0,0,1,0,0,0,3,0,2,1,0,1,0
5575,791236,19,0,2,0,1,0,1,0,0,0,1,1,0,1,0,0,0
5575,791240,9,0,1,0,1,0,0,1,2,1,0,0,3,0,0,0,1
5575,796939,2,0,0,0,0,0,0,0,0,0,0,0,0,0,0,0,0
5576,790870,35,8,17,8,17,0,0,2,2,5,11,3,1,1,3,1,18
5576,780493,16,0,3,0,0,0,3,0,0,1,3,1,2,0,0,0,0
5576,790869,37,6,15,6,13,0,2,5,6,0,10,3,3,0,6,0,17
5576,780116,31,2,5,2,3,0,2,2,2,1,3,0,5,1,1,0,6
5576,790866,38,1,8,0,1,1,7,0,0,0,4,1,1,0,1,0,3
5576,780492,5,0,0,0,0,0,0,0,0,1,0,0,1,0,1,0,0
5576,796427,11,2,2,2,2,0,0,0,0,0,2,1,2,0,2,0,4
5576,796421,27,5,9,4,7,1,2,2,4,1,3,0,1,0,2,0,13
5577,785863,31,5,13,5,13,0,0,2,6,2,3,1,4,2,0,0,12
5577,785631,24,1,5,1,3,0,2,0,0,1,4,0,2,3,2,0,2
5577,786248,34,7,12,7,12,0,0,2,2,1,14,1,4,0,1,3,16
5577,785630,32,0,6,0,5,0,1,0,0,1,0,0,1,0,0,0,0
5577,780777,28,7,19,4,11,3,8,3,5,2,4,2,3,1,0,0,20
5577,791197,5,0,0,0,0,0,0,0,0,1,0,0,1,0,0,0,0
5577,791198,7,0,0,0,0,0,0,0,0,0,0,0,0,0,0,0,0
5577,791200,19,2,7,1,4,1,3,0,0,0,0,2,0,0,2,0,5
5577,785632,20,3,6,3,6,0,0,7,8,1,2,0,1,2,0,1,13
5578,780651,31,6,8,6,8,0,0,4,9,0,4,1,3,0,1,2,16
5578,791815,32,8,18,8,15,0,3,4,4,0,4,3,4,2,1,0,20
5578,791810,33,2,6,2,4,0,2,1,1,0,3,11,3,2,2,0,5
5578,791814,28,2,5,0,1,2,4,0,0,0,1,2,3,1,0,0,6
5578,780650,36,5,11,4,8,1,3,0,2,0,11,2,3,0,4,0,11
5578,781596,13,3,3,3,3,0,0,1,1,0,2,0,1,0,2,2,7
5578,786644,12,1,1,1,1,0,0,0,0,1,1,0,2,0,0,1,2
5578,786645,15,2,4,2,3,0,1,0,0,0,2,1,4,0,0,1,4
5578,791812,0,0,0,0,0,0,0,0,0,0,0,0,0,0,0,0,0
5579,799906,29,2,6,0,1,2,5,1,2,0,3,3,4,0,2,1,7
5579,775833,16,0,4,0,3,0,1,1,2,2,8,0,5,0,0,1,1
5579,785439,36,3,9,3,6,0,3,6,10,0,4,1,1,2,2,0,12
5579,781036,40,8,14,3,5,5,9,6,7,0,2,3,0,0,3,0,27
5579,774894,40,6,11,2,5,4,6,2,2,0,3,3,1,0,2,1,18
5579,796847,18,3,6,2,3,1,3,2,2,2,2,0,2,0,1,0,9
5579,796845,4,0,0,0,0,0,0,0,0,0,0,1,0,1,0,0,0
5579,791178,17,1,2,1,2,0,0,0,0,0,6,1,2,0,1,0,2
5580,792565,14,1,2,1,2,0,0,0,0,1,4,0,4,0,3,0,2
5580,776333,12,0,0,0,0,0,0,0,1,1,2,0,0,1,0,0,0
5580,798133,12,1,2,1,1,0,1,0,0,1,0,1,2,0,0,0,2
5580,792563,17,2,7,0,1,2,6,2,2,0,3,1,0,0,0,0,8
5580,792561,18,1,6,0,2,1,4,0,0,0,1,2,2,0,2,0,3
5580,780266,26,8,20,3,6,5,14,0,0,2,2,0,3,1,0,0,21
5580,798134,23,2,7,2,3,0,4,1,2,1,2,2,0,0,2,0,5
5580,780270,28,6,15,3,8,3,7,2,3,3,3,4,1,0,1,1,17
5580,792560,20,1,4,1,4,0,0,0,0,4,4,1,2,1,0,1,2
5580,798132,17,1,2,0,0,1,2,0,0,0,0,0,2,0,0,0,3
5580,798135,12,1,2,1,2,0,0,1,1,0,1,1,3,0,0,0,3
5580,785472,1,0,0,0,0,0,0,0,0,0,0,0,0,0,0,0,0
5581,797142,15,1,1,1,1,0,0,0,0,1,3,0,3,0,0,1,2
5581,791522,38,4,8,4,7,0,1,5,7,1,7,4,4,0,1,0,13
5581,786351,30,4,6,1,1,3,5,0,0,2,4,1,2,2,0,0,11
5581,797146,36,8,21,5,8,3,13,9,9,1,3,4,1,0,3,0,28
5581,797143,39,7,12,3,3,4,9,1,1,0,2,9,1,2,3,1,19
5581,785816,17,1,2,1,2,0,0,1,1,1,3,1,0,1,0,1,3
5581,797147,13,0,0,0,0,0,0,0,0,0,2,3,1,0,2,0,0
5581,785479,10,0,3,0,2,0,1,2,2,1,2,0,3,0,0,0,2
5581,797148,2,0,0,0,0,0,0,0,0,0,0,0,0,0,0,0,0
5582,790784,28,2,9,2,7,0,2,3,4,5,1,3,1,0,0,3,7
5582,786548,29,9,14,9,14,0,0,4,5,4,0,1,2,2,2,1,22
5582,797475,27,3,10,1,3,2,7,4,4,0,2,0,0,1,1,0,12
5582,786229,28,2,5,1,2,1,3,3,5,1,3,2,1,1,0,0,8
5582,775229,27,2,9,1,3,1,6,5,6,0,4,4,2,1,5,0,10
5582,776219,11,0,0,0,0,0,0,1,2,1,3,0,1,0,1,0,1
5582,786235,7,0,0,0,0,0,0,0,0,0,0,0,2,0,0,0,0
5582,791871,11,0,1,0,0,0,1,0,0,0,0,1,0,0,0,0,0
5582,786581,5,1,1,1,1,0,0,0,0,0,0,0,0,0,0,0,2
5582,786770,15,2,5,2,5,0,0,0,0,0,5,0,0,0,2,0,4
5582,781518,12,1,3,0,0,1,3,0,1,0,4,0,2,0,0,0,3
5592,786566,37,7,14,7,11,0,3,4,6,1,5,0,1,1,0,0,18
5592,781204,16,1,4,0,2,1,2,0,0,1,1,0,4,0,0,0,3
5592,786568,11,1,4,1,4,0,0,0,0,2,1,0,0,1,0,0,2
5592,791993,30,5,11,5,10,0,1,1,2,1,8,1,1,2,1,0,11
5592,781188,38,4,17,4,12,0,5,11,13,0,7,6,2,2,2,0,19
5592,791997,25,6,11,5,8,1,3,0,0,2,0,0,3,0,0,0,13
5592,786562,22,2,3,1,1,1,2,1,1,2,0,1,1,1,2,0,6
5592,781189,21,2,2,2,2,0,0,0,0,0,3,0,4,2,3,0,4
5593,785126,15,3,5,2,4,1,1,0,0,1,1,2,0,0,0,0,7
5593,779857,24,3,10,3,9,0,1,0,0,1,4,1,2,1,0,0,6
5593,791014,12,0,3,0,0,0,3,2,2,0,3,0,3,0,0,0,2
5593,779976,34,3,11,2,5,1,6,5,6,0,5,3,0,0,1,0,12
5593,774990,27,3,10,3,5,0,5,2,2,0,3,1,2,1,6,1,8
5593,796673,3,0,1,0,1,0,0,0,0,0,0,0,0,0,1,0,0
5593,796674,25,3,4,2,3,1,1,4,4,1,5,0,2,1,1,0,11
5593,781586,15,3,4,3,4,0,0,4,4,3,1,1,3,0,2,1,10
5593,785961,26,6,8,4,5,2,3,1,1,0,3,1,3,2,2,0,15
5593,785339,19,1,1,1,1,0,0,0,0,0,3,2,4,0,0,0,2
5594,786131,21,6,8,5,5,1,3,2,3,0,1,0,4,0,1,0,15
5594,780904,22,4,10,4,10,0,0,4,4,2,5,4,5,0,3,0,12
5594,797688,32,2,4,2,2,0,2,2,3,1,4,3,2,3,2,2,6
5594,786128,36,6,12,6,12,0,0,7,12,2,3,5,2,1,3,2,19
5594,785884,16,2,2,1,1,1,1,0,0,1,4,1,0,0,1,0,5
5594,797685,22,5,8,2,4,3,4,2,2,3,4,3,4,1,2,0,15
5594,792096,7,0,1,0,0,0,1,0,0,0,0,2,0,0,0,0,0
5594,786145,24,3,8,1,3,2,5,2,2,0,3,1,1,0,0,0,10
5594,792100,17,4,5,4,5,0,0,0,0,1,2,0,2,0,1,1,8
5594,775251,3,0,1,0,0,0,1,0,0,0,0,0,2,0,0,0,0
5595,796960,23,3,4,3,4,0,0,2,3,0,2,1,5,2,2,1,8
5595,781272,37,6,9,6,8,0,1,2,3,1,3,3,4,0,1,3,14
5595,791261,29,4,10,3,6,1,4,3,4,1,2,0,3,0,2,0,12
5595,785501,31,2,12,2,6,0,6,6,8,3,0,2,2,3,2,0,10
5595,781270,36,11,20,6,13,5,7,3,4,0,4,3,4,3,1,0,30
5595,796959,5,0,0,0,0,0,0,0,0,0,0,0,0,0,0,0,0
5595,785502,2,0,0,0,0,0,0,0,0,0,0,0,1,0,0,1,0
5595,796958,20,1,4,1,4,0,0,1,2,0,3,1,4,0,1,0,3
5595,791258,17,1,3,0,0,1,3,2,2,1,3,0,1,1,2,0,5
5596,781558,25,3,6,1,4,2,2,3,4,2,1,0,5,0,0,0,11
5596,780993,21,2,4,2,3,0,1,2,2,2,6,2,0,0,1,1,6
5596,791452,35,5,9,1,4,4,5,0,0,1,1,4,1,2,3,0,14
5596,791449,14,1,8,1,6,0,2,1,2,1,0,1,2,1,0,0,3
5596,797224,29,7,12,6,7,1,5,1,1,0,9,2,4,2,2,0,16
5596,797230,2,1,2,1,2,0,0,0,0,0,0,0,0,0,0,0,2
5596,775248,36,11,19,6,10,5,9,7,9,4,7,3,0,1,3,2,34
5596,797231,6,1,2,0,0,1,2,0,0,0,0,0,1,0,0,0,3
5596,797225,32,2,6,2,4,0,2,3,3,1,2,4,4,1,2,0,7
5597,796663,20,2,4,2,4,0,0,3,3,1,2,0,2,0,0,0,7
5597,791004,29,3,11,1,4,2,7,0,0,0,2,0,3,1,0,0,8
5597,780291,30,8,16,5,9,3,7,0,1,5,2,1,3,0,2,0,19
5597,796665,34,2,7,2,6,0,1,0,0,1,4,3,2,0,2,1,4
5597,775305,40,8,18,7,13,1,5,5,6,2,6,4,0,1,3,1,22
5597,791006,12,2,5,1,3,1,2,0,0,0,0,0,4,0,0,0,5
5597,796666,13,1,2,1,2,0,0,1,2,2,3,1,1,0,0,1,3
5597,796664,22,9,13,6,7,3,6,2,3,2,3,1,1,3,1,0,23
5598,792249,29,2,3,2,3,0,0,3,4,1,5,1,3,3,2,3,7
5598,781430,29,6,10,5,8,1,2,3,7,3,11,6,3,1,3,1,16
5598,792248,36,2,10,0,3,2,7,1,2,0,3,2,2,1,1,0,7
5598,781445,39,8,16,4,6,4,10,1,1,0,7,1,1,0,1,0,21
5598,768845,30,6,9,1,4,5,5,1,2,0,6,4,2,0,1,1,18
5598,792253,4,0,2,0,2,0,0,0,0,0,0,1,0,0,0,0,0
5598,781448,11,0,3,0,3,0,0,0,0,0,0,2,1,0,1,1,0
5598,797941,5,1,2,0,1,1,1,0,0,0,0,0,2,0,1,0,3
5598,792250,17,2,6,1,4,1,2,0,2,0,2,2,1,2,1,0,5
5599,797712,5,2,3,2,3,0,0,0,0,1,0,0,0,0,0,0,4
5599,791964,23,1,6,1,1,0,5,0,0,0,6,0,2,2,3,0,2
5599,786056,25,1,4,0,1,1,3,0,2,0,1,3,1,0,3,0,3
5599,781339,37,3,14,2,7,1,7,2,2,0,5,1,3,1,1,0,9
5599,781337,34,5,14,3,8,2,6,4,4,0,1,1,1,1,1,0,16
5599,797713,5,1,3,1,3,0,0,0,0,2,3,0,0,0,1,0,2
5599,792041,13,2,7,2,5,0,2,4,4,2,3,2,1,1,1,0,8
5599,786054,20,5,7,5,7,0,0,3,3,2,2,1,4,0,1,1,13
5599,799737,6,0,0,0,0,0,0,0,0,0,1,0,1,1,0,1,0
5599,797711,24,3,8,2,3,1,5,2,2,1,6,1,3,1,0,0,9
5599,797710,8,1,3,1,2,0,1,1,1,0,2,0,1,0,0,0,3
5600,781300,22,4,11,4,10,0,1,2,4,4,7,1,1,1,2,1,10
5600,790803,17,3,6,3,6,0,0,3,3,2,2,0,1,0,1,0,9
5600,781305,20,2,4,0,0,2,4,0,0,0,1,1,1,1,1,0,6
5600,790801,18,4,4,4,4,0,0,0,1,1,1,4,1,0,2,0,8
5600,781304,27,5,6,4,5,1,1,0,0,0,2,0,2,1,3,1,11
5600,780598,20,4,7,3,5,1,2,2,2,2,8,0,1,0,0,0,11
5600,796363,25,4,8,3,5,1,3,2,2,1,0,1,1,1,3,0,11
5600,796364,9,1,1,1,1,0,0,0,0,0,1,0,2,1,0,0,2
5600,796360,19,3,7,3,5,0,2,2,2,1,2,4,3,0,1,0,8
5600,790802,13,1,5,0,1,1,4,0,0,2,2,0,1,0,1,0,3
5600,776372,2,1,2,1,2,0,0,0,0,0,0,0,0,0,1,0,2
5600,796362,4,0,0,0,0,0,0,0,0,0,0,0,0,0,0,1,0
5600,781303,2,0,1,0,0,0,1,0,0,2,1,0,0,0,0,0,0
5600,776366,2,0,0,0,0,0,0,0,0,0,1,0,0,0,0,1,0
5601,790821,36,4,8,2,5,2,3,3,6,1,1,1,2,1,2,0,13
5601,775585,19,1,2,1,2,0,0,0,0,2,3,0,3,1,1,0,2
5601,790822,38,6,16,3,9,3,7,6,6,0,1,3,1,3,3,0,21
5601,790820,27,2,8,2,4,0,4,1,2,0,3,0,2,1,3,0,5
5601,774980,36,5,11,2,5,3,6,0,0,1,3,3,0,3,4,0,13
5601,780445,25,1,2,1,2,0,0,0,0,0,3,0,1,0,0,2,2
5601,785365,17,1,6,0,3,1,3,0,3,2,1,0,0,1,0,0,3
5601,792436,2,0,1,0,1,0,0,0,0,0,0,0,0,0,0,0,0
5602,786765,28,3,8,3,6,0,2,6,8,2,7,4,2,2,1,1,12
5602,797852,32,4,9,3,7,1,2,0,0,0,3,7,1,3,0,0,9
5602,792379,30,5,8,1,1,4,7,0,0,0,2,3,3,0,0,1,14
5602,792380,33,4,8,2,2,2,6,0,0,0,1,4,1,2,1,0,10
5602,781669,27,8,13,3,6,5,7,2,3,0,6,2,2,1,2,0,23
5602,781668,2,0,0,0,0,0,0,0,0,0,0,0,1,0,0,0,0
5602,797860,12,3,5,3,5,0,0,0,0,1,3,0,3,0,2,0,6
5602,797854,10,0,1,0,0,0,1,0,0,1,2,0,1,0,2,0,0
5602,797853,2,1,1,0,0,1,1,0,0,0,0,0,0,0,0,0,3
5602,781672,21,3,9,3,8,0,1,4,5,0,7,0,2,0,0,3,10
5602,781671,3,0,0,0,0,0,0,0,0,0,1,1,0,0,0,0,0
5603,792140,24,4,8,4,8,0,0,0,0,2,1,1,2,1,2,1,8
5603,786596,22,3,9,3,7,0,2,3,3,2,2,1,3,0,2,0,9
5603,792144,29,3,9,3,5,0,4,0,0,3,3,1,2,0,3,0,6
5603,781429,33,2,6,0,1,2,5,1,2,0,5,1,2,1,1,0,7
5603,776092,28,6,12,3,7,3,5,0,1,1,5,2,1,2,0,0,15
5603,797791,9,1,3,1,3,0,0,0,2,1,1,0,0,0,0,0,2
5603,792146,5,0,2,0,2,0,0,0,0,0,1,0,0,0,1,0,0
5603,797793,13,3,4,1,1,2,3,0,0,0,1,0,1,0,1,0,8
5603,797797,2,0,0,0,0,0,0,0,0,0,0,0,0,0,0,0,0
5603,797787,6,0,3,0,1,0,2,0,0,0,1,0,0,0,1,1,0
5603,797786,15,0,6,0,4,0,2,5,5,0,1,0,1,0,0,0,5
5603,797789,2,0,0,0,0,0,0,0,0,0,0,0,0,0,0,0,0
5603,785976,9,0,2,0,1,0,1,1,2,1,2,1,1,1,1,0,1
5603,785975,1,0,0,0,0,0,0,0,0,0,0,0,0,0,0,0,0
5603,781431,2,0,1,0,1,0,0,0,0,0,0,0,1,0,0,0,0
5604,780765,33,4,9,3,6,1,3,2,2,1,5,2,3,0,3,1,11
5604,781301,22,1,2,1,2,0,0,2,5,2,3,0,2,0,0,4,4
5604,786255,38,3,9,2,5,1,4,6,6,0,6,1,1,1,3,0,13
5604,780762,30,8,12,4,5,4,7,0,1,3,6,0,3,0,1,0,20
5604,780768,27,3,9,3,6,0,3,0,0,1,0,6,4,2,1,0,6
5604,791729,12,1,4,1,2,0,2,0,0,1,3,0,1,0,1,1,2
5604,780755,20,2,4,2,3,0,1,0,0,1,2,0,1,0,2,1,4
5604,776241,18,7,10,4,5,3,5,4,4,0,4,1,1,0,1,0,21
5605,785714,16,1,3,1,3,0,0,2,4,0,1,2,3,0,0,0,4
5605,775894,34,5,13,3,8,2,5,2,2,2,3,3,2,0,0,0,14
5605,785711,36,6,11,1,2,5,9,1,2,0,3,3,2,2,3,0,18
5605,780985,38,11,17,4,5,7,12,0,1,0,2,4,0,0,1,0,29
5605,775266,34,5,12,3,6,2,6,1,3,0,7,1,3,3,1,0,13
5605,796829,17,1,2,1,2,0,0,0,0,2,2,2,3,0,1,2,2
5605,780988,3,0,1,0,1,0,0,0,0,0,0,2,0,0,0,0,0
5605,791167,9,0,1,0,0,0,1,2,2,1,0,0,2,1,0,0,2
5605,785378,5,0,1,0,1,0,0,0,0,1,0,1,0,0,1,0,0
5605,779994,8,1,3,0,1,1,2,0,0,0,1,0,1,1,0,0,3
5606,785800,26,4,6,1,2,3,4,1,3,2,6,0,1,0,0,0,12
5606,785799,15,2,4,2,4,0,0,1,2,4,2,3,4,0,0,0,5
5606,791676,31,4,9,2,5,2,4,2,2,0,2,6,2,1,3,0,12
5606,780554,28,2,6,1,5,1,1,4,4,1,2,1,0,1,2,0,9
5606,780553,26,11,22,11,21,0,1,0,0,1,1,2,4,0,1,0,22
5606,797426,7,0,1,0,0,0,1,0,0,1,1,0,0,0,0,0,0
5606,791678,2,0,0,0,0,0,0,0,0,0,0,0,0,0,0,0,0
5606,791679,4,0,1,0,1,0,0,0,0,3,1,1,0,0,2,1,0
5606,785807,12,0,1,0,1,0,0,0,0,1,2,0,0,0,0,0,0
5606,780760,20,4,8,3,4,1,4,2,2,1,4,0,2,0,0,1,11
5606,797427,21,4,7,2,2,2,5,0,0,0,0,2,0,0,1,0,10
5606,791677,8,0,1,0,1,0,0,0,0,0,0,0,0,0,2,0,0
5607,780797,28,6,10,1,4,5,6,0,0,0,3,2,3,1,0,0,17
5607,776418,20,4,8,4,8,0,0,1,2,0,3,1,1,1,0,1,9
5607,785505,13,5,7,5,6,0,1,2,3,0,1,2,5,0,3,0,12
5607,780555,37,0,1,0,0,0,1,7,8,0,3,2,3,4,2,1,7
5607,775604,37,4,9,3,6,1,3,1,1,0,4,7,2,0,3,0,10
5607,791616,19,3,5,2,4,1,1,0,0,2,4,0,1,0,0,0,7
5607,796981,19,2,7,2,7,0,0,2,2,0,1,0,0,0,3,0,6
5607,791618,27,0,2,0,0,0,2,0,0,0,1,1,2,1,3,1,0
5608,790914,17,1,4,1,4,0,0,0,0,1,4,3,4,0,0,1,2
5608,780798,27,4,6,2,3,2,3,0,0,4,4,0,1,0,0,0,10
5608,785455,30,7,16,4,8,3,8,1,2,2,1,2,1,1,0,0,18
5608,785453,29,4,12,1,8,3,4,1,2,3,1,1,1,2,3,1,12
5608,774940,22,3,9,3,8,0,1,2,2,2,1,1,2,0,3,0,8
5608,790915,17,3,7,3,7,0,0,0,0,5,0,0,3,0,3,4,6
5608,785458,26,8,15,8,14,0,1,3,3,4,6,1,2,3,2,1,19
5608,790913,17,2,3,1,2,1,1,1,1,0,2,6,3,1,1,0,6
5608,785454,6,1,1,1,1,0,0,0,0,0,1,1,2,0,1,0,2
5608,790911,4,0,1,0,0,0,1,0,0,1,0,1,0,0,0,0,0
5608,790912,2,0,1,0,1,0,0,0,0,0,0,0,0,2,2,0,0
5608,785456,3,0,0,0,0,0,0,0,0,0,0,0,0,0,0,0,0
5609,791302,19,2,6,2,4,0,2,3,4,1,2,0,4,1,1,1,7
5609,781622,26,1,8,1,1,0,7,4,4,6,1,1,2,0,2,0,6
5609,791309,38,3,12,2,7,1,5,2,2,3,6,7,1,1,4,1,9
5609,785835,24,4,5,4,4,0,1,1,2,0,2,2,0,2,2,1,9
5609,776334,23,0,5,0,1,0,4,0,0,0,2,3,0,0,2,0,0
5609,775862,21,4,11,4,11,0,0,2,3,5,0,0,4,2,1,1,10
5609,791301,8,0,1,0,1,0,0,0,0,0,0,0,1,0,2,0,0
5609,796601,24,5,14,2,7,3,7,1,2,2,2,0,1,1,2,0,14
5609,796603,5,0,1,0,1,0,0,0,0,0,0,0,0,0,0,0,0
5609,796602,8,2,3,2,3,0,0,0,0,2,0,0,1,0,1,0,4
5609,796604,2,0,0,0,0,0,0,0,0,0,0,0,0,0,0,0,0
5609,791304,2,0,0,0,0,0,0,0,0,0,0,0,0,0,0,0,0
5610,791923,24,3,9,3,9,0,0,1,2,3,2,0,3,0,2,1,7
5610,781122,26,7,10,7,10,0,0,2,3,3,8,0,3,0,3,1,16
5610,791925,34,10,18,9,13,1,5,0,2,0,5,2,2,0,1,1,21
5610,786527,22,1,4,0,1,1,3,0,0,2,0,0,3,1,0,0,3
5610,781112,17,3,3,3,3,0,0,0,2,0,0,4,0,0,3,0,6
5610,791922,0,0,0,0,0,0,0,0,0,0,0,0,0,0,1,0,0
5610,786529,4,0,0,0,0,0,0,0,0,0,0,0,0,0,0,0,0
5610,797541,16,2,3,2,3,0,0,0,0,1,2,1,0,0,1,1,4
5610,797542,23,5,9,4,7,1,2,5,6,2,2,1,0,0,3,0,16
5610,791927,13,0,5,0,3,0,2,0,0,1,1,0,4,1,3,0,0
5610,786858,21,2,3,2,2,0,1,4,4,0,3,4,2,1,2,0,8
5611,786460,21,5,10,5,10,0,0,2,3,1,0,0,3,0,5,0,12
5611,791766,27,3,6,3,4,0,2,2,2,3,0,0,3,2,1,0,8
5611,780604,30,2,6,2,5,0,1,2,2,0,4,2,5,2,4,0,6
5611,780603,27,2,5,1,1,1,4,0,0,0,2,5,1,0,3,0,5
5611,780602,35,8,21,8,19,0,2,1,3,2,7,2,3,2,1,1,17
5611,786071,19,3,3,3,3,0,0,2,3,0,4,1,2,1,0,3,8
5611,791767,13,2,3,2,2,0,1,1,2,2,2,1,2,1,3,0,5
5611,786230,28,4,7,0,2,4,5,0,0,1,0,4,3,2,2,0,12
5612,797601,39,9,18,4,6,5,12,1,4,0,3,6,1,2,2,0,24
5612,775563,28,5,11,4,9,1,2,5,8,4,4,0,2,3,3,0,16
5612,781012,35,4,10,0,4,4,6,3,4,2,1,3,1,3,2,0,15
5612,781011,33,4,6,4,6,0,0,0,0,3,6,0,4,2,4,3,8
5612,775119,13,1,3,1,2,0,1,1,2,0,0,3,2,1,3,0,3
5612,797604,29,2,6,1,2,1,4,1,2,1,4,0,1,2,0,0,6
5612,775806,11,1,2,1,2,0,0,0,0,0,1,0,0,0,0,0,2
5612,775188,3,1,1,1,1,0,0,0,0,0,1,0,0,0,0,0,2
5612,786466,5,0,1,0,0,0,1,0,0,0,0,0,0,0,0,0,0
5612,797602,4,0,1,0,0,0,1,0,0,0,0,0,0,0,0,0,0
5613,791608,37,6,11,3,3,3,8,2,3,0,3,2,2,2,4,0,17
5613,780471,37,7,14,7,14,0,0,1,2,5,10,4,2,1,4,0,15
5613,776011,29,5,10,4,9,1,1,1,2,2,0,6,4,1,2,0,12
5613,796996,15,2,3,2,3,0,0,0,1,0,2,0,3,0,3,0,4
5613,791613,6,1,1,1,1,0,0,0,0,0,0,1,2,0,0,0,2
5613,792071,25,4,8,2,3,2,5,0,0,0,3,2,1,2,2,0,10
5613,785680,34,2,9,0,3,2,6,1,2,1,3,0,3,1,2,0,7
5613,796994,17,1,5,1,3,0,2,0,0,0,2,5,1,0,1,0,2
5614,785409,19,1,3,1,3,0,0,2,2,1,2,1,4,1,1,3,4
5614,785408,36,5,9,4,8,1,1,6,7,2,2,0,1,3,3,1,17
5614,780539,19,1,2,0,1,1,1,0,0,0,0,1,3,2,0,0,3
5614,780560,25,2,8,2,6,0,2,0,0,0,0,2,2,1,3,0,4
5614,776484,29,7,10,4,6,3,4,3,4,2,6,2,1,0,5,0,20
5614,785407,26,3,6,3,4,0,2,2,2,1,5,0,2,1,1,2,8
5614,796416,20,0,4,0,3,0,1,5,8,0,2,4,2,1,2,0,5
5614,796415,18,3,6,1,3,2,3,1,2,0,3,2,0,0,1,2,9
5614,790861,8,1,1,1,1,0,0,0,2,0,1,0,0,1,1,0,2
5615,790899,25,3,7,3,7,0,0,5,7,2,2,0,1,1,0,0,11
5615,790897,34,4,12,2,4,2,8,3,4,1,6,0,3,0,4,0,13
5615,785442,25,1,6,1,4,0,2,2,2,3,1,1,4,0,2,1,4
5615,785579,32,9,14,5,7,4,7,0,0,0,2,1,0,2,4,0,22
5615,775737,12,1,2,1,1,0,1,0,0,0,1,2,2,2,2,1,2
5615,796447,11,2,3,2,3,0,0,1,2,2,1,0,4,0,0,2,5
5615,799907,13,0,2,0,2,0,0,0,0,0,2,0,0,0,4,0,0
5615,790898,24,3,5,1,2,2,3,0,0,0,0,3,2,0,1,0,8
5615,785448,7,0,4,0,2,0,2,0,0,0,0,1,0,2,0,0,0
5615,775959,17,1,3,1,2,0,1,0,0,2,4,0,5,0,1,1,2
5616,785536,29,4,8,4,6,0,2,0,0,2,5,1,3,0,1,5,8
5616,780119,30,4,8,3,7,1,1,1,1,1,5,2,1,0,1,0,10
5616,796559,19,1,3,1,2,0,1,3,5,1,0,2,3,0,3,1,5
5616,785280,24,3,7,2,4,1,3,2,2,0,0,0,2,1,0,0,9
5616,776097,37,3,7,1,3,2,4,1,3,1,1,3,3,2,3,0,9
5616,796560,7,0,0,0,0,0,0,0,0,0,3,1,3,0,0,0,0
5616,775679,4,0,1,0,1,0,0,0,0,0,0,0,0,0,0,0,0
5616,796558,25,7,9,7,9,0,0,0,1,2,4,1,1,2,3,0,14
5616,780149,25,4,11,1,5,3,6,8,9,0,5,2,0,1,1,0,19
5617,786447,24,2,7,2,7,0,0,1,2,1,2,0,4,0,1,0,5
5617,775074,29,1,5,1,5,0,0,1,1,3,5,1,3,1,0,1,3
5617,786448,24,4,6,4,5,0,1,2,2,2,1,2,2,2,2,0,10
5617,780731,34,5,12,5,8,0,4,1,2,0,1,1,3,1,1,0,11
5617,780462,29,9,12,9,9,0,3,1,2,0,3,1,3,1,1,0,19
5617,791632,8,1,2,1,1,0,1,0,0,1,0,0,1,0,0,1,2
5617,786132,7,0,1,0,0,0,1,2,2,0,2,1,0,2,0,0,2
5617,776365,10,1,3,1,1,0,2,0,0,0,1,0,1,0,0,2,2
5617,796971,18,1,4,0,2,1,2,0,0,0,1,2,0,0,2,1,3
5617,791631,9,0,3,0,2,0,1,0,0,0,2,1,0,0,0,0,0
5617,775121,8,1,2,1,1,0,1,0,1,0,0,0,2,1,2,1,2
5618,792050,35,5,8,2,4,3,4,4,4,3,8,2,3,1,1,0,17
5618,775601,27,3,9,1,4,2,5,7,8,0,2,1,3,0,3,0,15
5618,785347,37,5,15,4,8,1,7,2,3,0,2,3,1,3,2,0,13
5618,786338,40,3,9,2,5,1,4,3,6,1,4,2,2,4,3,0,10
5618,791512,15,1,4,1,4,0,0,2,2,3,1,0,1,0,1,0,4
5618,792051,13,3,7,3,5,0,2,0,0,2,1,2,1,0,0,0,6
5618,792047,25,2,4,2,4,0,0,0,2,4,6,2,3,0,2,1,4
5618,797647,3,0,0,0,0,0,0,0,0,0,0,0,0,0,0,0,0
5618,780862,3,0,1,0,0,0,1,0,0,0,0,0,0,0,0,0,0
5618,797648,2,0,0,0,0,0,0,0,0,0,1,0,1,0,1,0,0
5619,780313,35,3,10,2,5,1,5,6,8,0,5,6,2,0,3,2,13
5619,791069,28,3,8,1,3,2,5,2,3,0,1,1,5,0,2,0,10
5619,780758,25,3,3,3,3,0,0,0,0,2,8,1,3,0,0,0,6
5619,785561,22,2,7,2,6,0,1,0,3,1,2,3,4,2,5,0,4
5619,775489,22,2,5,2,4,0,1,0,0,1,6,1,2,0,4,0,4
5619,785560,27,3,9,1,4,2,5,0,0,1,2,4,4,0,0,1,8
5619,785563,22,3,3,3,3,0,0,0,0,0,2,0,3,0,4,0,6
5619,791088,16,3,6,3,4,0,2,0,0,0,0,1,0,0,1,0,6
5619,796751,3,0,0,0,0,0,0,0,0,0,0,0,0,0,0,0,0
5620,780919,27,4,8,4,8,0,0,6,6,1,4,2,1,1,2,0,14
5620,775640,14,1,1,0,0,1,1,1,2,0,2,1,2,0,1,1,4
5620,785803,26,1,4,1,3,0,1,0,0,0,3,1,3,2,3,0,2
5620,780920,35,2,7,1,5,1,2,11,11,1,1,7,1,1,2,0,16
5620,780914,33,2,7,0,2,2,5,0,0,0,2,1,2,0,1,1,6
5620,775816,26,6,9,3,4,3,5,0,1,1,4,0,0,1,0,0,15
5620,791141,10,1,2,0,1,1,1,0,0,0,0,1,0,1,0,1,3
5620,791142,16,1,3,0,2,1,1,0,0,0,1,3,3,2,0,0,3
5620,796797,10,2,3,1,2,1,1,2,3,1,2,0,2,0,1,2,7
5620,796799,3,0,0,0,0,0,0,0,0,0,0,0,0,0,1,0,0
5621,797823,21,1,5,1,2,0,3,0,0,1,2,1,4,1,1,0,2
5621,792286,1,0,0,0,0,0,0,0,0,0,0,0,1,0,0,0,0
5621,797829,28,3,10,3,10,0,0,6,8,3,5,0,5,0,1,2,12
5621,792283,24,1,3,1,2,0,1,0,0,2,0,1,3,0,1,0,2
5621,797831,21,0,2,0,1,0,1,0,0,1,1,1,0,0,2,1,0
5621,792280,32,6,12,3,5,3,7,0,0,0,1,2,2,1,4,1,15
5621,792284,31,4,7,3,5,1,2,0,0,0,2,2,3,1,3,0,9
5621,785950,16,2,4,1,1,1,3,0,0,0,1,0,1,1,0,1,5
5621,785701,1,0,0,0,0,0,0,0,0,0,0,0,1,0,0,0,0
5621,797826,23,5,9,3,6,2,3,1,1,0,5,0,1,1,2,0,13
5621,799468,2,0,0,0,0,0,0,0,0,0,0,0,0,0,0,0,0
5622,785224,24,4,9,2,2,2,7,0,0,0,4,0,3,0,0,2,10
5622,780879,34,6,12,5,8,1,4,3,3,5,4,4,2,0,1,1,16
5622,790768,30,5,11,1,3,4,8,1,2,0,1,3,2,1,0,0,15
5622,785226,22,1,3,1,1,0,2,0,0,0,3,2,1,0,4,0,2
5622,780875,36,2,5,2,3,0,2,2,4,0,7,2,3,0,2,0,6
5622,785743,10,0,4,0,0,0,4,0,0,0,0,0,0,0,1,0,0
5622,775785,16,1,3,1,1,0,2,2,2,1,3,0,1,0,1,0,4
5622,796326,6,0,0,0,0,0,0,0,0,0,2,0,0,0,0,1,0
5622,790769,10,0,3,0,0,0,3,0,0,0,2,1,1,1,1,0,0
5622,790767,12,0,3,0,0,0,3,1,2,0,3,0,2,1,1,0,1
5623,791531,14,2,4,1,1,1,3,0,2,1,1,0,2,0,0,0,5
5623,791534,32,2,7,2,6,0,1,3,5,4,8,0,1,3,0,0,7
5623,797127,24,2,8,2,6,0,2,0,1,3,1,1,3,0,0,0,4
5623,791528,34,2,8,2,5,0,3,0,0,1,3,0,3,2,5,0,4
5623,775045,37,4,14,3,8,1,6,2,2,0,5,3,2,2,3,0,11
5623,791533,25,3,5,3,3,0,2,1,2,2,8,1,1,0,0,0,7
5623,774880,17,1,4,0,2,1,2,0,0,1,1,0,1,0,0,0,3
5623,791529,8,1,4,0,0,1,4,0,0,0,1,2,1,0,0,0,3
5623,797124,9,1,3,0,2,1,1,3,4,0,0,0,1,0,0,0,6
5624,790869,36,8,21,7,17,1,4,6,6,2,9,3,2,0,4,0,23
5624,790870,34,4,13,4,13,0,0,12,14,7,7,4,4,1,1,0,20
5624,780493,39,2,8,0,0,2,8,4,5,0,3,0,1,3,0,0,10
5624,780116,18,2,4,1,2,1,2,5,6,0,0,0,2,0,1,0,10
5624,790866,13,0,2,0,0,0,2,0,0,0,1,0,0,0,0,1,0
5624,796421,31,2,4,1,3,1,1,0,0,0,2,0,4,2,1,1,5
5624,796427,26,1,3,1,2,0,1,1,1,0,0,0,2,1,1,0,3
5624,796426,3,1,1,1,1,0,0,0,0,0,0,0,0,0,1,0,2
5625,785863,40,10,15,10,15,0,0,4,5,3,4,3,2,1,2,0,24
5625,780777,35,9,16,9,14,0,2,0,1,1,2,1,2,1,4,0,18
5625,785630,31,4,14,1,6,3,8,0,0,1,1,2,1,0,0,0,11
5625,785631,30,3,7,2,4,1,3,3,3,0,4,1,3,1,2,1,10
5625,786248,22,2,5,2,5,0,0,0,0,3,11,1,4,0,1,0,4
5625,785632,10,2,2,2,2,0,0,0,0,2,1,0,3,0,1,0,4
5625,791200,15,1,6,1,4,0,2,1,2,0,2,2,1,0,0,0,3
5625,791197,12,1,1,1,1,0,0,0,0,0,1,0,4,0,0,0,2
5625,791199,4,0,1,0,1,0,0,2,2,2,0,0,2,0,0,0,2
5625,791198,1,0,0,0,0,0,0,0,0,0,0,0,0,0,0,0,0
5634,797241,21,2,3,2,3,0,0,0,3,2,4,1,3,2,1,0,4
5634,791366,19,1,6,1,3,0,3,0,1,3,3,3,2,0,2,1,2
5634,797244,30,3,5,3,4,0,1,5,6,0,3,0,1,1,0,0,11
5634,785742,34,6,14,2,4,4,10,3,4,0,0,2,2,0,4,0,19
5634,780163,31,6,14,1,5,5,9,6,8,1,1,1,2,1,5,0,23
5634,791361,19,4,5,4,4,0,1,0,0,3,2,1,4,2,0,2,8
5634,780170,18,2,4,2,4,0,0,2,2,1,7,0,1,1,0,0,6
5634,797245,0,0,0,0,0,0,0,0,0,0,0,0,0,0,0,0,0
5634,797243,11,2,4,2,4,0,0,1,2,2,0,0,0,0,0,0,5
5634,791363,13,0,2,0,1,0,1,0,0,0,4,0,4,0,1,0,0
5634,786340,4,0,0,0,0,0,0,0,0,0,2,2,1,0,0,0,0
5634,797246,0,0,0,0,0,0,0,0,0,0,0,0,0,0,0,0,0
5635,792261,28,4,6,4,6,0,0,1,2,7,4,2,4,1,2,2,9
5635,792258,30,6,11,3,4,3,7,8,8,0,2,2,2,0,3,0,23
5635,786122,24,2,9,2,5,0,4,1,2,1,3,0,3,0,1,0,5
5635,786331,25,0,6,0,5,0,1,4,4,1,2,0,2,1,1,1,4
5635,776284,22,1,9,1,7,0,2,2,2,0,1,1,5,0,4,0,4
5635,797980,13,1,3,1,3,0,0,0,0,1,1,0,0,0,0,0,2
5635,797982,13,1,2,1,1,0,1,0,0,0,2,0,0,0,0,0,2
5635,786845,3,0,0,0,0,0,0,0,0,0,0,0,0,0,0,0,0
5635,786113,23,2,5,2,4,0,1,3,4,1,4,3,1,2,2,0,7
5635,780308,19,2,7,0,4,2,3,1,2,0,2,2,3,1,2,0,7
5636,775556,30,2,11,0,6,2,5,0,3,0,4,5,3,1,1,0,6
5636,780234,33,7,13,7,13,0,0,2,7,4,6,0,3,2,1,3,16
5636,786411,34,5,9,3,4,2,5,5,6,0,3,3,3,1,2,0,17
5636,780046,25,0,6,0,2,0,4,0,0,0,2,4,4,0,3,0,0
5636,781104,33,4,6,1,2,3,4,11,11,0,2,2,3,2,0,0,22
5636,781110,17,0,1,0,1,0,0,0,0,1,4,1,3,0,2,0,0
5636,797185,1,0,0,0,0,0,0,0,0,0,0,0,0,0,1,0,0
5636,786405,27,1,5,1,3,0,2,0,0,2,2,2,1,1,2,0,2
5637,792593,39,8,13,8,13,0,0,4,6,6,6,2,4,1,4,0,20
5637,792594,26,4,8,2,3,2,5,4,4,0,4,2,5,2,3,0,14
5637,792588,29,1,7,0,1,1,6,0,0,0,6,1,4,0,0,0,3
5637,792595,38,3,10,3,10,0,0,7,9,1,2,5,3,0,3,0,13
5637,792583,33,4,10,0,1,4,9,0,0,0,4,0,1,1,2,0,12
5637,796989,1,0,0,0,0,0,0,0,0,0,0,0,0,0,0,0,0
5637,796987,9,2,3,2,2,0,1,1,2,1,3,1,1,0,0,0,5
5637,792591,25,0,1,0,0,0,1,1,2,1,3,2,1,0,2,0,1
5638,780122,11,2,3,2,2,0,1,0,0,1,1,0,3,0,0,1,4
5638,797215,31,3,9,2,4,1,5,0,0,0,1,2,2,3,4,0,7
5638,791461,31,6,10,4,7,2,3,1,1,2,4,2,0,3,2,0,15
5638,791460,26,2,5,1,4,1,1,1,3,1,1,3,3,0,0,0,6
5638,775598,15,2,8,1,4,1,4,0,0,2,0,1,0,0,1,0,5
5638,786299,23,2,7,2,7,0,0,0,0,2,3,0,4,0,1,0,4
5638,797214,21,1,5,1,4,0,1,2,2,0,1,0,0,0,0,0,4
5638,786295,22,4,6,3,3,1,3,0,0,0,2,0,4,1,3,0,9
5638,780792,20,1,7,1,4,0,3,4,4,0,2,2,1,2,3,0,6
5639,781407,23,2,3,2,3,0,0,4,6,0,5,0,1,0,2,2,8
5639,791583,33,5,8,5,8,0,0,1,2,1,3,1,1,0,1,2,11
5639,786110,23,1,4,1,1,0,3,0,0,0,1,0,3,1,3,0,2
5639,780580,32,4,8,2,5,2,3,4,4,0,0,6,0,0,3,0,14
5639,776150,37,7,11,2,5,5,6,6,7,0,5,3,2,2,3,0,25
5639,797448,18,2,3,1,2,1,1,0,0,1,3,1,1,0,0,2,5
5639,786608,2,1,2,1,2,0,0,1,2,0,0,0,0,0,0,0,3
5639,797445,18,0,0,0,0,0,0,3,4,0,4,0,3,2,2,0,3
5639,785623,10,1,2,1,1,0,1,0,0,0,3,0,0,0,2,0,2
5639,786659,4,0,0,0,0,0,0,0,0,0,1,1,0,0,2,0,0
5640,791276,31,3,6,3,6,0,0,4,6,2,8,1,4,0,3,1,10
5640,796529,33,0,8,0,3,0,5,2,2,0,2,3,1,2,0,0,2
5640,791275,23,2,6,1,1,1,5,0,0,0,2,2,3,2,1,0,5
5640,785746,32,6,11,2,4,4,7,3,4,0,1,2,4,1,1,0,19
5640,785741,36,3,8,1,4,2,4,0,0,0,5,3,2,1,2,1,8
5640,785755,12,1,1,1,1,0,0,1,2,0,2,0,2,0,1,0,3
5640,796526,9,0,3,0,1,0,2,2,2,1,0,0,0,1,1,0,2
5640,796527,2,0,0,0,0,0,0,0,0,1,1,0,0,0,1,0,0
5640,785748,22,2,6,0,0,2,6,7,8,0,0,1,1,0,3,0,13
5641,796912,32,8,15,1,4,7,11,0,1,1,1,3,3,0,1,1,23
5641,775626,26,7,8,5,5,2,3,3,3,2,10,2,0,2,1,1,19
5641,774964,26,5,9,4,8,1,1,2,3,3,8,6,3,2,1,0,13
5641,796908,27,2,6,0,0,2,6,0,0,2,4,1,1,1,0,0,6
5641,774962,22,3,7,3,3,0,4,2,2,0,1,7,3,1,4,0,8
5641,796910,14,2,5,2,5,0,0,0,1,1,2,1,5,0,1,1,4
5641,785609,10,0,2,0,1,0,1,0,2,0,2,0,2,0,1,0,0
5641,796909,1,0,1,0,0,0,1,0,0,0,0,0,0,0,0,0,0
5641,796907,14,1,1,1,1,0,0,0,0,1,1,1,2,2,2,0,2
5641,796911,5,0,1,0,0,0,1,0,0,0,0,0,0,0,0,0,0
5641,796906,21,4,7,2,2,2,5,1,1,0,0,4,0,1,2,0,11
5641,780619,2,0,2,0,1,0,1,0,0,0,0,0,1,0,0,0,0
5642,790794,21,0,1,0,1,0,0,0,0,1,2,0,4,0,2,1,0
5642,785368,21,6,8,6,8,0,0,1,2,2,3,1,3,0,1,1,13
5642,790793,23,4,10,1,5,3,5,4,4,1,3,2,2,0,1,1,15
5642,785246,34,4,12,1,5,3,7,1,2,1,4,1,1,1,2,0,12
5642,780886,33,3,6,1,1,2,5,4,4,0,2,6,2,0,3,1,12
5642,780281,7,2,3,1,1,1,2,0,0,0,2,1,2,0,1,1,5
5642,790789,11,0,1,0,1,0,0,2,2,0,0,1,1,0,1,0,2
5642,790792,28,5,8,5,6,0,2,0,2,0,1,4,2,4,1,0,10
5642,796351,11,2,2,2,2,0,0,0,0,2,1,0,4,2,2,0,4
5642,796350,6,2,3,1,1,1,2,0,0,1,1,0,1,0,1,0,5
5642,790790,5,0,0,0,0,0,0,0,0,0,0,0,0,0,0,0,0
5643,781605,14,1,1,1,1,0,0,2,2,0,1,0,1,0,1,0,4
5643,792306,34,6,10,5,9,1,1,5,6,4,5,0,3,0,2,2,18
5643,797914,12,0,2,0,0,0,2,0,0,0,0,0,5,0,0,0,0
5643,792300,25,3,8,2,6,1,2,0,0,3,2,2,2,3,2,0,7
5643,792303,38,12,22,8,15,4,7,4,6,2,3,6,2,1,6,0,32
5643,781603,27,2,6,0,2,2,4,0,2,1,1,2,1,1,0,0,6
5643,797912,14,0,3,0,0,0,3,2,2,1,2,0,1,0,3,0,2
5643,776424,16,0,1,0,0,0,1,0,0,0,2,0,2,1,0,0,0
5643,780456,15,1,5,1,3,0,2,0,0,2,0,0,0,1,3,0,2
5643,797907,5,0,0,0,0,0,0,0,0,0,2,1,0,0,0,0,0
5644,785423,37,3,4,3,4,0,0,1,3,2,8,0,4,0,5,2,7
5644,775676,11,1,4,1,4,0,0,1,2,0,4,0,3,1,1,2,3
5644,786210,35,3,9,3,5,0,4,1,2,0,3,2,1,0,1,0,7
5644,785425,37,3,13,3,9,0,4,2,2,0,5,2,1,1,0,0,8
5644,785422,35,8,20,5,12,3,8,3,5,1,3,3,2,0,4,1,22
5644,774957,25,1,2,1,1,0,1,0,0,0,6,0,2,1,1,2,2
5644,793801,6,0,2,0,1,0,1,0,0,0,1,0,0,0,0,0,0
5644,796429,10,1,2,1,2,0,0,0,0,1,1,0,0,1,0,0,2
5644,796431,4,0,0,0,0,0,0,0,0,0,1,1,2,0,0,0,0
5645,781342,31,5,10,5,9,0,1,4,4,3,9,0,3,1,2,3,14
5645,781593,34,7,14,7,13,0,1,0,2,0,11,3,3,0,0,3,14
5645,790901,32,7,14,6,11,1,3,0,0,0,9,5,3,0,3,0,15
5645,790903,23,1,6,0,1,1,5,0,0,1,0,1,2,2,2,1,3
5645,781620,32,1,6,0,0,1,6,0,0,0,3,3,2,2,0,0,3
5645,796450,15,0,0,0,0,0,0,0,4,2,2,0,4,0,1,0,0
5645,790902,24,4,9,0,2,4,7,1,2,0,3,1,0,3,1,0,13
5645,796449,8,0,2,0,1,0,1,0,0,0,1,0,0,0,1,0,0
5645,796452,1,0,1,0,0,0,1,0,0,0,0,0,0,0,0,0,0
5645,790904,0,0,0,0,0,0,0,0,0,0,0,0,0,0,0,0,0
5646,785384,19,1,5,1,4,0,1,1,2,4,1,1,4,1,0,0,3
5646,780025,39,4,7,4,7,0,0,1,1,3,4,1,3,0,1,2,9
5646,796391,42,2,9,1,5,1,4,3,6,0,6,0,1,1,1,0,8
5646,785385,34,2,10,0,2,2,8,7,7,1,3,1,0,1,0,0,13
5646,785383,43,10,22,6,14,4,8,7,10,0,6,6,3,3,4,0,31
5646,790837,16,1,3,1,1,0,2,2,2,1,0,1,2,0,0,1,4
5646,786297,6,0,1,0,1,0,0,0,0,0,2,0,1,0,0,0,0
5646,785382,3,0,1,0,0,0,1,0,0,0,0,0,0,0,0,0,0
5646,781046,21,2,4,2,4,0,0,0,0,2,3,0,0,3,1,1,4
5646,792180,2,0,1,0,1,0,0,0,0,0,0,0,1,0,0,0,0
5647,797050,27,2,7,2,4,0,3,1,3,1,2,1,3,0,3,1,5
5647,780394,20,0,0,0,0,0,0,2,2,0,3,0,1,0,1,0,2
5647,780391,27,4,7,4,7,0,0,1,2,0,7,2,3,0,2,1,9
5647,790871,33,5,10,5,6,0,4,2,3,0,1,6,4,1,3,0,12
5647,776473,34,4,9,3,6,1,3,4,5,0,6,3,5,1,4,1,13
5647,797048,35,6,10,6,10,0,0,0,0,1,7,0,2,0,0,1,12
5647,791570,7,0,2,0,1,0,1,0,0,0,2,0,0,0,0,0,0
5647,791573,15,1,3,1,1,0,2,0,0,0,3,0,3,1,1,0,2
5647,780392,27,3,5,1,2,2,3,0,0,0,0,0,2,0,1,0,8
5648,790873,29,6,9,6,8,0,1,10,10,0,7,0,3,0,3,1,22
5648,785429,22,3,6,0,0,3,6,0,0,1,0,1,0,0,1,0,9
5648,780054,31,5,7,5,7,0,0,3,3,2,8,1,2,5,3,2,13
5648,781140,27,3,3,2,2,1,1,3,3,2,3,0,5,0,1,0,10
5648,786851,33,2,11,0,2,2,9,2,2,0,3,6,2,1,4,0,8
5648,796433,9,5,5,5,5,0,0,1,1,2,0,0,1,0,0,1,11
5648,776357,25,2,8,1,5,1,3,1,1,1,2,3,5,0,3,0,6
5648,796432,5,1,1,1,1,0,0,0,0,1,0,0,0,0,0,0,2
5648,776245,11,0,2,0,1,0,1,0,0,0,1,0,2,0,0,0,0
5648,799973,4,1,2,1,1,0,1,0,1,0,0,0,0,0,1,0,2
5648,781139,4,0,0,0,0,0,0,0,0,0,0,0,0,0,0,0,0
5649,792005,37,7,16,3,8,4,8,8,10,1,3,0,3,0,3,0,26
5649,781175,32,4,10,4,10,0,0,7,7,6,4,1,3,1,1,0,15
5649,786553,27,4,9,2,5,2,4,0,0,0,0,3,2,1,1,0,10
5649,780895,33,7,15,6,13,1,2,3,5,0,3,2,4,1,3,0,18
5649,781172,30,2,4,2,3,0,1,0,2,2,2,3,0,2,0,0,4
5649,781177,14,0,1,0,1,0,0,0,0,0,0,0,4,1,1,0,0
5649,786555,24,2,4,0,0,2,4,0,0,0,3,0,3,0,1,0,6
5649,797503,1,0,0,0,0,0,0,0,0,0,0,0,0,0,1,0,0
5649,786557,2,0,0,0,0,0,0,0,0,0,0,0,0,0,0,0,0
5650,790846,25,3,7,3,6,0,1,1,2,1,2,1,2,1,2,0,7
5650,796754,25,2,7,2,5,0,2,0,0,2,0,1,1,3,5,0,4
5650,791099,33,6,12,2,3,4,9,2,3,0,6,3,2,2,0,0,18
5650,785470,33,3,7,0,2,3,5,3,4,0,5,3,0,1,0,0,12
5650,780298,31,4,11,2,6,2,5,3,5,1,5,3,4,2,3,0,13
5650,796755,11,3,5,3,5,0,0,3,4,1,3,0,2,0,1,0,9
5650,785586,22,1,1,1,1,0,0,0,0,1,1,0,2,0,2,0,2
5650,780315,20,1,1,0,0,1,1,3,4,1,1,1,2,0,1,0,6
5651,785589,39,10,18,10,18,0,0,3,5,3,7,1,0,1,0,0,23
5651,791216,32,2,6,2,4,0,2,2,6,2,3,2,0,1,3,0,6
5651,791215,29,7,13,4,7,3,6,1,2,3,1,3,3,0,4,0,18
5651,791214,34,1,5,0,1,1,4,2,4,2,0,4,4,1,2,0,5
5651,776313,33,3,7,3,6,0,1,0,0,0,4,1,3,2,1,1,6
5651,791213,22,3,10,3,3,0,7,0,0,1,3,0,4,1,1,1,6
5651,791209,7,0,0,0,0,0,0,0,0,0,2,0,1,0,0,1,0
5651,796917,4,0,1,0,1,0,0,0,0,0,0,0,0,0,0,0,0
5652,797111,30,4,9,3,7,1,2,0,0,4,3,0,1,0,2,0,9
5652,797110,23,2,7,1,1,1,6,0,0,0,3,0,1,0,0,0,5
5652,791407,26,5,13,4,9,1,4,3,4,1,2,1,3,0,3,0,14
5652,785928,35,3,10,1,4,2,6,2,3,2,1,0,2,1,3,0,10
5652,785923,33,5,8,5,8,0,0,0,0,2,6,4,2,1,2,1,10
5652,797113,8,0,1,0,1,0,0,0,0,0,2,0,1,0,2,0,0
5652,797109,1,0,0,0,0,0,0,0,0,0,1,0,0,0,0,0,0
5652,800038,1,1,1,1,1,0,0,0,0,0,0,0,0,0,0,0,2
5652,797114,14,1,3,1,2,0,1,2,2,0,0,1,2,1,1,0,4
5652,791404,29,1,5,1,3,0,2,1,3,0,3,3,4,0,2,0,3
5653,791440,14,1,2,1,2,0,0,6,8,2,3,0,4,0,3,0,8
5653,797019,29,4,6,4,6,0,0,1,2,0,1,4,2,1,1,0,9
5653,797016,32,3,9,1,2,2,7,2,2,0,2,4,2,2,2,0,10
5653,781378,31,6,12,6,8,0,4,2,2,4,3,4,2,1,2,0,14
5653,775267,28,3,8,2,2,1,6,0,0,0,3,0,2,0,0,1,7
5653,791443,3,2,2,2,2,0,0,0,1,0,0,0,0,0,0,0,4
5653,781629,7,0,2,0,2,0,0,0,0,2,0,0,2,0,1,0,0
5653,775739,3,0,0,0,0,0,0,0,0,0,1,0,1,0,0,0,0
5653,791441,11,0,3,0,1,0,2,2,2,0,1,1,3,1,3,0,2
5653,774959,19,0,1,0,0,0,1,0,0,0,5,0,0,0,1,0,0
5653,797015,23,7,11,6,9,1,2,4,4,1,8,0,1,1,1,2,19
5654,797861,25,3,5,3,5,0,0,3,6,3,8,0,4,0,2,0,9
5654,792208,29,3,6,3,6,0,0,1,3,0,4,3,2,1,4,0,7
5654,786262,39,2,6,0,0,2,6,0,0,0,3,2,2,0,2,0,6
5654,781317,17,2,3,0,1,2,2,0,0,0,0,2,0,1,1,0,6
5654,781314,32,6,13,4,8,2,5,2,2,1,5,3,3,0,2,0,16
5654,776018,15,1,4,1,4,0,0,0,1,0,3,2,2,0,1,1,2
5654,797859,31,7,13,5,9,2,4,6,6,3,2,0,3,1,1,0,22
5654,797856,10,1,2,1,2,0,0,0,0,1,0,1,1,0,2,0,2
5654,797858,1,0,0,0,0,0,0,0,0,0,0,0,0,0,0,0,0
5654,786682,1,0,0,0,0,0,0,0,0,0,0,0,0,0,0,0,0
5655,797367,27,6,7,6,7,0,0,0,0,2,3,3,4,2,0,1,12
5655,797369,33,2,3,0,0,2,3,0,0,1,4,4,1,2,1,1,6
5655,797366,23,0,1,0,1,0,0,0,0,1,2,1,1,0,1,0,0
5655,791807,40,7,13,3,4,4,9,3,3,0,5,3,1,0,3,1,21
5655,786130,35,6,24,5,14,1,10,5,6,1,6,2,2,1,3,0,18
5655,797371,5,0,2,0,2,0,0,0,0,1,1,0,2,0,0,0,0
5655,797368,1,1,1,1,1,0,0,0,0,1,0,0,0,0,0,0,2
5655,797364,6,1,2,1,2,0,0,0,0,1,1,0,3,0,1,0,2
5655,797365,12,2,4,1,1,1,3,0,0,0,0,0,1,1,0,0,5
5655,797363,16,2,5,1,3,1,2,4,4,0,0,2,1,0,0,0,9
5655,791808,2,0,0,0,0,0,0,0,0,0,0,0,1,0,0,0,0
5656,774936,20,7,13,7,12,0,1,6,8,2,2,2,1,0,0,2,20
5656,790933,30,4,7,3,3,1,4,3,3,1,4,0,5,1,0,1,12
5656,781345,36,3,8,2,3,1,5,4,4,2,3,5,0,0,2,1,11
5656,786805,26,4,13,4,12,0,1,2,4,5,1,0,2,1,4,0,10
5656,786803,23,1,6,1,4,0,2,0,0,0,1,2,3,3,1,0,2
5656,780033,16,4,5,1,1,3,4,3,4,1,1,0,4,0,1,0,14
5656,786804,17,2,7,1,2,1,5,6,6,1,5,0,0,1,0,0,11
5656,790934,15,0,2,0,1,0,1,0,0,0,4,1,3,1,1,1,0
5656,796490,1,1,1,1,1,0,0,0,0,0,0,0,1,0,0,0,2
5656,796487,12,0,0,0,0,0,0,0,0,0,3,2,0,0,2,0,0
5656,796488,2,0,0,0,0,0,0,0,0,0,0,0,0,0,0,0,0
5656,796489,1,0,0,0,0,0,0,0,0,0,0,0,0,0,0,0,0
5656,780030,1,0,1,0,0,0,1,0,0,0,0,0,0,0,0,0,0
5657,792154,33,4,13,3,12,1,1,4,4,3,12,1,1,2,2,0,13
5657,792152,33,6,10,6,9,0,1,0,0,1,1,0,0,3,3,0,12
5657,792158,19,5,8,4,7,1,1,1,1,3,1,0,4,0,4,0,12
5657,780138,27,4,8,4,8,0,0,3,7,4,3,1,4,1,0,0,11
5657,780581,27,2,8,2,6,0,2,2,2,0,2,7,3,2,2,1,6
5657,786014,21,0,1,0,0,0,1,3,7,0,3,0,1,0,3,0,3
5657,792157,11,1,2,1,2,0,0,1,2,0,0,0,4,0,0,0,3
5657,797756,11,1,3,1,1,0,2,0,1,0,1,0,0,0,2,0,2
5657,797755,10,0,0,0,0,0,0,0,0,0,3,1,5,0,3,4,0
5657,792162,7,0,1,0,1,0,0,0,1,2,2,0,3,0,3,0,0
5657,797759,1,0,0,0,0,0,0,0,0,0,0,0,0,0,0,0,0
5658,785298,21,1,2,1,2,0,0,2,2,3,3,0,1,0,0,3,4
5658,775224,24,4,6,4,5,0,1,0,0,1,4,1,1,3,1,1,8
5658,778046,25,5,9,4,5,1,4,2,2,2,5,5,1,3,3,0,13
5658,782121,28,12,16,5,7,7,9,0,0,0,2,5,2,3,2,0,31
5658,775793,23,6,11,2,5,4,6,2,2,0,6,5,2,1,1,0,18
5658,785485,14,3,4,3,4,0,0,1,2,2,1,1,4,0,1,0,7
5658,786594,14,2,5,1,3,1,2,0,0,0,1,1,1,1,1,0,5
5658,785302,15,4,7,2,4,2,3,0,1,1,2,2,4,2,1,0,10
5658,796598,17,1,3,0,1,1,2,0,0,0,1,2,0,1,1,0,3
5658,790987,8,0,3,0,3,0,0,0,0,1,2,0,2,0,1,0,0
5658,796599,5,2,3,1,2,1,1,1,2,2,0,1,1,0,0,0,6
5658,785301,3,0,1,0,1,0,0,0,0,0,0,0,0,0,1,0,0
5658,778469,3,1,1,1,1,0,0,0,0,1,1,0,1,0,0,0,2
5659,796372,13,3,6,3,6,0,0,1,2,1,2,0,2,1,1,0,7
5659,786013,22,0,1,0,1,0,0,0,0,1,0,0,2,2,0,0,0
5659,796379,32,3,10,2,4,1,6,4,4,1,4,5,2,0,1,0,11
5659,790815,14,1,5,1,3,0,2,0,0,0,0,0,2,0,3,0,2
5659,780176,21,2,9,1,4,1,5,0,0,0,1,3,3,0,2,0,5
5659,790814,15,2,4,0,1,2,3,2,2,0,0,0,0,1,3,0,8
5659,796378,8,0,0,0,0,0,0,1,1,0,1,1,4,0,2,0,1
5659,796377,27,2,5,2,4,0,1,4,4,1,4,0,1,1,6,0,8
5659,796374,24,1,3,0,0,1,3,5,6,0,4,1,0,2,1,0,8
5659,796376,8,0,3,0,3,0,0,0,0,0,1,0,0,0,0,0,0
5659,796375,13,4,5,4,5,0,0,1,5,1,0,0,0,1,1,0,9
5659,790817,3,0,1,0,0,0,1,0,0,0,1,0,0,0,0,0,0
5660,791194,20,0,5,0,3,0,2,1,2,2,3,0,2,1,3,0,1
5660,780384,31,7,13,7,13,0,0,2,4,10,6,0,3,1,3,2,16
5660,780159,28,2,9,2,6,0,3,3,3,2,5,1,2,1,0,0,7
5660,786738,36,7,16,7,14,0,2,2,4,4,1,3,4,0,5,0,16
5660,774827,35,8,18,5,13,3,5,2,4,0,3,4,2,2,1,0,21
5660,796863,8,0,0,0,0,0,0,0,0,0,2,0,2,0,4,0,0
5660,791193,7,0,1,0,1,0,0,0,0,0,0,0,0,0,0,0,0
5660,775694,22,1,5,1,2,0,3,0,1,0,5,1,2,0,2,0,2
5660,796865,13,2,3,1,1,1,2,0,0,1,1,0,1,1,0,1,5
5661,786180,10,1,2,1,2,0,0,0,0,3,4,1,4,0,0,2,2
5661,792104,34,6,15,3,10,3,5,1,3,1,5,1,2,0,3,1,16
5661,797709,34,7,16,4,8,3,8,1,2,0,3,1,0,0,1,0,18
5661,797708,33,6,10,5,6,1,4,2,3,3,3,5,2,3,2,0,15
5661,775779,34,1,4,1,3,0,1,5,5,0,4,9,1,1,1,0,7
5661,785608,15,6,7,6,6,0,1,3,3,0,2,0,5,3,2,1,15
5661,786204,15,1,5,1,2,0,3,0,2,1,2,0,3,0,2,0,2
5661,797707,16,2,5,2,2,0,3,2,3,2,1,2,2,0,0,0,6
5661,792106,3,0,1,0,0,0,1,0,0,0,1,1,0,0,0,0,0
5661,776327,6,0,0,0,0,0,0,0,0,0,0,0,2,0,1,0,0
5662,791585,34,5,14,2,5,3,9,0,0,2,6,0,2,0,0,3,13
5662,791581,30,3,6,2,2,1,4,0,0,0,6,2,2,2,1,0,7
5662,786395,35,1,10,1,6,0,4,2,3,1,5,2,2,2,2,0,4
5662,786394,35,6,14,2,6,4,8,2,2,0,2,1,2,1,3,0,18
5662,780404,36,3,6,2,3,1,3,4,4,0,1,5,2,1,2,0,11
5662,780062,10,1,1,1,1,0,0,0,0,0,1,1,3,0,1,0,2
5662,785228,19,0,2,0,0,0,2,0,0,0,2,1,0,0,0,0,0
5662,797041,1,0,0,0,0,0,0,0,0,0,0,0,0,0,0,0,0
5663,776004,23,8,12,4,6,4,6,3,3,4,8,2,2,0,3,0,23
5663,790930,30,2,5,2,4,0,1,0,0,1,4,3,2,2,2,0,4
5663,775011,21,1,4,0,1,1,3,0,0,0,3,0,3,0,2,0,3
5663,780357,30,2,8,0,1,2,7,0,0,0,1,1,2,0,0,0,6
5663,775018,38,4,14,3,11,1,3,4,4,0,8,3,1,0,3,0,13
5663,780358,16,2,3,1,2,1,1,0,0,0,3,0,0,1,1,0,5
5663,796480,25,2,7,2,5,0,2,0,0,2,1,0,3,1,1,2,4
5663,776270,17,1,3,0,0,1,3,0,0,0,1,2,2,0,0,0,3
5664,791145,31,10,16,8,11,2,5,5,8,5,10,1,3,1,3,1,27
5664,791146,39,5,9,5,7,0,2,2,3,0,1,10,2,2,8,0,12
5664,785777,29,4,8,3,5,1,3,2,2,0,3,0,3,1,0,0,11
5664,785782,34,2,6,0,0,2,6,0,0,1,5,1,2,2,1,0,6
5664,791144,20,2,4,2,4,0,0,0,0,2,4,3,2,1,2,0,4
5664,791148,16,3,4,1,2,2,2,3,3,1,2,0,1,1,1,0,11
5664,796804,4,1,1,0,0,1,1,0,0,0,0,0,1,0,2,0,3
5664,791147,15,1,3,1,2,0,1,0,0,0,4,1,3,0,1,1,2
5664,786748,12,1,1,1,1,0,0,0,0,0,1,1,1,0,0,0,2
5665,775255,32,8,16,5,9,3,7,1,2,0,2,1,2,2,3,1,20
5665,781215,35,3,9,1,4,2,5,2,2,0,3,1,1,1,0,0,10
5665,791001,30,3,9,3,6,0,3,2,2,2,2,4,1,3,2,0,8
5665,781159,29,3,8,3,4,0,4,0,0,2,2,0,3,0,4,1,6
5665,781174,29,1,2,1,2,0,0,2,7,1,6,2,3,2,0,0,4
5665,785231,20,3,6,3,4,0,2,2,2,1,1,1,1,2,3,0,8
5665,785320,14,0,3,0,1,0,2,0,0,0,0,1,1,0,0,0,0
5665,779972,10,0,2,0,2,0,0,0,0,1,1,1,0,0,0,0,0
5665,796643,1,0,0,0,0,0,0,0,0,0,0,0,0,0,1,0,0
5666,786164,31,3,5,1,2,2,3,3,4,1,1,2,4,1,2,2,11
5666,785482,32,1,12,1,7,0,5,0,0,1,6,0,3,3,1,0,2
5666,791375,37,2,9,0,1,2,8,2,3,1,4,2,0,0,1,0,8
5666,781560,31,4,5,4,5,0,0,1,2,2,5,1,2,1,5,1,9
5666,780837,34,12,21,7,14,5,7,4,5,0,1,4,3,0,0,0,33
5666,796477,18,2,6,1,1,1,5,0,0,1,1,5,2,0,2,1,5
5666,796479,15,2,2,2,2,0,0,2,2,1,3,1,2,1,0,0,6
5666,796473,2,0,0,0,0,0,0,0,0,0,0,0,0,0,0,0,0
5667,781584,39,5,9,2,4,3,5,2,2,0,2,1,0,0,2,0,15
5667,786731,31,6,16,6,16,0,0,1,3,1,7,3,3,0,2,2,13
5667,798023,38,7,13,6,8,1,5,4,4,2,7,9,2,3,1,0,19
5667,781579,30,5,8,4,5,1,3,2,2,4,5,4,3,2,1,0,13
5667,780347,29,4,9,1,5,3,4,1,4,2,3,2,3,0,4,1,12
5667,775696,12,2,2,1,1,1,1,0,0,0,0,1,1,0,0,0,5
5667,792358,8,1,2,1,2,0,0,1,2,1,0,0,1,0,1,0,3
5667,798008,5,1,2,0,1,1,1,0,0,2,0,1,2,0,0,0,3
5667,776481,7,0,1,0,1,0,0,0,0,1,2,0,0,0,1,0,0
5667,798017,1,0,0,0,0,0,0,0,0,0,0,0,0,0,0,0,0
5672,775556,28,7,15,6,10,1,5,1,2,2,3,6,3,2,3,1,16
5672,780234,28,10,12,10,12,0,0,4,5,3,8,1,3,4,1,1,24
5672,786411,24,4,7,2,4,2,3,1,2,5,2,0,3,0,1,0,11
5672,780046,35,5,13,4,8,1,5,2,2,0,10,2,1,1,4,0,13
5672,781104,29,0,6,0,2,0,4,3,3,1,2,3,0,1,4,0,3
5672,797188,5,0,1,0,1,0,0,0,0,1,0,0,1,0,1,0,0
5672,781110,11,1,3,1,3,0,0,0,2,2,3,2,4,0,0,0,2
5672,786328,4,0,2,0,2,0,0,0,0,0,0,0,0,0,0,0,0
5672,797189,0,0,0,0,0,0,0,0,0,0,0,0,0,0,1,0,0
5672,797185,12,1,3,1,3,0,0,0,4,1,1,1,1,1,0,1,2
5672,792656,1,0,0,0,0,0,0,0,0,0,0,0,0,0,0,0,0
5672,786405,23,3,7,2,4,1,3,0,1,1,1,3,3,0,2,0,7
5673,792593,29,4,11,4,11,0,0,2,5,5,7,0,5,0,3,2,10
5673,792594,26,3,7,2,4,1,3,4,4,0,4,0,1,0,3,0,11
5673,792588,29,1,7,0,1,1,6,0,0,0,2,3,3,0,0,0,3
5673,792595,28,2,3,2,3,0,0,0,1,1,1,0,1,3,4,0,4
5673,792583,24,2,6,0,0,2,6,0,0,1,1,1,0,0,0,0,6
5673,796989,11,0,2,0,1,0,1,0,0,0,1,1,4,0,1,1,0
5673,796988,8,2,3,0,0,2,3,0,0,0,2,1,0,1,1,0,6
5673,796987,21,10,18,10,17,0,1,3,3,0,0,2,0,1,2,0,23
5673,792591,16,0,2,0,0,0,2,0,0,0,1,0,1,0,0,0,0
5673,792592,1,0,0,0,0,0,0,0,0,0,0,0,0,0,0,0,0
5673,792586,7,2,2,1,1,1,1,0,0,0,1,2,0,2,0,0,5
5674,780634,28,6,9,6,9,0,0,1,1,7,7,0,1,1,1,5,13
5674,791826,25,2,4,2,3,0,1,0,1,2,3,1,1,1,2,0,4
5674,786785,30,3,15,3,9,0,6,3,4,2,5,3,1,1,0,1,9
5674,786783,28,3,10,3,7,0,3,2,2,1,2,0,3,3,1,0,8
5674,780633,31,5,9,4,5,1,4,0,0,0,5,5,1,5,1,0,11
5674,776009,22,3,6,1,4,2,2,2,2,0,2,2,1,0,6,0,10
5674,786784,16,3,5,1,2,2,3,0,0,1,0,0,2,2,1,0,8
5674,797389,10,0,0,0,0,0,0,0,0,0,1,0,4,0,0,1,0
5674,797388,2,1,1,1,1,0,0,0,0,0,0,0,0,1,0,0,2
5674,797387,2,0,0,0,0,0,0,2,2,0,1,1,0,0,0,0,2
5674,780637,2,0,1,0,1,0,0,0,0,0,0,0,0,0,0,0,0
5674,798156,2,0,0,0,0,0,0,0,0,0,1,0,0,0,0,0,0
5674,797390,2,0,0,0,0,0,0,0,0,0,0,0,0,0,0,0,0
5675,785374,12,0,2,0,2,0,0,0,0,2,2,0,2,0,0,0,0
5675,785372,34,3,10,3,6,0,4,1,2,0,3,1,2,1,6,1,7
5675,786384,18,3,5,3,3,0,2,0,0,1,0,0,1,0,1,0,6
5675,790825,25,2,7,2,6,0,1,0,0,1,0,2,1,0,3,0,4
5675,796385,19,2,5,1,3,1,2,0,1,0,6,2,3,0,3,0,5
5675,774905,21,1,8,0,4,1,4,0,2,1,0,0,0,1,3,0,3
5675,785375,19,2,6,2,5,0,1,0,0,2,5,1,3,1,1,2,4
5675,790827,17,1,6,1,4,0,2,0,0,2,1,2,0,0,1,0,2
5675,785371,17,1,4,0,1,1,3,0,0,1,0,0,1,1,0,1,3
5675,790828,9,1,1,0,0,1,1,0,0,0,1,0,0,0,0,0,3
5675,796387,5,0,0,0,0,0,0,0,0,0,1,0,1,0,0,0,0
5675,790826,1,0,0,0,0,0,0,0,0,0,0,0,1,0,0,0,0
5675,780007,3,0,2,0,2,0,0,0,0,0,0,0,0,0,1,0,0
5676,797662,27,6,9,6,8,0,1,3,4,1,3,1,2,0,5,0,15
5676,786067,31,6,15,6,15,0,0,3,4,1,4,4,0,1,1,0,15
5676,797661,23,2,7,0,3,2,4,0,0,0,3,2,0,1,2,0,6
5676,785591,31,7,14,6,10,1,4,0,0,0,2,1,4,2,1,1,15
5676,780258,28,0,6,0,4,0,2,0,0,0,4,1,2,0,0,0,0
5676,792082,10,1,2,1,1,0,1,0,0,0,2,0,0,0,1,0,2
5676,792078,11,0,0,0,0,0,0,0,0,1,3,0,1,0,3,0,0
5676,791952,9,0,1,0,1,0,0,1,2,1,2,1,0,0,0,1,1
5676,797659,2,0,0,0,0,0,0,2,2,0,0,0,0,0,0,0,2
5676,797660,17,0,3,0,2,0,1,2,2,0,2,0,0,0,0,0,2
5676,792083,6,1,2,1,1,0,1,0,0,1,0,1,0,0,0,0,2
5676,792079,3,1,1,0,0,1,1,0,0,1,0,0,0,1,0,0,3
5676,774898,2,0,0,0,0,0,0,0,0,0,0,0,0,0,0,0,0
5677,791524,25,4,14,2,8,2,6,0,0,0,8,1,2,0,2,1,10
5677,797139,22,5,6,5,6,0,0,0,0,2,2,0,3,2,2,1,10
5677,775394,25,3,8,1,2,2,6,2,2,1,2,3,1,2,2,0,10
5677,791526,25,5,7,5,6,0,1,5,5,0,3,4,0,0,1,1,15
5677,780272,29,3,9,2,5,1,4,0,0,0,3,3,1,2,2,0,7
5677,786354,6,1,1,1,1,0,0,0,0,1,0,0,1,0,1,0,2
5677,785970,13,4,5,4,5,0,0,0,0,2,2,0,5,1,0,0,8
5677,797141,1,0,0,0,0,0,0,0,0,0,0,0,0,0,0,0,0
5677,791523,15,1,3,0,0,1,3,0,0,0,2,1,1,1,0,1,3
5677,791525,1,0,0,0,0,0,0,0,0,0,0,0,0,0,1,0,0
5677,797137,1,0,0,0,0,0,0,0,0,0,0,0,1,0,0,0,0
5677,780273,19,1,4,1,3,0,1,0,0,2,2,0,0,0,0,0,2
5677,775592,18,4,8,3,5,1,3,0,0,0,7,2,2,0,1,0,9
5678,792373,34,8,15,8,14,0,1,2,4,1,3,1,5,0,0,1,18
5678,792370,37,4,11,3,7,1,4,6,6,5,3,3,5,0,3,1,15
5678,797960,40,4,11,0,1,4,10,2,2,1,3,0,1,0,0,0,14
5678,786739,43,1,8,1,6,0,2,3,6,2,7,5,2,3,5,0,5
5678,775303,44,2,9,0,2,2,7,6,8,0,8,2,0,0,2,1,12
5678,797958,3,1,1,1,1,0,0,1,2,0,0,0,0,0,0,0,3
5678,781598,14,0,4,0,2,0,2,1,2,1,3,2,2,0,1,1,1
5678,797951,26,6,11,2,3,4,8,2,2,1,0,2,1,1,0,0,18
5678,776491,8,0,1,0,1,0,0,2,2,1,1,0,0,0,0,0,2
5678,781597,1,0,0,0,0,0,0,3,4,0,0,0,0,0,0,0,3
5679,791011,30,0,1,0,0,0,1,0,2,1,7,3,3,0,1,0,0
5679,780303,43,11,22,10,20,1,2,4,6,3,7,0,4,2,2,0,27
5679,791594,36,6,14,5,11,1,3,0,0,0,5,2,4,0,4,0,13
5679,791012,24,1,4,1,4,0,0,0,0,1,2,2,4,0,0,0,2
5679,781385,38,9,18,7,13,2,5,0,2,0,1,2,3,0,1,1,20
5679,796671,10,3,3,3,3,0,0,0,0,2,1,0,4,0,3,1,6
5679,785337,24,3,9,3,8,0,1,4,6,4,5,0,3,1,1,0,10
5679,796668,1,0,0,0,0,0,0,0,0,0,0,0,1,0,1,0,0
5679,791013,8,0,0,0,0,0,0,0,0,0,3,2,1,0,1,0,0
5679,786349,36,3,7,3,6,0,1,1,1,0,4,2,3,2,1,1,7
5680,790810,18,0,6,0,3,0,3,0,0,0,4,1,1,0,2,0,0
5680,790808,27,1,3,0,1,1,2,2,2,1,4,0,1,1,1,0,5
5680,785362,26,7,13,6,12,1,1,0,0,4,2,0,1,1,2,1,15
5680,785361,38,5,14,3,5,2,9,1,2,0,3,4,3,1,1,0,13
5680,779997,34,3,7,3,6,0,1,2,4,0,7,2,3,2,4,2,8
5680,790809,22,3,4,3,4,0,0,1,2,0,1,3,2,3,0,0,7
5680,790811,4,0,1,0,1,0,0,0,0,0,0,0,0,0,1,1,0
5680,774854,14,1,2,1,2,0,0,0,1,2,2,1,1,0,1,3,2
5680,796368,17,3,6,3,5,0,1,3,5,1,4,0,1,0,3,0,9
5681,780874,22,3,6,2,3,1,3,0,2,2,3,0,3,1,1,0,7
5681,781326,26,2,4,2,4,0,0,1,4,3,5,2,1,2,4,0,5
5681,792215,24,1,6,1,4,0,2,0,0,1,2,4,1,0,1,0,2
5681,797870,34,6,12,1,4,5,8,1,2,0,4,1,4,1,4,0,18
5681,781323,38,4,14,2,10,2,4,2,2,0,6,2,2,1,4,0,12
5681,785430,14,2,4,2,4,0,0,0,0,2,3,0,2,0,3,0,4
5681,792210,22,0,7,0,3,0,4,0,0,0,1,1,2,2,0,1,0
5681,785638,18,1,1,1,1,0,0,1,1,1,1,0,2,0,2,0,3
5681,792213,2,0,0,0,0,0,0,0,0,0,0,0,0,0,0,0,0
5682,791352,20,1,5,1,2,0,3,0,0,0,1,1,2,0,1,0,2
5682,785837,13,3,8,3,6,0,2,0,0,2,0,0,4,0,2,1,6
5682,797251,34,2,4,2,3,0,1,3,3,1,3,0,4,1,2,0,7
5682,797247,37,6,9,4,7,2,2,3,3,0,5,2,0,0,1,0,17
5682,776297,35,6,12,5,8,1,4,5,5,0,5,1,3,0,4,0,18
5682,797252,2,0,1,0,0,0,1,0,0,0,0,0,0,0,0,0,0
5682,797250,3,3,5,3,5,0,0,0,1,1,0,0,0,1,0,0,6
5682,791355,13,1,3,1,2,0,1,0,0,0,3,0,1,1,1,0,2
5682,791354,18,1,4,1,3,0,1,1,2,0,1,0,2,1,1,0,3
5682,786227,9,1,1,1,1,0,0,0,0,0,0,1,3,0,0,1,2
5682,797249,4,0,1,0,0,0,1,0,0,0,0,1,0,1,2,0,0
5682,797248,12,1,2,0,0,1,2,0,0,0,0,0,0,0,0,0,3
5683,797292,24,3,6,3,6,0,0,5,7,1,5,2,2,1,0,1,11
5683,780509,28,3,7,2,4,1,3,4,6,3,3,0,4,1,1,0,11
5683,797290,35,5,9,1,4,4,5,5,6,0,3,1,1,0,1,0,19
5683,797291,27,1,7,1,5,0,2,3,4,0,1,6,1,1,2,0,5
5683,786064,23,6,7,4,4,2,3,1,1,1,2,0,3,0,2,0,15
5683,791658,5,0,1,0,1,0,0,0,0,0,1,0,0,0,1,0,0
5683,785658,23,4,7,4,5,0,2,0,0,1,3,1,1,1,1,0,8
5683,797295,1,0,0,0,0,0,0,0,0,0,0,0,0,0,1,0,0
5683,791660,31,6,9,3,4,3,5,1,2,0,3,6,1,0,1,0,16
5683,791663,1,0,0,0,0,0,0,0,0,0,0,0,0,0,0,0,0
5683,797294,1,0,0,0,0,0,0,0,0,0,0,0,0,0,0,0,0
5683,791661,1,0,0,0,0,0,0,0,0,0,0,0,0,0,0,0,0
5684,797849,35,6,14,4,8,2,6,3,4,2,3,2,2,1,2,0,17
5684,781537,34,2,11,2,10,0,1,0,0,7,7,1,1,1,3,1,4
5684,786079,30,3,8,2,6,1,2,0,0,1,4,4,0,2,2,0,7
5684,797846,25,2,6,1,4,1,2,0,0,1,2,1,2,0,0,0,5
5684,792202,26,1,6,1,2,0,4,0,0,0,1,2,2,1,0,0,2
5684,797848,11,1,5,1,5,0,0,0,0,4,1,0,1,0,1,0,2
5684,797847,26,4,11,1,4,3,7,0,0,0,3,2,1,3,2,0,11
5684,797838,13,1,2,0,0,1,2,0,0,0,2,1,1,1,2,0,3
5685,796927,27,1,7,0,3,1,4,2,2,6,4,0,4,2,0,0,5
5685,796929,31,0,7,0,1,0,6,0,0,1,1,3,0,2,2,0,0
5685,791222,32,6,14,5,9,1,5,1,1,2,7,0,2,1,4,1,14
5685,785571,38,5,19,5,14,0,5,1,1,0,3,4,1,2,3,1,11
5685,786436,34,1,4,0,1,1,3,2,2,0,5,0,0,0,4,0,5
5685,791811,23,3,4,3,4,0,0,0,0,3,6,0,2,0,1,0,6
5685,796928,15,0,2,0,1,0,1,0,0,0,1,0,0,0,1,0,0
5686,785987,34,4,9,0,2,4,7,0,0,0,4,1,2,3,2,0,12
5686,776037,29,3,6,3,6,0,0,1,5,0,3,1,3,0,4,1,7
5686,780588,27,5,8,5,8,0,0,1,1,1,4,3,4,0,1,1,11
5686,791759,16,2,5,2,5,0,0,1,1,0,0,0,1,2,2,0,5
5686,786147,37,6,8,2,3,4,5,0,0,0,3,6,4,2,1,1,16
5686,792562,12,4,7,4,7,0,0,1,1,1,4,0,4,0,2,0,9
5686,780667,25,1,6,1,4,0,2,0,0,0,4,0,0,1,3,0,2
5686,781647,15,0,7,0,6,0,1,0,0,1,1,2,3,0,1,0,0
5686,791758,5,0,1,0,0,0,1,0,0,0,0,0,0,0,0,0,0
5687,790799,16,5,5,5,5,0,0,0,0,1,4,1,4,0,0,0,10
5687,790798,28,8,13,8,13,0,0,5,8,4,3,2,2,1,1,1,21
5687,780140,30,8,13,5,8,3,5,0,0,0,8,2,1,1,4,1,19
5687,796355,31,5,9,2,5,3,4,4,5,1,5,3,2,3,3,0,17
5687,780137,32,2,4,2,2,0,2,0,0,0,4,3,1,2,3,1,4
5687,785245,34,2,9,2,4,0,5,1,2,1,2,10,0,2,1,0,5
5687,775553,10,0,0,0,0,0,0,1,2,0,2,2,1,1,0,0,1
5687,796354,10,4,5,2,2,2,3,1,2,1,0,0,2,1,1,0,11
5687,796359,7,0,1,0,1,0,0,2,2,0,0,0,0,0,0,0,2
5687,799892,1,0,0,0,0,0,0,0,0,0,2,0,0,0,0,0,0
5687,790795,1,0,0,0,0,0,0,0,0,0,0,0,0,0,0,0,0
5688,775913,15,4,8,4,8,0,0,1,3,2,1,0,0,0,0,0,9
5688,797331,20,2,4,2,2,0,2,5,9,1,1,1,2,0,2,0,9
5688,791737,26,2,6,1,3,1,3,2,5,2,5,2,3,0,3,0,7
5688,783524,26,2,9,2,4,0,5,3,4,1,4,3,2,1,2,0,7
5688,791734,3,0,1,0,1,0,0,0,0,0,0,0,1,0,0,0,0
5688,781516,12,1,4,1,4,0,0,2,2,1,1,0,1,0,0,0,4
5688,797332,6,1,1,1,1,0,0,1,2,0,3,1,1,0,1,0,3
5688,797333,23,2,4,0,2,2,2,2,2,0,4,3,1,0,1,0,8
5688,795372,3,0,0,0,0,0,0,0,0,0,0,0,0,0,0,0,0
5688,786223,19,2,6,2,3,0,3,0,1,0,2,0,3,6,1,0,4
5688,786220,21,1,5,0,3,1,2,0,2,2,2,2,0,4,1,1,3
5688,780561,26,3,7,0,3,3,4,1,2,2,2,1,3,2,3,0,10
5689,791723,15,1,2,1,2,0,0,0,0,0,1,1,4,0,1,2,2
5689,780956,33,9,16,8,13,1,3,4,7,4,1,2,3,1,1,1,23
5689,797310,32,4,6,3,4,1,2,2,3,0,4,6,3,1,3,1,11
5689,791724,20,0,1,0,1,0,0,0,0,0,3,0,4,0,2,0,0
5689,781617,26,2,5,1,1,1,4,1,1,0,8,0,5,0,4,0,6
5689,797312,6,0,2,0,1,0,1,2,2,0,2,0,1,0,0,0,2
5689,786285,27,5,11,5,8,0,3,0,0,0,3,1,0,2,4,0,10
5689,785580,30,3,6,2,4,1,2,1,2,1,7,1,4,0,4,0,8
5689,797308,3,0,1,0,1,0,0,0,0,0,1,0,0,0,0,0,0
5689,780706,8,0,1,0,0,0,1,0,0,0,1,0,1,0,2,0,0
5690,791686,32,1,5,1,5,0,0,1,2,3,6,2,3,1,2,2,3
5690,798028,30,1,4,1,3,0,1,0,0,1,6,3,1,1,2,0,2
5690,792270,16,0,5,0,3,0,2,0,0,2,1,0,0,0,0,1,0
5690,790940,34,4,14,3,8,1,6,2,2,3,3,0,2,2,0,0,11
5690,780770,33,5,10,3,6,2,4,4,5,0,3,4,2,2,3,0,16
5690,792271,20,4,7,4,7,0,0,4,6,5,0,0,1,0,1,0,12
5690,798020,3,0,2,0,0,0,2,3,3,0,0,0,0,0,0,0,3
5690,798022,3,0,4,0,1,0,3,0,0,0,0,0,0,0,0,0,0
5690,786060,26,5,12,4,7,1,5,2,2,0,0,0,3,0,0,0,13
5690,785284,3,0,0,0,0,0,0,0,0,0,0,0,0,0,0,0,0
5691,776286,24,3,10,2,6,1,4,0,1,7,8,2,0,0,1,0,7
5691,775557,14,1,3,1,3,0,0,0,0,1,2,0,0,2,0,3,2
5691,797010,32,6,12,5,7,1,5,3,3,2,3,3,4,1,1,0,16
5691,791445,23,1,5,0,0,1,5,0,0,0,0,1,4,2,1,0,3
5691,775560,21,2,4,1,1,1,3,1,2,1,1,4,1,1,3,2,6
5691,785287,20,3,4,3,4,0,0,2,3,2,2,1,3,0,1,0,8
5691,797012,18,4,6,4,6,0,0,0,0,0,1,4,2,0,3,0,8
5691,791444,15,0,0,0,0,0,0,2,2,0,7,2,1,0,0,0,2
5691,785895,26,11,18,2,3,9,15,0,0,0,2,1,1,0,0,0,31
5691,797011,7,0,3,0,3,0,0,0,0,1,0,0,0,0,0,0,0
5692,790776,20,2,4,2,4,0,0,1,2,1,2,0,4,0,0,3,5
5692,796332,27,3,4,1,1,2,3,2,2,0,3,1,2,1,2,0,10
5692,785813,35,7,16,4,8,3,8,0,0,0,3,6,3,0,6,0,17
5692,796337,37,5,10,3,7,2,3,1,2,0,5,4,1,0,3,0,13
5692,796330,26,3,6,2,3,1,3,3,3,0,4,2,1,1,1,0,10
5692,779975,3,0,0,0,0,0,0,0,0,1,0,0,0,0,2,1,0
5692,785827,18,1,4,1,4,0,0,3,4,2,3,1,2,0,2,0,5
5692,796334,34,1,9,1,7,0,2,2,2,1,3,1,2,2,2,0,4
5693,792143,34,4,10,2,4,2,6,0,0,1,5,1,4,2,0,1,10
5693,786302,27,1,3,1,3,0,0,1,3,0,4,1,3,1,2,2,3
5693,786293,31,7,12,6,11,1,1,6,8,1,2,1,1,2,3,0,21
5693,780953,32,6,13,5,10,1,3,4,6,1,4,3,4,0,5,1,17
5693,797750,37,5,6,4,4,1,2,3,4,0,3,4,0,2,0,0,14
5693,797751,21,2,5,0,2,2,3,0,0,0,4,1,1,0,2,0,6
5693,792147,8,1,1,1,1,0,0,0,0,0,1,1,2,0,0,1,2
5693,797742,10,0,3,0,1,0,2,0,0,0,2,0,0,1,0,0,0
5694,796344,25,3,7,3,5,0,2,3,3,1,4,4,0,0,0,1,9
5694,790781,27,6,8,6,8,0,0,0,0,1,2,0,4,0,2,2,12
5694,780040,22,4,4,4,4,0,0,1,2,1,7,0,2,0,2,2,9
5694,796340,31,4,11,1,4,3,7,0,1,1,3,2,4,2,2,2,11
5694,780037,29,6,14,6,11,0,3,7,11,0,2,2,0,2,1,0,19
5694,796339,23,3,4,3,3,0,1,0,1,0,1,1,0,3,0,0,6
5694,781232,16,0,1,0,1,0,0,0,0,0,3,3,0,1,1,0,0
5694,796343,13,0,2,0,2,0,0,0,0,1,0,0,4,0,1,0,0
5694,790785,14,2,5,2,4,0,1,2,2,0,1,2,2,0,1,0,6
5695,785532,32,7,12,7,12,0,0,2,2,6,7,1,1,1,1,0,16
5695,780063,26,1,7,0,2,1,5,2,2,0,3,3,3,0,2,0,5
5695,791280,16,0,2,0,2,0,0,2,2,0,1,2,1,0,3,1,2
5695,791055,28,2,6,2,6,0,0,0,0,0,1,2,4,0,1,0,4
5695,785530,32,8,20,5,12,3,8,7,11,2,8,1,2,0,3,0,26
5695,775573,18,1,6,0,0,1,6,0,0,0,3,0,0,0,1,0,3
5695,775926,14,2,5,1,1,1,4,0,0,0,1,1,0,0,0,0,5
5695,791059,2,0,0,0,0,0,0,0,0,1,0,0,0,0,0,0,0
5695,791057,8,1,1,1,1,0,0,0,0,2,0,0,0,0,1,0,2
5695,791058,7,1,1,1,1,0,0,0,1,0,2,0,1,1,1,0,2
5695,796734,17,1,1,0,0,1,1,0,0,1,2,4,5,0,1,0,3
5700,790893,15,4,8,4,8,0,0,1,2,3,2,2,2,0,1,1,9
5700,796444,35,6,12,6,10,0,2,2,3,5,8,3,0,1,3,3,14
5700,786615,23,1,7,0,2,1,5,0,0,1,4,3,3,0,3,0,3
5700,786732,24,4,7,3,6,1,1,2,2,3,2,1,1,1,1,0,11
5700,775260,33,3,8,2,3,1,5,0,0,0,3,4,1,1,1,0,7
5700,775536,18,4,6,4,6,0,0,0,3,5,5,0,1,1,2,1,8
5700,790890,17,3,7,1,3,2,4,2,2,0,1,2,4,0,1,0,10
5700,780702,23,4,8,1,2,3,6,0,0,1,1,0,0,0,3,1,11
5700,790889,12,0,2,0,1,0,1,2,2,1,0,1,1,1,0,0,2
5701,790854,17,1,1,1,1,0,0,2,2,1,1,0,0,0,0,0,4
5701,796404,21,3,7,3,7,0,0,2,3,3,2,0,3,1,1,2,8
5701,790850,32,6,11,2,5,4,6,2,2,0,2,0,2,0,2,0,18
5701,781164,21,1,4,1,1,0,3,0,0,0,1,2,1,1,1,0,2
5701,781163,37,7,17,5,11,2,6,4,4,3,4,5,2,3,3,0,20
5701,785434,15,1,5,1,3,0,2,0,0,1,3,0,0,0,0,0,2
5701,790849,21,1,7,0,3,1,4,0,0,0,1,4,1,2,1,0,3
5701,790853,9,1,2,1,2,0,0,0,0,0,0,0,2,2,0,0,2
5701,796406,5,0,3,0,3,0,0,0,0,1,1,0,1,0,2,0,0
5701,790848,14,1,2,0,1,1,1,0,0,1,0,1,2,0,0,0,3
5701,796405,4,0,0,0,0,0,0,0,0,0,0,0,1,1,0,0,0
5701,781223,4,0,3,0,1,0,2,0,0,0,2,0,1,1,0,0,0
5702,781417,14,0,1,0,1,0,0,0,0,0,2,1,3,0,1,0,0
5702,792246,23,4,5,4,5,0,0,0,2,1,3,0,3,0,2,1,8
5702,797925,28,5,8,2,3,3,5,1,3,1,0,0,1,0,0,1,14
5702,781420,40,7,12,5,8,2,4,3,3,0,8,9,2,4,3,0,19
5702,781405,37,10,20,6,10,4,10,8,11,3,3,4,3,0,3,0,32
5702,780615,14,1,2,1,2,0,0,0,0,2,1,0,4,0,1,0,2
5702,781624,28,3,10,2,7,1,3,2,2,1,6,0,2,0,0,0,9
5702,792245,16,0,1,0,0,0,1,2,2,0,1,0,2,0,0,0,2
5703,780095,29,3,5,3,5,0,0,0,0,5,1,2,4,0,1,2,6
5703,776321,39,5,11,5,11,0,0,14,15,2,8,0,1,0,4,0,24
5703,786081,35,6,14,6,11,0,3,0,1,4,9,1,2,2,0,0,12
5703,785431,30,3,9,2,4,1,5,0,0,0,1,2,5,0,1,0,7
5703,780232,39,7,19,4,11,3,8,7,10,0,2,0,3,0,1,1,24
5703,785356,11,1,2,0,0,1,2,0,0,1,0,0,1,0,0,0,3
5703,797918,10,0,0,0,0,0,0,0,0,0,1,2,1,1,0,0,0
5703,789040,7,1,4,1,3,0,1,1,2,1,0,1,3,0,1,0,3
5704,792066,21,2,2,2,2,0,0,1,2,2,2,0,1,2,0,1,5
5704,789101,28,3,8,2,5,1,3,3,4,4,1,1,2,2,1,0,10
5704,792063,10,0,2,0,2,0,0,3,4,0,1,2,0,1,0,0,3
5704,781371,22,2,7,2,3,0,4,0,0,1,2,4,0,2,1,0,4
5704,781367,21,4,11,2,6,2,5,2,4,4,3,1,3,1,1,0,12
5704,797731,15,3,4,3,4,0,0,0,0,2,3,0,1,0,0,0,6
5704,785459,13,0,5,0,5,0,0,0,2,2,2,1,1,1,0,0,0
5704,792064,19,7,9,1,1,6,8,0,1,0,1,0,0,1,0,0,20
5704,792061,5,1,5,1,4,0,1,0,0,0,0,0,1,1,0,0,2
5704,788037,15,3,8,3,6,0,2,4,5,2,1,2,0,1,2,1,10
5704,789102,31,4,7,3,6,1,1,3,4,0,4,4,2,0,3,1,12
5704,781362,0,0,1,0,1,0,0,0,0,0,0,0,0,0,0,0,0
5705,785791,28,4,6,1,1,3,5,1,2,0,3,0,3,0,1,0,12
5705,775606,24,1,3,1,3,0,0,0,4,1,4,0,5,0,1,4,2
5705,791674,25,4,11,3,8,1,3,2,2,1,4,3,0,0,4,1,11
5705,785787,25,7,8,6,7,1,1,0,0,0,0,1,3,2,2,0,15
5705,780552,32,7,11,1,3,6,8,0,0,0,4,0,2,0,1,0,20
5705,797423,5,0,0,0,0,0,0,0,0,0,1,0,0,0,0,0,0
5705,791672,17,3,3,3,3,0,0,2,2,0,1,0,0,0,2,0,8
5705,780550,22,3,4,3,4,0,0,2,3,0,4,1,3,0,3,0,8
5705,780538,21,1,6,1,6,0,0,2,2,1,2,4,5,0,3,0,4
5705,785793,0,0,0,0,0,0,0,0,0,0,0,0,1,0,0,0,0
5705,797424,1,0,0,0,0,0,0,0,0,0,0,0,0,0,0,0,0
5706,786041,31,7,9,6,7,1,2,2,2,3,2,0,1,2,2,0,17
5706,780881,20,5,9,2,5,3,4,0,0,1,3,1,0,2,2,0,13
5706,780275,17,0,0,0,0,0,0,0,0,0,2,0,2,0,0,0,0
5706,792075,34,5,13,4,6,1,7,4,5,0,1,2,1,1,2,0,15
5706,786686,36,2,13,2,7,0,6,2,2,2,2,8,2,1,3,0,6
5706,785437,21,3,6,3,5,0,1,2,2,3,0,0,3,1,0,2,8
5706,775222,29,3,10,3,9,0,1,2,2,1,5,1,1,0,2,1,8
5706,792074,12,0,0,0,0,0,0,0,0,0,2,1,2,0,0,0,0
5707,785518,33,7,10,6,9,1,1,2,2,5,6,4,4,2,3,1,17
5707,796390,18,1,2,1,2,0,0,1,2,0,6,0,3,0,1,2,3
5707,785451,29,7,13,2,4,5,9,0,0,0,1,2,2,1,2,0,19
5707,790834,27,1,4,1,3,0,1,3,4,0,2,2,3,0,1,0,5
5707,785379,6,0,1,0,0,0,1,0,0,0,0,0,0,0,0,0,0
5707,790830,23,2,3,1,1,1,2,0,0,0,1,1,0,0,2,0,5
5707,785377,28,2,3,2,3,0,0,2,2,0,3,8,3,3,4,0,6
5707,790832,17,3,9,1,4,2,5,1,3,0,1,0,0,1,1,0,9
5707,790831,4,0,1,0,1,0,0,0,0,0,0,0,1,1,0,0,0
5707,790833,15,0,2,0,1,0,1,1,2,0,2,2,1,0,1,1,1
5708,791669,12,0,1,0,1,0,0,0,0,2,1,0,3,0,1,1,0
5708,785762,34,9,16,8,13,1,3,6,8,5,11,1,1,1,2,0,25
5708,797407,16,2,2,2,2,0,0,4,7,0,2,2,3,0,5,0,8
5708,785760,13,1,3,1,2,0,1,0,0,1,2,1,0,0,2,1,2
5708,780531,38,2,8,1,1,1,7,2,2,1,5,2,2,1,0,2,7
5708,797414,7,1,3,1,3,0,0,0,0,1,0,0,1,0,0,0,2
5708,797411,2,0,0,0,0,0,0,0,0,0,1,1,1,0,0,0,0
5708,780534,24,5,6,5,6,0,0,2,2,2,3,2,2,0,1,0,12
5708,797409,19,2,5,2,4,0,1,0,0,0,4,2,4,0,1,0,4
5708,791671,2,0,1,0,0,0,1,0,0,0,0,0,0,0,0,0,0
5708,791666,29,3,8,1,2,2,6,2,2,0,3,3,0,0,0,0,10
5708,797415,2,0,0,0,0,0,0,0,0,0,0,0,0,0,0,0,0
5708,780535,2,1,1,0,0,1,1,0,0,0,0,0,0,0,0,0,3
5709,797821,22,3,7,1,3,2,4,1,2,0,1,0,2,1,1,0,9
5709,780433,31,2,3,2,3,0,0,2,2,1,2,0,4,0,1,2,6
5709,797816,30,2,9,1,3,1,6,0,0,0,3,0,3,0,3,0,5
5709,792188,25,0,7,0,3,0,4,2,3,0,5,2,1,0,1,1,2
5709,786675,14,0,2,0,0,0,2,0,0,0,0,1,2,1,0,1,0
5709,797819,13,1,1,1,1,0,0,0,0,0,3,0,0,0,0,2,2
5709,781447,10,0,1,0,1,0,0,0,0,1,2,0,2,0,0,0,0
5709,781490,17,2,3,2,2,0,1,0,0,0,3,0,0,0,1,0,4
5709,792187,3,0,0,0,0,0,0,0,0,0,0,0,0,0,0,1,0
5709,792183,32,5,16,3,10,2,6,10,10,0,2,4,2,5,4,0,22
5709,792185,3,1,3,0,2,1,1,0,0,1,0,0,0,0,0,0,3
5710,791306,26,6,11,5,9,1,2,0,0,1,3,3,0,2,0,0,13
5710,780210,38,9,19,8,15,1,4,4,7,4,8,2,2,1,1,1,23
5710,792432,34,7,11,1,2,6,9,0,0,0,2,4,3,0,1,0,20
5710,792427,37,3,11,1,4,2,7,2,3,0,4,1,2,0,1,0,10
5710,792433,11,0,0,0,0,0,0,0,0,0,0,2,4,0,0,0,0
5710,796592,16,1,4,1,4,0,0,0,2,1,1,0,0,1,0,1,2
5710,796594,22,2,5,1,2,1,3,0,0,2,1,3,1,1,2,0,5
5710,786422,10,1,2,0,1,1,1,0,0,1,0,1,1,0,1,0,3
5710,775005,6,0,1,0,1,0,0,0,0,0,0,0,1,0,0,0,0
5711,782133,34,7,13,1,3,6,10,4,6,0,5,1,2,1,1,1,24
5711,785123,25,7,10,7,10,0,0,0,0,1,4,4,4,0,0,3,14
5711,790990,35,2,5,1,3,1,2,1,2,0,2,3,1,0,2,0,6
5711,789219,35,2,5,2,3,0,2,0,2,0,1,3,1,0,2,0,4
5711,785059,36,8,10,7,9,1,1,2,2,1,9,3,2,1,1,0,19
5711,790989,0,0,0,0,0,0,0,0,0,0,0,0,0,0,0,0,0
5711,785305,2,0,0,0,0,0,0,0,2,0,1,0,1,0,2,0,0
5711,796622,12,3,3,3,3,0,0,0,0,1,2,0,0,0,0,0,6
5711,796623,17,3,5,2,3,1,2,1,1,0,2,1,1,0,2,0,8
5711,790988,2,0,0,0,0,0,0,0,0,0,1,0,0,0,0,0,0
5711,785122,2,0,0,0,0,0,0,0,0,0,0,0,0,0,0,0,0
5712,786157,17,2,4,2,4,0,0,0,0,0,5,0,1,0,2,0,4
5712,780676,20,6,12,5,9,1,3,0,0,2,5,3,1,3,1,0,13
5712,791756,19,1,3,1,2,0,1,0,0,1,1,3,1,2,1,0,2
5712,780992,22,5,7,1,3,4,4,0,0,0,1,1,1,1,0,0,14
5712,780677,26,6,11,3,5,3,6,1,2,2,4,4,1,1,1,0,16
5712,797350,6,0,0,0,0,0,0,0,0,0,0,0,2,0,0,0,0
5712,791730,3,0,0,0,0,0,0,0,0,0,0,0,0,0,0,0,0
5712,791754,21,2,3,1,1,1,2,1,2,0,4,2,3,0,0,1,6
5712,775533,20,4,6,4,6,0,0,0,0,2,5,2,2,0,0,1,8
5712,797353,1,0,0,0,0,0,0,0,0,0,0,0,0,0,0,0,0
5712,797351,1,0,1,0,1,0,0,0,0,0,0,0,0,0,0,0,0
5712,791753,3,1,1,1,1,0,0,0,0,0,0,0,0,0,0,0,2
5712,797348,20,5,9,4,7,1,2,2,4,0,4,6,3,1,4,0,13
5712,780673,21,4,8,3,5,1,3,0,0,0,3,1,2,1,2,0,9
5713,780844,19,1,6,1,1,0,5,0,0,2,1,1,1,0,0,1,2
5713,797699,37,2,13,0,4,2,9,0,0,0,1,5,2,1,7,1,6
5713,797692,34,3,9,0,1,3,8,0,1,0,1,3,1,1,1,0,9
5713,791954,25,5,11,2,4,3,7,2,2,2,7,1,3,2,2,0,15
5713,780846,33,0,4,0,1,0,3,6,6,0,3,3,2,0,3,0,6
5713,797698,9,2,2,1,1,1,1,0,0,0,0,0,2,0,0,0,5
5713,797695,21,4,8,4,8,0,0,2,2,1,5,0,2,0,1,0,10
5713,797694,22,1,7,0,0,1,7,1,2,0,4,1,0,0,2,0,4
5714,780180,23,0,2,0,1,0,1,0,0,1,3,1,1,0,0,2,0
5714,781650,22,6,12,6,12,0,0,0,0,1,4,0,3,0,2,0,12
5714,791432,25,5,6,2,2,3,4,0,0,0,1,4,0,1,4,0,13
5714,777865,25,2,6,1,2,1,4,2,2,0,1,2,1,1,3,0,7
5714,791429,26,2,6,2,4,0,2,0,0,0,0,4,3,0,1,0,4
5714,797066,18,4,7,4,7,0,0,0,0,2,5,1,0,0,2,1,8
5714,797067,16,1,7,1,6,0,1,1,2,2,1,0,0,1,0,0,3
5714,797070,13,2,4,2,2,0,2,0,0,0,3,0,1,0,2,0,4
5714,797068,15,0,2,0,1,0,1,0,0,0,3,2,2,1,3,0,0
5714,776079,17,2,4,1,1,1,3,0,0,0,2,3,0,0,2,0,5
5715,783072,22,2,4,2,4,0,0,0,0,1,4,1,2,1,2,0,4
5715,774879,27,2,8,2,7,0,1,3,4,1,6,2,1,1,0,1,7
5715,791540,25,6,9,4,6,2,3,0,0,0,3,2,2,0,0,0,14
5715,787782,29,7,11,5,8,2,3,3,3,0,6,1,1,5,2,0,19
5715,776068,30,6,13,4,7,2,6,2,2,0,2,5,1,4,1,0,16
5715,797817,11,2,4,2,4,0,0,0,0,0,1,0,1,2,2,0,4
5715,785647,4,0,1,0,0,0,1,0,0,0,0,0,0,0,0,0,0
5715,785962,4,1,3,1,3,0,0,0,0,2,1,0,0,0,0,0,2
5715,781463,19,5,5,3,3,2,2,0,0,0,0,3,2,1,1,0,12
5715,793057,4,0,0,0,0,0,0,0,0,0,1,0,0,0,0,0,0
5715,792153,13,1,3,0,1,1,2,0,0,0,2,1,0,0,1,0,3
5715,781202,12,0,2,0,0,0,2,0,2,0,0,2,0,0,0,0,0
5716,796979,27,5,9,5,7,0,2,1,1,6,5,0,2,0,1,0,11
5716,776200,29,1,6,1,6,0,0,1,2,2,4,3,1,3,1,0,3
5716,786437,34,3,9,2,6,1,3,0,0,0,7,2,3,1,3,0,7
5716,785620,36,5,12,1,7,4,5,2,2,1,2,3,3,2,7,1,16
5716,781034,37,4,9,2,4,2,5,2,2,0,2,3,3,0,2,0,12
5716,796980,6,1,3,1,3,0,0,0,2,1,0,0,1,0,1,0,2
5716,791625,13,2,4,1,2,1,2,0,0,0,1,0,1,0,1,1,5
5716,791622,5,0,0,0,0,0,0,0,2,0,1,0,1,0,0,0,0
5716,791637,13,1,1,0,0,1,1,0,0,0,2,0,3,0,3,0,3
5717,792288,23,1,2,1,1,0,1,0,0,2,2,1,1,0,0,0,2
5717,785227,27,5,7,5,7,0,0,0,0,7,6,1,4,0,1,1,10
5717,786237,29,10,17,10,17,0,0,3,8,3,3,4,1,4,1,0,23
5717,786232,29,6,11,3,5,3,6,0,0,1,2,1,2,1,1,1,15
5717,780287,19,1,9,1,3,0,6,0,0,1,0,1,1,0,2,0,2
5717,798067,13,0,2,0,2,0,0,0,0,1,2,1,2,0,0,2,0
5717,792278,29,4,12,2,4,2,8,3,4,0,1,1,1,2,3,0,13
5717,776309,31,2,7,2,5,0,2,1,2,1,4,4,0,2,1,0,5
5718,791743,32,7,9,7,9,0,0,1,2,2,2,0,2,1,2,0,15
5718,797340,26,3,8,2,4,1,4,0,1,0,3,0,1,0,4,0,7
5718,791746,35,5,6,5,5,0,1,2,5,1,6,4,4,4,4,0,12
5718,786193,40,5,13,2,5,3,8,2,2,0,0,0,1,1,3,0,15
5718,780711,33,0,3,0,0,0,3,0,0,2,9,1,3,0,0,0,0
5718,797343,5,1,1,1,1,0,0,0,0,1,0,0,1,0,0,0,2
5718,797342,3,0,0,0,0,0,0,0,0,0,1,0,0,0,0,0,0
5718,797341,26,3,8,1,4,2,4,0,0,1,3,1,0,1,1,0,8
5719,792473,25,1,2,1,2,0,0,0,0,3,3,1,4,1,0,1,2
5719,780036,35,5,10,3,6,2,4,2,2,1,3,0,2,0,2,1,14
5719,799276,36,1,4,1,1,0,3,1,2,1,2,2,2,1,2,0,3
5719,785249,34,8,18,4,8,4,10,1,2,0,4,1,4,3,3,0,21
5719,780035,34,4,14,2,4,2,10,0,0,1,3,3,0,2,1,0,10
5719,780043,29,3,5,3,4,0,1,2,4,0,4,0,0,2,3,2,8
5719,799281,4,0,0,0,0,0,0,0,0,0,0,0,0,0,0,0,0
5719,792477,3,0,1,0,0,0,1,0,0,1,0,0,0,0,0,0,0
5720,791281,35,1,7,1,5,0,2,2,2,4,12,1,3,2,3,0,4
5720,796534,23,0,3,0,3,0,0,1,2,3,1,1,2,1,1,0,1
5720,791278,38,3,8,0,0,3,8,0,0,0,4,2,3,1,1,0,9
5720,792276,37,2,8,0,0,2,8,1,4,1,4,5,2,1,5,0,7
5720,785507,34,5,13,1,4,4,9,4,5,1,3,0,2,1,1,0,18
5720,796536,12,3,5,3,5,0,0,2,4,2,1,0,3,0,2,0,8
5720,796537,10,1,1,0,0,1,1,0,0,0,0,0,0,0,0,0,3
5720,796535,6,0,0,0,0,0,0,0,2,0,1,1,1,2,1,0,0
5720,786026,21,6,10,6,9,0,1,2,3,1,0,4,3,2,0,0,14
5720,785398,5,0,2,0,1,0,1,0,0,0,1,0,1,0,2,0,0
5720,775814,4,0,2,0,2,0,0,0,0,0,1,0,1,1,1,0,0
5721,797546,26,1,2,1,2,0,0,1,3,4,0,0,4,0,1,2,3
5721,780351,24,0,3,0,3,0,0,1,3,3,2,1,4,1,3,1,1
5721,780586,41,9,17,9,16,0,1,6,6,0,5,1,4,2,3,1,24
5721,797549,35,6,9,6,9,0,0,2,4,1,9,1,4,1,9,1,14
5721,791716,20,0,4,0,3,0,1,0,0,1,4,0,0,1,1,0,0
5721,790857,24,4,9,3,6,1,3,1,2,1,1,0,1,1,1,0,10
5721,797544,34,5,15,5,12,0,3,0,1,1,3,1,2,0,0,0,10
5721,797540,8,0,1,0,1,0,0,0,0,1,1,0,0,0,0,0,0
5721,791715,13,0,1,0,0,0,1,0,0,0,1,0,1,0,0,0,0
5734,791839,29,5,6,5,6,0,0,2,2,4,4,3,4,0,2,2,12
5734,785322,25,3,5,1,1,2,4,2,4,0,4,3,0,0,3,0,10
5734,797444,29,2,5,0,1,2,4,1,3,0,1,0,2,1,0,0,7
5734,792381,38,7,14,4,7,3,7,4,4,0,0,0,1,1,5,0,21
5734,791842,32,1,8,1,7,0,1,5,7,1,5,1,1,0,6,0,7
5734,797443,11,2,2,2,2,0,0,3,4,0,2,0,4,0,0,0,7
5734,797442,16,2,3,0,0,2,3,0,0,0,1,0,2,0,2,0,6
5734,786613,17,2,3,2,3,0,0,0,0,0,4,4,3,1,0,0,4
5734,776341,3,0,0,0,0,0,0,0,0,0,0,0,0,0,0,0,0
5735,791883,26,4,4,4,4,0,0,0,0,3,3,1,2,1,3,0,8
5735,781066,31,6,11,6,11,0,0,4,4,4,3,2,4,2,5,0,16
5735,797594,28,5,11,3,3,2,8,0,0,0,0,0,2,2,1,0,12
5735,791884,33,9,16,7,12,2,4,10,11,0,4,4,2,1,1,0,30
5735,780695,30,3,9,1,3,2,6,0,0,2,4,1,4,1,3,0,8
5735,797600,9,0,1,0,1,0,0,0,2,0,4,0,0,0,0,0,0
5735,797598,2,0,1,0,1,0,0,0,0,0,0,0,0,0,0,0,0
5735,791885,4,0,1,0,0,0,1,0,0,0,0,1,0,0,0,0,0
5735,797596,16,1,1,1,1,0,0,0,0,0,0,0,1,0,2,0,2
5735,786496,21,1,3,0,1,1,2,0,0,1,2,1,4,2,0,0,3
5736,790232,36,6,12,5,8,1,4,7,8,0,1,3,3,0,1,0,20
5736,780614,21,4,6,2,4,2,2,0,0,1,3,1,5,0,0,1,10
5736,780093,27,4,5,4,5,0,0,2,2,3,7,1,2,0,2,1,10
5736,789066,31,3,15,3,8,0,7,0,0,1,4,5,3,2,1,0,6
5736,785806,24,1,1,1,1,0,0,0,0,0,2,4,1,0,4,0,2
5736,780255,17,1,3,1,2,0,1,0,1,2,2,1,3,2,0,0,2
5736,792411,16,1,3,0,0,1,3,0,0,0,1,1,1,0,0,0,3
5736,786465,11,0,1,0,0,0,1,4,4,0,0,0,0,0,0,0,4
5736,786463,17,3,9,1,5,2,4,2,4,0,1,0,2,1,1,0,10
5737,780494,31,8,12,5,7,3,5,0,0,0,6,5,5,0,1,0,19
5737,797276,17,1,2,1,1,0,1,2,2,1,3,3,1,2,1,0,4
5737,780497,21,1,1,1,1,0,0,1,2,1,3,3,3,0,0,1,3
5737,780496,29,2,6,1,2,1,4,5,5,0,2,3,1,0,3,0,10
5737,780495,36,6,15,3,10,3,5,3,4,0,3,2,2,0,0,0,18
5737,785693,22,5,6,5,6,0,0,2,3,1,5,1,2,2,2,0,12
5737,791643,4,0,1,0,1,0,0,0,0,0,2,0,1,0,1,0,0
5737,785692,23,0,1,0,0,0,1,2,2,0,1,4,2,0,0,0,2
5737,785644,17,2,6,0,3,2,3,3,4,0,0,2,3,1,0,0,9
5737,791645,0,0,0,0,0,0,0,0,0,0,0,0,0,0,0,0,0
5738,780686,37,3,5,3,4,0,1,0,0,3,4,6,1,0,0,0,6
5738,780683,32,5,12,2,7,3,5,5,7,6,5,3,1,1,1,1,18
5738,797681,34,4,14,0,1,4,13,1,1,1,3,7,3,2,3,0,13
5738,797680,32,4,11,3,5,1,6,0,0,0,1,1,0,0,1,0,9
5738,780688,36,9,14,4,8,5,6,1,2,2,3,1,3,0,1,0,24
5738,797683,9,1,2,1,1,0,1,0,0,1,0,1,1,0,1,0,2
5738,791942,15,0,0,0,0,0,0,3,6,0,0,1,3,0,2,0,3
5738,780689,2,0,1,0,0,0,1,0,0,0,0,0,0,0,0,0,0
5738,797679,3,0,0,0,0,0,0,0,0,0,0,0,0,0,0,0,0
5739,792414,24,4,5,2,2,2,3,0,0,2,2,0,1,0,1,0,10
5739,789020,34,4,8,3,5,1,3,0,0,1,2,2,3,1,4,0,9
5739,786787,40,10,23,5,9,5,14,0,0,0,3,7,0,3,3,0,25
5739,781456,31,6,7,6,7,0,0,0,1,0,3,1,1,1,0,0,12
5739,774954,28,1,3,1,3,0,0,2,2,1,3,3,1,2,0,1,4
5739,786795,9,1,2,1,2,0,0,0,0,1,0,0,1,0,0,0,2
5739,786792,10,1,1,1,1,0,0,0,0,2,3,0,2,0,0,0,2
5739,792091,21,5,9,3,5,2,4,2,2,0,1,3,3,1,0,0,14
5739,781497,3,0,0,0,0,0,0,0,0,0,0,0,0,0,0,0,0
5740,786519,25,1,1,1,1,0,0,0,0,0,5,1,4,1,0,2,2
5740,791911,25,2,4,0,0,2,4,0,0,0,4,0,1,0,0,0,6
5740,797559,9,0,1,0,1,0,0,0,0,1,0,1,0,1,2,0,0
5740,797556,30,7,14,6,10,1,4,5,5,0,0,0,1,0,1,0,20
5740,786520,30,9,24,8,20,1,4,6,8,2,10,0,2,2,2,0,25
5740,797558,11,1,5,1,3,0,2,2,3,0,2,0,0,1,0,0,4
5740,797560,15,0,0,0,0,0,0,0,0,1,2,0,4,0,1,0,0
5740,797555,7,1,2,1,2,0,0,0,0,0,0,0,0,2,0,0,2
5740,791913,31,3,6,3,6,0,0,7,9,0,0,4,1,2,0,0,13
5740,781105,17,0,0,0,0,0,0,0,0,0,0,0,2,0,0,0,0
5741,785916,21,1,4,0,1,1,3,0,0,1,7,1,0,0,1,0,3
5741,780105,29,3,11,2,7,1,4,5,6,4,3,0,5,0,1,1,12
5741,785637,29,4,7,0,1,4,6,0,0,0,2,2,4,0,2,0,12
5741,785915,27,3,6,0,0,3,6,0,0,0,5,1,3,2,1,0,9
5741,781131,30,3,12,3,9,0,3,2,4,1,2,2,3,1,4,2,8
5741,791408,19,1,3,1,3,0,0,1,2,4,2,0,2,0,2,0,3
5741,786183,21,6,11,4,8,2,3,1,1,4,3,5,2,0,3,0,15
5741,785894,24,2,7,0,1,2,6,0,0,0,2,1,1,0,1,0,6
5742,780824,33,4,5,4,5,0,0,0,1,1,6,2,3,0,2,0,8
5742,791117,26,1,8,0,5,1,3,0,0,1,2,2,1,0,1,0,3
5742,791118,44,6,17,4,9,2,8,11,11,2,8,0,1,2,5,0,25
5742,785676,36,4,8,4,4,0,4,1,2,1,6,2,3,2,5,1,9
5742,774974,38,4,8,4,8,0,0,0,0,0,5,2,4,1,3,0,8
5742,796771,2,0,0,0,0,0,0,0,0,0,1,0,2,0,0,0,0
5742,791115,10,1,2,1,2,0,0,0,0,0,1,1,2,0,2,0,2
5742,800022,3,0,0,0,0,0,0,0,0,0,0,0,1,0,1,0,0
5742,785947,33,2,2,1,1,1,1,3,5,0,10,1,2,1,2,1,8
5743,791266,25,2,7,2,7,0,0,2,2,4,1,0,3,2,1,2,6
5743,796522,22,0,7,0,0,0,7,0,0,0,0,0,0,0,0,0,0
5743,791270,30,2,10,1,4,1,6,0,0,1,2,0,2,3,0,0,5
5743,791265,35,1,6,1,2,0,4,2,3,0,4,5,3,2,3,0,4
5743,791269,36,4,14,3,6,1,8,5,6,3,9,1,3,3,1,2,14
5743,796524,4,0,0,0,0,0,0,0,0,1,0,0,0,0,0,0,0
5743,797879,1,0,0,0,0,0,0,0,0,0,0,0,0,0,0,0,0
5743,796523,11,0,2,0,1,0,1,1,2,0,3,1,0,0,1,0,1
5743,796525,21,2,6,1,3,1,3,1,2,1,3,0,3,2,1,1,6
5743,791271,15,2,3,2,3,0,0,0,0,0,2,0,4,1,2,0,4
5743,781313,25,4,9,1,4,3,5,4,5,1,0,1,2,0,3,0,15
5744,785459,13,2,7,2,7,0,0,0,0,1,0,0,1,2,0,0,4
5744,789101,30,1,4,1,3,0,1,4,4,4,4,0,2,0,0,0,6
5744,789102,31,6,15,6,14,0,1,2,4,2,3,3,1,2,2,0,14
5744,781371,18,1,5,0,1,1,4,0,0,0,0,0,1,0,0,0,3
5744,781367,24,4,8,4,6,0,2,0,0,1,2,0,3,0,1,0,8
5744,797731,13,0,3,0,3,0,0,0,1,5,0,0,1,1,0,0,0
5744,792066,16,1,4,1,4,0,0,1,2,2,1,0,5,0,0,0,3
5744,792064,17,1,5,0,1,1,4,0,0,1,1,0,0,0,0,0,3
5744,792063,10,0,4,0,1,0,3,1,2,2,1,1,2,0,1,0,1
5744,792061,7,2,5,1,2,1,3,0,1,3,1,0,1,0,0,0,5
5744,788037,21,4,9,4,7,0,2,0,0,3,3,0,1,1,2,1,8
5745,785791,23,1,2,0,0,1,2,0,0,0,1,0,3,0,2,1,3
5745,775606,27,4,5,4,5,0,0,1,4,4,6,0,4,0,4,5,9
5745,780550,27,3,6,3,5,0,1,6,7,0,4,3,1,0,5,0,12
5745,791674,33,4,11,1,5,3,6,2,2,1,3,2,0,1,3,1,13
5745,780552,33,2,7,1,1,1,6,0,0,1,3,1,0,0,2,0,5
5745,797424,5,0,0,0,0,0,0,0,0,0,2,0,0,0,0,0,0
5745,785793,4,1,2,0,0,1,2,0,0,0,1,0,0,0,0,0,3
5745,797423,8,0,1,0,1,0,0,0,0,0,0,0,5,0,1,2,0
5745,791672,23,3,4,3,4,0,0,0,0,2,3,0,3,0,1,0,6
5745,780538,17,2,4,2,2,0,2,2,4,0,1,2,4,1,2,0,6
5746,792299,22,1,6,1,5,0,1,1,1,3,1,2,4,0,3,0,3
5746,792304,30,4,14,3,9,1,5,0,0,0,2,1,0,2,2,0,9
5746,792301,32,2,9,2,9,0,0,1,2,0,4,2,0,0,0,0,5
5746,786280,24,3,9,3,9,0,0,1,2,4,5,0,2,1,3,0,7
5746,786275,28,3,9,1,4,2,5,6,6,0,4,1,3,2,1,0,14
5746,798092,13,0,1,0,0,0,1,2,2,0,1,0,0,1,1,0,2
5746,792302,5,1,1,1,1,0,0,0,0,0,0,1,1,0,1,0,2
5746,786181,15,1,3,1,3,0,0,0,0,1,1,0,2,0,1,1,2
5746,798093,2,0,0,0,0,0,0,1,2,0,0,0,0,0,0,0,1
5746,786286,29,3,6,3,4,0,2,0,1,1,1,0,1,0,0,0,6
5747,786704,25,5,6,5,6,0,0,0,0,1,7,1,1,1,0,1,10
5747,785395,23,4,12,3,7,1,5,1,2,2,5,2,2,1,1,1,10
5747,775840,32,4,7,2,4,2,3,1,2,0,2,4,0,1,0,0,11
5747,775811,11,1,1,1,1,0,0,0,0,0,1,0,4,0,1,0,2
5747,792327,3,0,0,0,0,0,0,0,0,0,0,0,1,0,0,0,0
5747,786706,12,3,3,3,3,0,0,0,2,0,1,0,2,0,1,1,6
5747,786703,2,0,0,0,0,0,0,0,0,0,0,0,0,0,0,0,0
5747,775287,15,1,1,1,1,0,0,0,0,0,3,0,1,0,1,1,2
5747,798110,1,0,0,0,0,0,0,0,0,0,0,0,1,0,0,0,0
5747,786702,7,2,2,2,2,0,0,0,0,0,3,1,1,0,2,0,4
5747,790921,12,2,3,2,2,0,1,1,2,0,5,1,2,1,2,1,5
5747,786551,27,3,6,2,5,1,1,4,5,0,2,2,1,0,1,0,11
5747,775955,30,5,10,4,6,1,4,0,0,1,2,5,1,1,3,1,11
5748,791083,24,4,8,4,4,0,4,2,2,3,2,0,1,1,1,4,10
5748,785294,27,3,7,3,6,0,1,5,8,1,5,0,0,0,2,0,11
5748,791085,31,4,10,4,8,0,2,4,6,0,2,4,2,0,0,0,12
5748,791080,31,4,9,3,5,1,4,0,0,1,3,0,0,0,3,0,9
5748,785675,28,1,7,0,4,1,3,4,4,1,6,1,1,2,2,0,7
5748,796511,17,1,3,1,1,0,2,0,2,0,4,0,4,0,0,0,2
5748,791081,12,3,3,3,3,0,0,2,4,1,1,0,4,0,0,1,8
5748,796512,5,0,3,0,3,0,0,0,0,0,1,1,0,0,0,0,0
5748,796515,8,0,1,0,0,0,1,0,0,0,3,0,0,0,0,0,0
5748,786446,17,2,7,2,5,0,2,1,2,1,3,2,2,2,3,1,5
5749,792167,25,6,11,6,11,0,0,4,5,1,4,1,4,0,3,1,16
5749,797767,27,1,4,1,4,0,0,2,2,0,3,2,3,1,3,0,4
5749,791372,35,5,16,3,7,2,9,0,0,2,2,3,1,2,1,0,12
5749,792164,38,4,15,2,12,2,3,3,4,1,10,3,1,2,2,1,13
5749,780974,29,4,11,1,4,3,7,0,0,1,4,1,2,0,1,0,11
5749,797766,19,2,5,2,4,0,1,0,0,2,3,0,3,0,0,0,4
5749,792163,19,0,2,0,1,0,1,0,0,0,2,1,3,0,1,0,0
5749,797764,8,1,4,0,1,1,3,0,0,0,0,0,1,0,0,0,3
5750,786080,27,5,13,2,5,3,8,2,3,0,4,1,2,2,3,0,15
5750,786216,25,1,5,1,5,0,0,3,4,3,4,0,3,1,1,1,5
5750,791348,38,4,10,4,10,0,0,1,1,1,3,1,2,1,0,0,9
5750,791350,34,1,6,0,1,1,5,0,0,0,3,1,4,1,3,0,3
5750,786218,37,6,12,3,7,3,5,5,7,1,4,4,3,0,3,2,20
5750,797258,3,0,0,0,0,0,0,0,0,0,1,0,0,0,0,2,0
5750,781645,17,1,3,1,1,0,2,0,0,0,3,2,1,2,0,0,2
5750,780156,19,0,2,0,2,0,0,0,0,0,1,0,1,2,0,0,0
5751,791482,31,3,6,2,3,1,3,0,0,3,5,1,1,0,4,1,7
5751,786319,16,3,7,3,6,0,1,2,2,1,5,1,2,2,1,0,8
5751,786318,34,5,14,3,4,2,10,0,2,0,5,0,0,0,4,0,12
5751,784268,30,6,10,3,6,3,4,3,3,1,2,3,1,1,1,0,18
5751,780223,32,1,7,1,1,0,6,2,2,1,4,0,2,0,1,1,4
5751,797198,1,0,2,0,2,0,0,0,0,1,0,0,0,0,0,0,0
5751,791481,17,0,2,0,1,0,1,1,2,0,3,1,3,0,0,2,1
5751,780225,24,2,5,1,1,1,4,0,0,2,3,0,2,0,0,1,5
5751,797200,4,0,1,0,0,0,1,0,0,0,1,1,0,0,0,0,0
5751,797199,11,0,0,0,0,0,0,4,4,0,0,0,2,0,0,0,4
5752,796566,36,7,15,7,15,0,0,1,1,5,15,0,4,2,3,1,15
5752,796563,10,0,6,0,4,0,2,0,0,5,0,1,0,0,0,0,0
5752,790969,33,3,6,2,4,1,2,7,8,0,0,7,1,0,2,0,14
5752,780166,30,5,11,5,7,0,4,8,8,0,4,3,3,0,5,1,18
5752,775107,33,3,7,1,5,2,2,0,0,1,1,1,0,0,0,0,8
5752,796568,23,5,9,5,8,0,1,1,2,4,9,0,1,0,0,0,11
5752,790971,9,1,2,1,2,0,0,0,0,2,1,0,2,0,1,0,2
5752,796569,14,0,4,0,4,0,0,0,0,1,3,0,2,1,2,1,0
5752,790968,11,0,4,0,1,0,3,0,0,0,0,1,0,1,0,0,0
5752,790967,26,5,8,0,1,5,7,0,0,0,0,1,1,1,1,0,15
5753,787239,34,2,3,2,3,0,0,0,0,4,5,0,2,0,1,6,4
5753,789058,35,4,8,3,6,1,2,0,0,1,5,0,2,1,0,1,9
5753,785286,31,3,7,0,2,3,5,4,6,0,3,2,0,0,4,0,13
5753,797898,36,6,17,5,10,1,7,6,6,0,4,1,5,0,1,0,19
5753,792237,36,11,24,7,14,4,10,2,2,3,3,3,1,0,0,0,28
5753,797895,10,0,1,0,1,0,0,0,0,0,2,1,1,1,2,0,0
5753,792238,1,0,0,0,0,0,0,0,0,0,1,0,0,0,0,1,0
5753,785818,9,0,1,0,1,0,0,0,0,0,0,0,1,0,1,0,0
5753,792236,21,0,8,0,8,0,0,0,0,1,1,3,2,1,1,0,0
5753,792240,12,1,1,1,1,0,0,0,0,0,1,0,2,2,1,0,2
5754,785681,28,5,8,5,8,0,0,1,1,0,7,1,3,0,0,1,11
5754,796789,23,5,8,4,4,1,4,0,0,1,1,2,4,2,0,2,11
5754,791126,32,4,11,3,9,1,2,3,4,4,4,4,0,0,0,0,12
5754,791124,36,6,10,5,8,1,2,3,5,1,2,6,1,3,4,0,16
5754,780050,30,4,9,1,4,3,5,2,4,0,4,0,3,1,1,0,13
5754,796786,10,0,3,0,2,0,1,0,0,1,0,0,2,1,0,0,0
5754,775813,12,0,3,0,3,0,0,2,3,2,1,0,1,0,1,0,2
5754,796784,11,1,2,0,1,1,1,0,0,0,1,0,0,0,0,0,3
5754,796782,15,2,4,0,1,2,3,0,0,0,1,1,3,0,2,0,6
5754,796783,3,0,0,0,0,0,0,0,0,0,0,0,0,0,0,0,0
5755,796657,19,3,4,3,4,0,0,0,2,2,2,1,2,0,4,0,6
5755,796651,7,1,2,1,1,0,1,1,2,2,0,0,1,0,0,1,3
5755,791323,28,0,1,0,1,0,0,2,2,0,5,0,1,0,0,2,2
5755,791320,38,9,16,8,13,1,3,8,9,0,3,1,3,2,2,0,27
5755,781511,37,5,13,3,4,2,9,0,0,0,8,5,1,0,1,0,12
5755,796650,20,3,6,3,5,0,1,0,0,2,2,0,4,2,1,1,6
5755,796656,5,0,1,0,1,0,0,0,0,0,0,0,0,0,0,0,0
5755,791321,16,1,2,1,2,0,0,2,2,3,1,0,1,0,1,0,4
5755,785912,30,3,10,1,3,2,7,0,2,1,4,4,1,0,1,1,8
5756,791493,27,3,5,3,5,0,0,2,2,2,7,0,2,2,1,1,8
5756,789036,37,8,12,8,11,0,1,1,1,3,6,1,3,0,4,2,17
5756,797191,11,1,4,1,3,0,1,0,0,1,1,1,0,0,1,0,2
5756,791494,16,2,4,2,2,0,2,0,0,0,1,0,3,1,1,0,4
5756,776494,28,3,7,1,1,2,6,4,7,1,0,2,1,2,1,0,12
5756,781307,13,0,2,0,2,0,0,0,0,0,2,1,2,0,0,1,0
5756,791492,20,1,4,1,2,0,2,1,1,1,3,3,1,1,1,0,3
5756,786324,29,5,13,3,7,2,6,5,8,4,2,3,2,3,4,0,17
5756,778888,19,1,5,0,0,1,5,0,0,0,2,2,2,0,1,0,3
5757,791515,37,4,8,4,4,0,4,1,2,2,4,1,3,1,0,1,9
5757,791511,20,3,4,3,4,0,0,0,2,2,3,0,3,1,2,1,6
5757,797150,36,2,11,0,4,2,7,0,0,0,2,3,2,1,2,0,6
5757,780946,30,0,4,0,1,0,3,2,2,1,0,5,2,2,0,0,2
5757,786637,35,8,17,5,10,3,7,0,0,0,4,2,1,0,6,0,19
5757,797151,19,1,5,1,5,0,0,0,0,3,1,0,3,1,1,0,2
5757,797154,4,1,1,0,0,1,1,0,0,0,0,0,0,1,1,0,3
5757,797152,4,0,0,0,0,0,0,0,0,0,0,0,1,0,2,0,0
5757,791513,15,5,7,3,4,2,3,3,3,0,2,0,3,0,0,0,15
5758,781454,16,2,3,2,3,0,0,1,4,1,1,0,3,0,3,2,5
5758,786424,25,4,6,4,6,0,0,3,4,1,13,1,4,0,5,2,11
5758,792366,37,6,11,4,9,2,2,4,5,1,6,4,3,3,3,2,18
5758,791015,23,1,3,0,0,1,3,0,0,0,2,3,2,0,2,0,3
5758,785483,34,5,10,3,5,2,5,3,3,0,5,7,3,1,1,1,15
5758,797991,2,0,1,0,0,0,1,0,0,0,0,0,0,0,0,0,0
5758,785959,7,0,0,0,0,0,0,0,0,1,0,0,1,0,0,0,0
5758,797988,22,0,0,0,0,0,0,2,2,0,0,5,0,1,1,0,2
5758,797979,25,7,9,2,3,5,6,0,0,1,0,2,0,0,0,0,19
5758,792279,9,0,0,0,0,0,0,0,2,0,0,1,1,1,1,0,0
5759,795730,22,1,4,1,2,0,2,2,2,0,2,1,0,0,0,0,4
5759,791868,27,7,16,6,14,1,2,3,4,0,3,2,3,2,4,0,18
5759,797802,40,2,7,1,4,1,3,2,4,0,4,0,2,1,1,1,7
5759,797807,31,0,3,0,3,0,0,0,0,0,1,1,1,1,0,0,0
5759,786058,26,3,7,3,6,0,1,0,0,0,1,1,2,1,2,0,6
5759,797812,1,0,0,0,0,0,0,0,0,0,0,0,2,0,0,0,0
5759,797810,2,0,0,0,0,0,0,0,0,0,0,0,0,0,0,0,0
5759,797808,5,2,3,2,3,0,0,2,2,0,0,1,1,0,1,1,6
5759,797809,10,1,5,1,3,0,2,1,1,0,0,0,1,0,0,0,3
5759,797811,1,0,0,0,0,0,0,0,0,0,0,0,0,0,0,0,0
5759,792264,33,5,6,4,5,1,1,5,5,3,3,0,4,2,1,0,16
5759,781113,2,0,0,0,0,0,0,0,0,0,0,0,1,0,0,0,0
5760,797587,26,5,7,5,7,0,0,0,3,1,1,1,3,1,1,2,10
5760,786501,32,4,6,2,4,2,2,2,2,0,4,0,3,0,2,0,12
5760,781078,28,4,9,3,8,1,1,1,1,1,4,1,3,4,0,0,10
5760,786502,38,8,14,8,13,0,1,5,9,1,7,5,1,1,0,0,21
5760,781080,37,3,7,1,3,2,4,0,0,0,3,2,3,1,1,0,8
5760,791891,17,2,5,1,4,1,1,0,0,2,2,2,1,0,1,0,5
5760,797584,18,1,4,1,3,0,1,0,0,0,0,2,3,1,1,0,2
5760,781561,4,0,1,0,1,0,0,0,0,0,0,1,1,0,1,0,0
5761,786509,31,3,3,3,3,0,0,3,4,2,7,0,4,0,3,2,9
5761,786508,36,4,11,0,2,4,9,4,8,2,5,1,1,1,0,1,16
5761,786505,28,0,6,0,0,0,6,0,0,0,2,5,1,1,1,0,0
5761,785796,32,4,9,3,4,1,5,6,6,1,3,1,3,2,1,1,15
5761,797576,33,6,8,2,2,4,6,4,4,0,2,3,2,0,4,0,20
5761,797577,8,0,0,0,0,0,0,0,0,2,0,1,3,0,1,0,0
5761,797580,3,0,2,0,0,0,2,0,0,0,1,0,0,0,0,0,0
5761,791897,6,0,0,0,0,0,0,0,0,0,1,1,0,0,0,0,0
5761,786507,9,1,2,0,1,1,1,1,2,0,2,0,4,0,2,0,4
5761,781325,14,0,2,0,0,0,2,0,0,0,0,1,1,0,1,0,0
5762,792029,28,5,7,4,5,1,2,2,2,1,8,3,4,0,0,0,13
5762,761149,24,1,2,1,1,0,1,0,0,0,4,1,2,0,2,0,2
5762,792032,30,3,9,3,7,0,2,2,2,0,6,2,3,0,2,0,8
5762,792031,30,5,8,2,4,3,4,3,4,0,2,2,1,0,0,0,16
5762,780828,28,11,18,9,15,2,3,8,8,0,5,2,1,0,2,0,32
5762,797641,8,1,1,1,1,0,0,2,4,0,1,0,1,0,0,0,4
5762,797639,2,1,2,1,1,0,1,0,0,0,1,0,0,0,0,0,2
5762,797640,13,2,3,2,3,0,0,1,3,1,1,0,1,1,0,0,5
5762,797638,2,0,1,0,1,0,0,0,0,0,0,1,0,0,0,0,0
5762,797637,21,1,2,0,0,1,2,0,0,1,2,1,1,1,0,2,3
5762,797636,12,3,5,3,5,0,0,0,0,1,3,0,1,0,0,0,6
5762,792030,2,0,0,0,0,0,0,0,0,0,2,1,1,0,0,0,0
5763,780570,15,2,3,2,3,0,0,0,0,1,1,0,4,0,2,0,4
5763,780569,34,4,6,4,6,0,0,0,0,2,1,1,1,0,2,1,8
5763,791697,27,3,12,2,8,1,4,1,2,0,2,1,2,0,2,0,8
5763,791696,35,3,12,1,8,2,4,3,6,0,4,1,2,1,0,0,11
5763,780565,25,5,9,5,7,0,2,0,0,0,6,4,1,0,1,0,10
5763,797433,5,0,1,0,1,0,0,0,1,0,1,0,1,0,0,0,0
5763,791693,1,0,0,0,0,0,0,0,0,0,0,0,2,0,0,0,0
5763,797432,18,1,6,0,2,1,4,0,2,0,1,0,2,0,0,0,3
5763,797436,12,2,5,0,0,2,5,0,0,0,3,1,1,0,0,0,6
5763,791694,2,1,1,1,1,0,0,0,0,1,0,0,0,0,0,0,2
5763,791695,2,0,1,0,1,0,0,0,0,0,0,0,0,0,0,0,0
5763,785824,18,1,4,0,3,1,1,2,2,1,2,0,3,1,1,0,5
5763,781556,6,1,3,1,3,0,0,0,0,0,0,0,1,0,0,0,2
5764,785664,15,0,1,0,1,0,0,0,2,2,3,1,0,0,0,0,0
5764,785841,28,4,6,3,3,1,3,2,3,2,5,0,2,2,4,1,11
5764,796609,23,6,16,4,9,2,7,3,5,0,0,1,2,2,2,0,17
5764,796611,14,3,6,2,2,1,4,1,1,2,1,0,1,0,0,0,8
5764,792869,25,1,3,1,2,0,1,0,0,0,2,2,0,2,1,0,2
5764,796613,16,1,6,0,2,1,4,0,0,2,2,0,2,0,1,0,3
5764,792232,10,1,3,1,2,0,1,0,0,1,1,1,2,0,0,0,2
5764,791312,10,0,1,0,1,0,0,1,2,1,1,0,2,0,0,1,1
5764,785840,3,0,0,0,0,0,0,0,0,0,1,0,0,0,0,0,0
5764,786685,21,0,5,0,4,0,1,1,2,1,1,1,0,0,2,0,1
5764,781504,26,4,11,2,7,2,4,4,5,0,1,2,2,1,3,2,14
5764,766623,9,1,4,1,3,0,1,1,2,0,1,0,3,1,2,0,3
5765,791135,24,3,7,3,7,0,0,3,4,2,8,1,3,0,0,0,9
5765,791132,30,5,9,3,3,2,6,3,3,2,7,1,2,4,2,0,15
5765,786090,32,5,15,5,12,0,3,1,1,0,4,0,3,1,3,0,11
5765,786088,32,1,2,1,1,0,1,0,0,1,3,3,2,1,4,0,2
5765,774921,32,8,12,6,9,2,3,3,3,2,3,3,3,5,4,0,21
5765,791133,10,1,1,1,1,0,0,0,0,0,1,1,2,0,0,1,2
5765,791134,2,1,2,1,2,0,0,0,0,0,0,0,0,0,0,0,2
5765,785541,7,2,4,1,2,1,2,0,0,0,3,1,2,0,1,0,5
5765,786097,1,0,0,0,0,0,0,0,0,0,1,0,0,0,0,0,0
5765,791521,4,0,0,0,0,0,0,0,0,0,0,0,0,0,0,0,0
5765,796791,26,4,7,0,2,4,5,0,0,0,1,0,0,0,3,0,12
5766,774806,21,5,5,5,5,0,0,1,2,0,5,2,5,0,2,3,11
5766,775823,25,7,9,6,8,1,1,1,2,1,7,3,3,0,5,0,16
5766,791041,38,5,10,1,2,4,8,2,2,1,5,3,3,0,2,0,16
5766,791038,34,4,13,2,5,2,8,4,4,0,3,4,1,0,2,0,14
5766,789023,40,6,15,2,6,4,9,2,4,1,3,8,2,1,1,0,18
5766,796716,2,0,1,0,1,0,0,0,0,0,0,0,0,0,0,0,0
5766,796714,19,1,1,1,1,0,0,1,2,3,4,1,1,0,0,1,3
5766,775205,21,2,5,0,0,2,5,5,5,0,4,0,2,0,1,0,11
5767,796892,15,4,6,4,6,0,0,0,1,2,2,1,3,0,3,0,8
5767,796891,30,8,15,7,13,1,2,6,6,1,8,4,4,1,1,2,23
5767,796884,33,7,12,5,7,2,5,1,2,3,2,2,3,1,0,0,17
5767,796882,34,5,14,4,10,1,4,6,8,0,3,2,0,5,2,0,17
5767,790447,21,1,6,0,4,1,2,0,0,0,3,4,5,0,1,1,3
5767,796890,1,0,1,0,0,0,1,0,0,0,0,0,0,0,0,0,0
5767,796886,20,1,2,1,1,0,1,2,2,2,2,0,1,0,1,1,4
5767,796896,25,1,6,1,4,0,2,0,0,1,3,4,4,1,2,0,2
5767,796888,7,0,1,0,0,0,1,0,0,0,0,0,1,0,0,0,0
5767,796887,12,0,4,0,1,0,3,0,0,0,1,1,0,0,0,0,0
5767,796894,1,0,0,0,0,0,0,0,0,0,0,0,0,0,0,0,0
5767,796881,1,0,0,0,0,0,0,0,0,0,0,0,0,0,0,0,0
5768,791416,26,2,7,2,7,0,0,5,7,4,6,0,2,2,0,1,9
5768,781614,30,4,6,3,3,1,3,2,2,2,8,0,0,2,2,0,11
5768,797096,18,0,3,0,0,0,3,0,0,0,2,1,3,0,0,0,0
5768,785906,36,11,18,8,15,3,3,0,0,1,1,4,1,0,2,0,25
5768,780096,38,8,13,4,4,4,9,4,4,0,4,1,2,1,1,0,24
5768,797093,26,3,4,3,4,0,0,2,2,1,3,8,2,1,3,0,8
5768,780100,12,0,1,0,0,0,1,0,0,0,3,1,2,0,2,0,0
5768,785907,13,1,5,1,5,0,0,1,2,0,1,0,2,0,2,0,3
5768,791415,1,0,1,0,1,0,0,0,0,0,0,0,0,0,0,0,0
5769,780027,28,9,18,8,15,1,3,0,1,2,2,1,4,1,0,0,19
5769,786176,32,6,13,1,6,5,7,2,2,1,3,1,2,0,2,0,19
5769,780028,32,4,9,2,4,2,5,1,1,1,2,5,3,1,2,0,11
5769,774828,28,2,6,0,1,2,5,0,0,0,2,5,0,0,2,0,6
5769,780029,14,2,7,2,5,0,2,0,0,1,2,0,3,1,0,4,4
5769,791380,13,3,5,3,5,0,0,0,0,1,0,0,1,1,2,0,6
5769,791379,14,0,3,0,3,0,0,0,0,1,1,2,2,0,0,0,0
5769,797178,7,1,2,1,2,0,0,0,1,1,2,2,0,0,0,0,2
5769,797175,32,4,9,4,6,0,3,0,1,3,5,1,0,0,0,0,8
5770,785524,29,5,9,3,5,2,4,2,2,1,2,1,5,0,0,1,14
5770,780739,29,9,13,8,12,1,1,1,1,3,0,3,5,1,3,0,20
5770,791053,24,3,4,3,4,0,0,2,2,0,5,2,3,1,1,1,8
5770,775456,33,7,11,5,8,2,3,0,0,0,7,4,1,0,5,0,16
5770,781115,24,1,4,1,4,0,0,1,2,0,1,5,5,0,1,0,3
5770,791051,10,0,0,0,0,0,0,0,0,2,1,0,1,0,0,0,0
5770,790819,11,1,3,1,2,0,1,3,4,0,1,3,1,0,2,0,5
5770,785784,1,0,0,0,0,0,0,0,0,0,0,0,1,0,0,0,0
5770,775094,10,0,4,0,2,0,2,0,0,0,0,1,1,0,1,0,0
5770,796730,14,4,7,2,2,2,5,0,0,0,2,0,2,0,0,0,10
5770,796731,10,2,2,2,2,0,0,1,1,0,0,0,4,0,1,1,5
5770,786310,5,1,2,1,1,0,1,1,2,0,3,0,1,1,0,0,3
5771,785829,9,0,0,0,0,0,0,0,2,0,1,0,1,2,0,0,0
5771,791048,26,3,4,2,3,1,1,4,7,1,0,1,3,1,0,1,11
5771,786531,36,7,10,2,5,5,5,2,3,0,1,3,2,0,1,0,21
5771,796726,34,5,11,4,7,1,4,7,7,0,1,2,0,2,0,0,18
5771,775838,28,6,11,6,10,0,1,2,2,2,7,2,5,1,3,0,14
5771,796724,2,0,2,0,2,0,0,0,0,1,0,0,0,0,0,0,0
5771,791044,4,0,0,0,0,0,0,0,0,0,1,0,0,0,0,0,0
5771,796729,25,4,7,1,2,3,5,11,14,0,3,2,3,0,3,0,22
5771,780723,20,0,1,0,1,0,0,0,0,1,2,1,3,0,1,0,0
5771,796727,16,1,4,0,0,1,4,1,2,0,0,0,0,1,0,0,4
5784,798153,8,0,1,0,1,0,0,1,2,0,0,0,1,0,0,0,1
5784,789025,29,3,4,3,4,0,0,1,2,0,3,1,1,1,0,0,7
5784,782157,22,5,9,5,9,0,0,0,0,1,3,9,3,2,1,0,10
5784,774985,21,9,15,7,11,2,4,2,3,0,4,1,2,4,3,0,22
5784,775276,19,3,7,2,5,1,2,0,0,1,1,0,0,0,0,2,7
5784,792666,16,3,7,3,4,0,3,0,0,0,0,0,2,2,0,1,6
5784,780852,23,3,4,3,4,0,0,2,4,4,1,1,1,1,1,1,8
5784,798152,24,5,11,4,8,1,3,1,2,2,4,6,3,4,1,0,12
5784,792670,20,6,8,1,1,5,7,0,0,1,4,2,4,0,1,0,17
5784,792669,18,2,6,2,5,0,1,0,0,0,3,5,4,3,4,0,4
5786,792227,31,3,8,2,3,1,5,0,0,1,4,2,2,0,2,1,7
5786,781352,20,4,11,4,11,0,0,3,6,1,3,0,3,1,0,2,11
5786,792223,24,3,8,2,3,1,5,2,2,1,2,2,4,1,1,0,9
5786,785935,38,5,12,5,9,0,3,4,6,2,3,3,3,0,0,0,14
5786,781340,32,1,11,1,9,0,2,1,2,7,5,2,3,2,3,0,3
5786,797881,8,0,1,0,1,0,0,0,0,1,1,0,0,0,0,0,0
5786,797889,12,3,5,3,5,0,0,0,0,2,1,1,2,0,0,0,6
5786,781351,9,2,3,2,2,0,1,0,0,0,0,0,2,0,0,0,4
5786,776128,26,2,5,0,0,2,5,0,0,0,3,3,2,0,1,0,6
5787,792334,31,3,6,2,5,1,1,4,6,2,8,2,2,0,5,0,11
5787,786575,28,3,5,3,5,0,0,2,2,1,4,2,4,0,0,2,8
5787,798094,23,0,2,0,2,0,0,0,0,0,1,2,2,0,0,0,0
5787,792338,30,3,9,3,7,0,2,2,2,0,8,1,3,0,0,0,8
5787,781666,34,7,15,4,7,3,8,4,8,1,4,0,1,1,2,0,21
5787,798097,11,2,3,2,3,0,0,0,1,1,2,1,4,0,2,0,4
5787,785531,7,0,2,0,0,0,2,2,2,0,0,0,1,0,0,0,2
5787,799842,19,2,2,2,2,0,0,1,3,0,0,1,3,0,0,0,5
5787,791636,17,1,2,0,0,1,2,0,0,0,0,1,0,1,3,0,3
5788,775110,36,4,7,4,7,0,0,5,8,6,9,0,3,1,1,3,13
5788,791392,32,4,5,4,4,0,1,0,0,0,6,1,3,2,0,0,8
5788,785936,25,1,3,0,0,1,3,0,0,4,2,2,2,1,2,0,3
5788,780128,35,6,18,4,9,2,9,0,0,0,1,4,4,0,3,1,14
5788,775458,36,10,18,7,12,3,6,3,4,2,4,1,1,0,4,0,26
5788,786062,4,0,0,0,0,0,0,0,0,1,1,1,0,0,0,1,0
5788,797138,8,0,1,0,1,0,0,2,2,0,0,0,1,0,0,0,2
5788,797135,15,1,7,0,3,1,4,2,4,0,4,2,0,0,0,0,5
5788,785264,9,1,4,1,2,0,2,0,0,0,0,1,0,0,0,0,2
5789,792036,20,1,5,1,4,0,1,0,0,0,3,0,3,0,1,0,2
5789,792043,30,3,6,1,3,2,3,0,0,0,6,0,3,1,1,0,8
5789,786266,25,3,8,2,3,1,5,3,3,0,2,2,3,0,1,0,10
5789,792040,27,2,4,1,2,1,2,0,0,0,3,1,1,0,0,1,5
5789,775028,33,8,22,6,15,2,7,2,2,1,6,4,2,1,1,0,20
5789,786039,22,5,5,5,5,0,0,0,0,2,2,0,3,0,3,0,10
5789,797723,7,1,3,1,2,0,1,0,0,0,1,0,0,0,0,0,2
5789,797719,13,1,4,0,1,1,3,0,0,0,1,0,0,0,0,0,3
5789,797718,23,2,4,1,2,1,2,3,4,0,0,1,1,2,1,0,8
5790,797466,24,1,3,1,1,0,2,0,0,0,7,2,2,1,4,1,2
5790,791858,38,4,11,2,5,2,6,0,0,2,3,1,2,0,1,0,10
5790,797463,32,7,14,3,6,4,8,1,2,1,3,3,2,2,3,0,19
5790,791109,38,2,5,1,4,1,1,0,0,0,3,4,3,1,3,1,5
5790,785625,34,3,5,0,0,3,5,0,0,1,5,2,3,1,3,2,9
5790,797468,4,0,0,0,0,0,0,0,2,0,0,0,0,0,2,0,0
5790,797464,11,0,1,0,0,0,1,0,0,0,2,0,2,0,0,0,0
5790,797467,2,0,0,0,0,0,0,0,0,0,1,0,0,0,0,0,0
5790,797469,12,0,1,0,1,0,0,0,0,0,0,0,2,0,1,0,0
5790,797465,2,0,1,0,0,0,1,0,0,0,0,0,1,0,1,0,0
5790,791854,3,0,0,0,0,0,0,0,0,0,2,0,1,0,1,0,0
5791,797174,30,3,6,2,3,1,3,0,0,1,3,1,2,1,3,0,7
5791,786699,23,3,3,3,3,0,0,1,4,3,3,0,1,3,1,0,7
5791,785593,28,4,10,3,5,1,5,4,6,1,2,0,1,4,1,0,13
5791,775357,31,0,10,0,4,0,6,0,1,1,1,2,0,0,1,0,0
5791,791507,17,1,3,1,3,0,0,2,2,1,3,0,1,0,1,0,4
5791,797168,22,2,7,2,6,0,1,2,4,0,3,4,2,1,1,0,6
5791,791508,2,0,0,0,0,0,0,0,0,1,0,0,0,0,0,0,0
5791,791504,28,3,7,1,4,2,3,1,2,2,2,2,2,1,2,0,9
5791,791510,19,1,3,1,2,0,1,1,1,1,2,0,1,0,1,0,3
5792,797235,26,4,4,4,4,0,0,0,0,1,1,0,0,1,2,1,8
5792,797232,30,3,7,2,3,1,4,2,2,0,2,3,3,0,3,1,9
5792,797237,22,2,5,1,1,1,4,0,2,0,0,0,2,1,3,0,5
5792,797234,27,5,9,5,7,0,2,0,0,1,7,3,1,0,2,0,10
5792,797239,23,4,6,2,3,2,3,0,0,0,2,2,4,1,2,1,10
5792,797236,1,0,1,0,1,0,0,2,2,2,0,1,0,0,0,0,2
5792,797233,4,0,0,0,0,0,0,0,0,0,0,0,1,0,0,0,0
5792,791368,12,1,3,1,2,0,1,0,1,1,1,0,0,0,0,0,2
5792,797238,8,0,0,0,0,0,0,0,0,0,0,0,0,0,0,0,0
5792,786535,1,0,0,0,0,0,0,0,0,0,0,0,1,0,1,0,0
5792,786251,2,0,0,0,0,0,0,2,2,1,2,0,0,0,0,1,2
5792,797240,11,2,3,0,0,2,3,0,0,0,0,2,0,0,1,0,6
5792,785446,12,1,5,0,2,1,3,0,0,0,0,2,1,0,1,0,3
5792,791367,19,2,4,2,4,0,0,3,4,0,2,2,0,1,1,0,7
5792,791369,2,1,3,0,1,1,2,0,0,1,0,0,0,0,0,0,3
5793,796617,17,3,4,3,4,0,0,0,0,0,1,2,1,2,2,0,6
5793,775131,30,4,8,2,3,2,5,2,2,1,2,2,2,1,1,0,12
5793,796616,26,1,3,1,1,0,2,0,0,0,0,3,0,3,1,0,2
5793,796612,23,6,9,5,8,1,1,1,1,1,2,3,1,2,0,0,14
5793,785562,26,9,13,9,12,0,1,3,4,1,5,3,0,2,0,0,21
5793,792429,12,1,2,1,2,0,0,0,0,0,1,0,1,0,0,0,2
5793,796618,3,0,1,0,1,0,0,0,0,0,0,1,1,1,0,0,0
5793,796619,6,1,2,1,2,0,0,0,0,1,0,0,2,0,1,0,2
5793,796614,11,1,6,1,5,0,1,0,0,0,0,0,2,0,2,0,2
5793,796610,3,0,0,0,0,0,0,0,0,0,0,0,1,0,0,0,0
5793,796607,18,7,9,6,8,1,1,6,6,0,2,2,1,1,0,0,21
5793,796606,25,1,2,1,2,0,0,0,0,1,5,3,1,0,0,0,2
5794,785495,35,6,14,5,9,1,5,1,2,2,3,3,2,1,0,0,14
5794,785958,33,5,9,5,8,0,1,4,4,6,6,4,3,2,3,0,14
5794,791130,15,1,7,0,1,1,6,3,5,0,1,1,4,1,1,0,6
5794,785494,35,4,9,2,5,2,4,1,1,1,3,4,2,1,2,0,11
5794,780698,38,7,11,4,7,3,4,1,2,0,3,1,0,2,3,3,18
5794,785490,3,0,1,0,0,0,1,0,0,0,0,0,0,1,0,0,0
5794,785659,14,3,6,3,5,0,1,2,4,1,0,1,2,0,1,0,8
5794,775377,9,0,0,0,0,0,0,0,0,1,2,0,1,1,0,0,0
5794,780427,18,1,6,0,2,1,4,1,2,0,2,0,3,2,4,0,4
5795,792197,24,7,13,4,4,3,9,0,0,0,4,1,4,3,0,0,17
5795,781132,36,3,8,3,5,0,3,0,0,1,7,2,4,0,3,1,6
5795,797517,37,8,10,8,10,0,0,5,9,4,2,2,2,1,1,0,21
5795,791940,33,4,8,2,3,2,5,0,0,1,2,1,1,1,3,1,10
5795,786534,39,7,15,7,14,0,1,0,0,0,9,4,4,0,6,0,14
5795,797522,3,0,1,0,1,0,0,0,0,0,0,0,2,0,0,0,0
5795,786539,4,0,0,0,0,0,0,0,0,0,0,1,1,0,0,0,0
5795,797518,12,1,2,1,2,0,0,3,3,0,1,1,2,0,2,0,5
5795,791938,12,1,2,0,0,1,2,0,0,0,1,2,0,0,0,0,3
5796,791042,33,8,13,8,13,0,0,4,6,1,8,1,1,0,2,2,20
5796,774834,17,1,1,1,1,0,0,2,4,1,2,0,4,0,1,1,4
5796,791043,35,6,16,3,4,3,12,0,0,1,3,4,4,0,1,0,15
5796,776374,22,2,4,2,3,0,1,0,1,0,1,8,2,1,1,0,4
5796,775412,31,7,12,1,2,6,10,1,2,1,4,2,4,3,1,0,21
5796,796723,15,1,3,1,1,0,2,0,0,0,2,0,1,0,0,0,2
5796,796719,21,1,5,1,3,0,2,4,4,1,3,1,1,1,0,0,6
5796,796718,6,1,1,1,1,0,0,0,1,0,1,0,0,0,0,0,2
5796,796717,18,1,3,1,3,0,0,0,0,0,3,3,1,0,0,0,2
5796,796720,2,0,1,0,1,0,0,0,0,0,0,0,0,0,0,0,0
5797,790511,18,1,5,1,5,0,0,0,0,1,2,3,3,0,0,0,2
5797,780194,27,2,6,2,6,0,0,2,4,2,0,2,4,1,2,2,6
5797,785706,28,3,6,0,0,3,6,0,0,0,3,1,1,0,0,0,9
5797,785700,33,8,13,6,9,2,4,0,0,1,4,2,4,0,2,0,18
5797,780269,36,5,12,4,10,1,2,8,8,0,4,3,1,1,5,0,19
5797,796837,22,2,3,2,2,0,1,3,6,1,5,3,1,0,0,1,7
5797,791171,12,2,7,2,7,0,0,1,1,0,5,1,2,1,0,0,5
5797,786721,21,2,4,2,2,0,2,0,1,1,5,0,3,0,1,0,4
5797,796838,1,0,0,0,0,0,0,0,0,0,0,0,3,0,0,0,0
5797,796833,2,0,1,0,1,0,0,0,0,0,0,0,0,0,0,0,0
5798,791882,18,3,6,3,5,0,1,0,0,1,2,0,2,0,2,0,6
5798,786493,28,1,5,1,3,0,2,4,4,0,1,1,5,0,3,0,6
5798,786491,26,1,5,1,4,0,1,3,4,0,1,0,3,0,3,1,5
5798,791881,23,4,7,3,5,1,2,2,3,0,2,1,5,0,2,0,11
5798,786420,37,12,22,9,13,3,9,4,6,0,3,4,2,0,2,1,31
5798,797616,22,2,5,2,4,0,1,0,0,4,3,0,1,1,1,0,4
5798,797614,0,0,0,0,0,0,0,0,0,0,0,0,0,0,0,0,0
5798,797613,22,1,4,0,0,1,4,0,0,0,2,0,1,0,0,0,3
5798,781052,24,4,5,0,0,4,5,0,0,1,1,0,2,0,0,0,12
5799,791787,31,6,12,6,11,0,1,7,7,0,5,1,2,0,5,1,19
5799,789048,31,3,6,3,6,0,0,4,6,4,6,0,0,1,1,0,10
5799,789046,25,3,5,3,5,0,0,4,4,0,3,3,2,1,3,0,10
5799,797630,27,4,8,3,5,1,3,2,2,0,4,0,2,1,1,0,11
5799,789041,25,5,6,3,3,2,3,0,0,0,2,4,4,2,2,0,12
5799,791785,27,2,4,1,3,1,1,1,2,1,1,1,0,0,1,0,6
5799,785540,12,1,4,1,4,0,0,3,4,1,4,0,3,0,0,0,5
5799,797631,14,2,4,1,2,1,2,3,3,0,0,1,2,2,0,0,8
5799,797629,7,0,1,0,1,0,0,1,2,0,0,0,0,0,2,0,1
5799,789044,1,0,0,0,0,0,0,0,0,0,0,0,1,0,0,0,0
5800,791289,32,3,5,3,5,0,0,1,2,1,6,0,4,5,1,3,7
5800,785786,27,2,5,2,3,0,2,2,4,3,2,1,2,0,1,2,6
5800,796574,23,2,7,2,3,0,4,1,1,1,2,3,2,0,2,0,5
5800,796571,31,2,8,1,4,1,4,0,0,1,6,2,2,2,2,0,5
5800,781346,32,6,13,2,4,4,9,0,0,1,2,4,1,2,3,0,16
5800,796576,26,2,8,0,2,2,6,0,2,1,3,2,2,0,1,0,6
5800,791290,8,2,5,1,1,1,4,0,0,0,1,0,1,0,0,1,5
5800,796572,21,1,3,1,3,0,0,3,6,2,2,0,5,0,2,0,5
5801,797877,33,7,16,7,16,0,0,3,5,3,6,0,2,0,1,0,17
5801,797873,22,4,8,4,8,0,0,4,8,5,3,1,3,1,2,1,12
5801,797872,27,0,3,0,2,0,1,0,0,1,0,2,3,1,0,0,0
5801,791338,30,1,3,1,3,0,0,6,8,0,5,4,1,1,2,0,8
5801,791339,30,4,12,3,8,1,4,2,3,1,4,4,1,0,3,0,11
5801,791337,11,1,1,1,1,0,0,0,0,0,0,0,2,0,1,0,2
5801,781599,15,0,2,0,1,0,1,0,0,1,5,1,0,0,1,0,0
5801,797875,12,0,1,0,0,0,1,2,2,0,0,1,1,2,0,0,2
5801,781595,20,3,6,2,2,1,4,0,0,0,3,0,0,0,1,0,7
5802,792265,37,9,19,8,15,1,4,4,6,4,8,1,1,1,0,1,23
5802,792266,23,3,7,3,6,0,1,4,4,0,2,0,2,0,3,1,10
5802,786152,22,2,6,2,6,0,0,0,0,2,5,1,5,1,0,3,4
5802,798003,26,5,8,4,7,1,1,6,6,1,2,2,4,1,3,1,17
5802,792267,31,2,5,2,4,0,1,2,2,0,6,0,4,0,3,0,6
5802,798007,14,0,1,0,1,0,0,2,4,2,4,1,3,1,1,0,2
5802,798002,6,0,0,0,0,0,0,1,2,2,1,1,2,0,2,0,1
5802,798009,27,2,8,1,4,1,4,3,4,0,1,1,2,0,3,0,8
5802,798006,10,0,0,0,0,0,0,0,0,0,2,0,0,0,1,0,0
5802,792263,4,0,0,0,0,0,0,0,0,0,0,0,0,1,0,0,0
5803,780832,27,2,4,2,4,0,0,5,9,3,6,0,3,1,0,1,9
5803,790961,33,5,9,5,9,0,0,5,6,1,3,2,2,3,1,0,15
5803,786240,7,0,2,0,1,0,1,0,0,0,0,2,0,1,2,0,0
5803,785278,35,3,11,3,7,0,4,2,2,0,5,1,2,1,4,1,8
5803,780146,32,4,13,4,8,0,5,1,4,1,2,2,4,2,1,0,9
5803,796556,3,0,1,0,1,0,0,0,0,0,0,0,0,1,0,0,0
5803,796554,13,1,3,1,3,0,0,0,0,1,2,0,3,0,0,0,2
5803,796557,3,0,1,0,1,0,0,0,0,0,0,0,0,0,0,0,0
5803,796555,13,2,4,1,1,1,3,0,0,0,0,0,3,0,0,0,5
5803,796553,0,0,0,0,0,0,0,0,0,0,0,0,0,0,0,0,0
5803,775860,34,3,12,2,6,1,6,7,7,1,4,2,4,1,1,0,14
5804,780521,37,5,13,1,4,4,9,2,2,0,6,3,2,1,3,0,16
5804,775163,24,3,3,3,3,0,0,0,0,1,3,4,1,0,1,3,6
5804,791370,26,3,9,1,4,2,5,2,4,0,2,2,2,0,2,0,10
5804,786199,38,4,9,3,6,1,3,3,3,1,8,3,1,1,4,0,12
5804,780991,26,2,7,0,3,2,4,0,0,0,2,1,4,1,1,1,6
5804,797269,3,0,0,0,0,0,0,0,0,0,0,0,0,0,0,0,0
5804,780145,8,0,0,0,0,0,0,0,0,0,0,0,3,0,0,0,0
5804,781611,5,1,2,1,2,0,0,1,2,2,2,0,1,0,0,0,3
5804,797271,17,5,7,4,4,1,3,0,0,0,0,1,0,0,2,0,11
5804,743593,13,1,5,1,5,0,0,0,1,2,1,1,2,0,0,0,2
5804,791371,3,0,1,0,1,0,0,0,0,0,0,0,0,0,1,0,0
5805,797529,31,4,8,3,7,1,1,2,2,4,8,2,5,2,1,0,11
5805,797527,33,5,8,5,7,0,1,1,1,1,2,0,2,3,2,1,11
5805,791936,36,5,10,5,10,0,0,1,4,1,6,4,2,2,0,0,11
5805,797532,39,5,17,2,10,3,7,5,6,2,1,9,0,1,1,0,18
5805,785688,23,2,7,0,2,2,5,1,2,0,3,0,0,0,1,0,7
5805,791931,2,0,1,0,1,0,0,0,0,1,1,0,0,0,0,0,0
5805,791932,15,3,4,1,1,2,3,0,0,0,0,1,2,1,0,0,8
5805,791933,2,0,0,0,0,0,0,0,0,0,0,0,0,0,0,0,0
5805,785988,19,5,11,2,2,3,9,2,4,1,2,0,0,1,1,0,15
5806,791062,33,7,14,5,10,2,4,7,8,0,5,0,0,1,3,1,23
5806,791063,28,4,9,4,8,0,1,2,2,2,5,9,3,0,0,0,10
5806,796735,18,1,1,1,1,0,0,0,0,0,1,2,3,1,2,0,2
5806,785542,38,3,3,3,3,0,0,4,6,2,3,2,0,2,1,0,10
5806,780743,36,4,11,3,6,1,5,0,1,3,4,2,2,0,1,0,9
5806,785548,16,1,2,1,2,0,0,0,0,1,1,1,4,0,1,0,2
5806,796737,5,0,0,0,0,0,0,0,0,0,1,0,2,0,2,0,0
5806,791064,26,1,9,0,3,1,6,0,2,1,2,0,3,0,1,0,3
5807,796766,32,3,6,2,2,1,4,1,2,0,4,1,1,0,0,0,8
5807,785614,9,1,1,1,1,0,0,0,0,0,0,0,4,0,2,0,2
5807,796767,30,2,7,2,4,0,3,3,3,1,3,3,3,0,3,0,7
5807,796765,22,1,5,1,3,0,2,0,0,1,1,2,4,0,3,0,2
5807,780812,39,6,13,4,9,2,4,3,4,0,4,3,2,4,1,0,17
5807,791113,29,3,7,3,6,0,1,2,2,0,4,1,1,1,1,1,8
5807,785618,11,2,4,0,0,2,4,0,0,0,2,0,3,0,1,0,6
5807,780813,28,3,5,3,5,0,0,2,3,1,4,2,3,0,1,0,8
5808,786838,24,2,6,2,6,0,0,0,2,0,7,1,5,1,2,6,4
5808,792131,23,2,4,1,3,1,1,0,0,1,6,0,3,1,2,1,5
5808,797736,24,5,9,2,3,3,6,0,0,0,5,1,3,1,2,0,13
5808,792132,26,5,8,2,4,3,4,2,5,0,0,3,2,0,5,0,15
5808,792127,35,0,3,0,2,0,1,0,0,2,3,5,3,0,1,1,0
5808,799273,4,0,1,0,1,0,0,2,2,2,2,0,1,0,0,0,2
5808,792128,25,3,8,3,8,0,0,6,8,2,5,0,2,0,3,0,12
5808,799908,6,0,1,0,0,0,1,0,0,0,0,0,1,0,0,0,0
5808,797739,4,0,2,0,0,0,2,0,0,0,1,0,1,0,0,0,0
5808,792126,16,1,2,1,1,0,1,1,2,0,2,0,1,0,0,0,3
5808,791668,13,2,3,1,2,1,1,0,0,0,0,1,2,0,1,0,5
5809,786404,28,2,7,1,3,1,4,2,4,0,1,0,3,2,1,0,7
5809,780378,27,4,11,4,11,0,0,5,11,2,4,0,4,0,2,1,13
5809,786374,35,4,8,4,8,0,0,1,3,1,7,4,3,2,0,1,9
5809,786253,23,3,9,2,5,1,4,4,4,0,1,1,4,0,4,0,11
5809,780121,5,0,0,0,0,0,0,0,0,0,0,0,2,0,0,0,0
5809,780382,13,0,0,0,0,0,0,0,0,1,3,0,2,0,0,0,0
5809,797065,10,0,0,0,0,0,0,0,0,0,2,0,0,0,0,0,0
5809,797061,5,0,1,0,0,0,1,0,0,0,2,0,1,0,2,0,0
5809,791562,8,0,0,0,0,0,0,2,2,0,1,0,0,0,1,0,2
5809,786378,25,3,7,1,2,2,5,2,3,1,0,4,3,3,1,0,10
5809,785798,21,1,7,0,4,1,3,0,1,1,1,0,1,0,1,0,3
5810,775599,31,7,15,6,11,1,4,4,5,1,6,1,3,0,0,0,19
5810,792344,29,1,3,1,1,0,2,0,0,0,1,2,4,1,1,0,2
5810,792341,36,5,8,3,6,2,2,0,0,1,0,0,5,1,2,0,12
5810,792342,37,2,8,1,4,1,4,0,0,0,2,7,4,0,2,0,5
5810,792346,38,5,13,5,12,0,1,2,3,2,5,3,3,2,3,0,12
5810,798085,6,0,2,0,0,0,2,5,6,0,2,0,1,1,0,0,5
5810,798080,22,4,6,0,0,4,6,0,0,1,1,0,5,0,0,0,12
5810,798088,1,0,0,0,0,0,0,0,0,0,0,0,0,0,0,0,0
5811,797620,25,0,3,0,2,0,1,2,2,1,3,2,3,0,2,1,2
5811,781044,32,2,5,2,4,0,1,5,6,1,9,2,2,0,0,1,9
5811,786489,30,3,7,1,3,2,4,2,2,0,4,1,2,1,1,1,10
5811,786488,33,4,6,4,6,0,0,7,8,0,4,0,0,1,1,0,15
5811,781038,34,5,8,5,5,0,3,4,6,0,3,1,2,1,3,0,14
5811,791796,2,0,0,0,0,0,0,0,0,0,0,1,0,0,1,0,0
5811,786490,4,1,2,1,2,0,0,0,0,1,0,0,0,0,1,0,2
5811,797619,25,3,5,3,5,0,0,4,7,1,2,0,3,1,2,0,10
5811,786487,15,3,4,2,3,1,1,2,2,0,2,2,2,0,2,0,9
5812,786481,35,7,10,7,10,0,0,11,12,2,12,4,2,1,4,1,25
5812,797626,25,2,3,2,2,0,1,1,2,0,4,1,1,0,5,0,5
5812,797624,27,2,3,0,0,2,3,2,2,0,2,0,4,0,0,0,8
5812,786480,31,5,9,2,4,3,5,1,3,0,2,0,2,0,1,0,14
5812,781032,22,2,8,1,4,1,4,2,2,1,2,3,4,0,4,0,7
5812,797628,16,2,2,2,2,0,0,1,1,0,3,0,3,0,1,0,5
5812,791793,14,1,2,1,1,0,1,5,6,1,3,1,2,0,1,0,7
5812,791791,2,0,1,0,0,0,1,0,0,0,0,0,0,0,1,0,0
5812,785965,28,3,8,1,4,2,4,4,5,1,0,0,1,0,1,0,12
5813,797779,40,8,12,2,5,6,7,12,14,3,2,0,2,1,3,0,34
5813,785568,17,2,3,2,2,0,1,0,0,0,1,0,4,1,1,0,4
5813,797778,15,4,12,3,5,1,7,1,2,4,3,2,3,0,1,0,10
5813,786256,40,4,16,4,16,0,0,0,0,4,5,2,4,1,3,1,8
5813,797774,28,7,15,5,10,2,5,2,3,0,4,3,4,2,1,0,18
5813,797770,12,0,3,0,2,0,1,0,1,1,0,0,4,0,0,0,0
5813,797780,6,0,1,0,1,0,0,0,0,0,0,0,0,1,0,0,0
5813,797776,22,0,0,0,0,0,0,0,0,1,0,0,0,0,0,0,0
5813,797771,10,0,1,0,0,0,1,2,2,0,0,0,1,0,0,0,2
5813,797768,10,2,5,1,2,1,3,0,0,0,1,2,0,0,0,0,5
5813,775106,0,0,0,0,0,0,0,0,0,0,0,0,0,0,0,0,0
5814,776279,28,3,6,1,1,2,5,0,0,1,4,1,4,0,1,0,8
5814,781505,34,6,13,4,9,2,4,0,0,1,2,2,4,0,5,0,14
5814,780353,26,4,4,4,4,0,0,4,4,1,8,0,4,0,0,1,12
5814,791317,37,2,5,2,3,0,2,7,8,1,2,8,3,0,2,0,11
5814,777573,29,6,12,4,7,2,5,0,0,0,1,4,3,1,0,0,14
5814,786222,20,3,5,3,5,0,0,0,0,1,1,1,5,0,1,0,6
5814,796649,15,2,4,1,2,1,2,0,0,0,3,1,3,0,2,0,5
5814,790851,11,0,0,0,0,0,0,0,0,0,1,2,1,0,0,0,0
5815,791763,19,3,5,1,1,2,4,1,2,2,2,0,0,0,0,0,9
5815,775910,30,4,11,3,5,1,6,6,9,4,3,2,4,2,1,0,15
5815,786451,32,1,7,1,4,0,3,3,5,2,2,1,2,1,1,0,5
5815,780600,29,3,9,2,4,1,5,5,5,2,2,0,4,1,3,0,12
5815,781387,39,1,10,0,2,1,8,3,5,1,1,3,2,0,1,0,6
5815,786456,12,1,1,1,1,0,0,2,2,2,4,0,0,1,0,0,4
5815,781577,19,0,4,0,2,0,2,4,4,3,3,1,4,0,3,0,4
5815,797554,6,0,0,0,0,0,0,0,0,1,1,0,0,0,0,1,0
5815,780020,14,3,5,3,3,0,2,1,1,0,0,0,2,0,1,0,7
5816,786059,38,13,20,13,18,0,2,3,4,2,9,1,1,0,1,2,29
5816,776174,23,3,12,3,12,0,0,1,1,5,2,3,0,0,0,0,7
5816,791958,38,4,9,4,7,0,2,8,8,1,4,6,0,2,1,0,16
5816,791960,31,4,9,3,6,1,3,0,0,0,1,2,1,0,2,0,9
5816,785861,28,2,4,1,1,1,3,0,0,0,3,4,3,0,2,0,5
5816,797704,15,1,4,0,0,1,4,0,0,0,1,0,1,0,0,0,3
5816,781332,27,3,6,1,3,2,3,2,4,0,1,1,1,0,0,1,10
5817,785481,28,7,9,5,6,2,3,2,2,1,7,1,1,1,3,3,18
5817,780631,20,1,7,1,2,0,5,0,0,1,2,0,2,0,1,0,2
5817,797391,34,6,11,2,5,4,6,0,0,0,2,2,1,0,1,0,16
5817,786625,17,0,5,0,3,0,2,0,0,1,1,2,4,1,2,0,0
5817,780625,35,6,14,4,9,2,5,0,0,1,3,6,3,1,1,0,14
5817,797397,5,0,0,0,0,0,0,0,0,0,1,0,2,0,0,0,0
5817,791830,15,1,2,1,2,0,0,0,0,1,4,0,3,0,1,0,2
5817,797395,25,6,12,4,8,2,4,0,0,0,3,2,1,0,0,0,14
5817,786630,21,2,5,2,5,0,0,0,0,2,2,0,1,0,1,0,4
5818,791144,17,2,3,2,3,0,0,0,1,1,1,2,2,0,2,0,4
5818,791145,34,6,13,5,10,1,3,3,4,3,5,3,4,2,4,0,16
5818,785777,31,1,5,0,1,1,4,0,0,0,1,0,2,1,1,0,3
5818,785782,34,8,13,3,4,5,9,3,3,0,1,0,3,0,0,2,24
5818,791146,38,7,15,6,11,1,4,2,2,0,9,8,2,2,7,0,17
5818,791148,22,2,4,1,2,1,2,0,0,0,3,0,3,0,2,0,5
5818,791147,11,2,2,2,2,0,0,2,2,2,1,1,1,0,0,0,6
5818,796804,2,0,1,0,1,0,0,0,0,0,0,1,0,0,0,0,0
5818,786748,11,1,2,1,2,0,0,0,0,0,0,1,2,0,1,0,2
5819,781215,29,8,13,6,9,2,4,3,3,0,3,1,3,2,1,0,21
5819,791001,23,2,8,2,6,0,2,1,2,0,2,2,3,2,2,0,5
5819,775255,26,3,8,1,2,2,6,1,2,0,1,4,2,1,4,0,9
5819,781159,30,3,8,0,2,3,6,8,10,1,6,2,2,2,4,4,17
5819,781174,33,5,7,5,7,0,0,2,5,6,3,2,2,1,1,1,12
5819,785231,25,5,5,3,3,2,2,1,6,0,2,2,1,0,0,0,13
5819,785320,16,1,2,1,2,0,0,2,2,0,2,2,1,0,0,0,4
5819,779972,16,2,4,2,3,0,1,0,0,0,1,3,2,1,1,0,4
5819,796643,2,0,0,0,0,0,0,0,0,0,0,0,0,0,0,0,0
5820,791334,34,2,4,1,2,1,2,4,4,0,5,1,1,0,2,0,9
5820,796883,29,2,7,1,4,1,3,0,0,0,0,5,0,0,1,0,5
5820,785874,18,1,5,1,4,0,1,0,0,0,5,1,2,2,1,0,2
5820,796879,15,0,3,0,2,0,1,0,0,0,1,0,1,1,0,0,0
5820,780256,25,6,8,4,4,2,4,0,0,0,5,1,3,0,0,0,14
5820,796880,28,3,8,2,4,1,4,0,0,1,1,1,3,2,3,0,7
5820,791760,22,5,13,5,11,0,2,2,2,2,4,0,3,1,3,0,12
5820,791757,14,1,3,1,2,0,1,0,0,0,1,0,1,1,1,0,2
5820,781590,15,0,4,0,1,0,3,0,0,0,3,0,1,1,1,1,0
5821,786296,19,1,4,1,2,0,2,0,0,1,2,0,1,0,1,0,2
5821,792319,26,1,4,0,1,1,3,2,3,3,0,0,0,1,0,0,5
5821,792307,13,0,2,0,1,0,1,0,0,0,1,2,2,0,1,0,0
5821,781530,28,3,10,3,9,0,1,1,2,1,4,1,1,0,1,1,7
5821,776423,29,9,16,9,16,0,0,0,0,6,8,0,0,0,1,5,18
5821,798096,16,2,3,2,2,0,1,0,2,0,2,0,4,0,1,0,4
5821,792309,6,1,2,1,2,0,0,0,0,0,1,2,1,1,2,0,2
5821,798106,13,0,2,0,1,0,1,0,0,0,2,0,0,0,0,0,0
5821,792321,6,0,0,0,0,0,0,1,2,1,0,0,0,0,0,0,1
5821,792314,12,3,5,3,5,0,0,0,1,0,2,0,1,0,1,0,6
5821,798104,26,3,11,3,6,0,5,2,2,0,2,4,1,4,3,0,8
5821,792320,6,0,0,0,0,0,0,0,0,0,1,0,0,0,1,0,0
5856,796372,30,3,3,3,3,0,0,3,4,2,5,0,0,0,1,2,9
5856,786013,13,1,3,1,3,0,0,0,3,2,3,0,2,0,0,0,2
5856,796379,38,9,16,1,2,8,14,0,0,0,3,5,3,3,3,0,26
5856,790815,4,1,3,1,2,0,1,0,0,0,0,0,1,0,0,0,2
5856,780176,38,4,10,2,3,2,7,0,0,1,2,6,1,2,2,0,10
5856,796374,18,0,3,0,0,0,3,0,0,0,1,0,2,1,1,0,0
5856,796375,1,0,1,0,1,0,0,0,0,0,0,0,0,0,0,0,0
5856,796377,25,1,5,1,2,0,3,0,0,0,2,2,5,1,4,0,2
5856,796378,14,1,6,1,1,0,5,0,0,0,3,1,0,0,0,0,2
5856,790814,19,3,6,3,4,0,2,2,2,4,1,1,4,0,0,0,8
5857,792560,12,0,3,0,3,0,0,0,0,1,0,1,2,0,0,0,0
5857,792565,27,4,9,4,9,0,0,4,4,1,4,0,3,1,1,0,12
5857,798133,7,0,0,0,0,0,0,0,0,1,1,0,0,0,1,0,0
5857,792561,25,1,5,0,2,1,3,7,8,0,3,3,0,1,0,0,10
5857,780266,29,5,12,1,4,4,8,0,0,0,3,0,1,1,1,0,14
5857,776333,13,2,4,2,4,0,0,0,2,2,4,0,1,1,2,0,4
5857,792563,15,1,2,1,2,0,0,4,4,0,3,1,1,1,1,0,6
5857,798134,17,2,3,1,2,1,1,1,2,0,2,1,0,2,1,0,6
5857,780270,26,5,7,5,7,0,0,4,4,4,4,1,1,0,1,0,14
5857,798135,6,0,1,0,1,0,0,0,0,0,1,0,0,1,1,0,0
5857,785472,5,0,1,0,1,0,0,0,0,0,0,0,1,0,0,0,0
5857,798132,18,0,2,0,0,0,2,2,2,0,0,0,1,0,0,0,2
5858,796318,28,3,7,3,7,0,0,3,4,3,5,5,0,2,1,0,9
5858,790761,25,4,13,1,4,3,9,0,0,1,3,1,3,2,1,0,11
5858,790764,28,4,7,3,3,1,4,4,4,1,3,3,3,0,2,0,13
5858,796319,22,4,7,2,3,2,4,1,2,0,2,3,3,1,4,0,11
5858,779993,34,2,6,2,3,0,3,0,0,1,5,5,0,2,0,0,4
5858,796320,24,4,7,2,2,2,5,2,2,1,2,3,2,0,1,0,12
5858,796322,14,4,6,4,6,0,0,3,5,2,3,0,0,0,0,2,11
5858,785219,14,2,6,0,1,2,5,0,0,0,1,0,1,0,0,0,6
5858,796321,5,0,0,0,0,0,0,0,0,1,0,0,0,0,0,0,0
5858,779990,1,1,1,1,1,0,0,0,0,1,0,0,0,0,0,0,2
5858,775668,3,0,0,0,0,0,0,0,0,0,1,0,1,0,0,0,0
5858,796323,2,0,1,0,1,0,0,0,0,1,0,0,0,0,0,0,0
5859,785224,7,0,0,0,0,0,0,0,0,0,2,0,1,0,1,0,0
5859,780879,27,7,13,6,11,1,2,4,5,3,3,4,4,2,2,0,19
5859,790768,27,2,6,0,1,2,5,0,0,0,0,0,0,1,2,0,6
5859,785226,12,1,7,1,6,0,1,0,0,0,2,0,0,0,1,0,2
5859,780875,25,1,2,1,2,0,0,0,0,0,4,3,1,0,0,1,2
5859,775785,14,0,2,0,1,0,1,0,0,0,1,0,3,0,2,1,0
5859,790767,17,1,1,1,1,0,0,2,2,0,2,0,0,0,1,0,4
5859,796326,9,0,2,0,0,0,2,2,2,1,1,1,3,0,1,0,2
5859,790769,18,4,8,3,7,1,1,0,0,1,1,2,0,1,1,0,9
5859,796324,21,3,7,3,5,0,2,0,2,5,4,1,2,0,1,0,6
5859,785743,23,1,9,0,2,1,7,0,0,0,1,2,2,1,1,0,3
5860,781403,34,5,14,3,8,2,6,0,0,1,5,4,2,0,2,0,12
5860,792653,17,3,6,3,6,0,0,0,1,5,2,0,2,0,1,2,6
5860,797301,29,4,7,4,7,0,0,0,0,0,5,5,2,1,2,0,8
5860,780524,22,4,7,2,2,2,5,0,0,0,4,0,0,0,0,0,10
5860,781400,38,2,12,1,4,1,8,4,4,1,4,6,4,2,0,0,9
5860,792654,20,4,6,4,6,0,0,1,2,3,2,0,2,0,1,1,9
5860,786857,30,4,12,3,8,1,4,10,12,4,5,1,3,0,1,1,19
5860,797302,8,0,0,0,0,0,0,0,0,1,2,0,0,0,0,0,0
5860,797306,2,0,0,0,0,0,0,0,0,1,0,0,0,0,0,0,0
5861,785384,8,2,2,1,1,1,1,0,0,0,0,0,2,1,0,0,5
5861,780025,26,5,10,5,10,0,0,2,3,2,3,1,5,0,0,1,12
5861,796391,36,4,7,4,6,0,1,2,3,0,5,5,1,0,3,0,10
5861,785385,38,10,17,4,5,6,12,2,2,2,3,5,3,0,0,0,28
5861,785383,38,2,11,2,10,0,1,1,2,0,4,7,1,0,1,0,5
5861,781046,25,2,8,1,5,1,3,0,0,2,5,0,1,2,0,0,5
5861,790837,15,1,4,1,3,0,1,0,0,1,1,0,4,0,0,0,2
5861,792180,2,0,2,0,0,0,2,0,0,0,0,0,0,0,0,0,0
5861,786297,12,2,5,2,5,0,0,1,1,2,2,0,2,0,1,0,5
5862,792378,27,6,7,6,7,0,0,1,2,4,6,1,3,0,2,1,13
5862,786746,34,4,8,3,5,1,3,2,3,0,4,0,1,0,3,0,11
5862,775075,29,2,4,2,4,0,0,2,2,2,1,0,4,0,2,0,6
5862,792376,35,5,10,2,4,3,6,11,12,0,4,4,3,1,2,1,24
5862,797883,26,4,10,4,9,0,1,2,3,1,5,4,2,4,3,0,10
5862,797890,14,0,2,0,0,0,2,0,0,0,1,1,0,1,1,0,0
5862,797888,13,2,7,2,6,0,1,1,2,5,1,1,0,1,1,0,5
5862,792374,14,1,3,1,1,0,2,2,2,0,1,0,3,2,3,0,4
5862,786747,6,0,2,0,2,0,0,0,0,0,0,0,1,0,0,0,0
5862,797885,2,0,0,0,0,0,0,0,0,0,0,0,0,0,0,0,0
5863,780122,20,0,1,0,1,0,0,1,2,1,1,1,2,0,3,0,1
5863,797215,35,4,10,4,6,0,4,4,5,0,1,2,3,2,2,0,12
5863,791461,14,1,2,1,1,0,1,2,2,1,0,0,3,0,0,0,4
5863,791460,33,7,15,3,7,4,8,2,2,3,2,4,2,4,5,0,20
5863,786295,34,5,12,4,7,1,5,0,0,2,6,1,3,2,3,1,11
5863,786299,22,3,5,3,5,0,0,1,4,1,2,1,3,0,1,1,7
5863,797214,19,1,2,1,2,0,0,0,0,0,2,1,1,0,3,0,2
5863,780792,15,1,5,0,1,1,4,2,2,1,1,0,2,0,0,0,5
5863,775598,8,0,0,0,0,0,0,0,0,0,2,1,2,0,0,0,0
5864,791564,30,3,10,3,9,0,1,1,2,2,4,0,0,1,2,0,7
5864,775549,22,2,3,2,3,0,0,0,0,1,1,1,2,0,2,1,4
5864,797054,33,5,8,3,5,2,3,1,2,0,2,4,0,2,2,0,13
5864,791568,19,3,6,3,5,0,1,0,0,1,1,0,2,0,1,1,6
5864,786381,28,3,9,2,4,1,5,1,2,0,3,0,2,1,0,0,8
5864,797058,10,0,2,0,0,0,2,1,2,0,4,1,1,0,1,0,1
5864,791566,3,0,0,0,0,0,0,0,0,0,0,0,0,0,0,1,0
5864,780425,15,2,2,2,2,0,0,1,1,0,5,0,4,1,0,0,5
5864,797056,29,3,10,0,5,3,5,0,1,0,3,2,2,0,0,0,9
5864,797055,11,0,1,0,0,0,1,2,2,0,1,0,0,0,0,0,2
5865,786569,32,5,6,5,6,0,0,2,2,2,5,2,2,0,3,2,12
5865,791726,28,3,13,1,5,2,8,0,0,0,1,1,0,2,1,1,8
5865,786273,32,4,14,3,8,1,6,0,0,1,5,3,2,1,1,1,9
5865,780773,38,2,10,0,4,2,6,1,2,3,8,5,2,0,0,0,7
5865,775228,29,2,5,1,1,1,4,0,0,0,5,1,1,1,1,0,5
5865,791728,6,0,1,0,1,0,0,1,2,0,2,0,4,0,1,0,1
5865,797317,27,5,8,4,6,1,2,1,3,3,0,1,3,2,1,0,12
5865,797313,6,0,0,0,0,0,0,0,0,0,0,0,0,0,0,0,0
5865,780274,2,0,0,0,0,0,0,0,0,0,0,0,0,0,0,0,0
5866,796850,24,4,9,4,6,0,3,0,0,2,5,2,1,1,3,0,8
5866,774969,26,4,7,4,7,0,0,1,4,3,7,5,1,0,4,1,9
5866,791179,24,5,10,1,2,4,8,0,0,1,4,0,0,0,1,1,14
5866,781054,24,2,7,0,2,2,5,0,0,0,2,1,2,1,2,0,6
5866,781053,27,3,4,1,2,2,2,3,3,0,0,4,2,2,1,0,11
5866,800085,3,0,0,0,0,0,0,1,2,1,1,0,1,0,1,1,1
5866,785670,14,1,2,1,1,0,1,0,0,1,3,0,1,0,1,0,2
5866,780981,14,2,3,1,2,1,1,2,4,1,4,0,1,0,1,0,7
5866,796848,19,2,5,2,4,0,1,0,0,0,5,3,2,0,3,1,4
5866,796849,3,0,0,0,0,0,0,0,0,0,0,0,0,0,1,0,0
5866,791181,22,2,3,2,3,0,0,0,0,0,2,1,1,2,0,1,4
5867,785523,22,4,6,4,6,0,0,1,1,0,1,2,1,2,3,0,9
5867,781247,23,1,3,1,1,0,2,0,0,0,1,0,2,0,0,0,2
5867,791250,32,2,7,1,4,1,3,1,1,1,5,1,2,2,2,0,6
5867,791249,30,4,14,4,9,0,5,2,4,1,0,2,0,3,1,0,10
5867,775358,28,2,8,1,5,1,3,0,0,0,4,2,2,0,3,0,5
5867,796949,11,3,5,3,5,0,0,0,1,2,3,0,1,1,1,0,6
5867,785522,9,0,1,0,1,0,0,0,0,0,2,0,2,0,0,0,0
5867,796947,18,1,8,1,6,0,2,0,0,0,1,0,1,2,0,0,2
5867,796946,5,0,2,0,1,0,1,0,0,0,0,0,0,0,0,0,0
5867,796944,16,1,3,0,1,1,2,0,0,1,0,0,2,0,1,0,3
5867,791247,4,0,2,0,2,0,0,0,0,0,0,0,1,0,0,0,0
5867,796948,2,0,0,0,0,0,0,0,0,0,0,0,0,0,0,0,0
5868,786434,10,0,4,0,4,0,0,0,0,1,1,0,0,0,0,0,0
5868,780440,30,6,12,4,8,2,4,2,2,2,3,1,1,1,0,0,16
5868,791621,25,1,6,1,2,0,4,7,8,0,5,2,2,0,2,0,9
5868,786432,34,1,4,0,0,1,4,1,2,0,2,1,0,1,2,0,4
5868,786431,34,5,11,5,8,0,3,5,6,0,2,6,2,3,1,0,15
5868,791619,13,2,3,2,2,0,1,0,0,0,4,0,0,0,1,0,4
5868,791620,12,3,3,1,1,2,2,0,0,1,5,0,1,0,0,0,8
5868,781125,22,3,5,3,5,0,0,3,5,4,5,1,2,0,2,2,9
5868,775620,6,0,1,0,1,0,0,0,0,0,1,0,1,0,1,0,0
5868,775622,14,0,4,0,3,0,1,0,0,0,3,1,0,0,1,0,0
5869,786003,21,0,2,0,0,0,2,0,0,0,4,2,0,0,1,2,0
5869,775455,32,10,15,10,14,0,1,0,0,2,5,2,2,0,0,0,20
5869,792123,31,4,12,2,5,2,7,0,0,1,5,1,3,2,4,0,10
5869,786005,16,0,4,0,3,0,1,0,0,0,2,1,2,1,0,0,0
5869,781397,24,5,7,5,6,0,1,0,0,0,2,1,2,0,0,0,10
5869,792119,3,0,0,0,0,0,0,0,0,1,1,1,0,0,0,0,0
5869,786009,2,0,1,0,1,0,0,0,0,0,0,0,0,1,0,0,0
5869,792124,12,2,4,2,4,0,0,1,3,0,2,0,2,0,1,0,5
5869,797749,25,1,4,0,0,1,4,2,2,0,3,0,2,0,0,0,5
5869,797747,19,2,9,2,7,0,2,0,0,1,2,1,5,2,0,1,4
5869,786002,11,0,0,0,0,0,0,0,0,0,0,1,3,1,1,0,0
5869,786008,4,1,2,1,1,0,1,0,0,0,1,0,0,0,0,0,2
5870,791980,16,0,1,0,0,0,1,0,0,1,2,0,3,0,1,0,0
5870,785967,34,7,11,7,11,0,0,14,17,4,8,0,4,3,2,1,28
5870,791976,30,4,11,3,6,1,5,2,5,0,3,1,3,1,1,0,11
5870,791978,33,3,15,3,9,0,6,3,4,5,1,9,4,1,0,0,9
5870,785973,16,0,1,0,0,0,1,1,1,0,2,3,1,0,1,0,1
5870,780160,18,0,1,0,1,0,0,0,2,4,1,3,3,1,0,1,0
5870,791977,25,7,15,2,4,5,11,2,2,0,0,0,2,0,2,0,21
5870,785972,12,2,3,1,2,1,1,0,0,0,1,1,0,0,0,0,5
5870,797800,16,2,5,1,2,1,3,0,0,0,1,0,1,0,2,1,5
5871,790794,14,2,3,2,3,0,0,0,0,2,1,0,3,0,0,0,4
5871,785368,27,6,9,6,9,0,0,9,9,4,3,1,4,0,4,5,21
5871,790793,23,3,9,0,3,3,6,0,0,0,3,3,3,0,2,0,9
5871,785246,27,5,10,1,3,4,7,5,6,0,5,1,3,1,1,0,19
5871,780886,31,3,9,3,8,0,1,6,7,0,5,7,2,3,3,0,12
5871,790790,5,1,2,1,2,0,0,0,0,0,0,0,1,0,0,0,2
5871,790789,9,0,2,0,2,0,0,2,2,1,1,1,1,0,1,0,2
5871,790792,24,3,5,2,4,1,1,0,0,0,4,2,2,1,0,1,7
5871,796351,13,2,2,2,2,0,0,0,1,1,3,0,1,0,1,0,4
5871,780281,21,1,3,1,1,0,2,1,2,1,2,0,2,0,1,0,3
5871,796350,6,0,0,0,0,0,0,2,3,0,0,0,2,0,0,0,2
5872,796631,15,3,5,2,2,1,3,0,0,2,2,1,2,0,2,0,7
5872,790998,31,7,11,5,9,2,2,0,0,2,4,1,2,2,1,0,16
5872,790997,23,2,6,1,3,1,3,1,3,1,7,0,1,1,0,4,6
5872,790996,28,4,10,2,5,2,5,0,0,0,4,0,3,1,2,0,10
5872,785621,28,3,8,2,5,1,3,0,0,0,2,6,1,3,2,0,7
5872,766874,21,4,7,4,7,0,0,1,2,1,5,0,3,1,0,4,9
5872,790992,6,0,0,0,0,0,0,2,2,0,2,0,1,0,0,0,2
5872,796632,11,0,2,0,1,0,1,1,2,0,3,0,1,0,4,0,1
5872,790993,1,0,0,0,0,0,0,0,0,0,1,0,0,0,0,0,0
5872,790995,16,0,2,0,1,0,1,0,0,0,0,3,0,0,1,0,0
5872,786375,18,1,2,1,2,0,0,5,7,1,6,0,2,0,2,0,7
5872,785313,2,0,0,0,0,0,0,0,0,0,0,0,0,0,0,0,0
5873,785836,16,2,6,1,2,1,4,0,0,1,5,0,0,0,0,0,5
5873,785833,30,2,8,2,5,0,3,2,4,1,6,1,2,2,2,2,6
5873,791707,36,4,8,2,4,2,4,0,1,3,2,1,1,1,2,0,10
5873,791704,18,0,2,0,1,0,1,3,4,0,3,0,3,0,1,0,3
5873,785838,28,1,10,1,9,0,1,0,1,1,2,0,4,0,1,0,2
5873,791705,13,0,5,0,2,0,3,0,0,1,0,1,2,1,0,0,0
5873,775872,8,0,4,0,2,0,2,0,0,0,1,1,0,1,1,0,0
5873,797534,4,1,1,0,0,1,1,1,2,0,1,0,0,0,0,0,4
5873,797533,27,2,7,2,4,0,3,2,3,1,0,0,2,1,1,0,6
5873,785892,20,3,7,3,6,0,1,2,2,0,1,0,1,1,3,0,8
5874,786123,27,8,11,8,11,0,0,2,4,1,14,1,4,0,2,1,18
5874,780437,32,3,3,3,3,0,0,0,0,2,6,1,3,0,0,0,6
5874,797673,36,5,12,4,8,1,4,3,4,1,2,4,2,1,4,0,14
5874,786118,40,9,11,5,5,4,6,0,0,2,2,4,3,0,1,2,22
5874,786117,40,8,12,8,9,0,3,4,6,2,2,5,2,0,3,0,20
5874,797675,13,1,4,1,4,0,0,0,0,0,0,0,2,0,2,0,2
5874,792093,12,1,4,1,3,0,1,0,0,0,2,0,0,0,0,0,2
5875,791295,19,4,5,4,5,0,0,0,0,3,2,0,1,0,1,1,8
5875,776345,26,2,7,2,6,0,1,2,8,4,2,1,1,0,2,1,6
5875,796579,36,5,13,1,3,4,10,3,4,0,3,4,2,1,1,0,17
5875,785794,38,7,17,4,13,3,4,2,3,2,3,1,3,1,1,1,19
5875,781373,27,2,7,0,2,2,5,0,0,1,3,6,2,0,3,0,6
5875,781379,3,0,0,0,0,0,0,0,0,0,0,0,2,0,0,0,0
5875,796577,11,2,4,1,2,1,2,0,0,2,0,0,2,1,0,1,5
5875,791292,9,1,3,1,2,0,1,0,0,0,1,0,0,0,0,1,2
5875,791293,6,0,1,0,0,0,1,0,0,0,0,0,0,0,0,0,0
5875,796580,21,2,6,2,6,0,0,0,2,0,1,1,0,1,0,0,4
5875,785792,4,0,0,0,0,0,0,0,0,0,0,0,0,0,0,0,0
5876,790899,27,2,6,2,6,0,0,1,3,3,9,0,2,0,1,0,5
5876,790897,12,0,8,0,5,0,3,0,0,1,0,0,1,1,0,0,0
5876,785442,27,4,10,2,4,2,6,3,4,2,7,2,0,0,1,1,13
5876,785579,35,6,10,3,4,3,6,1,2,0,2,1,3,0,3,0,16
5876,775737,12,0,1,0,0,0,1,0,0,0,1,0,0,1,1,0,0
5876,775959,23,5,10,2,3,3,7,2,2,0,1,1,1,2,0,0,15
5876,796447,13,0,2,0,2,0,0,0,0,1,1,1,1,0,0,1,0
5876,790898,12,0,1,0,1,0,0,0,0,0,2,3,2,0,2,0,0
5876,785448,17,2,4,0,1,2,3,0,0,1,4,2,1,1,0,0,6
5876,799907,22,4,4,1,1,3,3,0,0,0,2,1,1,1,2,0,11
5876,780596,0,0,0,0,0,0,0,0,0,0,0,0,0,0,0,0,0
5877,790821,31,5,10,4,8,1,2,1,2,2,5,1,3,1,2,2,12
5877,780445,29,3,4,2,3,1,1,0,0,0,3,0,1,0,0,1,7
5877,790822,38,5,15,1,8,4,7,0,0,0,7,1,0,2,3,0,14
5877,790820,34,2,6,2,5,0,1,0,2,0,3,9,3,2,2,0,4
5877,774980,36,7,12,4,8,3,4,0,0,0,5,2,2,2,2,1,17
5877,775585,20,0,2,0,2,0,0,0,4,1,2,0,1,0,1,2,0
5877,785365,12,0,2,0,1,0,1,0,0,0,1,0,2,0,0,0,0
5878,781612,34,1,7,1,4,0,3,0,0,2,6,1,2,1,3,1,2
5878,786459,40,12,25,12,25,0,0,0,0,6,5,2,1,1,3,0,24
5878,781609,38,4,12,3,10,1,2,2,3,3,10,2,2,1,1,1,11
5878,797006,25,2,7,1,4,1,3,0,1,0,1,3,2,0,0,0,5
5878,797004,38,4,9,3,6,1,3,4,5,0,1,1,2,1,4,0,13
5878,797005,15,0,5,0,2,0,3,1,2,0,1,0,0,0,0,0,1
5878,797008,2,0,1,0,1,0,0,0,0,0,0,0,0,0,0,0,0
5878,791360,25,2,5,1,2,1,3,0,0,1,1,0,4,2,1,0,5
5878,797003,8,0,1,0,0,0,1,2,2,0,0,0,3,0,0,0,2
5879,791140,34,7,9,7,9,0,0,2,2,5,8,2,1,0,2,5,16
5879,791138,28,2,3,2,2,0,1,0,0,1,6,0,1,1,1,0,4
5879,786084,38,5,12,4,10,1,2,0,0,0,10,5,1,3,1,1,11
5879,780910,35,6,17,5,13,1,4,8,10,2,3,5,3,1,3,0,21
5879,780288,33,3,9,3,5,0,4,1,2,0,1,0,1,0,0,0,7
5879,796794,3,0,0,0,0,0,0,1,2,1,0,0,0,0,2,0,1
5879,796795,11,2,2,2,2,0,0,0,0,0,1,1,1,0,3,0,4
5879,780912,12,2,4,2,3,0,1,1,1,1,0,0,1,2,1,0,5
5879,780911,18,2,8,1,2,1,6,0,0,1,3,0,3,1,0,0,5
5879,781635,13,0,3,0,1,0,2,0,0,0,2,1,1,0,0,0,0
5880,792171,30,3,7,2,5,1,2,1,1,5,9,5,4,0,4,5,8
5880,780049,29,4,9,4,9,0,0,2,4,2,2,0,1,0,0,1,10
5880,797784,34,4,13,4,9,0,4,0,0,2,2,3,1,1,7,0,8
5880,792173,19,1,8,0,3,1,5,0,0,0,2,1,2,1,1,0,3
5880,789059,36,6,12,3,4,3,8,0,0,4,6,3,2,0,3,1,15
5880,785674,19,2,8,1,2,1,6,0,0,1,1,0,1,0,1,0,5
5880,792174,13,0,2,0,1,0,1,0,0,1,2,2,0,0,0,0,0
5880,780527,20,3,8,1,3,2,5,0,0,4,3,2,1,0,0,1,8
5881,792417,30,4,7,3,5,1,2,0,0,3,0,2,4,1,2,1,9
5881,786861,40,5,9,4,6,1,3,2,3,2,8,1,1,2,0,1,13
5881,786867,32,3,9,2,2,1,7,0,0,1,5,0,1,1,0,0,7
5881,780387,33,6,16,6,11,0,5,3,3,2,4,2,2,1,1,0,15
5881,767033,39,5,19,5,14,0,5,3,4,1,2,3,3,4,4,0,13
5881,796870,7,0,0,0,0,0,0,0,0,0,0,0,2,0,0,0,0
5881,792416,12,0,2,0,1,0,1,2,2,0,3,1,0,0,0,0,2
5881,786866,7,0,3,0,0,0,3,0,0,0,0,2,0,0,0,0,0
5882,786690,18,5,7,5,6,0,1,0,0,1,2,0,5,1,6,0,10
5882,791161,21,0,5,0,1,0,4,0,0,0,1,1,1,1,1,0,0
5882,780629,34,3,7,3,3,0,4,6,8,1,3,1,0,3,2,0,12
5882,774845,39,3,13,2,9,1,4,3,6,2,2,4,3,0,1,0,10
5882,775888,35,5,12,4,8,1,4,5,11,2,9,4,3,4,3,4,16
5882,796817,4,1,1,0,0,1,1,0,0,0,0,0,0,0,0,0,3
5882,796816,22,2,6,2,4,0,2,0,1,0,5,0,4,0,2,0,4
5882,785346,27,4,8,1,3,3,5,10,11,0,4,0,3,1,1,0,21
5883,788113,15,1,4,0,0,1,4,0,0,2,1,1,3,0,3,0,3
5883,776497,28,10,22,7,12,3,10,5,6,2,5,1,3,0,4,1,28
5883,785731,38,2,9,2,6,0,3,2,2,1,8,3,2,2,1,2,6
5883,785729,34,6,11,6,10,0,1,2,2,2,4,1,5,2,0,0,14
5883,780864,29,4,8,1,2,3,6,2,2,1,8,2,3,0,2,0,13
5883,799881,5,0,0,0,0,0,0,0,0,0,0,0,1,0,0,0,0
5883,792407,3,0,0,0,0,0,0,0,0,0,1,0,4,0,2,0,0
5883,792402,10,0,1,0,0,0,1,0,2,0,0,0,1,0,3,0,0
5883,796211,16,1,4,1,2,0,2,0,0,2,4,1,4,1,0,0,2
5883,786231,22,5,15,4,9,1,6,2,2,6,3,0,2,1,3,0,13
5884,781592,16,2,4,2,3,0,1,0,0,1,2,0,4,0,0,0,4
5884,780229,22,9,14,9,14,0,0,1,2,0,5,2,0,2,2,0,19
5884,791483,23,4,5,3,3,1,2,4,5,0,5,2,0,0,3,0,13
5884,797193,16,2,6,2,4,0,2,3,4,0,1,0,0,2,0,0,7
5884,786322,19,2,4,2,2,0,2,1,2,1,2,3,0,1,1,0,5
5884,791484,18,1,4,0,1,1,3,2,2,1,3,0,1,0,1,0,5
5884,791487,12,2,3,0,1,2,2,0,2,1,3,0,1,0,1,0,6
5884,797195,16,4,6,3,3,1,3,0,0,0,2,3,1,3,2,0,9
5884,791488,13,1,2,1,2,0,0,0,0,1,4,0,1,1,2,0,2
5884,797194,15,2,6,0,1,2,5,0,0,0,1,1,0,0,0,0,6
5884,791485,16,4,6,1,3,3,3,0,0,0,2,3,0,1,2,0,11
5884,786323,13,1,2,1,1,0,1,0,0,0,0,5,1,2,1,0,2
5884,780228,1,0,0,0,0,0,0,0,0,0,0,0,0,0,0,0,0
5886,775110,31,3,10,3,10,0,0,4,6,8,6,1,4,0,4,2,10
5886,791392,30,0,4,0,2,0,2,0,0,1,3,4,3,1,0,0,0
5886,785936,28,1,3,0,0,1,3,6,6,1,3,0,3,1,0,0,9
5886,780128,38,9,23,6,14,3,9,5,5,0,1,4,3,3,4,0,26
5886,775458,39,5,18,2,9,3,9,6,6,0,4,2,4,0,2,0,19
5886,786062,9,1,1,1,1,0,0,3,4,3,1,0,4,0,0,0,5
5886,797138,1,0,1,0,1,0,0,0,0,0,0,0,0,0,0,0,0
5886,797135,13,1,1,0,0,1,1,0,0,0,3,0,1,1,0,0,3
5886,785264,11,1,4,0,1,1,3,1,2,1,0,1,2,0,0,0,4
5887,792036,27,5,7,5,7,0,0,1,2,3,5,0,2,1,1,0,11
5887,786039,21,2,4,2,4,0,0,2,3,2,2,2,4,0,0,1,6
5887,786266,36,8,15,5,8,3,7,5,7,1,5,3,0,0,2,0,24
5887,797718,18,3,3,2,2,1,1,3,3,0,1,3,4,0,1,0,10
5887,775028,35,3,12,3,8,0,4,8,9,1,6,5,2,3,7,1,14
5887,797723,6,0,1,0,1,0,0,0,0,0,1,1,1,1,0,0,0
5887,797719,16,3,5,1,1,2,4,0,0,0,1,0,3,0,0,0,8
5887,792040,15,3,6,3,4,0,2,0,0,0,2,0,1,0,0,1,6
5887,792043,26,1,4,1,3,0,1,2,3,0,8,1,4,0,1,0,4
5888,797066,26,4,6,4,6,0,0,0,0,0,4,1,4,1,1,0,8
5888,780180,24,3,5,3,4,0,1,0,2,3,0,1,4,1,3,0,6
5888,791432,34,5,13,2,7,3,6,0,0,0,1,1,1,0,3,0,13
5888,777865,28,1,6,0,3,1,3,2,2,1,1,4,1,4,4,0,5
5888,791429,24,2,6,2,5,0,1,2,3,1,2,5,0,0,2,0,6
5888,781650,14,3,4,3,4,0,0,1,2,0,3,2,2,0,4,0,7
5888,797067,16,3,6,3,6,0,0,0,0,1,2,0,1,0,2,0,6
5888,797070,8,1,2,0,0,1,2,0,0,1,0,0,0,0,0,0,3
5888,776079,12,0,4,0,0,0,4,0,0,2,1,1,1,0,0,0,0
5888,797068,14,3,5,1,3,2,2,0,0,0,2,1,0,0,0,0,8
5889,783072,29,5,6,4,5,1,1,0,1,0,5,2,1,1,2,0,11
5889,774879,29,3,7,2,4,1,3,8,8,3,5,4,3,2,1,3,15
5889,791540,32,10,15,7,10,3,5,0,0,0,3,1,1,2,3,1,23
5889,787782,33,4,9,3,6,1,3,4,4,2,3,2,1,1,1,1,13
5889,776068,34,5,12,2,6,3,6,1,1,0,1,3,2,2,3,0,14
5889,797817,7,0,0,0,0,0,0,0,0,0,2,3,1,0,2,0,0
5889,781463,17,2,5,1,3,1,2,0,0,1,2,3,2,1,0,0,5
5889,792153,12,0,0,0,0,0,0,0,0,0,0,0,2,0,1,0,0
5889,781202,6,0,1,0,0,0,1,0,0,0,1,0,0,0,0,0,0
5889,793057,1,0,0,0,0,0,0,0,0,0,0,0,0,0,0,0,0
5890,786029,32,8,9,8,9,0,0,2,2,1,3,1,3,0,2,0,18
5890,781398,24,2,3,1,1,1,2,2,2,1,2,5,0,2,0,0,7
5890,792114,42,9,15,4,5,5,10,6,8,0,2,3,3,1,2,0,29
5890,786018,36,3,10,3,4,0,6,6,8,1,1,0,2,1,2,1,12
5890,775678,34,3,11,0,3,3,8,3,4,0,4,7,3,4,4,0,12
5890,786022,12,0,3,0,3,0,0,0,0,0,1,0,2,0,1,2,0
5890,797740,12,0,6,0,5,0,1,0,2,1,1,1,1,0,1,0,0
5890,797737,13,1,1,1,1,0,0,0,0,0,0,2,1,2,0,0,2
5890,797746,19,4,7,3,4,1,3,4,7,3,5,1,1,2,0,0,13
5890,792112,1,0,0,0,0,0,0,0,0,0,0,0,0,0,0,0,0
5891,790846,17,4,5,4,4,0,1,0,0,0,4,1,2,1,3,0,8
5891,796754,39,6,12,6,10,0,2,0,1,1,6,4,3,1,3,0,12
5891,791099,27,3,7,3,4,0,3,2,2,0,1,0,3,1,2,0,8
5891,785470,40,6,7,4,5,2,2,3,5,1,3,2,4,2,2,0,17
5891,780298,26,2,7,0,1,2,6,0,0,0,0,2,1,0,3,0,6
5891,780315,24,3,6,2,4,1,2,0,0,1,2,2,2,0,1,0,7
5891,785586,26,4,8,3,6,1,2,4,4,0,4,3,4,2,3,0,13
5891,796755,26,7,9,7,9,0,0,3,5,3,5,0,3,0,5,0,17
5892,785572,23,2,8,0,3,2,5,5,8,0,3,1,0,0,1,0,11
5892,797655,21,4,6,4,6,0,0,2,6,3,4,1,0,0,1,1,10
5892,792069,18,3,8,3,6,0,2,1,1,0,1,1,4,0,3,0,7
5892,797657,21,2,4,0,1,2,3,0,0,0,5,0,5,0,0,0,6
5892,792072,37,2,9,1,4,1,5,0,1,0,1,1,3,2,2,0,5
5892,797652,31,4,9,4,7,0,2,2,3,1,5,5,2,0,2,0,10
5892,784640,19,3,5,2,2,1,3,0,0,1,3,1,2,2,0,0,7
5892,786025,8,2,2,2,2,0,0,0,4,0,1,0,2,0,0,0,4
5892,774844,15,0,0,0,0,0,0,2,2,0,2,0,2,0,2,0,2
5892,797653,7,0,1,0,0,0,1,0,0,0,0,1,0,0,0,0,0
5893,791905,34,8,14,6,8,2,6,3,5,2,10,3,4,0,1,0,21
5893,797568,34,5,8,3,5,2,3,5,7,0,3,2,2,0,3,0,17
5893,781191,38,7,15,6,9,1,6,1,3,1,6,4,1,1,1,1,16
5893,781103,23,2,5,2,4,0,1,3,3,2,11,3,4,0,1,0,7
5893,797566,35,2,7,2,4,0,3,1,4,0,3,0,3,2,0,2,5
5893,797569,15,3,5,3,5,0,0,0,0,0,0,0,2,2,0,1,6
5893,791907,14,1,2,1,2,0,0,0,0,3,1,2,5,0,2,0,2
5893,781364,5,0,0,0,0,0,0,0,0,0,0,0,0,1,3,0,0
5893,791904,2,0,0,0,0,0,0,0,0,0,0,0,0,0,0,0,0
5893,797570,0,0,0,0,0,0,0,0,0,0,0,0,0,0,0,0,0
5894,780923,24,8,12,7,8,1,4,3,6,0,1,4,1,0,3,2,20
5894,775564,32,7,15,7,13,0,2,0,1,4,4,3,3,3,3,2,14
5894,792101,32,5,12,4,7,1,5,2,3,1,1,2,2,5,4,1,13
5894,776386,22,3,8,2,6,1,2,0,0,2,5,1,2,0,1,1,7
5894,797701,21,3,5,3,5,0,0,0,0,1,3,4,4,0,2,0,6
5894,792102,22,5,8,4,7,1,1,2,2,0,2,1,1,1,0,0,13
5894,797700,15,3,3,3,3,0,0,1,2,1,1,0,5,1,1,1,7
5894,780922,21,2,5,2,2,0,3,0,1,1,3,0,1,1,0,1,4
5894,786160,10,0,0,0,0,0,0,2,2,0,0,0,0,0,0,0,2
5894,797703,1,0,0,0,0,0,0,2,2,0,0,0,0,1,1,0,2
5894,797697,0,0,0,0,0,0,0,0,0,0,0,0,0,0,0,0,0
5894,791856,0,0,0,0,0,0,0,0,0,0,0,0,0,0,0,0,0
5894,792103,0,0,0,0,0,0,0,0,0,0,0,0,0,0,0,0,0
5895,775556,33,9,12,6,8,3,4,2,3,3,5,1,3,1,4,1,23
5895,780234,34,8,12,4,8,4,4,2,4,2,11,4,4,3,1,1,22
5895,781104,38,7,19,4,10,3,9,4,4,2,3,8,1,5,4,0,21
5895,786411,30,5,10,1,3,4,7,0,0,1,1,3,3,0,1,0,14
5895,780046,31,4,8,2,4,2,4,2,2,0,4,5,1,2,2,0,12
5895,797185,12,2,2,2,2,0,0,3,4,2,0,1,2,1,0,0,7
5895,786405,16,1,6,1,6,0,0,1,2,2,1,1,2,2,4,0,3
5895,786328,6,0,0,0,0,0,0,0,0,1,1,0,0,0,0,0,0
5895,797186,0,0,0,0,0,0,0,0,0,0,0,0,0,0,0,0,0
5895,792656,0,0,0,0,0,0,0,0,0,0,0,0,0,0,0,0,0
5896,791220,12,1,2,1,1,0,1,0,0,0,2,1,3,0,0,0,2
5896,791219,27,7,12,5,7,2,5,4,5,4,9,2,3,1,0,0,20
5896,776217,18,2,4,2,4,0,0,3,4,3,4,0,4,1,2,0,7
5896,786396,30,7,9,4,5,3,4,4,5,0,0,2,2,0,0,0,21
5896,780730,31,5,13,3,8,2,5,8,8,4,2,1,1,1,1,0,20
5896,786824,22,8,13,6,9,2,4,0,0,1,3,1,2,2,0,0,18
5896,791221,8,1,4,0,3,1,1,0,0,0,1,1,5,1,1,0,3
5896,796923,8,2,2,2,2,0,0,0,0,0,2,0,1,0,0,0,4
5896,796921,4,0,0,0,0,0,0,2,2,0,1,0,1,0,0,0,2
5896,790818,25,2,6,1,4,1,2,5,6,0,2,6,1,2,1,0,10
5896,796924,3,1,1,0,0,1,1,0,0,0,0,0,1,1,0,0,3
5896,796920,6,0,1,0,1,0,0,0,0,0,0,1,0,1,0,0,0
5896,800086,3,1,2,1,2,0,0,0,0,0,0,1,0,0,0,0,2
5896,792496,3,0,0,0,0,0,0,0,0,0,0,0,0,0,0,0,0
5897,792249,33,2,3,2,2,0,1,2,2,2,3,6,2,1,1,4,6
5897,781430,26,7,10,5,6,2,4,5,10,3,5,3,3,0,3,0,21
5897,792248,31,3,7,0,1,3,6,4,5,1,3,2,2,0,1,0,13
5897,781445,27,6,16,3,6,3,10,1,3,0,3,0,4,0,1,0,16
5897,768845,24,2,3,1,1,1,2,1,2,0,1,5,2,1,4,0,6
5897,792253,5,2,3,2,3,0,0,0,0,0,1,0,1,0,0,0,4
5897,781448,10,1,4,1,4,0,0,0,0,1,0,1,2,1,1,0,2
5897,797941,19,3,3,2,2,1,1,2,5,0,1,0,1,0,1,0,9
5897,792250,6,0,1,0,0,0,1,1,2,0,0,0,2,0,0,0,1
5897,797957,3,0,0,0,0,0,0,0,0,0,1,0,0,0,1,0,0
5897,792251,3,0,0,0,0,0,0,0,0,0,0,1,0,0,0,0,0
5897,786076,10,2,2,1,1,1,1,1,1,0,0,1,0,0,3,0,6
5897,797944,3,0,0,0,0,0,0,0,0,0,0,0,0,0,0,0,0
5898,781339,37,9,15,5,7,4,8,0,0,0,1,1,0,2,1,0,22
5898,786056,31,3,5,1,3,2,2,4,4,0,5,2,2,1,1,0,12
5898,786054,20,6,10,6,10,0,0,0,0,4,2,1,4,0,1,1,12
5898,781337,31,4,11,3,4,1,7,0,0,0,3,2,3,0,3,0,9
5898,791964,21,0,4,0,1,0,3,0,0,0,5,1,0,1,0,1,0
5898,792041,20,4,7,3,4,1,3,0,0,0,1,2,2,0,1,1,9
5898,797711,23,4,6,4,4,0,2,0,0,0,2,0,3,2,2,0,8
5898,797710,11,0,1,0,0,0,1,0,0,0,3,1,1,0,1,0,0
5898,799737,6,0,1,0,0,0,1,0,0,0,1,1,1,0,0,0,0
5899,775604,36,7,10,4,6,3,4,1,3,1,2,1,2,0,1,0,18
5899,785505,37,6,16,6,13,0,3,4,4,3,2,5,3,1,4,2,16
5899,780797,34,4,9,3,6,1,3,0,0,1,6,1,2,0,1,0,9
5899,780555,16,2,6,2,5,0,1,0,1,0,2,1,1,0,2,0,4
5899,776418,7,1,1,1,1,0,0,0,2,0,0,0,1,0,1,0,2
5899,796981,28,4,9,3,6,1,3,0,0,1,7,4,0,2,1,0,9
5899,791616,23,2,3,2,3,0,0,1,2,2,2,2,1,1,1,1,5
5899,796986,11,1,1,0,0,1,1,0,0,0,1,1,1,0,1,0,3
5899,791618,7,1,3,0,1,1,2,0,0,0,0,0,4,1,0,0,3
5899,786429,1,0,0,0,0,0,0,0,0,0,0,0,0,0,0,0,0
5900,790883,21,5,7,2,3,3,4,0,0,0,2,0,3,0,3,0,13
5900,796439,32,4,10,4,10,0,0,3,6,3,3,2,2,2,5,1,11
5900,785436,32,3,8,2,5,1,3,0,0,0,4,5,5,3,5,0,7
5900,791635,24,2,4,2,2,0,2,2,2,0,2,2,1,0,0,2,6
5900,790884,31,8,11,8,11,0,0,0,0,6,6,0,1,1,0,3,16
5900,796438,27,2,7,1,2,1,5,2,2,1,2,0,1,1,2,1,7
5900,796436,31,7,13,5,8,2,5,5,5,0,7,5,1,3,4,0,21
5900,790885,1,0,1,0,0,0,1,0,0,0,0,0,0,0,0,0,0
5900,796442,1,0,0,0,0,0,0,0,0,0,0,0,0,0,0,0,0
5901,780119,37,9,14,9,14,0,0,0,0,4,3,4,3,0,4,0,18
5901,776097,24,1,5,1,5,0,0,1,2,0,0,2,1,1,4,0,3
5901,785536,26,4,9,3,5,1,4,0,0,1,3,0,1,1,3,5,9
5901,785280,15,2,4,1,2,1,2,0,0,2,2,2,1,1,0,0,5
5901,796559,32,8,13,7,10,1,3,0,1,0,4,1,0,0,1,0,17
5901,780149,28,4,12,2,6,2,6,3,4,1,2,2,0,2,2,0,13
5901,796558,28,6,12,6,12,0,0,0,0,2,2,1,4,3,1,0,12
5901,796560,7,0,1,0,1,0,0,0,0,1,3,1,2,0,0,0,0
5901,775679,3,0,0,0,0,0,0,0,0,0,0,0,2,0,0,0,0
5902,797235,28,3,5,3,5,0,0,1,2,2,4,0,3,0,2,0,7
5902,797232,37,4,10,1,3,3,7,5,5,0,7,4,2,2,1,0,16
5902,797237,19,1,2,0,1,1,1,0,0,0,3,2,2,0,0,0,3
5902,797234,33,2,7,2,4,0,3,0,0,0,2,0,5,2,3,1,4
5902,797239,37,10,21,4,8,6,13,1,1,0,3,3,4,0,4,0,27
5902,791368,15,4,4,4,4,0,0,2,2,2,1,1,2,0,1,0,10
5902,786535,3,0,1,0,0,0,1,2,2,0,0,0,0,0,0,0,2
5902,797240,2,0,0,0,0,0,0,0,0,0,0,0,1,0,0,0,0
5902,791367,21,4,7,4,6,0,1,2,3,3,0,2,3,2,4,0,10
5902,791369,5,0,0,0,0,0,0,0,0,0,0,0,0,0,0,0,0
5903,796617,15,2,3,2,3,0,0,4,4,1,1,1,2,0,1,1,8
5903,775131,23,1,4,1,1,0,3,0,0,0,2,2,4,1,1,0,2
5903,796616,34,6,10,4,6,2,4,8,8,0,1,0,2,3,0,0,22
5903,796612,40,8,12,8,12,0,0,0,2,0,5,5,1,0,1,1,16
5903,785562,35,5,11,5,9,0,2,9,11,1,7,2,3,3,4,0,19
5903,792429,5,2,2,1,1,1,1,0,0,0,0,0,1,0,1,0,5
5903,796614,2,1,1,1,1,0,0,0,0,0,0,0,0,0,0,0,2
5903,796607,27,3,4,3,4,0,0,2,2,0,5,2,1,0,1,1,8
5903,796606,19,1,1,1,1,0,0,0,0,0,0,1,4,0,0,0,2
5904,797472,36,4,11,1,5,3,6,7,7,1,6,4,1,4,1,1,18
5904,780965,38,7,12,6,9,1,3,0,0,0,1,12,3,1,4,1,15
5904,791863,28,4,4,2,2,2,2,2,2,0,2,1,3,2,1,0,12
5904,781081,23,5,6,5,6,0,0,0,0,3,11,0,5,0,4,1,10
5904,791864,23,4,6,2,3,2,3,0,0,0,6,1,1,0,2,0,10
5904,797470,24,1,6,1,3,0,3,6,9,0,2,1,3,4,2,0,8
5904,797473,17,3,4,3,4,0,0,0,0,0,0,0,3,0,1,0,6
5904,786791,7,0,0,0,0,0,0,0,0,0,2,1,5,0,1,0,0
5904,776447,3,0,1,0,1,0,0,0,0,0,0,0,0,0,0,0,0
5904,791865,1,0,0,0,0,0,0,0,0,0,1,0,0,0,0,0,0
5905,791988,27,8,18,8,18,0,0,2,5,3,4,0,1,1,1,2,18
5905,791989,28,4,7,3,5,1,2,7,8,1,0,1,0,1,2,0,16
5905,796507,20,3,4,2,3,1,1,0,0,0,0,1,2,1,1,0,7
5905,791987,35,0,4,0,2,0,2,1,2,0,1,1,2,1,5,0,1
5905,792443,19,1,2,1,2,0,0,2,4,2,4,1,2,0,2,1,4
5905,796509,24,2,3,2,3,0,0,1,6,2,1,0,1,0,0,0,5
5905,796503,23,0,6,0,3,0,3,4,7,0,1,1,5,1,3,0,4
5905,780077,7,1,3,1,3,0,0,0,0,0,3,1,1,0,1,0,2
5905,796508,14,0,4,0,3,0,1,0,1,1,0,0,2,0,0,0,0
5905,785258,2,0,0,0,0,0,0,0,0,0,0,0,0,0,0,0,0
5905,796506,1,0,0,0,0,0,0,0,0,0,0,0,0,0,0,0,0
5906,796540,13,1,4,1,2,0,2,0,0,1,3,1,1,1,2,0,2
5906,775037,18,0,1,0,1,0,0,0,0,3,0,0,1,1,1,0,0
5906,796545,24,4,11,4,8,0,3,2,4,1,0,1,3,1,2,0,10
5906,796541,6,0,2,0,2,0,0,0,0,1,2,0,0,0,1,0,0
5906,780087,27,7,20,7,20,0,0,7,8,3,1,1,1,1,0,0,21
5906,796543,15,1,2,1,2,0,0,0,0,0,3,0,1,0,1,0,2
5906,790951,11,0,2,0,2,0,0,1,2,2,2,0,2,0,0,2,1
5906,796544,9,1,6,0,2,1,4,0,0,0,0,0,1,3,0,0,3
5906,790952,17,2,3,2,3,0,0,1,2,0,0,0,1,2,0,0,5
5906,790954,9,2,5,2,4,0,1,3,4,1,1,0,0,1,0,0,7
5906,786309,31,3,10,3,7,0,3,0,0,2,4,0,3,4,4,0,6
5906,776076,20,1,5,1,5,0,0,0,2,1,2,0,1,0,1,0,2
5907,792067,38,3,7,1,4,2,3,2,2,2,6,0,2,0,4,0,10
5907,775523,27,2,7,2,5,0,2,1,2,2,11,0,2,0,2,1,5
5907,789028,36,8,9,6,7,2,2,1,1,2,4,8,3,3,5,0,19
5907,789029,19,3,8,1,3,2,5,3,4,1,1,2,4,1,4,1,11
5907,775323,34,5,8,4,4,1,4,4,6,0,1,2,4,0,4,1,15
5907,786836,1,0,0,0,0,0,0,0,0,0,0,0,0,0,0,0,0
5907,792056,2,0,0,0,0,0,0,0,0,0,0,0,1,0,0,0,0
5907,790779,7,0,1,0,1,0,0,0,0,0,1,0,1,1,0,0,0
5907,797649,29,5,11,3,4,2,7,4,6,0,6,1,4,1,1,1,16
5907,792058,7,0,0,0,0,0,0,0,0,1,1,0,1,0,1,0,0
5908,796334,28,5,10,4,8,1,2,1,2,3,3,1,1,0,1,1,12
5908,790776,18,3,6,3,6,0,0,3,5,1,5,1,2,3,0,0,9
5908,796330,33,4,8,2,3,2,5,0,0,0,3,1,2,0,3,0,10
5908,785813,33,7,14,5,10,2,4,4,5,1,0,8,0,2,0,0,20
5908,796337,27,0,2,0,2,0,0,1,2,0,5,4,3,2,2,0,1
5908,785827,19,5,7,5,7,0,0,2,4,2,0,0,2,1,1,3,12
5908,796332,24,3,4,2,2,1,2,0,0,1,2,1,2,0,1,0,7
5908,779975,15,0,1,0,1,0,0,0,0,0,6,1,1,0,2,0,0
5908,796333,3,0,0,0,0,0,0,0,0,0,0,0,1,0,1,0,0
5909,785532,15,2,4,2,4,0,0,0,2,2,1,0,6,0,1,0,4
5909,780063,24,1,6,1,5,0,1,2,2,1,2,1,2,0,2,0,4
5909,791055,30,4,6,3,4,1,2,1,1,0,1,1,2,0,2,0,10
5909,785530,25,7,10,2,4,5,6,2,2,0,1,1,1,1,6,1,21
5909,775926,23,2,7,1,1,1,6,0,0,0,5,0,1,0,2,0,5
5909,791057,8,0,1,0,0,0,1,0,0,0,0,0,1,0,0,0,0
5909,775573,17,1,5,1,2,0,3,0,0,0,1,0,1,0,0,0,2
5909,791280,9,0,2,0,1,0,1,0,0,0,1,1,0,0,2,0,0
5909,791059,11,0,1,0,1,0,0,0,0,1,2,1,3,0,1,0,0
5909,791058,21,0,0,0,0,0,0,2,4,0,2,0,0,0,0,1,2
5909,796734,9,1,4,1,2,0,2,0,0,0,0,1,0,2,0,0,2
5909,796733,7,0,1,0,1,0,0,0,0,0,0,2,0,0,0,0,0
5909,791056,1,0,0,0,0,0,0,0,0,0,0,0,0,0,0,0,0
5910,792227,33,5,10,4,6,1,4,1,2,1,0,1,1,2,0,0,12
5910,781352,26,1,7,1,7,0,0,2,2,2,2,1,2,0,2,0,4
5910,792223,33,6,8,4,6,2,2,1,1,1,4,2,1,0,3,0,15
5910,785935,34,9,13,7,10,2,3,7,7,0,0,4,1,1,0,0,27
5910,781340,29,2,6,2,6,0,0,1,1,4,3,2,0,3,0,0,5
5910,797881,11,3,9,3,9,0,0,0,0,2,0,0,1,0,1,0,6
5910,781351,7,1,3,1,2,0,1,0,0,1,0,0,3,0,0,0,2
5910,776128,24,1,5,1,4,0,1,0,0,0,4,3,2,0,1,0,2
5910,797889,3,0,0,0,0,0,0,0,0,0,0,0,0,0,0,0,0
5911,792334,25,3,7,2,5,1,2,0,0,0,3,0,3,0,1,0,7
5911,786575,30,2,5,2,5,0,0,0,0,0,3,0,2,0,1,2,4
5911,798094,30,3,4,3,3,0,1,2,2,0,5,6,2,1,2,0,8
5911,792338,19,3,4,3,4,0,0,1,2,2,2,3,4,2,1,0,7
5911,781666,35,9,17,3,8,6,9,0,0,1,2,1,1,0,2,0,24
5911,798097,10,2,3,2,3,0,0,0,0,2,1,0,1,0,0,1,4
5911,785531,11,0,1,0,1,0,0,0,0,1,1,0,0,0,0,0,0
5911,798095,4,0,0,0,0,0,0,0,0,0,1,0,0,0,0,0,0
5911,799842,12,0,1,0,1,0,0,2,2,0,1,0,0,0,2,0,2
5911,791636,24,6,7,2,2,4,5,2,2,0,1,0,2,1,1,0,18
5912,791882,30,7,8,5,6,2,2,2,4,2,3,0,3,1,1,0,18
5912,786493,33,6,15,3,7,3,8,5,7,0,0,3,2,0,1,1,20
5912,786491,29,3,4,2,2,1,2,1,2,1,4,1,1,1,1,1,8
5912,791881,31,0,3,0,2,0,1,4,4,1,0,8,1,1,1,0,4
5912,786420,31,6,12,3,7,3,5,3,3,0,0,1,2,0,1,0,18
5912,797616,17,1,3,0,1,1,2,2,3,2,4,1,1,1,1,2,5
5912,797613,12,3,5,2,3,1,2,0,0,0,1,0,1,0,0,0,7
5912,781052,17,0,1,0,1,0,0,2,2,0,0,0,1,0,0,0,2
5913,791787,26,9,12,9,12,0,0,2,2,3,4,1,5,0,3,0,20
5913,789048,33,7,12,7,12,0,0,0,0,4,7,1,3,0,2,2,14
5913,789046,21,2,4,1,1,1,3,0,0,1,4,3,5,1,3,0,5
5913,797630,30,2,5,0,2,2,3,0,0,0,1,1,1,0,1,0,6
5913,789041,27,3,9,1,4,2,5,6,6,0,0,1,0,0,3,0,14
5913,791785,22,1,6,0,1,1,5,3,4,3,3,1,2,0,0,0,6
5913,785540,16,1,5,1,4,0,1,1,2,3,2,1,1,0,0,0,3
5913,797631,19,2,5,2,5,0,0,0,0,0,0,1,2,0,1,0,4
5913,797629,6,0,0,0,0,0,0,0,0,0,0,0,1,1,0,0,0
5914,791289,26,5,6,5,6,0,0,1,4,3,1,2,2,2,3,3,11
5914,785786,25,2,2,2,2,0,0,0,0,1,2,1,3,0,0,1,4
5914,796574,34,6,11,0,2,6,9,0,0,0,3,5,2,2,1,0,18
5914,796571,23,1,4,0,1,1,3,0,0,0,1,2,4,0,4,0,3
5914,781346,34,5,11,1,2,4,9,0,0,0,2,6,0,1,1,0,14
5914,796576,20,2,5,1,1,1,4,3,4,0,0,1,4,0,2,0,8
5914,791290,10,2,2,2,2,0,0,0,0,0,0,0,1,0,2,1,4
5914,796572,28,3,5,3,4,0,1,1,3,2,6,1,4,0,2,2,7
5915,797873,22,5,7,4,6,1,1,0,0,3,3,1,3,0,2,0,11
5915,797877,29,5,12,5,11,0,1,3,5,0,4,1,2,1,1,0,13
5915,797872,34,2,4,2,2,0,2,3,4,3,2,1,2,2,0,0,7
5915,791338,34,1,3,1,2,0,1,2,2,1,0,3,2,4,1,1,4
5915,791339,36,9,17,7,11,2,6,8,11,1,3,4,1,1,3,0,28
5915,791337,8,0,1,0,1,0,0,0,0,0,0,0,2,0,1,0,0
5915,781599,20,4,5,3,4,1,1,0,0,2,2,0,1,1,1,1,9
5915,797875,4,0,1,0,0,0,1,0,0,0,0,0,0,0,0,0,0
5915,781595,13,0,3,0,2,0,1,0,0,1,0,3,0,0,0,0,0
5916,786519,26,3,3,3,3,0,0,1,1,3,5,0,3,0,1,0,7
5916,791911,23,1,2,0,0,1,2,0,0,2,3,0,2,0,0,0,3
5916,797556,35,5,16,5,15,0,1,1,2,0,1,1,1,0,0,0,11
5916,791913,33,5,10,5,7,0,3,2,3,0,2,2,3,4,4,0,12
5916,786520,36,5,12,5,10,0,2,5,6,4,1,3,1,1,1,0,15
5916,797558,11,2,4,1,2,1,2,1,3,0,2,0,1,0,1,0,6
5916,797560,14,2,2,2,2,0,0,0,2,1,2,0,3,0,0,1,4
5916,797559,7,2,2,1,1,1,1,0,0,1,0,1,2,0,1,0,5
5916,797555,8,3,5,3,5,0,0,0,0,0,0,0,0,1,0,0,6
5916,781105,7,0,1,0,0,0,1,0,0,1,1,0,0,0,2,0,0
5917,785916,12,0,4,0,4,0,0,2,2,3,0,2,3,0,2,0,2
5917,780105,29,4,5,3,3,1,2,0,0,1,3,1,2,0,2,1,9
5917,785637,37,5,11,4,7,1,4,3,3,0,3,4,2,2,1,0,14
5917,785915,35,3,6,0,0,3,6,0,0,0,1,0,1,0,0,0,9
5917,781131,28,4,9,4,9,0,0,2,6,1,5,1,3,1,3,0,10
5917,791408,27,6,7,6,7,0,0,5,8,5,3,3,3,1,3,0,17
5917,786183,19,1,5,0,3,1,2,0,0,0,1,0,3,0,1,0,3
5917,785894,13,1,3,0,0,1,3,0,0,1,0,1,0,1,1,0,3
5918,791493,34,7,9,7,8,0,1,2,3,4,8,3,3,1,1,3,16
5918,789036,29,6,11,5,9,1,2,5,6,3,8,2,1,1,3,1,18
5918,797191,8,0,1,0,1,0,0,0,0,0,0,1,1,0,1,0,0
5918,791494,16,1,4,1,3,0,1,0,0,0,0,1,0,0,0,0,2
5918,776494,33,4,7,2,2,2,5,1,1,0,1,3,2,0,1,0,11
5918,797192,8,0,2,0,2,0,0,0,0,0,0,0,3,0,0,0,0
5918,791492,17,0,4,0,0,0,4,0,0,0,2,0,0,1,1,1,0
5918,786324,32,5,12,3,4,2,8,4,4,1,3,6,2,4,4,0,16
5918,778888,23,0,4,0,0,0,4,2,2,0,1,2,1,2,1,0,2
5919,791515,29,4,11,2,6,2,5,0,0,4,3,0,3,0,0,0,10
5919,791511,30,2,9,2,9,0,0,0,0,2,4,2,2,1,1,2,4
5919,797150,30,1,4,1,2,0,2,0,0,2,1,2,1,0,3,0,2
5919,780946,29,2,6,1,4,1,2,0,0,0,1,0,0,1,1,0,5
5919,786637,36,4,14,3,7,1,7,3,4,0,6,4,4,1,3,0,12
5919,797151,11,0,1,0,1,0,0,0,0,0,3,1,4,0,3,1,0
5919,797152,6,0,1,0,1,0,0,0,0,0,0,0,0,0,0,0,0
5919,791514,8,1,2,0,0,1,2,0,0,0,0,0,0,0,1,0,3
5919,791513,21,5,8,5,6,0,2,3,3,0,2,1,0,0,4,0,13
5920,791306,9,1,2,1,2,0,0,2,4,1,4,0,3,0,1,0,4
5920,780210,39,6,9,5,8,1,1,5,6,5,5,1,2,1,6,3,18
5920,792432,34,3,7,1,3,2,4,2,2,0,4,4,1,1,4,0,10
5920,792427,35,4,13,2,4,2,9,5,6,0,7,1,2,1,4,0,15
5920,792433,24,3,8,1,3,2,5,2,2,1,4,1,1,1,2,0,10
5920,796592,32,3,6,3,6,0,0,1,2,4,8,1,3,1,2,0,7
5920,796594,20,1,4,0,1,1,3,1,2,0,0,2,3,0,0,0,4
5920,786422,7,1,2,0,1,1,1,0,0,0,0,2,0,0,0,0,3
5921,797821,23,2,9,1,4,1,5,1,4,2,4,0,3,1,1,0,6
5921,780433,9,0,1,0,1,0,0,0,0,0,2,0,3,0,0,2,0
5921,781490,14,1,3,1,3,0,0,0,0,0,0,2,0,0,0,0,2
5921,792188,34,5,10,1,2,4,8,2,2,0,4,1,1,2,3,1,16
5921,792183,33,6,12,6,10,0,2,4,8,2,2,1,5,2,2,0,16
5921,797819,17,0,1,0,0,0,1,0,0,0,1,1,1,1,0,0,0
5921,781447,34,2,6,2,6,0,0,0,2,1,1,0,2,2,0,1,4
5921,796255,1,0,1,0,0,0,1,0,0,0,0,0,0,0,0,0,0
5921,792187,3,0,0,0,0,0,0,0,0,0,0,0,0,0,2,0,0
5921,792185,20,5,11,3,5,2,6,0,0,1,2,0,2,2,2,0,12
5921,786675,12,0,4,0,1,0,3,0,0,0,2,1,1,0,2,0,0
5922,780686,36,8,14,8,14,0,0,4,4,3,8,6,0,1,3,0,20
5922,780683,22,3,6,1,2,2,4,2,2,3,3,1,1,0,0,0,10
5922,797681,22,2,8,0,2,2,6,0,0,0,2,3,3,0,0,0,6
5922,797680,23,4,10,4,6,0,4,2,2,0,1,0,2,0,1,0,10
5922,780688,36,4,8,3,5,1,3,3,3,2,3,2,3,1,1,0,12
5922,797683,21,2,7,1,2,1,5,0,0,2,2,2,4,0,0,1,5
5922,797679,17,1,8,0,2,1,6,4,4,1,2,0,2,0,0,0,7
5922,791942,23,1,6,1,4,0,2,0,0,0,1,3,4,1,4,0,2
5923,786792,20,0,0,0,0,0,0,0,2,2,4,1,1,0,0,1,0
5923,789020,38,3,13,1,6,2,7,0,0,1,6,2,2,0,1,0,8
5923,786787,36,8,19,4,10,4,9,4,6,0,6,5,3,1,4,0,24
5923,781456,34,5,9,4,7,1,2,6,6,0,3,0,3,2,1,0,17
5923,774954,25,6,6,6,6,0,0,2,2,2,2,2,2,0,1,0,14
5923,786795,17,3,3,3,3,0,0,0,0,0,3,0,2,1,0,1,6
5923,792091,30,4,6,4,4,0,2,0,0,0,3,1,3,0,0,0,8
5924,791062,35,6,8,3,4,3,4,3,5,2,7,0,2,0,5,0,18
5924,791063,31,5,8,4,6,1,2,1,2,3,9,2,2,1,4,0,12
5924,796735,26,2,5,1,1,1,4,0,1,0,1,3,1,3,0,0,5
5924,785542,31,1,4,1,3,0,1,6,9,0,0,5,4,0,2,0,8
5924,780743,35,7,13,5,7,2,6,0,0,1,3,3,2,0,2,0,16
5924,785548,14,3,5,3,5,0,0,0,1,0,1,0,1,0,0,0,6
5924,796736,3,0,1,0,1,0,0,0,0,0,1,0,1,0,1,0,0
5924,791064,24,3,5,2,2,1,3,3,4,0,0,3,2,1,0,0,10
5924,796737,1,0,1,0,0,0,1,0,0,0,0,0,0,0,0,0,0
5925,796766,30,1,7,1,3,0,4,0,0,0,5,1,2,1,2,1,2
5925,785614,22,5,7,5,7,0,0,3,5,2,4,0,4,1,1,0,13
5925,796767,17,1,6,0,4,1,2,0,0,1,2,1,2,0,3,0,3
5925,796765,38,5,8,2,2,3,6,2,2,1,3,2,1,1,3,0,15
5925,780812,30,3,10,2,4,1,6,1,2,1,3,1,4,2,3,0,8
5925,791113,19,0,2,0,2,0,0,2,4,1,0,0,0,0,1,0,2
5925,785618,11,2,4,1,2,1,2,0,0,1,1,1,3,0,0,0,5
5925,780813,33,9,11,8,9,1,2,0,1,2,5,2,4,1,2,1,19
5926,785126,8,1,2,0,0,1,2,0,0,0,2,0,0,0,0,0,3
5926,779857,23,5,7,4,6,1,1,2,2,3,5,0,0,0,1,0,13
5926,791014,9,0,1,0,0,0,1,0,0,0,1,1,2,1,0,0,0
5926,779976,44,7,11,7,10,0,1,9,10,2,7,7,3,2,2,0,23
5926,774990,43,8,15,3,7,5,8,3,4,0,0,5,2,0,4,0,24
5926,796673,16,3,8,2,3,1,5,0,0,0,3,1,3,1,1,0,7
5926,796674,21,1,6,1,3,0,3,2,5,2,6,0,1,0,2,0,4
5926,785961,31,2,7,1,3,1,4,1,1,0,1,2,3,0,0,0,6
5926,781586,24,4,5,4,5,0,0,0,4,1,5,0,2,0,1,0,8
5926,785339,31,2,4,0,0,2,4,1,2,1,0,1,4,3,3,0,7
5927,786550,40,3,8,2,2,1,6,2,2,1,4,1,5,1,1,1,9
5927,776054,31,4,8,2,2,2,6,2,3,4,6,1,5,2,1,0,12
5927,792007,25,2,5,2,5,0,0,4,5,3,5,2,1,0,0,0,8
5927,792009,47,5,14,4,11,1,3,2,2,0,2,2,4,0,1,0,13
5927,792006,13,2,5,1,4,1,1,2,2,2,0,1,1,1,1,0,7
5927,792011,2,0,0,0,0,0,0,0,0,0,0,0,0,0,0,0,0
5927,780177,12,1,1,1,1,0,0,0,0,1,3,0,5,0,1,1,2
5927,792008,8,1,2,1,2,0,0,0,0,0,0,0,2,0,1,0,2
5927,786552,35,6,12,3,7,3,5,1,3,0,1,1,1,0,2,0,16
5927,776273,37,6,16,5,13,1,3,5,8,1,2,4,1,2,3,1,18
5928,791743,40,9,11,9,11,0,0,4,7,4,10,1,3,0,4,0,22
5928,797340,23,3,8,2,5,1,3,2,2,0,0,1,1,1,1,0,9
5928,791746,38,3,6,3,5,0,1,0,0,0,8,8,2,0,2,1,6
5928,786193,40,5,13,0,2,5,11,6,8,0,2,3,2,1,1,0,21
5928,780711,35,2,6,2,3,0,3,0,0,0,6,4,0,0,0,0,4
5928,797341,24,5,8,2,2,3,6,0,1,1,4,2,3,1,3,0,13
5929,792473,31,7,14,7,12,0,2,0,0,0,2,4,4,0,3,2,14
5929,780036,25,2,5,1,2,1,3,0,0,1,6,2,2,0,1,1,5
5929,799276,36,4,10,1,2,3,8,0,2,2,6,1,2,1,1,0,11
5929,785249,40,6,16,2,3,4,13,0,0,0,2,6,3,0,1,0,16
5929,780035,37,5,12,2,3,3,9,0,0,1,2,2,3,1,0,0,13
5929,780043,27,1,2,1,2,0,0,1,2,0,3,2,1,1,0,0,3
5929,792477,4,0,2,0,0,0,2,0,0,0,1,0,1,0,0,0,0
5930,781342,36,10,15,8,12,2,3,7,8,2,8,4,0,0,0,1,29
5930,781593,34,2,7,2,5,0,2,0,0,1,7,2,2,0,2,0,4
5930,790901,29,1,4,0,3,1,1,0,0,0,4,1,1,0,3,0,3
5930,790903,26,2,6,0,0,2,6,0,0,0,2,0,1,0,2,0,6
5930,781620,35,2,3,1,2,1,1,2,2,0,4,5,4,1,3,1,7
5930,790902,31,5,7,2,2,3,5,2,2,0,1,1,0,1,0,2,15
5930,796450,7,0,1,0,1,0,0,1,2,1,0,0,0,0,1,0,1
5930,790904,2,0,1,0,1,0,0,0,0,0,0,0,0,0,0,0,0
5931,775510,34,4,10,2,3,2,7,0,0,2,3,1,3,1,0,0,10
5931,774976,23,5,7,2,4,3,3,0,0,1,3,1,4,1,2,1,13
5931,797865,33,0,5,0,2,0,3,1,2,0,1,3,1,0,1,0,1
5931,786614,34,3,7,1,2,2,5,2,2,1,5,1,3,1,1,0,10
5931,786759,34,4,13,1,7,3,6,0,0,1,1,0,0,1,2,0,11
5931,792293,25,2,7,2,3,0,4,0,0,0,1,2,1,1,0,0,4
5931,792291,8,0,2,0,2,0,0,0,0,0,0,1,0,1,0,0,0
5931,786761,5,0,0,0,0,0,0,0,0,0,2,0,3,0,2,0,0
5931,792294,4,1,1,1,1,0,0,0,0,0,2,0,1,0,0,0,2
5932,775954,30,5,8,5,8,0,0,1,2,1,5,3,1,0,1,0,11
5932,781006,23,7,9,5,7,2,2,1,1,2,3,0,3,0,0,0,17
5932,796194,31,3,4,2,3,1,1,0,0,0,6,1,1,0,1,0,7
5932,796464,21,3,8,3,7,0,1,2,2,0,1,0,1,0,3,0,8
5932,796459,27,3,7,3,7,0,0,7,7,2,2,3,3,1,2,0,13
5932,790918,15,2,7,2,7,0,0,0,0,0,3,0,4,0,0,0,4
5932,790917,27,3,6,0,1,3,5,0,0,2,9,4,1,0,2,1,9
5932,781157,24,2,4,0,0,2,4,5,5,0,2,4,2,1,3,0,11
5932,790916,1,0,0,0,0,0,0,0,0,0,0,0,0,1,0,0,0
5932,785238,1,0,0,0,0,0,0,0,0,0,0,0,0,0,0,0,0
5933,785362,33,8,12,8,12,0,0,1,2,0,2,0,1,1,0,1,17
5933,790809,21,0,0,0,0,0,0,0,1,0,0,1,3,1,0,0,0
5933,790808,22,0,4,0,0,0,4,2,2,0,2,1,1,0,1,0,2
5933,785361,31,3,12,2,3,1,9,2,4,0,2,3,4,1,0,0,9
5933,779997,34,4,7,2,5,2,2,5,5,0,2,4,3,1,1,0,15
5933,790810,21,2,7,0,2,2,5,4,6,3,6,6,1,0,1,0,10
5933,774854,9,1,3,1,2,0,1,0,0,1,1,0,3,1,2,0,2
5933,796368,14,1,5,1,4,0,1,1,2,0,2,1,2,1,1,0,3
5933,790811,11,1,3,0,1,1,2,0,0,0,1,0,0,0,1,0,3
5933,796371,1,0,0,0,0,0,0,0,0,0,0,0,0,0,0,0,0
5933,779999,1,0,0,0,0,0,0,0,0,0,0,0,0,0,0,0,0
5933,796369,2,0,0,0,0,0,0,0,0,0,0,0,0,0,0,0,0
5934,786080,34,10,19,8,10,2,9,5,7,1,2,1,4,3,4,0,27
5934,786216,33,3,8,3,8,0,0,1,1,2,5,2,4,0,4,0,7
5934,791348,37,1,4,1,3,0,1,1,2,3,5,3,0,0,2,1,3
5934,791350,25,2,5,0,1,2,4,0,0,0,3,1,1,2,1,0,6
5934,786218,37,3,8,3,6,0,2,6,10,1,1,1,0,1,2,0,12
5934,781645,6,0,2,0,0,0,2,0,0,0,1,0,1,0,0,0,0
5934,780156,23,1,1,0,0,1,1,0,0,0,4,0,3,1,1,0,3
5934,780150,5,0,0,0,0,0,0,0,0,0,0,0,0,0,0,0,0
5935,791482,29,2,9,2,2,0,7,0,0,1,5,4,4,1,2,0,4
5935,786319,15,0,3,0,3,0,0,0,0,0,3,0,4,0,1,1,0
5935,786318,35,8,14,5,8,3,6,6,6,1,2,3,3,2,1,0,25
5935,784268,30,4,8,3,6,1,2,4,4,1,4,0,1,1,3,0,13
5935,780223,34,3,8,2,4,1,4,0,0,1,0,1,2,1,2,0,7
5935,791481,23,2,2,2,2,0,0,0,0,1,4,1,2,0,0,0,4
5935,780225,25,4,6,3,3,1,3,0,0,0,4,2,3,0,1,0,9
5935,797199,8,0,1,0,1,0,0,2,2,0,0,1,0,0,1,0,2
5935,797198,1,0,0,0,0,0,0,0,0,0,0,0,0,0,0,0,0
5936,796637,17,5,7,5,7,0,0,0,0,1,1,1,1,1,1,0,10
5936,792632,30,4,4,4,4,0,0,2,3,1,7,0,3,3,3,1,10
5936,796638,7,0,1,0,1,0,0,0,0,0,0,0,0,2,1,0,0
5936,792626,28,1,3,1,3,0,0,3,4,3,6,10,4,0,3,1,5
5936,780250,22,2,9,1,5,1,4,0,0,1,1,0,4,1,3,1,5
5936,796645,10,1,6,1,4,0,2,0,0,1,1,1,0,0,0,2,2
5936,792627,21,3,8,3,8,0,0,5,6,0,0,1,1,0,1,0,11
5936,792629,12,0,2,0,2,0,0,1,2,0,2,3,0,2,0,0,1
5936,792631,27,4,7,0,2,4,5,4,5,0,6,4,2,0,1,0,16
5936,781491,26,6,7,5,6,1,1,1,3,1,1,2,1,1,4,1,14
5937,792418,27,1,5,1,5,0,0,2,2,3,6,1,1,3,3,1,4
5937,782654,26,1,3,1,2,0,1,0,0,2,0,0,4,1,2,0,2
5937,796693,33,6,23,2,6,4,17,2,2,0,5,6,1,0,2,0,18
5937,792422,32,2,6,2,5,0,1,2,2,3,2,2,2,2,4,0,6
5937,789484,37,9,18,8,12,1,6,5,8,1,4,2,5,3,4,3,24
5937,796695,3,0,0,0,0,0,0,0,0,0,0,0,1,1,0,1,0
5937,796692,10,2,4,0,1,2,3,1,1,0,1,1,2,0,1,0,7
5937,792424,13,1,3,1,3,0,0,0,0,3,0,0,0,0,0,1,2
5937,796694,2,1,2,1,2,0,0,0,1,1,1,1,0,0,0,0,2
5937,792423,17,2,4,1,2,1,2,1,1,2,2,0,1,1,0,0,6
5938,791042,26,6,9,6,8,0,1,1,1,1,3,1,3,2,5,0,13
5938,774834,23,3,7,3,6,0,1,1,1,2,1,1,4,1,1,0,7
5938,791043,31,2,11,2,5,0,6,0,0,0,2,2,4,0,1,1,4
5938,776374,26,3,8,2,6,1,2,0,0,1,4,5,2,3,2,0,7
5938,775412,34,3,9,0,0,3,9,0,0,2,3,4,2,1,1,0,9
5938,796723,16,1,3,0,0,1,3,0,0,0,1,0,0,0,1,0,3
5938,796719,23,2,3,1,1,1,2,0,0,3,5,1,2,0,4,1,5
5938,796718,3,1,2,0,0,1,2,0,0,0,0,0,0,0,2,0,3
5938,796717,11,0,3,0,2,0,1,0,0,0,1,0,3,0,2,0,0
5938,796720,7,0,2,0,1,0,1,0,0,0,0,0,0,0,0,0,0
5939,790511,15,0,2,0,2,0,0,3,4,0,1,1,1,0,0,2,3
5939,780194,25,1,4,1,4,0,0,2,3,0,0,1,2,2,0,0,4
5939,796833,23,4,7,0,1,4,6,2,2,0,2,0,1,0,0,0,14
5939,785706,11,1,5,1,2,0,3,0,0,0,0,0,1,0,1,0,2
5939,785700,38,4,9,3,5,1,4,0,0,0,11,2,1,1,2,0,9
5939,796838,8,0,1,0,1,0,0,0,0,0,1,0,2,0,1,0,0
5939,796837,25,3,5,1,2,2,3,0,0,1,2,3,0,0,3,0,8
5939,791171,7,0,1,0,1,0,0,0,0,1,3,1,0,0,2,0,0
5939,786721,14,1,3,0,0,1,3,0,0,0,0,0,2,0,2,0,3
5939,780269,34,9,15,9,13,0,2,3,3,0,3,3,1,3,3,0,21
5940,791083,25,5,8,4,6,1,2,1,1,5,4,0,1,0,6,2,12
5940,785294,21,0,2,0,2,0,0,0,0,2,4,1,1,1,2,2,0
5940,791085,28,2,8,1,5,1,3,0,2,0,0,4,2,0,2,1,5
5940,791080,33,7,12,6,10,1,2,1,3,3,5,3,1,1,1,1,16
5940,785675,29,3,10,0,2,3,8,0,1,0,3,1,3,1,1,0,9
5940,796511,14,0,4,0,0,0,4,2,2,0,0,0,0,0,0,0,2
5940,791081,8,1,1,1,1,0,0,0,0,1,3,0,0,1,0,0,2
5940,796512,20,4,10,2,3,2,7,2,2,1,0,2,3,1,1,0,12
5940,796515,3,1,2,0,0,1,2,0,0,0,1,0,0,0,0,0,3
5940,786446,19,2,6,1,2,1,4,0,0,0,4,3,0,1,2,0,5
5941,792167,17,3,8,3,7,0,1,0,0,1,0,0,2,0,5,0,6
5941,797766,34,2,4,0,2,2,2,2,2,3,7,0,2,1,0,1,8
5941,791372,37,8,15,4,7,4,8,0,0,1,2,1,1,5,0,1,20
5941,792164,33,11,18,6,9,5,9,3,4,0,3,3,2,2,2,0,30
5941,780974,28,1,7,1,6,0,1,6,6,4,5,3,1,2,0,0,8
5941,797767,19,0,2,0,2,0,0,0,1,0,4,3,3,0,2,0,0
5941,792163,24,2,4,1,1,1,3,0,0,1,1,1,1,1,0,0,5
5941,797764,8,0,2,0,1,0,1,0,0,0,2,0,2,0,1,0,0
5942,780521,27,5,8,0,0,5,8,0,0,0,2,3,2,0,1,0,15
5942,775163,23,3,5,3,5,0,0,0,0,1,0,4,2,1,0,1,6
5942,791370,26,3,7,3,4,0,3,0,0,1,6,2,5,1,4,0,6
5942,786199,37,5,13,5,6,0,7,0,0,1,2,6,2,0,1,1,10
5942,780991,35,9,13,6,8,3,5,0,0,1,3,2,3,2,4,1,21
5942,780145,11,0,1,0,1,0,0,0,0,2,2,0,4,2,1,0,0
5942,781611,5,0,0,0,0,0,0,2,2,1,0,0,0,0,0,0,2
5942,797271,21,5,12,3,5,2,7,0,0,1,3,2,3,2,1,0,12
5942,743593,15,1,2,0,0,1,2,0,0,0,0,1,1,1,1,0,3
5943,797529,38,8,12,6,8,2,4,1,2,1,8,1,1,1,2,2,19
5943,797527,31,4,7,4,5,0,2,2,3,2,1,2,3,0,0,0,10
5943,791936,37,5,6,5,6,0,0,5,8,1,4,4,2,1,1,0,15
5943,797532,32,4,8,2,4,2,4,12,14,0,1,4,1,1,5,0,22
5943,785688,28,1,4,0,0,1,4,2,2,0,2,2,0,1,3,0,5
5943,791932,20,2,6,1,4,1,2,4,4,1,0,1,1,0,0,0,9
5943,791933,0,0,0,0,0,0,0,0,0,0,0,0,0,0,0,0,0
5943,785988,14,1,4,1,2,0,2,0,0,0,2,0,2,0,1,0,2
5944,791281,28,3,5,3,5,0,0,0,0,1,4,2,5,1,2,3,6
5944,791278,32,2,8,0,1,2,7,4,4,2,3,1,2,2,1,0,10
5944,792276,29,1,5,0,1,1,4,4,4,0,2,5,1,2,5,0,7
5944,786026,26,3,7,3,4,0,3,7,8,2,5,0,3,2,6,0,13
5944,785507,35,5,8,1,2,4,6,2,2,0,2,2,2,1,1,0,16
5944,796534,8,0,0,0,0,0,0,0,2,0,1,1,0,0,0,0,0
5944,796536,10,2,2,2,2,0,0,1,3,0,0,0,0,0,0,0,5
5944,796537,3,0,2,0,0,0,2,0,0,0,0,0,0,0,0,0,0
5944,796535,16,3,4,3,3,0,1,0,1,0,3,3,0,1,1,0,6
5944,785398,13,1,2,1,1,0,1,0,0,0,0,0,0,0,0,0,2
5945,780351,24,3,5,3,5,0,0,0,0,1,4,0,1,0,0,0,6
5945,797544,28,3,9,3,8,0,1,0,0,4,1,1,2,0,2,1,6
5945,780586,36,5,17,4,8,1,9,0,2,0,8,3,3,1,0,0,11
5945,797549,29,1,8,1,6,0,2,4,7,3,3,1,3,1,5,1,6
5945,790857,28,4,13,2,6,2,7,0,0,1,0,1,0,1,4,0,10
5945,797546,11,1,3,1,3,0,0,0,0,2,0,0,3,0,1,0,2
5945,797540,10,2,4,2,3,0,1,0,0,1,0,1,0,0,0,0,4
5945,791716,24,4,6,2,3,2,3,0,0,5,3,1,4,4,1,0,10
5945,791715,8,0,0,0,0,0,0,0,0,1,0,0,2,0,1,0,0
5945,789065,2,0,0,0,0,0,0,0,0,0,0,0,0,0,0,0,0
5946,780283,29,5,10,5,9,0,1,6,10,3,7,2,2,2,0,0,16
5946,790925,32,1,5,1,3,0,2,7,9,5,3,0,1,2,1,1,9
5946,791456,33,3,11,2,6,1,5,0,0,0,4,2,0,1,2,0,7
5946,785476,32,2,6,1,3,1,3,4,4,0,2,4,2,2,2,0,9
5946,785474,11,0,2,0,0,0,2,0,0,0,0,1,1,0,0,0,0
5946,790926,13,2,4,1,2,1,2,0,0,0,0,1,0,0,0,0,5
5946,785480,31,3,11,0,2,3,9,0,0,0,5,2,1,1,0,0,9
5946,780292,11,0,1,0,1,0,0,0,0,1,2,0,4,0,0,0,0
5946,796470,8,1,2,1,2,0,0,0,0,1,0,0,1,0,1,0,2
5947,790854,5,0,0,0,0,0,0,0,0,0,2,0,4,0,1,0,0
5947,796404,26,2,6,2,6,0,0,2,2,1,8,0,3,0,0,2,6
5947,790850,33,2,7,0,1,2,6,0,0,0,1,0,1,0,0,0,6
5947,781164,23,1,4,1,2,0,2,0,0,0,2,1,1,1,4,0,2
5947,781163,36,6,12,5,8,1,4,3,5,1,3,5,3,0,4,0,16
5947,790853,16,2,3,2,3,0,0,0,0,0,1,0,2,0,2,0,4
5947,790849,14,2,7,1,4,1,3,0,0,0,2,2,0,0,1,0,5
5947,785434,21,3,6,0,1,3,5,0,0,1,4,2,2,2,1,0,9
5947,790848,8,0,0,0,0,0,0,0,0,0,2,1,1,0,2,0,0
5947,796406,18,2,2,2,2,0,0,0,0,2,1,0,3,0,0,0,4
5948,786131,20,3,7,2,4,1,3,0,2,1,1,0,3,0,2,0,7
5948,780904,24,3,5,3,5,0,0,0,3,0,4,4,1,0,3,0,6
5948,797688,27,1,6,0,0,1,6,0,0,1,5,0,1,1,3,2,3
5948,786145,38,4,8,2,4,2,4,1,2,0,3,4,0,4,1,0,11
5948,786128,28,4,12,2,9,2,3,4,7,2,5,3,3,0,2,0,14
5948,792100,14,3,6,3,6,0,0,0,0,6,1,0,1,0,0,0,6
5948,785884,20,3,5,3,3,0,2,4,4,0,7,0,1,0,0,0,10
5948,797685,26,1,6,1,4,0,2,0,0,1,1,0,3,0,5,0,2
5948,792096,3,0,0,0,0,0,0,3,3,0,0,0,1,0,1,0,3
5949,785577,19,5,8,5,8,0,0,1,2,1,3,0,5,1,2,2,11
5949,791094,33,0,2,0,0,0,2,6,10,0,5,4,2,2,3,0,6
5949,791091,18,1,3,1,3,0,0,0,0,0,0,2,0,0,1,0,2
5949,791093,32,4,10,2,6,2,4,0,0,3,4,0,1,1,3,0,10
5949,785569,18,1,4,1,2,0,2,0,0,0,2,1,3,0,0,1,2
5949,791089,17,4,7,3,3,1,4,0,0,0,5,1,1,1,1,0,9
5949,791092,4,1,2,1,2,0,0,0,0,0,1,0,1,1,0,0,2
5949,796753,21,2,6,2,4,0,2,0,0,0,2,1,2,1,0,0,4
5949,796752,24,3,4,3,4,0,0,2,3,0,1,0,2,0,3,0,8
5949,791090,14,0,2,0,1,0,1,5,5,0,1,2,1,2,3,0,5
5950,775599,20,4,9,2,5,2,4,1,3,1,8,0,4,0,0,4,11
5950,792344,10,0,0,0,0,0,0,0,0,0,0,0,2,0,0,0,0
5950,792341,39,4,9,2,4,2,5,0,0,2,1,1,2,2,0,0,10
5950,792342,40,2,12,1,7,1,5,2,4,1,1,6,1,0,2,0,7
5950,792346,39,5,10,5,9,0,1,2,2,2,5,1,2,5,5,0,12
5950,798085,4,0,1,0,1,0,0,0,0,0,0,0,1,0,0,0,0
5950,798080,17,2,4,0,1,2,3,0,0,0,2,0,3,0,0,0,6
5950,792345,31,1,5,1,5,0,0,1,2,2,2,3,0,2,1,1,3
5951,797620,28,2,4,2,3,0,1,0,0,2,1,0,2,0,3,2,4
5951,781044,36,3,13,1,5,2,8,2,2,2,5,0,2,0,1,0,10
5951,797619,32,1,4,1,3,0,1,0,0,1,2,3,4,0,3,1,2
5951,786488,35,2,10,2,7,0,3,2,2,2,12,2,4,3,3,0,6
5951,781038,39,4,6,3,5,1,1,5,7,2,3,2,0,0,3,0,14
5951,786490,3,0,0,0,0,0,0,0,0,0,1,0,1,0,1,0,0
5951,786487,27,4,10,2,4,2,6,1,1,0,2,0,1,0,0,1,11
5952,791194,20,3,9,3,7,0,2,0,0,1,4,0,4,0,2,0,6
5952,780384,18,1,2,1,2,0,0,1,2,2,3,0,3,0,0,1,3
5952,780159,24,3,10,3,8,0,2,0,0,2,1,2,4,0,2,1,6
5952,786738,34,4,12,3,8,1,4,4,4,3,5,5,3,3,2,0,13
5952,775694,37,8,13,5,6,3,7,2,2,2,3,1,2,4,1,0,21
5952,791193,17,1,5,1,5,0,0,1,2,1,2,0,1,0,0,2,3
5952,796863,31,3,6,2,2,1,4,0,0,1,2,2,1,2,3,1,7
5952,796865,19,1,8,0,3,1,5,0,0,2,2,0,1,0,1,0,3
5953,785714,22,4,5,4,5,0,0,6,6,5,1,0,2,1,2,0,14
5953,775894,33,1,3,1,3,0,0,1,2,1,5,1,4,2,4,1,3
5953,785711,32,6,12,3,6,3,6,4,4,0,4,5,2,0,1,0,19
5953,780985,34,1,6,0,1,1,5,1,2,0,3,4,1,1,0,0,4
5953,775266,29,4,13,2,5,2,8,4,4,1,4,1,1,0,2,0,14
5953,796829,18,6,7,6,7,0,0,0,0,1,3,0,0,0,2,2,12
5953,779994,11,1,6,1,4,0,2,0,0,1,1,1,1,1,0,0,2
5953,791167,16,0,3,0,3,0,0,1,2,0,3,3,0,2,0,0,1
5953,785378,5,0,1,0,0,0,1,0,0,0,1,0,0,0,1,0,0
5954,796344,29,5,9,3,3,2,6,0,0,2,2,1,2,1,3,0,12
5954,790781,27,5,7,5,7,0,0,2,2,1,4,1,4,1,1,1,12
5954,780040,23,1,2,1,2,0,0,3,3,1,1,0,3,0,0,0,5
5954,796340,33,5,11,2,5,3,6,2,2,1,0,3,3,1,4,0,15
5954,780037,31,9,15,8,13,1,2,4,6,0,2,6,3,4,3,0,23
5954,796339,11,0,4,0,2,0,2,0,0,0,1,0,3,2,0,0,0
5954,781232,11,0,3,0,0,0,3,0,0,0,4,0,0,1,2,0,0
5954,790785,25,4,7,4,7,0,0,4,4,0,2,4,3,2,1,0,12
5954,796343,10,0,0,0,0,0,0,0,0,0,0,0,2,0,0,1,0
5955,792143,26,1,6,1,2,0,4,2,4,1,2,1,4,1,2,0,4
5955,786302,18,1,2,1,2,0,0,0,0,1,1,1,1,0,0,0,2
5955,786293,32,6,11,5,8,1,3,8,8,0,5,0,4,0,8,1,21
5955,780953,38,6,12,6,11,0,1,6,6,3,8,4,1,1,1,1,18
5955,797750,31,2,6,2,3,0,3,8,8,0,4,3,5,3,1,0,12
5955,797748,3,0,0,0,0,0,0,2,2,1,0,0,0,0,0,0,2
5955,797751,34,4,7,3,4,1,3,4,4,1,1,0,2,3,3,0,13
5955,797742,8,0,1,0,0,0,1,0,0,0,1,0,0,0,2,0,0
5955,792147,6,1,1,1,1,0,0,1,2,1,1,0,0,0,0,0,3
5955,786301,4,0,1,0,1,0,0,0,0,0,0,0,0,0,1,0,0
5956,781454,28,3,6,2,4,1,2,1,2,2,3,1,2,0,3,1,8
5956,786424,32,3,5,3,5,0,0,3,6,5,11,1,2,0,3,5,9
5956,792366,17,2,4,2,3,0,1,4,6,0,5,0,1,0,1,1,8
5956,791015,27,3,8,0,3,3,5,0,1,0,1,4,2,1,0,0,9
5956,785483,28,3,8,3,6,0,2,7,8,0,0,5,5,0,4,0,13
5956,785959,7,1,1,1,1,0,0,0,2,0,1,1,0,0,0,2,2
5956,797988,14,1,1,1,1,0,0,0,0,0,0,1,3,0,1,0,2
5956,797979,33,2,9,2,5,0,4,1,2,1,2,1,2,0,0,0,5
5956,792279,6,0,0,0,0,0,0,0,0,0,0,0,0,2,0,0,0
5956,775335,7,2,5,0,0,2,5,0,0,0,0,0,1,0,0,0,6
5956,797991,1,0,0,0,0,0,0,0,0,0,0,0,0,0,0,0,0
5957,791868,38,7,15,6,12,1,3,1,2,1,2,2,3,0,1,2,16
5957,797802,10,1,1,1,1,0,0,0,0,0,1,1,3,0,0,0,2
5957,797809,11,0,2,0,2,0,0,1,2,0,1,1,2,0,2,0,1
5957,797807,40,5,11,1,6,4,5,10,10,1,5,1,2,0,0,0,24
5957,786058,40,3,5,1,3,2,2,2,2,0,1,4,3,1,1,1,10
5957,797810,5,0,0,0,0,0,0,0,0,0,0,0,1,0,0,0,0
5957,797808,28,3,8,3,7,0,1,1,1,1,3,2,4,2,0,0,7
5957,792264,28,4,9,2,4,2,5,0,0,0,8,0,3,1,1,0,10
5958,786481,26,8,16,8,15,0,1,8,10,1,5,1,4,0,3,0,24
5958,797626,26,5,8,3,6,2,2,1,3,2,1,3,5,1,2,0,13
5958,797624,32,4,6,2,2,2,4,1,2,0,4,1,3,1,0,2,11
5958,786480,32,1,5,0,2,1,3,4,4,0,3,5,2,1,0,1,7
5958,781032,34,4,11,1,3,3,8,0,0,0,1,3,4,0,2,0,11
5958,797628,17,2,4,1,3,1,1,0,0,0,0,0,4,1,0,1,5
5958,791793,13,0,3,0,3,0,0,4,4,1,3,0,2,0,1,0,4
5958,797627,2,1,1,0,0,1,1,0,0,0,0,0,0,1,1,0,3
5958,785965,18,4,7,3,4,1,3,0,1,0,1,1,4,0,0,0,9
5959,797779,40,7,12,3,5,4,7,1,1,0,5,0,1,2,0,1,19
5959,785568,36,6,8,6,8,0,0,2,4,2,5,0,2,2,2,0,14
5959,797778,21,3,5,2,2,1,3,0,0,0,3,0,1,0,0,1,7
5959,786256,25,1,4,1,4,0,0,7,9,4,5,3,3,0,0,0,9
5959,797774,35,7,13,5,9,2,4,12,16,0,1,10,3,1,5,0,28
5959,797770,15,3,5,2,3,1,2,4,4,0,3,0,5,0,1,1,11
5959,797768,5,2,3,1,1,1,2,0,0,0,1,0,0,0,0,0,5
5959,775106,23,2,3,2,3,0,0,2,3,0,3,1,1,0,0,0,6
5960,781605,16,2,3,2,3,0,0,0,0,0,2,0,0,0,3,0,4
5960,792306,28,5,10,3,3,2,7,5,6,4,3,3,2,5,3,2,17
5960,792300,24,4,7,4,6,0,1,1,1,0,4,4,1,0,0,0,9
5960,792303,28,6,10,3,5,3,5,8,8,1,1,7,1,2,1,1,23
5960,781603,34,9,15,4,7,5,8,6,10,0,4,2,1,1,1,0,29
5960,776424,12,0,3,0,2,0,1,0,0,1,4,1,2,0,2,0,0
5960,780456,21,2,4,0,0,2,4,0,0,0,3,1,0,0,1,0,6
5960,790813,11,1,4,0,0,1,4,0,0,0,1,1,1,1,1,0,3
5960,797914,6,0,0,0,0,0,0,0,0,0,0,0,2,0,1,0,0
5960,797912,15,0,3,0,0,0,3,2,2,2,1,2,3,0,0,0,2
5960,797907,2,0,0,0,0,0,0,0,0,2,0,0,3,0,1,1,0
5960,781607,2,0,0,0,0,0,0,0,0,0,0,0,0,0,0,0,0
5960,797902,1,0,0,0,0,0,0,0,0,0,0,0,0,0,0,0,0
5961,790914,22,1,2,1,2,0,0,2,4,2,3,1,4,1,0,1,4
5961,780798,23,4,5,2,2,2,3,1,2,2,2,1,4,0,2,0,11
5961,785455,32,2,15,0,9,2,6,0,0,0,2,4,0,0,4,0,6
5961,785453,30,7,16,4,7,3,9,4,4,2,2,1,1,2,1,0,21
5961,774940,24,5,7,4,5,1,2,0,0,0,1,3,2,3,5,0,11
5961,785458,20,6,9,5,8,1,1,0,0,0,6,2,4,0,1,0,13
5961,790915,14,1,2,1,2,0,0,0,1,0,0,0,3,2,1,0,2
5961,790913,12,4,4,4,4,0,0,2,2,1,2,0,2,0,1,0,10
5961,785454,11,0,0,0,0,0,0,0,1,1,1,1,2,0,1,0,0
5961,785456,9,1,2,0,0,1,2,0,0,0,1,0,0,0,0,0,3
5961,790911,3,0,0,0,0,0,0,0,0,0,0,0,0,0,0,0,0
5962,774806,33,2,7,2,6,0,1,2,5,2,16,3,4,2,8,3,6
5962,775823,28,5,7,5,6,0,1,2,2,5,7,1,4,0,3,0,12
5962,791041,40,9,16,3,7,6,9,2,4,3,4,4,3,0,2,0,26
5962,791038,38,3,10,1,3,2,7,2,2,0,4,1,2,1,3,0,10
5962,789023,40,8,16,6,11,2,5,2,3,0,3,8,2,0,6,0,20
5962,796714,7,0,0,0,0,0,0,1,2,0,1,0,1,0,1,0,1
5962,796711,1,0,1,0,1,0,0,0,0,0,0,0,0,0,0,0,0
5962,775205,13,0,0,0,0,0,0,0,0,0,0,0,4,0,0,1,0
5963,796892,20,6,10,6,10,0,0,1,2,2,4,0,2,1,2,0,13
5963,796891,23,4,7,2,4,2,3,1,2,1,3,0,4,1,2,1,11
5963,796884,35,6,13,5,11,1,2,1,1,2,2,3,0,2,1,0,14
5963,796882,35,9,16,6,11,3,5,1,3,0,1,6,1,4,2,0,22
5963,790447,31,2,7,2,7,0,0,2,2,0,1,4,2,2,0,0,6
5963,796890,1,0,0,0,0,0,0,0,0,0,0,0,3,0,1,0,0
5963,796886,30,3,5,2,3,1,2,0,0,1,8,3,1,0,2,0,7
5963,796896,18,1,8,1,3,0,5,4,6,0,3,1,2,2,0,0,6
5963,796887,7,0,1,0,1,0,0,0,0,0,0,0,0,0,1,0,0
5964,791053,15,0,2,0,2,0,0,0,0,2,1,1,1,0,2,1,0
5964,780739,38,11,15,11,15,0,0,4,7,3,2,1,1,3,0,2,26
5964,785524,20,3,6,3,3,0,3,0,0,1,3,2,4,0,4,0,6
5964,781115,26,5,9,5,9,0,0,0,1,1,4,4,2,0,1,1,10
5964,775456,27,8,13,7,11,1,2,3,3,0,3,5,1,1,5,0,20
5964,796731,21,6,9,6,9,0,0,0,0,3,3,1,5,3,2,0,12
5964,796730,8,0,2,0,1,0,1,0,0,0,0,0,0,0,0,0,0
5964,791051,8,0,1,0,1,0,0,0,0,0,3,0,1,0,2,0,0
5964,790819,26,2,7,2,5,0,2,0,0,1,3,5,2,0,2,0,4
5964,775094,11,2,3,1,1,1,2,0,0,0,4,0,3,0,1,0,5
5965,780723,12,0,1,0,1,0,0,4,4,0,2,0,3,0,4,0,4
5965,775838,32,7,12,7,11,0,1,1,1,0,2,1,2,1,2,1,15
5965,796726,36,4,10,2,6,2,4,4,4,0,3,4,2,0,3,0,14
5965,791048,38,3,7,1,2,2,5,2,2,0,6,4,2,0,1,1,10
5965,786531,35,5,10,2,3,3,7,2,5,0,4,1,3,2,3,0,15
5965,791044,11,0,1,0,1,0,0,0,2,0,1,0,0,0,1,0,0
5965,796729,25,3,7,1,2,2,5,7,7,1,1,0,1,1,0,0,15
5965,796727,11,0,3,0,0,0,3,0,0,0,0,0,1,0,0,0,0
5966,791760,13,1,5,1,4,0,1,0,0,1,2,0,0,0,4,0,2
5966,780256,29,0,2,0,1,0,1,0,1,1,4,0,2,2,4,0,0
5966,796883,31,1,3,0,2,1,1,0,0,1,1,2,2,1,4,0,3
5966,796880,39,6,15,5,10,1,5,9,10,2,3,3,2,5,3,0,22
5966,791334,37,5,10,3,6,2,4,4,4,1,1,0,3,2,2,0,16
5966,785874,32,2,4,1,2,1,2,0,0,1,6,2,3,0,0,1,5
5966,796879,13,1,4,1,3,0,1,0,0,1,1,1,0,0,0,0,2
5966,791757,15,2,6,0,3,2,3,0,0,0,2,1,0,1,1,0,6
5966,781590,16,2,4,2,4,0,0,2,2,0,4,0,5,0,1,0,6
5967,786296,16,0,4,0,3,0,1,0,0,0,3,0,0,0,0,0,0
5967,781530,33,7,15,6,13,1,2,5,5,3,6,0,2,1,6,0,20
5967,776423,34,8,14,8,14,0,0,0,0,4,7,1,4,0,0,2,16
5967,792307,24,0,3,0,0,0,3,0,0,0,3,2,2,1,1,0,0
5967,792319,29,1,4,1,2,0,2,0,0,0,0,0,2,0,4,0,2
5967,792314,9,1,1,1,1,0,0,0,0,0,1,0,0,0,0,0,2
5967,792320,11,2,2,2,2,0,0,0,0,3,0,1,2,0,0,1,4
5967,798106,17,1,3,1,3,0,0,1,1,0,0,0,1,1,1,1,3
5967,798104,15,2,6,1,4,1,2,2,2,1,1,1,5,1,4,0,7
5967,798096,23,3,10,2,7,1,3,0,0,0,0,0,1,1,1,0,7
5967,792309,11,0,1,0,1,0,0,0,0,0,2,0,1,0,2,0,0
5967,792321,3,0,0,0,0,0,0,0,0,0,0,0,1,1,0,0,0
6000,790877,31,2,4,2,4,0,0,4,4,3,2,2,3,1,1,0,8
6000,785432,17,1,4,1,4,0,0,0,0,2,4,0,1,0,0,0,2
6000,790876,38,7,15,4,8,3,7,1,3,1,3,4,2,2,3,0,18
6000,785699,33,6,13,5,9,1,4,1,2,0,5,1,4,3,4,0,14
6000,781062,34,4,10,1,6,3,4,1,3,0,5,2,1,2,2,0,12
6000,779985,23,5,13,4,7,1,6,1,1,1,5,0,2,0,1,0,12
6000,790879,22,0,3,0,3,0,0,0,1,5,3,0,3,1,1,1,0
6000,796434,2,0,0,0,0,0,0,0,0,0,0,0,0,0,0,0,0
6001,780058,27,6,14,3,4,3,10,0,2,0,5,2,2,1,0,1,15
6001,780059,36,2,4,1,3,1,1,2,4,3,3,5,3,3,5,0,7
6001,796494,26,2,6,1,3,1,3,0,0,0,3,0,0,0,2,0,5
6001,790944,31,5,12,3,9,2,3,2,2,0,3,2,2,2,2,0,14
6001,780061,34,2,8,0,1,2,7,3,4,0,5,1,2,0,4,2,9
6001,790941,4,0,1,0,0,0,1,0,0,1,0,0,1,0,0,0,0
6001,796496,20,4,6,3,4,1,2,2,2,1,4,1,3,0,1,0,11
6001,796497,2,0,0,0,0,0,0,0,0,0,1,0,0,0,0,0,0
6001,790943,7,0,2,0,1,0,1,0,0,0,0,0,2,0,0,0,0
6001,786754,13,0,1,0,1,0,0,0,0,0,1,1,2,1,2,0,0
6002,792486,7,0,1,0,1,0,0,0,0,0,0,1,4,1,1,0,0
6002,785772,23,4,6,4,6,0,0,0,0,4,3,0,3,4,1,2,8
6002,785778,25,3,5,3,5,0,0,2,2,0,5,2,3,1,3,0,8
6002,785766,19,3,6,2,4,1,2,0,0,1,5,2,1,0,0,0,7
6002,792488,28,5,10,1,3,4,7,3,4,1,2,4,1,3,0,0,17
6002,792479,2,0,0,0,0,0,0,0,0,0,0,0,1,1,0,0,0
6002,780544,15,1,2,1,2,0,0,3,3,0,1,0,2,1,1,0,5
6002,797417,1,0,1,0,1,0,0,0,0,0,0,0,0,0,0,0,0
6002,797419,18,1,6,1,3,0,3,1,2,0,1,1,3,1,1,0,3
6002,792482,23,0,3,0,0,0,3,2,2,0,7,3,0,1,2,1,2
6002,780543,33,8,16,6,10,2,6,2,3,0,2,1,1,0,3,1,20
6002,792484,2,0,0,0,0,0,0,0,0,0,0,0,0,0,0,0,0
6002,785774,4,0,0,0,0,0,0,0,0,0,0,0,0,0,0,0,0
6003,791548,26,4,11,2,6,2,5,0,1,0,8,0,1,0,2,0,10
6003,791550,16,2,3,2,3,0,0,0,3,0,2,1,4,0,1,0,4
6003,786364,30,1,3,1,2,0,1,4,4,1,0,1,2,0,5,0,6
6003,780330,22,2,6,2,4,0,2,0,0,1,1,1,3,1,0,2,4
6003,797082,20,1,3,0,2,1,1,3,4,1,5,3,1,2,0,1,6
6003,786366,6,1,1,1,1,0,0,0,0,0,1,0,3,0,0,0,2
6003,780332,16,0,2,0,1,0,1,0,1,0,2,1,1,0,1,2,0
6003,797080,12,1,4,0,2,1,2,2,4,0,1,0,1,0,1,0,5
6003,786368,15,2,4,2,2,0,2,0,1,1,1,0,0,1,0,0,4
6003,789984,3,0,0,0,0,0,0,0,0,0,0,0,0,0,1,0,0
6003,786365,9,1,1,0,0,1,1,0,0,0,1,1,0,0,0,0,3
6003,780329,25,3,9,3,7,0,2,2,2,0,0,2,2,1,7,0,8
6004,785589,37,11,16,11,16,0,0,4,6,3,5,1,2,2,0,0,26
6004,776313,27,0,5,0,3,0,2,1,2,1,1,1,2,0,1,0,1
6004,791213,33,5,11,4,8,1,3,2,2,1,2,6,3,1,1,0,13
6004,791214,16,0,3,0,1,0,2,0,0,1,3,3,1,1,3,0,0
6004,791215,36,6,15,3,6,3,9,0,0,0,1,4,4,3,5,0,15
6004,791216,21,2,4,1,3,1,1,2,3,1,2,5,5,1,1,1,7
6004,791210,14,0,3,0,2,0,1,2,3,1,0,1,2,0,1,0,2
6004,791209,16,1,1,1,1,0,0,2,2,2,1,0,4,0,1,2,4
6005,785913,32,7,10,7,10,0,0,2,6,2,6,2,3,1,1,1,16
6005,786516,27,4,11,0,2,4,9,2,2,0,3,0,2,0,1,0,14
6005,781464,24,1,2,0,1,1,1,0,0,0,3,1,0,0,1,0,3
6005,781502,31,2,6,2,5,0,1,7,8,1,3,1,2,1,5,0,11
6005,780259,36,6,9,5,7,1,2,8,11,2,8,3,4,1,3,1,21
6005,785282,14,0,1,0,1,0,0,0,0,0,1,2,1,0,1,0,0
6005,781501,27,3,7,3,4,0,3,4,5,2,1,4,0,2,1,0,10
6005,792277,6,1,2,1,2,0,0,0,0,1,0,0,2,0,0,1,2
6005,798051,3,0,0,0,0,0,0,0,0,0,1,0,1,0,0,0,0
6006,792140,17,1,3,1,3,0,0,0,0,1,1,0,4,1,3,1,2
6006,786596,32,9,15,6,10,3,5,1,1,0,5,1,2,1,1,1,22
6006,792144,25,3,9,0,2,3,7,0,0,1,3,2,2,2,0,0,9
6006,781429,34,1,5,0,0,1,5,2,2,0,2,2,3,0,2,0,5
6006,776092,36,4,12,2,7,2,5,4,6,4,4,7,2,2,3,1,14
6006,797791,2,1,1,1,1,0,0,0,0,0,1,0,0,0,1,0,2
6006,792146,13,3,5,3,5,0,0,0,0,1,3,1,0,1,0,1,6
6006,797793,31,3,8,0,1,3,7,0,0,0,2,1,1,0,0,1,9
6006,797787,8,0,1,0,0,0,1,0,0,0,2,0,1,0,1,1,0
6006,785976,2,0,2,0,1,0,1,0,0,0,0,0,0,0,0,0,0
6007,781335,33,7,12,5,9,2,3,1,1,0,1,3,2,2,3,2,17
6007,776351,36,6,12,5,6,1,6,0,1,0,6,2,1,1,1,1,13
6007,796538,13,1,1,1,1,0,0,0,0,0,1,0,1,0,0,0,2
6007,785770,34,5,11,4,8,1,3,2,2,1,2,1,2,1,1,0,13
6007,781341,35,5,9,1,3,4,6,2,2,1,3,5,2,0,0,0,16
6007,796542,8,1,3,1,2,0,1,0,2,0,4,0,2,1,1,0,2
6007,791285,3,0,0,0,0,0,0,0,0,0,0,0,1,0,0,0,0
6007,785775,35,5,8,4,6,1,2,1,3,1,8,4,2,1,6,1,12
6007,791284,3,0,0,0,0,0,0,0,0,0,0,0,0,0,0,0,0
6008,792261,38,2,8,2,8,0,0,2,4,6,6,3,2,2,1,3,6
6008,792258,37,7,17,1,6,6,11,2,2,1,3,2,4,1,2,0,22
6008,786122,30,4,11,1,5,3,6,4,4,1,2,2,2,2,1,0,15
6008,786331,8,2,4,2,3,0,1,0,0,3,1,0,1,0,1,0,4
6008,776284,37,7,18,5,12,2,6,0,2,0,1,1,3,2,3,0,16
6008,797980,22,2,3,2,3,0,0,5,7,3,3,2,3,1,0,0,9
6008,786113,15,1,4,1,4,0,0,0,0,1,0,1,0,1,0,0,2
6008,780308,13,0,4,0,2,0,2,0,0,0,0,0,4,0,2,0,0
6009,792110,17,3,5,3,5,0,0,3,3,1,1,2,3,0,0,0,9
6009,786031,28,6,11,5,9,1,2,6,7,1,5,2,4,0,3,0,19
6009,797734,33,4,7,3,5,1,2,0,0,0,5,2,0,1,3,0,9
6009,797735,33,9,12,6,6,3,6,2,2,0,2,1,2,0,1,0,23
6009,781386,33,4,9,3,7,1,2,7,7,0,2,3,2,2,5,0,16
6009,786033,23,3,4,3,4,0,0,2,3,0,8,1,2,0,0,4,8
6009,797733,15,0,2,0,2,0,0,0,0,0,3,4,0,0,1,0,0
6009,792109,12,0,0,0,0,0,0,0,0,0,1,0,1,0,1,0,0
6009,792107,6,0,0,0,0,0,0,0,0,0,0,0,0,0,0,0,0
6010,791356,40,8,11,8,11,0,0,1,3,2,6,2,3,2,1,0,17
6010,797431,32,3,7,2,4,1,3,0,0,0,2,4,4,0,1,0,7
6010,791680,32,2,9,2,3,0,6,0,0,1,2,2,1,1,0,1,4
6010,785812,37,4,11,0,0,4,11,0,0,1,2,2,3,0,0,0,12
6010,780104,40,7,19,4,10,3,9,4,4,0,2,7,3,0,3,1,21
6010,791681,18,6,6,6,6,0,0,0,0,4,2,0,5,0,0,0,12
6010,791682,1,0,0,0,0,0,0,0,0,0,0,0,1,0,0,0,0
6011,791344,26,7,10,6,7,1,3,1,2,5,4,1,4,0,3,0,16
6011,781425,30,8,11,8,11,0,0,2,2,1,6,1,0,0,1,0,18
6011,797001,20,2,5,2,4,0,1,2,2,0,2,2,0,0,0,0,6
6011,791343,33,0,7,0,5,0,2,1,4,0,5,6,2,1,1,0,1
6011,781602,40,5,9,2,2,3,7,4,4,0,3,3,1,1,1,0,17
6011,781601,10,0,0,0,0,0,0,0,1,3,3,0,0,0,0,0,0
6011,776173,4,0,0,0,0,0,0,0,0,0,0,0,0,0,1,0,0
6011,797000,10,2,2,1,1,1,1,2,2,1,1,1,1,1,1,0,7
6011,796998,0,0,1,0,1,0,0,0,0,0,0,0,2,0,0,0,0
6011,786611,27,7,9,5,5,2,4,1,1,0,1,0,3,0,1,0,17
6012,790935,22,2,4,1,1,1,3,2,4,0,1,0,0,1,1,0,7
6012,792442,16,2,2,2,2,0,0,0,0,1,7,0,2,0,2,0,4
6012,780933,15,1,4,0,1,1,3,0,0,0,2,0,0,0,1,0,3
6012,775340,29,7,11,6,7,1,4,1,2,0,4,6,0,1,2,0,16
6012,774826,19,0,5,0,3,0,2,0,0,0,1,1,2,1,0,0,0
6012,796190,17,3,6,1,1,2,5,1,2,0,3,1,1,2,0,0,9
6012,790937,20,3,4,3,4,0,0,3,3,2,5,0,2,2,3,0,9
6012,785445,17,4,4,2,2,2,2,0,0,0,1,2,2,1,0,0,10
6012,790938,20,2,8,1,4,1,4,1,2,0,1,0,3,1,2,0,6
6012,796492,11,2,4,2,4,0,0,0,1,1,2,0,0,0,0,0,4
6012,796493,4,1,1,1,1,0,0,1,4,2,0,0,1,0,0,2,3
6012,790936,4,1,2,1,1,0,1,1,1,1,1,0,0,0,0,0,3
6012,796491,5,0,2,0,1,0,1,0,0,1,1,0,0,0,0,0,0
6012,786778,1,0,0,0,0,0,0,0,0,0,0,0,0,0,0,0,0
6013,775087,23,3,8,3,7,0,1,2,2,1,3,0,3,0,2,0,8
6013,790984,25,2,5,1,3,1,2,0,0,0,2,1,5,0,1,0,5
6013,785297,33,1,5,0,1,1,4,0,0,0,6,1,2,1,2,0,3
6013,785296,31,2,5,1,1,1,4,1,2,0,4,1,0,1,7,1,6
6013,780212,32,6,15,5,10,1,5,0,0,0,3,3,1,1,2,0,13
6013,790985,16,2,3,2,3,0,0,0,1,0,2,0,1,0,2,1,4
6013,780215,8,0,0,0,0,0,0,0,0,0,3,0,3,0,1,1,0
6013,796596,28,1,8,1,3,0,5,0,0,1,1,1,1,0,1,0,2
6013,796597,4,0,1,0,0,0,1,1,2,0,0,1,1,1,0,0,1
6014,790863,34,2,3,1,2,1,1,2,4,5,8,2,1,2,1,0,7
6014,780021,35,13,16,13,16,0,0,7,15,5,6,1,3,0,3,3,33
6014,785413,33,5,11,4,10,1,1,0,0,0,2,1,2,1,2,1,11
6014,785412,34,10,19,2,6,8,13,8,9,0,1,4,0,1,2,0,36
6014,776214,31,4,8,4,4,0,4,2,4,0,1,5,4,0,2,0,10
6014,775686,11,0,0,0,0,0,0,0,0,0,3,1,3,0,0,0,0
6014,780099,29,1,4,0,0,1,4,2,3,0,1,2,2,0,1,2,5
6014,785411,2,0,0,0,0,0,0,0,0,0,0,1,1,0,0,0,0
6014,776221,10,0,0,0,0,0,0,0,0,0,0,2,0,0,0,1,0
6014,785417,6,0,0,0,0,0,0,0,0,0,1,0,0,0,0,0,0
6015,780874,34,6,10,3,4,3,6,2,2,1,4,1,4,0,2,0,17
6015,781326,19,2,3,2,3,0,0,2,3,2,1,0,5,0,1,0,6
6015,792215,24,3,6,2,5,1,1,0,0,1,0,1,1,1,0,0,7
6015,797870,41,12,20,10,16,2,4,2,2,2,3,5,1,3,0,1,28
6015,781323,34,6,16,5,12,1,4,2,3,0,4,3,4,1,3,0,15
6015,785430,20,4,6,4,6,0,0,3,4,3,4,0,2,0,0,0,11
6015,792210,31,4,7,4,6,0,1,2,3,0,0,1,5,1,0,0,10
6015,785638,11,0,1,0,1,0,0,0,0,0,2,1,1,1,1,0,0
6015,792213,4,1,1,1,1,0,0,0,0,0,0,0,0,0,1,0,2
6015,797869,7,1,1,1,1,0,0,0,0,1,1,0,0,1,0,0,2
6016,797142,21,0,0,0,0,0,0,0,0,1,1,2,2,0,2,1,0
6016,791522,30,2,11,2,9,0,2,0,2,0,4,2,5,1,2,1,4
6016,786351,21,4,5,2,2,2,3,1,2,4,5,0,2,1,1,0,11
6016,797146,39,6,20,3,11,3,9,10,11,0,0,0,1,2,3,1,25
6016,797143,37,12,18,8,11,4,7,1,2,0,0,1,2,3,2,0,29
6016,785479,21,1,2,1,2,0,0,0,0,4,2,0,2,1,0,0,2
6016,785816,19,0,0,0,0,0,0,0,1,1,5,1,5,2,0,0,0
6016,797147,12,0,2,0,0,0,2,0,0,0,1,2,1,0,2,0,0
6017,780323,24,3,8,3,8,0,0,0,2,7,5,2,2,0,1,1,6
6017,797894,16,1,1,1,1,0,0,0,0,1,1,1,0,0,3,1,2
6017,792229,32,5,10,5,9,0,1,0,0,1,5,3,4,0,3,0,10
6017,785954,32,3,8,1,3,2,5,0,0,0,1,3,3,0,0,0,8
6017,785811,36,7,15,4,8,3,7,5,6,2,3,0,0,2,2,0,22
6017,792233,30,6,13,4,7,2,6,9,10,2,8,0,3,2,1,0,23
6017,792230,2,0,0,0,0,0,0,0,0,0,0,0,1,0,1,0,0
6017,797891,7,0,3,0,0,0,3,2,2,1,0,0,0,0,0,0,2
6017,792234,5,0,1,0,1,0,0,0,0,0,0,0,0,0,0,0,0
6017,786016,16,1,3,1,2,0,1,1,1,1,1,1,0,0,2,0,3
6018,797824,20,2,5,1,2,1,3,0,0,0,1,0,3,1,3,1,5
6018,797825,15,1,2,1,2,0,0,0,0,1,1,1,3,1,0,1,2
6018,792190,39,2,8,1,2,1,6,0,0,0,3,6,1,1,2,0,5
6018,791928,5,0,2,0,1,0,1,0,0,0,1,0,0,0,0,0,0
6018,786664,39,6,13,5,8,1,5,4,4,1,1,2,2,3,5,0,17
6018,797828,1,0,0,0,0,0,0,0,0,0,0,0,0,0,0,0,0
6018,775116,28,5,11,4,7,1,4,0,0,5,3,3,3,0,2,0,11
6018,797822,26,3,13,3,6,0,7,2,2,2,2,1,0,4,3,0,8
6018,792191,19,2,3,2,3,0,0,0,0,1,2,0,1,0,2,0,4
6018,781266,8,1,2,0,0,1,2,0,0,0,1,0,0,0,1,0,3
6019,797292,26,9,16,9,16,0,0,4,8,4,9,1,0,1,4,2,22
6019,780509,26,5,6,5,6,0,0,0,0,3,3,1,3,0,3,0,10
6019,797290,30,3,5,2,2,1,3,2,3,0,5,3,1,3,4,0,9
6019,797291,26,3,4,3,4,0,0,1,1,0,1,4,0,1,2,1,7
6019,786064,36,6,9,3,4,3,5,0,0,0,2,1,0,1,3,0,15
6019,791658,8,0,0,0,0,0,0,0,0,3,0,0,2,1,1,0,0
6019,791663,1,0,0,0,0,0,0,0,0,0,0,0,0,0,0,0,0
6019,791661,1,1,1,0,0,1,1,0,0,0,1,0,1,1,0,0,3
6019,785658,19,2,3,1,1,1,2,0,0,0,1,1,0,0,2,0,5
6019,797295,1,0,0,0,0,0,0,0,0,0,0,0,0,0,0,0,0
6019,797294,1,0,1,0,0,0,1,0,0,0,0,0,0,0,0,0,0
6019,797293,1,0,0,0,0,0,0,0,0,0,0,1,0,0,0,0,0
6019,791660,24,1,9,0,5,1,4,0,0,0,1,5,1,0,0,0,3
6020,785740,29,2,6,2,6,0,0,1,2,6,5,0,2,0,1,0,5
6020,785809,35,3,12,3,10,0,2,2,2,5,1,2,3,1,0,1,8
6020,780530,37,9,16,8,11,1,5,0,0,7,3,0,2,0,1,6,19
6020,797402,29,3,9,1,4,2,5,0,0,0,0,0,2,1,1,0,8
6020,785738,39,4,18,3,13,1,5,0,0,1,7,6,2,1,2,1,9
6020,797396,6,2,4,2,3,0,1,0,0,2,2,0,1,0,1,0,4
6020,785739,2,0,0,0,0,0,0,0,0,0,0,0,1,0,0,0,0
6020,786144,15,1,6,1,3,0,3,0,0,0,0,2,1,0,0,0,2
6020,791664,8,1,3,0,1,1,2,0,0,0,1,0,1,0,0,0,3
6021,797380,32,1,6,1,3,0,3,2,2,2,3,1,2,0,3,0,4
6021,797379,33,6,7,6,7,0,0,0,0,3,5,1,1,1,2,2,12
6021,797377,24,3,4,1,1,2,3,1,2,0,3,1,1,1,0,0,9
6021,791818,32,3,13,3,9,0,4,1,1,2,4,1,2,0,1,0,7
6021,780646,22,1,4,0,2,1,2,2,2,0,4,3,3,0,0,0,5
6021,797382,11,1,5,1,4,0,1,2,2,1,2,0,3,0,0,0,4
6021,797375,3,0,0,0,0,0,0,0,0,0,0,0,0,0,0,0,0
6021,797378,19,2,4,2,4,0,0,0,0,0,0,0,0,1,0,0,4
6021,786636,24,4,9,2,3,2,6,6,6,0,1,1,1,0,3,0,16
6022,797205,13,3,4,3,4,0,0,2,2,2,3,0,0,0,2,0,8
6022,786316,26,6,15,6,15,0,0,2,2,1,4,2,3,0,2,0,14
6022,791475,15,1,3,0,0,1,3,0,0,0,0,2,3,0,3,0,3
6022,791477,30,2,9,2,9,0,0,3,4,3,5,3,4,1,0,1,7
6022,780220,32,7,15,6,12,1,3,0,0,1,3,2,3,2,3,0,15
6022,797206,24,2,6,2,6,0,0,3,4,2,6,0,2,1,1,0,7
6022,786314,28,4,12,3,8,1,4,0,0,2,8,1,0,1,0,1,9
6022,797202,7,0,0,0,0,0,0,0,0,0,0,1,3,0,3,0,0
6022,791476,25,1,8,1,4,0,4,5,5,3,0,0,3,1,0,0,7
6023,780346,34,6,18,5,15,1,3,10,11,1,7,0,3,2,3,0,23
6023,780338,6,0,0,0,0,0,0,0,0,0,0,0,4,1,2,0,0
6023,791030,22,4,4,4,4,0,0,0,0,0,0,3,0,0,0,0,8
6023,785477,33,4,6,4,5,0,1,2,2,0,8,0,3,0,2,0,10
6023,785475,21,6,12,2,4,4,8,0,0,0,3,0,1,0,0,1,16
6023,791032,4,0,0,0,0,0,0,0,0,0,0,0,1,0,1,0,0
6023,796689,20,3,4,3,4,0,0,2,3,1,6,2,4,0,0,0,8
6023,791031,13,0,1,0,0,0,1,0,0,0,2,0,1,0,0,1,0
6023,796687,24,4,8,3,6,1,2,8,9,0,2,4,1,3,3,0,17
6023,786655,23,1,3,1,2,0,1,0,0,0,3,1,1,1,1,0,2
6024,787524,25,4,13,4,8,0,5,3,6,1,10,1,0,1,3,1,11
6024,787522,15,3,6,3,6,0,0,0,1,3,2,0,2,1,1,0,6
6024,781019,28,5,7,4,6,1,1,4,5,0,2,10,1,3,3,0,15
6024,780017,21,4,7,1,2,3,5,0,0,1,0,1,3,2,0,0,11
6024,775961,23,4,8,3,5,1,3,1,2,0,2,1,2,0,2,0,10
6024,775541,17,2,4,1,2,1,2,1,2,0,4,0,1,1,3,0,6
6024,797611,11,1,2,1,1,0,1,2,2,0,3,0,1,0,2,0,4
6024,791774,12,1,2,1,2,0,0,0,0,2,1,0,2,0,2,0,2
6024,791772,18,0,3,0,1,0,2,1,2,0,3,2,1,1,0,0,1
6024,791722,8,1,2,1,1,0,1,0,0,0,0,0,0,0,0,0,2
6024,780328,22,1,4,1,4,0,0,0,0,0,1,4,3,0,1,0,2
6025,781658,32,3,8,3,8,0,0,3,6,4,6,2,2,0,2,0,9
6025,781656,16,0,3,0,3,0,0,1,2,0,2,0,3,0,3,2,1
6025,796964,21,2,4,2,3,0,1,0,0,0,0,1,1,1,2,0,4
6025,786798,40,4,15,4,15,0,0,4,5,1,9,9,1,4,1,0,12
6025,780129,31,2,10,0,3,2,7,0,0,1,2,2,1,2,2,1,6
6025,798206,11,1,3,1,1,0,2,0,1,1,1,1,0,1,0,0,2
6025,790256,1,0,1,0,1,0,0,0,0,1,0,0,0,0,0,0,0
6025,791263,16,1,3,1,2,0,1,3,4,0,4,0,3,1,1,0,5
6025,796966,4,1,1,1,1,0,0,0,0,0,0,0,1,0,0,0,2
6025,796962,28,5,9,1,1,4,8,3,4,0,3,0,2,0,4,0,17
6026,780919,27,3,6,3,6,0,0,1,1,0,2,0,1,0,0,1,7
6026,775816,23,4,7,2,3,2,4,0,0,0,5,0,1,1,0,0,10
6026,785803,28,2,5,0,2,2,3,0,0,3,2,2,5,1,1,0,6
6026,780920,25,5,14,2,7,3,7,2,2,0,2,4,3,1,2,1,15
6026,780914,29,4,8,3,5,1,3,0,0,1,2,2,2,1,1,0,9
6026,796797,15,1,3,0,1,1,2,2,2,0,4,1,2,1,2,0,5
6026,775640,14,4,4,4,4,0,0,0,0,0,0,1,3,0,1,0,8
6026,791142,19,3,6,0,1,3,5,0,1,2,3,1,3,0,1,0,9
6026,791141,19,2,8,1,4,1,4,0,0,0,1,6,0,0,2,1,5
6026,796801,1,0,0,0,0,0,0,0,0,0,0,0,0,0,0,0,0
6027,792351,34,4,6,4,4,0,2,1,2,2,4,2,3,0,2,0,9
6027,786723,35,5,14,4,11,1,3,6,8,1,9,4,1,1,2,0,17
6027,792349,21,1,3,1,2,0,1,2,2,1,6,2,1,0,1,0,4
6027,798060,34,3,7,1,4,2,3,0,0,0,3,1,4,0,2,1,8
6027,792352,17,0,1,0,0,0,1,0,0,0,1,2,0,0,2,0,0
6027,786724,23,4,6,3,3,1,3,0,0,0,2,1,0,1,0,0,9
6027,798061,17,1,2,0,1,1,1,4,4,0,0,2,1,0,0,1,7
6027,792355,17,8,13,4,7,4,6,3,3,0,0,0,2,1,1,0,23
6027,786726,2,0,0,0,0,0,0,0,0,0,0,0,0,0,0,0,0
6028,786553,32,8,12,5,9,3,3,1,2,1,4,1,0,1,1,0,20
6028,792005,19,1,6,1,3,0,3,0,0,0,2,3,1,1,0,0,2
6028,780895,36,8,15,8,14,0,1,2,2,1,7,3,0,1,0,0,18
6028,781175,28,5,7,5,7,0,0,7,11,1,8,1,2,1,1,1,17
6028,781172,30,2,5,0,1,2,4,3,4,1,3,5,3,2,2,0,9
6028,786555,23,1,6,0,0,1,6,4,4,1,1,1,0,0,1,0,7
6028,781177,12,0,2,0,0,0,2,0,0,0,3,0,1,0,1,0,0
6028,785312,20,2,7,0,2,2,5,2,2,0,0,0,3,0,0,0,8
6029,775018,32,2,9,2,4,0,5,2,2,0,0,3,1,1,2,0,6
6029,776004,15,3,7,3,4,0,3,0,0,1,1,1,3,0,0,1,6
6029,775011,32,6,12,3,4,3,8,0,0,1,7,1,3,0,3,0,15
6029,780357,29,3,11,1,5,2,6,0,0,2,5,3,5,0,2,0,8
6029,790930,32,6,10,5,7,1,3,0,0,2,8,2,3,0,3,2,13
6029,780358,23,7,12,6,10,1,2,3,4,2,3,0,1,0,1,1,18
6029,796480,20,2,3,2,3,0,0,1,2,1,2,2,5,1,1,1,5
6029,776270,17,0,2,0,1,0,1,0,0,1,2,2,0,0,0,0,0
6030,797111,29,1,4,1,3,0,1,2,2,3,5,2,4,0,1,0,4
6030,797110,20,4,9,1,2,3,7,0,0,0,0,0,1,1,0,0,11
6030,791407,39,7,13,3,6,4,7,5,7,0,6,2,3,1,5,0,23
6030,785928,33,3,11,0,3,3,8,0,2,0,1,1,3,3,1,0,9
6030,785923,35,5,9,4,8,1,1,6,6,1,3,5,2,1,0,0,17
6030,797113,0,0,0,0,0,0,0,0,0,0,0,0,1,0,0,0,0
6030,797117,3,0,0,0,0,0,0,0,0,0,0,0,3,0,0,0,0
6030,797114,13,1,4,0,2,1,2,0,0,0,0,1,1,0,0,0,3
6030,791404,20,0,3,0,0,0,3,0,0,0,1,4,0,1,1,0,0
6030,797109,8,0,0,0,0,0,0,0,0,0,0,0,2,0,0,0,0
6031,786805,25,5,6,4,5,1,1,6,8,5,2,1,0,0,0,1,17
6031,774936,22,5,6,5,6,0,0,6,8,1,4,1,1,0,1,0,16
6031,790933,24,4,7,2,2,2,5,0,0,0,2,1,3,0,2,0,10
6031,781345,37,0,2,0,0,0,2,0,1,1,1,7,1,0,0,0,0
6031,786803,17,4,7,2,4,2,3,2,2,1,2,1,3,1,1,0,12
6031,790934,20,4,7,3,5,1,2,1,2,2,7,0,0,0,2,0,10
6031,786804,14,0,5,0,2,0,3,4,4,0,3,0,2,0,3,0,4
6031,796487,2,0,1,0,0,0,1,0,0,0,0,0,0,0,0,0,0
6031,790932,27,3,6,3,4,0,2,0,0,1,4,2,4,1,3,0,6
6031,780033,12,0,5,0,1,0,4,0,0,1,1,4,3,0,0,0,0
6031,780030,0,0,0,0,0,0,0,0,0,0,0,0,0,0,0,0,0
6032,791524,30,4,8,2,5,2,3,1,1,1,3,2,4,1,1,1,11
6032,797139,22,6,7,6,7,0,0,2,5,1,4,1,3,0,3,0,14
6032,775394,29,3,7,1,3,2,4,0,1,1,6,3,1,1,1,0,8
6032,791526,26,3,10,3,6,0,4,3,4,0,4,2,2,1,4,0,9
6032,780272,33,5,10,3,4,2,6,3,4,0,3,3,1,1,1,0,15
6032,786354,3,0,1,0,1,0,0,0,0,0,0,0,1,0,0,0,0
6032,785970,11,0,1,0,1,0,0,0,0,0,3,0,3,0,2,0,0
6032,791523,2,0,2,0,0,0,2,0,0,0,0,0,2,0,0,0,0
6032,780273,21,0,2,0,1,0,1,2,2,0,2,1,0,3,0,0,2
6032,775592,23,2,6,2,4,0,2,2,4,0,1,0,1,0,1,0,6
6033,797662,8,1,1,1,1,0,0,0,0,0,2,0,5,0,1,0,2
6033,792082,29,3,11,0,2,3,9,0,1,1,6,1,3,0,2,0,9
6033,786067,36,9,17,9,17,0,0,2,2,1,6,4,2,0,2,1,20
6033,785591,34,4,9,3,5,1,4,1,2,0,3,1,3,0,3,0,10
6033,780258,34,0,4,0,3,0,1,3,6,0,6,4,2,1,1,0,3
6033,792078,17,0,2,0,2,0,0,0,0,1,5,0,4,2,1,1,0
6033,791952,2,0,0,0,0,0,0,0,0,0,1,1,2,0,0,0,0
6033,797661,13,2,6,2,3,0,3,0,0,1,1,1,2,1,3,0,4
6033,797660,27,5,8,5,8,0,0,4,4,3,0,0,1,1,0,2,14
6034,780765,38,4,15,4,12,0,3,4,6,4,5,3,4,0,2,2,12
6034,781301,12,2,2,2,2,0,0,0,0,1,2,0,1,0,1,1,4
6034,786255,29,4,11,0,5,4,6,0,0,0,4,0,5,2,3,1,12
6034,780762,32,5,10,3,4,2,6,0,0,0,3,3,1,0,1,1,12
6034,780768,22,5,7,4,6,1,1,2,2,0,0,3,3,3,0,0,13
6034,791729,26,1,1,1,1,0,0,0,0,1,4,0,3,0,1,0,2
6034,776241,19,2,8,1,6,1,2,4,4,0,0,2,0,0,0,0,9
6034,780755,22,3,6,3,4,0,2,2,2,5,1,0,2,1,3,1,8
6035,791981,20,8,12,6,8,2,4,5,5,1,4,1,4,1,1,0,23
6035,780342,31,6,8,5,6,1,2,4,5,1,2,0,2,0,1,0,17
6035,791982,35,6,13,2,8,4,5,0,0,0,5,2,0,0,2,0,16
6035,780333,36,2,7,2,4,0,3,7,7,0,3,11,2,2,1,0,11
6035,781493,28,1,5,0,3,1,2,4,6,0,4,0,1,2,2,0,7
6035,786756,24,2,5,0,1,2,4,0,0,0,3,1,2,2,2,0,6
6035,786755,19,0,2,0,1,0,1,0,0,1,0,0,1,0,0,0,0
6035,791984,7,0,2,0,1,0,1,0,0,1,0,0,0,0,0,0,0
6036,774894,40,9,14,5,6,4,8,0,0,1,6,2,2,0,0,0,22
6036,781036,40,6,14,5,8,1,6,2,3,1,1,5,2,4,3,0,15
6036,799906,30,5,7,4,5,1,2,0,0,1,6,3,3,0,2,0,11
6036,775833,22,5,9,5,9,0,0,1,1,2,6,0,5,0,2,0,11
6036,785439,36,1,9,1,5,0,4,3,4,1,6,6,1,0,0,0,5
6036,796847,24,1,3,0,1,1,2,0,0,1,1,2,1,0,1,1,3
6036,796845,4,0,0,0,0,0,0,0,0,0,0,0,0,0,0,0,0
6036,791178,4,0,1,0,1,0,0,0,0,0,1,0,1,0,0,0,0
6037,776150,33,6,11,4,6,2,5,2,2,1,5,2,0,0,0,0,16
6037,791583,26,5,12,5,12,0,0,2,2,1,5,0,4,0,4,1,12
6037,780580,19,1,6,0,2,1,4,1,2,0,2,2,0,1,0,0,4
6037,786110,16,1,4,1,1,0,3,0,0,0,1,2,3,0,2,0,2
6037,781407,15,0,2,0,0,0,2,0,0,1,1,0,2,0,0,1,0
6037,785623,25,3,8,1,5,2,3,0,0,3,2,1,0,0,1,0,8
6037,786608,11,2,4,2,4,0,0,1,2,1,0,2,1,0,0,0,5
6037,797445,21,1,3,1,1,0,2,2,2,1,1,1,0,0,1,0,4
6037,786659,19,1,2,1,2,0,0,1,4,0,2,1,1,0,2,2,3
6037,797448,15,1,4,1,1,0,3,0,0,1,1,0,0,0,1,0,2
6038,790232,40,7,13,6,10,1,3,10,17,1,0,3,2,0,3,0,25
6038,780614,33,4,6,3,4,1,2,1,4,2,4,2,3,0,1,2,10
6038,789066,29,3,10,1,5,2,5,0,0,0,3,3,1,1,2,0,8
6038,780093,17,1,2,1,2,0,0,3,4,1,2,3,2,0,0,0,5
6038,786465,18,1,5,1,3,0,2,0,0,0,3,1,1,1,1,0,2
6038,780255,21,8,8,8,8,0,0,6,7,2,6,2,4,1,1,0,22
6038,785806,25,2,4,1,3,1,1,0,2,0,4,2,4,1,0,0,5
6038,786463,9,1,3,0,0,1,3,0,0,0,2,0,3,1,0,0,3
6038,792411,8,1,3,0,0,1,3,0,0,0,1,1,1,0,0,0,3
6039,780494,30,4,10,2,5,2,5,4,4,3,8,1,4,0,4,0,14
6039,780496,26,4,11,1,2,3,9,1,1,1,3,4,1,0,1,1,12
6039,780495,19,4,14,3,8,1,6,0,0,1,3,1,5,0,2,1,9
6039,797276,17,1,3,1,2,0,1,2,2,0,3,1,3,0,1,0,4
6039,780497,22,1,1,1,1,0,0,0,1,0,1,0,3,0,0,0,2
6039,785644,21,6,11,3,5,3,6,2,2,0,0,1,1,0,2,0,17
6039,791643,14,3,5,2,4,1,1,1,1,2,0,1,5,0,2,0,8
6039,785692,24,0,0,0,0,0,0,5,6,0,2,5,2,1,2,0,5
6039,797274,10,1,3,1,3,0,0,1,2,0,0,0,1,0,1,0,3
6039,791645,10,0,2,0,1,0,1,0,0,0,1,0,2,2,0,0,0
6039,797275,4,0,0,0,0,0,0,0,0,0,1,0,1,0,0,0,0
6039,797277,3,0,0,0,0,0,0,0,0,0,0,0,1,0,0,0,0
6040,785355,32,0,2,0,0,0,2,2,2,0,3,1,4,0,3,0,2
6040,781462,38,8,15,8,12,0,3,7,9,1,6,2,2,6,1,1,23
6040,780876,30,3,9,2,4,1,5,0,0,1,3,3,4,1,2,2,7
6040,785353,40,4,12,1,5,3,7,8,12,3,5,5,2,1,3,0,19
6040,781457,40,8,16,5,9,3,7,2,2,1,1,6,3,6,2,0,21
6040,791305,5,0,0,0,0,0,0,0,0,1,1,1,1,0,0,0,0
6040,790895,15,2,3,2,3,0,0,0,0,0,0,1,1,0,2,0,4
6041,781300,34,7,10,7,10,0,0,5,8,3,6,2,3,3,5,1,19
6041,790803,17,3,5,3,5,0,0,0,2,3,4,0,4,0,2,0,6
6041,781305,26,2,7,1,2,1,5,0,0,0,1,1,2,1,2,0,5
6041,790801,27,1,6,1,6,0,0,3,4,2,3,3,0,1,3,0,5
6041,781304,25,3,5,2,2,1,3,1,2,0,1,1,5,1,4,0,8
6041,796360,23,3,5,3,5,0,0,3,4,2,1,6,2,2,4,0,9
6041,796363,17,3,7,3,6,0,1,1,1,3,1,2,2,0,1,0,7
6041,796364,6,1,3,1,3,0,0,0,0,1,1,0,0,0,0,0,2
6041,780598,21,0,6,0,3,0,3,1,2,0,3,0,4,1,0,2,1
6041,790802,4,1,2,0,0,1,2,0,0,0,0,0,0,0,0,0,3
6042,775248,37,10,21,8,10,2,11,4,4,2,9,3,2,1,6,2,26
6042,780993,33,5,10,5,9,0,1,4,4,3,9,1,2,0,1,3,14
6042,797224,7,2,5,0,1,2,4,0,0,0,2,0,0,0,0,0,6
6042,791452,38,1,4,0,1,1,3,2,3,1,2,6,0,1,0,0,5
6042,781558,12,2,3,2,3,0,0,0,0,0,1,0,5,0,2,0,4
6042,797225,27,4,9,2,6,2,3,3,4,3,3,5,2,1,5,1,13
6042,797231,17,3,7,1,2,2,5,2,2,1,2,2,3,1,1,0,10
6042,791449,23,1,4,1,1,0,3,3,4,1,1,2,3,3,1,0,5
6042,797230,6,0,3,0,3,0,0,0,0,2,0,0,1,0,0,0,0
6042,797229,0,0,0,0,0,0,0,0,0,0,0,0,0,0,0,0,0
6042,791446,0,0,0,0,0,0,0,0,0,0,0,0,0,0,0,0,0
6043,796758,34,11,16,11,16,0,0,4,5,3,9,0,1,0,2,0,26
6043,791105,37,4,8,3,6,1,2,1,3,0,2,2,4,4,6,0,10
6043,780794,25,3,8,1,2,2,6,0,1,0,1,0,0,1,1,0,8
6043,791101,29,1,12,0,6,1,6,2,4,0,3,5,1,0,2,0,5
6043,796761,23,0,0,0,0,0,0,0,0,1,4,0,4,1,0,3,0
6043,796757,27,8,13,3,6,5,7,2,4,2,4,3,3,0,1,0,23
6043,780109,19,2,7,2,5,0,2,0,0,1,2,1,5,2,2,0,4
6043,791103,3,0,0,0,0,0,0,0,0,0,1,0,1,0,1,0,0
6043,785597,3,0,0,0,0,0,0,0,0,0,0,0,0,0,0,0,0
6044,797466,32,3,9,3,7,0,2,0,0,1,4,2,3,0,1,0,6
6044,791858,32,3,7,2,3,1,4,0,1,2,1,4,2,1,0,0,7
6044,797463,37,7,10,5,6,2,4,4,7,4,1,2,1,3,3,0,20
6044,791109,25,3,6,3,5,0,1,0,0,1,1,0,5,1,3,0,6
6044,785625,24,3,5,1,2,2,3,6,6,0,5,2,3,1,1,0,14
6044,797464,27,1,4,1,2,0,2,1,2,1,2,1,3,0,0,0,3
6044,797469,7,2,4,0,1,2,3,2,2,0,1,0,0,0,3,0,8
6044,797465,16,1,4,1,3,0,1,0,0,1,1,2,0,0,0,0,2
6045,797174,30,3,6,3,5,0,1,0,0,0,1,1,5,0,2,1,6
6045,791510,21,3,6,3,4,0,2,3,4,3,4,1,0,0,2,0,9
6045,786699,23,1,2,1,2,0,0,0,0,3,4,0,0,1,2,0,2
6045,785593,28,2,7,0,1,2,6,2,2,0,2,0,4,0,1,0,8
6045,775357,33,4,13,3,8,1,5,2,2,1,0,2,3,1,1,0,11
6045,791507,17,3,3,3,3,0,0,1,2,0,5,0,3,3,2,0,7
6045,797168,22,3,6,3,5,0,1,2,6,0,0,1,1,2,2,0,8
6045,791504,23,1,3,1,3,0,0,1,2,1,0,0,2,1,3,0,3
6045,791508,3,0,0,0,0,0,0,0,0,0,0,0,0,0,0,0,0
6046,785298,17,0,4,0,4,0,0,0,0,4,7,1,2,0,0,1,0
6046,775224,21,0,3,0,3,0,0,2,4,1,1,1,3,1,1,2,2
6046,778046,34,6,18,5,10,1,8,3,4,1,2,5,2,2,2,1,16
6046,782121,31,4,9,1,3,3,6,2,2,1,2,7,3,1,1,0,13
6046,775793,31,6,13,5,8,1,5,2,3,1,3,0,0,1,2,0,15
6046,786594,24,8,12,5,7,3,5,0,0,4,4,0,2,0,0,0,19
6046,785485,21,2,4,2,4,0,0,2,3,3,3,1,1,1,0,3,6
6046,785302,15,5,9,2,3,3,6,0,2,2,4,2,2,1,2,0,13
6046,796598,6,0,0,0,0,0,0,0,0,0,0,0,0,0,0,0,0
6047,796699,24,6,9,5,6,1,3,0,0,1,3,0,3,1,1,2,13
6047,790983,30,7,10,4,4,3,6,0,0,3,5,2,4,0,0,2,17
6047,790979,34,3,14,2,8,1,6,4,6,1,7,6,1,1,5,0,11
6047,796697,33,6,17,5,12,1,5,2,2,1,6,5,1,0,4,0,15
6047,788820,21,0,4,0,3,0,1,0,0,2,2,1,2,0,0,0,0
6047,796701,14,1,2,1,2,0,0,0,0,1,0,0,2,1,0,0,2
6047,790978,25,4,11,4,7,0,4,2,2,2,2,3,0,0,2,0,10
6047,796698,7,1,1,1,1,0,0,2,3,2,0,0,0,0,0,0,4
6047,790976,7,0,0,0,0,0,0,0,2,2,1,0,1,0,0,0,0
6047,790980,5,0,0,0,0,0,0,0,0,0,0,0,1,0,1,0,0
6048,780824,17,1,3,1,3,0,0,1,2,0,5,1,0,0,1,0,3
6048,791118,37,8,11,4,4,4,7,2,3,0,6,4,2,1,1,0,22
6048,785947,16,0,1,0,0,0,1,2,4,1,2,2,1,1,2,0,2
6048,785676,37,4,8,3,5,1,3,3,3,1,1,2,3,1,0,0,12
6048,774974,38,5,10,3,5,2,5,0,0,0,3,3,1,0,0,0,12
6048,796771,4,0,2,0,1,0,1,2,2,0,1,1,1,0,0,0,2
6048,791115,19,0,1,0,1,0,0,0,0,0,2,5,2,0,2,1,0
6048,791117,31,6,9,4,7,2,2,1,1,1,3,2,3,0,4,1,15
6048,791116,1,0,0,0,0,0,0,0,0,0,0,0,0,0,0,0,0
6049,791266,23,3,6,3,6,0,0,3,3,3,5,1,3,0,1,2,9
6049,796522,26,3,6,2,3,1,3,0,0,0,1,3,2,1,0,0,7
6049,791270,32,0,1,0,1,0,0,1,2,0,4,2,2,1,0,0,1
6049,791265,22,2,6,1,3,1,3,0,0,0,2,5,0,1,1,0,5
6049,791269,34,6,17,1,6,5,11,0,2,1,2,3,3,1,3,0,17
6049,796524,5,1,1,1,1,0,0,0,0,0,0,0,1,0,1,0,2
6049,796523,6,1,1,0,0,1,1,0,0,0,1,0,1,0,0,0,3
6049,796525,17,2,4,2,2,0,2,2,2,1,5,1,1,0,1,0,6
6049,791271,12,2,3,2,3,0,0,0,0,2,0,0,3,0,0,0,4
6049,781313,23,5,10,4,7,1,3,0,0,0,0,0,1,1,0,0,11
6050,785664,19,3,3,3,3,0,0,2,2,3,3,0,3,1,1,1,8
6050,785841,31,4,7,2,3,2,4,0,0,1,2,2,1,1,2,0,10
6050,796609,29,2,10,1,5,1,5,1,2,1,4,4,0,3,2,0,6
6050,796611,22,5,9,3,4,2,5,3,3,0,2,0,0,1,1,0,15
6050,792869,17,1,3,1,1,0,2,0,0,0,2,1,2,0,2,0,2
6050,796613,16,1,6,1,5,0,1,0,0,1,1,0,4,1,2,0,2
6050,792232,10,2,4,2,4,0,0,0,0,0,1,0,0,1,0,0,4
6050,791312,1,0,0,0,0,0,0,0,0,0,0,0,1,0,0,0,0
6050,786685,19,1,4,1,3,0,1,2,2,0,1,0,0,1,1,1,4
6050,781504,28,3,7,3,6,0,1,0,0,0,0,4,1,2,2,0,6
6050,766623,8,1,3,1,2,0,1,2,2,1,1,1,1,0,0,0,4
6051,791135,15,3,5,3,5,0,0,0,1,0,3,0,0,1,2,0,6
6051,791132,27,2,6,1,3,1,3,0,0,1,5,0,0,0,0,0,5
6051,786090,35,9,20,6,12,3,8,6,7,1,2,1,3,5,4,0,27
6051,786088,37,1,4,1,4,0,0,0,0,1,6,5,2,1,4,0,2
6051,774921,22,2,4,1,2,1,2,0,1,1,1,1,5,2,5,0,5
6051,791133,21,4,5,4,5,0,0,1,4,3,3,1,2,0,2,1,9
6051,791134,4,0,0,0,0,0,0,0,0,0,1,0,0,0,2,0,0
6051,791131,5,0,0,0,0,0,0,0,0,0,0,0,0,0,1,0,0
6051,785541,10,0,1,0,1,0,0,0,0,0,1,0,1,1,1,0,0
6051,796791,24,1,3,1,2,0,1,2,2,1,2,1,0,1,1,0,4
6052,776285,16,3,4,3,4,0,0,2,3,1,2,1,3,0,3,0,8
6052,791780,23,2,4,1,1,1,3,0,0,0,0,2,2,1,2,1,5
6052,791777,29,6,9,5,6,1,3,5,5,1,3,3,0,1,0,1,18
6052,781025,15,3,6,1,2,2,4,1,1,0,3,0,0,0,0,0,9
6052,786474,29,6,10,0,1,6,9,6,6,0,5,5,2,0,1,0,24
6052,791781,9,0,1,0,1,0,0,0,0,0,2,1,0,0,0,0,0
6052,791778,7,1,1,1,1,0,0,0,0,0,0,1,0,0,1,0,2
6052,786476,6,0,2,0,2,0,0,0,0,2,1,0,0,0,0,0,0
6052,797612,3,1,2,1,1,0,1,0,0,1,0,0,0,0,0,0,2
6052,791783,3,0,1,0,1,0,0,0,0,0,0,0,0,0,1,0,0
6052,791776,12,2,4,0,0,2,4,0,0,0,1,1,2,0,0,0,6
6052,791829,19,6,8,4,5,2,3,3,4,0,1,1,2,1,1,0,17
6052,780488,16,0,3,0,0,0,3,0,0,1,1,7,1,0,1,0,0
6052,775503,13,1,3,0,1,1,2,0,0,0,2,1,2,0,1,0,3
6053,790494,15,1,4,0,1,1,3,0,0,2,1,1,2,1,2,0,3
6053,781005,21,4,6,2,3,2,3,1,1,0,5,1,4,1,2,1,11
6053,792684,21,4,6,3,3,1,3,0,0,0,1,2,0,2,1,0,9
6053,782162,34,8,17,6,13,2,4,1,2,2,2,3,3,0,1,0,19
6053,796851,35,1,3,0,0,1,3,4,4,0,4,4,1,1,2,0,7
6053,796855,3,1,1,1,1,0,0,0,0,0,1,0,0,0,0,0,2
6053,788866,13,1,1,1,1,0,0,1,1,0,0,1,4,0,1,0,3
6053,781659,11,0,1,0,1,0,0,0,0,0,0,0,1,0,2,0,0
6053,781411,7,1,2,1,2,0,0,0,0,1,0,0,0,0,0,1,2
6053,796853,19,2,4,2,2,0,2,1,4,1,2,1,1,0,1,0,5
6053,792683,6,0,2,0,1,0,1,0,0,0,0,0,0,0,1,0,0
6053,780610,15,2,6,1,3,1,3,0,0,0,1,0,2,0,1,0,5
6054,791512,8,1,2,1,2,0,0,0,0,2,2,0,2,0,1,1,2
6054,786338,35,6,16,4,10,2,6,6,9,3,6,0,2,3,0,0,20
6054,792050,22,1,2,1,2,0,0,2,2,1,1,1,4,2,0,1,4
6054,785347,31,4,12,3,8,1,4,3,4,1,5,4,3,2,4,1,12
6054,775601,37,7,14,7,11,0,3,10,14,0,5,3,0,1,4,1,24
6054,797648,3,0,0,0,0,0,0,0,0,0,1,1,2,0,0,0,0
6054,792052,22,0,1,0,0,0,1,0,0,0,2,1,3,0,1,1,0
6054,792047,32,8,13,7,12,1,1,0,0,3,7,1,4,1,0,0,17
6054,792051,6,0,2,0,1,0,1,0,0,0,0,0,1,0,1,0,0
6054,780862,4,0,0,0,0,0,0,0,0,0,0,0,0,1,0,0,0
6055,786460,18,0,4,0,4,0,0,3,4,1,2,0,4,1,2,1,3
6055,791766,30,1,3,1,2,0,1,3,3,1,7,2,3,0,3,0,5
6055,786230,37,7,15,5,9,2,6,2,3,4,4,6,2,1,3,0,18
6055,780604,24,3,8,3,8,0,0,2,2,0,3,0,3,0,2,0,8
6055,780602,36,6,8,5,6,1,2,9,12,1,6,4,5,2,4,1,22
6055,786071,19,1,3,1,3,0,0,2,2,0,2,0,1,0,0,1,4
6055,791767,11,2,7,1,2,1,5,0,0,1,2,0,1,0,1,0,5
6055,780605,8,1,1,0,0,1,1,0,0,0,1,1,3,0,1,0,3
6055,780603,17,2,9,1,2,1,7,0,0,1,3,1,2,0,0,0,5
6056,796663,12,0,4,0,4,0,0,0,0,2,2,0,2,0,0,0,0
6056,780291,30,4,11,3,7,1,4,0,0,4,2,1,3,1,1,2,9
6056,796665,29,4,11,3,5,1,6,0,0,0,4,1,1,0,1,0,9
6056,785333,20,1,7,1,2,0,5,0,0,0,1,2,1,3,0,0,2
6056,775305,37,5,18,5,13,0,5,1,1,1,1,5,2,2,1,0,11
6056,791004,23,6,12,1,1,5,11,0,0,2,2,1,1,2,1,0,17
6056,791006,6,1,1,1,1,0,0,0,0,0,1,0,0,0,0,0,2
6056,796666,19,2,3,2,2,0,1,0,0,1,6,0,0,0,0,0,4
6056,796664,24,5,11,4,7,1,4,1,4,1,8,0,0,0,4,0,12
6057,797972,29,3,6,2,3,1,3,1,2,0,5,0,0,0,3,3,8
6057,797967,33,5,8,5,6,0,2,1,2,1,4,1,1,0,1,0,11
6057,797970,28,5,12,4,7,1,5,0,0,0,7,2,2,1,3,0,11
6057,781453,33,6,15,5,6,1,9,2,3,0,12,7,2,2,4,0,15
6057,774869,36,7,10,2,2,5,8,0,0,0,3,1,1,2,1,0,19
6057,792254,17,3,7,2,4,1,3,3,4,4,3,1,0,0,0,0,10
6057,792256,1,0,0,0,0,0,0,0,0,0,0,0,0,0,0,0,0
6057,797962,1,0,0,0,0,0,0,0,0,0,1,0,0,0,0,0,0
6057,786098,21,4,5,3,3,1,2,1,2,0,1,1,2,0,0,0,10
6057,786106,1,0,2,0,2,0,0,0,0,1,0,0,0,0,0,0,0
6058,780758,31,4,8,4,6,0,2,0,0,3,8,0,1,0,2,1,8
6058,775489,16,2,3,2,3,0,0,1,1,0,2,2,3,1,5,2,5
6058,785563,31,5,7,5,6,0,1,2,2,3,2,2,2,0,2,0,12
6058,791069,28,7,13,4,7,3,6,0,0,0,2,1,4,1,1,0,17
6058,780313,35,5,16,5,8,0,8,6,7,0,2,9,2,2,3,0,16
6058,796751,9,0,1,0,1,0,0,0,0,1,2,1,0,0,0,0,0
6058,796750,3,0,0,0,0,0,0,0,0,0,0,0,1,0,0,0,0
6058,791088,22,4,8,3,7,1,1,0,0,2,1,1,1,0,1,1,9
6058,785560,25,4,7,2,3,2,4,0,0,0,2,0,2,1,1,1,10
6059,791923,36,5,13,5,13,0,0,6,6,3,9,0,2,2,2,0,16
6059,781122,13,1,3,1,3,0,0,0,0,1,2,0,1,1,1,0,2
6059,791925,36,8,16,6,10,2,6,0,0,1,4,4,0,1,3,0,18
6059,786527,31,6,11,3,4,3,7,1,2,1,1,2,2,1,1,0,16
6059,781112,19,3,5,3,4,0,1,0,0,0,2,3,0,0,1,0,6
6059,786529,15,2,4,2,4,0,0,0,0,4,1,0,1,1,1,0,4
6059,797541,12,2,3,2,3,0,0,1,2,1,2,1,1,0,0,3,5
6059,797542,21,3,10,0,4,3,6,5,6,0,1,3,1,1,4,0,14
6059,791927,12,0,2,0,0,0,2,0,0,0,1,0,2,0,0,0,0
6059,786858,5,0,0,0,0,0,0,0,0,0,0,2,0,0,0,0,0
6060,786059,29,4,8,4,7,0,1,2,3,2,4,2,2,0,2,3,10
6060,776174,30,15,22,15,22,0,0,4,8,6,5,3,1,1,3,1,34
6060,791958,30,5,8,3,5,2,3,4,5,2,1,4,0,1,1,0,16
6060,791960,32,3,10,1,5,2,5,0,0,0,4,4,3,0,0,0,8
6060,785861,34,4,9,0,1,4,8,0,0,2,6,2,0,0,1,0,12
6060,786063,3,1,3,1,3,0,0,1,3,3,0,0,1,0,0,0,3
6060,781334,5,1,4,0,2,1,2,0,0,0,1,0,0,0,0,0,3
6060,797706,8,0,0,0,0,0,0,0,0,0,1,1,0,0,0,0,0
6060,797704,24,0,2,0,0,0,2,0,0,0,4,0,1,1,0,0,0
6060,791959,5,0,1,0,1,0,0,0,0,1,0,0,0,1,2,0,0
6061,785481,32,2,7,2,4,0,3,0,0,0,5,0,4,2,1,1,4
6061,780631,12,0,2,0,1,0,1,0,0,1,0,0,2,0,1,0,0
6061,797391,18,4,6,3,4,1,2,0,0,1,1,0,0,1,1,0,9
6061,786625,35,2,6,0,3,2,3,0,0,0,4,1,1,0,2,0,6
6061,780625,28,4,9,2,3,2,6,0,0,0,0,5,3,0,2,0,10
6061,797397,17,2,2,2,2,0,0,2,2,1,4,0,2,0,1,1,6
6061,791830,13,4,6,4,6,0,0,0,0,2,5,0,5,0,2,0,8
6061,797395,23,3,10,2,7,1,3,0,0,0,1,1,0,1,4,0,7
6061,786630,22,2,7,2,6,0,1,2,4,0,1,1,2,1,1,0,6
6062,796568,33,5,9,5,9,0,0,2,2,5,5,0,2,1,0,0,12
6062,796566,24,7,12,7,12,0,0,0,0,4,6,1,4,1,1,2,14
6062,790969,31,0,5,0,3,0,2,0,1,0,1,6,0,1,1,0,0
6062,780166,37,5,18,4,11,1,7,3,3,1,4,7,1,1,4,1,14
6062,775107,21,4,7,2,4,2,3,0,0,0,2,1,1,1,2,0,10
6062,790971,13,1,2,1,2,0,0,0,0,1,0,0,0,0,0,0,2
6062,796569,6,0,3,0,3,0,0,0,0,0,0,0,2,2,0,0,0
6062,790968,14,2,5,1,1,1,4,0,0,1,1,0,1,0,0,0,5
6062,790967,21,3,4,2,2,1,2,0,0,1,2,0,0,3,3,1,7
6063,787239,28,2,3,2,3,0,0,2,3,2,4,0,0,0,0,2,6
6063,789058,10,0,1,0,0,0,1,0,0,0,1,0,2,1,3,0,0
6063,785286,14,1,3,1,2,0,1,1,2,0,0,3,1,1,2,0,3
6063,797898,29,9,16,6,10,3,6,0,0,1,2,1,3,3,2,0,21
6063,792237,34,8,17,3,8,5,9,2,2,1,1,2,1,1,2,0,23
6063,797895,17,1,4,1,2,0,2,3,4,0,4,0,1,0,3,1,5
6063,792238,21,0,1,0,1,0,0,0,0,5,0,2,4,2,0,0,0
6063,797897,2,0,0,0,0,0,0,0,0,0,0,0,0,0,1,0,0
6063,792236,27,2,7,2,6,0,1,0,0,2,7,0,2,0,2,0,4
6063,792240,18,1,5,0,2,1,3,0,0,0,5,1,0,0,1,0,3
6064,792265,36,6,13,6,9,0,4,7,8,1,6,1,1,0,3,0,19
6064,792266,12,1,3,0,1,1,2,0,0,0,1,1,0,1,1,0,3
6064,786152,22,5,7,5,7,0,0,1,2,3,2,0,3,1,2,0,11
6064,798003,35,1,5,1,2,0,3,2,2,1,7,2,4,1,3,0,4
6064,792267,28,2,3,0,0,2,3,0,1,1,0,2,2,1,0,0,6
6064,798007,19,2,2,1,1,1,1,2,2,0,4,3,3,0,1,2,7
6064,798002,3,0,2,0,2,0,0,0,0,1,0,0,0,1,0,1,0
6064,798009,26,4,13,2,6,2,7,2,2,1,2,6,1,0,2,0,12
6064,798006,11,1,1,0,0,1,1,0,0,0,1,1,1,0,0,0,3
6064,792263,8,0,1,0,0,0,1,0,0,0,0,0,2,0,1,0,0
6065,780832,21,5,7,5,7,0,0,3,3,2,0,0,4,0,1,0,13
6065,796555,15,0,2,0,1,0,1,0,1,0,1,1,0,1,0,0,0
6065,790961,30,3,9,2,8,1,1,1,6,2,4,2,3,2,0,0,8
6065,785278,36,3,8,2,4,1,4,0,0,1,4,1,2,2,0,1,7
6065,780146,30,6,14,5,7,1,7,2,3,0,2,4,3,1,5,0,15
6065,796556,9,1,3,0,0,1,3,0,0,1,0,1,1,0,0,0,3
6065,796554,17,1,3,0,1,1,2,0,0,3,0,1,0,0,1,1,3
6065,796557,3,0,1,0,0,0,1,0,0,0,0,0,0,0,0,0,0
6065,796553,6,0,0,0,0,0,0,0,0,0,0,1,1,1,1,0,0
6065,775860,33,4,10,2,4,2,6,0,0,1,6,2,3,1,1,0,10
6066,797849,33,5,18,5,12,0,6,3,4,2,4,2,4,0,1,0,13
6066,781537,37,2,7,2,4,0,3,2,2,6,1,1,1,1,2,0,6
6066,786079,24,3,8,2,6,1,2,0,0,2,3,2,4,0,0,0,7
6066,797846,27,9,14,6,9,3,5,3,3,0,1,0,3,0,1,2,24
6066,792202,23,0,4,0,0,0,4,0,0,0,3,2,1,1,1,0,0
6066,797848,5,2,3,2,3,0,0,0,1,1,2,0,1,0,0,0,4
6066,797842,20,2,6,2,5,0,1,1,2,4,2,1,4,1,2,0,5
6066,797847,16,0,4,0,2,0,2,0,0,1,1,0,1,0,1,0,0
6066,797838,10,0,0,0,0,0,0,1,3,0,1,1,1,1,1,0,1
6066,797835,5,0,2,0,1,0,1,0,0,0,0,0,0,1,0,0,0
6067,791723,29,2,5,2,5,0,0,2,4,2,2,1,2,1,0,5,6
6067,780956,31,6,14,4,8,2,6,4,4,0,4,3,2,0,1,1,18
6067,797310,33,2,2,2,2,0,0,0,0,0,4,5,0,1,3,1,4
6067,791724,31,3,7,2,2,1,5,0,1,4,5,0,4,1,0,2,7
6067,781617,27,6,9,4,6,2,3,6,6,0,7,2,3,1,2,1,20
6067,797312,5,1,2,1,2,0,0,0,0,1,0,0,2,0,0,0,2
6067,786285,13,3,5,1,1,2,4,0,0,1,1,1,1,0,2,0,8
6067,785580,6,0,1,0,0,0,1,1,2,0,0,0,0,0,0,0,1
6067,797308,13,2,3,1,1,1,2,0,0,0,1,3,0,0,1,0,5
6067,780706,12,1,2,0,0,1,2,2,2,0,2,5,2,0,2,0,5
6068,780201,35,8,16,8,16,0,0,2,2,3,7,1,4,2,1,1,18
6068,791469,33,3,5,3,5,0,0,0,0,4,7,3,3,1,2,2,6
6068,797210,31,4,6,3,5,1,1,4,4,2,3,4,3,0,4,0,13
6068,797208,8,0,1,0,1,0,0,0,0,0,1,0,3,0,2,0,0
6068,791467,31,2,13,2,4,0,9,4,4,1,5,3,0,2,0,1,8
6068,786311,35,5,12,1,2,4,10,3,5,0,1,1,0,2,0,0,17
6068,775516,27,1,7,1,6,0,1,0,0,0,3,4,0,1,1,0,2
6069,796996,37,6,9,6,9,0,0,2,2,2,8,0,0,0,3,1,14
6069,780471,29,5,14,5,14,0,0,2,4,4,8,2,3,0,3,1,12
6069,791613,26,2,6,0,1,2,5,2,2,0,2,4,4,1,2,0,8
6069,791608,34,3,7,0,1,3,6,0,0,0,3,1,3,1,3,0,9
6069,776011,32,0,7,0,5,0,2,3,4,2,3,1,2,1,0,0,3
6069,791610,4,1,2,1,2,0,0,0,0,1,0,0,1,0,0,0,2
6069,796994,11,0,1,0,0,0,1,0,0,0,0,3,1,0,0,0,0
6069,792071,11,2,5,0,0,2,5,0,0,0,3,0,1,0,1,0,6
6069,785680,16,1,5,1,4,0,1,0,0,0,0,1,0,1,0,0,2
6070,785498,22,0,6,0,3,0,3,2,2,3,2,0,1,0,1,0,2
6070,776469,34,7,10,6,8,1,2,1,2,5,6,2,3,0,2,0,16
6070,796708,11,0,2,0,0,0,2,0,0,0,0,1,1,0,0,0,0
6070,780701,34,5,13,5,13,0,0,0,0,1,2,2,4,1,2,0,10
6070,776322,30,3,11,1,2,2,9,0,0,1,3,0,1,0,0,0,8
6070,781169,27,5,14,5,12,0,2,1,3,1,5,1,2,1,0,2,11
6070,796706,5,0,1,0,0,0,1,0,0,0,0,0,0,0,0,0,0
6070,796705,27,2,8,0,3,2,5,0,0,0,1,2,3,2,0,0,6
6070,780704,2,0,1,0,0,0,1,0,0,0,0,0,1,0,0,0,0
6070,791036,8,1,1,1,1,0,0,0,0,1,0,0,2,1,0,0,2
6071,791949,36,3,10,3,5,0,5,0,3,1,9,1,1,2,1,1,6
6071,776014,30,1,2,1,1,0,1,0,3,1,4,2,1,0,2,1,2
6071,785304,28,6,9,3,6,3,3,0,0,0,3,2,3,0,4,1,15
6071,780747,33,9,13,7,11,2,2,4,4,2,5,3,3,0,3,0,24
6071,776363,37,5,7,1,1,4,6,0,0,0,6,2,2,0,2,0,14
6071,797691,19,0,6,0,5,0,1,2,2,1,0,2,0,0,0,0,2
6071,797689,10,2,3,1,1,1,2,0,0,0,0,0,1,0,0,0,5
6071,791946,3,0,1,0,1,0,0,0,0,0,0,0,0,0,0,0,0
6071,784336,4,0,0,0,0,0,0,0,0,0,2,0,1,0,0,0,0
6072,785509,14,1,3,1,1,0,2,0,0,0,3,0,2,1,1,0,2
6072,791424,19,3,9,2,7,1,2,2,2,1,3,1,2,0,1,2,9
6072,797085,30,2,4,2,3,0,1,2,2,1,9,3,1,2,4,0,6
6072,791421,32,5,8,3,5,2,3,1,2,0,5,2,1,0,0,0,13
6072,785899,26,6,7,3,4,3,3,5,7,1,1,2,1,0,0,0,20
6072,797079,5,0,2,0,2,0,0,0,0,0,1,0,1,0,1,0,0
6072,797081,2,1,1,1,1,0,0,0,0,2,0,0,0,0,0,0,2
6072,791425,20,6,6,6,6,0,0,0,0,1,1,3,0,1,2,1,12
6072,797086,5,0,1,0,0,0,1,0,0,0,0,0,1,0,0,0,0
6072,797089,2,0,1,0,0,0,1,0,0,0,0,0,0,0,0,0,0
6072,797090,14,2,3,2,3,0,0,2,2,0,2,0,2,0,1,1,6
6072,797084,2,0,1,0,1,0,0,0,0,0,0,0,0,0,0,0,0
6072,797083,7,1,3,0,1,1,2,0,0,0,1,2,1,0,0,1,3
6072,797078,2,0,1,0,0,0,1,0,0,0,0,0,0,0,0,0,0
6072,797088,20,6,8,2,2,4,6,0,0,0,4,3,0,0,0,0,16
6074,791302,33,4,8,3,6,1,2,1,2,2,6,1,2,0,4,1,10
6074,781622,31,3,5,1,2,2,3,0,0,1,4,2,3,2,0,0,8
6074,791309,38,4,10,2,5,2,5,3,11,0,4,5,2,0,3,0,13
6074,785835,27,6,9,5,7,1,2,0,0,2,2,2,1,0,2,0,13
6074,776334,32,3,6,1,1,2,5,0,0,0,1,4,3,4,3,0,8
6074,775862,17,4,6,4,6,0,0,3,4,2,1,2,2,0,3,1,11
6074,796601,12,1,2,1,2,0,0,3,3,0,0,0,3,0,2,0,5
6074,791301,6,1,1,0,0,1,1,0,0,0,0,0,1,0,0,1,3
6074,791304,3,0,0,0,0,0,0,0,0,1,0,0,0,0,0,0,0
6074,796604,1,0,0,0,0,0,0,0,0,0,0,0,0,0,0,0,0
6075,786132,32,5,7,5,6,0,1,0,1,2,4,1,1,2,2,1,10
6075,775074,24,4,5,4,5,0,0,0,0,3,1,2,4,1,3,1,8
6075,786448,28,3,9,2,5,1,4,2,2,1,4,0,2,2,1,1,9
6075,780731,38,4,14,4,13,0,1,6,7,1,4,1,4,6,3,0,14
6075,780462,34,4,14,4,10,0,4,3,5,2,2,2,2,0,4,0,11
6075,791632,6,1,1,1,1,0,0,0,0,2,0,0,1,0,1,0,2
6075,786447,5,0,2,0,2,0,0,0,0,0,0,0,0,0,0,0,0
6075,796971,17,1,5,0,3,1,2,2,4,3,0,0,1,1,1,1,5
6075,776365,13,1,5,1,4,0,1,0,0,1,0,0,0,0,0,0,2
6075,775121,2,0,2,0,2,0,0,0,0,1,0,0,0,0,0,0,0
6075,791631,1,0,0,0,0,0,0,0,0,0,0,0,1,0,0,0,0
6076,781516,15,3,6,3,6,0,0,5,7,2,2,0,2,0,2,0,11
6076,797331,19,1,3,0,1,1,2,0,0,1,2,0,3,0,1,0,3
6076,791737,27,3,5,3,4,0,1,4,4,1,7,5,0,0,1,0,10
6076,783524,25,5,7,4,5,1,2,0,0,0,4,5,2,5,2,0,11
6076,780561,27,5,10,2,3,3,7,0,0,1,4,2,1,5,3,0,13
6076,791734,10,1,3,1,3,0,0,4,4,2,0,0,3,0,2,0,6
6076,791736,5,0,4,0,2,0,2,0,0,0,0,0,0,0,0,0,0
6076,797332,14,3,3,3,3,0,0,1,2,0,3,0,1,1,1,0,7
6076,797333,22,3,4,2,2,1,2,0,0,2,3,1,1,0,2,0,7
6076,795372,5,0,1,0,1,0,0,0,0,2,2,1,0,0,0,0,0
6076,786223,15,1,3,1,3,0,0,0,0,2,3,0,2,0,1,0,2
6076,786220,16,2,8,2,6,0,2,1,3,2,4,3,0,0,0,0,5
6077,796927,30,1,5,1,1,0,4,2,2,1,2,1,2,0,1,0,4
6077,791222,26,2,5,1,3,1,2,1,2,0,1,1,3,3,1,1,6
6077,791224,18,1,7,0,3,1,4,0,0,3,1,1,0,1,3,0,3
6077,785571,27,3,10,1,7,2,3,3,4,0,5,1,1,2,4,0,11
6077,786436,16,2,3,1,1,1,2,0,0,0,0,1,1,1,1,0,5
6077,791811,17,0,2,0,2,0,0,1,2,2,1,1,4,0,2,0,1
6077,796929,27,2,8,0,1,2,7,0,0,0,0,2,1,0,0,0,6
6077,796928,20,0,1,0,0,0,1,0,0,0,1,0,2,0,3,0,0
6077,785564,19,3,12,1,2,2,10,0,1,0,2,0,1,2,0,1,8
6078,785999,23,6,9,6,9,0,0,4,4,4,3,2,1,2,0,0,16
6078,775654,17,0,1,0,1,0,0,0,0,3,4,1,1,0,3,0,0
6078,796398,13,0,1,0,0,0,1,2,2,2,0,1,2,1,0,1,2
6078,791639,26,8,13,6,10,2,3,2,3,0,3,1,1,0,2,0,20
6078,785389,25,5,16,3,11,2,5,5,6,2,1,5,2,2,0,0,17
6078,775171,17,2,5,1,2,1,3,0,1,0,0,0,3,0,1,0,5
6078,791640,16,3,5,2,4,1,1,0,2,2,4,0,2,1,1,1,7
6078,785255,13,1,3,1,3,0,0,0,1,1,5,0,3,0,0,1,2
6078,796399,23,5,8,5,6,0,2,0,0,0,3,9,1,1,1,0,10
6078,796401,5,3,3,2,2,1,1,0,0,0,0,0,0,0,0,0,7
6078,785391,5,1,1,1,1,0,0,0,0,0,0,0,1,0,0,1,2
6078,796400,6,2,2,1,1,1,1,0,0,0,0,2,0,1,0,0,5
6078,791642,2,0,0,0,0,0,0,0,0,0,0,0,0,1,0,0,0
6078,796403,6,1,6,1,4,0,2,0,0,1,0,0,0,0,1,0,2
6078,796402,3,0,0,0,0,0,0,0,0,0,0,0,0,0,0,0,0
6079,786185,31,0,0,0,0,0,0,1,2,3,7,0,2,0,4,0,1
6079,797182,18,2,5,1,2,1,3,0,0,0,2,1,5,0,1,2,5
6079,797273,30,1,6,0,3,1,3,2,2,2,3,0,5,1,4,0,5
6079,786558,30,4,11,4,8,0,3,10,13,1,6,1,2,0,4,1,18
6079,797272,25,4,9,2,2,2,7,1,2,0,1,2,2,0,3,0,11
6079,797181,18,2,7,2,3,0,4,1,2,0,0,1,0,1,1,0,5
6079,766611,23,3,8,3,6,0,2,1,2,1,2,0,1,2,4,0,7
6079,791377,23,1,4,1,2,0,2,2,2,2,2,2,2,1,0,0,4
6079,786194,2,0,0,0,0,0,0,0,0,0,0,1,0,0,0,0,0
6080,789177,29,5,7,5,7,0,0,5,5,7,12,0,1,1,3,1,15
6080,780227,20,3,9,3,8,0,1,6,9,1,5,2,4,4,3,0,12
6080,791340,20,4,7,4,6,0,1,2,3,2,0,4,3,2,0,0,10
6080,780181,24,7,19,4,12,3,7,4,6,2,10,1,0,1,3,1,21
6080,776089,19,3,4,1,1,2,3,0,1,1,1,1,3,0,0,0,8
6080,797262,5,0,3,0,1,0,2,0,0,0,2,0,2,0,0,0,0
6080,797260,8,1,1,1,1,0,0,0,0,0,0,0,5,1,0,0,2
6080,797266,3,1,1,1,1,0,0,1,2,0,0,0,1,0,0,0,3
6080,775758,15,3,3,3,3,0,0,4,5,1,1,0,0,1,0,0,10
6080,797265,2,2,3,0,1,2,2,0,0,0,0,0,0,0,0,0,6
6080,797261,6,0,1,0,0,0,1,2,2,0,0,0,2,0,1,0,2
6080,791336,23,3,6,2,5,1,1,5,6,1,4,2,1,1,2,0,12
6080,797264,5,1,1,0,0,1,1,0,0,0,0,0,0,1,0,0,3
6080,789178,21,1,3,1,1,0,2,0,0,0,2,1,3,1,0,0,2
6081,800005,13,2,4,2,4,0,0,0,0,2,1,0,5,0,1,0,4
6081,799129,24,2,5,1,3,1,2,3,4,0,4,0,5,0,1,0,8
6081,799130,38,4,17,3,9,1,8,6,9,0,3,0,2,2,2,0,15
6081,792634,33,1,8,1,6,0,2,0,2,1,3,3,2,0,8,0,2
6081,799136,17,1,1,1,1,0,0,0,0,0,0,0,5,0,0,0,2
6081,799128,2,0,0,0,0,0,0,0,0,0,0,0,0,0,0,0,0
6081,799133,19,0,3,0,2,0,1,1,2,0,3,0,2,0,3,0,1
6081,799134,20,3,9,1,5,2,4,4,6,0,0,0,2,0,0,0,12
6081,800091,30,4,8,4,6,0,2,4,4,1,9,0,2,1,4,0,12
6081,799135,4,0,0,0,0,0,0,0,0,0,1,0,0,0,0,0,0
6082,785800,21,2,4,1,2,1,2,0,0,0,3,0,4,1,1,0,5
6082,785799,20,6,9,6,9,0,0,1,1,4,5,1,2,2,0,0,13
6082,791676,26,3,9,1,2,2,7,0,1,1,1,4,2,2,1,0,8
6082,780554,25,5,9,3,5,2,4,0,0,1,2,2,2,0,1,0,12
6082,780553,27,11,21,10,18,1,3,2,2,0,7,0,1,7,1,0,25
6082,797426,15,2,7,1,2,1,5,3,3,0,3,0,1,1,1,1,8
6082,791678,9,0,2,0,1,0,1,0,1,0,2,0,1,0,0,1,0
6082,791679,3,0,0,0,0,0,0,0,1,1,0,0,1,0,0,0,0
6082,785807,13,0,2,0,1,0,1,0,0,1,1,0,2,0,0,0,0
6082,780760,15,0,1,0,1,0,0,0,0,0,2,0,0,1,1,1,0
6082,797427,12,1,6,0,2,1,4,0,0,0,1,1,2,0,1,0,3
6082,791677,14,1,2,1,2,0,0,0,0,0,4,1,0,1,0,0,2
6083,786765,32,7,14,4,5,3,9,1,1,0,6,4,1,0,2,1,18
6083,797852,29,1,4,1,2,0,2,0,0,0,4,1,3,0,6,0,2
6083,792379,28,2,10,1,3,1,7,2,2,2,7,2,0,1,1,0,7
6083,792380,30,3,9,0,1,3,8,2,2,0,3,2,2,0,3,0,11
6083,781669,31,2,9,2,4,0,5,0,0,0,5,2,2,1,5,0,4
6083,781668,2,0,0,0,0,0,0,0,0,0,1,0,0,0,0,0,0
6083,797860,7,0,1,0,1,0,0,0,0,0,2,0,1,0,0,1,0
6083,797854,10,1,2,0,0,1,2,0,0,1,1,0,4,0,0,0,3
6083,797853,4,0,1,0,0,0,1,0,0,0,1,0,0,0,0,0,0
6083,781672,23,5,8,5,8,0,0,3,6,4,3,0,0,0,1,1,13
6083,781671,4,0,0,0,0,0,0,1,2,0,0,0,0,0,1,0,1
6084,792299,38,4,6,1,2,3,4,2,4,1,5,1,4,0,1,0,13
6084,792304,43,8,21,5,12,3,9,4,5,1,7,0,4,3,2,1,23
6084,792301,40,8,21,7,18,1,3,2,3,4,1,4,1,0,2,0,19
6084,786280,15,2,4,2,4,0,0,2,2,0,2,0,3,0,3,0,6
6084,786275,20,1,3,1,2,0,1,7,8,1,2,3,5,1,3,0,9
6084,798092,7,0,0,0,0,0,0,0,0,0,1,0,0,0,0,0,0
6084,792302,2,0,0,0,0,0,0,0,0,0,0,0,1,0,0,0,0
6084,786181,27,3,4,3,4,0,0,7,7,2,3,1,4,0,2,1,13
6084,786286,33,1,2,0,0,1,2,0,0,0,3,0,3,0,0,1,3
6085,786704,32,2,5,2,5,0,0,5,6,3,6,2,3,0,4,0,9
6085,785395,17,5,7,2,3,3,4,4,4,0,0,0,3,0,2,0,17
6085,775840,38,2,4,1,2,1,2,2,2,0,3,4,5,2,1,0,7
6085,775955,40,8,17,7,13,1,4,1,1,0,4,4,3,1,2,0,18
6085,775811,17,3,3,2,2,1,1,3,4,0,5,2,0,1,0,0,10
6085,792327,6,0,1,0,1,0,0,0,0,0,3,0,0,0,0,0,0
6085,786706,7,0,0,0,0,0,0,0,0,0,0,0,4,0,1,0,0
6085,786703,9,0,0,0,0,0,0,2,2,0,0,0,2,0,0,0,2
6085,775287,19,1,4,0,1,1,3,1,2,0,0,0,1,0,1,0,4
6085,790921,6,0,0,0,0,0,0,0,1,0,0,0,2,0,0,0,0
6085,786551,34,7,16,3,8,4,8,4,6,2,1,0,2,1,3,0,22
6086,785681,9,1,1,1,1,0,0,0,0,1,1,0,3,0,0,0,2
6086,796789,31,3,8,1,2,2,6,0,0,0,3,1,1,0,2,1,8
6086,791126,35,6,8,6,8,0,0,4,6,1,4,3,2,4,4,0,16
6086,791124,37,4,6,3,4,1,2,7,8,0,1,3,0,2,1,0,16
6086,780050,20,3,7,1,3,2,4,1,2,0,3,2,2,0,2,0,9
6086,784479,1,0,0,0,0,0,0,0,0,0,0,0,1,0,1,0,0
6086,796786,11,1,1,0,0,1,1,3,3,0,1,0,1,0,0,0,6
6086,775813,29,6,10,6,10,0,0,4,7,2,3,3,1,0,3,0,16
6086,796784,17,0,2,0,1,0,1,0,2,0,1,0,4,1,1,0,0
6086,796782,10,0,1,0,1,0,0,0,0,1,1,0,1,0,1,0,0
6087,796657,19,2,3,0,1,2,2,0,0,2,1,0,0,1,1,0,6
6087,796651,12,0,0,0,0,0,0,0,0,0,0,0,1,0,1,0,0
6087,791323,33,0,4,0,2,0,2,0,0,0,5,4,5,0,2,1,0
6087,791320,38,11,16,10,13,1,3,6,7,0,2,2,0,2,1,0,29
6087,781511,33,5,14,3,9,2,5,2,2,2,2,2,0,0,3,0,14
6087,796650,19,1,2,1,2,0,0,0,0,1,0,1,4,0,1,0,2
6087,796656,3,0,0,0,0,0,0,0,0,0,0,0,1,0,0,0,0
6087,796653,3,0,0,0,0,0,0,0,0,0,0,0,1,0,1,0,0
6087,791321,16,1,2,1,2,0,0,0,1,2,1,0,4,0,1,1,2
6087,785912,24,4,9,2,2,2,7,2,2,0,3,0,2,1,5,0,12
6088,796912,30,1,4,0,2,1,2,2,2,2,1,2,2,1,1,2,5
6088,775626,35,8,16,6,10,2,6,6,6,6,6,4,2,2,2,1,24
6088,774964,29,6,13,6,11,0,2,0,2,2,5,1,4,0,2,3,12
6088,796908,26,1,4,0,0,1,4,0,0,1,5,3,2,0,0,0,3
6088,774962,32,3,13,2,5,1,8,0,0,0,3,4,1,0,0,0,7
6088,796910,14,2,5,2,4,0,1,0,0,0,3,2,3,0,0,2,4
6088,785609,2,0,0,0,0,0,0,0,0,0,0,0,0,0,1,0,0
6088,796907,14,2,4,2,3,0,1,1,1,2,3,0,1,0,0,1,5
6088,796906,18,3,9,2,5,1,4,0,0,0,2,1,0,1,0,0,7
6089,797715,26,2,6,0,1,2,5,0,0,0,2,1,3,1,5,0,6
6089,797717,8,4,11,4,9,0,2,1,2,5,6,0,0,0,1,0,9
6089,780937,37,4,14,1,3,3,11,4,4,4,5,3,3,2,1,0,15
6089,780938,30,2,4,2,4,0,0,2,4,0,4,1,2,0,1,0,6
6089,791950,32,3,10,2,6,1,4,0,2,0,6,2,2,0,1,1,7
6089,797716,8,0,2,0,2,0,0,0,0,0,0,0,3,0,1,0,0
6089,792115,26,0,4,0,3,0,1,2,2,1,3,4,1,0,1,0,2
6089,792113,28,2,7,1,4,1,3,0,0,1,3,1,1,2,0,0,5
6089,780779,5,0,2,0,0,0,2,0,0,0,1,0,1,0,0,0,0
6090,796960,6,0,1,0,1,0,0,0,0,1,2,0,4,0,1,0,0
6090,781272,31,5,8,4,6,1,2,2,2,1,5,3,3,2,3,1,13
6090,791261,30,6,12,1,2,5,10,1,2,0,4,1,0,1,0,2,18
6090,785501,26,2,12,1,6,1,6,0,0,1,1,3,3,0,1,0,5
6090,781270,40,9,19,5,10,4,9,4,5,0,3,5,1,0,3,0,26
6090,796959,25,5,7,5,7,0,0,2,2,5,1,0,1,2,3,0,12
6090,791260,2,0,0,0,0,0,0,0,0,0,0,0,1,0,0,0,0
6090,796958,22,0,2,0,2,0,0,2,4,5,7,1,3,1,4,2,2
6090,791258,18,2,6,1,3,1,3,0,1,0,0,1,0,1,0,0,5
6091,791023,31,9,9,9,9,0,0,0,0,2,3,1,4,0,2,1,18
6091,791027,36,5,14,3,7,2,7,2,4,5,9,5,2,6,3,0,14
6091,791024,36,0,9,0,4,0,5,4,4,0,2,5,4,0,5,0,4
6091,781507,21,2,2,1,1,1,1,1,2,1,5,1,2,0,3,0,6
6091,777572,32,4,9,2,5,2,4,0,0,1,2,5,1,1,2,1,10
6091,791028,11,1,1,0,0,1,1,2,2,0,0,2,0,0,0,0,5
6091,796685,31,7,17,1,5,6,12,2,2,1,3,2,2,1,1,0,22
6091,796683,2,0,0,0,0,0,0,0,0,0,0,0,0,0,0,0,0
6092,790839,29,3,6,1,2,2,4,3,4,5,4,0,3,2,0,0,11
6092,785388,32,7,18,7,18,0,0,3,4,6,8,3,4,2,2,0,17
6092,790840,36,9,14,4,8,5,6,6,6,0,6,0,0,2,1,0,29
6092,796395,18,3,9,2,7,1,2,0,1,0,1,1,1,1,1,2,7
6092,785386,39,2,5,2,3,0,2,0,0,1,5,7,3,1,2,0,4
6092,796393,8,1,1,1,1,0,0,2,4,1,0,0,3,0,2,0,4
6092,780370,11,2,3,2,2,0,1,0,0,2,1,0,2,0,2,0,4
6092,790841,26,0,1,0,1,0,0,5,5,0,0,0,2,0,0,0,5
6092,796396,1,0,0,0,0,0,0,0,0,0,0,0,0,0,0,0,0
6093,776462,33,4,7,4,5,0,2,3,4,1,2,3,2,2,0,0,11
6093,785635,30,6,16,4,9,2,7,1,3,3,4,1,4,0,3,6,15
6093,791629,23,3,4,1,2,2,2,0,0,1,4,1,1,0,0,0,8
6093,786440,30,2,5,0,0,2,5,0,0,0,1,3,3,3,0,0,6
6093,781199,38,2,13,2,8,0,5,2,2,2,2,5,4,1,2,0,6
6093,775642,9,3,6,1,3,2,3,2,2,0,0,0,3,0,0,0,10
6093,786720,13,0,1,0,1,0,0,0,0,0,2,1,2,0,3,0,0
6093,791628,7,0,0,0,0,0,0,0,0,1,1,1,2,0,1,1,0
6093,796974,16,2,5,0,1,2,4,0,0,0,0,0,0,0,1,0,6
6093,791626,1,0,0,0,0,0,0,0,0,0,0,0,0,0,1,0,0
6094,792131,21,2,4,1,2,1,2,0,0,0,3,2,3,0,2,0,5
6094,786838,27,3,9,3,9,0,0,7,13,4,4,1,4,1,4,3,13
6094,797736,23,1,8,1,4,0,4,0,0,0,5,1,2,0,3,0,2
6094,792132,32,2,4,2,2,0,2,5,8,1,2,4,1,1,0,0,9
6094,792127,34,4,11,3,7,1,4,5,5,0,6,1,1,1,2,0,14
6094,799273,5,1,1,1,1,0,0,0,0,0,2,0,3,0,0,1,2
6094,792128,25,4,7,4,7,0,0,2,3,5,5,1,4,3,1,0,10
6094,799908,2,0,0,0,0,0,0,0,1,0,1,0,0,0,0,0,0
6094,797739,3,0,0,0,0,0,0,0,0,0,1,0,0,0,0,0,0
6094,792126,20,3,8,0,2,3,6,2,2,0,1,1,1,0,0,0,11
6094,791668,8,1,2,1,2,0,0,0,0,1,0,0,1,0,2,0,2
6095,786404,28,0,3,0,2,0,1,0,1,2,9,2,3,2,0,0,0
6095,780378,27,4,6,4,6,0,0,5,6,5,6,0,5,1,5,0,13
6095,786378,33,6,13,1,2,5,11,1,2,0,2,0,2,1,1,2,18
6095,786374,26,1,8,1,5,0,3,0,0,0,3,3,4,0,2,2,2
6095,786253,33,3,20,2,14,1,6,2,2,1,1,3,4,1,2,0,9
6095,780382,7,0,0,0,0,0,0,0,0,0,1,0,2,0,0,0,0
6095,797061,16,1,2,1,1,0,1,2,3,1,4,1,0,1,2,1,4
6095,791562,3,0,0,0,0,0,0,0,0,0,0,0,2,0,0,0,0
6095,789057,1,0,0,0,0,0,0,0,0,0,0,0,2,0,0,0,0
6095,785798,16,3,6,2,2,1,4,1,2,0,0,0,3,1,2,0,8
6095,780121,2,0,0,0,0,0,0,0,0,0,0,0,0,0,0,0,0
6095,797065,8,0,0,0,0,0,0,0,0,0,0,0,0,0,0,0,0
6096,792029,9,0,0,0,0,0,0,0,0,0,0,0,4,1,0,0,0
6096,761149,35,5,5,2,2,3,3,2,2,1,4,3,1,1,0,0,15
6096,792032,38,14,23,9,13,5,10,4,4,1,2,8,4,0,3,0,37
6096,792031,27,3,7,2,3,1,4,3,4,1,2,0,1,0,2,0,10
6096,780828,36,10,15,8,11,2,4,2,7,0,8,5,1,1,3,2,24
6096,797641,19,3,4,3,4,0,0,0,2,4,2,2,2,0,0,1,6
6096,797640,6,1,1,1,1,0,0,0,0,0,0,0,0,0,0,0,2
6096,797637,20,1,5,0,2,1,3,0,0,1,2,1,1,3,2,0,3
6096,797636,10,0,1,0,1,0,0,0,0,0,0,1,0,0,0,0,0
6097,780570,21,2,4,2,4,0,0,0,0,0,2,0,3,0,2,0,4
6097,780569,34,7,11,7,11,0,0,2,8,6,7,0,1,0,0,1,16
6097,791697,34,8,12,6,8,2,4,1,2,1,6,2,3,1,2,1,19
6097,791696,29,9,14,6,10,3,4,2,2,0,2,2,5,1,3,0,23
6097,780565,31,3,6,2,5,1,1,2,2,0,1,5,2,0,2,0,9
6097,797432,8,0,1,0,0,0,1,2,2,0,0,0,0,0,0,0,2
6097,797436,16,5,7,2,3,3,4,2,2,0,2,2,1,2,1,0,15
6097,791695,4,0,0,0,0,0,0,0,0,0,1,0,1,0,0,0,0
6097,785824,18,1,3,1,2,0,1,0,0,0,2,0,3,0,0,0,2
6097,781556,5,1,5,0,3,1,2,0,0,0,0,0,1,1,1,0,3
6098,791876,34,8,20,6,14,2,6,1,1,4,7,1,1,2,0,2,19
6098,791877,29,3,6,3,5,0,1,0,0,2,3,1,2,0,0,1,6
6098,785667,24,3,6,0,0,3,6,0,0,0,3,0,2,0,2,0,9
6098,786572,29,3,11,3,6,0,5,2,2,2,1,3,0,0,1,0,8
6098,786570,19,2,6,1,4,1,2,0,0,0,1,3,5,1,2,0,5
6098,797486,9,0,1,0,1,0,0,0,0,1,1,3,0,0,1,0,0
6098,797491,14,0,6,0,4,0,2,1,2,2,0,2,3,0,0,0,1
6098,781205,3,0,0,0,0,0,0,0,0,0,1,0,0,0,0,0,0
6098,797487,6,0,2,0,2,0,0,0,0,1,0,1,0,0,0,0,0
6098,780436,12,1,7,1,5,0,2,0,0,2,1,3,1,0,1,0,2
6098,790396,12,1,2,0,1,1,1,0,0,0,2,1,1,1,0,0,3
6098,797492,5,0,4,0,4,0,0,0,0,1,2,0,0,0,0,0,0
6098,791878,4,2,2,1,1,1,1,0,0,0,0,0,0,0,1,0,5
6099,785423,24,3,7,3,4,0,3,1,3,0,9,3,1,0,0,1,7
6099,775676,24,7,11,7,11,0,0,0,1,0,3,1,2,1,0,2,14
6099,786210,29,1,4,0,2,1,2,0,0,0,1,5,2,0,1,0,3
6099,785425,29,6,11,5,9,1,2,3,4,0,9,1,1,2,0,0,16
6099,785422,35,5,9,0,2,5,7,2,2,0,1,9,1,0,3,1,17
6099,774957,22,3,6,2,2,1,4,1,1,2,5,1,1,0,0,1,8
6099,786298,28,7,8,2,2,5,6,0,1,1,4,0,1,1,2,0,19
6099,796431,3,0,0,0,0,0,0,0,0,0,1,0,0,0,0,0,0
6099,796429,3,0,1,0,1,0,0,0,0,0,0,0,0,0,1,0,0
6099,793801,3,0,0,0,0,0,0,0,0,0,0,0,0,0,0,0,0
6100,786566,33,5,12,4,8,1,4,0,0,0,6,0,2,1,2,0,11
6100,781204,26,3,5,2,3,1,2,0,0,1,1,0,2,0,1,1,7
6100,786568,10,1,1,1,1,0,0,0,0,0,3,1,1,0,1,0,2
6100,791993,32,5,12,3,10,2,2,2,3,2,4,4,3,3,1,0,14
6100,781188,34,5,13,3,9,2,4,4,4,2,2,7,4,0,7,0,16
6100,781189,13,2,6,2,4,0,2,0,0,0,0,2,2,0,0,0,4
6100,797494,5,0,1,0,0,0,1,1,2,0,1,0,1,0,1,0,1
6100,791997,10,0,2,0,0,0,2,2,2,0,2,0,1,2,1,0,2
6100,786562,23,2,4,1,1,1,3,1,2,0,2,3,2,0,1,0,6
6100,786563,6,1,4,1,2,0,2,0,0,0,1,1,0,0,0,0,2
6100,797493,4,2,3,2,3,0,0,4,4,0,0,0,0,0,0,0,8
6100,786565,2,0,0,0,0,0,0,2,2,0,0,0,0,1,0,0,2
6100,791995,2,0,0,0,0,0,0,0,0,0,0,0,0,0,0,0,0
6101,790799,22,6,9,6,7,0,2,0,0,1,4,3,4,1,0,1,12
6101,790798,29,7,9,7,9,0,0,5,6,2,4,3,2,1,3,0,19
6101,780140,32,5,11,2,3,3,8,3,3,0,5,1,1,0,0,0,16
6101,796355,17,2,6,2,3,0,3,0,0,0,5,1,5,1,1,0,4
6101,780137,29,4,6,3,3,1,3,2,2,1,6,3,3,2,4,0,11
6101,785245,31,6,10,3,4,3,6,2,2,0,2,8,1,1,2,0,17
6101,775553,21,6,8,4,5,2,3,1,2,0,1,2,2,3,0,1,15
6101,796354,8,1,2,1,1,0,1,1,2,1,1,0,1,0,2,0,3
6101,799892,5,0,0,0,0,0,0,0,0,0,1,0,2,0,1,1,0
6101,796359,5,0,1,0,0,0,1,0,0,0,0,0,1,0,1,0,0
6101,790795,1,0,0,0,0,0,0,0,0,0,0,0,0,0,0,0,0
6102,792399,15,3,7,2,6,1,1,2,2,2,5,0,2,0,2,0,9
6102,785471,21,7,9,7,8,0,1,4,5,2,3,0,3,0,0,1,18
6102,780263,31,1,8,1,5,0,3,2,6,3,6,2,2,2,3,0,4
6102,786697,34,1,6,1,3,0,3,2,2,1,3,4,4,1,3,1,4
6102,775628,36,5,13,5,11,0,2,8,8,0,7,5,3,3,4,3,18
6102,799000,17,4,10,4,10,0,0,0,0,3,6,0,3,0,2,2,8
6102,775198,25,3,6,3,6,0,0,1,2,0,4,2,2,0,2,0,7
6102,775547,9,1,2,1,2,0,0,2,4,1,4,1,2,1,1,1,4
6102,792397,4,0,1,0,0,0,1,0,0,0,0,0,1,0,0,0,0
6102,780571,8,2,3,0,0,2,3,2,2,0,1,0,1,0,2,1,8
6103,796516,27,4,9,4,8,0,1,0,2,1,3,0,3,0,0,2,8
6103,792318,27,4,12,4,12,0,0,4,5,4,6,0,3,0,3,0,12
6103,796519,17,1,2,0,1,1,1,2,2,1,2,1,4,3,1,0,5
6103,786717,22,0,5,0,4,0,1,0,0,1,4,3,2,0,0,0,0
6103,780753,31,5,14,3,8,2,6,4,5,0,3,5,2,0,3,0,16
6103,792308,7,0,2,0,2,0,0,0,0,0,0,0,3,0,1,0,0
6103,796520,17,0,6,0,2,0,4,0,0,1,1,1,2,1,2,0,0
6103,796518,5,0,1,0,0,0,1,1,2,0,1,1,0,0,1,0,1
6103,796517,17,2,8,1,3,1,5,5,5,1,2,2,1,0,0,0,10
6103,792315,8,0,0,0,0,0,0,0,0,0,0,0,1,0,0,1,0
6103,775329,22,7,13,3,5,4,8,3,4,0,3,1,4,2,2,0,21
6104,791669,30,5,10,5,10,0,0,1,2,3,2,1,3,1,3,1,11
6104,785762,33,6,15,4,12,2,3,4,5,9,7,3,3,2,2,1,18
6104,797407,13,2,5,1,4,1,1,0,0,0,2,1,1,0,2,0,5
6104,785760,16,0,2,0,0,0,2,0,0,0,2,1,1,0,1,0,0
6104,780531,40,5,13,2,5,3,8,0,1,0,7,6,0,1,2,2,13
6104,797414,3,0,0,0,0,0,0,0,0,0,0,0,1,0,0,0,0
6104,780534,14,4,5,4,5,0,0,0,1,1,5,0,3,0,1,0,8
6104,797409,25,2,5,2,4,0,1,2,4,1,0,6,2,1,1,0,6
6104,791666,26,4,8,2,3,2,5,0,0,0,0,0,2,0,2,1,10
6105,782133,25,4,7,1,2,3,5,0,0,0,5,1,4,2,4,0,11
6105,785123,32,5,10,5,10,0,0,2,4,1,4,3,2,0,1,5,12
6105,790990,24,1,5,0,1,1,4,3,4,0,5,1,4,0,0,0,6
6105,789219,26,3,5,1,1,2,4,2,3,0,2,3,3,2,0,0,10
6105,785059,32,6,9,5,6,1,3,0,0,1,5,5,2,2,2,0,13
6105,785305,5,1,1,0,0,1,1,0,0,0,0,0,0,0,0,0,3
6105,796622,8,2,3,2,3,0,0,0,0,1,2,0,0,0,2,1,4
6105,796623,28,4,10,2,4,2,6,3,4,0,2,5,2,0,2,0,13
6105,790988,5,0,0,0,0,0,0,0,2,0,0,0,0,0,0,0,0
6105,785122,15,0,1,0,0,0,1,0,0,0,1,0,0,0,0,0,0
6106,776279,27,3,9,1,2,2,7,0,0,0,1,0,0,0,0,1,8
6106,781505,28,4,9,2,5,2,4,2,2,2,2,2,5,0,2,0,12
6106,780353,34,7,11,7,11,0,0,0,0,4,6,0,3,1,3,0,14
6106,791317,38,5,9,5,6,0,3,1,2,0,7,5,1,2,2,0,11
6106,777573,27,2,7,2,4,0,3,2,2,0,2,2,1,1,1,0,6
6106,786222,18,3,6,3,5,0,1,3,5,2,0,0,1,1,1,0,9
6106,796649,15,1,1,0,0,1,1,0,0,0,1,2,1,0,0,0,3
6106,790851,13,1,2,1,2,0,0,0,0,1,3,1,2,0,1,0,2
6107,791763,28,5,9,4,4,1,5,2,2,0,3,0,1,1,0,0,13
6107,775910,20,1,5,1,1,0,4,2,2,2,2,1,2,1,3,0,4
6107,786451,32,2,9,1,2,1,7,2,2,3,2,3,2,1,2,0,7
6107,780600,35,4,7,1,1,3,6,0,0,0,3,2,2,0,5,0,11
6107,781387,36,1,7,0,3,1,4,0,2,1,1,3,2,0,0,0,3
6107,800084,6,0,3,0,2,0,1,0,0,0,2,0,0,0,0,0,0
6107,786456,7,1,1,1,1,0,0,0,0,0,2,0,1,0,0,0,2
6107,781577,26,4,8,3,4,1,4,2,2,1,1,3,1,0,0,0,11
6107,797554,2,0,1,0,1,0,0,0,0,0,0,0,0,0,0,0,0
6107,780020,8,1,2,1,2,0,0,0,0,0,1,0,2,0,1,0,2
6108,780095,36,2,3,2,3,0,0,3,4,3,4,1,2,0,2,0,7
6108,776321,27,3,6,2,4,1,2,0,0,1,8,1,4,0,4,1,7
6108,786081,33,4,11,3,7,1,4,1,1,1,13,0,2,1,3,1,10
6108,785431,39,6,12,5,11,1,1,3,3,0,10,1,1,0,5,1,16
6108,780232,39,7,17,7,13,0,4,6,7,0,1,1,3,0,3,0,20
6108,785356,7,0,0,0,0,0,0,0,0,0,0,1,3,0,0,0,0
6108,781328,7,0,1,0,1,0,0,2,2,1,0,0,1,1,0,0,2
6108,789040,12,3,6,3,5,0,1,1,1,2,1,0,0,0,0,0,7
6109,781417,6,0,1,0,1,0,0,1,2,0,0,0,1,0,1,0,1
6109,792246,26,4,9,4,9,0,0,3,3,2,3,0,2,0,1,2,11
6109,797925,30,2,6,1,5,1,1,1,2,0,2,0,2,2,0,0,6
6109,781420,36,5,16,5,10,0,6,5,7,0,4,0,2,1,2,0,15
6109,781405,25,3,10,3,5,0,5,1,2,1,2,1,5,1,2,0,7
6109,780615,11,0,2,0,2,0,0,0,0,1,1,0,0,0,0,0,0
6109,781624,24,2,6,1,3,1,3,0,0,0,5,0,0,1,0,0,5
6109,797933,3,0,1,0,0,0,1,0,0,0,0,0,0,0,0,0,0
6109,791701,14,2,7,2,7,0,0,0,0,2,1,0,2,0,1,1,4
6109,792245,25,0,3,0,2,0,1,2,2,1,2,0,2,1,1,0,2
6110,786157,14,4,5,4,5,0,0,0,0,1,0,0,4,0,0,0,8
6110,780676,29,9,16,5,9,4,7,4,4,1,4,4,2,2,2,0,26
6110,791756,20,2,4,2,2,0,2,0,0,0,2,3,3,1,4,0,4
6110,780992,21,0,2,0,1,0,1,0,0,0,1,4,1,0,0,0,0
6110,780677,25,3,4,1,2,2,2,2,2,0,2,0,2,0,1,0,10
6110,797350,2,1,2,1,1,0,1,0,0,0,1,1,0,0,0,0,2
6110,791730,1,2,2,2,2,0,0,2,2,0,0,0,1,0,0,0,6
6110,791754,22,6,8,4,6,2,2,1,1,1,4,2,1,0,0,0,15
6110,775533,22,1,2,1,1,0,1,6,7,2,2,1,4,0,0,0,8
6110,791753,1,0,0,0,0,0,0,0,0,0,0,1,0,1,0,0,0
6110,797348,19,3,4,2,2,1,2,4,6,0,2,4,5,1,1,0,11
6110,780673,24,3,7,1,2,2,5,0,0,0,2,1,3,0,0,0,8
6110,797353,0,0,0,0,0,0,0,0,0,0,0,0,0,0,0,0,0
6110,797351,0,0,0,0,0,0,0,0,0,0,0,0,0,0,0,0,0
6111,780844,15,0,1,0,0,0,1,1,2,1,1,1,3,0,0,0,1
6111,797699,33,6,10,2,2,4,8,2,2,0,0,6,3,2,5,1,18
6111,797692,24,4,5,2,2,2,3,1,2,0,1,0,3,1,1,0,11
6111,791954,33,2,10,2,5,0,5,7,9,1,1,3,2,0,1,0,11
6111,780846,35,0,3,0,0,0,3,4,7,0,4,4,3,1,2,0,4
6111,797698,17,3,5,1,2,2,3,3,3,1,1,0,4,0,0,0,11
6111,797695,25,3,6,3,5,0,1,3,4,1,2,0,4,1,2,0,9
6111,797694,18,2,6,0,0,2,6,0,0,0,1,1,1,0,0,0,6
6111,797693,0,0,0,0,0,0,0,0,0,0,0,0,0,0,0,0,0
6111,800096,0,0,0,0,0,0,0,0,0,0,0,0,0,0,0,0,0
6126,790873,28,6,12,5,9,1,3,7,9,2,6,0,3,2,1,2,20
6126,785429,23,2,5,0,0,2,5,1,3,0,3,0,4,0,1,0,7
6126,780054,28,4,7,4,6,0,1,9,10,1,6,2,3,1,1,0,17
6126,781140,18,3,4,3,4,0,0,0,0,3,4,1,4,0,1,0,6
6126,786851,31,2,10,0,4,2,6,2,2,0,2,3,2,0,2,0,8
6126,796433,12,2,3,2,3,0,0,0,1,0,3,0,0,0,0,0,4
6126,776357,25,3,8,3,7,0,1,4,4,0,2,2,1,3,3,0,10
6126,781139,16,0,0,0,0,0,0,0,0,0,0,0,3,0,0,1,0
6126,776245,11,3,5,2,3,1,2,0,0,0,1,0,2,0,0,0,7
6126,796432,5,0,0,0,0,0,0,0,0,0,0,0,2,0,0,0,0
6126,799973,3,0,1,0,1,0,0,0,0,0,0,0,0,0,0,0,0
6127,785374,9,2,2,2,2,0,0,0,0,0,1,1,3,0,1,0,4
6127,785372,29,2,8,2,4,0,4,6,8,1,6,3,4,1,1,0,10
6127,786384,34,5,11,4,6,1,5,0,1,0,5,1,3,0,1,1,11
6127,790825,27,2,9,1,6,1,3,1,2,0,0,2,1,0,2,0,6
6127,774905,32,4,15,2,6,2,9,4,4,0,0,2,3,0,1,0,14
6127,785375,8,0,1,0,1,0,0,4,4,1,3,0,3,0,0,0,4
6127,790827,14,0,1,0,0,0,1,4,5,2,3,1,1,0,1,0,4
6127,790828,16,1,3,1,3,0,0,4,6,1,4,0,4,1,1,1,6
6127,785371,21,1,2,0,0,1,2,0,0,0,4,1,2,0,1,0,3
6127,796387,5,0,0,0,0,0,0,0,1,1,1,0,0,0,0,0,0
6127,796385,5,0,1,0,1,0,0,0,0,0,0,0,0,0,1,0,0
6128,792261,37,3,6,3,6,0,0,0,2,4,11,2,2,2,1,7,6
6128,792258,23,3,6,2,2,1,4,2,3,0,0,2,4,0,1,0,9
6128,786122,33,6,14,3,6,3,8,0,0,1,2,1,2,0,1,1,15
6128,786331,27,4,10,4,10,0,0,2,4,5,3,1,2,0,0,0,10
6128,776284,38,7,20,4,10,3,10,1,1,0,4,8,2,1,2,0,18
6128,797980,14,3,5,3,5,0,0,0,0,2,2,0,0,1,0,0,6
6128,786113,8,2,4,1,2,1,2,0,0,0,2,0,0,0,0,0,5
6128,780308,20,2,4,1,1,1,3,0,0,0,1,2,4,1,1,0,5
6129,792110,21,1,4,1,4,0,0,0,0,2,1,1,2,2,1,0,2
6129,786031,31,3,8,2,6,1,2,1,2,2,4,1,1,0,2,0,8
6129,797734,25,4,8,4,7,0,1,3,3,0,4,2,2,0,3,0,11
6129,797735,35,12,19,11,17,1,2,5,7,2,10,1,2,2,2,0,30
6129,781386,36,8,14,6,8,2,6,2,2,1,1,3,3,1,0,0,20
6129,786033,19,1,3,1,3,0,0,0,0,1,3,0,0,0,0,4,2
6129,797733,15,1,6,1,5,0,1,0,0,0,2,0,0,0,0,0,2
6129,792109,10,0,2,0,2,0,0,0,0,0,1,0,0,0,0,0,0
6129,792107,8,0,0,0,0,0,0,0,0,0,0,2,0,0,0,0,0
6130,796850,28,3,4,2,3,1,1,5,6,1,4,2,3,1,1,3,12
6130,774969,33,5,11,5,11,0,0,5,10,2,8,0,3,1,3,1,15
6130,791179,34,1,4,0,0,1,4,4,6,1,2,2,2,0,2,1,7
6130,781054,39,7,14,3,5,4,9,8,11,1,3,3,1,0,3,1,26
6130,781053,37,5,12,2,5,3,7,0,0,0,2,2,4,2,3,1,13
6130,785670,13,0,1,0,0,0,1,0,0,1,3,0,0,0,0,0,0
6130,780981,6,1,1,1,1,0,0,0,0,0,0,0,1,0,0,0,2
6130,796848,10,0,1,0,0,0,1,0,0,0,0,2,0,0,0,0,0
6131,785523,23,6,10,6,10,0,0,0,0,0,1,2,3,0,3,0,12
6131,781247,20,0,2,0,1,0,1,0,0,2,1,1,5,0,0,0,0
6131,791250,28,4,8,3,5,1,3,3,5,2,5,1,3,2,3,1,12
6131,791249,30,9,17,3,7,6,10,6,6,0,3,7,3,2,2,0,30
6131,775358,27,4,11,2,5,2,6,0,0,0,4,1,3,0,1,0,10
6131,796949,2,1,1,1,1,0,0,0,0,0,0,0,2,0,0,0,2
6131,785522,7,1,1,1,1,0,0,0,0,0,0,1,5,0,1,0,2
6131,796947,20,1,3,1,2,0,1,0,0,0,3,0,0,1,0,0,2
6131,796944,14,0,3,0,1,0,2,0,0,0,0,0,1,0,0,0,0
6131,796948,0,0,0,0,0,0,0,0,0,0,0,0,0,0,1,0,0
6131,791247,29,0,0,0,0,0,0,0,0,0,0,0,0,0,0,0,0
6132,785740,30,6,9,6,9,0,0,0,0,5,8,0,3,0,0,1,12
6132,785809,35,4,8,3,5,1,3,1,2,2,0,1,1,4,1,0,10
6132,780530,39,2,9,2,9,0,0,4,7,4,4,2,2,0,1,3,8
6132,797402,38,8,11,3,4,5,7,1,1,0,0,1,1,4,1,0,22
6132,785738,39,6,16,2,10,4,6,6,8,0,0,7,1,0,3,0,22
6132,797396,2,0,1,0,1,0,0,0,0,0,0,0,0,0,0,0,0
6132,785739,9,1,1,1,1,0,0,0,0,1,2,0,0,1,1,0,2
6132,791664,8,0,1,0,0,0,1,0,0,0,5,0,0,0,0,0,0
6133,797380,24,3,8,2,4,1,4,0,0,1,1,2,2,1,0,0,7
6133,797379,37,5,6,5,6,0,0,3,3,1,6,1,4,1,0,1,13
6133,797377,35,3,5,2,3,1,2,0,0,1,3,3,2,0,2,0,7
6133,791818,37,9,16,5,8,4,8,1,1,2,4,4,0,1,4,0,23
6133,780646,31,3,9,2,6,1,3,0,0,0,4,1,3,0,2,0,7
6133,797382,8,1,1,1,1,0,0,0,0,0,0,0,2,0,1,0,2
6133,797378,5,0,3,0,3,0,0,0,0,0,0,0,0,1,0,0,0
6133,786636,23,1,7,0,2,1,5,2,2,1,0,1,0,0,1,0,5
6134,792171,24,4,9,3,6,1,3,0,0,2,3,1,3,0,2,2,9
6134,780049,25,2,9,2,7,0,2,0,0,3,5,1,2,0,3,0,4
6134,780527,15,3,7,3,5,0,2,0,0,1,3,0,3,0,0,0,6
6134,797784,36,3,8,1,4,2,4,0,0,0,2,4,1,2,2,0,8
6134,789059,22,1,5,1,2,0,3,1,2,1,6,1,2,1,2,0,3
6134,797782,5,0,1,0,1,0,0,2,2,0,0,1,0,0,1,1,2
6134,797783,18,5,7,5,7,0,0,3,4,1,4,1,1,0,2,0,13
6134,785674,24,5,8,1,3,4,5,2,2,0,4,0,2,0,1,0,16
6134,792174,20,0,5,0,3,0,2,0,0,1,1,2,0,0,0,2,0
6134,792173,11,1,3,1,1,0,2,0,0,0,1,1,0,0,0,1,2
6134,792175,0,0,0,0,0,0,0,0,0,0,0,0,0,0,0,0,0
6135,792417,20,3,7,3,5,0,2,1,2,1,3,0,2,0,2,1,7
6135,786861,38,5,8,5,6,0,2,5,6,1,5,1,0,0,2,5,15
6135,786867,28,0,4,0,3,0,1,0,0,0,0,0,1,0,0,0,0
6135,780387,32,4,11,3,7,1,4,2,4,1,5,1,4,1,3,1,11
6135,767033,34,3,11,1,7,2,4,0,0,0,4,8,5,3,5,0,8
6135,792416,11,1,4,1,2,0,2,0,0,0,0,2,1,1,2,0,2
6135,786866,22,1,6,1,1,0,5,0,0,1,4,1,3,1,1,0,2
6135,796870,8,1,1,1,1,0,0,0,0,0,1,0,0,0,0,0,2
6135,785801,2,0,1,0,0,0,1,0,0,0,0,0,1,0,0,0,0
6135,796867,3,0,2,0,1,0,1,2,2,0,0,0,0,0,0,0,2
6135,796868,2,0,0,0,0,0,0,0,0,0,0,0,0,0,0,0,0
6136,797241,29,1,3,1,3,0,0,3,4,0,6,1,2,0,0,1,5
6136,791366,25,3,7,2,5,1,2,4,5,2,5,0,1,0,1,1,11
6136,797244,28,5,7,4,5,1,2,0,0,2,2,1,2,1,2,0,11
6136,785742,26,4,9,1,2,3,7,4,4,0,0,1,3,0,1,0,15
6136,780163,37,6,13,6,10,0,3,3,4,0,4,6,2,5,0,0,15
6136,791361,9,0,2,0,0,0,2,2,2,1,0,0,1,0,1,0,2
6136,780170,12,2,7,2,5,0,2,0,0,3,2,0,1,1,0,0,4
6136,797243,11,3,5,2,4,1,1,0,0,1,2,0,2,0,0,0,7
6136,791363,10,0,1,0,0,0,1,0,2,0,2,0,0,0,0,0,0
6136,786340,13,1,5,0,0,1,5,0,0,0,0,0,2,0,0,0,3
6137,791201,23,1,2,1,2,0,0,0,0,1,5,1,5,0,1,0,2
6137,775767,21,3,7,3,7,0,0,0,0,1,5,2,1,0,2,0,6
6137,785629,31,0,4,0,2,0,2,2,2,0,2,1,3,0,3,0,2
6137,785628,40,10,21,8,13,2,8,7,9,2,4,3,3,1,5,0,29
6137,785627,34,5,10,3,5,2,5,3,5,0,5,1,3,0,2,0,15
6137,796904,1,0,0,0,0,0,0,0,0,1,1,0,1,0,0,1,0
6137,781135,17,1,1,1,1,0,0,0,0,3,3,0,2,0,0,0,2
6137,796903,10,2,4,0,0,2,4,0,0,0,0,0,0,0,1,0,6
6137,796902,6,0,1,0,0,0,1,2,2,0,0,0,0,0,1,0,2
6137,796901,17,0,3,0,1,0,2,0,0,0,1,0,0,0,0,0,0
6138,790870,18,0,3,0,3,0,0,2,2,4,4,2,4,1,2,0,2
6138,790869,35,3,12,2,10,1,2,1,2,1,9,1,1,0,3,0,8
6138,780116,25,3,7,2,4,1,3,2,4,2,0,0,3,0,0,0,9
6138,796421,35,3,10,3,8,0,2,2,2,0,1,2,2,0,2,1,8
6138,790866,27,2,7,1,1,1,6,0,0,1,1,0,0,0,2,0,5
6138,796426,6,1,4,1,3,0,1,0,0,2,1,0,1,0,1,0,2
6138,796425,3,0,0,0,0,0,0,0,0,0,1,0,1,0,1,0,0
6138,780493,26,2,5,0,0,2,5,0,0,1,2,0,2,1,0,1,6
6138,780492,3,0,0,0,0,0,0,0,0,0,0,0,1,0,0,0,0
6138,796428,2,0,0,0,0,0,0,0,0,0,0,0,0,0,1,0,0
6138,796427,15,2,9,1,5,1,4,1,2,0,2,1,1,0,1,0,6
6138,796424,3,0,1,0,0,0,1,0,0,0,0,0,0,0,0,0,0
6138,783997,2,0,1,0,0,0,1,0,0,0,1,0,0,0,0,0,0
6139,775897,25,3,4,3,4,0,0,1,2,0,2,1,1,0,0,0,7
6139,780324,23,8,18,8,18,0,0,2,2,3,5,5,0,1,1,0,18
6139,791543,25,4,5,3,3,1,2,3,3,0,6,0,2,1,0,0,12
6139,786530,22,2,4,2,3,0,1,0,0,0,2,2,1,1,1,0,4
6139,780317,25,3,5,2,2,1,3,0,0,0,4,1,3,3,3,0,7
6139,791546,15,2,4,2,2,0,2,1,2,0,4,1,1,0,1,0,5
6139,785932,3,0,0,0,0,0,0,0,0,0,0,0,0,1,0,0,0
6139,797092,3,0,1,0,0,0,1,1,2,0,0,0,0,0,0,0,1
6139,797091,4,1,1,1,1,0,0,2,2,0,1,0,0,0,0,0,4
6139,791547,5,0,0,0,0,0,0,0,0,0,0,0,0,0,0,0,0
6139,791545,23,2,5,2,4,0,1,4,6,1,3,0,2,1,2,0,8
6139,786360,11,0,2,0,1,0,1,0,0,0,2,0,2,0,0,0,0
6139,784246,14,3,4,3,4,0,0,0,0,0,5,1,2,0,1,0,6
6139,775437,2,0,0,0,0,0,0,0,0,0,0,0,0,0,0,0,0
6140,792288,33,4,10,4,9,0,1,2,2,4,8,1,2,0,0,0,10
6140,785227,36,6,8,6,8,0,0,0,0,2,4,2,1,1,1,5,12
6140,786237,21,2,5,2,5,0,0,7,9,0,2,1,3,0,2,0,11
6140,786232,5,1,2,0,1,1,1,0,0,0,0,2,0,1,0,0,3
6140,780287,32,2,8,1,5,1,3,7,8,2,3,4,1,0,2,0,12
6140,798067,6,1,2,1,2,0,0,0,0,0,1,0,2,1,0,0,2
6140,798084,7,0,0,0,0,0,0,0,0,0,3,2,0,0,1,0,0
6140,792278,27,3,10,0,3,3,7,2,2,0,1,3,1,2,1,0,11
6140,776309,33,1,7,1,5,0,2,0,0,1,7,2,1,0,3,1,2
6141,796979,28,1,6,0,4,1,2,0,0,1,4,0,1,2,1,0,3
6141,776200,21,0,4,0,4,0,0,0,0,2,3,0,2,0,2,0,0
6141,786437,34,5,9,5,7,0,2,3,5,1,7,3,1,1,2,1,13
6141,785620,34,3,13,1,7,2,6,1,2,1,1,1,5,0,3,0,9
6141,781034,38,6,14,4,7,2,7,0,2,1,1,2,3,3,1,0,14
6141,791625,12,1,2,1,1,0,1,1,2,1,0,0,0,0,0,1,3
6141,791622,20,5,6,5,6,0,0,0,0,1,5,0,3,0,1,1,10
6141,791637,13,0,4,0,1,0,3,0,0,0,0,0,0,0,0,1,0
6142,797050,39,6,13,4,9,2,4,6,8,6,3,0,3,0,0,0,20
6142,780394,35,6,9,4,5,2,4,0,0,1,6,1,3,3,2,0,14
6142,780391,37,5,11,5,11,0,0,6,8,4,4,2,0,1,1,2,16
6142,790871,36,3,11,3,8,0,3,6,6,0,4,4,0,1,5,0,12
6142,776473,31,4,12,3,7,1,5,2,2,0,2,4,3,2,2,0,11
6142,791570,3,0,0,0,0,0,0,0,0,0,0,0,0,0,1,0,0
6142,791573,5,0,1,0,0,0,1,0,0,0,0,0,1,0,0,0,0
6142,780392,14,0,0,0,0,0,0,0,0,0,2,0,2,1,1,1,0
6143,786180,17,2,3,2,3,0,0,0,0,3,1,0,5,0,0,2,4
6143,792104,34,7,14,3,7,4,7,4,4,2,5,0,3,1,2,0,22
6143,797709,27,3,6,1,3,2,3,2,2,1,1,4,3,0,3,0,10
6143,797708,34,6,14,4,10,2,4,1,1,1,1,3,1,6,2,0,15
6143,775779,35,4,11,4,10,0,1,3,3,0,3,3,1,1,4,0,11
6143,785608,15,2,4,1,2,1,2,0,0,1,2,2,1,0,1,2,5
6143,786204,14,1,4,1,4,0,0,0,0,1,3,0,1,0,0,0,2
6143,776327,2,0,0,0,0,0,0,0,0,0,0,0,2,0,0,0,0
6143,797707,20,3,7,3,5,0,2,0,0,3,2,1,1,0,2,0,6
6143,792106,2,0,0,0,0,0,0,0,0,0,0,0,0,0,0,0,0
6144,796959,28,9,12,9,12,0,0,3,4,1,3,0,1,2,1,3,21
6144,781272,30,5,5,4,4,1,1,5,6,1,13,7,4,0,4,1,16
6144,791261,22,4,9,1,2,3,7,2,2,0,2,0,3,2,4,0,13
6144,785501,11,0,4,0,3,0,1,0,0,1,1,1,1,1,2,0,0
6144,781270,38,7,13,5,8,2,5,2,2,1,0,4,0,2,2,0,18
6144,796960,12,1,1,1,1,0,0,1,2,0,0,0,2,0,0,0,3
6144,791260,16,3,5,3,5,0,0,0,0,3,6,0,2,1,2,0,6
6144,796958,23,3,5,3,4,0,1,0,0,4,3,3,5,1,4,0,6
6144,791258,19,1,5,0,1,1,4,9,10,0,3,0,1,1,0,1,12
6144,799825,1,0,0,0,0,0,0,0,0,0,0,0,0,0,0,0,0
6145,791023,20,3,5,3,5,0,0,1,3,2,1,0,3,0,1,1,7
6145,791027,36,6,13,3,6,3,7,3,3,2,3,2,1,0,1,0,18
6145,791024,27,4,14,1,4,3,10,0,0,0,4,1,1,2,5,0,11
6145,781507,30,2,2,2,2,0,0,0,0,1,3,6,2,2,3,0,4
6145,777572,35,8,18,5,11,3,7,5,7,4,2,4,5,0,2,0,24
6145,791028,19,0,3,0,1,0,2,1,2,2,2,3,3,2,2,0,1
6145,796685,30,4,14,0,1,4,13,4,5,2,1,0,3,0,2,0,16
6145,796683,3,1,3,0,1,1,2,0,0,0,0,1,3,2,0,0,3
6145,796684,0,0,0,0,0,0,0,0,0,0,0,0,0,0,0,0,0
6146,792158,27,0,5,0,4,0,1,5,6,3,4,0,3,2,0,1,5
6146,780138,28,3,7,3,7,0,0,3,4,1,3,2,2,0,3,0,9
6146,792154,29,3,7,3,5,0,2,3,3,0,4,3,2,0,1,0,9
6146,792152,36,8,14,8,11,0,3,3,3,0,5,2,1,2,1,2,19
6146,780581,29,8,12,4,4,4,8,2,2,0,3,5,2,3,4,0,22
6146,797755,12,0,2,0,2,0,0,0,0,0,0,0,0,0,0,2,0
6146,792157,13,3,6,3,6,0,0,1,2,3,2,0,1,0,0,0,7
6146,797756,2,0,1,0,1,0,0,0,0,1,0,0,0,0,0,0,0
6146,786014,24,2,7,1,4,1,3,2,2,1,1,3,4,0,0,0,7
6147,797367,27,2,3,2,3,0,0,1,2,2,8,3,3,1,1,3,5
6147,797369,35,3,8,3,5,0,3,1,2,0,1,5,4,1,1,1,7
6147,797366,20,1,4,1,2,0,2,0,0,0,2,2,4,0,1,0,2
6147,791807,28,2,6,2,3,0,3,6,6,1,1,0,1,0,2,0,10
6147,786130,32,5,12,4,11,1,1,3,3,0,2,1,3,1,5,0,14
6147,797368,2,0,0,0,0,0,0,2,2,0,1,1,0,0,0,0,2
6147,797364,11,3,3,3,3,0,0,1,1,2,2,0,3,1,0,0,7
6147,797365,12,1,4,0,0,1,4,0,0,0,0,0,2,0,0,0,3
6147,797363,27,6,16,2,9,4,7,0,0,0,0,2,2,0,1,1,16
6147,791808,6,1,1,1,1,0,0,0,0,0,0,0,0,0,1,0,2
6148,781249,31,4,6,3,4,1,2,0,0,0,3,1,1,0,0,1,9
6148,775165,30,0,0,0,0,0,0,0,0,0,3,2,3,1,1,0,0
6148,785514,31,7,10,6,7,1,3,2,3,0,8,2,0,1,2,1,17
6148,785515,31,8,13,7,9,1,4,2,2,0,3,4,3,3,3,0,19
6148,781253,32,2,6,0,1,2,5,0,0,1,0,0,0,0,2,0,6
6148,796953,16,1,3,1,2,0,1,0,0,1,0,0,2,0,2,0,2
6148,796951,3,0,0,0,0,0,0,0,0,0,1,0,0,0,1,0,0
6148,791251,1,0,0,0,0,0,0,0,0,0,0,0,0,0,0,0,0
6148,791687,25,7,10,6,7,1,3,2,2,0,4,0,2,0,1,0,17
6149,792373,29,7,9,5,7,2,2,2,2,0,3,0,0,0,2,0,18
6149,792370,30,1,7,1,4,0,3,1,2,1,2,2,2,0,0,0,3
6149,797960,33,2,4,0,0,2,4,0,2,1,1,0,3,1,2,0,6
6149,786739,24,1,3,1,3,0,0,0,2,0,0,1,0,2,2,0,2
6149,775303,31,4,5,3,3,1,2,4,4,0,3,1,2,1,3,1,13
6149,797958,5,0,1,0,1,0,0,1,2,0,0,0,1,0,1,0,1
6149,781598,10,1,4,1,2,0,2,0,0,0,2,1,0,0,0,0,2
6149,797951,15,1,4,1,1,0,3,0,0,0,2,2,1,0,1,0,2
6149,790499,10,1,2,1,2,0,0,1,2,0,1,1,1,0,0,0,3
6149,781597,2,1,1,1,1,0,0,0,0,0,0,0,0,0,0,0,2
6149,776491,11,0,0,0,0,0,0,0,0,0,0,1,3,0,2,0,0
6150,786459,33,7,15,7,15,0,0,3,4,2,8,0,1,0,6,0,17
6150,781612,26,1,7,1,5,0,2,1,2,3,6,1,2,1,1,8,3
6150,797006,19,0,4,0,2,0,2,0,0,0,2,1,2,0,3,0,0
6150,797004,32,5,8,5,6,0,2,2,2,0,1,4,1,0,1,1,12
6150,781609,27,3,11,2,8,1,3,1,2,2,3,2,2,0,1,0,8
6150,797002,4,1,1,1,1,0,0,0,0,1,0,1,1,0,0,0,2
6150,797005,25,4,5,2,2,2,3,0,0,0,4,1,2,1,0,2,10
6150,797008,2,0,0,0,0,0,0,0,0,0,0,0,1,0,0,0,0
6150,791360,20,1,5,0,2,1,3,0,0,1,2,1,1,1,2,0,3
6150,797003,12,2,3,1,2,1,1,0,0,0,0,0,3,0,0,0,5
6151,791140,21,2,4,2,4,0,0,0,0,2,2,1,2,1,1,2,4
6151,791138,23,0,5,0,2,0,3,2,2,0,5,0,1,3,0,0,2
6151,786084,30,2,7,0,1,2,6,2,2,0,4,2,1,1,2,0,8
6151,780910,29,7,19,7,18,0,1,4,5,1,4,2,2,2,1,0,18
6151,780288,26,7,11,6,7,1,4,4,5,1,0,0,1,0,0,0,19
6151,796794,6,0,0,0,0,0,0,1,2,0,0,0,1,0,0,0,1
6151,791137,1,0,1,0,1,0,0,0,0,0,0,0,0,0,0,0,0
6151,796795,17,3,7,3,7,0,0,4,5,7,2,1,3,0,3,3,10
6151,796793,1,0,1,0,1,0,0,0,0,0,0,0,0,0,0,0,0
6151,780912,10,0,3,0,1,0,2,0,0,0,4,3,0,1,0,0,0
6151,780911,21,4,6,1,2,3,4,1,1,1,4,0,1,0,0,0,12
6151,781635,14,2,4,2,3,0,1,0,0,0,2,0,0,1,0,0,4
6151,786082,1,0,0,0,0,0,0,0,0,0,0,0,0,0,0,0,0
6152,797655,28,4,8,4,8,0,0,2,2,0,6,0,4,1,3,1,10
6152,797657,33,5,10,1,2,4,8,0,0,0,2,0,4,0,2,0,14
6152,792072,19,0,1,0,0,0,1,0,1,0,3,1,4,2,1,0,0
6152,792069,40,10,15,3,4,7,11,0,0,1,4,6,1,2,2,0,27
6152,785572,18,0,7,0,3,0,4,0,0,0,3,0,2,0,0,0,0
6152,786025,8,0,0,0,0,0,0,1,2,0,1,0,1,0,0,0,1
6152,784640,22,3,8,1,5,2,3,3,4,4,6,4,2,0,2,0,11
6152,797652,32,3,5,1,2,2,3,0,0,0,4,5,1,3,6,1,8
6153,791905,38,5,9,5,5,0,4,1,5,1,7,4,2,0,2,0,11
6153,781103,10,1,2,0,1,1,1,0,0,0,2,1,2,0,3,0,3
6153,797568,37,4,8,1,2,3,6,5,7,0,2,1,0,1,3,0,16
6153,797566,33,5,12,4,7,1,5,2,3,0,4,3,1,1,1,0,13
6153,781191,36,6,14,6,8,0,6,1,5,1,4,3,4,3,2,0,13
6153,797569,23,3,5,1,2,2,3,0,1,3,2,2,1,5,2,0,8
6153,791907,19,2,2,2,2,0,0,0,0,0,2,0,2,2,1,0,4
6153,781364,2,0,1,0,1,0,0,0,0,0,1,0,0,0,0,0,0
6153,781102,2,0,0,0,0,0,0,0,0,0,0,0,0,0,0,0,0
6154,791917,11,0,0,0,0,0,0,0,0,0,0,0,3,0,1,0,0
6154,786526,35,2,8,2,4,0,4,2,4,1,8,3,3,1,1,0,6
6154,786525,36,5,13,4,7,1,6,4,5,0,4,0,1,1,5,0,15
6154,791914,19,1,3,1,1,0,2,0,0,1,2,3,2,0,5,0,2
6154,786030,32,6,13,4,8,2,5,0,0,0,3,2,4,5,4,0,14
6154,786856,29,4,6,4,6,0,0,6,8,1,2,1,3,1,2,0,14
6154,797550,14,1,3,0,0,1,3,0,0,0,0,0,4,1,0,0,3
6154,786524,2,0,0,0,0,0,0,0,0,0,0,1,0,0,0,0,0
6154,781109,22,1,2,1,2,0,0,0,0,3,3,0,2,0,0,0,2
6155,780634,26,3,3,3,3,0,0,1,2,0,6,0,4,1,1,1,7
6155,791826,23,1,4,0,1,1,3,0,0,1,1,5,3,3,2,0,3
6155,786785,35,5,10,5,6,0,4,3,3,0,2,1,1,1,3,1,13
6155,786783,24,1,5,1,2,0,3,0,0,0,5,2,3,1,1,1,2
6155,780633,34,4,8,2,3,2,5,2,2,0,4,2,1,0,5,0,12
6155,797389,13,1,1,1,1,0,0,0,3,1,0,0,4,1,0,0,2
6155,776009,27,6,10,4,7,2,3,5,8,0,2,2,1,0,3,0,19
6155,786784,18,2,6,2,2,0,4,2,4,2,3,0,3,1,3,1,6
6156,797523,23,3,4,1,1,2,3,0,0,1,4,1,4,0,1,0,8
6156,785402,22,2,8,2,8,0,0,1,3,1,3,0,2,0,2,2,5
6156,797524,22,2,4,1,2,1,2,0,1,0,3,3,2,1,1,0,5
6156,792118,33,6,11,4,6,2,5,1,2,0,4,11,2,1,1,0,15
6156,782593,31,6,9,3,4,3,5,2,2,0,3,2,1,1,4,2,17
6156,785828,15,5,7,3,5,2,2,4,6,1,4,1,3,2,0,1,16
6156,791699,18,4,6,2,2,2,4,1,1,0,6,1,0,0,0,0,11
6156,791700,22,2,2,0,0,2,2,0,0,0,2,1,0,0,0,0,6
6156,791702,6,0,0,0,0,0,0,0,0,0,1,0,0,0,0,0,0
6156,797525,3,1,2,1,2,0,0,2,2,0,0,0,1,0,0,0,4
6156,797526,3,0,2,0,1,0,1,0,0,0,0,0,0,0,0,0,0
6156,792663,2,0,0,0,0,0,0,2,2,0,0,1,0,1,0,0,2
6157,786164,35,4,15,1,4,3,11,2,2,1,4,1,3,1,4,0,13
6157,781560,26,3,10,3,10,0,0,2,2,6,3,0,1,1,0,0,8
6157,796477,33,2,10,2,5,0,5,0,0,0,0,4,1,0,1,0,4
6157,791375,38,4,9,3,5,1,4,2,2,0,5,3,2,1,5,0,11
6157,780837,27,4,12,1,7,3,5,2,2,0,2,3,5,3,1,0,13
6157,796479,23,2,4,1,3,1,1,0,0,1,7,0,4,0,2,0,5
6157,796473,3,0,1,0,0,0,1,0,0,1,0,0,0,0,0,0,0
6157,796476,15,3,3,3,3,0,0,0,1,2,1,0,3,0,0,0,6
6170,785930,24,6,10,6,10,0,0,3,5,2,7,0,2,0,3,0,15
6170,780996,27,3,7,1,1,2,6,0,0,0,1,1,2,2,1,1,8
6170,780995,20,3,6,2,2,1,4,2,2,0,0,1,3,1,2,0,9
6170,796468,35,1,6,1,5,0,1,0,3,1,10,9,3,1,1,0,2
6170,790920,32,4,10,3,5,1,5,6,8,2,2,4,2,1,3,0,15
6170,791035,33,3,13,2,5,1,8,1,1,0,0,0,3,0,2,0,8
6170,796466,6,1,2,1,2,0,0,0,0,1,0,0,0,0,0,0,2
6170,775709,23,2,4,1,1,1,3,0,0,0,1,1,1,1,0,0,5
6171,792271,29,5,9,5,8,0,1,2,3,4,9,0,0,0,2,2,12
6171,791686,28,5,8,4,5,1,3,4,5,0,7,4,2,2,2,0,15
6171,798028,19,1,2,0,0,1,2,0,0,0,3,2,5,1,1,0,3
6171,790940,40,6,12,2,4,4,8,7,8,0,8,1,1,0,1,0,23
6171,780770,38,6,13,5,8,1,5,2,2,2,1,8,2,2,1,0,15
6171,786060,33,6,13,5,8,1,5,0,0,0,2,2,1,0,3,0,13
6171,792269,12,0,1,0,1,0,0,0,0,1,1,1,3,0,1,0,0
6171,792270,1,0,0,0,0,0,0,0,0,0,1,0,0,0,0,0,0
6172,776286,30,2,8,1,6,1,2,4,6,3,14,0,2,2,1,0,9
6172,775557,19,0,0,0,0,0,0,2,4,1,2,0,3,0,0,2,2
6172,791445,34,5,15,1,3,4,12,5,7,1,3,1,2,3,1,0,19
6172,785357,28,2,8,0,1,2,7,0,0,2,4,0,4,1,1,0,6
6172,775560,32,3,10,3,9,0,1,3,5,2,1,5,3,1,2,1,9
6172,791444,9,0,1,0,1,0,0,0,0,0,2,0,0,1,1,0,0
6172,785287,21,4,4,4,4,0,0,2,2,3,2,2,2,1,1,1,10
6172,785895,7,1,2,0,0,1,2,2,2,0,0,0,1,0,0,0,5
6172,797010,17,1,7,1,6,0,1,4,4,1,1,0,4,0,2,0,6
6172,797012,3,1,1,1,1,0,0,2,2,0,0,0,0,1,0,0,4
6173,786041,27,4,6,4,5,0,1,2,3,1,7,0,2,1,2,1,10
6173,780881,22,2,4,2,2,0,2,2,4,0,2,1,2,0,2,0,6
6173,780275,19,1,3,1,3,0,0,0,1,0,4,0,3,1,3,0,2
6173,792075,28,0,8,0,4,0,4,1,3,1,2,1,0,0,1,0,1
6173,786686,34,3,12,1,8,2,4,3,3,0,2,4,4,1,1,0,11
6173,785437,17,3,6,3,5,0,1,4,4,3,1,1,3,1,0,0,10
6173,775222,32,2,7,2,6,0,1,2,6,1,5,1,3,0,2,0,6
6173,792074,14,0,1,0,0,0,1,0,0,0,0,1,2,0,1,0,0
6173,780882,2,0,0,0,0,0,0,2,2,0,0,0,1,0,1,0,2
6173,792076,1,0,0,0,0,0,0,0,0,0,0,0,1,0,0,0,0
6173,786051,2,0,0,0,0,0,0,0,0,0,1,0,0,0,0,0,0
6173,780884,2,0,0,0,0,0,0,0,0,0,0,0,0,0,0,0,0
6174,791356,37,4,6,3,5,1,1,0,0,1,4,6,3,0,2,2,9
6174,797431,31,4,8,1,2,3,6,0,0,0,2,1,4,1,1,0,11
6174,791680,34,6,9,2,4,4,5,5,6,1,5,2,4,1,1,1,21
6174,785812,37,2,9,1,4,1,5,6,6,0,5,3,2,0,2,0,11
6174,780104,38,12,26,12,23,0,3,6,6,4,5,6,4,3,4,0,30
6174,791681,23,0,1,0,1,0,0,1,2,1,2,0,4,1,0,2,1
6175,791344,33,7,11,7,9,0,2,3,7,8,3,0,1,2,1,3,17
6175,781425,31,7,10,7,10,0,0,7,9,2,3,0,3,0,1,0,21
6175,797001,22,0,3,0,0,0,3,2,2,0,2,1,2,0,2,0,2
6175,791343,36,5,10,3,6,2,4,3,3,0,6,5,1,1,3,0,15
6175,781602,37,7,16,6,10,1,6,3,3,0,4,2,2,2,2,0,18
6175,781601,8,2,2,2,2,0,0,2,3,2,0,0,4,0,0,1,6
6175,776173,3,0,1,0,0,0,1,0,0,0,0,0,0,0,0,0,0
6175,786611,25,4,8,2,3,2,5,0,0,0,4,1,4,1,1,0,10
6175,797000,5,0,0,0,0,0,0,0,0,0,0,0,1,0,0,0,0
6176,796631,27,3,9,0,2,3,7,2,2,1,2,0,2,1,1,0,11
6176,790998,24,1,5,0,2,1,3,0,0,4,5,2,5,1,1,1,3
6176,790997,40,5,10,4,8,1,2,1,1,2,5,3,5,1,3,0,12
6176,790996,40,4,14,2,8,2,6,4,4,1,1,3,4,2,4,0,14
6176,785621,36,3,13,3,5,0,8,0,0,0,5,2,1,0,1,0,6
6176,766874,34,4,8,4,8,0,0,3,4,3,8,0,4,0,2,1,11
6176,790995,12,3,7,3,5,0,2,0,0,0,0,1,0,0,0,0,6
6176,786375,12,1,1,1,1,0,0,0,1,1,1,0,1,1,3,0,2
6177,785836,45,9,15,5,9,4,6,2,3,2,12,1,1,1,1,1,24
6177,785833,39,5,13,3,6,2,7,6,9,2,8,3,2,2,4,0,18
6177,791707,35,2,5,2,4,0,1,5,5,0,0,4,4,2,3,2,9
6177,791704,13,1,6,1,5,0,1,0,0,0,2,0,3,0,3,1,2
6177,785892,34,4,8,3,6,1,2,3,3,0,3,1,3,0,0,0,12
6177,775872,12,0,2,0,1,0,1,0,0,2,0,2,3,0,0,0,0
6177,797533,12,1,4,1,2,0,2,0,0,0,2,0,0,1,0,0,2
6177,785838,35,2,9,2,7,0,2,0,2,6,2,0,2,0,1,1,4
6178,785843,34,3,6,2,4,1,2,1,1,0,4,3,2,0,1,3,8
6178,780578,27,4,7,4,6,0,1,4,7,2,5,1,4,1,3,2,12
6178,797537,10,1,2,1,1,0,1,0,0,0,1,0,0,0,0,0,2
6178,797538,35,5,13,3,9,2,4,1,2,0,3,1,1,1,0,1,13
6178,780579,40,6,11,5,7,1,4,2,6,0,3,0,0,4,3,0,15
6178,797536,13,3,6,2,3,1,3,1,2,0,1,1,3,1,1,0,8
6178,785845,5,1,1,1,1,0,0,0,0,1,0,0,3,0,2,0,2
6178,785293,25,3,5,2,3,1,2,0,0,0,5,2,2,0,1,2,7
6178,785847,11,1,3,1,2,0,1,0,0,2,3,0,0,1,0,0,2
6179,781158,27,3,9,3,9,0,0,0,0,1,8,1,3,0,3,0,6
6179,781652,37,5,13,4,9,1,4,0,2,3,8,2,2,0,0,0,11
6179,786034,30,3,6,1,2,2,4,0,0,0,0,1,1,3,3,0,8
6179,786419,35,5,14,1,6,4,8,2,2,1,5,4,5,0,4,0,16
6179,781283,26,4,5,1,1,3,4,0,0,0,2,1,3,2,4,0,11
6179,791614,5,0,2,0,1,0,1,0,0,0,1,1,1,0,0,0,0
6179,785419,10,0,1,0,1,0,0,3,4,2,1,0,2,1,1,1,3
6179,791615,11,1,1,1,1,0,0,0,0,0,1,1,2,0,2,0,2
6179,785277,19,2,6,0,1,2,5,2,2,1,2,0,0,1,0,0,8
6180,780346,29,11,16,10,13,1,3,9,9,1,1,3,1,1,2,0,32
6180,780338,18,3,4,3,4,0,0,0,0,2,5,0,3,1,0,1,6
6180,791030,21,2,4,1,1,1,3,3,3,0,4,7,1,1,2,0,8
6180,785477,29,6,14,3,6,3,8,2,2,1,4,1,0,0,0,0,17
6180,785475,27,4,4,0,0,4,4,0,0,0,3,1,3,1,1,1,12
6180,791029,6,1,4,1,4,0,0,0,0,0,2,0,0,0,1,0,2
6180,796689,18,3,4,3,4,0,0,0,0,1,8,0,1,0,1,3,6
6180,796687,19,3,7,2,4,1,3,0,0,0,1,1,2,2,4,0,7
6180,786655,18,1,5,1,2,0,3,0,0,0,5,1,2,0,1,0,2
6180,791032,8,0,2,0,1,0,1,0,0,0,1,0,1,0,0,0,0
6180,791031,4,0,0,0,0,0,0,0,0,1,0,0,1,0,0,0,0
6180,780344,3,0,2,0,2,0,0,0,0,0,0,0,0,0,0,0,0
6181,797205,13,1,2,0,1,1,1,0,0,1,3,0,3,1,0,0,3
6181,786316,16,1,7,1,7,0,0,1,2,2,0,0,2,0,2,0,3
6181,791475,16,0,8,0,2,0,6,0,0,0,2,1,0,1,0,0,0
6181,791477,27,5,10,4,7,1,3,3,4,3,7,0,0,1,1,1,14
6181,780220,26,2,9,1,5,1,4,4,4,0,2,3,0,0,1,1,9
6181,797206,16,0,1,0,1,0,0,2,2,0,0,0,3,1,2,0,2
6181,791473,13,3,5,3,4,0,1,3,4,1,2,1,1,2,1,0,9
6181,786314,23,5,10,2,6,3,4,3,4,2,4,1,2,0,2,0,16
6181,797202,22,3,7,2,5,1,2,2,2,0,1,4,0,2,2,0,9
6181,791476,20,1,4,0,1,1,3,0,0,0,0,0,0,0,0,1,3
6181,797204,4,0,1,0,0,0,1,0,0,0,0,0,0,0,0,0,0
6181,791474,4,0,1,0,1,0,0,0,0,0,2,0,0,0,1,0,0
6182,781244,34,9,16,6,9,3,7,2,3,2,13,2,1,0,4,1,23
6182,791243,27,2,4,1,3,1,1,0,1,0,0,1,1,1,1,0,5
6182,791241,9,1,3,1,2,0,1,2,2,1,0,0,3,0,2,0,4
6182,785537,33,2,6,2,4,0,2,2,2,2,1,2,3,0,3,0,6
6182,781243,34,1,3,1,1,0,2,2,2,3,6,1,3,1,2,2,4
6182,791245,21,5,10,4,6,1,4,2,2,0,1,4,1,2,0,0,13
6182,791246,6,2,5,2,5,0,0,0,0,2,1,0,2,0,1,0,4
6182,785529,13,0,2,0,0,0,2,0,0,0,2,0,0,0,0,0,0
6182,776205,23,3,10,2,4,1,6,2,2,0,4,3,1,0,1,0,9
6183,786635,34,7,16,6,13,1,3,2,2,2,6,2,4,0,3,0,17
6183,791822,40,4,10,1,2,3,8,3,3,0,4,0,4,1,0,0,14
6183,781543,25,3,9,0,2,3,7,0,0,0,2,7,0,1,1,0,9
6183,780642,30,2,11,2,8,0,3,1,2,1,3,1,1,2,3,1,5
6183,776449,27,3,7,3,5,0,2,0,0,1,4,2,2,1,3,0,6
6183,797383,20,2,4,1,2,1,2,0,0,2,2,0,3,1,1,0,5
6183,786182,11,0,3,0,3,0,0,4,4,2,0,0,3,0,1,0,4
6183,786632,13,0,0,0,0,0,0,0,0,0,1,1,0,0,1,0,0
6183,791823,0,0,0,0,0,0,0,0,0,0,0,0,0,0,0,0,0
6184,785863,24,3,8,3,8,0,0,0,0,4,5,1,4,1,1,1,6
6184,785631,37,6,13,6,8,0,5,1,2,1,5,0,2,3,2,0,13
6184,786248,31,10,10,10,10,0,0,0,0,3,7,2,5,0,2,0,20
6184,785630,34,4,12,1,1,3,11,0,0,0,0,0,3,1,0,0,11
6184,780777,43,3,15,3,8,0,7,4,4,2,1,9,2,3,5,0,10
6184,791197,8,0,0,0,0,0,0,2,2,0,0,0,0,2,1,0,2
6184,791198,8,0,3,0,0,0,3,0,0,0,0,0,0,0,0,0,0
6184,791196,0,0,1,0,0,0,1,0,0,0,0,0,0,0,0,0,0
6184,791200,18,4,6,3,3,1,3,0,0,0,3,1,0,1,0,0,9
6184,785632,22,3,8,3,8,0,0,1,2,3,3,1,1,0,1,0,7
6185,797103,31,3,8,3,8,0,0,3,7,3,3,1,3,1,4,0,9
6185,797105,39,2,5,2,4,0,1,2,2,0,6,1,0,1,0,1,6
6185,797100,30,3,4,2,2,1,2,0,0,1,3,4,4,0,3,0,7
6185,791413,41,8,16,5,11,3,5,8,9,2,4,1,0,2,3,0,27
6185,791411,41,6,15,4,8,2,7,0,0,1,6,4,4,2,4,0,14
6185,797099,2,0,0,0,0,0,0,0,0,0,0,0,0,0,0,0,0
6185,791414,13,0,1,0,1,0,0,2,2,0,3,0,1,0,1,0,2
6185,785911,12,2,3,0,0,2,3,0,0,1,1,0,2,1,2,2,6
6185,781209,16,2,7,1,4,1,3,0,0,0,0,0,1,1,1,1,5
6186,791564,26,2,5,2,4,0,1,0,0,1,7,1,5,0,0,0,4
6186,775549,15,1,3,1,3,0,0,0,0,0,4,0,4,0,1,2,2
6186,797054,27,4,11,4,7,0,4,0,0,0,0,1,1,0,2,0,8
6186,791568,21,1,1,1,1,0,0,2,4,1,4,0,4,0,1,0,4
6186,786381,30,2,6,1,2,1,4,2,4,0,3,1,3,1,3,0,7
6186,797058,10,0,0,0,0,0,0,0,0,0,1,0,2,0,0,0,0
6186,791566,3,1,2,0,1,1,1,0,0,1,1,0,2,0,0,0,3
6186,780425,22,2,3,2,3,0,0,0,0,0,4,0,1,0,1,0,4
6186,797056,26,3,9,2,4,1,5,2,2,0,2,1,1,1,7,0,9
6186,797055,20,3,5,3,4,0,1,3,4,0,0,1,0,0,0,0,9
6187,786569,30,3,7,3,7,0,0,0,0,1,5,5,4,3,2,0,6
6187,791726,24,2,5,0,1,2,4,0,1,0,0,0,3,1,0,0,6
6187,786273,34,4,5,2,2,2,3,1,2,1,4,1,0,1,2,0,11
6187,780773,37,4,14,3,10,1,4,10,16,3,10,2,1,1,2,0,19
6187,775228,36,3,5,1,1,2,4,0,0,0,1,2,3,2,0,0,8
6187,797313,5,0,1,0,1,0,0,1,2,0,0,0,1,0,0,0,1
6187,791728,10,2,3,2,3,0,0,4,8,0,1,0,1,0,1,0,8
6187,797317,24,2,4,2,3,0,1,0,0,0,1,1,2,1,1,2,4
6188,786131,33,4,8,3,5,1,3,2,2,0,1,1,2,0,3,0,11
6188,780904,19,2,4,2,4,0,0,0,0,1,3,1,0,1,2,0,4
6188,797688,33,6,13,4,5,2,8,2,2,0,5,0,3,1,4,0,16
6188,786145,36,5,9,2,4,3,5,0,0,1,1,3,0,2,0,0,13
6188,786128,23,4,7,1,2,3,5,3,4,1,1,4,5,0,4,0,14
6188,792100,11,1,2,1,2,0,0,1,1,1,3,1,2,0,0,1,3
6188,785884,17,4,6,3,5,1,1,3,4,1,3,0,3,1,0,0,12
6188,797685,22,0,1,0,1,0,0,1,2,0,3,5,0,0,1,0,1
6188,792096,6,1,2,0,0,1,2,0,0,0,0,0,1,0,0,0,3
6189,785577,17,2,2,2,2,0,0,2,2,1,0,0,4,0,3,0,6
6189,791094,32,3,5,1,1,2,4,0,0,0,6,6,2,2,1,0,8
6189,791091,16,2,4,2,3,0,1,2,2,0,0,4,3,0,2,0,6
6189,791093,4,0,2,0,2,0,0,0,0,0,0,0,0,0,0,0,0
6189,785569,21,1,5,0,1,1,4,2,2,0,0,0,2,0,1,0,5
6189,791089,23,3,8,3,6,0,2,2,2,5,2,1,2,0,2,2,8
6189,796753,22,7,10,3,4,4,6,1,2,0,0,1,1,3,0,0,19
6189,796752,32,4,10,3,9,1,1,0,0,1,3,3,3,3,2,0,9
6189,791090,33,8,11,4,4,4,7,4,7,1,4,1,1,2,0,0,24
6190,791883,17,3,4,2,2,1,2,0,0,0,5,1,3,0,0,1,7
6190,781066,25,7,8,7,8,0,0,0,0,3,7,2,1,2,3,0,14
6190,797594,22,2,6,2,4,0,2,0,0,0,0,1,1,1,1,0,4
6190,791884,27,5,13,3,9,2,4,0,0,0,2,1,2,0,0,0,12
6190,780695,26,4,7,2,2,2,5,2,2,0,4,3,0,3,1,0,12
6190,797600,10,3,3,3,3,0,0,1,1,1,1,0,2,0,3,0,7
6190,797598,13,2,4,2,4,0,0,0,0,1,3,0,1,0,0,1,4
6190,797597,4,1,2,1,1,0,1,0,0,0,0,0,0,0,0,0,2
6190,791885,11,1,1,0,0,1,1,2,2,0,1,2,1,1,1,0,5
6190,797596,23,3,6,2,4,1,2,0,0,1,1,2,1,0,1,0,7
6190,786496,22,1,2,0,0,1,2,2,2,1,1,1,3,1,1,0,5
6191,791839,26,8,12,8,12,0,0,2,2,3,5,2,1,1,1,1,18
6191,785322,27,1,6,1,1,0,5,0,0,0,2,0,1,1,3,0,2
6191,792381,32,3,9,2,6,1,3,2,2,0,1,2,2,0,1,0,9
6191,791842,31,2,11,2,9,0,2,0,1,2,2,1,0,0,2,0,4
6191,786613,24,2,5,2,2,0,3,3,4,2,1,2,1,1,2,0,7
6191,797443,14,2,5,2,5,0,0,1,2,1,1,0,1,0,2,0,5
6191,797444,18,1,2,0,0,1,2,1,2,0,1,1,3,0,0,0,4
6191,797442,20,1,3,0,1,1,2,1,2,0,1,0,0,3,1,0,4
6191,776341,8,0,1,0,1,0,0,0,0,1,0,0,1,1,0,0,0
6192,791391,22,0,1,0,1,0,0,2,6,3,3,0,4,0,3,1,2
6192,797156,21,2,3,2,3,0,0,3,4,0,2,2,0,2,1,0,7
6192,791390,36,4,8,3,7,1,1,3,8,5,4,2,0,4,1,1,12
6192,780133,24,4,9,3,4,1,5,0,0,0,3,4,0,0,1,0,9
6192,780130,35,3,13,1,7,2,6,4,6,1,7,1,1,0,1,0,12
6192,797158,5,0,0,0,0,0,0,0,0,0,0,0,1,0,1,0,0
6192,791388,17,4,7,4,5,0,2,1,2,2,1,1,1,0,0,0,9
6192,775743,22,1,6,0,2,1,4,0,0,0,1,3,2,0,2,0,3
6192,780407,18,2,4,0,2,2,2,0,0,0,1,2,0,0,1,0,6
6193,791011,24,5,7,5,5,0,2,2,2,1,8,0,4,0,0,0,12
6193,780303,34,4,8,4,7,0,1,0,0,0,8,2,2,0,1,3,8
6193,791594,21,1,6,1,5,0,1,0,0,0,0,4,2,0,3,0,2
6193,786349,27,0,2,0,2,0,0,2,2,0,0,2,4,0,3,0,2
6193,781385,18,0,4,0,2,0,2,0,0,0,1,2,4,0,0,2,0
6193,796671,0,0,0,0,0,0,0,0,0,0,1,0,0,0,0,0,0
6193,785337,29,6,11,6,10,0,1,2,3,2,2,1,3,1,1,0,14
6193,796668,9,1,4,1,1,0,3,0,0,0,3,1,1,0,0,0,2
6193,791013,4,0,0,0,0,0,0,0,0,1,0,0,0,0,2,0,0
6193,791012,34,7,11,4,5,3,6,0,0,1,0,1,0,0,4,0,17
6194,787524,28,3,7,3,5,0,2,0,1,2,3,1,3,1,2,1,6
6194,787522,20,5,5,5,5,0,0,0,0,2,2,0,2,0,1,0,10
6194,781019,37,4,8,1,5,3,3,2,2,0,3,10,1,1,10,0,13
6194,780017,17,4,8,3,6,1,2,1,2,0,3,1,4,0,5,0,10
6194,775961,19,1,7,0,2,1,5,0,0,0,3,0,5,0,1,1,3
6194,775541,11,1,3,1,2,0,1,0,2,0,3,1,0,0,0,0,2
6194,797611,13,0,1,0,0,0,1,2,2,0,1,0,0,0,0,0,2
6194,791774,8,2,2,1,1,1,1,0,0,0,2,0,0,0,0,0,5
6194,791772,6,1,2,0,0,1,2,0,0,0,0,0,2,2,2,0,3
6194,791722,19,1,1,0,0,1,1,0,0,0,1,0,2,0,0,1,3
6194,780328,22,5,7,5,6,0,1,0,1,0,2,1,1,1,0,0,10
6195,781658,35,3,6,3,5,0,1,4,4,5,2,1,2,1,1,0,10
6195,781656,32,7,10,7,10,0,0,1,2,5,1,3,1,1,1,2,15
6195,796962,31,4,14,3,8,1,6,4,6,1,4,4,3,1,1,0,13
6195,786798,38,7,15,7,15,0,0,6,10,2,8,4,1,2,5,0,20
6195,780129,29,1,5,0,1,1,4,1,1,0,1,0,3,2,3,0,4
6195,798206,8,0,3,0,0,0,3,0,0,1,1,2,1,0,0,0,0
6195,790256,1,0,0,0,0,0,0,0,0,0,0,0,0,0,0,0,0
6195,791263,4,0,0,0,0,0,0,0,0,0,0,1,1,0,0,0,0
6195,796966,2,0,0,0,0,0,0,0,0,0,0,0,1,0,0,0,0
6195,796964,20,1,4,0,0,1,4,0,2,1,1,2,0,1,3,0,3
6196,792181,39,5,11,5,10,0,1,0,0,3,7,1,5,1,0,1,10
6196,785902,39,6,13,3,6,3,7,4,4,1,5,2,3,4,3,3,19
6196,780986,38,4,6,4,6,0,0,3,4,5,3,6,3,4,2,0,11
6196,792179,25,2,10,1,5,1,5,0,0,0,2,4,2,0,1,1,5
6196,786662,40,6,16,2,8,4,8,1,1,0,2,3,2,0,2,0,17
6196,797796,16,6,7,6,7,0,0,2,2,0,1,1,1,0,2,0,14
6196,792177,2,0,0,0,0,0,0,0,0,1,0,0,0,0,0,0,0
6196,786661,1,0,0,0,0,0,0,0,0,0,0,0,0,0,0,0,0
6197,785409,38,7,9,7,9,0,0,3,5,4,10,1,5,1,0,4,17
6197,785408,37,9,19,9,17,0,2,6,7,3,6,4,1,1,5,0,24
6197,796416,18,0,3,0,0,0,3,1,2,1,2,4,2,1,2,0,1
6197,780539,36,4,8,1,3,3,5,0,0,0,1,4,1,0,0,0,11
6197,780560,36,1,6,0,1,1,5,3,3,1,2,3,0,1,0,0,6
6197,796415,17,2,8,1,3,1,5,0,0,0,0,1,1,1,3,0,5
6197,790861,16,4,8,3,5,1,3,0,0,0,2,2,5,2,0,1,9
6197,796417,2,0,0,0,0,0,0,0,0,0,0,0,0,0,0,0,0
6198,776344,19,3,9,3,6,0,3,2,2,1,2,0,3,2,1,1,8
6198,775821,21,5,10,1,4,4,6,0,0,1,3,0,1,1,2,0,14
6198,792453,26,2,6,1,3,1,3,2,2,1,8,6,0,2,2,0,7
6198,785131,26,1,7,1,3,0,4,1,1,1,6,2,2,1,1,1,3
6198,781538,28,2,5,0,1,2,4,0,0,1,1,2,0,0,1,0,6
6198,798113,12,4,5,4,5,0,0,0,0,2,2,1,3,0,1,0,8
6198,785152,12,2,4,2,4,0,0,1,1,0,0,0,1,0,0,0,5
6198,798115,22,2,4,0,0,2,4,0,0,0,7,3,1,0,2,0,6
6198,792324,16,1,5,1,3,0,2,0,0,1,3,2,1,0,2,1,2
6198,776233,18,4,7,0,2,4,5,0,0,0,2,2,2,1,1,0,12
6199,780913,21,6,12,1,1,5,11,0,0,0,3,1,3,1,3,0,17
6199,798119,30,2,8,2,4,0,4,0,0,0,2,0,0,0,1,0,4
6199,798117,31,2,8,2,8,0,0,1,2,1,5,2,2,1,1,0,5
6199,780594,30,1,3,1,2,0,1,0,0,1,3,4,0,1,2,0,2
6199,775664,23,0,4,0,1,0,3,0,0,0,4,0,1,0,1,0,0
6199,798123,23,5,12,3,9,2,3,3,6,3,4,0,1,1,3,0,15
6199,798118,3,0,0,0,0,0,0,0,0,0,1,1,0,0,0,0,0
6199,769332,12,3,7,0,1,3,6,0,0,0,1,1,1,0,1,1,9
6199,798124,27,2,4,1,2,1,2,2,4,0,3,3,0,1,2,0,7
6200,786772,17,1,2,1,2,0,0,4,6,3,1,1,4,1,4,1,6
6200,781484,9,1,2,1,2,0,0,0,0,1,2,0,3,0,1,1,2
6200,786769,38,3,8,1,5,2,3,1,4,0,7,4,2,2,0,0,9
6200,786024,35,4,11,3,6,1,5,4,6,1,2,3,4,0,4,0,13
6200,780002,35,7,18,3,7,4,11,2,2,0,1,2,4,2,3,0,20
6200,797840,18,0,2,0,2,0,0,0,0,0,0,2,0,2,2,0,0
6200,791967,14,3,6,2,4,1,2,0,0,1,0,2,0,0,3,0,7
6200,786773,17,1,1,1,1,0,0,0,0,1,4,0,1,1,0,2,2
6200,791970,17,1,5,0,1,1,4,0,0,0,1,0,0,0,2,0,3
6201,797831,18,0,3,0,0,0,3,0,0,0,0,0,2,0,2,0,0
6201,797823,33,5,8,5,6,0,2,3,5,5,8,1,4,0,3,0,13
6201,797829,28,4,7,4,7,0,0,3,7,0,3,0,4,2,1,0,11
6201,792280,36,6,17,4,10,2,7,7,8,3,3,2,3,3,2,0,21
6201,780505,38,10,17,8,12,2,5,3,6,1,6,4,3,2,5,0,25
6201,792286,12,2,2,2,2,0,0,0,0,1,3,0,1,0,1,0,4
6201,792283,20,1,4,0,1,1,3,0,0,2,2,0,2,0,2,0,3
6201,792284,13,0,2,0,1,0,1,0,1,0,0,0,2,0,2,0,0
6201,785701,2,0,1,0,1,0,0,0,0,0,0,0,0,0,0,0,0
6206,791531,16,1,4,1,2,0,2,0,0,1,1,0,0,1,1,0,2
6206,791534,20,2,5,2,5,0,0,2,2,3,4,1,3,1,0,2,6
6206,797127,29,1,5,1,5,0,0,4,4,2,4,2,1,0,2,0,6
6206,791528,38,9,20,3,9,6,11,0,0,2,8,0,1,2,3,1,24
6206,775045,39,5,17,5,13,0,4,2,2,1,5,8,3,0,1,0,12
6206,791533,30,8,13,7,12,1,1,3,6,7,11,1,0,0,1,0,20
6206,774880,8,0,2,0,1,0,1,0,0,0,1,1,1,0,0,0,0
6206,797124,4,0,0,0,0,0,0,0,0,0,0,0,1,0,0,0,0
6206,797129,16,2,6,2,6,0,0,0,3,4,2,0,3,0,0,0,4
6207,785355,21,0,4,0,1,0,3,0,0,0,0,1,2,0,0,0,0
6207,781462,40,6,17,5,15,1,2,2,4,5,11,3,0,1,1,7,15
6207,780876,30,4,14,2,7,2,7,1,2,0,2,2,4,1,0,0,11
6207,785353,36,6,15,3,9,3,6,2,2,3,6,2,4,0,2,1,17
6207,781457,37,3,11,2,5,1,6,0,0,1,4,4,2,2,3,0,7
6207,790895,15,2,4,2,3,0,1,1,1,0,0,1,2,1,0,0,5
6207,781673,11,1,3,0,1,1,2,0,0,0,1,0,0,0,0,0,3
6207,791305,10,0,0,0,0,0,0,0,0,1,3,0,2,0,0,3,0
6208,780956,26,2,13,1,9,1,4,7,8,2,1,2,1,1,0,0,12
6208,791723,22,2,3,2,3,0,0,4,4,1,4,1,4,0,1,3,8
6208,781617,37,7,15,7,11,0,4,2,3,0,9,0,4,1,3,0,16
6208,797310,29,2,5,2,4,0,1,2,4,2,3,3,2,1,4,0,6
6208,791724,38,2,8,1,4,1,4,0,1,3,2,1,3,4,1,1,5
6208,797308,11,1,3,0,1,1,2,0,0,0,0,0,0,0,0,0,3
6208,785580,10,1,2,1,2,0,0,0,0,1,2,2,1,0,1,0,2
6208,800056,3,0,1,0,0,0,1,0,0,0,0,0,0,1,0,0,0
6208,797312,13,1,1,1,1,0,0,2,2,1,0,0,2,1,3,0,4
6208,780706,11,1,2,1,2,0,0,1,2,0,0,1,1,0,2,0,3
6209,791306,23,5,7,5,7,0,0,4,4,1,3,0,3,1,1,0,14
6209,780210,35,6,11,6,11,0,0,3,4,2,6,4,3,1,4,0,15
6209,792432,31,4,7,1,2,3,5,0,0,1,1,9,3,0,1,0,11
6209,792427,24,2,6,0,1,2,5,0,0,0,0,1,3,3,1,0,6
6209,792433,28,4,8,1,1,3,7,2,4,0,6,0,3,1,2,0,13
6209,796592,14,1,1,1,1,0,0,0,0,0,0,1,4,1,2,0,2
6209,796594,12,2,3,2,3,0,0,1,2,0,1,1,0,0,1,0,5
6209,790880,9,1,3,1,3,0,0,0,0,0,1,0,1,0,0,0,2
6209,775005,15,1,5,1,3,0,2,0,0,1,1,0,1,0,0,0,2
6209,786422,9,1,3,1,3,0,0,2,2,0,1,1,1,0,1,0,4
6210,792164,20,8,10,3,4,5,6,0,0,0,2,5,0,2,2,0,21
6210,791372,18,5,8,1,1,4,7,0,0,0,0,4,1,1,0,0,14
6210,792167,20,3,10,3,10,0,0,5,6,7,7,1,2,1,2,1,11
6210,780974,16,4,5,4,4,0,1,2,2,1,3,2,0,4,1,1,10
6210,797766,15,1,4,1,2,0,2,0,0,1,4,0,0,1,0,1,2
6210,792170,20,6,13,5,10,1,3,2,2,2,2,2,1,1,2,1,15
6210,792163,14,4,7,0,0,4,7,0,0,0,4,2,0,0,0,1,12
6210,797764,22,3,7,0,2,3,5,0,0,0,1,0,0,1,0,0,9
6210,792169,19,3,8,2,6,1,2,0,0,4,2,0,2,1,0,0,7
6210,797767,23,3,3,3,3,0,0,0,0,0,1,5,1,0,0,0,6
6210,797765,13,1,5,0,1,1,4,0,0,1,0,2,2,1,0,0,3
6212,786054,21,3,5,3,5,0,0,0,0,2,2,0,2,1,5,0,6
6212,797711,30,5,6,3,3,2,3,2,2,1,4,0,4,1,1,0,14
6212,786056,26,1,2,0,0,1,2,0,0,0,4,3,1,1,3,0,3
6212,781339,38,6,12,3,4,3,8,0,2,0,2,2,2,2,1,0,15
6212,781337,38,7,14,3,6,4,8,1,2,1,1,2,1,1,3,0,19
6212,797713,7,0,1,0,1,0,0,0,0,2,0,0,1,0,0,0,0
6212,792041,22,3,5,1,2,2,3,2,2,2,2,1,1,0,0,0,10
6212,799737,15,0,3,0,0,0,3,0,0,0,1,1,1,1,0,0,0
6212,797710,3,0,1,0,0,0,1,0,0,0,0,0,0,0,0,0,0
6213,791220,30,2,4,2,4,0,0,3,3,3,2,1,0,2,2,0,7
6213,791219,28,8,12,2,3,6,9,2,3,4,4,1,3,1,2,0,24
6213,776217,29,2,4,2,4,0,0,0,0,2,2,0,2,0,2,1,4
6213,786396,23,2,8,1,2,1,6,0,0,0,2,0,2,2,0,0,5
6213,780730,34,3,11,1,3,2,8,0,0,0,3,1,2,2,1,0,8
6213,786824,21,3,8,2,5,1,3,0,0,2,3,0,2,0,0,0,7
6213,791221,8,1,3,1,2,0,1,0,0,1,0,1,1,0,1,0,2
6213,790818,27,2,7,1,3,1,4,0,0,1,2,5,3,2,6,0,5
6214,785863,29,8,10,8,10,0,0,2,2,1,4,3,2,2,1,1,18
6214,785631,28,10,15,4,5,6,10,4,5,2,6,0,0,2,0,1,30
6214,786248,23,1,4,1,4,0,0,1,1,0,3,3,2,0,3,0,3
6214,785630,26,1,5,0,0,1,5,0,1,0,0,6,1,2,1,0,3
6214,780777,20,3,6,2,4,1,2,0,0,1,2,7,2,2,1,1,7
6214,791198,8,4,6,0,0,4,6,0,0,0,0,0,1,0,0,0,12
6214,791200,18,1,8,1,5,0,3,2,2,0,2,1,0,2,1,0,4
6214,785632,17,3,4,3,4,0,0,3,3,2,6,2,1,1,0,0,9
6214,791197,10,1,1,1,1,0,0,0,0,1,0,0,2,0,0,0,2
6214,796898,4,0,3,0,2,0,1,0,0,1,0,2,0,0,0,0,0
6214,791199,5,1,1,1,1,0,0,0,0,1,0,0,2,0,0,1,2
6214,791196,5,1,2,0,0,1,2,0,0,0,0,0,1,0,0,0,3
6214,781129,3,0,1,0,0,0,1,0,0,0,0,0,0,1,0,0,0
6214,796899,2,0,0,0,0,0,0,0,0,1,1,1,0,0,0,0,0
6214,796900,1,0,1,0,0,0,1,0,0,0,0,0,0,0,0,0,0
6214,791195,1,1,1,1,1,0,0,0,0,0,0,0,0,0,0,0,2
6215,797103,17,1,6,1,6,0,0,0,0,0,2,1,1,0,1,0,2
6215,797105,31,3,7,2,3,1,4,0,0,0,3,0,1,0,1,0,7
6215,797100,29,0,6,0,1,0,5,0,0,0,3,3,3,2,4,0,0
6215,791413,31,8,11,6,8,2,3,2,3,0,1,2,0,0,3,1,20
6215,791411,30,4,9,2,4,2,5,1,2,0,2,2,3,0,3,0,11
6215,791414,13,3,5,2,3,1,2,0,0,1,3,0,1,0,0,1,7
6215,785911,17,3,5,3,3,0,2,0,0,3,4,0,2,2,1,2,6
6215,781209,14,1,7,1,3,0,4,0,1,1,0,2,1,0,2,0,2
6215,797099,7,1,1,1,1,0,0,3,5,3,0,0,0,1,0,0,5
6215,797102,3,0,0,0,0,0,0,0,0,2,0,0,0,0,0,0,0
6215,797101,7,0,1,0,1,0,0,0,0,0,0,1,0,0,0,0,0
6215,797104,1,0,2,0,0,0,2,0,0,0,1,0,0,0,0,0,0
6216,790821,29,6,9,5,7,1,2,3,4,0,3,2,3,2,3,1,16
6216,790822,39,6,10,5,9,1,1,3,4,1,2,3,0,1,3,2,16
6216,790820,24,4,10,4,9,0,1,0,0,0,4,2,0,2,1,0,8
6216,780982,32,8,10,5,5,3,5,2,5,1,6,0,3,3,2,0,21
6216,774980,38,2,12,0,9,2,3,0,0,1,2,2,2,1,3,0,6
6216,775585,25,2,4,2,3,0,1,0,0,3,1,3,2,0,1,2,4
6216,780445,13,3,4,3,4,0,0,0,0,2,2,2,1,0,1,0,6
6217,796318,26,6,12,6,11,0,1,1,1,2,5,2,2,1,4,0,13
6217,790761,35,7,9,6,8,1,1,3,3,3,3,3,3,1,2,0,18
6217,790764,38,7,15,6,9,1,6,6,7,0,3,0,3,0,1,1,21
6217,796319,34,5,13,3,8,2,5,2,2,3,3,0,1,0,1,1,14
6217,779993,35,2,10,1,6,1,4,0,0,2,2,1,2,2,3,0,5
6217,796322,16,1,1,1,1,0,0,0,0,0,3,2,2,1,1,4,2
6217,796320,14,1,3,1,2,0,1,0,0,0,0,0,0,1,1,0,2
6217,785219,2,0,0,0,0,0,0,0,0,0,0,0,0,0,0,0,0
6218,785518,22,6,6,6,6,0,0,3,3,1,1,1,3,5,2,0,15
6218,796390,24,3,6,3,6,0,0,0,4,1,3,1,1,0,2,3,6
6218,785451,24,8,16,4,8,4,8,0,0,1,0,3,1,1,2,0,20
6218,790832,17,5,8,4,4,1,4,0,0,0,1,3,2,4,3,0,11
6218,790834,20,4,5,2,2,2,3,3,4,1,5,6,3,3,1,0,13
6218,790831,13,1,1,1,1,0,0,0,0,1,1,0,4,1,3,0,2
6218,790833,23,3,10,1,5,2,5,1,2,3,4,0,3,1,2,0,9
6218,785379,15,1,4,1,3,0,1,4,4,0,3,0,0,0,0,0,6
6218,785377,18,5,6,1,1,4,5,0,0,0,3,3,0,4,0,1,14
6218,790830,15,0,0,0,0,0,0,0,0,0,1,3,3,1,4,0,0
6218,800099,7,0,2,0,1,0,1,0,0,0,2,1,1,0,2,0,0
6218,796389,2,0,0,0,0,0,0,0,0,0,0,0,0,0,0,0,0
6219,790846,27,2,4,2,3,0,1,1,2,2,2,1,2,3,4,1,5
6219,796754,17,2,4,2,3,0,1,1,4,0,3,1,3,3,3,0,5
6219,791099,27,4,14,1,4,3,10,0,0,1,1,0,1,1,1,0,11
6219,785470,31,5,9,2,4,3,5,2,2,2,4,2,2,1,3,1,15
6219,785586,27,4,9,4,8,0,1,3,4,0,2,3,0,2,4,0,11
6219,780298,28,3,9,1,4,2,5,5,6,0,1,4,4,0,4,0,13
6219,796755,15,2,5,2,5,0,0,4,4,2,3,0,2,0,4,0,8
6219,780315,16,0,0,0,0,0,0,1,2,0,1,0,3,0,3,0,1
6219,780814,12,0,1,0,1,0,0,0,0,1,1,1,2,0,0,0,0
6220,796637,24,8,16,8,15,0,1,7,7,4,7,1,4,1,0,0,23
6220,792632,18,1,3,1,3,0,0,0,0,1,4,0,5,3,1,1,2
6220,796638,18,2,6,1,2,1,4,0,0,0,2,1,0,2,1,0,5
6220,792626,28,2,5,1,4,1,1,4,5,1,5,6,1,3,2,0,9
6220,780250,26,6,12,5,9,1,3,4,6,4,3,3,1,0,1,0,17
6220,796634,5,0,1,0,1,0,0,0,0,1,1,2,0,0,1,0,0
6220,796642,3,0,2,0,0,0,2,0,0,0,0,0,0,0,0,0,0
6220,792627,13,3,5,3,5,0,0,1,4,1,0,1,1,0,2,0,7
6220,792629,14,2,5,0,1,2,4,1,2,0,1,2,1,0,1,0,7
6220,792631,18,1,7,0,2,1,5,0,0,1,3,6,1,1,2,0,3
6220,781491,33,4,6,2,2,2,4,2,2,2,1,2,4,1,1,0,12
6221,800005,12,0,0,0,0,0,0,0,4,0,1,0,5,0,1,1,0
6221,799129,36,4,16,2,8,2,8,2,3,1,2,5,1,2,2,0,12
6221,799130,18,1,4,1,2,0,2,0,0,0,1,1,1,1,2,0,2
6221,792634,39,8,15,5,7,3,8,3,4,1,1,6,1,1,3,0,22
6221,799135,9,0,1,0,1,0,0,1,2,1,2,0,1,1,0,1,1
6221,800091,40,10,13,8,10,2,3,5,9,0,11,0,1,0,2,0,27
6221,799128,24,1,2,1,2,0,0,1,2,0,0,4,2,2,2,0,3
6221,799133,9,1,1,0,0,1,1,0,0,0,1,1,0,0,1,0,3
6221,799136,13,1,2,1,2,0,0,0,0,1,4,0,5,0,1,2,2
6222,792399,25,0,7,0,7,0,0,5,8,3,6,0,0,1,0,0,5
6222,780263,20,3,7,1,1,2,6,0,0,1,3,1,2,2,2,0,8
6222,786697,27,5,9,0,2,5,7,0,0,1,4,2,2,0,2,0,15
6222,775628,37,5,12,3,8,2,4,2,5,1,7,8,1,2,3,0,14
6222,785471,24,4,12,4,9,0,3,1,1,7,2,1,1,0,1,2,9
6222,799000,18,3,5,3,5,0,0,2,2,3,2,0,2,0,2,1,8
6222,780571,8,1,4,0,1,1,3,0,0,0,0,0,0,0,0,0,3
6222,775547,11,2,3,2,2,0,1,0,0,0,2,2,2,0,3,1,4
6222,775198,22,0,3,0,1,0,2,0,0,1,2,1,1,0,0,0,0
6222,786695,1,0,0,0,0,0,0,0,0,0,0,0,0,0,0,0,0
6222,798999,1,0,0,0,0,0,0,0,0,0,0,0,0,0,0,0,0
6222,792397,6,0,1,0,0,0,1,0,0,1,1,0,1,1,1,0,0
6223,791987,23,0,2,0,2,0,0,0,0,0,0,4,1,1,1,1,0
6223,791988,36,5,15,5,15,0,0,4,4,3,3,0,3,1,3,1,14
6223,791989,32,4,14,2,5,2,9,0,0,1,2,1,0,1,3,0,10
6223,796507,20,2,10,2,6,0,4,2,6,1,1,1,2,2,2,1,6
6223,792443,13,1,2,1,2,0,0,0,0,1,1,0,4,0,2,0,2
6223,796503,22,0,3,0,1,0,2,0,0,0,0,0,2,0,0,0,0
6223,796506,14,1,5,1,5,0,0,1,2,3,5,0,1,0,0,1,3
6223,785258,7,0,0,0,0,0,0,0,0,0,5,0,1,0,0,0,0
6223,796508,16,3,4,1,1,2,3,0,0,1,3,0,0,0,0,0,8
6223,796509,17,3,8,3,5,0,3,0,2,1,4,0,2,0,0,0,6
6224,781149,31,4,11,1,6,3,5,0,0,2,8,4,2,0,2,0,11
6224,789025,32,4,5,4,5,0,0,5,5,0,3,3,3,1,2,0,13
6224,782157,29,2,2,2,2,0,0,5,6,0,2,9,2,0,3,0,9
6224,774985,35,4,9,2,5,2,4,2,3,0,0,2,2,3,5,1,12
6224,775276,5,0,2,0,0,0,2,0,0,0,0,0,1,0,0,0,0
6224,780852,17,3,3,3,3,0,0,2,2,1,0,0,4,1,1,0,8
6224,798152,4,0,0,0,0,0,0,1,2,0,0,0,0,1,1,0,1
6224,792670,20,6,8,1,1,5,7,0,0,0,2,0,1,1,3,0,17
6224,792669,10,2,2,1,1,1,1,0,0,0,4,3,5,1,2,0,5
6224,780193,17,6,9,3,4,3,5,0,2,0,0,1,0,2,1,0,15
6225,798966,9,0,0,0,0,0,0,0,0,0,0,0,3,0,1,1,0
6225,798962,29,4,7,3,6,1,1,0,0,2,5,2,3,1,3,2,9
6225,791717,25,7,11,6,7,1,4,3,4,2,5,0,1,3,2,1,18
6225,798963,23,5,8,4,6,1,2,4,6,0,0,4,4,0,3,0,15
6225,791718,29,4,7,2,2,2,5,2,4,1,2,3,2,2,0,0,12
6225,791720,4,0,0,0,0,0,0,0,0,0,0,0,0,0,1,0,0
6225,798968,16,0,5,0,2,0,3,0,0,0,1,0,0,0,0,0,0
6225,798961,3,0,0,0,0,0,0,0,0,0,0,0,1,0,1,0,0
6225,798965,29,4,8,2,3,2,5,3,5,0,2,0,2,2,1,1,13
6225,781446,24,3,8,3,6,0,2,4,4,0,1,4,0,1,4,0,10
6225,768880,6,0,1,0,0,0,1,0,0,1,0,0,1,0,0,0,0
6225,787996,3,0,0,0,0,0,0,0,0,0,0,0,0,0,0,0,0
6228,792140,21,4,5,4,5,0,0,1,2,4,6,2,3,0,5,3,9
6228,786596,23,7,15,6,11,1,4,1,1,0,4,2,5,2,3,0,16
6228,792144,31,4,8,4,6,0,2,1,2,2,3,2,2,2,2,1,9
6228,781429,39,2,7,2,3,0,4,0,0,0,4,1,0,1,1,0,4
6228,776092,33,7,15,7,13,0,2,7,8,1,3,5,3,0,1,0,21
6228,792146,19,7,8,7,8,0,0,0,2,2,4,0,2,0,0,0,14
6228,797793,24,1,4,0,0,1,4,0,0,0,1,1,0,1,1,0,3
6228,797786,5,0,0,0,0,0,0,0,0,0,0,0,2,0,0,0,0
6228,785976,5,0,0,0,0,0,0,0,0,0,0,0,0,0,0,0,0
6229,792249,26,4,7,4,6,0,1,0,0,0,3,0,4,1,3,1,8
6229,781430,38,7,17,7,14,0,3,2,4,4,13,2,3,1,2,0,16
6229,792248,34,5,8,4,5,1,3,5,6,0,1,1,0,1,0,0,16
6229,781445,38,6,12,4,5,2,7,3,4,0,1,3,0,0,2,0,17
6229,768845,29,4,10,4,7,0,3,0,1,0,2,1,4,1,1,2,8
6229,781448,14,0,0,0,0,0,0,0,0,0,1,0,3,0,2,1,0
6229,797941,10,1,2,1,2,0,0,0,0,1,1,0,2,0,1,1,2
6229,792250,11,3,4,2,2,1,2,1,2,1,1,2,2,0,1,0,8
6230,781244,25,8,11,8,9,0,2,1,3,2,4,2,4,0,2,0,17
6230,791243,9,0,0,0,0,0,0,0,0,0,1,1,1,0,3,0,0
6230,791241,22,5,7,5,5,0,2,1,2,3,2,3,3,1,2,1,11
6230,785537,38,5,11,4,8,1,3,0,0,0,2,3,0,0,1,0,11
6230,781243,21,4,5,4,5,0,0,0,0,0,6,3,2,0,2,0,8
6230,796943,2,0,0,0,0,0,0,0,0,1,0,1,0,0,0,0,0
6230,785535,2,0,0,0,0,0,0,0,0,0,1,1,0,0,0,0,0
6230,796940,6,2,2,2,2,0,0,0,0,0,0,0,0,0,1,0,4
6230,791245,30,7,8,3,4,4,4,2,4,1,5,6,2,0,1,0,20
6230,791246,19,3,4,1,1,2,3,1,2,0,2,2,3,0,0,1,9
6230,785529,4,0,1,0,0,0,1,0,0,0,0,0,0,0,2,0,0
6230,785528,2,0,1,0,1,0,0,0,0,0,0,0,0,0,0,0,0
6230,776205,20,4,10,0,4,4,6,2,2,1,1,2,1,1,1,0,14
6231,786635,29,3,9,2,7,1,2,5,6,1,3,2,3,1,6,0,12
6231,791822,33,3,7,2,3,1,4,0,1,0,0,0,2,0,0,0,7
6231,781543,29,5,12,1,4,4,8,1,2,0,1,2,1,2,3,0,15
6231,780642,29,6,10,3,6,3,4,5,6,2,5,5,2,1,1,0,20
6231,776449,30,5,11,4,8,1,3,0,0,1,2,0,2,3,2,0,11
6231,797383,18,0,2,0,1,0,1,0,0,1,1,0,3,0,0,0,0
6231,791823,3,0,0,0,0,0,0,0,0,0,0,0,0,0,0,0,0
6231,791821,4,1,1,1,1,0,0,0,0,0,0,0,0,0,0,0,2
6231,785830,2,0,0,0,0,0,0,0,0,0,0,0,0,0,0,0,0
6231,786632,6,2,3,1,1,1,2,0,0,0,0,0,0,0,0,0,5
6231,786182,17,3,4,3,3,0,1,1,2,1,0,2,4,2,1,0,7
6232,780130,36,6,12,5,7,1,5,6,8,0,4,3,1,0,1,0,19
6232,780133,32,5,9,4,5,1,4,0,0,0,2,4,1,1,3,0,11
6232,797156,23,2,4,1,2,1,2,4,6,1,5,0,2,0,0,0,9
6232,791391,32,4,9,4,9,0,0,0,1,3,3,1,3,0,2,1,8
6232,791390,33,3,8,3,7,0,1,0,0,2,3,3,2,1,2,1,6
6232,791388,15,2,4,0,2,2,2,2,2,0,4,0,1,0,0,0,8
6232,780407,15,2,3,0,1,2,2,0,0,0,0,1,1,0,1,0,6
6232,775743,11,0,1,0,1,0,0,0,0,0,0,0,0,0,0,0,0
6232,797158,3,0,0,0,0,0,0,0,0,0,0,0,0,0,0,0,0
6233,791011,30,7,12,5,5,2,7,1,2,2,3,3,0,0,2,1,17
6233,780303,33,5,13,5,12,0,1,1,1,2,10,1,3,1,3,0,11
6233,786349,22,2,6,2,3,0,3,2,2,1,1,0,2,0,1,0,6
6233,781385,29,0,7,0,3,0,4,1,2,0,1,7,4,0,2,0,1
6233,796668,8,0,1,0,0,0,1,0,0,1,0,0,2,0,0,0,0
6233,791012,29,4,8,2,2,2,6,0,0,1,0,2,1,0,1,0,10
6233,796671,11,4,6,4,6,0,0,0,2,0,1,0,0,1,0,1,8
6233,791013,17,0,1,0,1,0,0,2,2,0,3,2,1,0,0,0,2
6233,785337,21,0,3,0,2,0,1,0,0,0,4,0,3,0,2,0,0
6234,791266,15,2,2,2,2,0,0,0,0,2,4,0,3,2,2,3,4
6234,791270,17,2,3,0,0,2,3,0,0,1,0,2,0,1,0,0,6
6234,791265,14,1,4,0,0,1,4,0,0,0,0,4,0,1,0,0,3
6234,791269,20,2,7,0,1,2,6,0,0,1,3,0,1,1,0,0,6
6234,785685,29,6,13,5,7,1,6,5,8,0,2,9,3,3,2,0,18
6234,796524,14,3,4,3,4,0,0,0,0,0,2,0,2,1,1,0,6
6234,788872,4,0,3,0,1,0,2,0,0,0,0,0,1,0,0,0,0
6234,796523,18,2,2,1,1,1,1,5,5,0,1,1,3,1,2,0,10
6234,796522,21,7,14,1,1,6,13,0,0,0,4,1,1,1,0,1,20
6234,796525,17,3,8,0,1,3,7,0,0,1,2,2,1,3,1,0,9
6234,791271,12,1,3,1,3,0,0,1,2,1,2,2,1,0,0,0,3
6234,781313,19,2,6,1,2,1,4,0,0,0,0,5,0,1,2,0,5
6236,781249,29,2,10,1,2,1,8,0,2,1,6,2,1,0,0,0,5
6236,775165,34,4,5,1,2,3,3,0,0,1,5,1,0,0,1,1,11
6236,785514,36,6,8,6,8,0,0,0,0,0,5,2,1,0,2,2,12
6236,785515,35,5,10,4,8,1,2,1,2,1,4,5,1,4,4,0,12
6236,781253,33,3,8,1,2,2,6,2,2,2,1,0,0,1,0,0,10
6236,796953,13,2,4,1,2,1,2,1,1,2,1,1,0,0,1,0,6
6236,796951,2,0,0,0,0,0,0,0,0,0,0,0,3,0,0,0,0
6236,791687,18,1,7,1,3,0,4,0,0,0,2,0,0,0,1,0,2
6237,792373,26,3,6,3,6,0,0,0,0,0,0,4,2,1,1,0,6
6237,792370,37,7,14,7,14,0,0,0,0,0,3,1,0,0,1,1,14
6237,797960,18,1,3,0,0,1,3,0,0,0,3,0,4,0,1,0,3
6237,786739,30,4,7,3,4,1,3,0,0,0,3,2,2,2,2,0,9
6237,775303,31,0,2,0,1,0,1,0,0,0,4,0,0,0,0,0,0
6237,781598,12,2,5,1,3,1,2,0,0,0,1,0,2,0,1,0,5
6237,797951,27,3,6,1,3,2,3,0,1,0,4,1,2,2,4,1,8
6237,790499,9,2,4,2,3,0,1,2,2,1,3,1,1,1,0,0,6
6237,776491,9,0,1,0,1,0,0,0,0,0,1,1,0,0,0,0,0
6237,797958,1,0,0,0,0,0,0,0,0,0,0,0,0,0,0,0,0
6238,781516,11,2,3,2,3,0,0,1,2,1,0,1,2,0,3,0,5
6238,797331,27,4,7,0,1,4,6,0,0,1,2,1,0,0,0,0,12
6238,791737,29,4,8,4,7,0,1,3,4,1,8,1,3,1,3,0,11
6238,783524,25,2,8,2,3,0,5,6,6,0,0,2,0,1,0,0,10
6238,780561,22,2,7,1,2,1,5,0,0,1,1,1,1,0,2,0,5
6238,791734,19,2,4,2,4,0,0,0,1,1,4,1,0,0,0,1,4
6238,797332,10,1,1,1,1,0,0,0,0,0,1,1,1,0,0,3,2
6238,797333,20,0,1,0,0,0,1,0,0,1,2,4,1,0,3,1,0
6238,795372,6,1,1,0,0,1,1,0,0,0,0,0,0,0,1,0,3
6238,786223,9,0,1,0,1,0,0,0,0,0,1,1,0,0,0,0,0
6238,786220,22,3,7,1,3,2,4,0,0,0,0,1,0,0,1,0,8
6239,791669,29,5,8,5,8,0,0,0,0,2,3,2,4,0,3,3,10
6239,785762,34,10,16,5,9,5,7,1,2,4,7,1,0,4,1,0,26
6239,797407,21,2,4,2,4,0,0,0,0,1,0,3,2,1,1,0,4
6239,785760,28,5,8,2,2,3,6,3,4,1,1,3,3,0,1,0,16
6239,780531,36,3,8,1,3,2,5,0,0,0,4,4,1,0,0,0,8
6239,797414,6,0,0,0,0,0,0,0,0,1,1,1,1,0,0,0,0
6239,780534,10,1,5,1,5,0,0,0,0,0,2,0,1,1,1,0,2
6239,797409,16,2,4,1,2,1,2,0,0,0,3,3,1,2,1,0,5
6239,791666,20,2,6,1,4,1,2,1,2,0,0,3,0,0,0,0,6
6240,790870,18,2,3,2,3,0,0,0,0,1,2,1,5,1,3,1,4
6240,790869,39,5,12,5,8,0,4,6,6,1,6,2,3,2,4,0,16
6240,780116,25,0,3,0,2,0,1,0,0,1,3,0,2,0,3,0,0
6240,796421,38,9,12,9,12,0,0,3,4,1,1,2,2,1,1,0,21
6240,790866,27,0,5,0,1,0,4,0,0,0,2,0,1,0,0,0,0
6240,796426,14,2,3,2,3,0,0,1,3,1,1,0,0,0,0,0,5
6240,780493,18,0,3,0,1,0,2,0,0,0,0,1,1,1,1,0,0
6240,780492,5,0,0,0,0,0,0,0,0,0,1,0,1,0,0,0,0
6240,796427,15,1,5,1,4,0,1,2,3,0,0,1,1,0,0,0,4
6240,783997,1,0,0,0,0,0,0,0,0,0,0,0,0,0,0,0,0
6241,775897,33,4,4,3,3,1,1,3,3,1,2,2,2,1,1,0,12
6241,780324,29,7,14,7,14,0,0,5,6,2,3,5,1,3,3,1,19
6241,791543,29,2,6,0,3,2,3,2,3,0,2,1,0,0,1,0,8
6241,786530,35,2,4,0,1,2,3,0,1,1,3,4,2,0,0,1,6
6241,780317,29,4,5,1,1,3,4,0,0,0,3,3,2,1,2,0,11
6241,791546,11,1,1,1,1,0,0,0,0,0,2,1,3,0,1,0,2
6241,797091,3,0,0,0,0,0,0,0,0,0,0,0,1,0,1,1,0
6241,791547,3,0,1,0,0,0,1,0,0,0,0,0,0,0,0,0,0
6241,791545,11,3,3,3,3,0,0,0,0,0,2,0,3,1,0,0,6
6241,786360,1,0,0,0,0,0,0,0,0,0,0,0,0,0,1,0,0
6241,784246,15,3,5,3,4,0,1,0,0,0,1,0,2,0,2,0,6
6241,775437,1,0,0,0,0,0,0,0,0,0,0,0,1,0,0,0,0
6242,789177,36,4,8,4,8,0,0,1,4,3,10,0,1,1,1,0,9
6242,780227,26,4,9,4,9,0,0,4,8,2,4,1,3,1,2,0,12
6242,791340,38,3,6,2,5,1,1,0,0,0,2,5,3,1,2,0,7
6242,780181,38,8,19,5,12,3,7,12,13,4,9,1,2,2,2,1,31
6242,776089,34,0,4,0,1,0,3,2,2,0,2,5,4,1,2,0,2
6242,797262,2,0,1,0,0,0,1,0,0,0,0,0,2,0,0,0,0
6242,775758,13,1,2,1,2,0,0,0,0,2,0,0,1,1,1,1,2
6242,791336,11,0,3,0,2,0,1,0,0,0,4,0,0,0,2,0,0
6242,789178,2,0,0,0,0,0,0,0,0,0,0,0,1,0,0,0,0
6243,792418,26,1,7,1,7,0,0,2,2,1,7,1,3,0,0,6,4
6243,782654,27,0,7,0,6,0,1,1,2,2,4,0,4,0,1,0,1
6243,796693,30,2,7,2,7,0,0,7,8,0,2,0,1,2,2,0,11
6243,792422,26,2,6,2,4,0,2,1,1,1,1,0,3,1,2,0,5
6243,789484,37,7,13,7,12,0,1,2,2,3,7,1,3,2,0,0,16
6243,796692,1,0,0,0,0,0,0,0,0,0,0,0,0,0,0,0,0
6243,792424,18,2,5,2,5,0,0,0,0,2,0,1,2,0,2,1,4
6243,796691,28,5,13,3,8,2,5,0,0,0,1,0,2,1,1,0,12
6243,792423,1,0,0,0,0,0,0,0,0,0,0,0,0,0,0,0,0
6243,800100,6,1,2,1,2,0,0,0,0,0,0,0,0,1,1,0,2
6244,781081,26,3,7,3,7,0,0,0,0,2,5,0,5,0,1,1,6
6244,791864,25,5,10,5,10,0,0,4,7,4,4,0,3,0,1,1,14
6244,791863,17,2,3,1,2,1,1,1,2,0,3,0,4,3,0,0,6
6244,797472,34,4,11,3,7,1,4,0,0,0,2,2,2,3,4,0,9
6244,780965,37,8,14,4,6,4,8,4,5,1,1,10,2,3,1,0,24
6244,797473,19,2,3,2,3,0,0,4,4,1,2,0,4,0,0,2,8
6244,786791,10,3,4,3,4,0,0,2,2,3,2,1,4,1,2,0,8
6244,797470,30,4,12,3,7,1,5,3,5,0,3,3,3,2,0,2,12
6244,776447,1,0,1,0,0,0,1,0,0,0,0,0,0,0,0,0,0
6244,791865,1,0,0,0,0,0,0,0,0,0,0,0,0,0,0,0,0
6245,796516,31,3,4,3,4,0,0,2,3,1,6,1,0,1,2,1,8
6245,792318,23,4,9,4,9,0,0,2,4,2,3,0,3,0,3,1,10
6245,796519,26,2,3,1,1,1,2,1,2,0,4,2,1,1,6,0,6
6245,786717,22,3,6,2,4,1,2,1,2,0,1,2,4,0,1,0,8
6245,780753,30,3,8,2,5,1,3,1,2,0,1,1,2,2,5,0,8
6245,792308,5,0,0,0,0,0,0,2,4,1,0,0,2,0,0,1,2
6245,796520,18,2,6,0,1,2,5,1,5,1,1,0,2,0,1,0,7
6245,796518,5,0,2,0,1,0,1,2,2,1,2,0,0,0,1,0,2
6245,796517,14,0,2,0,2,0,0,3,4,1,0,3,3,0,0,0,3
6245,792315,5,0,1,0,1,0,0,0,0,0,0,0,1,0,1,0,0
6245,775329,19,3,7,1,4,2,3,1,2,0,2,2,1,0,2,0,9
6245,792310,2,0,0,0,0,0,0,0,0,0,0,0,0,0,0,0,0
6246,780323,22,2,7,2,7,0,0,0,0,3,5,2,3,0,0,0,4
6246,797894,16,1,3,1,3,0,0,1,2,2,0,0,2,0,0,0,3
6246,792229,32,3,10,1,7,2,3,5,6,3,5,2,1,4,3,0,13
6246,785954,33,2,8,1,5,1,3,0,0,1,2,0,1,0,3,1,5
6246,785811,28,0,7,0,2,0,5,6,6,0,1,2,1,0,2,1,6
6246,792234,13,1,1,1,1,0,0,0,0,2,6,0,1,0,0,2,2
6246,792233,29,5,10,4,8,1,2,4,4,1,2,1,2,1,1,0,15
6246,792230,15,2,2,1,1,1,1,2,4,0,3,0,0,0,0,0,7
6246,786016,12,1,3,1,3,0,0,0,0,0,1,0,0,0,1,0,2
6247,790877,33,3,11,3,9,0,2,0,0,1,1,0,4,1,0,0,6
6247,785432,12,0,2,0,2,0,0,0,0,1,2,0,2,1,1,0,0
6247,790876,35,4,15,4,9,0,6,4,5,0,2,1,1,2,1,0,12
6247,785699,38,3,8,2,4,1,4,0,1,1,6,1,4,0,3,0,7
6247,781062,34,4,8,1,2,3,6,3,3,2,5,1,1,4,2,0,14
6247,790879,20,0,0,0,0,0,0,2,2,2,0,0,2,0,1,0,2
6247,779985,28,4,10,2,6,2,4,1,2,2,5,0,2,0,1,2,11
6256,797050,18,5,6,4,4,1,2,3,4,0,2,0,5,2,2,0,14
6256,780394,37,4,8,2,5,2,3,0,0,1,6,2,0,1,0,0,10
6256,780391,28,2,2,2,2,0,0,1,3,0,5,1,5,0,2,2,5
6256,790871,35,6,7,5,6,1,1,5,7,1,8,3,4,0,2,0,18
6256,776473,36,5,10,5,7,0,3,8,11,1,3,3,3,0,8,0,18
6256,780392,4,0,1,0,0,0,1,0,0,0,1,0,0,0,1,0,0
6256,791573,19,1,4,1,2,0,2,1,3,0,2,2,0,1,1,0,3
6256,797049,10,1,1,1,1,0,0,0,1,0,0,0,3,1,1,0,2
6256,791570,13,0,0,0,0,0,0,0,0,0,1,1,1,0,2,0,0
6257,785498,18,2,4,2,3,0,1,0,0,1,0,1,3,1,1,0,4
6257,776469,29,4,8,4,8,0,0,5,10,4,2,0,4,4,1,0,13
6257,781169,39,5,13,3,10,2,3,3,6,3,9,8,2,0,1,0,15
6257,780701,27,1,3,1,3,0,0,1,4,0,0,3,5,0,1,0,3
6257,776322,32,4,12,0,2,4,10,0,0,1,0,0,0,1,1,1,12
6257,796708,15,1,6,1,2,0,4,2,3,0,1,1,2,2,2,0,4
6257,796706,7,0,0,0,0,0,0,0,0,0,0,0,2,0,0,0,0
6257,796705,21,5,8,1,3,4,5,2,2,0,1,1,3,1,2,0,16
6257,780704,4,0,0,0,0,0,0,0,0,0,0,0,0,0,0,0,0
6257,791036,8,0,0,0,0,0,0,0,0,1,1,0,1,0,0,0,0
6258,796761,24,0,0,0,0,0,0,0,0,0,6,0,2,0,1,0,0
6258,796758,30,4,12,4,12,0,0,2,2,0,3,1,3,2,2,0,10
6258,791101,34,8,16,5,8,3,8,7,8,1,5,3,2,4,2,0,26
6258,791105,35,0,4,0,2,0,2,0,0,0,0,4,0,2,4,0,0
6258,780794,21,3,5,0,1,3,4,0,0,0,0,0,1,1,4,0,9
6258,791103,3,0,0,0,0,0,0,0,0,0,1,0,0,0,0,0,0
6258,780109,23,3,10,3,6,0,4,1,2,2,2,0,1,1,1,0,7
6258,796757,25,5,12,2,4,3,8,4,4,1,3,0,1,1,2,0,17
6258,785597,5,0,1,0,1,0,0,0,0,0,0,1,1,1,0,0,0
6259,792197,27,5,13,3,4,2,9,0,0,1,3,2,2,0,3,1,12
6259,781132,37,5,6,2,2,3,4,0,0,0,3,4,3,2,5,2,13
6259,797517,30,7,7,7,7,0,0,0,0,4,6,0,1,0,1,0,14
6259,791940,24,4,5,4,4,0,1,4,4,1,2,0,2,1,1,0,12
6259,786534,38,8,16,7,11,1,5,0,1,1,10,6,2,1,6,0,17
6259,797522,7,0,1,0,1,0,0,0,0,0,1,0,3,0,0,0,0
6259,786539,3,0,0,0,0,0,0,0,0,0,0,1,1,0,0,0,0
6259,797518,21,3,6,3,4,0,2,5,6,0,3,2,1,3,1,0,11
6259,791938,13,2,6,2,2,0,4,0,0,0,2,0,1,0,0,0,4
6260,775087,26,4,7,3,6,1,1,2,2,2,2,2,4,1,5,0,11
6260,790984,33,0,8,0,2,0,6,0,0,1,5,3,2,0,1,0,0
6260,785297,24,2,7,1,3,1,4,0,0,2,6,0,2,1,0,0,5
6260,785296,30,4,10,3,7,1,3,2,2,3,5,4,2,0,5,1,11
6260,780212,38,7,17,3,7,4,10,4,4,0,1,1,2,2,0,0,22
6260,780406,18,1,7,1,1,0,6,1,2,1,4,1,4,1,5,1,3
6260,790985,6,1,1,1,1,0,0,0,0,1,2,0,2,0,2,0,2
6260,780215,8,0,2,0,2,0,0,0,0,1,0,0,0,0,0,0,0
6260,796596,17,2,5,2,3,0,2,0,0,1,1,1,2,0,0,0,4
6261,785495,38,5,16,5,12,0,4,5,7,2,6,4,1,2,0,0,15
6261,785958,33,6,11,5,9,1,2,9,12,4,12,1,3,5,1,1,22
6261,785659,33,4,4,4,4,0,0,3,4,1,5,0,1,3,2,0,11
6261,785494,38,7,13,2,4,5,9,1,2,0,1,4,2,1,2,0,20
6261,780698,31,2,10,1,5,1,5,2,4,1,4,2,3,1,2,1,7
6261,785490,4,0,0,0,0,0,0,0,0,0,0,1,1,1,0,0,0
6261,791034,7,0,1,0,0,0,1,0,0,0,0,0,4,0,1,0,0
6261,791130,5,0,1,0,0,0,1,0,0,0,0,1,0,0,2,0,0
6261,780427,11,1,3,0,1,1,2,0,0,2,2,0,1,0,2,0,3
6262,791585,35,3,6,2,2,1,4,0,0,0,1,2,2,4,0,1,7
6262,780062,14,0,0,0,0,0,0,2,4,0,0,0,4,1,2,0,2
6262,786395,36,4,8,1,2,3,6,5,6,1,2,5,0,1,4,0,16
6262,786394,38,7,16,4,8,3,8,1,1,2,9,1,3,1,1,1,18
6262,780404,33,4,8,3,6,1,2,2,4,0,1,4,4,3,2,0,11
6262,785228,17,1,2,0,1,1,1,0,0,0,2,0,1,0,0,0,3
6262,791581,23,2,5,2,2,0,3,0,0,0,2,1,1,0,1,0,4
6262,780403,2,0,1,0,0,0,1,0,0,0,0,0,0,0,0,0,0
6262,791582,2,0,0,0,0,0,0,0,0,0,0,0,0,0,0,0,0
6263,790839,24,1,4,1,2,0,2,1,2,2,4,2,1,0,0,0,3
6263,785388,33,9,12,9,12,0,0,5,6,3,8,1,2,0,3,0,23
6263,790840,23,1,7,0,3,1,4,0,0,1,0,0,2,0,3,0,3
6263,796395,30,5,13,5,10,0,3,4,5,0,4,3,4,0,2,1,14
6263,785386,35,1,4,1,2,0,2,2,2,0,0,2,2,1,3,0,4
6263,780370,16,0,4,0,1,0,3,0,0,2,4,0,0,1,1,0,0
6263,796393,7,2,3,2,3,0,0,0,0,1,1,0,1,0,1,0,4
6263,796396,9,1,1,0,0,1,1,0,0,0,0,1,0,1,1,0,3
6263,790841,23,2,2,0,0,2,2,0,0,1,1,0,3,0,0,0,6
6264,786185,11,1,4,1,4,0,0,1,2,1,1,0,2,0,1,0,3
6264,797273,38,3,5,3,4,0,1,0,1,0,6,6,2,1,6,1,6
6264,786558,31,7,15,7,12,0,3,1,3,1,5,7,2,3,4,0,15
6264,797272,23,5,10,0,2,5,8,0,0,0,0,1,2,1,2,0,15
6264,766611,30,4,12,1,5,3,7,0,0,1,4,1,5,0,1,0,11
6264,774846,29,5,10,5,10,0,0,5,5,4,1,0,3,0,1,0,15
6264,791376,22,2,4,1,2,1,2,0,0,1,3,2,2,1,1,0,5
6264,797182,11,1,2,1,2,0,0,0,1,0,2,1,2,1,0,0,2
6264,797181,5,0,1,0,1,0,0,0,0,0,0,0,1,0,0,0,0
6265,791980,16,1,5,0,3,1,2,0,0,1,1,0,1,2,0,0,3
6265,785967,21,5,11,5,11,0,0,3,4,4,8,0,3,0,4,0,13
6265,791976,27,5,7,4,5,1,2,7,8,2,1,2,0,1,2,0,18
6265,791978,34,4,11,4,9,0,2,1,3,2,6,3,1,3,2,0,9
6265,785973,22,2,6,1,3,1,3,1,1,0,3,5,2,1,1,0,6
6265,780160,13,0,0,0,0,0,0,0,0,3,1,2,2,2,1,1,0
6265,785972,26,4,9,3,6,1,3,4,4,2,5,0,1,1,0,0,13
6265,797801,6,0,0,0,0,0,0,0,0,1,1,0,2,0,1,1,0
6265,791977,24,5,10,2,3,3,7,0,1,0,3,1,1,0,3,0,13
6265,797800,11,0,1,0,1,0,0,1,3,0,0,0,1,2,1,0,1
6266,775074,33,5,9,5,9,0,0,4,5,1,5,1,4,2,1,0,14
6266,780462,37,7,17,6,11,1,6,0,1,1,6,0,0,2,1,0,15
6266,786448,31,3,7,2,5,1,2,0,0,0,6,4,4,2,2,0,7
6266,786132,25,1,2,1,2,0,0,2,4,3,1,1,4,2,5,0,4
6266,780731,26,2,7,2,7,0,0,3,4,0,1,0,1,0,1,1,7
6266,776365,13,1,2,1,2,0,0,0,0,1,0,0,3,0,1,1,2
6266,796971,26,1,7,0,3,1,4,0,0,0,2,1,1,0,5,0,3
6266,791632,5,0,0,0,0,0,0,0,0,0,1,0,0,0,0,0,0
6266,775121,1,0,0,0,0,0,0,0,0,0,0,0,1,0,1,0,0
6266,791631,3,0,0,0,0,0,0,0,0,0,0,0,0,0,0,0,0
6267,775954,29,3,5,3,5,0,0,2,2,0,4,1,3,1,3,1,8
6267,796459,31,1,7,1,7,0,0,0,2,2,1,4,1,2,3,1,2
6267,796194,28,1,4,0,0,1,4,0,0,0,2,3,4,1,2,0,3
6267,781006,28,5,9,3,6,2,3,1,2,0,4,0,4,1,1,0,13
6267,796464,27,2,6,1,5,1,1,6,8,1,3,4,1,0,1,0,11
6267,790917,24,3,9,0,2,3,7,1,2,0,6,1,2,1,3,1,10
6267,781157,23,1,4,0,0,1,4,0,0,0,2,1,2,0,2,0,3
6267,790918,8,0,1,0,1,0,0,0,0,0,1,0,0,0,0,1,0
6267,780648,2,0,0,0,0,0,0,0,0,0,0,0,0,0,0,0,0
6268,796469,19,2,5,1,4,1,1,0,3,0,1,1,3,0,2,0,5
6268,779981,33,4,4,4,4,0,0,2,8,3,6,1,0,1,2,2,10
6268,785463,38,5,11,3,7,2,4,0,0,1,1,6,0,1,3,1,12
6268,779978,31,5,10,2,3,3,7,0,0,0,4,2,1,2,5,0,13
6268,776003,35,10,16,6,7,4,9,1,3,2,3,3,1,1,2,0,25
6268,790923,23,2,4,2,3,0,1,0,0,1,2,0,0,1,1,2,4
6268,785466,14,0,1,0,1,0,0,0,0,0,1,0,2,0,0,0,0
6268,779980,7,0,0,0,0,0,0,0,0,1,0,0,2,0,0,0,0
6269,785298,10,1,3,1,3,0,0,0,0,0,2,0,2,0,1,1,2
6269,775224,24,3,7,3,7,0,0,0,0,3,3,1,3,0,1,0,6
6269,778046,29,8,15,5,7,3,8,2,2,0,1,3,3,4,2,0,21
6269,782121,37,11,16,6,9,5,7,0,0,0,1,4,3,1,1,0,27
6269,775793,30,4,7,4,6,0,1,2,2,1,2,2,2,0,3,0,10
6269,785302,16,3,3,2,2,1,1,0,0,0,3,0,2,3,3,0,7
6269,786594,28,3,5,1,1,2,4,0,0,0,1,3,1,1,1,0,8
6269,785485,26,1,2,1,2,0,0,0,0,0,6,0,2,1,0,0,2
6270,780027,35,9,18,8,16,1,2,8,14,2,10,2,3,0,1,2,27
6270,786176,24,2,7,1,3,1,4,0,0,0,1,0,1,1,0,1,5
6270,786173,12,1,2,1,2,0,0,0,0,0,1,1,2,0,0,0,2
6270,780028,19,1,7,1,3,0,4,0,1,1,1,3,1,0,2,0,2
6270,774828,20,2,4,1,1,1,3,4,4,0,3,2,1,0,0,0,9
6270,797175,15,2,4,2,3,0,1,3,3,4,0,0,1,0,0,1,7
6270,791380,21,3,5,3,4,0,1,4,6,0,1,6,3,1,1,0,10
6270,780029,23,4,5,2,3,2,2,2,3,4,4,1,2,1,0,0,12
6270,791379,15,2,2,2,2,0,0,0,1,1,3,0,0,0,0,1,4
6270,797178,13,2,2,2,2,0,0,0,1,0,1,0,3,0,0,0,4
6270,797179,3,0,0,0,0,0,0,2,2,1,0,1,0,0,0,0,2
6271,785375,11,0,2,0,2,0,0,0,0,0,4,0,5,0,0,1,0
6271,785372,38,10,16,6,11,4,5,0,0,5,4,5,4,1,3,1,24
6271,786384,24,3,7,1,3,2,4,2,3,4,5,3,4,1,2,1,10
6271,785371,18,1,8,0,1,1,7,2,2,1,1,3,3,0,0,0,5
6271,774905,32,5,16,2,10,3,6,2,4,1,1,1,2,0,0,0,15
6271,785374,14,3,3,3,3,0,0,1,2,2,0,1,4,0,1,1,7
6271,790827,13,0,3,0,2,0,1,0,0,3,1,1,2,0,1,0,0
6271,790828,15,3,5,3,5,0,0,2,2,2,1,0,1,1,0,0,8
6271,790825,22,3,9,1,3,2,6,0,0,0,0,1,2,0,0,0,8
6271,796385,10,0,1,0,1,0,0,1,2,0,1,1,0,0,1,0,1
6271,796387,3,0,0,0,0,0,0,0,0,1,0,0,1,0,0,0,0
6272,792265,18,6,9,6,8,0,1,5,8,3,1,1,2,0,1,2,17
6272,786152,25,7,14,7,14,0,0,3,5,7,8,1,0,1,1,1,17
6272,798003,20,2,5,1,2,1,3,1,2,0,4,4,3,1,1,0,6
6272,797997,12,0,3,0,1,0,2,0,0,0,0,2,1,0,0,0,0
6272,798006,21,2,5,1,2,1,3,2,2,0,1,3,3,3,1,0,7
6272,798007,23,3,4,2,2,1,2,0,2,1,4,2,1,2,1,0,7
6272,798005,13,3,3,3,3,0,0,0,0,1,4,0,2,1,2,2,6
6272,792266,17,2,4,2,3,0,1,5,6,0,3,1,2,2,3,0,9
6272,798004,3,1,2,0,0,1,2,0,0,0,0,0,0,0,0,0,3
6272,797999,3,0,3,0,2,0,1,0,0,0,1,1,0,1,1,0,0
6272,792267,29,5,10,3,6,2,4,3,4,0,0,2,2,0,1,0,15
6272,792263,16,1,3,1,3,0,0,1,2,0,4,1,0,1,3,1,3
6274,790810,23,3,13,1,7,2,6,2,3,3,3,3,2,0,2,0,10
6274,785362,24,9,14,9,14,0,0,0,0,3,7,0,3,2,0,0,18
6274,790808,31,6,11,2,2,4,9,2,2,1,3,2,1,1,0,0,18
6274,785361,32,6,10,4,5,2,5,1,1,0,2,2,1,0,0,0,15
6274,779997,24,1,5,1,1,0,4,0,0,0,6,5,2,1,3,0,2
6274,774854,17,1,5,1,4,0,1,2,2,3,2,0,2,1,1,1,4
6274,790809,21,0,2,0,2,0,0,0,0,0,2,5,2,0,0,0,0
6274,790811,20,2,5,2,3,0,2,0,0,3,1,0,1,1,0,1,4
6274,779999,1,1,1,0,0,1,1,0,0,0,0,0,0,0,0,0,3
6274,796369,2,0,1,0,0,0,1,0,0,0,1,0,0,0,0,0,0
6274,796368,5,0,0,0,0,0,0,0,0,0,1,0,0,0,0,0,0
6275,796372,23,3,5,3,5,0,0,2,2,1,2,0,1,0,2,1,8
6275,790814,23,2,6,2,4,0,2,3,4,4,4,0,2,0,1,0,7
6275,796377,31,3,8,2,3,1,5,2,3,2,4,0,3,0,1,0,9
6275,796379,35,4,10,2,5,2,5,0,0,0,5,3,1,1,4,0,10
6275,780176,34,3,10,2,4,1,6,3,5,0,4,2,3,0,3,0,10
6275,786013,13,0,5,0,5,0,0,0,0,1,2,1,2,0,0,0,0
6275,796378,14,2,4,2,3,0,1,0,0,0,3,2,0,0,0,0,4
6275,796374,17,0,1,0,1,0,0,0,0,0,0,1,1,0,0,0,0
6275,796375,4,0,1,0,1,0,0,0,0,0,0,0,0,0,0,0,0
6275,796376,4,0,1,0,0,0,1,0,0,0,0,0,0,0,0,0,0
6275,790817,2,1,2,0,1,1,1,0,0,0,1,0,0,0,0,0,3
6276,792143,19,3,4,2,2,1,2,0,1,0,2,1,5,0,1,0,7
6276,786302,31,1,3,1,3,0,0,1,2,1,6,1,1,0,1,0,3
6276,786293,32,10,16,8,12,2,4,0,1,0,0,1,2,0,2,0,22
6276,780953,24,4,9,3,7,1,2,0,0,1,3,1,4,0,2,1,9
6276,797750,38,7,12,5,7,2,5,4,4,2,4,4,1,1,4,0,20
6276,797751,26,1,6,0,3,1,3,0,0,0,2,1,1,2,1,0,3
6276,797742,6,0,1,0,1,0,0,0,0,0,2,2,3,0,0,0,0
6276,792147,21,1,1,1,1,0,0,0,0,1,2,1,1,0,2,0,2
6276,786301,3,0,0,0,0,0,0,0,0,0,0,0,0,0,0,0,0
6277,796444,38,8,13,8,12,0,1,7,7,4,7,1,1,1,3,2,23
6277,790893,33,3,5,3,5,0,0,1,4,0,4,1,2,0,1,4,7
6277,786615,30,4,8,2,5,2,3,5,6,0,1,3,3,0,0,0,15
6277,786732,13,1,3,1,1,0,2,1,2,1,0,0,2,0,2,0,3
6277,775260,35,7,13,7,9,0,4,0,0,0,1,2,1,1,1,0,14
6277,790889,21,2,6,1,4,1,2,0,1,1,4,0,1,1,1,0,5
6277,775536,9,1,2,1,2,0,0,0,0,1,1,1,1,0,1,0,2
6277,790890,14,0,3,0,2,0,1,0,0,0,0,1,1,0,0,0,0
6277,780702,7,1,4,0,0,1,4,0,0,1,0,0,0,0,1,0,3
6278,796912,26,3,6,1,1,2,5,0,0,0,3,1,4,0,0,1,8
6278,775626,29,6,10,5,7,1,3,7,10,1,4,0,2,0,4,1,20
6278,774964,31,6,11,6,9,0,2,1,3,2,12,1,2,0,1,0,13
6278,796908,26,0,2,0,1,0,1,2,4,0,3,0,2,1,1,0,2
6278,774962,30,2,11,1,5,1,6,2,2,1,3,6,0,2,3,0,7
6278,796910,17,3,4,3,4,0,0,1,2,2,2,1,0,0,0,0,7
6278,785606,3,0,0,0,0,0,0,0,0,0,0,0,0,0,0,0,0
6278,796907,21,3,6,3,4,0,2,1,1,2,2,2,2,1,1,0,7
6278,796906,17,2,3,1,1,1,2,0,0,0,0,1,0,1,1,0,5
6279,799906,33,4,8,1,2,3,6,0,0,2,9,2,5,0,1,3,11
6279,775833,9,1,1,1,1,0,0,1,2,0,0,0,4,0,2,0,3
6279,785439,15,0,0,0,0,0,0,0,0,0,0,0,3,0,4,0,0
6279,781036,40,10,18,7,7,3,11,5,7,0,4,6,2,3,3,0,28
6279,774894,39,4,17,4,7,0,10,0,0,0,4,2,1,0,1,0,8
6279,796846,25,4,6,2,2,2,4,0,0,0,3,1,4,1,0,0,10
6279,796847,30,1,7,1,5,0,2,0,0,0,2,2,1,1,1,0,2
6279,796845,9,1,2,1,1,0,1,0,0,1,1,0,0,0,0,0,2
6279,789925,0,0,1,0,0,0,1,0,0,0,0,0,0,0,0,0,0
6280,797523,24,1,4,1,1,0,3,0,0,0,4,2,3,1,0,0,2
6280,785402,24,5,7,5,7,0,0,5,7,3,3,0,1,0,0,1,15
6280,797524,20,1,3,1,2,0,1,0,0,0,1,1,3,0,2,0,2
6280,792118,39,6,15,4,9,2,6,4,4,0,1,4,2,1,1,0,18
6280,782593,29,2,9,1,4,1,5,2,2,1,2,4,2,0,1,0,7
6280,785828,16,1,2,1,2,0,0,2,2,1,4,0,2,1,0,4,4
6280,791700,19,0,2,0,0,0,2,0,0,1,2,2,0,0,1,0,0
6280,791699,21,5,9,3,4,2,5,7,7,1,7,0,1,0,2,0,19
6280,791702,4,1,2,1,2,0,0,0,0,0,1,0,1,0,0,0,2
6280,797526,4,1,1,0,0,1,1,0,0,0,0,1,0,0,0,0,3
6281,786164,37,4,11,1,3,3,8,5,5,1,6,1,4,1,1,0,16
6281,781560,35,3,7,3,7,0,0,2,4,3,6,3,3,2,1,1,8
6281,796477,24,5,11,4,6,1,5,0,0,0,1,3,3,0,5,1,11
6281,791375,38,4,9,0,1,4,8,2,2,0,2,3,2,0,1,1,14
6281,780837,26,3,9,2,4,1,5,0,0,0,3,1,1,1,4,0,7
6281,796476,7,1,1,1,1,0,0,0,0,0,2,0,2,0,0,0,2
6281,796479,28,1,2,1,1,0,1,0,0,0,4,4,4,0,0,0,2
6281,796473,5,1,1,1,1,0,0,0,0,0,0,0,2,0,1,0,2
6288,785843,24,1,2,0,0,1,2,1,2,4,0,4,3,0,0,0,4
6288,780578,29,4,6,4,5,0,1,0,0,1,2,0,4,1,0,0,8
6288,797537,13,2,3,1,2,1,1,2,3,0,0,0,2,1,1,0,7
6288,797538,35,6,15,4,8,2,7,2,2,0,3,1,1,0,0,0,16
6288,780579,37,7,20,5,13,2,7,5,8,1,5,0,0,2,0,0,21
6288,797536,12,2,7,2,3,0,4,0,0,1,1,2,4,2,3,0,4
6288,785845,15,2,2,2,2,0,0,2,4,2,3,2,5,0,0,1,6
6288,785293,17,0,4,0,2,0,2,0,0,2,0,0,1,1,0,0,0
6288,785847,18,2,7,2,4,0,3,1,1,2,4,1,0,0,0,0,5
6289,781158,32,6,8,6,8,0,0,1,3,0,7,1,1,0,1,0,13
6289,781652,22,4,5,4,4,0,1,2,2,3,6,2,5,0,4,0,10
6289,786034,30,3,5,2,3,1,2,0,0,0,2,0,0,0,1,0,7
6289,786419,29,3,6,3,5,0,1,6,6,1,6,1,3,0,0,0,12
6289,781283,34,5,12,4,7,1,5,6,7,0,0,0,3,1,4,0,17
6289,791614,1,0,0,0,0,0,0,0,0,0,0,0,0,0,0,0,0
6289,785419,7,0,0,0,0,0,0,0,0,0,2,1,1,0,1,0,0
6289,791615,21,2,8,2,7,0,1,2,2,0,5,0,5,0,2,0,6
6289,785277,24,2,2,1,1,1,1,5,5,0,2,0,2,0,0,0,10
6290,785423,30,2,6,2,5,0,1,2,2,1,9,1,1,0,0,2,6
6290,775676,24,7,9,7,8,0,1,4,5,2,7,2,1,1,1,4,18
6290,786210,28,3,7,0,2,3,5,0,0,0,1,1,0,0,1,0,9
6290,785425,28,4,11,3,8,1,3,1,1,1,3,1,0,0,1,1,10
6290,785422,32,4,11,2,5,2,6,0,0,1,4,10,3,0,2,0,10
6290,774957,23,4,5,3,3,1,2,0,0,1,7,0,0,0,2,0,9
6290,786298,26,5,9,2,4,3,5,0,0,1,2,3,3,3,0,2,13
6290,796431,3,1,2,1,2,0,0,0,0,0,0,0,2,0,0,0,2
6290,796429,3,0,0,0,0,0,0,0,0,0,1,0,0,0,0,0,0
6290,793801,3,1,1,1,1,0,0,0,0,1,0,0,0,1,1,0,2
6291,790899,20,6,12,6,12,0,0,1,2,3,3,0,2,0,1,1,13
6291,790897,23,2,11,0,5,2,6,2,3,1,2,1,0,0,1,0,8
6291,785442,25,5,11,3,8,2,3,2,3,3,2,0,1,0,0,0,14
6291,785579,38,3,11,1,7,2,4,0,0,0,3,4,1,2,0,0,8
6291,775737,16,0,5,0,0,0,5,0,0,0,3,2,1,0,0,0,0
6291,785448,10,1,1,1,1,0,0,0,0,0,2,0,0,0,0,0,2
6291,775959,12,1,3,1,2,0,1,0,0,1,1,1,1,0,0,0,2
6291,796447,15,1,1,1,1,0,0,0,0,0,0,0,2,1,0,1,2
6291,799907,24,2,6,0,3,2,3,0,0,0,4,3,1,1,1,0,6
6291,790898,16,1,3,0,2,1,1,0,0,0,1,1,0,0,2,1,3
6291,796446,1,0,0,0,0,0,0,0,0,1,0,0,1,0,1,0,0
6292,781558,30,4,7,3,5,1,2,2,3,0,3,1,2,0,2,1,11
6292,780993,13,0,4,0,2,0,2,1,2,1,2,0,1,0,0,0,1
6292,775248,34,8,15,3,7,5,8,9,12,0,5,1,2,0,2,1,30
6292,791452,34,3,8,0,3,3,5,1,2,0,4,5,3,2,2,0,10
6292,791449,23,1,6,1,4,0,2,1,2,1,1,0,5,1,1,0,3
6292,797230,15,5,6,5,6,0,0,0,0,3,4,0,1,0,0,1,10
6292,797231,24,2,6,0,0,2,6,0,0,2,3,2,3,0,3,0,6
6292,797225,27,1,2,1,2,0,0,4,5,1,7,6,1,0,1,0,6
6293,786434,6,0,1,0,1,0,0,0,0,0,1,0,0,0,0,0,0
6293,780440,28,4,12,3,6,1,6,0,0,1,6,0,3,1,3,0,9
6293,791621,26,5,10,2,5,3,5,4,4,3,3,4,4,1,1,0,17
6293,786432,31,4,10,3,4,1,6,0,0,0,3,1,4,1,0,0,9
6293,786431,37,5,12,4,10,1,2,2,4,3,3,3,4,2,2,1,13
6293,791619,5,0,4,0,3,0,1,0,0,1,0,0,0,0,0,0,0
6293,791620,13,1,3,0,0,1,3,0,0,1,2,0,2,0,0,0,3
6293,781125,15,0,4,0,4,0,0,0,0,0,2,0,2,0,0,0,0
6293,775620,16,5,5,5,5,0,0,1,1,1,1,0,3,0,1,0,11
6293,781088,19,2,4,2,2,0,2,2,3,0,1,2,1,0,0,0,6
6293,775622,4,0,1,0,1,0,0,0,0,0,1,0,1,0,1,0,0
6294,791723,19,0,0,0,0,0,0,4,6,4,1,1,2,0,1,1,4
6294,780956,29,5,10,3,6,2,4,0,0,1,3,2,1,0,3,0,12
6294,797310,10,0,2,0,1,0,1,1,2,0,0,0,0,1,1,0,1
6294,791724,34,5,8,5,7,0,1,3,3,0,5,2,4,2,0,0,13
6294,781617,38,4,12,4,7,0,5,1,2,1,5,2,2,0,0,0,9
6294,797312,12,1,2,1,1,0,1,1,2,0,1,0,1,0,1,0,3
6294,800056,3,0,0,0,0,0,0,0,0,1,0,0,0,0,0,0,0
6294,785580,33,4,13,3,8,1,5,1,1,2,5,4,2,0,2,0,10
6294,797308,5,1,2,0,0,1,2,0,0,1,1,0,0,0,0,0,3
6294,780706,17,2,8,0,1,2,7,0,0,0,1,5,4,1,1,0,6
6295,791811,18,2,3,2,3,0,0,0,0,1,2,0,4,1,3,0,4
6295,796927,33,1,3,0,1,1,2,3,6,0,6,0,4,0,1,1,6
6295,796929,38,2,5,1,1,1,4,4,4,0,2,5,1,1,0,0,9
6295,791224,40,7,16,5,12,2,4,2,2,1,9,8,1,3,6,0,18
6295,785571,2,1,2,1,2,0,0,0,0,0,1,0,0,0,0,0,2
6295,791225,27,6,8,6,8,0,0,3,8,2,3,0,4,0,1,0,15
6295,796928,11,0,1,0,1,0,0,0,0,0,0,0,0,0,0,0,0
6295,785564,31,5,9,0,0,5,9,1,2,1,3,1,1,0,0,1,16
6296,797972,34,8,11,5,8,3,3,6,6,3,2,3,2,0,0,2,25
6296,797967,33,4,10,2,7,2,3,0,0,2,3,0,1,0,2,0,10
6296,797970,27,0,7,0,3,0,4,0,0,3,5,3,3,1,0,1,0
6296,781453,34,7,15,7,8,0,7,5,6,0,11,8,4,0,8,0,19
6296,774869,36,6,8,1,2,5,6,0,0,1,4,0,4,2,1,0,17
6296,792254,10,2,2,1,1,1,1,1,2,1,1,0,1,0,0,0,6
6296,792256,1,0,1,0,1,0,0,0,0,0,1,0,1,0,0,0,0
6296,786098,24,4,8,2,3,2,5,4,4,1,1,2,3,0,0,0,14
6296,797962,1,0,0,0,0,0,0,0,0,0,0,0,0,0,0,0,0
6296,786106,0,0,0,0,0,0,0,0,0,0,0,0,0,0,0,0,0
6297,790935,24,3,7,1,3,2,4,0,0,1,2,1,3,0,1,0,8
6297,792442,18,2,3,2,3,0,0,0,2,6,5,0,3,0,2,2,4
6297,780933,34,5,11,1,1,4,10,0,0,0,1,0,1,0,0,0,14
6297,775340,35,11,24,9,17,2,7,8,10,1,2,4,3,3,1,0,32
6297,774826,19,1,5,1,4,0,1,2,3,0,2,1,3,0,0,0,4
6297,796491,2,0,0,0,0,0,0,0,0,0,0,0,1,0,0,0,0
6297,796190,13,0,1,0,0,0,1,0,0,0,1,1,0,1,0,0,0
6297,790937,17,4,5,4,5,0,0,1,2,2,6,2,4,0,4,0,9
6297,785445,16,1,3,1,2,0,1,0,0,0,1,1,4,0,0,1,2
6297,790938,17,0,2,0,1,0,1,2,4,0,0,1,0,0,1,0,2
6297,796492,5,0,2,0,2,0,0,1,2,0,0,0,1,0,0,0,1
6297,796493,0,0,0,0,0,0,0,0,0,0,0,0,0,0,0,0,0
6298,791352,35,8,11,5,5,3,6,3,4,2,4,1,3,0,1,1,22
6298,780455,23,5,9,5,9,0,0,2,2,2,4,0,1,0,1,0,12
6298,797251,29,2,4,1,2,1,2,0,0,1,6,2,5,1,3,0,5
6298,797247,41,8,16,5,10,3,6,0,1,2,5,1,0,1,6,1,19
6298,776297,35,4,13,2,10,2,3,2,2,1,3,3,1,1,1,0,12
6298,791355,4,0,0,0,0,0,0,0,0,0,0,0,0,0,1,0,0
6298,791354,10,2,4,2,4,0,0,1,2,1,0,0,0,0,1,0,5
6298,785837,20,1,6,1,5,0,1,0,0,1,0,1,3,0,0,0,2
6298,797255,2,0,0,0,0,0,0,0,2,0,1,0,0,0,0,0,0
6298,797249,6,1,2,1,2,0,0,0,0,0,0,0,1,0,0,0,2
6298,797248,17,1,5,1,2,0,3,1,1,0,2,0,0,0,0,0,3
6298,797250,3,0,0,0,0,0,0,0,0,0,0,0,0,0,0,0,0
6298,786227,0,0,0,0,0,0,0,0,0,0,0,0,0,0,0,0,0
6299,791230,38,4,8,0,0,4,8,3,4,3,4,2,2,2,1,0,15
6299,785557,26,3,14,3,11,0,3,0,0,0,5,1,5,0,2,1,6
6299,791227,38,2,3,0,0,2,3,0,0,1,1,3,1,0,0,0,6
6299,796932,40,7,20,3,10,4,10,4,6,1,6,8,2,2,1,0,22
6299,785624,36,8,17,4,8,4,9,0,0,2,1,3,1,3,2,0,20
6299,796933,17,3,6,3,3,0,3,0,0,1,0,0,0,0,0,0,6
6299,791226,19,5,6,5,6,0,0,1,2,3,3,0,4,0,0,0,11
6299,781198,5,0,1,0,0,0,1,0,0,0,1,0,1,1,0,1,0
6299,781201,6,0,0,0,0,0,0,0,0,0,0,0,0,0,0,0,0
6300,796699,25,2,7,2,4,0,3,0,0,2,2,1,1,0,1,0,4
6300,790979,29,4,8,4,5,0,3,4,6,0,4,2,4,0,3,0,12
6300,796697,35,5,10,4,8,1,2,8,10,0,1,9,5,2,4,0,19
6300,788820,24,4,11,2,3,2,8,3,4,1,5,1,0,2,1,0,13
6300,796701,12,0,0,0,0,0,0,0,0,0,3,2,2,0,0,2,0
6300,790978,19,3,7,1,3,2,4,4,5,0,2,1,3,3,0,1,12
6300,796698,14,2,3,1,1,1,2,0,0,1,2,2,3,1,2,0,5
6300,790976,8,0,0,0,0,0,0,0,0,1,1,0,2,1,2,0,0
6300,790980,3,0,0,0,0,0,0,0,0,0,0,0,0,0,0,1,0
6300,790983,31,9,14,7,9,2,5,1,1,2,3,0,0,0,1,3,21
6301,791302,28,5,9,4,7,1,2,4,4,3,9,2,4,2,1,1,15
6301,781622,30,5,8,3,4,2,4,1,2,2,0,0,3,0,0,0,13
6301,791309,32,5,13,4,11,1,2,2,2,0,1,7,1,3,4,0,13
6301,785835,22,7,10,6,8,1,2,1,2,2,4,0,3,1,2,0,16
6301,776334,26,3,7,2,5,1,2,4,4,0,3,0,5,0,1,0,11
6301,796602,6,0,1,0,0,0,1,0,0,0,1,0,0,0,2,0,0
6301,775862,19,4,9,4,8,0,1,1,2,4,0,1,1,1,1,0,9
6301,796601,23,3,9,2,7,1,2,5,8,0,4,0,2,0,1,0,12
6301,796604,8,0,0,0,0,0,0,0,0,1,2,4,1,0,0,0,0
6301,791304,6,1,1,1,1,0,0,0,0,0,1,0,1,0,1,0,2
6302,785224,26,5,11,3,6,2,5,4,4,0,4,1,4,2,0,1,16
6302,780879,36,4,10,3,7,1,3,1,1,4,2,6,3,0,1,0,10
6302,790767,25,1,4,1,2,0,2,0,0,0,2,1,3,1,1,0,2
6302,785743,26,2,7,0,3,2,4,0,0,0,3,0,1,1,1,0,6
6302,780875,35,6,13,5,10,1,3,1,3,0,9,2,0,1,0,1,14
6302,775785,4,1,2,1,2,0,0,0,0,0,1,0,0,0,0,0,2
6302,796324,10,0,1,0,0,0,1,3,4,0,0,0,1,1,0,0,3
6302,790768,17,3,6,2,3,1,3,0,0,0,0,1,1,0,3,0,7
6302,790769,17,1,3,0,1,1,2,0,0,0,1,1,2,0,0,0,3
6302,796326,4,0,0,0,0,0,0,0,0,0,0,0,2,0,1,0,0
6303,790856,19,0,1,0,1,0,0,1,2,0,3,0,4,1,2,0,1
6303,780452,34,4,10,4,9,0,1,0,1,1,8,1,3,1,1,0,8
6303,796413,24,3,7,0,1,3,6,0,0,0,1,1,0,0,1,0,9
6303,796408,29,2,10,1,4,1,6,4,4,0,7,1,1,1,4,0,9
6303,796407,21,1,1,1,1,0,0,1,2,0,3,1,2,0,2,0,3
6303,780450,20,1,1,0,0,1,1,1,2,0,1,0,0,0,2,0,4
6303,796409,12,0,3,0,1,0,2,0,0,0,2,2,2,1,1,0,0
6303,796410,24,6,8,6,8,0,0,4,10,5,3,1,1,0,3,0,16
6303,790858,14,0,3,0,0,0,3,0,0,0,2,1,3,0,1,0,0
6303,796411,3,0,0,0,0,0,0,0,0,0,0,0,0,0,0,0,0
6304,781149,34,2,6,1,5,1,1,4,6,2,5,1,4,1,1,2,9
6304,789025,27,2,5,1,3,1,2,0,0,0,1,0,3,1,0,0,5
6304,782157,12,0,1,0,1,0,0,0,0,1,1,5,1,0,0,0,0
6304,774985,38,6,17,4,10,2,7,1,1,0,5,4,2,1,1,2,15
6304,775276,3,0,1,0,1,0,0,0,0,0,0,0,2,0,1,0,0
6304,780852,10,2,2,2,2,0,0,2,2,2,2,0,0,0,0,0,6
6304,792670,20,2,5,1,3,1,2,0,1,0,2,0,1,0,2,1,5
6304,792669,28,3,9,3,9,0,0,2,3,2,4,4,3,3,5,0,8
6304,780193,28,6,12,3,6,3,6,1,2,0,0,0,3,1,0,0,16
6305,798966,14,1,1,1,1,0,0,0,0,2,3,0,2,0,0,0,2
6305,798962,32,5,7,5,7,0,0,5,8,3,4,0,1,0,1,0,15
6305,791717,30,3,10,2,5,1,5,1,1,3,4,0,3,0,2,1,8
6305,798963,35,2,7,2,6,0,1,1,4,0,6,11,2,1,10,1,5
6305,781446,19,1,4,1,2,0,2,0,0,0,2,0,3,0,3,0,2
6305,787996,3,0,0,0,0,0,0,0,0,0,0,0,1,0,0,0,0
6305,798968,24,4,6,1,3,3,3,0,0,0,2,0,1,0,0,1,11
6305,798965,22,3,7,2,3,1,4,2,4,2,6,0,2,0,2,1,9
6305,791718,14,3,6,2,3,1,3,2,2,0,1,0,5,0,0,0,9
6305,768880,7,1,3,1,1,0,2,0,0,0,2,1,1,1,0,0,2
6306,786690,25,3,8,2,5,1,3,3,6,3,4,1,3,0,5,1,10
6306,791161,11,1,5,0,0,1,5,0,0,0,1,0,5,0,2,0,3
6306,780629,25,2,11,2,8,0,3,3,4,3,4,0,2,1,1,0,7
6306,774845,37,3,6,3,4,0,2,0,1,0,1,5,0,1,3,0,6
6306,775888,37,7,11,7,9,0,2,8,11,3,7,4,0,2,2,2,22
6306,796817,2,0,0,0,0,0,0,0,0,0,0,0,1,0,0,0,0
6306,796816,33,6,11,5,6,1,5,6,8,3,3,0,4,1,2,0,19
6306,796815,2,1,1,0,0,1,1,0,0,0,1,0,0,0,0,0,3
6306,791159,6,2,4,1,1,1,3,0,0,0,0,0,0,0,0,0,5
6306,785346,22,3,6,2,3,1,3,0,0,1,4,1,3,2,0,0,7
6307,788113,29,4,10,3,6,1,4,6,6,4,6,2,5,1,1,0,15
6307,776497,35,6,17,4,7,2,10,1,1,0,4,4,3,1,1,2,15
6307,785731,35,6,10,4,6,2,4,2,2,3,7,3,4,1,3,1,16
6307,785729,31,3,6,3,4,0,2,4,4,2,1,6,4,1,5,0,10
6307,780864,32,4,10,1,2,3,8,5,5,3,2,3,2,2,0,0,16
6307,799881,1,0,0,0,0,0,0,0,0,0,0,0,1,0,1,0,0
6307,796211,5,0,2,0,1,0,1,0,0,1,0,0,2,0,1,0,0
6307,786231,30,7,15,2,6,5,9,4,4,1,5,1,4,1,3,0,23
6307,792405,2,0,0,0,0,0,0,0,0,0,0,0,0,0,0,0,0
6308,776004,21,4,7,4,6,0,1,4,5,3,5,2,0,2,1,0,12
6308,790930,31,2,4,1,2,1,2,0,0,1,1,3,2,1,1,0,5
6308,775011,25,3,8,2,5,1,3,0,0,1,2,0,0,1,1,0,7
6308,780357,35,3,10,0,4,3,6,4,4,1,6,1,1,1,1,0,13
6308,775018,34,0,5,0,3,0,2,0,0,0,4,6,2,0,1,0,0
6308,780358,18,4,5,4,5,0,0,1,2,1,1,0,1,0,2,1,9
6308,776270,12,3,5,3,5,0,0,3,3,0,0,3,3,0,1,0,9
6308,796480,18,6,7,2,3,4,4,1,2,1,3,1,3,3,6,0,17
6308,785491,2,0,1,0,1,0,0,0,0,0,0,0,1,0,1,0,0
6308,796486,1,0,0,0,0,0,0,0,0,0,1,0,0,0,0,0,0
6308,796485,1,0,0,0,0,0,0,0,0,0,0,0,0,0,0,0,0
6308,785496,1,0,0,0,0,0,0,0,0,0,0,0,0,0,0,0,0
6308,796482,1,0,0,0,0,0,0,0,0,0,0,0,0,0,0,0,0
6309,792005,27,2,7,0,0,2,7,0,0,3,0,1,1,1,1,2,6
6309,781175,22,3,3,3,3,0,0,4,4,3,2,2,2,2,1,0,10
6309,786553,34,6,15,4,9,2,6,0,2,0,2,0,0,1,2,0,14
6309,780895,26,4,9,4,8,0,1,0,0,0,1,1,2,0,2,0,8
6309,781172,23,1,3,0,1,1,2,0,0,0,2,1,4,1,2,0,3
6309,781177,19,1,6,1,3,0,3,2,2,2,2,0,2,0,1,0,4
6309,786555,16,0,2,0,1,0,1,0,0,0,1,2,3,0,2,0,0
6309,785312,19,3,7,3,6,0,1,0,0,1,2,2,2,0,2,0,6
6309,797503,4,1,1,1,1,0,0,0,0,0,1,0,0,0,0,0,2
6309,792004,1,0,1,0,1,0,0,0,0,0,0,0,0,0,0,1,0
6309,786557,3,0,1,0,0,0,1,0,0,0,1,0,0,1,0,0,0
6309,797502,4,0,0,0,0,0,0,0,2,0,0,0,0,0,0,0,0
6309,797501,1,0,1,0,0,0,1,0,0,1,0,1,0,0,0,0,0
6309,797500,1,1,1,0,0,1,1,0,0,0,0,0,0,0,0,0,3
6310,785536,29,6,11,5,7,1,4,0,0,3,5,2,4,2,3,3,13
6310,780119,36,5,8,5,7,0,1,0,0,3,7,1,1,0,1,0,10
6310,796558,36,4,12,4,12,0,0,2,2,2,6,2,2,0,3,0,10
6310,796559,38,4,12,3,8,1,4,4,4,3,4,1,4,2,3,0,13
6310,776097,28,2,9,2,7,0,2,2,2,1,2,5,2,3,2,1,6
6310,796560,9,0,2,0,0,0,2,0,0,0,0,0,2,2,1,0,0
6310,785280,4,0,3,0,2,0,1,0,0,0,1,0,0,0,0,2,0
6310,775679,2,0,1,0,0,0,1,0,0,0,0,0,0,0,1,0,0
6310,780149,17,2,6,2,4,0,2,5,6,0,3,2,0,1,3,0,9
6310,785285,1,0,0,0,0,0,0,0,0,0,0,0,0,0,0,0,0
6311,785999,34,3,8,3,8,0,0,4,8,2,3,1,1,1,5,0,10
6311,775654,23,1,4,1,4,0,0,0,0,0,1,0,0,0,0,2,2
6311,796399,18,0,3,0,2,0,1,0,1,0,4,1,5,1,3,1,0
6311,791639,31,1,4,1,3,0,1,4,4,0,3,3,3,0,4,0,6
6311,785389,37,4,10,4,8,0,2,0,0,0,3,3,3,5,4,0,8
6311,791640,15,2,6,0,0,2,6,0,0,1,1,1,0,2,2,0,6
6311,796398,14,0,2,0,1,0,1,0,0,1,1,0,2,0,2,0,0
6311,775171,14,2,5,1,2,1,3,1,2,0,1,0,2,0,1,0,6
6311,785255,5,0,0,0,0,0,0,0,0,1,2,1,1,0,2,0,0
6311,796401,9,2,7,0,2,2,5,1,3,1,3,0,1,0,2,1,7
6312,791401,40,6,18,6,18,0,0,7,10,5,9,1,3,0,3,2,19
6312,780125,38,6,9,6,9,0,0,6,12,2,6,2,2,3,2,2,18
6312,791400,34,4,9,4,8,0,1,3,4,0,3,2,5,1,1,0,11
6312,785931,13,0,2,0,2,0,0,0,0,0,0,0,5,1,0,0,0
6312,780118,31,2,6,0,4,2,2,7,8,0,2,1,4,1,2,0,13
6312,797126,13,1,1,1,1,0,0,0,0,2,1,0,1,0,0,0,2
6312,797130,19,2,5,0,1,2,4,0,0,0,2,2,5,0,1,0,6
6312,797132,12,0,1,0,0,0,1,0,0,0,2,1,2,0,2,0,0
6312,797125,25,1,3,1,3,0,0,0,0,0,0,3,1,0,2,0,2
6313,791416,38,7,15,7,15,0,0,2,2,5,5,0,3,1,1,2,16
6313,797096,31,1,6,0,0,1,6,1,2,0,2,0,4,0,3,0,4
6313,785906,29,2,11,2,10,0,1,6,6,1,5,2,5,2,2,0,10
6313,781614,17,2,3,1,1,1,2,0,0,1,1,2,1,0,2,0,5
6313,780096,43,5,11,1,2,4,9,5,7,0,4,2,2,2,1,0,19
6313,797093,24,3,6,3,6,0,0,6,9,1,4,4,4,2,1,0,12
6313,780100,28,0,0,0,0,0,0,4,6,1,3,0,2,0,0,1,4
6313,785907,15,2,5,1,4,1,1,0,0,2,0,0,5,0,0,0,5
6313,797094,0,0,0,0,0,0,0,0,0,0,0,0,0,0,0,0,0
6324,785589,38,6,13,6,13,0,0,9,13,2,13,4,3,0,1,1,21
6324,791209,11,2,4,2,4,0,0,0,0,1,0,2,3,0,1,0,4
6324,791215,33,5,8,0,2,5,6,2,3,1,3,2,2,2,1,0,17
6324,791213,31,6,12,4,7,2,5,0,0,1,1,3,5,2,1,0,14
6324,791214,36,3,7,3,3,0,4,4,4,0,4,6,3,3,2,0,10
6324,791210,12,0,2,0,1,0,1,0,0,0,1,1,0,0,0,0,0
6324,776313,30,4,9,1,3,3,6,2,4,1,0,1,2,1,0,0,13
6324,776364,8,1,2,0,0,1,2,0,0,0,0,1,1,0,1,0,3
6324,791212,1,0,0,0,0,0,0,0,0,0,0,0,0,0,0,0,0
6325,776286,36,5,11,4,9,1,2,0,1,4,7,1,5,2,1,0,11
6325,775557,18,1,3,1,3,0,0,0,0,1,0,1,3,0,2,0,2
6325,791445,39,5,14,2,4,3,10,4,4,0,1,3,2,1,2,0,17
6325,785357,29,2,10,1,3,1,7,2,4,3,4,1,3,0,2,1,7
6325,775560,37,7,13,4,8,3,5,8,10,0,5,5,2,1,2,0,25
6325,785287,16,1,2,1,2,0,0,4,4,3,3,0,0,0,1,1,6
6325,797010,17,1,2,1,1,0,1,0,0,0,1,2,1,0,1,0,2
6325,791444,2,0,0,0,0,0,0,0,0,0,0,0,1,0,0,0,0
6325,785895,4,1,4,0,0,1,4,0,0,0,2,0,2,0,0,0,3
6325,797012,2,0,0,0,0,0,0,0,0,0,1,0,0,0,0,0,0
6326,790794,24,5,5,5,5,0,0,0,2,1,3,0,4,0,0,2,10
6326,785368,32,4,12,4,12,0,0,3,4,3,4,1,2,0,1,7,11
6326,790793,36,6,16,4,9,2,7,3,4,0,8,3,4,3,3,0,17
6326,785246,31,5,9,2,2,3,7,2,2,1,2,2,0,0,2,1,15
6326,780886,37,2,9,0,4,2,5,0,1,0,4,4,1,3,2,0,6
6326,780281,13,3,4,3,3,0,1,0,0,2,0,1,1,1,2,1,6
6326,790792,14,0,4,0,2,0,2,1,2,0,3,2,3,1,2,1,1
6326,796353,2,0,1,0,0,0,1,0,0,0,0,0,0,0,0,0,0
6326,796350,7,0,2,0,0,0,2,0,0,0,0,0,0,0,0,0,0
6326,790790,1,0,0,0,0,0,0,0,0,0,0,0,0,0,0,0,0
6326,790789,3,0,0,0,0,0,0,0,0,0,0,0,0,0,0,0,0
6327,790914,20,3,5,3,5,0,0,0,0,4,3,1,1,1,2,0,6
6327,780798,28,1,6,1,2,0,4,0,0,1,1,2,0,1,1,0,2
6327,785455,32,4,12,3,7,1,5,0,1,0,4,2,3,3,2,0,9
6327,785453,33,9,16,7,10,2,6,2,5,1,7,1,4,1,4,0,22
6327,774940,26,6,10,6,8,0,2,0,0,0,4,1,3,2,1,0,12
6327,785458,19,4,9,4,8,0,1,0,0,2,5,0,3,0,1,2,8
6327,790915,14,3,6,3,6,0,0,0,0,1,3,1,2,1,1,1,6
6327,790913,15,0,3,0,3,0,0,4,4,1,1,1,1,1,1,0,4
6327,785456,13,1,1,0,0,1,1,0,0,0,1,1,0,0,0,0,3
6328,781407,21,4,7,3,5,1,2,2,2,1,5,2,2,2,1,1,11
6328,791583,22,5,9,5,9,0,0,0,0,4,3,3,4,1,4,3,10
6328,797445,35,6,11,4,8,2,3,3,4,2,2,1,2,0,2,0,17
6328,786110,20,1,5,1,1,0,4,0,0,0,1,0,2,2,0,1,2
6328,776150,40,6,13,5,8,1,5,0,1,0,2,6,0,1,1,0,13
6328,797448,16,1,4,0,0,1,4,0,1,0,4,1,4,0,3,1,3
6328,786608,12,2,3,2,3,0,0,0,0,1,0,1,1,0,1,0,4
6328,785623,29,1,7,1,6,0,1,0,0,3,4,0,1,1,0,2,2
6328,786659,5,0,1,0,1,0,0,0,0,0,0,1,0,1,2,0,0
6329,792378,24,0,4,0,3,0,1,3,4,1,8,0,3,0,1,4,3
6329,786746,32,2,6,1,4,1,2,3,4,1,6,3,3,2,2,0,8
6329,780178,25,7,8,7,8,0,0,1,2,2,1,1,2,2,1,1,15
6329,792376,38,8,17,3,8,5,9,2,2,2,2,2,4,3,5,0,23
6329,797883,34,2,9,2,5,0,4,2,2,2,2,6,0,1,3,0,6
6329,797890,19,2,9,1,5,1,4,0,0,0,3,0,0,0,1,0,5
6329,797888,7,0,1,0,1,0,0,0,0,0,0,0,2,0,1,0,0
6329,775075,14,0,0,0,0,0,0,1,2,1,1,0,0,1,0,1,1
6329,797885,7,0,3,0,2,0,1,2,2,0,0,0,0,0,0,0,2
6330,786054,6,1,2,1,2,0,0,0,0,0,1,0,1,0,0,0,2
6330,797711,28,4,9,0,3,4,6,0,0,0,5,2,3,3,1,0,12
6330,786056,35,5,8,3,4,2,4,2,2,0,5,3,3,2,0,1,14
6330,781339,36,1,8,1,2,0,6,2,2,0,4,1,2,1,3,0,4
6330,781337,38,5,16,2,6,3,10,0,0,1,3,7,1,3,4,0,13
6330,797712,24,4,4,4,4,0,0,5,6,2,0,3,3,0,1,0,13
6330,792041,18,3,8,2,4,1,4,0,0,1,2,0,4,0,1,0,7
6330,799737,15,1,5,0,0,1,5,0,0,0,2,3,1,0,1,0,3
6330,791964,25,4,9,2,5,2,4,2,2,0,2,0,3,0,0,0,12
6331,786765,43,9,12,7,9,2,3,2,2,0,9,4,4,0,5,4,22
6331,792379,44,3,8,1,3,2,5,6,6,2,7,1,1,0,2,2,14
6331,792380,38,6,13,3,5,3,8,0,0,0,2,0,2,1,2,0,15
6331,781672,30,5,8,5,8,0,0,1,2,1,6,3,2,3,2,0,11
6331,781669,45,8,18,5,10,3,8,3,5,1,3,6,1,1,5,0,22
6331,797860,2,0,0,0,0,0,0,0,0,0,1,0,2,0,0,0,0
6331,797854,15,0,1,0,0,0,1,0,0,1,3,1,1,0,1,0,0
6331,781671,8,0,0,0,0,0,0,0,1,0,1,0,0,0,0,0,0
6332,792249,20,2,2,2,2,0,0,1,2,2,3,0,1,2,2,2,5
6332,781430,38,5,15,5,11,0,4,9,11,3,4,2,2,1,5,0,19
6332,792248,36,3,9,0,1,3,8,2,2,0,4,0,0,0,0,0,11
6332,781445,32,3,9,2,3,1,6,6,6,0,7,0,1,0,1,0,13
6332,768845,32,3,11,3,7,0,4,0,0,1,5,1,3,0,1,0,6
6332,792253,2,0,0,0,0,0,0,0,0,1,0,0,0,0,1,0,0
6332,781448,16,2,3,2,3,0,0,1,1,2,0,2,1,1,1,1,5
6332,797941,16,3,6,2,5,1,1,0,3,0,3,1,1,0,2,2,7
6332,792250,2,0,0,0,0,0,0,0,0,0,0,0,0,0,1,1,0
6332,786076,6,0,0,0,0,0,0,0,0,0,0,1,1,0,0,0,0
6333,785800,16,3,7,3,5,0,2,0,0,0,3,0,5,0,0,0,6
6333,785799,21,3,7,3,7,0,0,0,0,2,6,3,2,1,1,0,6
6333,791676,24,3,4,1,1,2,3,2,2,0,2,4,1,0,0,0,10
6333,780554,25,10,13,9,11,1,2,1,1,0,4,2,1,0,0,1,22
6333,780553,27,7,18,7,18,0,0,1,2,1,6,7,2,3,2,0,15
6333,797426,9,1,3,1,2,0,1,0,0,0,1,0,0,0,0,0,2
6333,791678,6,1,2,1,1,0,1,0,0,0,0,0,0,0,0,0,2
6333,791679,3,0,0,0,0,0,0,0,0,0,0,0,1,0,1,0,0
6333,785807,17,2,5,1,1,1,4,0,0,2,1,0,0,2,0,0,5
6333,780760,16,1,3,0,0,1,3,0,0,0,2,1,2,0,0,4,3
6333,797427,20,4,6,0,0,4,6,2,2,0,0,2,2,2,0,0,14
6333,790964,1,0,0,0,0,0,0,0,0,0,0,0,1,0,0,0,0
6333,791677,15,0,1,0,1,0,0,0,0,0,3,1,1,1,3,0,0
6334,791876,33,3,8,3,5,0,3,4,4,3,10,2,5,0,1,0,10
6334,791877,27,1,1,1,1,0,0,3,4,0,1,0,3,1,1,2,5
6334,797486,17,2,5,2,4,0,1,3,3,0,4,1,3,0,1,0,7
6334,786572,36,4,7,3,5,1,2,5,5,1,5,3,1,1,1,0,14
6334,780436,8,0,3,0,2,0,1,0,0,0,0,0,0,0,1,0,0
6334,785667,31,5,11,1,2,4,9,1,2,0,2,0,1,1,0,0,15
6334,786570,36,11,17,7,10,4,7,6,7,0,5,7,2,2,2,0,32
6334,781205,12,0,0,0,0,0,0,0,0,0,1,0,3,1,0,0,0
6335,781342,32,10,16,6,9,4,7,6,6,3,7,5,2,0,1,2,30
6335,781593,38,7,12,7,11,0,1,3,5,4,2,0,3,1,2,1,17
6335,790901,33,1,8,1,6,0,2,2,3,1,3,3,4,1,0,0,4
6335,790903,31,3,9,0,0,3,9,0,0,0,2,2,2,0,2,0,9
6335,781620,26,0,5,0,1,0,4,0,0,1,3,5,3,0,1,1,0
6335,790902,24,4,10,2,3,2,7,2,2,0,2,2,5,0,1,1,12
6335,796450,10,0,1,0,1,0,0,0,0,0,1,2,2,0,0,0,0
6335,796449,6,0,0,0,0,0,0,0,0,0,1,0,0,0,0,0,0
6336,780291,29,8,17,6,10,2,7,0,2,0,2,0,2,1,0,0,18
6336,796666,9,0,1,0,1,0,0,1,2,0,1,0,4,1,0,0,1
6336,796665,28,1,7,1,2,0,5,0,0,0,2,3,0,0,1,0,2
6336,785333,38,3,10,1,4,2,6,0,0,0,3,5,1,1,1,0,8
6336,796663,15,2,5,2,5,0,0,2,4,3,1,0,1,0,0,0,6
6336,775305,37,9,17,6,12,3,5,4,4,1,5,2,1,4,1,1,25
6336,791004,24,1,6,0,1,1,5,0,0,1,5,4,3,1,1,0,3
6336,791006,3,0,0,0,0,0,0,0,0,0,1,0,1,1,0,0,0
6336,785607,3,1,1,1,1,0,0,1,2,1,1,0,1,0,0,0,3
6336,796664,14,2,3,2,3,0,0,0,0,1,0,0,2,0,0,0,4
6337,775455,31,7,12,7,10,0,2,2,2,2,10,4,2,0,2,1,16
6337,792124,18,1,4,1,4,0,0,2,4,2,3,1,3,0,2,0,4
6337,792123,31,6,12,3,6,3,6,1,1,1,2,3,2,1,4,0,16
6337,786005,28,3,6,0,0,3,6,4,4,0,2,0,3,1,2,0,13
6337,781397,30,2,5,2,3,0,2,0,0,0,6,3,0,0,1,0,4
6337,786003,26,3,6,1,2,2,4,0,0,1,3,3,1,0,2,1,8
6337,797749,15,3,3,0,0,3,3,0,0,1,1,0,1,0,0,0,9
6337,797747,12,1,5,0,4,1,1,0,0,0,1,1,1,1,0,0,3
6337,786002,9,1,3,1,1,0,2,1,2,1,1,2,0,0,2,0,3
6338,797861,26,4,9,4,8,0,1,1,2,3,3,0,4,0,1,0,9
6338,792208,35,7,16,4,11,3,5,2,3,0,7,3,1,1,1,0,19
6338,792204,37,4,12,2,8,2,4,3,6,1,3,7,4,1,1,0,13
6338,786262,40,3,7,0,1,3,6,0,0,1,1,1,1,0,2,0,9
6338,781314,36,9,15,6,9,3,6,2,3,0,2,4,1,1,2,0,23
6338,776018,21,1,2,1,2,0,0,0,0,0,3,0,3,1,1,3,2
6338,797858,1,0,1,0,1,0,0,0,0,0,0,0,0,0,0,0,0
6338,792206,4,0,0,0,0,0,0,0,0,0,0,0,0,0,1,0,0
6339,792158,21,3,5,3,5,0,0,6,6,1,7,0,2,0,1,0,12
6339,780138,29,5,10,5,10,0,0,6,8,3,6,1,3,0,3,0,16
6339,792154,31,12,20,8,14,4,6,1,2,0,6,0,1,0,1,0,29
6339,786014,35,1,5,1,3,0,2,0,0,1,4,3,2,2,1,1,2
6339,780581,30,3,7,3,4,0,3,0,0,0,1,6,2,1,2,0,6
6339,797755,19,4,6,4,5,0,1,1,2,4,4,1,1,0,0,1,9
6339,792157,11,2,3,2,3,0,0,0,0,2,2,1,2,1,2,0,4
6339,797756,18,3,9,3,7,0,2,0,0,2,1,3,2,0,1,0,6
6339,792159,6,0,1,0,1,0,0,0,0,0,0,0,0,0,0,0,0
6340,785518,26,1,3,0,2,1,1,4,6,1,4,2,1,1,1,0,7
6340,796390,19,4,5,4,5,0,0,1,2,1,2,0,2,1,2,2,9
6340,785451,30,6,12,6,9,0,3,6,7,4,6,0,1,2,4,2,18
6340,790832,15,4,7,3,5,1,2,0,0,0,1,1,1,2,3,0,9
6340,790834,23,1,5,1,3,0,2,2,2,2,2,2,1,1,2,0,4
6340,790833,25,4,6,3,4,1,2,2,2,1,3,2,4,1,2,0,11
6340,785377,24,4,7,4,7,0,0,0,0,0,3,6,0,2,2,0,8
6340,790830,14,1,2,1,1,0,1,0,0,1,0,0,2,1,0,0,2
6340,790831,13,2,3,2,3,0,0,0,2,1,1,0,3,0,1,0,4
6340,785379,11,1,5,1,3,0,2,1,1,1,0,0,1,2,1,0,3
6341,790846,29,6,9,6,8,0,1,3,3,2,5,1,1,1,1,1,15
6341,796755,15,2,5,2,5,0,0,0,0,0,1,0,0,0,1,0,4
6341,791099,33,6,9,5,5,1,4,0,0,1,3,1,1,1,3,0,13
6341,785470,38,3,14,2,6,1,8,0,0,2,5,5,4,2,1,0,7
6341,785586,21,1,4,1,1,0,3,0,1,0,0,3,3,1,4,0,2
6341,780814,14,1,2,1,2,0,0,0,0,1,2,0,1,2,1,1,2
6341,780298,29,5,12,3,6,2,6,6,6,3,1,4,4,1,4,0,18
6341,780315,15,0,2,0,1,0,1,0,1,1,0,1,0,0,2,0,0
6341,796754,6,0,0,0,0,0,0,0,0,0,0,0,5,0,2,0,0
6342,785913,33,1,9,1,9,0,0,1,2,1,2,2,2,0,2,0,3
6342,786516,27,3,11,1,2,2,9,1,3,0,4,0,2,0,0,0,9
6342,781464,32,8,11,7,8,1,3,1,1,3,2,1,1,4,3,0,18
6342,781502,30,2,5,1,3,1,2,5,6,0,2,3,3,2,3,0,10
6342,780259,37,5,13,5,10,0,3,5,6,2,3,2,2,5,0,0,15
6342,792277,3,0,0,0,0,0,0,0,0,1,0,0,0,0,0,0,0
6342,785282,16,1,3,1,2,0,1,0,0,0,2,0,2,0,3,0,2
6342,781501,18,3,3,3,3,0,0,0,1,1,4,3,3,0,3,0,6
6342,798058,4,0,0,0,0,0,0,0,0,0,0,0,0,1,0,0,0
6343,785437,21,1,2,1,1,0,1,0,1,0,0,0,3,0,2,1,2
6343,786041,31,4,5,3,3,1,2,1,2,3,9,0,3,2,3,1,10
6343,780881,13,1,5,0,2,1,3,2,2,2,1,0,1,0,4,0,5
6343,792075,25,0,4,0,1,0,3,0,0,0,0,0,1,0,1,0,0
6343,786686,38,10,18,8,14,2,4,0,2,2,2,10,0,1,5,0,22
6343,780884,4,1,1,1,1,0,0,0,0,1,1,0,0,0,0,0,2
6343,792074,14,3,5,0,0,3,5,0,0,0,4,0,2,0,2,1,9
6343,775222,26,1,5,1,4,0,1,3,7,1,6,0,4,0,3,0,5
6343,780882,16,1,2,0,0,1,2,0,0,0,1,1,2,1,1,0,3
6343,780275,12,3,5,3,5,0,0,1,1,2,1,0,2,0,0,1,7
6344,785409,25,4,8,4,8,0,0,1,2,4,0,1,3,0,1,0,9
6344,785408,37,9,15,6,9,3,6,2,2,1,4,0,5,1,1,0,23
6344,790861,17,1,6,1,5,0,1,0,0,2,1,0,0,1,1,0,2
6344,780539,36,2,5,2,2,0,3,1,3,0,4,2,3,1,1,0,5
6344,780560,25,1,6,0,3,1,3,0,0,0,3,3,1,1,1,0,3
6344,785407,17,3,8,3,8,0,0,3,5,2,3,0,3,1,2,0,9
6344,796415,19,1,2,1,1,0,1,0,0,0,2,0,1,1,2,0,2
6344,796416,24,2,3,2,3,0,0,0,0,0,2,3,0,0,2,0,4
6345,775510,38,5,11,3,5,2,6,6,6,2,3,1,2,0,1,0,18
6345,774976,33,5,12,4,6,1,6,1,1,0,6,3,3,2,1,1,12
6345,797865,37,2,3,2,3,0,0,4,5,0,5,1,0,0,3,2,8
6345,786614,34,5,8,3,5,2,3,6,6,1,4,0,3,0,1,0,18
6345,786759,36,2,3,1,1,1,2,3,4,0,2,6,3,2,3,0,8
6345,792293,12,0,3,0,3,0,0,0,0,0,0,1,1,1,2,0,0
6345,792291,3,0,1,0,1,0,0,0,0,0,0,0,1,0,0,0,0
6345,792294,2,0,0,0,0,0,0,0,0,0,1,0,0,0,0,0,0
6345,786761,5,0,0,0,0,0,0,0,0,0,0,0,0,0,0,0,0
6346,785714,31,5,7,5,7,0,0,4,6,3,7,2,2,0,1,0,14
6346,775894,27,3,10,2,4,1,6,0,0,1,4,0,5,1,2,0,7
6346,785711,35,4,11,3,7,1,4,5,7,0,4,6,5,2,3,0,14
6346,780985,37,6,11,2,3,4,8,0,0,0,3,3,1,1,3,0,16
6346,775266,34,7,13,4,7,3,6,5,6,1,3,4,3,2,1,0,22
6346,796829,9,0,1,0,1,0,0,0,0,0,0,0,0,0,1,0,0
6346,785378,8,2,2,1,1,1,1,0,0,0,1,0,1,0,2,0,5
6346,791167,13,0,2,0,1,0,1,1,2,0,1,1,3,0,2,0,1
6346,779994,6,0,0,0,0,0,0,0,0,0,0,0,0,0,0,0,0
6347,786857,30,7,13,7,11,0,2,3,4,3,3,1,1,4,1,0,17
6347,781403,37,5,10,1,4,4,6,2,3,1,6,3,3,1,5,0,16
6347,792654,31,5,9,5,9,0,0,2,4,2,6,0,4,0,2,0,12
6347,797301,35,1,5,1,3,0,2,6,6,0,4,5,4,1,2,0,8
6347,781400,39,6,13,1,5,5,8,5,7,0,2,7,2,0,2,0,22
6347,792653,8,3,4,3,4,0,0,0,0,1,2,0,4,0,1,1,6
6347,797302,4,0,0,0,0,0,0,0,0,0,1,0,0,0,0,0,0
6347,780524,16,2,4,1,1,1,3,0,0,0,1,0,2,0,0,0,5
6356,797241,19,2,3,2,3,0,0,1,3,2,4,1,4,0,0,0,5
6356,791366,23,3,6,3,4,0,2,2,3,2,3,0,2,0,2,0,8
6356,797244,29,5,10,2,4,3,6,2,2,1,4,0,0,2,0,0,15
6356,785742,26,1,10,0,3,1,7,1,2,0,2,5,2,1,1,0,4
6356,780163,29,3,10,2,5,1,5,7,7,0,4,2,3,4,4,0,14
6356,791361,17,3,10,2,6,1,4,1,2,2,4,0,1,3,2,0,8
6356,780170,19,4,6,4,6,0,0,3,4,2,2,2,1,0,1,0,11
6356,797246,1,0,0,0,0,0,0,0,0,0,1,0,0,0,0,0,0
6356,797243,11,0,0,0,0,0,0,0,0,0,4,1,2,0,0,0,0
6356,791363,4,0,0,0,0,0,0,0,0,1,1,0,0,0,0,0,0
6356,786340,20,4,7,1,3,3,4,2,2,0,4,1,3,1,0,1,13
6356,797242,1,0,0,0,0,0,0,0,0,0,0,0,0,0,0,0,0
6356,797245,1,0,0,0,0,0,0,0,0,0,0,0,0,0,0,0,0
6357,785523,25,2,6,2,6,0,0,3,4,1,5,2,4,0,2,0,7
6357,791250,32,2,12,0,1,2,11,2,2,0,10,0,2,0,4,1,8
6357,796947,29,4,9,3,4,1,5,2,4,1,4,3,2,2,1,1,11
6357,791249,36,7,14,2,3,5,11,0,0,0,1,1,1,1,1,0,19
6357,775358,37,1,5,1,2,0,3,2,2,0,4,7,4,2,3,0,4
6357,785522,13,2,2,1,1,1,1,0,0,0,1,0,3,0,1,1,5
6357,781247,8,0,0,0,0,0,0,0,1,0,0,0,5,0,0,0,0
6357,796948,1,1,1,1,1,0,0,0,0,0,0,0,0,0,0,0,2
6357,796946,1,0,1,0,1,0,0,0,0,0,1,0,0,0,0,0,0
6357,796944,15,0,6,0,2,0,4,1,2,0,1,0,0,0,1,0,1
6357,791247,1,0,0,0,0,0,0,0,0,0,0,1,0,0,0,0,0
6357,796949,1,0,0,0,0,0,0,0,0,0,0,0,0,0,0,0,0
6357,796945,1,0,0,0,0,0,0,0,0,0,0,0,0,0,0,0,0
6358,785687,18,1,3,1,3,0,0,0,0,1,0,0,0,1,0,0,2
6358,775047,31,2,5,2,4,0,1,5,6,4,1,2,3,4,3,1,9
6358,797025,32,5,13,3,6,2,7,2,3,0,3,5,3,3,7,2,14
6358,791600,36,5,15,3,5,2,10,1,2,4,8,5,2,0,0,0,13
6358,780410,34,3,14,1,3,2,11,2,4,0,3,0,2,1,1,0,10
6358,797028,21,3,5,2,3,1,2,1,2,1,3,1,3,1,1,1,8
6358,797027,18,1,2,0,1,1,1,0,0,0,2,0,1,1,1,0,3
6358,791597,10,0,0,0,0,0,0,1,2,1,2,1,4,0,0,0,1
6359,791276,32,5,8,5,8,0,0,2,4,3,10,2,3,0,2,0,12
6359,796529,37,7,14,6,11,1,3,2,3,0,4,3,3,1,4,0,17
6359,791275,32,4,7,3,4,1,3,2,2,0,4,0,1,0,2,1,11
6359,785746,40,1,4,0,2,1,2,1,2,0,3,1,2,1,2,0,4
6359,785741,34,1,5,1,3,0,2,0,2,0,7,5,4,3,5,0,2
6359,785755,8,2,3,2,3,0,0,0,1,0,0,0,1,0,0,0,4
6359,785748,17,2,7,2,3,0,4,0,0,1,0,2,1,1,1,0,4
6360,780058,26,5,8,4,5,1,3,2,2,0,4,1,2,1,0,2,13
6360,780059,16,2,8,2,6,0,2,0,0,3,5,1,4,2,1,1,4
6360,796494,24,1,3,1,2,0,1,0,0,0,5,1,2,2,1,0,2
6360,790944,29,7,16,6,9,1,7,4,4,1,2,2,1,0,4,0,19
6360,780061,32,3,9,3,5,0,4,0,0,1,6,5,1,0,2,0,6
6360,790941,14,6,8,6,7,0,1,0,0,1,6,0,3,2,1,1,12
6360,796496,21,4,5,2,3,2,2,0,0,2,5,0,3,1,1,1,10
6360,790943,3,0,1,0,1,0,0,0,0,0,0,0,0,0,0,0,0
6360,796497,4,0,1,0,1,0,0,0,0,0,0,0,1,0,0,0,0
6360,796495,6,1,2,1,1,0,1,0,0,0,2,2,0,0,1,0,2
6360,796499,0,0,0,0,0,0,0,0,0,0,0,0,1,0,2,0,0
6360,785097,1,0,0,0,0,0,0,0,0,0,0,0,0,0,0,0,0
6360,792690,1,0,0,0,0,0,0,0,0,0,0,0,0,0,0,0,0
6360,788853,1,0,0,0,0,0,0,0,0,0,0,0,0,0,0,0,0
6360,786754,22,4,8,2,5,2,3,0,0,0,3,3,0,1,4,0,10
6361,797142,25,2,3,2,3,0,0,0,0,1,2,3,2,1,0,1,4
6361,791522,35,3,13,3,11,0,2,3,8,2,7,3,0,3,2,2,9
6361,785816,25,2,5,2,5,0,0,0,0,1,2,1,3,2,1,1,4
6361,797146,34,8,19,6,15,2,4,4,4,0,5,0,2,0,2,0,22
6361,797143,36,4,15,2,9,2,6,4,4,0,3,0,1,2,5,0,14
6361,785479,15,0,1,0,0,0,1,1,2,1,2,0,1,0,0,2,1
6361,797144,10,0,3,0,1,0,2,0,0,0,0,0,2,3,0,0,0
6361,797147,16,1,5,1,4,0,1,4,4,0,1,1,2,3,2,0,6
6361,797148,2,0,0,0,0,0,0,0,0,1,0,0,0,0,0,0,0
6361,786348,2,0,1,0,0,0,1,0,0,0,0,0,0,0,0,0,0
6362,790863,9,0,2,0,0,0,2,0,0,0,0,0,4,1,1,0,0
6362,780021,29,3,8,3,8,0,0,2,7,2,3,0,3,0,3,1,8
6362,785413,17,2,5,2,5,0,0,0,0,0,3,0,0,0,0,0,4
6362,785412,31,5,14,3,11,2,3,2,3,0,0,4,2,3,3,0,14
6362,776214,38,6,11,4,8,2,3,12,14,2,5,5,3,2,1,0,26
6362,775686,29,1,7,0,1,1,6,2,2,3,9,2,3,1,2,0,5
6362,780099,26,4,10,1,5,3,5,0,0,0,2,1,0,1,0,0,11
6362,785417,12,2,2,1,1,1,1,0,0,1,2,0,1,0,1,2,5
6362,776221,9,1,2,1,1,0,1,0,0,0,1,1,0,0,1,0,2
6363,797222,34,3,6,3,6,0,0,2,4,0,10,2,3,3,2,4,8
6363,781526,12,4,6,3,5,1,1,0,0,1,1,2,5,1,2,0,9
6363,797217,31,2,8,2,7,0,1,3,5,0,3,4,4,0,2,1,7
6363,797218,29,4,9,2,6,2,3,0,0,1,2,2,5,1,0,0,10
6363,775697,33,6,12,2,3,4,9,2,3,0,2,2,2,2,3,1,18
6363,797223,29,3,4,3,4,0,0,2,4,2,8,0,4,0,3,3,8
6363,791454,24,4,8,2,4,2,4,0,0,1,5,1,1,0,4,0,10
6363,791453,7,0,2,0,0,0,2,0,0,1,0,0,0,0,1,0,0
6363,797221,1,0,0,0,0,0,0,0,0,0,0,0,0,0,0,0,0
6364,792140,32,8,12,8,12,0,0,2,2,1,3,0,4,1,3,2,18
6364,786596,32,4,10,2,6,2,4,1,2,2,5,2,1,0,1,1,11
6364,792144,35,4,9,1,5,3,4,0,0,1,7,0,2,0,2,1,11
6364,781429,37,4,9,1,1,3,8,1,1,1,1,0,1,0,0,0,12
6364,776092,35,4,13,3,8,1,5,4,4,1,6,7,4,1,6,0,13
6364,797791,1,0,0,0,0,0,0,0,0,0,0,0,0,0,1,0,0
6364,792146,7,0,1,0,1,0,0,0,0,0,3,0,1,0,1,0,0
6364,797793,16,1,2,1,2,0,0,0,0,0,2,0,0,0,1,2,2
6364,797787,5,0,0,0,0,0,0,0,0,0,0,2,0,0,1,0,0
6365,786646,24,5,10,4,8,1,2,0,0,0,3,1,2,3,0,0,11
6365,780890,24,1,4,1,2,0,2,0,0,0,0,0,1,0,0,0,2
6365,786066,39,9,14,8,10,1,4,3,4,0,5,4,1,5,4,0,22
6365,780167,33,8,19,8,17,0,2,2,4,3,3,3,3,0,0,0,18
6365,775574,38,8,14,6,9,2,5,0,0,1,4,0,1,4,2,0,18
6365,791121,2,0,2,0,2,0,0,0,0,1,0,0,0,0,0,0,0
6365,791123,8,0,1,0,1,0,0,0,1,0,1,0,1,0,2,0,0
6365,785636,32,1,2,0,0,1,2,0,0,2,5,2,2,0,1,1,3
6366,791616,29,2,4,2,4,0,0,2,2,3,2,1,1,0,1,0,6
6366,780797,27,3,9,3,4,0,5,2,4,0,4,1,2,1,1,1,8
6366,796981,28,5,9,3,6,2,3,1,2,0,3,0,0,0,0,1,13
6366,785505,35,7,11,5,8,2,3,1,1,1,1,4,1,1,4,0,17
6366,775604,34,3,9,1,2,2,7,0,0,0,3,1,1,0,0,0,8
6366,776418,5,1,3,1,3,0,0,0,0,2,0,0,1,0,0,0,2
6366,796984,13,1,2,1,2,0,0,0,0,1,2,3,2,0,1,0,2
6366,791618,6,0,0,0,0,0,0,0,0,0,2,2,1,0,0,0,0
6366,780555,23,2,5,0,1,2,4,2,4,0,2,2,4,2,2,0,8
6367,791220,29,3,4,3,4,0,0,0,0,2,1,3,1,1,1,0,6
6367,791219,30,9,14,5,6,4,8,2,3,3,7,2,3,3,1,0,24
6367,776217,31,5,8,5,8,0,0,1,2,3,7,0,2,1,1,2,11
6367,786396,25,2,9,2,5,0,4,0,0,0,2,1,1,0,1,0,4
6367,780730,35,3,8,2,5,1,3,1,2,0,0,1,1,1,3,0,8
6367,800086,1,0,2,0,2,0,0,0,0,1,0,0,0,0,0,0,0
6367,786824,12,1,2,1,1,0,1,0,0,0,0,0,0,0,1,0,2
6367,791221,6,0,0,0,0,0,0,0,0,0,0,0,0,0,0,0,0
6367,796923,4,0,0,0,0,0,0,1,2,0,1,0,0,0,0,0,1
6367,796924,1,0,0,0,0,0,0,0,0,0,0,0,0,0,0,0,0
6367,796921,1,0,0,0,0,0,0,0,0,0,0,0,2,0,0,0,0
6367,796920,3,0,0,0,0,0,0,0,0,0,0,0,0,0,0,0,0
6367,790818,22,5,8,4,6,1,2,3,6,0,3,1,3,0,0,0,14
6368,780122,24,4,9,3,7,1,2,2,4,2,4,1,4,0,0,3,11
6368,797215,18,0,4,0,2,0,2,0,0,0,0,4,3,0,3,0,0
6368,791461,22,2,3,2,3,0,0,0,0,0,6,1,2,1,1,0,4
6368,791460,28,2,8,2,3,0,5,13,15,0,1,3,3,1,3,0,17
6368,786295,37,6,8,3,4,3,4,0,0,2,7,3,1,0,3,1,15
6368,786299,18,4,4,4,4,0,0,2,2,1,0,1,4,1,0,1,10
6368,797214,22,1,4,1,3,0,1,1,2,0,1,2,4,2,2,0,3
6368,780792,31,8,15,4,10,4,5,2,3,0,5,1,1,1,3,0,22
6369,780651,17,1,3,1,3,0,0,0,1,1,1,3,5,2,2,0,2
6369,791815,31,4,15,4,11,0,4,5,5,1,1,2,4,3,3,2,13
6369,791810,21,2,5,2,5,0,0,3,4,0,1,2,1,0,2,0,7
6369,791814,25,3,6,0,0,3,6,0,0,0,0,1,0,0,0,0,9
6369,780650,31,5,12,4,8,1,4,1,3,1,5,1,3,0,4,0,12
6369,791809,15,3,4,3,4,0,0,2,3,2,3,0,1,0,0,1,8
6369,781596,7,1,2,1,2,0,0,2,4,3,1,0,2,0,0,1,4
6369,797373,7,0,3,0,1,0,2,0,0,0,0,1,0,1,0,0,0
6369,786645,18,3,6,3,6,0,0,6,6,4,5,4,3,0,1,1,12
6369,786644,28,3,6,3,3,0,3,2,2,0,0,0,2,1,1,0,8
6370,781046,31,4,10,2,6,2,4,0,1,3,5,0,2,1,2,0,10
6370,780025,31,4,9,4,9,0,0,2,4,2,6,0,0,0,0,2,10
6370,796391,13,0,3,0,1,0,2,0,0,0,0,0,3,0,1,0,0
6370,785385,35,2,5,2,3,0,2,0,0,0,2,1,1,0,0,0,4
6370,785383,36,2,8,1,3,1,5,1,2,2,4,6,4,0,6,1,6
6370,792180,25,3,9,0,5,3,4,0,1,0,2,1,2,1,3,3,9
6370,786297,5,0,2,0,2,0,0,0,0,0,2,0,0,0,3,0,0
6370,790837,24,2,4,2,3,0,1,0,0,2,1,1,1,2,1,0,4
6371,780765,36,8,16,6,11,2,5,2,2,2,5,3,1,2,4,0,20
6371,781301,19,1,2,1,2,0,0,0,0,0,3,0,3,0,0,2,2
6371,786255,33,1,8,1,4,0,4,0,0,2,5,2,1,2,0,1,2
6371,780762,36,7,14,6,8,1,6,4,5,3,3,0,1,2,0,0,19
6371,780768,19,1,5,1,3,0,2,2,2,1,0,4,4,2,1,0,4
6371,791729,16,3,5,2,3,1,2,0,0,0,2,0,1,0,0,0,7
6371,780755,19,1,2,1,1,0,1,0,0,0,4,0,0,0,0,1,2
6371,776241,20,1,7,1,3,0,4,2,2,0,1,3,4,1,1,0,4
6371,797320,2,0,0,0,0,0,0,0,0,0,0,0,0,0,0,0,0
6372,780201,29,2,5,2,5,0,0,0,1,1,6,2,2,1,1,0,4
6372,797210,38,3,9,2,7,1,2,2,3,2,2,4,3,2,4,0,9
6372,797208,23,5,12,5,12,0,0,0,0,3,2,2,3,2,1,0,10
6372,791467,21,1,6,0,2,1,4,0,0,1,1,0,2,1,1,0,3
6372,786311,40,4,12,0,4,4,8,7,7,1,1,2,3,2,1,0,19
6372,791469,31,4,7,4,7,0,0,1,2,0,6,1,0,2,0,4,9
6372,775516,18,2,5,2,3,0,2,0,0,0,0,4,4,0,1,0,4
6373,797111,14,0,2,0,2,0,0,2,2,1,2,1,4,0,2,1,2
6373,797110,35,4,9,1,3,3,6,0,0,0,0,0,1,1,0,0,11
6373,791407,40,6,14,2,8,4,6,8,12,0,5,2,2,0,6,0,24
6373,785928,36,3,4,2,2,1,2,0,0,3,5,3,2,1,4,0,7
6373,785923,37,1,6,1,5,0,1,6,8,1,3,5,0,1,1,1,8
6373,791403,26,6,8,6,8,0,0,0,0,2,11,2,0,0,1,0,12
6373,791406,2,0,1,0,1,0,0,0,0,0,0,0,0,0,0,0,0
6373,791404,10,1,2,0,1,1,1,0,0,0,2,1,2,0,0,0,3
6374,786029,22,1,2,1,2,0,0,1,2,1,4,1,5,0,2,0,3
6374,792114,34,7,14,3,7,4,7,4,5,1,3,0,1,1,3,0,22
6374,786018,28,3,6,1,1,2,5,0,0,1,2,1,1,0,2,4,8
6374,775678,31,3,8,1,3,2,5,9,10,0,6,4,1,1,1,1,17
6374,797746,17,2,6,1,1,1,5,4,6,0,4,1,2,1,1,0,9
6374,786022,16,1,4,1,4,0,0,0,0,2,2,1,4,0,1,0,2
6374,797737,15,1,1,1,1,0,0,0,0,1,3,2,2,0,0,0,2
6374,797740,15,3,6,3,3,0,3,1,2,0,4,2,3,0,1,0,7
6374,792112,1,0,0,0,0,0,0,0,0,0,0,0,0,0,0,0,0
6374,781398,21,1,7,0,3,1,4,2,2,2,5,3,2,0,2,0,5
6375,792271,21,4,12,4,12,0,0,5,5,3,5,1,4,1,1,1,13
6375,791686,24,2,6,2,5,0,1,5,6,1,3,0,4,0,1,1,9
6375,798028,30,4,7,3,3,1,4,0,0,0,3,2,2,1,0,0,9
6375,790940,37,0,13,0,5,0,8,9,10,1,5,0,4,0,1,0,9
6375,780770,39,9,17,6,10,3,7,2,2,0,1,4,2,2,2,0,23
6375,786060,18,0,6,0,4,0,2,0,0,0,3,0,1,0,0,0,0
6375,792269,15,1,1,1,1,0,0,0,1,0,3,0,2,0,0,0,2
6375,792270,15,0,2,0,0,0,2,2,2,2,2,3,2,3,1,0,2
6375,798022,1,0,1,0,0,0,1,0,0,0,0,0,0,0,0,0,0
6376,780874,26,5,6,3,3,2,3,3,3,2,5,1,2,0,1,1,15
6376,781326,25,5,9,5,9,0,0,4,7,1,5,0,1,1,1,2,14
6376,797870,36,7,17,5,11,2,6,2,3,2,2,5,3,2,4,1,18
6376,792210,27,0,4,0,2,0,2,0,0,0,1,2,5,1,0,0,0
6376,781323,38,8,15,7,11,1,4,3,3,0,5,7,2,1,4,1,20
6376,785430,15,3,7,3,7,0,0,2,3,1,1,1,3,0,0,0,8
6376,785638,14,2,2,2,2,0,0,2,2,3,1,0,1,0,0,0,6
6376,792215,17,0,1,0,1,0,0,0,0,0,3,1,4,1,1,1,0
6376,792213,2,0,0,0,0,0,0,0,0,0,0,0,1,0,1,0,0
6377,796439,35,6,9,6,9,0,0,5,8,2,8,1,3,0,2,1,17
6377,790884,12,0,2,0,2,0,0,1,2,0,3,0,2,0,0,1,1
6377,790883,36,2,5,2,4,0,1,0,0,0,2,3,5,1,1,2,4
6377,796436,28,5,13,3,9,2,4,7,8,0,2,2,2,1,4,1,19
6377,785436,28,1,3,1,3,0,0,2,4,0,1,3,1,1,2,1,4
6377,791635,26,4,8,3,5,1,3,2,4,0,2,6,4,1,1,2,11
6377,796438,27,4,6,1,2,3,4,5,6,0,3,0,2,1,1,0,16
6377,781262,8,2,3,0,0,2,3,0,0,0,1,0,0,0,0,0,6
6378,786180,13,1,2,1,2,0,0,0,0,2,1,0,0,0,1,0,2
6378,797709,29,4,9,0,2,4,7,0,0,0,0,0,2,0,0,0,12
6378,792104,29,4,12,2,6,2,6,4,4,2,11,0,3,0,2,3,14
6378,797708,36,7,14,5,10,2,4,0,0,2,2,6,1,3,4,0,16
6378,775779,28,1,6,1,6,0,0,3,4,1,4,3,1,1,5,0,5
6378,786204,19,1,6,1,5,0,1,0,0,2,1,1,1,2,0,2,2
6378,797707,23,3,7,1,2,2,5,1,2,0,4,2,1,1,0,1,9
6378,785608,19,4,5,4,5,0,0,0,1,3,3,1,4,1,1,1,8
6378,786198,4,1,1,1,1,0,0,0,0,0,0,1,0,0,0,0,2
6378,792106,0,0,0,0,0,0,0,0,0,0,0,0,0,0,0,0,0
6379,791981,36,5,14,4,11,1,3,3,4,8,9,2,1,1,3,0,14
6379,780342,25,1,6,1,4,0,2,0,0,2,4,2,2,1,2,0,2
6379,791982,36,3,11,2,6,1,5,2,2,0,5,3,1,3,0,0,9
6379,780333,38,2,12,2,4,0,8,0,0,1,2,6,0,1,6,0,4
6379,781493,27,4,10,1,3,3,7,5,6,0,1,0,3,0,1,0,16
6379,786756,15,2,5,0,1,2,4,0,0,2,1,0,1,0,1,0,6
6379,786755,13,1,1,1,1,0,0,0,0,1,0,0,3,1,2,0,2
6379,791984,10,2,3,1,2,1,1,1,1,0,1,0,1,0,0,0,6
6379,791985,0,0,0,0,0,0,0,0,0,0,0,0,0,0,0,0,0
6388,797701,9,2,3,2,3,0,0,3,4,0,0,0,3,0,1,0,7
6388,792101,35,4,15,3,10,1,5,2,3,1,3,1,4,2,2,0,11
6388,792102,33,5,9,4,4,1,5,2,2,2,3,1,3,0,0,1,13
6388,775564,36,3,10,3,8,0,2,3,4,4,6,5,4,1,2,1,9
6388,776386,39,7,11,5,7,2,4,3,3,1,3,1,2,1,5,0,19
6388,797700,10,1,2,1,2,0,0,0,0,0,2,1,4,1,2,1,2
6388,797697,15,0,2,0,2,0,0,0,0,0,0,0,2,0,0,3,0
6388,780922,7,0,1,0,0,0,1,0,1,0,1,0,1,0,0,0,0
6388,786156,5,1,2,1,1,0,1,0,0,0,1,0,2,0,0,0,2
6388,786160,11,0,2,0,0,0,2,4,4,1,1,2,1,0,0,0,4
6389,792388,16,2,2,2,2,0,0,2,2,1,3,0,5,0,2,0,6
6389,781533,21,0,5,0,3,0,2,0,0,0,3,0,5,0,2,0,0
6389,797845,25,1,3,0,0,1,3,2,4,1,1,1,3,0,3,0,5
6389,797851,31,6,10,6,8,0,2,2,3,4,2,1,4,1,0,0,14
6389,792395,37,9,15,9,13,0,2,9,14,1,5,2,1,5,5,1,27
6389,792396,4,0,0,0,0,0,0,0,0,0,0,0,0,0,0,0,0
6389,792393,31,3,6,3,6,0,0,2,5,2,6,1,1,0,0,0,8
6389,792391,32,6,14,6,13,0,1,2,3,3,5,4,2,2,0,2,14
6389,786115,3,0,0,0,0,0,0,0,0,0,0,0,1,0,0,0,0
6390,785622,31,5,8,4,6,1,2,2,4,1,6,1,1,1,3,0,13
6390,781058,28,5,10,5,9,0,1,2,3,3,10,0,2,0,1,0,12
6390,780327,26,7,12,7,12,0,0,0,0,1,0,1,1,0,1,1,14
6390,797458,27,1,5,1,5,0,0,3,4,1,5,1,1,0,1,0,5
6390,791849,19,0,3,0,1,0,2,0,0,0,1,1,1,1,2,0,0
6390,797455,14,6,9,6,9,0,0,1,3,4,3,0,2,0,1,0,13
6390,797451,26,1,8,1,5,0,3,0,0,1,1,5,0,3,3,0,2
6390,791847,7,0,1,0,0,0,1,0,0,0,0,0,1,0,0,0,0
6390,791848,7,1,2,1,2,0,0,0,0,1,1,0,0,0,0,0,2
6390,786607,12,1,4,1,1,0,3,0,0,1,0,2,1,1,0,0,2
6390,797456,3,0,0,0,0,0,0,0,0,0,0,0,0,0,0,0,0
6391,785948,27,3,5,3,5,0,0,1,1,1,5,0,3,1,1,1,7
6391,785946,20,1,2,0,0,1,2,0,0,1,4,0,3,0,1,0,3
6391,792020,36,4,16,1,7,3,9,3,4,0,3,5,3,0,2,0,14
6391,785939,31,3,11,2,6,1,5,2,2,0,1,3,2,0,3,0,9
6391,785938,26,6,11,4,6,2,5,0,0,0,1,0,0,1,1,0,14
6391,792026,22,3,4,3,4,0,0,1,2,2,3,0,1,1,1,1,7
6391,792025,10,2,2,2,2,0,0,0,0,0,2,0,0,0,0,0,4
6391,792023,11,0,1,0,1,0,0,0,0,0,2,1,3,0,1,0,0
6391,785941,17,1,4,0,1,1,3,0,0,0,2,0,3,0,1,0,3
6392,792351,23,1,2,1,2,0,0,2,3,2,2,2,5,2,1,0,4
6392,786723,37,7,13,6,11,1,2,3,4,1,8,1,1,1,2,1,18
6392,792349,22,4,7,3,6,1,1,1,1,2,1,0,4,0,0,1,10
6392,798060,27,5,9,3,6,2,3,2,2,0,3,4,4,4,2,0,14
6392,792352,27,1,2,1,2,0,0,1,2,0,2,3,4,0,1,0,3
6392,786724,29,3,6,1,4,2,2,2,2,1,2,0,2,0,2,0,10
6392,792355,24,5,13,3,6,2,7,0,0,0,2,0,1,0,0,0,12
6392,798061,5,0,0,0,0,0,0,0,0,1,0,0,0,0,0,0,0
6392,786726,6,1,1,1,1,0,0,0,0,0,1,0,1,0,1,0,2
6393,796334,32,5,8,5,8,0,0,7,8,4,3,0,2,1,3,0,17
6393,790776,24,4,5,4,5,0,0,1,3,3,4,0,3,0,2,2,9
6393,796330,21,1,6,1,5,0,1,2,2,3,2,1,1,0,1,0,4
6393,785813,30,2,9,0,6,2,3,4,4,0,1,3,1,1,3,0,10
6393,796337,32,3,11,3,10,0,1,2,2,2,2,4,0,1,1,0,8
6393,785827,16,4,9,4,9,0,0,0,1,0,5,1,3,0,1,1,8
6393,796332,18,0,2,0,0,0,2,0,0,0,2,1,4,2,1,0,0
6393,796336,19,0,2,0,0,0,2,0,0,0,0,2,1,1,0,0,0
6393,779975,8,1,2,1,2,0,0,0,0,1,0,0,0,0,0,0,2
6394,785930,13,3,5,3,5,0,0,0,0,0,4,0,4,1,4,0,6
6394,780996,27,3,5,1,1,2,4,0,0,3,2,2,1,0,2,0,8
6394,780995,28,3,8,2,6,1,2,0,0,1,6,3,3,0,3,0,7
6394,796468,31,5,8,3,5,2,3,1,2,0,4,0,1,0,2,1,13
6394,790920,30,3,10,3,10,0,0,10,13,0,4,3,3,1,3,0,16
6394,791035,29,4,14,2,6,2,8,0,0,0,6,3,2,2,1,0,10
6394,796467,6,0,1,0,0,0,1,0,0,0,0,1,0,1,0,0,0
6394,785461,8,0,0,0,0,0,0,0,0,1,1,0,3,1,2,0,0
6394,775709,25,0,2,0,1,0,1,0,0,0,2,1,2,0,0,0,0
6394,796466,3,0,0,0,0,0,0,0,0,0,0,0,0,0,0,0,0
6395,791973,10,0,3,0,2,0,1,0,0,0,1,0,0,1,0,0,0
6395,781107,28,0,4,0,4,0,0,3,6,3,2,2,2,0,0,2,3
6395,791972,36,5,13,2,5,3,8,1,3,1,6,2,0,2,1,1,14
6395,796777,15,0,3,0,1,0,2,0,0,0,1,1,1,0,1,0,0
6395,785366,35,10,18,6,7,4,11,2,4,0,4,3,3,3,4,0,26
6395,780863,22,6,11,4,6,2,5,1,2,1,2,1,5,0,4,1,15
6395,796778,12,0,1,0,0,0,1,0,0,2,4,0,2,2,2,1,0
6395,791974,22,0,2,0,1,0,1,3,6,0,1,3,1,1,0,0,3
6395,796780,20,1,2,1,1,0,1,0,0,0,4,0,0,0,0,0,2
6396,797175,20,2,8,2,6,0,2,1,2,4,2,0,2,0,0,0,5
6396,780027,36,6,13,5,10,1,3,3,6,2,5,5,3,0,0,0,16
6396,786176,37,6,14,2,6,4,8,1,2,1,9,2,1,1,0,0,17
6396,780028,27,1,5,0,1,1,4,0,1,2,0,3,2,1,1,0,3
6396,774828,37,5,11,1,3,4,8,4,4,0,2,6,2,1,1,0,18
6396,791379,13,4,4,4,4,0,0,0,0,0,1,0,0,1,1,0,8
6396,780029,23,6,12,2,5,4,7,2,2,2,4,2,0,0,2,0,18
6396,791380,7,0,1,0,1,0,0,0,0,0,1,2,2,0,1,0,0
6396,797178,0,0,0,0,0,0,0,0,0,0,0,0,1,0,0,0,0
6396,797179,0,0,0,0,0,0,0,0,0,0,0,0,0,0,0,0,0
6397,790873,27,5,12,4,11,1,1,5,6,2,5,3,3,0,1,2,16
6397,785429,19,3,8,0,0,3,8,0,0,0,2,1,2,1,1,0,9
6397,780054,34,5,9,3,6,2,3,0,1,4,7,5,1,1,1,0,12
6397,781140,32,5,6,3,4,2,2,4,4,2,4,0,3,1,0,0,16
6397,786851,27,6,15,3,6,3,9,1,2,0,3,2,1,0,0,0,16
6397,796433,14,3,3,3,3,0,0,2,4,2,5,0,4,0,0,1,8
6397,776245,6,0,2,0,0,0,2,0,0,0,1,0,1,0,0,0,0
6397,776357,25,1,5,1,3,0,2,1,2,0,4,9,4,1,1,0,3
6397,781139,2,0,0,0,0,0,0,0,0,0,0,0,0,0,1,1,0
6397,799973,10,2,3,0,0,2,3,0,0,0,0,0,0,0,1,0,6
6397,796432,4,1,2,0,0,1,2,0,0,1,0,0,0,0,0,0,3
6398,797292,28,8,14,8,14,0,0,0,0,3,7,1,1,0,1,4,16
6398,780509,31,3,4,2,3,1,1,2,4,1,5,1,0,0,2,1,9
6398,797290,36,6,9,6,7,0,2,0,0,0,4,4,0,1,1,0,12
6398,797291,30,3,6,2,4,1,2,5,6,1,3,2,0,1,4,2,12
6398,786064,34,5,11,3,6,2,5,0,1,2,5,2,0,0,1,0,12
6398,791658,12,1,1,1,1,0,0,0,2,0,3,0,1,0,1,1,2
6398,791661,0,0,0,0,0,0,0,0,0,0,0,0,1,0,0,0,0
6398,785658,9,0,2,0,1,0,1,0,0,0,2,0,0,0,0,0,0
6398,791660,20,1,2,0,0,1,2,0,0,0,1,3,5,0,3,1,3
6399,791669,19,2,4,2,4,0,0,1,2,0,2,0,2,1,0,0,5
6399,785762,30,3,8,2,5,1,3,0,0,0,2,3,0,0,4,3,7
6399,797407,12,1,1,1,1,0,0,0,0,0,0,1,1,1,1,0,2
6399,785760,18,1,3,0,0,1,3,2,2,0,2,0,0,0,0,0,5
6399,780531,40,4,17,1,5,3,12,2,2,2,7,1,3,3,2,0,13
6399,797414,5,0,0,0,0,0,0,0,0,0,0,0,1,0,0,1,0
6399,780534,16,0,1,0,1,0,0,0,0,0,0,0,1,1,0,0,0
6399,797409,26,3,7,0,3,3,4,0,0,1,1,4,1,1,1,0,9
6399,791666,21,5,11,2,6,3,5,0,0,0,1,1,0,3,0,0,13
6399,797411,3,1,2,1,2,0,0,0,0,0,0,0,2,0,0,0,2
6399,797415,9,0,1,0,1,0,0,0,0,0,1,0,2,1,0,0,0
6399,780535,1,0,0,0,0,0,0,0,0,0,0,0,0,0,0,0,0
6400,780844,15,1,3,0,0,1,3,1,2,0,1,0,2,0,1,0,4
6400,797699,38,6,12,2,3,4,9,1,2,0,2,6,2,1,4,0,17
6400,797692,29,6,12,1,2,5,10,0,0,1,2,2,4,0,1,0,17
6400,791954,30,3,9,3,5,0,4,4,4,2,4,3,3,2,3,0,10
6400,780846,38,5,11,5,7,0,4,4,6,2,4,4,2,1,0,0,14
6400,797698,7,0,1,0,0,0,1,0,0,2,0,0,1,0,1,0,0
6400,797695,25,4,6,4,6,0,0,0,1,1,3,1,2,0,3,1,8
6400,797694,18,1,7,1,2,0,5,0,0,0,2,0,1,1,0,0,2
6401,791144,18,4,5,4,5,0,0,2,2,0,0,0,0,0,5,0,10
6401,785782,34,3,6,1,2,2,4,0,0,1,5,0,2,0,0,1,8
6401,791145,36,6,12,6,11,0,1,3,4,1,7,3,2,0,3,1,15
6401,791146,29,3,8,3,7,0,1,0,0,0,4,2,5,0,5,0,6
6401,785777,35,4,7,2,3,2,4,3,4,0,2,4,1,1,0,0,13
6401,791147,4,0,2,0,0,0,2,0,0,0,0,0,4,1,1,0,0
6401,796804,6,2,3,2,2,0,1,0,0,1,1,0,1,0,0,0,4
6401,791148,22,3,4,1,1,2,3,6,6,0,3,1,3,0,1,0,14
6401,786748,16,2,2,2,2,0,0,0,0,0,2,0,1,1,2,0,4
6402,780634,28,7,8,7,8,0,0,0,3,6,6,2,0,2,0,3,14
6402,791826,32,1,3,0,1,1,2,2,2,2,4,4,1,0,3,0,5
6402,786785,34,2,6,2,4,0,2,5,6,0,3,1,4,0,1,2,9
6402,786783,30,5,11,4,9,1,2,3,4,1,5,3,1,3,2,0,14
6402,780633,32,5,8,3,3,2,5,4,4,1,2,2,4,2,1,0,16
6402,797389,12,0,0,0,0,0,0,3,4,0,1,0,2,0,0,1,3
6402,776009,18,3,8,1,5,2,3,1,2,0,2,0,3,1,6,0,9
6402,786784,14,3,5,3,4,0,1,0,0,0,1,1,1,0,0,1,6
6403,776462,35,4,11,4,11,0,0,2,3,4,3,1,1,0,0,0,10
6403,785635,31,6,9,5,7,1,2,3,4,6,4,3,5,3,0,0,16
6403,791629,16,1,5,0,2,1,3,0,0,0,2,1,1,1,0,1,3
6403,786440,29,2,7,1,4,1,3,2,2,1,0,2,4,1,3,0,7
6403,781199,37,7,14,6,10,1,4,3,4,0,6,7,3,0,5,0,18
6403,796974,23,2,7,0,4,2,3,4,4,0,0,0,3,1,1,0,10
6403,775642,10,1,3,1,3,0,0,0,0,2,0,0,1,0,0,0,2
6403,786720,15,3,7,3,5,0,2,0,0,1,1,0,1,1,2,0,6
6403,791628,4,0,1,0,0,0,1,0,0,0,0,0,1,0,0,0,0
6404,781516,26,10,14,10,14,0,0,2,2,0,6,0,2,1,2,1,22
6404,797333,20,0,1,0,1,0,0,2,2,0,5,1,1,0,1,0,2
6404,797331,32,1,5,0,1,1,4,2,2,0,2,3,3,3,2,0,5
6404,791737,24,1,7,1,4,0,3,0,0,0,2,3,1,0,2,0,2
6404,783524,30,3,5,1,3,2,2,5,5,0,0,5,3,0,5,0,13
6404,791734,2,0,1,0,1,0,0,0,0,0,0,0,0,0,2,0,0
6404,797332,12,1,1,1,1,0,0,0,1,2,1,0,1,0,2,1,2
6404,795372,7,1,2,0,0,1,2,0,0,0,0,0,2,0,0,0,3
6404,786223,6,0,0,0,0,0,0,0,0,0,0,1,0,0,0,0,0
6404,786220,21,3,6,2,3,1,3,7,7,0,2,2,2,0,1,0,14
6404,780561,20,2,3,1,2,1,1,0,0,0,2,2,2,1,0,0,5
6405,797824,16,0,6,0,4,0,2,0,0,1,3,0,1,0,2,0,0
6405,797825,8,0,2,0,2,0,0,0,0,0,0,1,2,1,0,0,0
6405,797822,21,5,7,3,4,2,3,2,3,0,2,0,4,3,3,0,14
6405,792190,39,4,8,3,5,1,3,4,4,2,4,5,2,1,2,0,13
6405,786664,39,6,13,5,9,1,4,1,1,0,3,6,0,2,3,0,14
6405,792192,22,3,6,3,6,0,0,0,1,1,1,2,2,0,1,1,6
6405,775116,27,2,5,0,0,2,5,2,2,2,3,0,2,1,2,1,8
6405,792191,24,2,6,1,5,1,1,4,6,2,2,0,2,0,2,0,9
6405,791928,4,0,0,0,0,0,0,0,0,0,0,0,0,0,0,0,0
6406,797066,13,1,5,0,4,1,1,4,6,2,3,1,1,1,1,1,7
6406,780180,24,4,5,4,5,0,0,4,6,1,3,0,2,1,0,0,12
6406,791432,33,6,10,2,3,4,7,2,2,0,0,1,1,0,1,0,18
6406,777865,29,3,9,1,5,2,4,1,1,0,2,1,5,0,1,0,9
6406,791429,28,3,6,3,6,0,0,1,4,0,3,6,3,0,2,0,7
6406,781650,21,6,8,6,8,0,0,1,2,3,2,3,5,1,2,0,13
6406,797067,12,2,2,2,2,0,0,2,4,1,1,0,0,1,1,0,6
6406,797070,22,1,6,0,3,1,3,0,0,0,4,0,2,0,2,0,3
6406,797068,18,0,4,0,3,0,1,0,0,0,1,3,3,0,1,0,0
6407,781244,22,4,7,4,7,0,0,4,5,1,5,2,5,0,2,3,12
6407,791243,25,4,8,2,4,2,4,5,6,1,0,4,1,0,1,0,15
6407,791241,11,3,6,1,3,2,3,4,4,1,3,0,4,0,1,0,12
6407,785537,31,7,10,6,8,1,2,2,2,1,2,2,3,2,1,0,17
6407,781243,31,2,7,1,3,1,4,0,0,1,3,2,1,0,0,2,5
6407,796943,4,1,1,1,1,0,0,0,0,0,2,0,0,0,0,0,2
6407,796940,3,0,0,0,0,0,0,0,0,0,0,0,1,0,0,0,0
6407,791245,30,3,9,2,4,1,5,1,1,3,1,4,3,1,1,0,8
6407,791246,15,4,7,2,3,2,4,0,0,2,6,0,1,0,0,0,10
6407,785529,12,1,2,0,0,1,2,0,0,0,0,1,2,1,1,0,3
6407,776205,16,1,3,0,2,1,1,2,2,0,2,0,1,1,2,0,5
6408,785532,26,5,7,5,7,0,0,5,5,1,6,0,5,1,0,1,15
6408,780063,27,0,5,0,2,0,3,0,0,0,2,3,1,1,3,0,0
6408,785530,32,6,12,1,5,5,7,7,7,0,4,4,5,1,3,0,24
6408,775573,12,1,6,1,3,0,3,0,0,0,0,1,0,0,1,0,2
6408,775926,28,3,12,2,6,1,6,0,0,1,2,1,1,0,2,0,7
6408,791058,17,0,0,0,0,0,0,1,2,1,1,0,0,0,1,0,1
6408,791280,10,0,2,0,0,0,2,0,0,0,0,0,1,0,3,0,0
6408,791059,6,0,0,0,0,0,0,0,0,0,0,0,2,0,0,1,0
6408,791055,30,1,3,1,3,0,0,0,1,1,4,2,2,0,3,0,2
6408,796734,8,2,3,2,2,0,1,0,0,1,0,0,1,0,0,0,4
6408,791057,4,0,0,0,0,0,0,0,0,0,1,0,1,0,0,0,0
6409,792143,32,3,6,1,1,2,5,0,1,0,2,4,3,3,1,0,8
6409,786302,29,2,4,2,4,0,0,0,4,1,6,0,4,1,0,0,4
6409,786293,34,5,7,3,4,2,3,2,5,1,2,0,2,1,1,0,14
6409,780953,36,8,17,8,14,0,3,8,8,1,10,4,2,2,3,1,24
6409,797750,31,0,2,0,2,0,0,3,4,0,2,4,3,0,3,0,3
6409,797751,18,5,8,5,7,0,1,0,0,0,1,0,0,0,1,0,10
6409,797748,14,3,4,3,4,0,0,0,0,0,1,0,0,1,1,1,6
6409,797742,5,0,0,0,0,0,0,0,0,0,0,0,2,0,2,0,0
6409,786301,1,0,0,0,0,0,0,1,2,0,0,0,0,0,0,0,1
6409,792147,0,0,0,0,0,0,0,0,0,0,0,0,0,0,0,0,0
6410,790784,33,5,11,3,6,2,5,1,1,0,2,2,1,3,2,1,13
6410,786235,16,2,2,2,2,0,0,0,0,1,5,0,2,0,2,2,4
6410,797475,32,2,7,2,4,0,3,4,5,1,1,1,3,2,2,0,8
6410,786229,32,3,8,2,4,1,4,1,2,2,2,1,3,2,0,0,8
6410,775229,34,4,18,3,10,1,8,1,4,2,4,5,5,2,3,0,10
6410,776219,29,5,8,4,4,1,4,0,2,1,4,0,1,1,3,0,11
6410,791871,11,1,2,1,2,0,0,1,2,0,0,1,2,0,1,0,3
6410,786581,9,0,1,0,0,0,1,0,0,0,1,1,1,0,0,0,0
6410,786770,13,2,9,1,6,1,3,0,0,1,2,1,0,1,1,0,5
6410,786719,4,0,1,0,1,0,0,0,0,0,1,1,0,0,1,0,0
6410,781518,12,1,2,1,1,0,1,0,0,1,1,0,1,1,0,0,2
6411,791648,24,4,8,4,6,0,2,4,4,1,4,0,2,1,1,0,12
6411,785694,9,0,1,0,1,0,0,0,0,1,1,0,0,0,0,1,0
6411,797280,36,4,9,4,8,0,1,6,10,0,4,3,2,3,8,0,14
6411,797279,35,4,9,0,4,4,5,2,2,1,2,1,2,0,3,0,14
6411,786640,30,2,6,2,6,0,0,0,0,0,3,6,3,0,3,0,4
6411,797281,18,1,5,1,4,0,1,0,0,1,4,0,0,0,2,0,2
6411,791647,31,3,6,3,6,0,0,0,0,1,7,0,0,0,2,3,6
6411,786195,20,6,8,6,8,0,0,0,0,1,3,0,3,1,2,3,12
6411,791649,22,0,1,0,0,0,1,6,6,0,4,3,5,1,1,1,6
6418,791723,13,1,3,1,3,0,0,0,0,1,2,1,4,0,1,4,2
6418,797310,38,5,13,3,7,2,6,2,3,3,6,0,2,2,2,0,14
6418,785580,30,6,10,5,9,1,1,3,9,3,5,5,2,2,4,0,16
6418,791724,40,4,13,4,10,0,3,4,6,5,6,1,3,0,4,4,12
6418,781617,19,2,5,2,5,0,0,7,7,2,3,0,2,1,4,0,11
6418,797312,27,2,6,2,4,0,2,0,0,1,0,2,2,0,0,1,4
6418,797308,22,1,5,1,3,0,2,0,0,1,2,2,0,2,2,0,2
6418,780706,11,2,3,1,2,1,1,2,2,0,0,1,1,1,2,1,7
6419,792186,36,14,20,14,20,0,0,2,4,2,7,0,3,2,1,0,30
6419,781447,17,0,1,0,1,0,0,1,1,3,1,1,4,0,1,0,1
6419,781490,14,0,3,0,2,0,1,0,0,3,0,2,1,2,1,0,0
6419,792188,25,2,7,2,4,0,3,0,0,1,2,4,3,1,2,0,4
6419,792183,38,5,18,5,10,0,8,2,2,2,3,5,3,3,7,0,12
6419,797819,25,2,5,2,4,0,1,1,4,1,3,0,3,2,1,0,5
6419,780433,5,0,2,0,2,0,0,0,2,1,2,0,1,0,1,3,0
6419,792185,18,2,7,1,3,1,4,0,0,1,2,0,2,0,1,0,5
6419,786675,22,1,6,1,2,0,4,1,2,2,1,2,2,1,1,0,3
6420,792593,29,4,6,4,6,0,0,1,2,0,5,3,3,3,4,1,9
6420,792594,26,5,7,1,2,4,5,2,2,0,1,0,4,2,4,1,16
6420,792588,36,4,10,1,2,3,8,2,2,1,7,2,2,1,0,0,13
6420,792595,35,4,11,2,5,2,6,1,4,0,6,6,0,0,2,0,11
6420,792583,33,2,6,0,0,2,6,0,0,0,0,0,0,1,0,0,6
6420,792580,11,1,2,1,2,0,0,0,0,1,0,0,4,0,1,1,2
6420,796987,12,4,6,3,5,1,1,0,0,0,3,0,1,0,1,0,9
6420,792591,18,1,1,1,1,0,0,0,0,0,2,2,0,1,0,0,2
6421,792100,29,6,8,6,8,0,0,1,1,1,3,2,3,1,0,0,13
6421,786131,25,4,8,4,8,0,0,3,4,1,7,1,1,0,2,0,11
6421,797688,31,5,6,5,5,0,1,0,1,0,4,3,1,1,2,0,10
6421,786145,32,3,9,0,3,3,6,1,2,0,2,3,0,1,1,0,10
6421,786128,38,5,12,4,9,1,3,2,4,1,5,3,2,2,8,0,13
6421,797684,2,0,1,0,1,0,0,0,0,0,0,0,0,0,0,1,0
6421,785884,15,1,2,1,2,0,0,0,0,1,0,1,3,0,1,0,2
6421,780904,8,0,0,0,0,0,0,0,2,0,2,0,1,0,0,2,0
6421,797685,14,0,4,0,3,0,1,0,0,0,1,1,0,0,0,0,0
6421,792096,6,0,1,0,0,0,1,3,3,0,1,0,1,0,0,0,3
6422,791289,24,2,5,2,5,0,0,4,4,4,3,0,3,0,1,4,8
6422,796572,27,2,4,2,4,0,0,8,10,3,9,0,1,0,2,0,12
6422,796574,32,3,7,2,4,1,3,3,4,1,1,1,3,0,3,0,10
6422,796571,33,1,6,1,4,0,2,5,7,0,6,1,2,0,1,0,7
6422,781346,27,1,8,0,3,1,5,3,4,0,0,4,2,1,4,0,6
6422,785786,26,2,2,2,2,0,0,0,0,0,6,1,2,2,1,1,4
6422,796576,23,3,11,1,4,2,7,2,4,0,2,3,2,1,2,0,10
6422,791290,8,1,5,1,2,0,3,0,0,1,0,0,1,1,0,0,2
6423,797466,30,4,11,4,11,0,0,5,7,4,5,0,4,0,1,0,13
6423,791858,37,2,8,2,4,0,4,0,0,4,4,4,3,1,1,0,4
6423,797463,37,6,21,3,9,3,12,5,5,1,8,2,2,2,3,0,20
6423,791109,27,1,4,1,3,0,1,2,4,0,1,3,5,3,5,1,4
6423,785625,33,3,7,1,1,2,6,0,0,1,1,1,5,3,4,0,8
6423,797464,16,1,2,0,0,1,2,1,1,0,1,0,2,1,1,0,4
6423,797467,3,0,1,0,1,0,0,0,0,0,0,0,2,0,0,0,0
6423,797469,14,0,3,0,1,0,2,0,0,0,0,0,1,0,1,0,0
6423,797465,3,0,1,0,0,0,1,0,0,0,0,0,2,0,0,0,0
6424,791230,29,3,7,0,0,3,7,2,2,1,3,0,1,1,1,0,11
6424,785557,18,4,8,3,7,1,1,0,0,1,5,0,5,1,3,1,9
6424,791227,35,2,6,0,1,2,5,0,0,1,1,2,3,2,0,0,6
6424,796932,35,9,20,6,14,3,6,4,4,1,1,9,4,2,4,0,25
6424,785624,38,6,16,2,7,4,9,0,2,1,0,3,1,2,0,0,16
6424,796933,16,3,6,3,4,0,2,0,0,1,3,1,2,0,1,0,6
6424,791226,18,2,3,2,3,0,0,0,0,3,3,0,2,0,1,0,4
6424,781198,11,1,3,1,2,0,1,0,1,0,2,3,2,1,0,0,2
6425,791306,24,5,7,5,7,0,0,2,3,4,3,1,1,0,2,0,12
6425,780210,38,13,21,10,17,3,4,1,2,6,8,4,1,1,2,0,30
6425,792432,35,3,8,1,3,2,5,4,4,0,2,4,3,0,2,0,12
6425,792427,27,5,13,1,6,4,7,0,0,0,3,8,3,1,7,0,14
6425,792433,19,3,5,2,3,1,2,0,0,1,3,1,4,1,1,0,7
6425,796592,18,3,4,3,4,0,0,1,1,3,5,2,1,0,2,0,7
6425,796594,12,2,4,1,3,1,1,1,1,0,1,1,0,0,0,0,6
6425,786422,5,1,2,1,2,0,0,1,2,0,0,0,3,0,0,0,3
6425,775005,22,1,3,0,1,1,2,0,0,0,5,1,2,0,2,0,3
6426,775556,31,7,17,5,11,2,6,4,5,4,7,4,2,1,5,1,20
6426,780234,38,12,21,12,20,0,1,9,16,10,10,0,3,6,1,2,33
6426,786411,29,2,8,0,1,2,7,0,0,0,0,1,4,1,1,0,6
6426,780046,27,0,7,0,3,0,4,1,2,0,5,3,3,0,5,0,1
6426,781104,27,1,6,1,3,0,3,1,1,0,2,4,0,1,4,0,3
6426,781110,16,1,5,1,4,0,1,0,0,0,0,1,3,0,0,0,2
6426,797185,18,2,4,2,3,0,1,0,0,0,1,1,2,3,3,1,4
6426,786405,14,0,2,0,1,0,1,1,2,1,4,0,1,0,1,0,1
6426,786328,0,0,0,0,0,0,0,0,0,0,0,0,0,0,0,0,0
6427,796959,13,5,5,5,5,0,0,0,0,0,2,1,3,1,1,1,10
6427,781272,37,2,8,1,6,1,2,0,0,4,9,3,1,1,3,1,5
6427,791261,24,2,11,2,5,0,6,2,2,1,3,1,3,2,0,0,6
6427,785501,36,3,12,1,5,2,7,2,5,0,10,6,3,0,3,1,10
6427,781270,38,8,13,4,8,4,5,7,8,0,2,4,1,2,4,0,27
6427,796960,10,0,0,0,0,0,0,0,0,1,1,0,2,0,1,0,0
6427,791260,14,4,5,4,5,0,0,1,2,0,1,0,2,1,0,1,9
6427,796958,15,2,4,1,2,1,2,3,4,0,2,1,3,1,1,0,8
6427,791258,13,1,3,1,1,0,2,1,2,0,1,0,1,0,3,0,3
6427,799825,0,0,0,0,0,0,0,0,0,0,0,0,0,0,0,0,0
6428,797483,23,1,2,1,2,0,0,0,0,0,2,4,0,1,0,1,2
6428,797482,34,7,11,5,9,2,2,1,2,0,1,3,1,1,1,0,17
6428,797485,22,3,5,0,1,3,4,0,0,0,0,0,3,0,1,0,9
6428,797481,24,3,8,2,6,1,2,2,4,0,1,1,1,1,1,2,9
6428,785944,27,4,12,1,5,3,7,0,0,1,1,2,1,0,2,0,11
6428,797480,8,0,3,0,2,0,1,0,0,0,0,1,1,0,0,0,0
6428,791875,15,0,3,0,2,0,1,0,0,1,1,2,0,1,0,0,0
6428,781217,11,2,2,2,2,0,0,0,0,0,1,0,1,0,3,0,4
6428,797478,12,1,5,0,2,1,3,0,0,0,1,1,1,0,0,0,3
6428,791873,4,1,3,1,3,0,0,0,0,0,0,0,0,0,0,0,2
6428,797484,12,0,1,0,1,0,0,0,0,0,1,0,1,0,0,1,0
6428,797479,4,1,1,0,0,1,1,0,0,0,0,0,1,0,0,0,3
6428,786579,4,0,0,0,0,0,0,0,0,0,0,0,1,0,0,0,0
6429,796673,21,8,12,7,9,1,3,2,2,3,10,3,2,2,0,0,19
6429,796674,23,4,5,3,4,1,1,2,3,2,4,1,1,0,2,0,11
6429,779857,18,6,9,5,8,1,1,2,2,1,5,2,3,0,3,1,15
6429,779976,26,5,9,3,6,2,3,0,0,2,1,4,1,1,1,0,12
6429,774990,31,6,12,3,6,3,6,0,0,2,1,5,1,1,1,0,15
6429,781586,18,2,3,2,3,0,0,0,0,0,2,2,0,0,0,1,4
6429,791014,17,3,4,0,0,3,4,0,0,0,5,1,3,2,2,0,9
6429,785339,18,5,6,3,4,2,2,0,0,2,0,2,0,0,1,0,12
6429,785961,18,3,6,1,2,2,4,0,0,1,4,0,0,0,0,0,8
6429,785126,4,0,1,0,1,0,0,0,0,0,0,1,0,0,0,0,0
6429,796672,2,0,0,0,0,0,0,0,0,0,0,1,0,0,0,0,0
6429,780142,4,0,0,0,0,0,0,0,0,0,0,0,0,0,0,0,0
6430,791811,28,3,7,3,7,0,0,0,0,2,9,1,0,1,4,2,6
6430,791225,22,4,8,4,7,0,1,1,4,2,4,0,1,2,2,1,9
6430,796929,31,1,6,0,1,1,5,0,0,0,2,3,0,1,1,0,3
6430,791224,33,7,18,7,13,0,5,1,2,0,6,8,3,1,5,0,15
6430,785564,23,1,5,1,1,0,4,2,2,1,3,1,2,0,1,0,4
6430,796927,23,4,6,1,1,3,5,0,0,1,2,0,2,1,1,0,11
6430,796928,21,2,5,0,1,2,4,0,0,0,2,1,1,0,0,0,6
6430,791222,19,3,6,2,5,1,1,0,0,1,0,3,1,0,2,0,7
6431,782133,20,5,10,3,5,2,5,0,1,1,0,3,1,1,0,0,12
6431,785123,22,5,8,5,8,0,0,1,1,2,4,5,2,0,1,1,11
6431,790990,19,6,8,4,4,2,4,0,0,0,2,3,3,1,1,0,14
6431,789219,24,4,8,1,2,3,6,0,0,0,0,4,0,3,1,0,11
6431,785059,24,1,3,1,2,0,1,0,0,1,6,6,0,3,0,0,2
6431,796624,9,2,6,2,5,0,1,0,0,1,0,1,2,0,1,0,4
6431,790989,9,0,2,0,1,0,1,0,0,0,2,0,0,1,1,0,0
6431,785305,6,1,1,0,0,1,1,0,0,1,1,0,0,0,1,0,3
6431,796622,11,3,6,3,6,0,0,0,0,1,2,0,2,0,0,1,6
6431,796623,19,1,5,1,3,0,2,0,0,0,6,2,0,0,1,0,2
6431,790988,10,2,3,1,2,1,1,3,4,1,4,1,1,0,1,0,8
6431,785303,19,4,7,1,1,3,6,2,2,0,1,1,1,0,0,0,13
6431,785122,8,1,3,0,0,1,3,0,0,0,0,0,0,2,1,0,3
6432,791281,31,2,9,2,7,0,2,4,4,1,4,6,2,1,4,0,8
6432,791278,32,2,3,0,0,2,3,0,0,1,3,0,3,0,0,1,6
6432,792276,19,1,8,1,5,0,3,0,0,2,1,0,0,1,2,0,2
6432,786026,16,2,6,2,5,0,1,1,2,1,1,1,4,2,0,0,5
6432,785507,25,2,8,1,1,1,7,0,0,0,3,0,0,0,0,1,5
6432,796534,9,0,0,0,0,0,0,1,2,0,0,0,1,0,0,0,1
6432,785764,14,4,6,4,6,0,0,1,1,3,1,0,1,0,0,0,9
6432,796536,15,3,3,3,3,0,0,1,2,1,2,0,3,1,3,1,7
6432,785763,2,0,0,0,0,0,0,0,0,0,0,0,1,0,0,0,0
6432,796537,2,0,0,0,0,0,0,0,0,0,0,0,1,0,0,0,0
6432,796535,3,0,1,0,1,0,0,0,0,0,0,0,0,0,0,0,0
6432,785398,14,2,3,2,3,0,0,1,2,0,2,0,0,1,2,0,5
6432,775814,18,2,7,1,4,1,3,0,0,0,2,1,0,0,0,0,5
6433,781579,17,2,4,1,3,1,1,0,0,1,4,2,0,0,0,0,5
6433,786731,21,5,9,5,9,0,0,4,5,1,4,1,2,0,2,5,14
6433,798023,17,1,4,1,2,0,2,1,1,1,2,2,2,0,0,0,3
6433,781584,36,4,7,4,7,0,0,0,0,0,2,2,2,1,0,0,8
6433,780347,35,2,10,1,6,1,4,2,3,1,4,4,3,3,3,0,7
6433,775696,22,5,9,3,6,2,3,1,1,1,3,0,1,1,1,0,13
6433,776481,17,3,3,3,3,0,0,3,5,3,2,1,3,2,1,2,9
6433,798017,1,0,0,0,0,0,0,0,0,0,0,0,0,0,1,0,0
6433,798008,26,4,6,2,2,2,4,0,0,1,0,4,1,1,3,0,10
6433,792358,6,0,0,0,0,0,0,0,0,0,1,1,0,0,0,0,0
6433,798021,1,0,0,0,0,0,0,0,0,0,0,0,0,0,0,0,0
6433,798026,1,0,0,0,0,0,0,0,0,0,0,0,0,0,0,0,0
6434,797842,18,1,7,1,5,0,2,2,2,3,1,2,2,0,1,0,4
6434,797849,36,7,11,2,4,5,7,2,2,1,1,3,0,0,4,2,21
6434,781537,26,3,7,2,4,1,3,1,2,0,2,1,3,1,2,0,8
6434,786079,32,6,9,2,4,4,5,0,0,1,5,6,4,1,3,0,16
6434,792202,38,5,10,2,4,3,6,0,0,0,1,2,3,0,0,0,13
6434,797848,11,1,3,1,2,0,1,2,4,2,2,1,3,0,0,1,4
6434,792201,1,0,0,0,0,0,0,0,0,0,0,0,0,0,0,0,0
6434,779986,24,1,8,1,8,0,0,0,0,2,5,0,2,1,1,4,2
6434,797836,4,1,2,1,1,0,1,0,0,0,0,0,0,0,0,0,2
6434,797847,7,0,1,0,0,0,1,0,0,1,2,0,0,0,0,0,0
6434,797838,3,0,1,0,1,0,0,0,0,0,2,0,1,0,0,0,0
6435,791352,29,3,6,1,2,2,4,0,0,0,5,0,2,1,2,0,8
6435,780455,20,6,9,6,9,0,0,4,6,3,5,1,2,0,1,0,16
6435,797251,26,3,8,1,3,2,5,0,0,3,3,3,1,0,3,2,8
6435,797247,35,3,7,1,2,2,5,3,4,0,1,5,0,2,0,0,11
6435,776297,31,5,11,4,8,1,3,5,6,1,3,6,1,1,1,0,16
6435,797250,0,0,0,0,0,0,0,0,0,0,0,0,0,0,0,0,0
6435,791355,4,1,2,0,1,1,1,0,0,0,0,0,0,0,0,0,3
6435,791354,6,0,1,0,1,0,0,3,6,3,0,0,2,1,1,0,3
6435,785837,14,1,4,1,4,0,0,2,2,1,3,0,2,0,1,1,4
6435,786227,8,1,3,1,3,0,0,0,1,4,2,1,0,1,0,0,2
6435,797249,3,0,1,0,1,0,0,0,0,0,0,0,0,0,0,0,0
6435,797248,24,4,8,1,2,3,6,0,2,1,0,2,1,1,0,0,11
6436,783072,18,4,6,4,6,0,0,2,5,0,3,2,4,1,0,0,10
6436,774879,23,6,12,4,9,2,3,3,4,3,3,1,4,0,0,2,17
6436,791540,27,6,9,5,8,1,1,4,4,0,2,2,2,1,3,0,17
6436,787782,31,7,11,5,5,2,6,0,0,0,4,1,2,0,1,1,16
6436,776068,40,8,11,7,9,1,2,0,0,0,3,2,3,0,4,0,17
6436,797817,28,5,7,4,5,1,2,3,5,1,6,2,1,2,2,1,14
6436,785962,0,0,0,0,0,0,0,0,0,0,0,0,0,0,0,1,0
6436,781463,15,1,2,1,1,0,1,0,0,0,2,1,3,2,0,0,2
6436,792153,18,1,2,1,2,0,0,1,1,0,1,1,0,0,0,0,3
6437,791652,18,3,8,3,8,0,0,11,12,2,1,2,3,0,1,1,17
6437,786495,17,7,9,3,3,4,6,0,0,1,5,0,2,0,3,0,18
6437,797285,26,3,7,0,0,3,7,1,3,0,0,1,0,0,0,0,10
6437,791650,35,5,8,3,6,2,2,3,4,2,3,1,3,1,2,0,15
6437,776384,39,4,11,1,7,3,4,4,6,0,1,7,0,0,5,0,15
6437,791653,33,4,6,3,3,1,3,1,2,0,5,3,4,1,0,0,10
6437,791654,1,0,0,0,0,0,0,0,0,0,0,0,0,0,0,0,0
6437,775705,17,1,2,1,2,0,0,0,0,2,1,0,3,0,0,1,2
6437,797289,0,0,0,0,0,0,0,1,2,0,0,0,1,0,0,0,1
6437,797286,11,0,3,0,0,0,3,0,0,0,1,1,1,0,1,0,0
6437,797283,3,0,1,0,0,0,1,0,0,0,0,0,0,0,0,0,0
6438,796404,31,7,13,7,13,0,0,1,2,4,7,3,4,3,1,3,15
6438,790853,25,6,7,6,7,0,0,2,2,1,1,0,5,2,1,0,14
6438,790850,32,6,12,1,3,5,9,2,3,0,0,4,3,0,1,0,19
6438,781164,30,4,9,2,5,2,4,7,7,0,4,8,3,3,0,0,17
6438,781163,32,6,12,3,5,3,7,1,1,0,2,7,2,3,0,0,16
6438,790849,9,0,1,0,1,0,0,0,0,0,0,2,3,0,2,0,0
6438,790854,11,0,1,0,1,0,0,1,2,0,3,0,0,0,0,0,1
6438,785434,11,2,6,1,4,1,2,2,2,1,1,0,0,0,0,0,7
6438,790848,5,0,1,0,1,0,0,0,0,0,1,0,1,0,0,0,0
6438,796406,5,1,1,1,1,0,0,0,0,1,0,0,0,0,0,0,2
6438,781223,9,0,2,0,0,0,2,0,0,0,1,1,0,0,0,0,0
6439,786772,17,3,3,3,3,0,0,0,0,1,3,0,3,0,1,0,6
6439,785441,8,0,1,0,1,0,0,0,0,1,0,0,1,0,0,0,0
6439,786769,33,2,6,1,4,1,2,8,8,0,4,2,3,1,1,0,13
6439,786024,27,5,11,5,6,0,5,4,4,1,1,2,0,0,2,0,14
6439,780002,30,1,7,1,3,0,4,0,0,0,1,2,3,1,4,0,2
6439,781484,23,3,5,1,2,2,3,0,0,1,3,1,3,0,1,1,8
6439,786773,18,0,2,0,2,0,0,0,0,0,6,1,2,0,1,1,0
6439,791967,25,8,13,6,9,2,4,4,4,1,3,1,0,1,4,0,22
6439,790823,18,1,3,1,1,0,2,4,6,1,3,1,2,0,0,0,6
6439,797840,1,0,0,0,0,0,0,0,0,0,0,0,0,0,0,0,0
6440,786550,39,3,11,2,6,1,5,1,2,1,2,0,2,3,4,0,8
6440,776054,20,5,9,4,5,1,4,0,0,3,7,1,5,1,2,1,11
6440,792007,30,4,5,4,4,0,1,1,2,2,3,0,3,0,0,0,9
6440,792009,38,5,18,4,16,1,2,2,2,0,2,1,2,1,3,0,13
6440,792006,33,5,11,5,11,0,0,2,6,1,3,6,3,1,2,0,12
6440,780177,15,2,4,2,4,0,0,0,0,1,0,0,5,1,2,0,4
6440,786552,15,0,1,0,0,0,1,1,2,0,2,1,0,0,0,1,1
6440,776273,8,0,1,0,1,0,0,0,0,0,1,0,2,0,0,0,0
6440,792011,2,0,1,0,1,0,0,0,1,0,0,0,1,0,0,0,0
6441,790799,17,2,3,2,3,0,0,0,1,0,1,0,2,2,2,0,4
6441,790798,32,8,12,8,11,0,1,5,8,1,4,1,2,0,2,1,21
6441,780140,30,3,7,1,2,2,5,6,7,0,2,1,4,2,3,1,14
6441,796355,39,6,12,4,6,2,6,5,7,2,7,3,3,1,2,0,19
6441,780137,31,2,6,2,5,0,1,4,4,0,8,0,2,0,2,0,8
6441,785245,32,1,5,1,2,0,3,0,0,1,1,3,2,1,3,1,2
6441,775553,19,2,4,2,3,0,1,2,2,0,1,2,1,0,0,0,6
6441,799892,0,0,0,0,0,0,0,0,0,0,1,0,0,0,0,0,0
6441,796354,0,1,1,1,1,0,0,0,0,0,0,0,0,0,0,0,2
6441,790795,0,0,0,0,0,0,0,0,0,0,0,0,0,0,0,0,0
6441,796359,0,0,0,0,0,0,0,0,0,0,0,0,0,0,0,0,0
6442,785392,33,2,9,2,5,0,4,6,7,1,5,5,3,1,5,0,10
6442,775142,33,6,12,4,9,2,3,7,8,4,3,1,5,2,3,1,21
6442,790843,20,5,8,4,5,1,3,0,1,0,4,2,1,0,4,0,11
6442,786212,36,4,13,3,8,1,5,3,4,6,5,1,4,1,1,0,12
6442,790844,15,0,3,0,3,0,0,0,0,2,2,2,5,1,0,1,0
6442,799986,14,1,1,1,1,0,0,0,0,0,1,0,4,0,1,1,2
6442,790847,9,1,2,1,2,0,0,2,2,1,0,0,4,0,1,0,4
6442,781563,27,5,7,4,5,1,2,0,0,0,0,0,2,0,1,0,11
6442,796914,13,0,0,0,0,0,0,0,0,0,0,1,0,1,0,0,0
6443,797823,22,1,2,1,1,0,1,2,2,2,3,1,3,0,1,0,4
6443,780505,39,7,13,5,7,2,6,7,9,0,0,4,3,3,4,0,23
6443,792283,15,3,5,0,1,3,4,0,0,1,2,2,2,0,2,0,9
6443,797829,24,2,9,2,9,0,0,2,2,2,3,0,5,0,2,0,6
6443,792280,33,2,11,0,5,2,6,8,10,0,2,1,4,2,3,0,14
6443,797831,25,2,4,1,2,1,2,0,0,1,3,2,2,0,0,1,5
6443,792284,12,0,0,0,0,0,0,1,3,0,1,3,0,0,1,0,1
6443,792286,13,1,1,1,1,0,0,1,4,1,0,0,3,0,0,0,3
6443,785950,17,3,4,1,1,2,3,1,1,1,1,1,2,0,2,0,9
6458,796860,35,5,13,5,13,0,0,2,3,3,5,4,3,1,3,1,12
6458,791183,6,1,1,1,1,0,0,0,0,1,1,0,4,0,1,0,2
6458,796861,34,4,10,0,1,4,9,0,0,1,3,1,2,0,2,0,12
6458,785650,30,3,6,0,1,3,5,0,0,0,1,2,2,1,0,0,9
6458,785649,39,5,15,3,11,2,4,13,16,1,6,3,1,1,3,0,25
6458,791187,30,7,9,7,9,0,0,3,5,1,6,0,5,1,3,2,17
6458,775208,8,0,0,0,0,0,0,1,2,0,1,0,3,0,1,0,1
6458,796857,6,0,1,0,0,0,1,0,0,0,0,0,1,0,0,0,0
6458,796856,16,1,4,1,3,0,1,0,0,0,2,1,4,1,0,0,2
6458,791184,21,1,2,1,2,0,0,0,0,0,0,1,2,3,3,0,2
6459,786481,24,6,9,6,8,0,1,2,5,2,5,1,5,0,2,0,14
6459,797626,38,8,16,8,15,0,1,3,5,3,4,3,1,3,6,0,19
6459,797624,27,2,3,1,1,1,2,0,2,1,6,3,1,1,2,2,5
6459,786480,33,2,5,0,2,2,3,2,2,0,4,0,4,1,1,0,8
6459,781032,35,3,9,1,5,2,4,0,0,0,2,2,2,2,2,0,8
6459,797628,24,1,6,1,3,0,3,10,11,0,5,1,3,0,1,0,12
6459,791793,7,1,2,1,2,0,0,0,0,1,1,0,1,1,0,0,2
6459,791791,15,3,4,1,1,2,3,1,1,0,0,0,4,0,1,0,9
6459,797627,2,0,0,0,0,0,0,0,0,0,0,0,1,0,0,0,0
6459,785965,20,3,4,1,1,2,3,0,1,0,2,2,1,2,1,0,8
6460,791704,34,5,11,4,9,1,2,2,4,0,2,1,4,2,1,1,13
6460,785836,39,7,13,2,5,5,8,0,1,2,3,2,2,0,1,1,19
6460,785833,38,5,9,4,6,1,3,1,2,0,7,1,2,0,1,0,12
6460,785332,10,1,2,1,1,0,1,0,0,1,0,0,0,0,1,0,2
6460,775872,3,0,1,0,0,0,1,0,0,0,1,0,0,0,0,0,0
6460,791707,32,2,6,2,4,0,2,1,1,0,3,8,5,1,3,0,5
6460,785892,22,5,8,4,5,1,3,5,10,0,0,3,4,1,1,0,16
6460,797533,2,0,0,0,0,0,0,0,0,0,0,0,1,0,0,0,0
6460,785838,20,1,4,1,4,0,0,0,0,0,0,0,3,0,2,0,2
6461,786410,39,2,5,2,4,0,1,2,2,0,3,1,1,0,1,0,6
6461,791605,32,3,5,2,3,1,2,1,1,0,6,2,4,2,1,0,8
6461,791606,33,6,11,2,5,4,6,3,4,1,2,2,0,0,0,1,19
6461,791603,5,1,2,0,1,1,1,0,0,0,3,0,0,1,0,0,3
6461,797020,15,1,2,1,2,0,0,1,2,0,3,0,1,1,2,1,3
6461,797021,14,1,2,1,2,0,0,0,0,0,0,1,0,1,0,0,2
6461,791843,7,0,1,0,1,0,0,0,0,0,1,1,2,0,2,1,0
6461,786406,30,7,14,6,12,1,2,3,3,1,4,3,3,1,3,1,18
6461,792392,15,3,5,3,5,0,0,3,5,1,3,1,3,0,0,0,9
6461,775095,10,3,3,3,3,0,0,0,0,0,1,1,3,0,3,1,6
6462,797701,17,1,1,1,1,0,0,3,4,1,1,2,1,0,1,2,5
6462,792101,36,3,12,2,9,1,3,1,2,0,0,3,4,0,1,0,8
6462,792102,33,4,7,1,2,3,5,2,2,1,2,0,1,0,1,0,13
6462,775564,30,5,10,5,8,0,2,5,5,2,8,2,4,0,1,0,15
6462,776386,32,4,7,4,5,0,2,1,2,1,9,3,2,1,3,0,9
6462,797700,25,4,11,4,11,0,0,2,2,4,0,1,4,3,4,0,10
6462,780922,21,0,2,0,2,0,0,0,0,0,4,0,4,2,1,1,0
6462,786165,2,0,1,0,1,0,0,0,0,0,0,0,0,0,0,0,0
6462,786156,3,0,1,0,0,0,1,0,0,0,0,0,0,0,0,0,0
6462,786160,26,6,9,2,4,4,5,5,7,2,1,2,4,1,2,0,21
6463,792388,6,0,1,0,1,0,0,0,0,0,0,0,5,0,0,0,0
6463,781533,40,3,10,2,5,1,5,0,0,5,3,2,3,0,0,0,7
6463,797845,32,2,9,0,1,2,8,6,7,0,3,1,1,2,1,0,12
6463,797851,33,7,16,3,9,4,7,2,4,1,3,1,2,0,1,0,20
6463,792395,44,7,15,7,13,0,2,11,14,8,4,3,4,0,3,0,25
6463,792393,27,2,7,2,4,0,3,3,4,1,4,4,5,0,3,0,7
6463,792391,38,5,9,5,9,0,0,3,3,1,7,1,2,1,5,1,13
6463,792396,5,0,0,0,0,0,0,0,0,0,0,0,0,0,0,0,0
6464,796657,20,1,4,1,4,0,0,2,2,0,3,0,3,0,0,0,4
6464,796650,35,6,10,6,10,0,0,3,4,3,4,2,3,0,1,1,15
6464,791323,26,1,4,1,2,0,2,0,0,0,3,7,2,1,0,1,2
6464,791320,37,10,23,8,16,2,7,4,7,1,4,1,2,1,1,0,26
6464,781511,33,6,11,5,6,1,5,0,0,0,3,2,1,1,1,1,13
6464,796651,5,1,1,1,1,0,0,0,0,0,2,0,3,0,0,0,2
6464,796654,4,1,1,1,1,0,0,0,0,0,0,0,0,1,0,0,2
6464,791321,20,0,1,0,1,0,0,0,0,3,2,1,1,0,1,0,0
6464,785912,20,3,9,2,5,1,4,0,0,0,1,3,3,1,3,0,7
6465,775110,38,5,8,5,8,0,0,5,8,2,9,0,3,0,4,0,15
6465,791392,35,1,2,1,2,0,0,0,0,1,2,6,3,0,0,0,2
6465,785936,33,3,5,0,1,3,4,0,0,0,5,1,1,1,1,1,9
6465,780128,33,7,16,6,11,1,5,6,6,0,4,1,1,3,1,0,21
6465,775458,39,5,10,1,3,4,7,11,13,0,3,6,2,1,2,0,25
6465,786062,2,0,1,0,1,0,0,0,0,0,0,0,1,0,0,0,0
6465,797135,7,0,1,0,0,0,1,0,0,0,0,0,1,0,0,0,0
6465,785264,11,3,9,1,6,2,3,0,0,1,0,1,2,0,0,0,8
6465,797138,2,0,0,0,0,0,0,0,0,0,0,0,0,0,0,0,0
6466,786792,32,2,2,2,2,0,0,2,5,3,5,0,1,2,0,0,6
6466,789020,38,12,21,7,9,5,12,0,1,0,3,1,1,1,3,0,29
6466,786787,39,9,17,1,6,8,11,4,4,1,1,3,1,0,4,0,30
6466,781456,18,0,1,0,1,0,0,0,0,0,0,2,0,0,1,0,0
6466,774954,30,2,3,2,3,0,0,2,2,0,5,7,2,2,1,0,6
6466,792414,12,1,3,0,0,1,3,0,0,0,2,0,0,1,0,0,3
6466,792091,28,2,4,0,1,2,3,2,2,0,2,2,1,1,0,1,8
6466,786795,3,0,0,0,0,0,0,0,0,0,0,0,0,0,0,0,0
6467,780521,28,2,5,1,2,1,3,0,0,1,2,4,0,2,1,0,5
6467,775163,14,1,1,1,1,0,0,0,1,0,0,1,0,0,2,0,2
6467,791370,20,3,8,2,4,1,4,0,0,1,2,2,2,1,3,0,7
6467,786199,36,3,9,0,3,3,6,2,6,0,9,0,3,0,3,1,11
6467,780991,36,7,13,6,7,1,6,2,2,1,4,2,0,2,2,2,17
6467,780145,19,2,2,2,2,0,0,0,0,2,1,2,3,0,0,0,4
6467,781611,7,0,0,0,0,0,0,0,0,0,1,0,1,0,0,0,0
6467,797271,18,6,10,1,1,5,9,0,0,1,1,2,2,1,2,0,17
6467,743593,21,4,5,3,3,1,2,0,0,1,1,4,4,1,1,0,9
6467,791371,1,0,0,0,0,0,0,0,0,0,0,0,0,0,0,0,0
6468,784268,21,2,6,2,5,0,1,0,0,1,3,1,2,0,2,0,4
6468,786318,23,3,8,0,1,3,7,0,0,0,2,4,0,1,1,0,9
6468,780223,23,7,10,4,5,3,5,2,2,1,1,4,1,3,0,0,19
6468,791482,21,2,4,1,2,1,2,1,2,1,2,2,0,1,0,1,6
6468,786319,18,7,8,7,8,0,0,3,4,5,4,2,2,1,0,0,17
6468,797198,11,2,4,2,3,0,1,3,3,1,1,1,2,0,1,0,7
6468,791481,11,0,1,0,1,0,0,0,0,1,1,1,2,1,1,0,0
6468,780225,19,2,6,0,1,2,5,0,0,0,2,2,0,0,0,0,6
6468,797200,8,2,4,0,0,2,4,0,0,0,0,0,0,0,0,0,6
6468,797199,16,4,5,4,5,0,0,0,0,0,4,2,0,1,0,0,8
6468,797201,5,0,2,0,0,0,2,0,0,0,1,0,0,0,0,0,0
6468,791479,4,1,2,1,2,0,0,0,0,0,0,0,0,0,0,0,2
6468,791480,4,0,1,0,0,0,1,0,0,1,0,0,0,0,0,0,0
6468,786317,5,1,2,1,1,0,1,0,0,0,1,1,1,1,0,0,2
6468,786320,6,2,2,2,2,0,0,0,0,0,3,0,0,0,0,0,4
6468,796079,5,0,0,0,0,0,0,0,0,0,0,0,0,0,0,0,0
6470,791289,22,3,6,3,6,0,0,3,4,1,0,0,3,1,1,2,9
6470,796572,24,5,9,5,9,0,0,1,1,4,5,1,2,0,1,0,11
6470,796574,25,5,8,2,4,3,4,3,3,0,0,2,3,2,0,0,16
6470,796571,29,3,8,2,3,1,5,2,2,0,3,2,2,4,1,0,9
6470,781346,31,6,8,2,2,4,6,3,4,0,2,6,1,0,1,0,19
6470,785786,14,0,0,0,0,0,0,0,0,2,4,0,2,0,0,1,0
6470,791287,4,0,0,0,0,0,0,0,0,0,1,0,1,0,0,1,0
6470,796576,29,7,8,4,4,3,4,2,3,0,2,3,2,0,1,0,19
6470,796575,2,0,0,0,0,0,0,0,0,1,1,0,0,0,0,0,0
6470,791290,16,3,6,1,2,2,4,0,0,1,2,0,1,0,0,1,8
6470,791288,4,0,1,0,1,0,0,0,0,0,0,2,0,0,0,0,0
6471,797466,21,6,9,6,9,0,0,2,3,2,0,1,2,0,0,0,14
6471,791858,28,2,5,0,0,2,5,2,2,3,4,2,2,0,1,0,8
6471,797463,36,5,12,2,6,3,6,2,2,1,2,4,4,0,2,0,15
6471,791109,36,6,10,5,8,1,2,4,6,0,4,4,1,0,2,0,17
6471,785625,28,1,5,0,2,1,3,0,2,3,3,0,1,0,0,0,3
6471,797468,8,0,2,0,2,0,0,1,2,0,0,1,0,0,1,0,1
6471,797464,15,1,2,1,1,0,1,0,0,1,1,0,2,0,1,0,2
6471,797467,4,0,1,0,1,0,0,0,0,0,0,0,0,0,0,1,0
6471,797469,11,0,3,0,0,0,3,1,2,0,0,1,0,1,1,0,1
6471,797465,8,0,0,0,0,0,0,0,0,0,0,1,2,0,0,0,0
6471,791854,5,1,1,0,0,1,1,0,0,0,0,0,0,0,1,0,3
6472,799906,31,4,9,2,6,2,3,0,0,1,2,1,0,0,1,0,10
6472,775833,32,4,8,4,7,0,1,0,0,3,11,1,4,0,1,2,8
6472,785439,37,5,7,2,4,3,3,0,0,1,5,4,1,1,3,0,13
6472,781036,40,7,13,5,8,2,5,5,6,0,3,7,3,0,4,0,21
6472,774894,40,7,15,2,5,5,10,1,3,0,5,3,0,1,1,0,20
6472,796846,9,1,2,1,1,0,1,0,0,1,1,1,0,0,1,0,2
6472,796847,11,0,0,0,0,0,0,0,1,0,2,1,1,0,2,0,0
6473,791295,29,5,11,5,11,0,0,1,2,4,3,1,1,0,2,0,11
6473,776345,35,3,11,3,9,0,2,1,1,4,5,1,1,0,0,1,7
6473,796579,35,5,16,2,5,3,11,0,0,0,2,3,1,2,0,0,13
6473,785794,30,5,11,4,6,1,5,5,6,1,2,1,1,0,2,0,16
6473,781373,32,5,11,1,3,4,8,0,0,0,7,1,2,1,2,0,14
6473,791292,9,1,2,1,1,0,1,0,0,1,0,1,0,0,0,0,2
6473,791293,15,1,4,1,4,0,0,0,0,0,1,1,4,1,1,0,2
6473,796580,10,0,3,0,0,0,3,0,0,0,1,2,1,0,1,0,0
6473,796577,0,0,0,0,0,0,0,0,0,0,0,0,1,0,0,0,0
6473,785792,5,0,0,0,0,0,0,0,0,0,0,0,0,0,0,0,0
6474,781558,32,5,12,5,11,0,1,0,0,2,2,0,1,0,4,0,10
6474,775248,38,6,20,4,11,2,9,3,5,5,6,5,3,2,5,0,17
6474,797231,21,1,6,0,1,1,5,2,2,2,2,0,4,0,0,0,5
6474,791452,34,4,9,2,3,2,6,0,0,1,1,3,0,0,2,0,10
6474,791449,19,2,4,2,3,0,1,0,0,1,0,0,1,1,2,0,4
6474,797230,7,1,2,1,2,0,0,0,0,0,1,0,1,0,1,1,2
6474,791446,4,0,2,0,0,0,2,1,2,1,1,0,1,0,0,0,1
6474,797226,10,0,2,0,1,0,1,0,0,1,3,0,1,0,2,0,0
6474,797225,35,4,9,3,7,1,2,3,3,0,3,2,4,3,1,1,12
6475,790935,22,1,3,0,1,1,2,0,0,1,2,1,1,0,2,0,3
6475,792442,28,2,3,2,3,0,0,0,0,2,9,0,1,0,0,4,4
6475,780933,33,8,11,1,1,7,10,3,3,0,1,0,1,0,0,0,26
6475,775340,36,9,23,8,18,1,5,2,4,2,3,8,1,1,5,0,21
6475,774826,13,0,1,0,0,0,1,0,0,0,1,0,3,0,2,0,0
6475,796190,18,1,3,0,0,1,3,0,0,0,2,2,0,0,2,0,3
6475,790937,11,3,5,3,5,0,0,0,0,1,2,0,4,1,2,1,6
6475,785445,19,2,4,1,2,1,2,1,2,2,3,1,2,1,0,1,6
6475,790938,16,1,4,1,3,0,1,1,2,2,0,2,3,1,2,0,3
6475,796492,4,0,2,0,1,0,1,0,0,0,1,0,0,0,0,0,0
6476,780631,19,3,6,2,4,1,2,0,0,2,1,0,1,0,1,0,7
6476,791827,34,9,16,9,16,0,0,2,2,3,8,4,4,3,5,0,20
6476,797391,18,0,9,0,2,0,7,0,0,1,2,1,2,0,1,0,0
6476,786625,34,2,6,1,3,1,3,0,2,0,3,4,5,1,1,1,5
6476,780625,38,4,9,0,3,4,6,0,0,0,2,9,2,1,0,0,12
6476,785481,24,6,9,5,6,1,3,4,4,3,2,3,0,3,3,3,17
6476,797395,14,1,4,0,1,1,3,0,0,0,1,2,1,0,2,0,3
6476,797394,21,6,8,6,7,0,1,0,1,1,2,0,3,0,1,1,12
6476,786630,23,1,4,1,4,0,0,0,0,1,2,0,3,0,2,0,2
6477,780686,40,7,12,7,12,0,0,4,8,1,6,5,3,2,6,1,18
6477,780683,23,5,6,2,2,3,4,0,0,0,3,2,2,1,1,0,13
6477,797681,27,0,3,0,3,0,0,4,4,1,2,5,1,3,0,0,4
6477,797680,17,0,2,0,1,0,1,2,2,0,1,1,2,0,1,0,2
6477,780688,29,5,7,5,6,0,1,0,0,2,4,0,2,1,2,0,10
6477,797683,9,1,1,0,0,1,1,0,0,0,1,0,1,0,2,0,3
6477,797677,15,3,4,1,2,2,2,0,0,1,2,0,1,0,0,0,8
6477,791942,20,0,2,0,2,0,0,2,2,0,1,2,2,0,1,0,2
6477,786112,27,4,16,1,11,3,5,9,10,1,2,1,1,0,3,1,20
6477,780689,18,2,2,2,2,0,0,0,0,1,6,0,1,0,1,0,4
6478,786296,21,1,2,0,1,1,1,0,0,0,1,0,2,1,0,0,3
6478,781530,25,5,10,4,8,1,2,5,5,1,4,1,0,2,0,4,16
6478,776423,26,4,8,4,8,0,0,0,2,1,7,2,1,0,1,0,8
6478,792307,18,1,4,0,1,1,3,0,2,0,0,1,2,0,1,1,3
6478,792319,18,1,5,0,1,1,4,1,2,1,3,1,2,0,2,0,4
6478,792316,4,0,0,0,0,0,0,2,2,0,1,0,0,0,0,2,2
6478,792314,10,0,1,0,1,0,0,2,2,1,1,0,0,0,1,0,2
6478,792320,9,1,2,1,2,0,0,1,2,1,0,0,1,0,0,1,3
6478,798106,18,2,4,2,3,0,1,0,0,0,1,2,1,0,0,0,4
6478,798104,21,2,5,1,4,1,1,3,5,0,1,2,0,2,2,0,8
6478,798096,19,3,8,3,6,0,2,5,6,2,0,1,1,1,1,0,11
6478,792309,6,2,2,2,2,0,0,0,0,0,1,0,1,0,1,0,4
6478,792321,5,1,2,1,2,0,0,0,0,2,1,2,0,0,1,0,2
6479,791053,13,3,7,3,7,0,0,0,2,0,2,1,4,0,1,0,6
6479,780739,17,2,5,2,5,0,0,0,0,1,2,0,2,0,1,0,4
6479,785524,28,3,4,1,1,2,3,0,0,1,4,1,4,0,2,0,8
6479,781115,28,2,3,2,3,0,0,0,0,0,0,6,2,1,3,0,4
6479,775456,18,1,7,1,6,0,1,4,4,1,1,0,2,3,2,0,6
6479,796731,16,3,10,3,9,0,1,0,0,3,4,0,0,1,0,1,6
6479,796730,7,0,1,0,1,0,0,0,0,0,0,0,0,0,0,0,0
6479,785784,2,0,0,0,0,0,0,0,0,0,0,0,0,0,1,0,0
6479,791051,13,1,2,1,2,0,0,0,0,1,1,0,3,1,2,0,2
6479,791052,7,0,1,0,1,0,0,0,0,0,2,0,2,0,1,1,0
6479,790819,22,3,7,2,6,1,1,0,0,0,3,1,2,1,1,1,7
6479,786310,11,1,1,0,0,1,1,0,0,0,0,0,0,0,1,0,3
6479,775094,18,3,8,3,7,0,1,1,1,1,1,2,0,0,0,0,7
6480,787239,28,1,2,1,2,0,0,0,1,5,5,0,2,1,0,4,2
6480,789058,30,5,11,2,5,3,6,1,2,4,3,1,3,2,0,2,14
6480,785286,25,2,9,1,5,1,4,0,0,2,2,1,0,0,1,0,5
6480,797898,37,6,18,3,11,3,7,2,2,1,1,7,1,3,3,1,17
6480,792237,32,9,18,7,11,2,7,3,4,0,3,3,2,1,1,0,23
6480,797895,8,0,0,0,0,0,0,0,0,0,1,0,0,1,0,0,0
6480,792238,13,1,2,1,2,0,0,0,1,0,3,0,1,2,0,0,2
6480,785818,2,0,1,0,1,0,0,0,0,0,0,1,1,0,0,0,0
6480,792236,13,0,5,0,4,0,1,0,0,0,2,3,1,0,1,1,0
6480,792240,12,0,0,0,0,0,0,0,0,1,2,1,2,2,1,0,0
6481,791511,26,3,5,3,5,0,0,2,2,2,5,1,3,1,1,2,8
6481,778442,32,4,11,3,8,1,3,2,2,0,5,1,2,0,6,0,11
6481,797150,23,2,4,0,1,2,3,0,0,0,2,7,2,1,3,0,6
6481,780946,27,2,4,1,3,1,1,0,0,0,2,2,1,0,0,0,5
6481,786637,27,2,8,1,2,1,6,0,0,1,4,0,0,1,2,0,5
6481,797151,14,1,4,1,4,0,0,1,1,3,0,1,0,1,1,0,3
6481,791515,4,0,2,0,2,0,0,0,0,2,0,1,0,0,1,0,0
6481,797152,2,0,0,0,0,0,0,0,0,0,1,0,0,0,1,0,0
6481,797149,7,0,0,0,0,0,0,0,0,0,2,1,3,0,1,1,0
6481,791514,13,1,3,1,3,0,0,1,2,0,4,1,0,0,0,0,3
6481,791513,25,5,9,3,6,2,3,3,4,0,3,0,2,0,1,0,15
6482,792265,34,6,15,3,6,3,9,5,5,2,9,0,2,0,3,1,20
6482,786152,36,3,9,3,8,0,1,1,2,2,5,0,1,0,0,0,7
6482,798003,32,7,10,7,9,0,1,6,9,0,5,8,4,4,5,1,20
6482,798009,20,1,8,1,6,0,2,0,0,1,0,0,1,0,0,0,2
6482,798006,9,0,2,0,0,0,2,0,0,0,2,0,0,0,1,0,0
6482,798007,9,0,1,0,1,0,0,0,0,2,1,0,2,0,1,0,0
6482,792266,16,3,4,2,2,1,2,0,0,0,3,0,1,1,2,0,7
6482,792267,23,1,4,1,2,0,2,1,2,0,5,2,4,2,2,0,3
6482,792263,21,3,4,2,3,1,1,2,2,0,3,0,2,1,0,0,9
6483,785664,21,0,3,0,2,0,1,0,0,3,5,0,2,0,1,0,0
6483,785841,23,2,7,2,6,0,1,1,3,0,4,0,3,2,6,0,5
6483,796609,30,5,12,2,7,3,5,3,4,0,5,4,2,3,2,0,16
6483,796611,22,4,9,1,2,3,7,2,2,0,3,1,1,1,2,1,13
6483,792869,31,2,8,1,3,1,5,0,0,0,0,1,2,0,3,0,5
6483,796613,17,3,5,1,3,2,2,1,2,2,2,0,2,0,0,0,9
6483,792232,8,1,1,1,1,0,0,0,0,0,1,0,1,0,2,0,2
6483,791312,9,0,0,0,0,0,0,0,0,0,1,0,2,0,1,1,0
6483,781504,32,1,8,1,7,0,1,4,5,0,3,4,3,1,1,0,6
6483,766623,7,0,1,0,1,0,0,0,0,0,2,1,2,1,0,0,0
6484,796979,30,3,5,3,4,0,1,2,2,3,2,1,2,0,1,0,8
6484,776200,26,2,3,2,3,0,0,0,2,0,2,1,3,1,0,0,4
6484,786437,30,4,5,3,3,1,2,0,0,1,3,5,3,2,4,1,9
6484,785620,24,6,8,5,6,1,2,3,6,0,2,3,1,1,1,0,16
6484,781034,35,4,10,2,5,2,5,0,0,0,2,1,0,1,4,1,10
6484,791625,10,0,2,0,1,0,1,0,0,0,0,0,2,0,0,0,0
6484,796978,2,1,1,0,0,1,1,0,0,0,1,0,0,0,0,0,3
6484,791622,12,3,3,3,3,0,0,0,0,0,1,0,3,0,1,0,6
6484,791637,10,0,2,0,0,0,2,0,0,0,0,0,0,0,2,0,0
6484,780925,21,3,8,1,2,2,6,2,2,0,4,0,0,2,0,0,10
6485,780824,16,2,2,2,2,0,0,1,2,1,1,0,3,0,0,0,5
6485,791118,39,7,11,7,9,0,2,3,3,1,2,3,0,0,4,0,17
6485,785947,25,0,2,0,0,0,2,0,0,0,4,0,1,0,1,0,0
6485,785676,36,5,7,3,5,2,2,1,1,0,2,6,1,1,1,1,13
6485,774974,38,6,10,6,10,0,0,0,0,0,3,2,2,4,3,1,12
6485,796771,16,2,5,1,1,1,4,0,0,0,5,0,2,0,1,1,5
6485,791115,8,1,2,1,2,0,0,0,0,0,0,0,5,0,2,0,2
6485,791117,20,5,8,5,7,0,1,1,2,0,1,0,0,0,1,0,11
6485,791116,2,0,1,0,0,0,1,0,0,0,0,0,0,0,0,0,0
6486,791266,25,5,6,5,6,0,0,5,6,4,7,3,2,1,1,6,15
6486,791270,21,1,3,1,1,0,2,0,0,2,1,2,1,1,1,0,2
6486,791265,36,5,11,2,4,3,7,4,4,0,2,4,2,0,3,0,17
6486,791269,28,2,4,1,1,1,3,1,3,0,2,0,5,0,0,0,6
6486,785685,35,12,26,11,20,1,6,1,3,1,1,1,3,2,3,0,26
6486,796523,12,0,0,0,0,0,0,0,0,0,2,2,1,0,2,0,0
6486,796522,21,3,7,1,1,2,6,2,2,0,0,0,0,0,1,0,10
6486,791271,15,2,2,2,2,0,0,0,2,1,3,0,1,0,0,0,4
6486,781313,7,0,0,0,0,0,0,0,0,1,0,2,0,0,0,0,0
6487,781624,28,2,4,2,4,0,0,2,2,4,5,1,2,2,3,1,6
6487,792246,9,1,3,1,3,0,0,0,0,0,1,0,0,0,1,0,2
6487,797925,19,2,6,1,2,1,4,2,2,3,1,1,3,0,1,0,7
6487,781420,35,12,19,8,12,4,7,5,5,0,7,0,2,2,2,0,33
6487,781405,33,7,16,4,11,3,5,5,5,1,2,3,4,0,4,0,22
6487,797924,7,0,0,0,0,0,0,0,0,0,0,0,0,2,0,0,0
6487,781417,9,4,6,4,6,0,0,0,1,1,1,1,1,0,0,0,8
6487,780615,9,0,1,0,1,0,0,0,0,1,0,0,3,0,0,0,0
6487,791701,23,4,5,4,5,0,0,1,2,3,5,1,4,2,1,1,9
6487,792245,28,0,3,0,1,0,2,0,0,0,0,3,2,0,1,1,0
6488,792288,37,2,6,2,6,0,0,1,3,3,5,3,2,2,1,1,5
6488,785227,34,6,9,6,9,0,0,2,2,4,9,2,3,2,3,4,14
6488,786237,22,3,6,3,6,0,0,0,0,0,1,1,3,1,1,1,6
6488,786232,23,0,4,0,2,0,2,0,0,1,4,1,2,0,1,0,0
6488,780287,30,5,12,5,9,0,3,4,4,0,2,0,2,1,1,0,14
6488,798067,8,0,0,0,0,0,0,0,0,0,3,0,0,0,0,1,0
6488,792278,14,2,7,2,5,0,2,2,2,0,1,0,0,0,2,0,6
6488,776309,32,6,13,5,10,1,3,5,7,1,5,1,3,1,3,1,18
6489,780095,16,0,1,0,1,0,0,0,0,0,1,0,3,1,1,1,0
6489,776321,40,9,13,9,11,0,2,1,1,3,5,0,0,1,0,0,19
6489,786081,31,2,5,2,4,0,1,0,0,1,4,1,5,2,2,0,4
6489,785431,40,0,9,0,5,0,4,1,3,0,6,3,3,0,0,2,1
6489,780232,40,7,20,5,13,2,7,6,7,0,5,3,0,1,7,1,22
6489,785356,24,2,6,1,2,1,4,0,0,0,2,1,3,0,0,2,5
6489,789040,9,0,5,0,3,0,2,0,0,0,1,0,3,0,0,0,0
6490,791883,26,7,11,5,7,2,4,1,1,3,0,1,5,0,2,0,17
6490,781066,32,3,5,3,5,0,0,0,0,1,5,3,1,3,2,2,6
6490,797594,18,2,6,1,1,1,5,0,0,0,1,1,3,0,2,0,5
6490,791884,32,3,8,2,6,1,2,0,0,0,2,3,0,0,3,0,7
6490,780695,34,5,12,3,4,2,8,0,0,1,3,3,3,0,0,0,12
6490,797600,4,0,2,0,1,0,1,0,2,1,0,0,1,0,1,0,0
6490,797598,8,0,0,0,0,0,0,2,2,0,4,0,2,0,1,1,2
6490,791885,4,0,0,0,0,0,0,0,0,0,1,0,0,1,0,0,0
6490,797596,25,4,7,2,4,2,3,0,0,0,2,4,1,0,0,0,10
6490,786496,17,1,3,1,1,0,2,2,2,1,3,3,2,0,1,0,4
6491,791524,30,12,15,9,12,3,3,0,2,1,5,1,2,1,2,1,27
6491,797139,29,7,10,7,10,0,0,0,4,4,6,2,2,0,2,0,14
6491,775394,33,0,4,0,0,0,4,2,4,0,6,0,3,1,3,0,2
6491,791526,23,4,7,3,4,1,3,2,2,1,1,4,1,1,0,0,11
6491,780272,32,2,4,1,2,1,2,0,0,0,0,1,1,1,1,0,5
6491,785970,11,1,4,1,4,0,0,0,0,2,0,0,2,0,0,0,2
6491,791523,9,0,2,0,0,0,2,0,0,0,1,0,1,2,1,0,0
6491,780273,18,1,3,1,1,0,2,1,2,0,0,0,0,0,0,0,3
6491,775592,15,1,4,1,3,0,1,2,2,0,2,0,0,0,0,0,4
6492,781044,28,3,10,2,3,1,7,0,0,0,5,1,5,0,3,3,7
6492,791795,26,4,10,3,6,1,4,6,8,5,4,0,1,1,0,0,15
6492,786489,31,4,10,4,6,0,4,3,4,1,4,0,1,1,1,0,11
6492,786488,38,5,8,4,5,1,3,2,5,0,8,4,2,0,1,0,13
6492,781038,35,1,9,0,3,1,6,0,0,2,3,2,1,1,4,0,3
6492,797620,23,1,5,0,3,1,2,0,0,1,5,1,1,0,2,1,3
6492,786490,3,3,3,3,3,0,0,0,0,1,0,0,0,0,0,0,6
6492,797619,16,0,1,0,1,0,0,3,4,0,1,2,2,0,1,1,3
6493,786547,11,0,0,0,0,0,0,0,0,0,2,0,1,0,1,0,0
6493,786544,37,10,19,5,12,5,7,1,2,2,9,3,2,1,2,1,26
6493,797507,28,0,3,0,3,0,0,0,0,2,2,1,4,1,1,0,0
6493,792012,40,8,22,4,9,4,13,0,0,0,4,2,2,2,2,0,20
6493,775084,32,2,10,0,4,2,6,0,0,1,5,2,2,1,3,0,6
6493,797512,2,0,1,0,1,0,0,0,0,0,0,0,0,0,1,0,0
6493,786860,27,0,5,0,3,0,2,0,0,0,2,0,4,1,1,0,0
6493,786546,22,1,3,1,1,0,2,0,0,0,5,0,3,0,1,1,2
6493,797509,1,0,0,0,0,0,0,0,0,0,0,0,0,0,0,0,0
6494,797523,19,1,2,0,0,1,2,0,0,0,2,1,4,0,3,1,3
6494,785402,18,1,4,1,4,0,0,2,2,0,4,1,4,1,1,0,4
6494,797524,25,1,3,1,2,0,1,0,0,0,2,1,2,0,1,0,2
6494,792118,37,9,16,7,12,2,4,0,0,0,3,14,1,3,2,0,20
6494,782593,34,8,14,4,5,4,9,1,2,0,3,4,1,1,0,0,21
6494,785828,22,7,8,7,7,0,1,3,4,0,3,0,3,0,0,0,17
6494,791699,27,2,7,2,4,0,3,0,0,0,3,0,1,0,0,0,4
6494,791700,18,1,3,0,1,1,2,0,0,0,2,1,0,0,1,0,3
6495,781174,29,0,1,0,1,0,0,5,8,3,5,2,4,1,2,0,5
6495,781159,34,6,12,4,7,2,5,1,2,1,4,1,2,1,3,0,15
6495,791001,29,3,9,3,6,0,3,0,0,0,4,4,0,1,0,0,6
6495,781215,24,2,6,2,5,0,1,0,0,0,1,1,2,0,3,0,4
6495,775255,36,9,14,4,7,5,7,0,0,1,4,3,0,1,4,0,23
6495,785320,11,0,1,0,0,0,1,0,0,0,1,2,2,1,0,0,0
6495,785231,12,0,1,0,1,0,0,0,0,0,0,2,0,0,0,0,0
6495,779972,25,6,11,2,3,4,8,3,4,0,4,0,1,1,1,0,19
6496,796892,25,5,8,5,8,0,0,6,6,0,3,1,2,1,1,2,16
6496,796891,32,4,14,4,12,0,2,2,4,5,3,0,2,1,0,0,10
6496,796884,26,4,12,3,9,1,3,2,3,2,3,1,2,0,0,0,11
6496,796882,30,1,6,1,4,0,2,5,5,1,4,4,3,1,2,0,7
6496,790447,14,1,6,1,5,0,1,0,0,0,3,1,2,1,1,0,2
6496,796886,20,3,5,1,2,2,3,4,4,2,7,0,0,1,2,0,12
6496,796896,27,1,5,1,2,0,3,8,8,0,4,3,2,1,2,0,10
6496,796888,8,1,2,0,1,1,1,0,0,0,3,0,3,1,0,0,3
6496,796887,13,2,6,1,2,1,4,1,1,1,0,0,2,0,2,0,6
6496,796881,5,0,0,0,0,0,0,0,0,1,0,2,0,0,0,0,0
6497,797325,35,3,8,3,8,0,0,1,1,5,7,1,3,1,1,0,7
6497,781002,15,0,2,0,2,0,0,0,0,0,0,0,3,0,1,1,0
6497,797329,38,3,10,3,5,0,5,2,3,5,10,0,5,0,1,4,8
6497,797323,38,10,22,7,16,3,6,7,9,1,4,6,2,2,7,0,30
6497,780759,39,7,12,1,2,6,10,0,0,0,2,2,3,0,1,0,20
6497,786246,8,1,5,0,0,1,5,0,0,0,0,1,1,1,0,0,3
6497,797324,4,0,0,0,0,0,0,0,0,0,1,0,2,0,1,0,0
6497,797322,23,3,12,2,4,1,8,1,2,1,4,1,4,1,0,0,8
6498,791334,34,6,7,2,2,4,5,4,4,1,5,1,2,1,1,0,20
6498,785874,28,5,6,5,6,0,0,4,4,2,7,2,2,0,3,1,14
6498,780256,24,4,6,2,4,2,2,4,6,0,4,3,2,1,1,0,14
6498,791757,18,2,5,2,3,0,2,1,2,0,1,0,2,0,2,0,5
6498,796883,21,1,3,1,1,0,2,2,2,0,3,2,1,0,1,0,4
6498,796880,22,4,8,2,4,2,4,3,5,2,1,0,1,0,4,0,13
6498,791760,12,3,6,3,5,0,1,0,0,1,3,0,4,0,1,0,6
6498,796879,19,2,4,1,2,1,2,0,1,1,4,3,1,0,0,0,5
6498,781590,14,1,2,1,1,0,1,1,2,0,2,3,1,0,1,0,3
6498,796885,6,0,1,0,1,0,0,0,0,0,0,1,0,1,0,0,0
6498,785876,2,0,0,0,0,0,0,0,0,0,0,0,0,0,0,0,0
6499,791043,25,6,12,3,6,3,6,0,0,0,2,3,4,0,2,0,15
6499,791042,20,4,10,2,7,2,3,4,4,0,0,0,4,0,0,1,14
6499,775412,25,4,8,0,0,4,8,0,0,0,2,0,3,2,0,1,12
6499,776374,24,3,6,2,4,1,2,1,1,0,0,3,1,1,1,0,8
6499,774834,27,1,2,1,2,0,0,3,4,1,3,3,2,1,3,0,5
6499,785512,16,3,5,3,5,0,0,0,0,1,2,0,0,1,2,0,6
6499,796723,18,1,3,1,2,0,1,2,2,1,1,1,1,0,0,0,4
6499,796718,13,1,5,1,2,0,3,0,1,0,1,3,2,1,0,0,2
6499,796719,11,1,2,1,1,0,1,0,0,1,0,0,2,0,0,0,2
6499,796717,16,0,4,0,3,0,1,0,0,0,3,3,3,1,0,0,0
6499,796720,5,0,1,0,1,0,0,0,0,0,0,0,1,0,0,0,0
6514,791839,26,4,5,4,5,0,0,0,0,1,6,3,3,0,2,2,8
6514,785322,28,4,10,1,2,3,8,0,0,1,2,0,2,0,0,0,11
6514,797444,27,1,5,0,2,1,3,3,4,1,3,3,2,1,0,0,6
6514,792381,30,5,11,2,6,3,5,1,1,0,3,0,2,1,2,0,14
6514,791842,25,10,19,4,8,6,11,3,4,1,6,1,3,0,1,0,29
6514,797443,17,5,6,5,6,0,0,2,2,3,3,1,3,1,1,0,12
6514,797442,6,0,2,0,0,0,2,0,0,0,2,1,0,0,0,0,0
6514,786613,18,3,5,3,3,0,2,0,0,0,5,4,0,1,1,0,6
6514,786736,21,0,1,0,0,0,1,0,0,0,5,6,0,0,1,0,0
6514,791840,1,1,1,1,1,0,0,0,0,0,1,0,0,0,0,0,2
6514,791841,1,0,0,0,0,0,0,0,0,0,0,1,0,0,0,0,0
6515,797662,20,5,11,4,9,1,2,4,6,1,3,0,2,1,0,2,15
6515,786067,30,2,9,2,9,0,0,5,6,1,4,2,1,0,0,0,9
6515,797661,26,3,12,3,6,0,6,0,0,0,3,2,3,1,1,1,6
6515,785591,30,5,9,2,5,3,4,2,3,0,3,1,2,0,3,0,15
6515,780258,24,1,4,1,2,0,2,1,2,0,3,1,1,1,0,0,3
6515,792082,18,2,4,1,2,1,2,0,0,1,2,2,3,0,2,0,5
6515,791952,7,0,0,0,0,0,0,0,0,1,2,0,0,0,0,0,0
6515,797660,19,3,7,2,5,1,2,0,2,0,2,1,2,1,0,0,7
6515,792083,13,0,3,0,3,0,0,0,0,0,0,2,0,0,0,0,0
6515,792078,9,1,1,1,1,0,0,0,0,1,2,0,0,0,0,0,2
6515,797659,1,0,0,0,0,0,0,0,0,0,0,0,0,0,0,0,0
6515,792079,2,0,0,0,0,0,0,0,0,0,0,0,0,0,0,0,0
6515,774898,1,0,1,0,1,0,0,0,0,0,0,0,0,0,0,0,0
6516,792593,28,5,9,5,8,0,1,0,5,2,6,2,3,0,5,0,10
6516,792594,32,2,6,2,4,0,2,2,2,0,6,1,3,0,1,2,6
6516,792588,31,3,4,1,1,2,3,0,1,0,3,0,2,0,0,1,8
6516,792595,35,4,10,2,4,2,6,5,7,2,6,7,1,2,3,0,15
6516,792583,32,2,7,1,1,1,6,0,0,1,3,1,0,1,1,1,5
6516,792580,12,2,4,2,4,0,0,0,0,0,2,1,3,0,0,3,4
6516,796987,13,5,7,4,6,1,1,0,0,0,1,0,1,0,2,0,11
6516,792591,17,0,3,0,2,0,1,0,0,0,0,0,0,0,0,0,0
6517,792100,15,1,7,1,7,0,0,3,4,6,3,3,0,1,2,0,5
6517,786131,19,1,9,1,7,0,2,0,0,2,2,1,0,0,3,0,2
6517,797688,28,2,8,1,3,1,5,0,0,3,6,0,2,0,3,0,5
6517,786145,26,2,8,1,2,1,6,0,0,0,2,1,1,1,1,0,5
6517,786128,37,5,10,2,5,3,5,1,2,1,5,3,4,3,3,0,14
6517,797684,2,0,0,0,0,0,0,0,0,0,0,0,1,0,0,0,0
6517,785884,21,3,6,2,3,1,3,2,4,0,3,1,3,2,0,1,9
6517,780904,20,1,3,1,3,0,0,1,2,2,5,1,4,0,2,0,3
6517,797685,30,4,9,1,6,3,3,0,0,0,1,3,2,1,0,0,11
6517,792096,2,0,1,0,0,0,1,0,0,0,0,0,0,0,0,0,0
6518,792227,25,4,7,4,5,0,2,1,1,1,3,2,2,2,6,1,9
6518,781352,15,3,6,3,6,0,0,4,4,1,0,1,4,0,0,0,10
6518,792223,34,4,11,3,6,1,5,0,0,0,4,2,2,1,3,0,9
6518,785935,34,4,9,3,8,1,1,0,0,0,5,4,1,0,0,0,9
6518,781340,36,3,4,2,3,1,1,0,0,0,6,0,2,2,1,0,7
6518,797881,10,2,3,2,3,0,0,0,2,0,2,0,3,1,1,2,4
6518,797889,14,2,4,2,4,0,0,0,0,2,1,0,2,0,0,0,4
6518,781351,15,1,3,0,1,1,2,2,2,0,2,1,2,0,0,0,5
6518,776128,17,0,2,0,0,0,2,0,0,0,0,5,1,1,1,0,0
6519,791493,34,2,2,2,2,0,0,0,1,2,9,1,3,3,2,0,4
6519,789036,25,5,9,5,9,0,0,2,2,1,1,1,3,1,2,1,12
6519,791494,17,1,6,1,4,0,2,0,2,0,1,1,2,0,0,0,2
6519,786324,15,2,3,0,1,2,2,0,0,1,1,1,0,0,2,0,6
6519,776494,36,2,7,1,3,1,4,2,2,1,1,2,2,1,2,0,7
6519,781307,6,0,1,0,1,0,0,1,2,1,0,0,2,0,1,0,1
6519,791495,12,0,2,0,0,0,2,1,2,0,0,0,0,0,1,0,1
6519,791492,23,3,7,2,3,1,4,2,3,0,2,0,1,1,4,0,9
6519,778888,32,2,7,1,3,1,4,0,0,0,3,0,2,0,1,0,5
6520,775556,39,6,17,4,7,2,10,4,6,2,9,6,1,2,3,1,18
6520,780234,31,5,8,5,8,0,0,3,8,3,4,1,3,1,0,1,13
6520,786405,35,2,7,2,5,0,2,1,1,4,0,3,1,1,2,0,5
6520,786411,33,2,11,1,2,1,9,0,0,4,1,4,1,2,0,0,5
6520,780046,38,6,18,1,5,5,13,0,0,1,1,2,3,3,5,0,17
6520,781110,13,0,4,0,4,0,0,2,4,1,2,0,1,0,1,2,2
6520,786328,1,0,0,0,0,0,0,0,0,0,0,0,1,0,1,1,0
6520,797185,10,1,2,1,1,0,1,0,0,1,1,0,2,0,0,0,2
6521,796959,20,3,5,3,5,0,0,0,0,0,7,0,2,0,1,1,6
6521,781272,33,7,11,5,9,2,2,1,1,2,4,3,2,1,2,3,17
6521,791261,26,4,12,3,6,1,6,0,0,0,1,1,2,0,0,1,9
6521,785501,22,4,9,3,5,1,4,2,4,1,4,2,3,1,2,1,11
6521,781270,39,5,11,3,6,2,5,1,2,1,1,7,0,1,2,0,13
6521,796960,13,4,5,4,5,0,0,2,3,3,2,1,2,0,0,0,10
6521,791260,8,1,2,1,2,0,0,0,0,0,1,0,3,0,1,0,2
6521,796958,23,1,3,0,2,1,1,2,4,3,4,2,1,2,1,0,5
6521,791258,9,0,0,0,0,0,0,2,2,0,2,1,0,0,2,0,2
6521,785503,3,1,1,1,1,0,0,0,0,0,1,0,0,0,0,0,2
6521,799825,2,0,0,0,0,0,0,0,0,0,0,0,0,0,1,0,0
6521,785502,2,0,0,0,0,0,0,0,0,0,0,0,0,0,0,0,0
6522,792036,16,1,4,1,4,0,0,0,0,1,1,1,2,1,1,0,2
6522,792043,20,1,4,0,2,1,2,0,0,1,2,0,1,0,0,0,3
6522,786266,33,7,13,5,10,2,3,8,9,0,3,1,1,1,3,1,24
6522,797718,28,2,6,2,5,0,1,3,3,2,2,1,0,0,0,0,7
6522,775028,23,5,11,4,9,1,2,1,3,0,5,6,3,1,3,2,12
6522,797728,21,1,3,0,1,1,2,0,0,1,2,1,3,0,2,0,3
6522,786039,23,1,5,1,5,0,0,4,8,7,4,0,2,0,4,0,6
6522,797719,9,1,3,0,0,1,3,0,0,0,2,0,1,1,0,0,3
6522,792040,27,6,9,5,6,1,3,0,0,0,2,2,1,1,0,1,13
6523,786519,28,5,5,5,5,0,0,0,1,1,8,2,2,1,0,2,10
6523,791911,28,5,8,0,1,5,7,2,2,0,3,0,2,0,0,0,17
6523,797556,34,7,18,2,5,5,13,2,3,0,2,8,1,1,2,0,21
6523,791913,31,7,14,3,8,4,6,1,1,0,1,4,3,3,1,0,19
6523,786520,30,3,10,1,6,2,4,0,0,4,3,7,4,2,1,0,8
6523,797558,12,3,5,2,2,1,3,0,0,1,0,1,2,0,0,0,7
6523,797560,12,0,0,0,0,0,0,0,0,2,2,0,3,1,0,0,0
6523,797555,13,2,5,1,2,1,3,0,0,1,1,1,2,0,3,1,5
6523,781105,11,0,1,0,0,0,1,0,0,1,3,0,3,0,1,0,0
6523,797557,1,0,0,0,0,0,0,0,0,0,0,0,0,0,1,0,0
6524,785622,26,5,8,2,3,3,5,3,3,1,4,0,2,0,2,0,16
6524,781058,19,4,7,4,7,0,0,1,2,2,3,2,3,0,2,0,9
6524,780327,19,2,4,2,4,0,0,6,6,2,1,0,3,0,1,0,10
6524,797458,21,2,4,1,2,1,2,2,2,0,2,2,2,0,0,0,7
6524,797451,25,2,7,1,2,1,5,0,0,1,2,5,0,2,0,0,5
6524,797455,17,5,9,5,9,0,0,1,1,2,3,0,2,1,0,0,11
6524,797456,4,1,2,0,0,1,2,0,0,0,0,1,1,0,0,0,3
6524,791847,11,0,3,0,1,0,2,3,4,1,1,1,3,0,0,0,3
6524,791848,10,0,3,0,1,0,2,2,2,1,3,2,0,0,2,0,2
6524,791849,19,5,6,0,0,5,6,1,2,0,2,1,1,2,0,0,16
6524,786607,14,4,7,3,3,1,4,0,0,0,1,4,0,0,1,1,9
6524,797457,4,0,0,0,0,0,0,0,0,0,2,0,0,0,0,0,0
6524,797454,2,1,1,1,1,0,0,1,1,0,0,0,0,0,0,0,3
6524,797453,3,1,1,1,1,0,0,2,2,0,0,1,2,0,0,0,4
6524,791850,3,0,0,0,0,0,0,1,2,0,1,0,0,0,0,0,1
6524,797452,3,1,1,0,0,1,1,0,0,0,0,0,0,0,0,0,3
6525,785948,20,1,2,1,2,0,0,0,2,0,2,0,4,0,2,2,2
6525,785946,18,1,1,1,1,0,0,0,0,0,2,0,3,1,1,0,2
6525,792020,30,4,8,2,5,2,3,2,2,1,0,3,0,0,2,0,12
6525,785939,28,5,13,5,10,0,3,5,6,0,4,1,1,0,1,0,15
6525,785938,24,3,8,3,5,0,3,1,2,1,1,2,1,1,1,0,7
6525,792026,19,0,0,0,0,0,0,0,0,0,3,0,3,0,1,0,0
6525,792025,20,4,5,4,5,0,0,2,2,1,4,0,4,0,1,0,10
6525,792023,11,2,5,1,3,1,2,0,0,0,1,2,1,1,2,0,5
6525,785941,22,4,12,1,6,3,6,0,0,1,1,0,3,1,1,0,11
6525,797635,3,0,0,0,0,0,0,2,2,0,0,0,1,0,0,0,2
6525,792024,5,0,0,0,0,0,0,0,1,0,0,0,0,0,0,0,0
6526,785294,26,6,10,5,8,1,2,1,4,3,7,3,1,0,1,2,14
6526,791085,27,5,11,3,6,2,5,4,4,0,3,5,1,1,3,1,16
6526,791080,23,6,9,6,8,0,1,0,0,4,4,0,1,0,1,0,12
6526,786446,23,3,7,3,4,0,3,3,4,0,3,4,1,1,3,0,9
6526,785675,23,4,12,2,6,2,6,0,0,0,6,2,0,1,1,0,10
6526,796511,14,1,4,1,2,0,2,0,0,0,6,1,2,1,1,0,2
6526,791084,4,1,2,1,2,0,0,0,0,0,2,0,1,1,1,0,2
6526,791083,11,1,5,1,4,0,1,0,0,2,2,1,0,1,0,3,2
6526,791081,2,0,0,0,0,0,0,0,0,0,1,0,0,0,0,0,0
6526,796512,22,5,7,3,5,2,2,0,1,0,3,1,0,1,1,0,12
6526,791082,2,0,1,0,1,0,0,0,0,0,0,0,0,0,0,0,0
6526,791077,4,0,0,0,0,0,0,0,0,0,1,0,1,0,0,0,0
6526,796515,17,2,5,0,0,2,5,1,2,0,3,0,1,0,0,0,7
6526,791079,2,0,0,0,0,0,0,0,0,0,0,0,0,0,0,0,0
6527,791787,21,6,21,5,17,1,4,0,1,3,4,1,4,0,0,0,13
6527,789048,25,4,8,4,8,0,0,0,0,4,5,3,1,1,2,0,8
6527,789046,19,1,7,1,3,0,4,1,2,0,0,0,0,0,0,0,3
6527,797630,12,1,5,1,4,0,1,0,0,0,0,0,1,1,1,0,2
6527,789041,17,0,6,0,2,0,4,0,0,0,0,0,2,0,1,0,0
6527,799762,5,0,1,0,0,0,1,0,0,0,0,0,0,0,0,0,0
6527,791785,15,1,3,1,3,0,0,0,0,0,0,1,0,1,0,0,2
6527,785540,13,2,4,2,4,0,0,1,2,1,3,0,1,0,1,1,5
6527,797632,2,0,0,0,0,0,0,0,0,0,1,0,0,0,0,0,0
6527,797633,2,0,0,0,0,0,0,0,0,0,0,0,0,0,1,0,0
6527,797631,23,3,5,2,4,1,1,1,2,0,3,0,2,1,1,1,8
6527,797629,10,3,5,3,5,0,0,0,1,0,2,0,0,0,0,0,6
6527,791786,26,3,8,2,4,1,4,0,0,0,7,4,2,0,3,0,7
6527,789044,10,2,3,0,0,2,3,0,0,0,3,0,0,0,1,1,6
6528,792167,23,5,8,5,8,0,0,3,6,4,3,0,3,0,2,3,13
6528,797766,27,5,9,2,5,3,4,0,1,3,4,0,3,2,3,1,13
6528,791372,37,8,18,3,6,5,12,0,0,0,2,2,3,2,0,0,21
6528,792164,34,5,8,3,4,2,4,3,6,0,4,7,2,5,2,0,15
6528,780974,25,1,4,1,2,0,2,2,2,0,2,2,0,1,1,0,4
6528,792170,10,1,3,1,2,0,1,0,0,0,2,0,2,0,1,0,2
6528,797767,22,0,2,0,2,0,0,0,0,0,1,4,1,2,2,0,0
6528,797772,5,0,1,0,0,0,1,0,0,0,1,0,1,0,0,0,0
6528,792163,16,2,5,1,2,1,3,0,0,0,1,0,0,0,0,0,5
6528,797764,1,0,1,0,0,0,1,0,0,0,0,0,1,0,0,0,0
6529,780229,31,9,13,9,13,0,0,2,4,3,6,4,2,0,8,0,20
6529,795572,33,6,11,6,9,0,2,2,4,3,5,3,2,1,0,0,14
6529,791483,28,1,3,1,2,0,1,2,4,1,3,0,1,1,2,0,4
6529,786322,24,2,6,0,1,2,5,1,2,1,2,0,1,0,2,0,7
6529,791484,9,4,5,2,2,2,3,0,0,1,1,0,1,1,0,1,10
6529,791487,0,0,0,0,0,0,0,0,0,0,0,0,0,0,0,0,0
6529,781592,21,0,5,0,2,0,3,2,2,0,3,1,3,0,2,0,2
6529,797195,4,0,0,0,0,0,0,0,0,0,0,0,0,0,0,0,0
6529,797193,12,1,4,0,3,1,1,0,0,0,4,2,1,0,1,0,3
6529,791485,9,1,2,1,1,0,1,0,0,0,0,1,0,1,1,0,2
6529,780228,29,2,7,0,2,2,5,0,0,0,4,3,2,0,1,0,6
6530,792005,18,1,8,1,2,0,6,0,0,1,4,1,2,1,1,1,2
6530,781175,28,2,4,2,4,0,0,5,6,4,8,1,4,0,2,0,9
6530,786553,29,1,9,1,5,0,4,0,0,0,2,1,1,1,2,0,2
6530,780895,39,4,11,4,10,0,1,5,6,2,4,2,3,2,1,1,13
6530,781172,35,3,8,0,3,3,5,2,2,1,3,1,3,2,2,0,11
6530,781177,10,1,1,1,1,0,0,2,2,1,3,2,0,0,0,0,4
6530,786555,25,3,7,1,1,2,6,0,0,0,3,1,1,0,2,0,8
6530,785312,16,2,6,2,5,0,1,2,2,0,1,1,2,1,3,0,6
6531,791585,30,3,7,2,4,1,3,2,3,0,4,0,4,0,2,2,9
6531,780062,8,0,2,0,2,0,0,2,2,1,2,0,0,0,3,0,2
6531,786395,37,6,11,4,5,2,6,9,9,0,3,1,2,1,2,1,23
6531,786394,38,1,11,1,7,0,4,0,0,1,3,1,2,3,1,2,2
6531,780404,34,3,7,3,5,0,2,0,0,1,3,2,3,0,4,2,6
6531,785228,18,2,3,2,2,0,1,0,2,0,2,1,3,0,0,0,4
6531,791581,27,2,6,2,5,0,1,0,0,2,2,1,1,2,4,0,4
6531,797041,7,0,1,0,1,0,0,0,0,0,1,0,0,0,0,0,0
6531,780403,1,0,0,0,0,0,0,0,0,0,0,0,1,0,0,0,0
6532,790511,15,3,4,3,4,0,0,0,0,2,0,1,3,0,1,0,6
6532,780194,3,0,3,0,2,0,1,0,0,0,0,0,2,0,0,0,0
6532,785706,4,0,0,0,0,0,0,0,0,0,1,0,1,0,0,0,0
6532,785700,38,4,5,1,2,3,3,4,5,0,2,6,2,3,2,0,15
6532,780269,36,4,13,3,9,1,4,9,11,0,3,4,2,3,3,0,18
6532,796838,19,1,3,1,3,0,0,2,2,2,2,0,5,1,1,1,4
6532,796837,25,3,7,3,4,0,3,0,0,0,3,2,3,0,0,0,6
6532,791171,17,4,5,4,5,0,0,3,7,0,2,0,3,0,0,0,11
6532,796833,16,2,4,0,0,2,4,0,0,0,1,0,1,1,3,0,6
6532,786721,27,4,5,2,2,2,3,4,8,0,2,1,4,3,1,0,14
6533,792299,28,2,5,1,2,1,3,1,2,2,4,1,4,1,2,1,6
6533,786181,24,3,5,3,5,0,0,1,1,3,3,0,5,3,3,0,7
6533,792304,34,4,10,4,8,0,2,0,0,0,4,2,2,1,3,0,8
6533,792301,34,6,9,6,8,0,1,7,7,2,1,3,2,1,4,0,19
6533,786286,36,1,6,0,0,1,6,0,0,0,3,0,3,0,1,0,3
6533,792302,2,0,0,0,0,0,0,0,0,0,0,0,1,0,0,0,0
6533,798093,6,0,0,0,0,0,0,0,1,0,0,0,1,0,1,0,0
6533,786280,10,1,2,1,2,0,0,2,2,0,2,0,3,0,0,0,4
6533,786278,23,7,11,6,7,1,4,15,17,0,6,0,4,0,2,0,30
6533,798092,3,0,0,0,0,0,0,0,0,0,0,0,0,0,0,0,0
6534,796617,18,2,2,2,2,0,0,1,3,1,1,0,0,0,1,0,5
6534,775131,32,3,8,1,2,2,6,1,2,0,2,3,1,3,1,1,9
6534,796616,32,1,6,1,1,0,5,2,2,0,0,3,0,0,0,0,4
6534,796612,32,7,12,7,11,0,1,0,0,3,3,4,4,1,5,1,14
6534,785562,31,10,16,9,14,1,2,3,4,3,7,5,0,1,1,1,24
6534,792429,6,1,6,1,4,0,2,0,0,0,1,0,1,0,0,0,2
6534,796614,4,0,0,0,0,0,0,0,0,0,0,0,2,0,0,0,0
6534,796607,21,4,7,3,5,1,2,0,0,0,4,0,1,1,0,0,9
6534,796606,24,2,4,2,4,0,0,0,0,3,1,1,3,1,1,0,4
6535,786080,26,3,11,2,6,1,5,3,4,1,3,2,3,2,8,2,10
6535,786216,17,1,3,1,3,0,0,0,0,2,1,1,3,1,3,0,2
6535,791348,33,4,8,4,6,0,2,1,2,1,3,3,2,0,1,1,9
6535,791350,35,4,6,0,0,4,6,0,0,0,3,0,0,1,2,0,12
6535,786218,32,4,10,3,4,1,6,1,2,1,3,2,2,1,3,0,10
6535,797258,15,2,4,2,4,0,0,0,0,1,6,0,1,0,0,2,4
6535,781645,14,2,2,2,2,0,0,0,0,0,1,0,1,0,1,0,4
6535,780156,8,0,0,0,0,0,0,0,0,1,2,0,1,0,0,0,0
6535,780150,20,2,6,1,3,1,3,0,0,0,0,0,1,0,0,0,5
6536,796455,26,3,3,3,3,0,0,1,2,2,3,0,4,1,1,1,7
6536,787175,25,1,8,0,1,1,7,0,2,1,3,0,3,0,0,0,3
6536,790909,37,6,17,3,7,3,10,5,6,3,3,4,5,1,4,0,20
6536,781393,40,8,19,4,8,4,11,8,8,1,6,6,3,0,2,0,28
6536,775351,22,2,5,2,5,0,0,0,0,1,1,3,4,3,3,0,4
6536,790907,17,0,0,0,0,0,0,0,0,0,1,0,1,0,0,0,0
6536,782126,32,3,7,0,1,3,6,0,0,1,7,0,2,1,1,1,9
6536,796454,1,0,0,0,0,0,0,0,0,0,0,0,0,0,0,0,0
6537,791135,24,3,8,3,8,0,0,5,8,3,1,0,2,1,0,0,11
6537,791132,22,1,7,1,3,0,4,0,0,3,4,1,3,0,2,0,2
6537,786090,33,2,4,2,4,0,0,6,7,6,8,2,4,0,2,0,10
6537,786088,34,2,5,2,4,0,1,0,0,1,3,7,2,0,3,0,4
6537,774921,36,6,15,1,4,5,11,1,2,2,6,1,3,2,3,0,18
6537,791133,5,0,0,0,0,0,0,0,0,1,1,0,0,0,2,0,0
6537,791131,12,2,6,2,3,0,3,1,2,1,0,0,0,0,0,1,5
6537,785541,17,3,9,0,1,3,8,0,0,0,2,0,1,1,0,0,9
6537,796791,15,2,9,2,4,0,5,2,2,1,0,0,0,0,1,0,6
6537,786092,2,0,1,0,1,0,0,0,0,1,0,0,0,0,0,0,0
6538,797529,33,2,9,2,7,0,2,0,0,2,4,0,2,2,1,0,4
6538,797527,33,5,10,4,7,1,3,2,3,5,7,0,3,3,1,0,13
6538,791936,33,5,8,5,8,0,0,3,5,4,5,2,2,1,2,0,13
6538,797532,39,6,14,4,10,2,4,6,7,0,2,11,1,2,4,0,20
6538,785988,28,4,12,2,5,2,7,4,4,1,1,1,4,0,4,0,14
6538,797528,6,1,3,1,2,0,1,0,0,0,1,1,2,0,0,0,2
6538,791932,19,1,2,0,0,1,2,0,0,0,0,0,2,1,2,0,3
6538,791933,9,1,5,0,0,1,5,0,0,0,0,0,0,1,0,0,3
6538,791935,0,0,0,0,0,0,0,0,0,0,0,0,2,0,0,0,0
6539,785681,24,4,4,4,4,0,0,1,2,0,5,3,4,0,2,0,9
6539,796789,20,2,5,2,2,0,3,0,0,1,4,3,3,2,1,0,4
6539,791126,31,2,3,2,3,0,0,0,0,1,2,4,3,0,1,1,4
6539,791124,37,4,11,2,7,2,4,4,8,0,2,6,2,1,3,1,14
6539,780050,33,9,13,9,10,0,3,3,5,4,6,4,1,1,5,0,21
6539,796786,12,4,7,0,0,4,7,0,0,0,0,0,0,1,0,0,12
6539,775813,11,0,2,0,2,0,0,2,4,1,0,1,2,0,1,0,2
6539,796784,17,3,6,2,3,1,3,2,2,0,1,1,2,1,1,0,9
6539,796782,15,2,3,1,1,1,2,0,0,2,2,0,1,1,0,0,5
6540,786542,32,6,15,6,14,0,1,4,6,5,3,2,3,0,3,0,16
6540,786540,22,7,12,7,11,0,1,2,3,5,7,2,2,3,1,2,16
6540,792016,27,4,9,4,6,0,3,0,0,0,3,3,2,0,3,1,8
6540,791845,26,2,8,2,6,0,2,2,3,3,2,2,4,0,0,0,6
6540,775995,37,4,8,3,5,1,3,0,0,0,3,5,5,1,2,0,9
6540,785364,21,9,19,9,19,0,0,2,2,8,5,1,2,0,1,0,20
6540,781147,22,3,3,2,2,1,1,0,0,1,1,0,2,0,0,0,7
6540,797515,13,0,2,0,0,0,2,0,0,0,1,2,0,0,1,0,0
6541,797047,20,5,6,5,6,0,0,6,9,1,0,0,3,0,1,1,16
6541,775515,28,3,8,0,1,3,7,0,2,1,5,1,3,1,1,5,9
6541,791579,28,3,7,1,4,2,3,0,0,1,3,2,3,1,3,0,8
6541,786387,38,8,13,7,12,1,1,5,7,0,1,2,0,2,2,0,22
6541,780399,38,4,11,3,6,1,5,0,0,1,3,10,2,3,1,0,9
6541,786846,18,4,7,2,3,2,4,3,3,3,1,1,2,0,0,1,13
6541,780400,13,1,2,1,2,0,0,1,4,0,2,0,2,0,0,0,3
6541,791575,2,0,0,0,0,0,0,0,0,0,1,0,0,0,0,1,0
6541,797046,15,0,4,0,0,0,4,1,2,0,2,1,0,1,1,0,1
6542,796568,18,4,6,4,6,0,0,0,0,1,1,1,3,0,1,0,8
6542,796566,25,4,6,4,6,0,0,1,2,2,7,1,4,1,1,2,9
6542,790969,25,8,11,6,7,2,4,2,4,0,1,3,2,1,0,0,20
6542,780166,33,8,10,5,5,3,5,13,14,0,1,9,1,1,2,0,32
6542,775107,6,0,1,0,1,0,0,0,0,0,1,0,0,0,0,0,0
6542,790971,12,0,2,0,2,0,0,0,0,2,1,0,1,1,0,0,0
6542,796569,8,0,2,0,2,0,0,0,0,0,0,0,1,1,0,0,0
6542,796563,25,2,6,0,2,2,4,0,0,0,3,1,3,0,1,0,6
6542,790968,24,2,4,1,1,1,3,2,2,0,3,4,1,0,0,0,7
6542,790967,24,5,10,2,6,3,4,0,0,0,1,0,0,1,2,0,13
6543,792334,32,9,12,7,9,2,3,3,8,7,7,1,3,0,2,0,23
6543,786575,23,4,6,4,6,0,0,3,4,2,3,1,2,0,2,0,11
6543,798094,16,0,2,0,0,0,2,0,0,0,0,4,0,0,0,1,0
6543,792338,35,3,10,3,9,0,1,1,2,1,3,2,4,1,3,1,7
6543,781666,25,7,13,3,5,4,8,1,1,0,1,1,4,0,2,0,19
6543,798097,14,3,4,3,4,0,0,4,4,3,4,1,0,0,1,0,10
6543,785531,4,1,2,0,0,1,2,0,0,0,0,0,1,0,0,0,3
6543,798095,11,0,1,0,0,0,1,0,0,0,0,1,1,0,0,0,0
6543,799842,20,3,6,3,5,0,1,2,3,0,1,2,3,2,3,0,8
6543,791636,20,2,5,0,1,2,4,0,0,0,2,3,3,1,0,0,6
6544,785916,23,2,13,2,6,0,7,0,0,0,4,1,4,0,1,1,4
6544,780105,24,2,4,2,4,0,0,0,0,0,2,1,4,0,2,0,4
6544,785637,28,5,10,5,8,0,2,0,1,0,1,2,0,1,2,0,10
6544,785915,36,2,3,0,0,2,3,0,0,0,2,2,0,1,1,0,6
6544,781131,31,3,13,3,12,0,1,0,0,0,5,2,2,1,3,0,6
6544,791408,21,4,8,4,8,0,0,1,2,1,6,1,3,0,3,1,9
6544,785914,3,1,1,1,1,0,0,0,0,0,0,0,0,0,0,0,2
6544,780106,3,0,0,0,0,0,0,0,0,0,0,0,0,0,0,0,0
6544,797108,2,0,1,0,0,0,1,0,0,0,0,0,0,0,0,0,0
6544,791409,2,1,1,1,1,0,0,0,0,0,1,0,0,0,0,0,2
6544,797107,2,0,0,0,0,0,0,0,0,0,0,1,1,0,0,0,0
6544,785894,25,2,6,2,2,0,4,0,1,2,2,0,1,0,2,0,4
6545,786059,24,4,11,4,9,0,2,1,3,3,7,3,2,0,2,2,9
6545,776174,30,9,17,9,17,0,0,5,7,5,7,0,2,2,2,2,23
6545,791958,33,1,8,1,7,0,1,2,4,3,4,0,1,0,2,0,4
6545,791960,35,6,12,6,9,0,3,0,0,0,3,5,0,1,1,2,12
6545,785861,32,4,6,3,3,1,3,0,0,0,7,3,0,0,1,0,9
6545,786063,2,0,0,0,0,0,0,0,0,0,0,0,0,0,0,0,0
6545,781334,3,1,1,0,0,1,1,0,0,0,0,0,0,0,0,0,3
6545,797706,3,1,2,0,1,1,1,0,0,1,0,1,0,0,1,0,3
6545,797704,12,0,1,0,0,0,1,0,0,0,2,0,0,0,0,0,0
6545,791957,2,0,0,0,0,0,0,0,0,0,0,0,0,0,0,0,0
6545,791959,3,0,1,0,1,0,0,1,2,0,1,0,0,0,0,0,1
6545,781332,21,3,4,1,2,2,2,0,0,1,0,1,4,2,1,0,8
6546,780570,16,0,2,0,2,0,0,1,2,0,3,0,3,1,1,1,1
6546,780569,36,3,6,3,6,0,0,3,6,3,6,3,5,1,5,4,9
6546,791697,27,4,11,4,7,0,4,2,2,0,2,1,3,0,0,0,10
6546,791696,27,2,11,2,10,0,1,3,5,2,1,3,1,3,4,0,7
6546,780565,35,9,11,6,7,3,4,6,7,1,4,4,3,1,1,0,27
6546,797436,16,4,6,1,2,3,4,0,0,0,1,1,4,0,1,0,11
6546,791695,9,1,2,1,2,0,0,0,1,0,1,0,0,0,0,0,2
6546,785824,12,2,3,1,1,1,2,3,4,0,1,0,2,1,0,0,8
6546,781556,12,1,3,1,3,0,0,0,0,0,0,0,2,0,2,0,2
6546,780564,10,0,2,0,2,0,0,0,0,0,2,0,2,0,0,0,0
6547,797779,21,5,8,3,3,2,5,9,9,0,4,0,3,1,1,0,21
6547,785568,21,1,1,1,1,0,0,0,0,2,7,0,3,0,3,0,2
6547,797778,25,4,8,3,5,1,3,0,0,1,3,0,2,2,0,0,9
6547,786256,26,3,10,3,10,0,0,0,0,3,4,0,1,1,5,1,6
6547,797774,24,4,6,3,3,1,3,4,5,0,1,3,2,1,4,0,13
6547,797770,13,4,8,4,7,0,1,1,1,2,2,0,4,0,1,1,9
6547,797780,9,0,0,0,0,0,0,2,2,0,1,0,0,1,0,0,2
6547,797776,3,0,1,0,1,0,0,0,0,0,1,0,1,0,0,0,0
6547,797771,17,0,2,0,1,0,1,0,2,1,3,0,2,1,0,0,0
6547,797768,14,1,6,0,3,1,3,0,0,0,1,1,1,0,1,0,3
6547,775106,27,5,9,5,8,0,1,10,13,3,4,2,4,1,2,0,20
6548,792035,35,3,10,3,10,0,0,4,12,2,4,0,4,1,4,0,10
6548,780833,31,2,5,2,5,0,0,1,2,2,6,1,2,1,1,1,5
6548,792034,39,5,10,2,2,3,8,2,4,1,15,4,0,1,3,1,15
6548,792033,40,6,21,4,9,2,12,4,4,1,2,0,1,1,0,2,18
6548,780830,20,1,5,1,4,0,1,0,0,0,4,1,5,1,4,2,2
6548,797645,9,0,1,0,1,0,0,0,0,0,3,0,3,0,2,0,0
6548,791688,5,0,2,0,0,0,2,0,0,0,1,0,1,0,0,0,0
6548,785381,21,2,6,0,1,2,5,0,0,0,0,1,1,0,0,0,6
6549,792029,28,2,12,2,7,0,5,2,2,4,12,2,3,0,1,1,6
6549,761149,34,3,7,2,4,1,3,2,2,1,2,0,4,0,0,0,9
6549,792032,36,8,17,7,11,1,6,2,3,0,4,5,1,0,4,0,19
6549,792031,30,5,10,4,7,1,3,0,1,0,3,2,2,2,1,0,11
6549,780828,38,4,13,3,9,1,4,5,6,0,7,1,3,3,2,1,14
6549,797641,9,1,5,1,5,0,0,0,0,3,4,0,3,0,1,0,2
6549,797640,5,0,3,0,3,0,0,0,0,1,0,0,0,0,0,0,0
6549,797637,14,1,3,0,1,1,2,0,0,0,2,1,3,1,0,0,3
6549,797636,6,0,0,0,0,0,0,0,0,0,0,1,0,0,0,0,0
6550,781577,26,4,9,4,8,0,1,0,0,3,3,4,3,1,2,0,8
6550,775910,22,3,8,1,5,2,3,3,4,1,2,0,4,1,1,1,11
6550,786451,32,4,9,1,3,3,6,0,0,0,7,4,2,0,2,0,11
6550,780600,29,7,11,7,9,0,2,3,5,1,5,1,0,0,1,1,17
6550,781387,33,3,9,0,2,3,7,2,2,0,0,4,3,0,1,0,11
6550,791763,11,2,4,2,2,0,2,0,0,2,0,2,0,0,0,0,4
6550,790888,5,0,1,0,0,0,1,0,0,0,1,0,0,0,0,0,0
6550,786456,15,3,3,3,3,0,0,0,0,1,3,0,0,0,1,1,6
6550,780020,19,3,5,2,3,1,2,0,0,0,1,0,3,1,0,0,7
6550,800084,1,0,1,0,1,0,0,0,0,0,1,0,0,0,0,0,0
6550,797561,7,0,0,0,0,0,0,0,0,0,0,0,1,0,0,0,0
6551,774806,26,8,10,8,10,0,0,2,4,2,4,1,3,0,0,1,18
6551,775823,31,4,9,4,8,0,1,1,3,2,4,0,1,0,0,0,9
6551,791041,38,7,8,2,2,5,6,0,0,1,3,2,2,0,1,0,19
6551,791038,37,7,16,5,9,2,7,2,4,1,2,4,3,0,0,0,18
6551,789023,40,3,13,3,10,0,3,4,5,0,2,8,3,1,2,0,10
6551,796714,14,3,4,3,4,0,0,0,0,1,4,0,0,0,1,0,6
6551,796711,0,0,0,0,0,0,0,0,0,0,0,0,1,0,0,0,0
6551,775205,14,1,3,0,1,1,2,2,2,0,2,0,1,0,1,0,5
6552,786404,27,1,4,0,1,1,3,0,0,0,6,1,1,0,2,0,3
6552,780378,26,7,11,7,11,0,0,2,6,5,5,1,3,1,0,1,16
6552,786378,31,2,13,0,2,2,11,0,0,1,0,3,4,1,0,0,6
6552,786374,29,3,12,3,11,0,1,1,1,5,4,3,1,1,5,1,7
6552,786253,28,4,7,2,4,2,3,4,4,0,0,5,2,2,3,0,14
6552,780382,14,1,2,1,2,0,0,0,0,1,4,1,1,0,1,0,2
6552,797061,25,5,10,4,6,1,4,1,1,1,2,2,3,0,1,0,12
6552,791562,6,1,2,0,0,1,2,0,0,0,0,0,2,0,0,0,3
6552,785798,13,1,8,1,2,0,6,0,0,1,2,1,5,0,1,0,2
6552,780121,1,0,0,0,0,0,0,0,0,0,0,0,1,0,0,0,0
6553,785693,26,2,3,2,3,0,0,1,4,3,4,1,1,0,0,1,5
6553,780494,32,7,14,5,8,2,6,2,4,2,7,3,3,0,2,0,18
6553,797276,14,0,2,0,1,0,1,1,4,0,3,6,2,1,1,0,1
6553,780496,32,5,9,3,4,2,5,2,3,1,3,3,2,1,3,0,14
6553,780495,38,5,12,3,8,2,4,4,5,0,5,3,3,0,3,1,16
6553,797274,6,1,2,1,2,0,0,0,0,0,1,0,3,0,2,0,2
6553,791645,4,1,1,1,1,0,0,0,0,0,0,0,1,0,0,0,2
6553,791643,9,0,1,0,0,0,1,0,0,1,0,0,3,0,1,0,0
6553,785692,26,1,4,1,4,0,0,4,6,0,1,3,1,1,1,0,6
6553,780497,13,2,3,2,2,0,1,2,2,0,2,2,1,0,2,0,6
6588,796810,32,3,7,3,4,0,3,6,7,1,2,1,2,0,2,0,12
6588,786609,34,3,4,2,3,1,1,3,5,2,4,0,4,2,3,0,10
6588,780952,30,1,4,1,3,0,1,0,0,1,1,2,4,1,0,4,2
6588,785752,16,2,6,1,2,1,4,0,0,0,0,1,2,0,2,0,5
6588,796812,22,5,8,5,8,0,0,2,2,1,1,2,5,0,2,0,12
6588,780945,5,0,0,0,0,0,0,0,0,0,2,0,1,0,0,0,0
6588,791156,25,5,11,3,5,2,6,8,9,0,1,2,1,2,0,0,20
6588,780950,16,2,5,1,2,1,3,0,0,1,0,1,0,0,0,0,5
6588,796814,20,2,3,1,2,1,1,2,2,1,3,0,1,1,1,0,7
6589,786255,29,4,9,3,6,1,3,2,2,1,5,3,4,1,1,0,11
6589,781301,29,1,1,1,1,0,0,4,6,2,2,0,2,0,1,2,6
6589,780762,35,7,13,4,7,3,6,3,3,0,2,0,2,1,1,0,20
6589,780765,36,5,10,3,7,2,3,10,12,3,4,2,0,1,3,0,22
6589,780768,25,2,4,2,3,0,1,0,0,0,2,3,4,1,4,0,4
6589,776241,17,1,3,0,1,1,2,6,6,0,0,1,1,1,2,0,9
6589,791729,11,2,2,0,0,2,2,0,0,0,1,0,1,1,1,0,6
6589,780755,18,0,2,0,1,0,1,2,2,2,0,2,3,0,0,0,2
6590,790774,25,1,5,1,2,0,3,0,0,0,1,0,0,0,1,0,2
6590,790771,31,4,11,3,4,1,7,3,4,3,3,1,1,1,0,3,12
6590,780271,35,4,10,2,4,2,6,4,4,0,7,1,1,1,1,0,14
6590,790772,36,9,15,7,9,2,6,0,0,1,1,0,1,0,3,0,20
6590,780375,30,3,12,1,5,2,7,3,3,0,3,2,1,2,4,0,11
6590,780267,6,0,1,0,0,0,1,0,0,0,0,0,2,0,2,0,0
6590,792438,18,2,3,0,0,2,3,0,0,0,4,1,1,0,2,0,6
6590,782638,4,0,0,0,0,0,0,0,0,0,1,0,1,1,0,0,0
6590,782637,3,0,0,0,0,0,0,0,0,0,0,1,0,1,0,0,0
6590,794458,5,0,1,0,1,0,0,0,0,0,0,1,1,0,0,0,0
6590,800120,6,0,1,0,0,0,1,0,0,0,0,0,0,0,0,0,0
6591,785409,23,5,7,5,7,0,0,4,4,1,6,0,2,2,2,0,14
6591,785408,20,5,9,4,7,1,2,0,0,2,1,0,2,1,2,0,11
6591,796416,23,3,7,2,4,1,3,0,0,1,4,4,1,2,2,0,7
6591,780539,27,1,3,0,0,1,3,0,0,0,1,3,3,0,1,1,3
6591,780560,26,3,9,3,4,0,5,1,1,0,2,4,2,3,2,2,7
6591,785407,21,5,8,5,8,0,0,4,4,3,4,0,0,1,0,0,14
6591,790861,17,1,3,1,2,0,1,1,2,1,3,0,0,0,0,0,3
6591,796415,23,8,12,5,8,3,4,0,0,0,6,2,0,2,3,1,19
6591,796417,8,1,2,1,2,0,0,0,0,1,1,0,1,0,1,0,2
6591,796418,7,0,1,0,1,0,0,1,2,1,1,0,2,0,1,0,1
6591,796419,5,0,1,0,1,0,0,0,0,0,0,0,0,0,0,0,0
6592,785498,22,1,4,1,3,0,1,2,2,2,0,1,1,0,0,0,4
6592,776469,30,6,8,3,4,3,4,7,12,0,3,2,2,0,1,0,22
6592,781169,31,2,6,2,4,0,2,3,4,4,6,2,4,2,3,3,7
6592,780701,37,3,5,3,5,0,0,3,6,0,3,5,2,3,3,1,9
6592,776322,22,1,5,0,1,1,4,0,0,0,3,1,2,0,1,0,3
6592,780704,15,0,1,0,0,0,1,0,0,0,0,0,3,0,0,0,0
6592,796705,29,5,12,1,4,4,8,8,9,0,2,1,1,0,4,0,22
6592,796708,3,0,0,0,0,0,0,1,2,0,0,0,2,0,0,0,1
6592,796706,8,0,0,0,0,0,0,0,1,0,1,0,2,0,0,1,0
6592,791036,3,0,0,0,0,0,0,0,0,0,0,0,0,0,0,0,0
6593,791194,30,4,7,4,7,0,0,0,1,1,2,2,4,1,0,1,8
6593,780384,22,2,3,2,3,0,0,0,0,1,1,0,1,0,0,0,4
6593,780159,5,0,2,0,2,0,0,0,0,0,1,0,0,0,0,0,0
6593,786738,34,9,15,6,10,3,5,5,8,4,4,3,4,4,1,0,26
6593,774827,26,2,8,1,5,1,3,0,0,2,1,3,4,0,4,0,5
6593,796863,21,1,7,1,6,0,1,0,2,0,1,0,3,1,1,0,2
6593,775694,30,1,5,0,2,1,3,4,4,0,2,4,4,1,4,0,7
6593,791193,21,2,3,2,3,0,0,0,1,0,4,0,4,0,1,2,4
6593,796865,7,0,2,0,1,0,1,0,0,0,1,0,3,0,1,0,0
6593,800119,4,1,4,1,3,0,1,0,0,1,0,0,1,0,0,0,2
6594,779985,32,4,7,3,3,1,4,0,0,2,13,4,1,1,2,0,9
6594,790876,30,2,5,2,4,0,1,0,0,0,1,1,2,0,1,0,4
6594,785699,32,6,9,5,7,1,2,6,8,1,5,0,1,0,2,0,19
6594,781062,38,6,11,2,2,4,9,2,2,1,4,0,1,1,1,0,18
6594,774987,35,5,10,5,9,0,1,6,6,0,8,8,4,1,4,0,16
6594,785432,7,1,3,1,3,0,0,0,2,0,0,1,1,0,1,1,2
6594,790877,22,5,7,5,6,0,1,1,3,2,1,0,0,1,2,0,11
6594,790879,1,0,0,0,0,0,0,0,0,0,0,0,2,0,1,0,0
6594,796434,3,0,1,0,0,0,1,0,0,0,1,0,0,0,0,0,0
6595,774846,33,6,16,6,16,0,0,0,0,5,0,2,2,0,3,0,12
6595,797273,21,0,0,0,0,0,0,2,2,0,2,3,2,1,1,0,2
6595,786558,39,8,20,3,12,5,8,0,0,0,7,4,5,1,1,1,21
6595,797272,25,2,4,0,1,2,3,0,0,0,2,0,0,2,1,0,6
6595,766611,25,4,13,1,5,3,8,0,0,1,1,2,5,0,0,0,11
6595,781480,25,4,7,1,3,3,4,0,0,0,5,2,5,0,2,2,11
6595,791376,25,3,8,0,0,3,8,0,0,2,2,1,2,0,1,0,9
6595,786185,7,0,3,0,3,0,0,0,0,1,1,0,0,0,0,0,0
6595,797182,0,0,0,0,0,0,0,0,0,0,0,0,0,0,0,0,0
6596,785836,36,6,13,1,7,5,6,5,6,2,7,0,1,0,2,2,22
6596,785833,38,2,6,1,3,1,3,2,2,0,5,2,1,1,2,0,7
6596,791707,35,6,10,5,7,1,3,3,3,0,4,5,2,2,1,0,16
6596,791704,32,5,8,5,7,0,1,5,7,3,3,2,0,0,3,1,15
6596,785892,28,4,9,3,6,1,3,1,2,1,4,0,3,0,2,1,10
6596,775872,6,0,0,0,0,0,0,0,0,0,2,0,0,0,0,0,0
6596,785332,17,1,5,1,5,0,0,2,2,3,3,1,2,0,1,0,4
6596,785838,8,0,5,0,3,0,2,0,0,1,1,0,0,0,0,0,0
6597,791606,34,5,10,3,7,2,3,0,0,1,4,2,2,2,2,0,12
6597,786410,32,3,9,2,6,1,3,0,0,0,4,2,2,0,1,1,7
6597,775095,16,2,4,2,4,0,0,2,2,2,2,1,1,2,0,2,6
6597,791605,23,5,11,5,8,0,3,0,0,1,2,0,3,1,1,1,10
6597,786406,38,6,15,5,13,1,2,2,2,1,2,3,2,1,2,0,15
6597,797020,12,1,3,1,3,0,0,2,2,0,1,0,3,0,0,0,4
6597,792392,7,0,1,0,1,0,0,0,0,0,1,0,0,0,0,0,0
6597,797021,27,2,6,2,5,0,1,5,6,1,3,1,1,1,0,0,9
6597,791603,3,0,0,0,0,0,0,0,0,0,0,0,2,0,0,0,0
6597,791843,8,0,1,0,1,0,0,0,2,0,0,0,0,0,0,0,0
6598,775820,19,3,3,1,1,2,2,0,0,0,1,1,4,0,1,0,8
6598,775538,34,4,5,4,5,0,0,2,4,5,8,1,4,2,6,0,10
6598,791110,33,3,10,2,7,1,3,3,6,1,2,3,4,0,3,0,10
6598,785603,42,8,18,6,10,2,8,3,3,0,4,2,5,1,0,0,21
6598,776425,41,5,14,1,6,4,8,3,3,2,1,8,0,1,3,1,17
6598,791107,14,2,5,2,4,0,1,3,4,2,3,0,3,0,1,0,7
6598,791106,32,2,4,2,3,0,1,0,0,0,0,0,0,0,0,1,4
6598,796762,4,1,1,0,0,1,1,0,0,0,0,0,2,0,0,0,3
6598,786494,31,4,9,3,4,1,5,1,2,2,7,0,3,0,1,0,10
6599,792261,48,9,12,9,12,0,0,2,2,2,4,0,3,0,3,3,20
6599,792258,43,1,11,0,4,1,7,5,6,0,3,6,3,1,1,0,8
6599,786122,44,4,15,0,4,4,11,1,2,3,4,3,3,2,2,1,13
6599,786331,12,1,3,1,3,0,0,0,0,1,2,0,5,0,1,0,2
6599,776284,47,12,23,9,14,3,9,7,8,0,5,4,1,1,4,0,34
6599,797980,28,2,3,2,3,0,0,2,3,6,2,0,4,2,1,0,6
6599,797982,1,0,0,0,0,0,0,0,0,0,1,0,0,0,0,0,0
6599,786113,14,0,1,0,1,0,0,0,0,1,0,1,0,0,1,0,0
6599,780308,13,1,3,0,0,1,3,2,4,0,1,1,2,1,0,0,5
6600,797292,32,9,14,9,14,0,0,1,2,3,5,0,4,1,3,4,19
6600,780509,32,0,2,0,0,0,2,2,2,1,2,1,2,0,2,0,2
6600,797290,40,3,10,2,5,1,5,3,4,0,5,2,3,0,2,0,10
6600,797291,8,0,1,0,1,0,0,2,2,0,0,1,2,0,3,0,2
6600,786064,43,7,15,6,10,1,5,5,5,5,8,0,2,1,3,0,20
6600,791658,13,2,3,2,3,0,0,0,0,1,1,0,1,0,1,1,4
6600,785658,13,2,3,1,2,1,1,0,0,2,2,2,0,1,1,0,5
6600,797295,4,1,1,0,0,1,1,0,0,0,0,0,0,0,0,0,3
6600,791660,40,4,9,2,4,2,5,0,0,0,0,4,0,1,0,1,10
6601,791306,36,5,11,5,10,0,1,1,1,3,2,0,1,3,1,0,11
6601,780210,45,12,21,12,19,0,2,4,5,5,5,1,1,3,4,2,28
6601,792432,41,2,5,1,2,1,3,0,0,0,1,3,3,1,0,0,5
6601,792427,38,5,14,0,5,5,9,5,5,1,2,1,1,1,3,0,20
6601,792433,33,3,3,1,1,2,2,0,0,0,2,1,5,0,0,0,8
6601,796592,9,1,2,1,2,0,0,0,0,0,0,0,4,0,1,0,2
6601,796594,6,0,1,0,0,0,1,0,0,0,0,1,0,0,1,0,0
6601,786422,5,0,0,0,0,0,0,0,0,0,0,1,0,0,0,0,0
6601,775005,12,0,4,0,2,0,2,0,0,0,0,0,1,0,1,0,0
6601,790880,0,0,0,0,0,0,0,0,0,0,0,0,0,0,0,0,0
6602,796761,25,4,7,4,7,0,0,2,2,2,5,0,2,1,1,1,10
6602,796758,33,3,4,3,4,0,0,0,0,1,3,2,3,1,5,0,6
6602,796757,33,5,12,4,7,1,5,0,0,1,3,0,4,0,2,0,11
6602,791101,38,10,15,8,10,2,5,7,11,2,3,1,2,1,4,0,29
6602,780794,27,0,4,0,0,0,4,2,2,0,3,1,1,0,0,0,2
6602,791103,1,0,0,0,0,0,0,0,0,0,0,0,1,0,0,0,0
6602,780109,24,1,4,1,2,0,2,3,4,1,4,0,2,0,1,1,5
6602,796760,2,0,0,0,0,0,0,0,0,0,0,0,1,0,0,0,0
6602,785597,17,1,1,1,1,0,0,0,0,0,0,1,1,2,0,0,2
6603,797754,15,2,6,2,5,0,1,1,1,4,2,0,2,1,0,0,5
6603,775455,27,8,12,8,11,0,1,0,2,1,7,2,4,1,1,0,16
6603,792123,34,6,13,2,3,4,10,0,0,1,4,1,2,1,2,0,16
6603,786005,20,0,5,0,1,0,4,0,0,0,1,0,1,0,1,0,0
6603,781397,25,2,2,2,2,0,0,5,5,4,1,0,2,1,1,0,9
6603,786003,22,1,5,1,4,0,1,0,0,1,4,3,2,0,0,1,2
6603,786009,12,1,3,0,2,1,1,0,0,0,0,0,2,0,0,0,3
6603,797749,18,3,6,0,0,3,6,2,2,1,0,2,1,1,1,0,11
6603,797747,8,1,1,0,0,1,1,0,0,0,0,1,1,1,2,0,3
6603,792120,13,1,4,1,3,0,1,0,1,0,1,3,0,3,3,0,2
6603,786002,6,0,1,0,1,0,0,0,0,0,0,1,0,0,0,0,0
6604,791344,32,3,8,3,6,0,2,0,2,5,1,1,3,2,3,0,6
6604,781425,33,5,11,5,11,0,0,6,6,4,4,0,3,1,4,0,16
6604,791343,35,3,9,3,7,0,2,2,2,1,3,7,3,1,2,0,8
6604,781602,33,10,23,2,10,8,13,2,2,1,2,3,2,3,0,0,30
6604,775746,29,2,8,1,6,1,2,4,4,5,0,0,1,0,0,1,9
6604,781601,7,0,0,0,0,0,0,0,0,0,0,0,1,1,0,0,0
6604,776173,8,0,1,0,0,0,1,0,0,0,0,0,0,0,0,0,0
6604,797001,7,1,1,1,1,0,0,0,0,0,0,0,0,0,0,0,2
6604,796998,4,0,0,0,0,0,0,0,0,0,0,0,0,0,1,0,0
6604,786611,12,0,3,0,2,0,1,0,0,1,0,0,1,1,1,0,0
6605,791201,31,7,9,7,9,0,0,4,4,2,2,6,3,1,5,0,18
6605,775767,25,3,6,3,6,0,0,1,1,0,1,2,3,1,1,1,7
6605,796902,14,1,2,0,1,1,1,0,0,0,0,2,2,1,0,0,3
6605,785628,40,5,8,2,3,3,5,3,4,0,4,5,1,1,4,0,16
6605,785627,29,4,9,3,5,1,4,2,2,1,1,1,1,1,2,0,11
6605,781135,16,1,1,1,1,0,0,1,2,0,5,1,4,1,0,1,3
6605,796903,12,3,3,0,0,3,3,0,0,0,2,2,0,0,0,0,9
6605,796901,8,1,2,0,1,1,1,0,0,0,0,0,0,0,1,0,3
6605,785629,25,1,2,0,0,1,2,0,0,0,5,1,2,0,5,0,3
6606,791883,29,0,4,0,1,0,3,3,4,1,4,0,2,1,1,0,3
6606,781066,21,3,6,3,6,0,0,1,2,2,1,1,3,1,3,2,7
6606,797594,20,3,7,1,2,2,5,0,0,0,2,0,2,0,2,0,8
6606,791884,21,2,6,2,4,0,2,0,0,0,1,1,5,1,4,0,4
6606,780695,31,5,10,3,4,2,6,0,0,0,5,2,0,2,1,0,12
6606,797600,10,1,3,0,2,1,1,2,2,1,0,0,0,0,0,1,5
6606,797598,14,3,5,3,5,0,0,0,0,2,3,0,4,0,1,3,6
6606,797596,26,1,7,0,3,1,4,5,6,0,2,2,1,2,3,0,8
6606,786496,28,1,4,1,3,0,1,2,2,2,3,1,1,1,1,0,4
6607,791524,19,2,6,1,4,1,2,0,0,1,1,0,4,0,3,0,5
6607,797139,26,3,8,3,8,0,0,3,6,3,11,1,4,3,3,0,9
6607,775394,31,3,7,2,5,1,2,1,2,1,0,1,3,3,2,0,8
6607,791526,32,2,7,1,3,1,4,4,5,0,1,2,1,0,6,0,9
6607,780272,29,3,7,1,3,2,4,2,2,0,0,1,0,1,2,0,10
6607,785970,14,0,1,0,1,0,0,1,2,2,5,0,1,0,0,1,1
6607,791523,12,2,6,1,4,1,2,2,2,0,1,1,2,2,0,0,7
6607,780273,17,0,1,0,0,0,1,2,2,1,1,1,0,0,0,0,2
6607,775592,20,1,3,1,1,0,2,2,2,0,1,0,1,1,1,0,4
6608,775897,35,4,6,4,5,0,1,0,0,1,2,1,3,1,0,0,8
6608,780324,29,8,13,8,13,0,0,4,5,3,8,4,0,1,1,3,20
6608,791543,29,5,7,3,4,2,3,0,0,0,1,3,4,3,1,0,12
6608,786530,34,3,8,2,3,1,5,2,2,0,4,2,1,1,2,0,9
6608,780317,33,3,5,2,2,1,3,2,3,0,2,1,1,1,0,0,9
6608,791546,9,0,1,0,1,0,0,0,0,0,2,0,0,0,0,0,0
6608,797091,13,2,2,2,2,0,0,1,2,0,1,1,0,1,0,0,5
6608,786360,3,0,1,0,0,0,1,0,0,0,0,0,0,0,0,0,0
6608,784246,15,2,6,2,4,0,2,1,1,0,0,0,3,0,2,0,5
6609,796953,18,3,9,2,6,1,3,0,0,2,2,2,5,0,1,1,7
6609,775165,34,0,1,0,1,0,0,0,0,1,2,1,1,1,0,0,0
6609,785514,25,4,9,3,5,1,4,0,0,1,1,1,2,0,8,0,9
6609,785515,28,3,8,2,5,1,3,0,0,0,3,2,3,0,2,0,7
6609,781253,34,6,10,3,3,3,7,0,1,0,2,0,2,0,0,1,15
6609,796951,8,2,2,0,0,2,2,0,0,0,1,0,0,1,1,0,6
6609,781249,27,2,3,1,1,1,2,0,0,0,7,5,2,0,1,1,5
6609,791687,26,2,6,0,2,2,4,0,0,0,0,2,1,0,0,0,6
6610,791266,18,1,3,1,3,0,0,4,4,3,1,0,2,1,3,3,6
6610,791270,22,2,3,1,1,1,2,0,0,2,1,3,1,1,3,0,5
6610,791265,19,0,4,0,1,0,3,0,0,0,2,1,1,0,5,0,0
6610,791269,22,2,7,1,2,1,5,0,0,0,1,1,3,0,2,1,5
6610,785685,28,7,13,6,8,1,5,4,6,2,2,2,4,3,5,0,19
6610,796524,7,0,1,0,1,0,0,0,1,0,2,0,0,0,1,1,0
6610,796523,19,0,2,0,1,0,1,0,0,1,1,0,0,0,0,0,0
6610,796522,20,1,6,0,1,1,5,0,0,0,0,0,1,0,4,0,3
6610,796525,14,1,3,1,2,0,1,0,0,0,4,0,1,0,1,0,2
6610,791271,18,2,4,2,4,0,0,1,2,1,1,0,3,0,1,0,5
6610,781313,11,1,3,1,3,0,0,0,0,0,2,0,0,0,2,0,2
6610,788872,2,0,0,0,0,0,0,0,0,0,0,0,0,0,0,0,0
6611,781624,20,2,6,2,5,0,1,2,2,1,1,1,2,2,0,1,6
6611,792246,9,3,5,3,5,0,0,2,2,2,0,0,0,0,1,0,8
6611,797925,24,2,6,1,5,1,1,2,2,2,4,2,1,0,1,1,7
6611,781420,27,6,13,6,11,0,2,4,4,0,4,5,3,2,3,1,16
6611,781405,30,7,11,3,4,4,7,4,4,0,3,5,0,3,1,0,22
6611,797924,14,1,3,1,3,0,0,0,0,2,2,1,3,2,2,1,2
6611,781417,12,2,3,2,3,0,0,0,0,1,0,1,0,1,0,1,4
6611,780615,12,1,1,1,1,0,0,0,0,1,3,0,1,1,1,0,2
6611,797920,3,0,1,0,1,0,0,0,0,0,0,0,0,1,0,0,0
6611,797930,3,0,1,0,0,0,1,0,0,0,0,0,0,0,0,0,0
6611,797933,5,1,2,1,2,0,0,2,2,0,0,0,0,0,1,0,4
6611,791701,19,6,6,5,5,1,1,3,3,0,1,0,2,3,4,0,16
6611,792245,22,1,4,0,3,1,1,0,0,1,3,3,1,4,0,0,3
6612,788113,26,7,10,5,8,2,2,5,7,1,2,1,4,1,1,0,21
6612,776497,34,6,17,5,11,1,6,4,5,1,3,1,0,0,1,2,17
6612,785731,37,8,14,8,12,0,2,3,3,5,12,2,1,3,4,2,19
6612,785729,38,3,5,3,5,0,0,2,2,4,2,6,2,0,3,0,8
6612,780864,27,1,4,1,3,0,1,5,6,1,1,0,3,0,3,0,7
6612,792407,5,0,0,0,0,0,0,0,0,0,1,2,1,0,0,1,0
6612,792402,3,0,0,0,0,0,0,0,0,0,0,0,0,0,1,0,0
6612,796211,5,0,1,0,1,0,0,0,0,0,1,0,0,0,0,0,0
6612,786231,19,1,8,1,5,0,3,0,0,1,3,2,2,1,3,0,2
6612,785443,6,0,4,0,2,0,2,0,0,0,0,0,1,0,0,0,0
6613,781005,26,5,11,2,7,3,4,0,2,0,2,1,1,0,2,2,13
6613,788866,11,0,0,0,0,0,0,0,0,1,1,0,5,0,0,0,0
6613,782162,30,4,14,4,12,0,2,1,2,1,3,1,2,1,3,0,9
6613,792684,24,6,7,2,3,4,4,1,1,1,2,2,2,1,2,1,17
6613,781665,36,0,6,0,1,0,5,2,2,0,5,6,1,1,3,0,2
6613,781659,10,1,1,1,1,0,0,1,1,0,1,0,0,0,0,2,3
6613,781411,5,0,1,0,1,0,0,0,0,0,1,0,1,1,1,3,0
6613,796853,26,3,7,2,4,1,3,0,0,1,4,0,2,3,1,1,7
6613,792683,8,1,2,1,2,0,0,0,0,1,0,0,2,0,1,0,2
6613,780610,24,5,12,3,5,2,7,4,4,1,0,2,2,0,1,0,16
6614,781046,33,6,9,2,3,4,6,3,4,4,4,2,3,1,4,1,19
6614,780025,35,13,20,13,20,0,0,4,6,6,2,1,2,1,1,1,30
6614,796391,22,3,10,2,5,1,5,2,2,0,0,1,4,1,1,0,9
6614,785385,38,4,10,1,2,3,8,2,2,0,2,5,2,0,2,0,13
6614,785383,37,3,8,3,5,0,3,3,4,1,5,7,2,3,2,0,9
6614,790837,14,0,3,0,1,0,2,1,2,0,1,0,0,0,1,0,1
6614,786297,5,0,0,0,0,0,0,0,2,0,0,0,1,0,0,0,0
6614,785382,2,0,1,0,0,0,1,0,0,0,1,0,0,0,0,0,0
6614,792180,14,0,1,0,0,0,1,0,0,0,1,1,3,0,1,0,0
6615,786180,11,1,1,1,1,0,0,0,0,0,1,0,3,0,1,0,2
6615,792104,34,9,18,5,11,4,7,2,2,2,8,1,2,2,1,0,24
6615,797709,16,0,2,0,1,0,1,0,0,1,3,0,0,0,0,0,0
6615,797708,31,8,14,5,9,3,5,2,2,0,1,4,1,1,3,0,21
6615,775779,33,5,8,5,7,0,1,3,4,0,2,10,1,1,2,0,13
6615,786204,18,2,4,1,1,1,3,4,4,1,5,1,3,2,1,0,9
6615,785608,17,4,6,4,6,0,0,1,2,2,2,0,4,0,0,0,9
6615,797707,23,3,3,3,3,0,0,2,2,0,2,1,3,2,2,0,8
6615,786198,17,2,2,0,0,2,2,0,0,0,1,0,2,1,1,0,6
6616,785518,28,2,11,2,7,0,4,3,4,1,7,1,5,1,3,1,7
6616,796390,17,1,1,1,1,0,0,0,0,3,3,1,5,0,2,2,2
6616,785451,32,4,13,1,6,3,7,1,2,0,5,1,3,1,5,0,12
6616,790832,11,1,4,0,0,1,4,2,4,0,0,0,1,0,0,0,5
6616,790834,24,3,6,1,3,2,3,0,2,2,0,0,2,0,1,0,8
6616,790833,24,3,5,2,3,1,2,5,6,2,2,1,1,0,2,0,12
6616,785377,27,2,4,2,4,0,0,6,8,3,2,9,0,5,1,0,10
6616,790831,14,3,3,3,3,0,0,1,3,0,2,0,2,1,1,2,7
6616,790830,17,1,4,0,2,1,2,0,0,0,1,1,3,2,1,0,3
6616,785379,6,0,1,0,1,0,0,0,0,0,0,0,0,0,0,0,0
6617,785589,38,8,13,8,13,0,0,7,10,2,7,1,3,0,4,0,23
6617,791209,19,2,3,2,3,0,0,0,0,1,0,1,3,0,0,0,4
6617,791215,33,1,7,1,3,0,4,3,4,1,2,4,2,2,2,0,5
6617,791213,31,3,9,3,5,0,4,2,2,0,1,1,4,2,2,0,8
6617,791214,37,1,8,0,4,1,4,2,2,1,4,4,2,0,3,0,5
6617,791216,20,3,4,3,3,0,1,4,6,0,4,2,1,0,3,0,10
6617,776313,19,2,3,2,3,0,0,0,0,0,1,2,5,1,1,0,4
6617,791212,3,0,0,0,0,0,0,0,0,0,0,0,0,0,0,0,0
6618,791444,30,5,7,5,7,0,0,0,2,5,6,1,3,2,0,1,10
6618,785287,17,3,4,3,4,0,0,0,0,1,3,2,0,1,3,1,6
6618,797010,22,9,12,7,9,2,3,2,2,1,5,6,3,3,3,1,22
6618,797012,36,10,16,10,14,0,2,0,0,1,8,11,2,8,5,0,20
6618,785895,32,11,19,1,1,10,18,0,0,1,2,2,1,2,0,0,32
6618,797009,23,3,11,0,3,3,8,0,0,0,2,2,1,0,1,0,9
6618,797011,28,5,10,5,10,0,0,1,2,5,8,0,1,1,0,2,11
6618,781626,12,0,4,0,4,0,0,2,2,1,2,1,1,0,1,0,2
6620,790884,41,8,13,8,13,0,0,6,11,4,11,0,4,1,0,5,22
6620,791635,32,2,7,2,4,0,3,2,2,0,3,0,3,0,3,3,6
6620,790883,44,4,13,4,11,0,2,8,9,2,8,1,4,2,7,0,16
6620,796436,41,5,22,2,17,3,5,6,6,1,7,2,4,2,6,1,19
6620,796438,22,2,3,2,3,0,0,0,1,0,2,0,1,2,3,0,4
6620,790885,1,0,0,0,0,0,0,0,0,0,0,0,0,0,0,0,0
6620,781262,19,2,4,0,1,2,3,0,0,0,0,0,0,0,0,0,6
6620,785436,46,1,6,1,6,0,0,0,2,2,6,1,3,1,2,0,2
6620,796442,4,0,0,0,0,0,0,0,0,0,0,0,0,0,0,0,0
6621,796469,20,2,8,2,5,0,3,1,2,3,7,1,2,0,4,2,5
6621,779981,19,3,7,3,7,0,0,1,1,4,4,0,3,1,3,2,7
6621,785463,44,2,15,1,9,1,6,8,8,1,2,2,3,4,1,0,13
6621,779978,45,3,14,3,7,0,7,1,2,1,4,3,4,2,2,0,7
6621,776003,41,5,20,3,7,2,13,5,5,1,3,0,1,4,4,0,17
6621,785466,27,1,4,0,0,1,4,0,0,3,7,3,3,5,1,1,3
6621,779980,6,1,2,1,2,0,0,1,1,1,1,0,3,0,0,0,3
6621,790923,22,3,5,2,4,1,1,4,6,3,6,0,5,1,5,1,11
6621,790924,26,0,4,0,3,0,1,1,2,3,0,0,1,1,1,0,1
6622,792036,17,1,1,1,1,0,0,2,2,0,1,0,4,0,1,0,4
6622,792043,18,1,6,0,4,1,2,0,0,0,1,0,1,1,2,0,3
6622,786266,32,5,12,5,8,0,4,0,1,0,4,4,3,1,1,0,10
6622,797718,21,2,4,0,1,2,3,2,2,0,0,2,3,2,1,0,8
6622,775028,35,4,10,4,7,0,3,0,0,0,4,4,3,0,5,0,8
6622,797728,25,2,6,2,3,0,3,0,1,0,3,1,2,0,0,1,4
6622,786039,14,1,1,1,1,0,0,2,2,0,2,0,4,0,3,1,4
6622,797719,12,2,4,1,2,1,2,0,2,0,0,1,0,0,0,0,5
6622,792040,26,8,10,8,10,0,0,3,4,2,1,0,1,1,0,1,19
6623,786519,32,7,8,7,8,0,0,3,4,5,9,3,2,0,2,0,17
6623,791911,27,1,5,1,2,0,3,0,0,1,3,2,4,0,2,0,2
6623,797556,32,4,9,3,6,1,3,7,8,0,3,1,1,1,2,0,16
6623,791913,36,3,8,2,3,1,5,0,0,0,3,5,2,1,1,0,7
6623,786520,34,6,14,4,9,2,5,7,8,2,3,1,3,2,1,0,21
6623,797558,11,1,5,1,2,0,3,0,0,0,3,0,3,0,2,0,2
6623,797560,8,0,0,0,0,0,0,0,1,0,0,1,1,0,0,1,0
6623,797555,8,5,7,3,5,2,2,2,3,1,1,0,1,1,1,0,14
6623,781105,12,0,0,0,0,0,0,0,0,0,2,1,1,0,1,0,0
6624,790784,32,5,9,4,5,1,4,1,1,2,5,1,2,0,2,1,12
6624,786235,23,4,6,4,6,0,0,0,0,2,2,0,3,0,0,3,8
6624,797475,26,3,9,0,3,3,6,6,8,1,4,1,1,0,0,0,15
6624,786229,21,2,3,2,2,0,1,0,0,0,1,3,4,2,1,0,4
6624,775229,25,3,6,3,6,0,0,3,4,1,5,3,4,0,4,0,9
6624,776219,17,0,2,0,0,0,2,0,0,0,0,1,0,0,1,0,0
6624,791871,14,0,2,0,2,0,0,0,0,0,0,2,0,2,2,0,0
6624,786581,11,1,1,1,1,0,0,2,2,0,2,0,0,0,0,0,4
6624,786770,15,3,4,3,4,0,0,0,1,0,1,1,1,0,3,0,6
6624,786719,8,0,0,0,0,0,0,0,0,0,1,0,0,0,1,0,0
6624,781518,8,1,1,0,0,1,1,0,0,0,0,0,1,0,0,0,3
6625,791648,20,1,2,1,2,0,0,0,0,0,1,0,2,0,1,0,2
6625,786195,22,5,7,5,7,0,0,3,4,1,1,0,2,1,3,0,13
6625,797280,32,3,9,3,7,0,2,0,0,0,3,5,2,1,1,0,6
6625,797279,19,1,5,0,1,1,4,1,2,0,2,0,1,1,1,0,4
6625,786640,35,3,7,2,6,1,1,2,2,0,1,2,1,2,2,0,9
6625,797281,12,3,5,3,5,0,0,0,1,1,1,0,1,0,0,0,6
6625,791647,31,4,6,3,5,1,1,5,7,0,4,1,4,0,1,0,14
6625,791649,29,1,3,1,2,0,1,0,0,0,4,2,4,1,2,0,2
6625,785694,0,0,0,0,0,0,0,0,0,0,0,0,1,0,0,0,0
6626,790914,20,2,3,2,3,0,0,3,4,4,6,1,2,1,2,1,7
6626,780798,21,0,6,0,1,0,5,0,0,1,2,1,2,0,0,0,0
6626,785455,25,1,8,1,5,0,3,2,3,3,0,4,2,2,5,1,4
6626,785453,31,4,13,2,5,2,8,3,5,1,4,0,2,0,1,0,13
6626,774940,27,4,8,2,5,2,3,0,0,0,2,1,1,1,1,0,10
6626,790915,12,2,4,2,4,0,0,1,2,0,0,0,3,0,1,1,5
6626,785458,26,4,13,4,10,0,3,5,7,0,2,1,2,1,1,2,13
6626,790913,10,0,1,0,1,0,0,2,2,0,1,0,1,1,1,0,2
6626,785456,7,1,1,0,0,1,1,0,0,0,0,0,1,1,0,0,3
6626,785454,17,0,3,0,1,0,2,0,0,0,1,3,0,1,1,0,0
6626,790911,4,1,1,1,1,0,0,0,0,0,0,0,0,1,0,0,2
6627,785999,26,3,6,3,6,0,0,3,7,2,6,1,4,0,2,0,9
6627,775654,28,1,3,1,3,0,0,0,0,3,4,0,2,1,2,2,2
6627,796399,29,3,12,1,7,2,5,0,1,2,4,5,2,1,4,1,8
6627,791639,29,5,11,3,6,2,5,4,4,0,4,4,2,0,3,0,16
6627,785389,36,10,17,6,11,4,6,5,5,0,3,1,3,3,3,0,29
6627,796401,29,3,4,1,2,2,2,1,1,0,4,2,2,1,2,2,9
6627,791640,11,1,1,1,1,0,0,0,0,1,3,1,2,1,2,1,2
6627,785255,3,0,1,0,0,0,1,0,0,0,1,0,1,0,1,0,0
6627,796398,9,0,1,0,1,0,0,0,0,1,1,0,3,0,0,0,0
6628,796372,22,1,5,1,5,0,0,3,8,0,4,0,4,0,3,1,5
6628,790814,40,1,4,1,3,0,1,2,4,3,6,1,2,1,0,2,4
6628,796379,27,5,7,1,2,4,5,2,2,0,7,2,4,1,6,0,16
6628,796377,18,1,2,1,2,0,0,2,2,1,5,2,3,1,1,0,4
6628,780176,40,5,15,1,4,4,11,2,2,1,1,5,3,2,3,0,16
6628,786013,18,4,6,4,6,0,0,2,3,1,1,0,4,0,3,0,10
6628,796374,26,2,3,1,1,1,2,0,0,0,0,3,0,0,0,0,5
6628,796378,9,1,2,1,1,0,1,0,1,0,0,0,0,0,0,0,2
6629,780323,27,3,10,3,10,0,0,0,0,2,4,5,1,1,0,0,6
6629,797894,12,0,2,0,2,0,0,0,0,1,0,0,2,0,0,0,0
6629,785811,35,8,17,7,11,1,6,6,9,0,4,4,3,2,5,1,23
6629,785954,35,4,6,1,2,3,4,2,4,0,8,3,2,1,1,1,13
6629,792229,36,4,8,1,4,3,4,4,5,2,4,4,3,0,1,0,15
6629,792234,13,1,1,0,0,1,1,2,2,0,1,0,0,2,0,3,5
6629,786016,17,1,3,0,0,1,3,0,0,1,0,1,3,2,0,0,3
6629,792230,11,1,1,1,1,0,0,1,2,0,0,0,1,0,1,0,3
6629,797891,3,1,1,0,0,1,1,0,0,0,1,1,2,0,0,0,3
6629,792233,11,1,2,1,1,0,1,0,0,0,0,0,1,0,0,0,2
6630,785392,38,5,12,2,6,3,6,6,8,1,1,5,3,1,5,0,19
6630,775142,34,8,12,5,8,3,4,6,6,4,1,3,2,3,3,0,25
6630,781563,32,3,7,3,6,0,1,2,3,0,3,2,2,0,2,0,8
6630,786212,35,3,14,2,7,1,7,0,0,2,7,2,3,2,1,1,7
6630,790844,22,2,4,2,4,0,0,0,0,1,2,5,4,1,1,0,4
6630,799986,15,3,3,3,3,0,0,2,3,2,0,0,4,0,1,2,8
6630,796914,24,5,7,0,0,5,7,0,0,1,3,1,0,1,1,0,15
6631,786772,22,0,3,0,3,0,0,2,4,0,2,0,2,1,1,0,2
6631,786769,39,5,8,3,5,2,3,1,1,0,2,1,3,1,2,2,13
6631,786024,20,2,8,1,5,1,3,2,2,0,2,2,2,3,2,0,7
6631,781484,23,2,3,0,0,2,3,1,2,1,2,0,4,1,2,2,7
6631,780002,32,7,14,5,10,2,4,7,8,1,3,4,3,0,5,0,23
6631,791967,23,6,10,4,4,2,6,1,2,1,1,2,0,0,1,0,15
6631,790823,19,0,0,0,0,0,0,0,0,0,2,0,2,1,1,0,0
6631,786773,10,3,3,3,3,0,0,1,2,1,1,0,0,0,0,2,7
6631,797840,12,0,0,0,0,0,0,0,0,0,0,2,1,0,0,0,0
6632,775510,38,8,9,5,5,3,4,4,4,0,6,1,2,0,1,0,23
6632,774976,25,5,6,2,2,3,4,0,2,1,7,0,5,1,2,2,13
6632,797865,27,1,4,0,2,1,2,1,2,0,0,2,3,2,0,0,4
6632,786614,36,3,8,3,6,0,2,2,2,2,2,0,0,2,1,0,8
6632,786759,37,4,12,3,6,1,6,2,2,0,1,8,3,0,4,0,11
6632,786761,7,0,0,0,0,0,0,0,0,0,1,0,2,0,1,0,0
6632,792293,10,0,2,0,1,0,1,0,0,0,0,0,0,0,1,0,0
6632,792291,20,4,6,0,1,4,5,2,2,0,2,2,0,0,0,0,14
6633,791876,36,8,18,8,17,0,1,2,2,4,6,1,1,1,2,0,18
6633,791877,32,4,9,4,9,0,0,1,2,4,2,2,2,0,0,0,9
6633,785667,34,5,13,2,5,3,8,2,2,1,3,1,2,0,0,0,15
6633,786572,38,4,6,4,5,0,1,0,1,1,2,0,4,2,2,0,8
6633,786570,36,3,12,3,9,0,3,4,6,1,3,7,1,1,1,1,10
6633,797486,21,2,2,1,1,1,1,1,2,0,2,0,1,0,1,0,6
6633,781205,3,0,0,0,0,0,0,0,0,0,0,0,0,0,1,0,0
6634,796699,27,3,8,3,6,0,2,2,3,1,2,2,2,1,2,1,8
6634,790983,28,6,11,2,4,4,7,0,0,3,3,3,2,1,0,1,16
6634,790978,37,5,12,3,5,2,7,4,4,2,5,0,1,0,2,2,16
6634,790979,29,6,8,4,5,2,3,2,4,1,3,2,3,2,5,0,16
6634,796697,40,4,13,1,5,3,8,4,5,0,1,14,2,3,6,0,15
6634,796701,29,5,7,5,7,0,0,0,2,4,2,1,2,0,0,0,10
6634,788820,20,1,4,0,2,1,2,0,0,0,2,0,1,0,2,0,3
6634,796698,7,0,0,0,0,0,0,0,0,0,0,1,1,0,0,1,0
6634,790976,7,0,0,0,0,0,0,0,0,0,1,0,3,0,0,0,0
6634,790977,1,0,0,0,0,0,0,0,0,0,0,0,0,0,0,0,0
6635,786132,37,3,6,2,3,1,3,5,6,2,3,1,3,0,0,1,12
6635,775074,40,14,18,14,17,0,1,2,3,6,4,1,4,1,1,4,30
6635,786448,34,1,4,0,2,1,2,2,2,2,7,3,3,1,3,0,5
6635,780731,39,4,10,4,8,0,2,0,0,0,0,1,2,4,4,0,8
6635,780462,41,10,25,6,15,4,10,2,2,0,6,4,2,2,3,0,26
6635,786447,6,0,0,0,0,0,0,0,0,0,0,1,1,0,1,0,0
6635,796971,13,0,1,0,1,0,0,0,0,1,1,0,1,0,1,0,0
6635,791632,10,1,2,1,1,0,1,3,4,0,0,2,2,1,0,0,5
6635,791631,5,0,0,0,0,0,0,0,0,0,0,0,0,0,1,0,0
6636,796540,29,2,5,2,4,0,1,2,2,0,3,0,3,1,0,0,6
6636,790951,20,2,6,2,6,0,0,1,2,4,1,0,2,0,2,2,5
6636,786309,18,3,7,2,4,1,3,3,4,1,1,0,2,4,0,0,10
6636,780087,37,7,15,5,12,2,3,9,10,1,3,1,5,3,5,0,25
6636,776136,30,1,5,0,2,1,3,2,2,2,4,4,4,1,3,0,5
6636,796543,6,0,0,0,0,0,0,0,0,0,1,0,1,0,0,0,0
6636,775037,7,1,2,1,2,0,0,0,0,0,1,0,0,0,0,0,2
6636,796545,4,0,0,0,0,0,0,0,0,0,0,0,1,0,0,0,0
6636,796544,3,0,0,0,0,0,0,0,0,0,0,1,1,0,1,0,0
6636,790952,21,1,2,0,0,1,2,2,2,0,1,0,0,2,0,0,5
6636,786089,6,2,4,0,0,2,4,0,0,0,0,0,1,0,0,0,6
6636,776076,19,1,3,1,3,0,0,0,2,0,0,2,3,2,2,0,2
6637,789177,29,3,4,3,4,0,0,2,4,3,12,1,3,1,3,3,8
6637,780227,17,0,1,0,1,0,0,1,3,1,1,0,4,0,3,0,1
6637,791340,34,6,9,4,6,2,3,5,7,0,1,5,3,1,2,0,19
6637,780181,36,7,16,5,9,2,7,5,5,1,5,3,0,0,2,1,21
6637,776089,32,4,8,1,2,3,6,0,0,0,0,2,2,1,4,1,11
6637,797260,1,0,0,0,0,0,0,0,0,0,0,0,0,0,0,0,0
6637,775758,25,0,1,0,1,0,0,4,4,2,0,2,3,0,2,1,4
6637,791336,15,4,7,2,4,2,3,0,0,0,0,3,1,2,2,0,10
6637,789178,11,0,2,0,0,0,2,0,0,0,1,0,1,0,0,0,0
6638,796617,12,1,1,1,1,0,0,0,0,0,0,1,2,0,2,0,2
6638,775131,32,2,7,0,2,2,5,2,2,0,4,3,3,1,2,2,8
6638,796616,25,2,6,0,2,2,4,0,0,0,2,0,1,2,0,0,6
6638,796612,30,6,10,6,8,0,2,0,0,2,2,3,0,1,2,0,12
6638,785562,27,6,9,5,7,1,2,2,2,2,9,4,2,3,0,0,15
6638,792429,8,0,4,0,2,0,2,0,0,0,1,1,1,0,2,0,0
6638,796618,4,0,0,0,0,0,0,0,0,0,0,0,1,0,0,1,0
6638,796619,4,0,1,0,0,0,1,0,0,0,0,0,0,0,3,0,0
6638,796614,10,3,6,3,6,0,0,0,1,1,3,0,1,0,0,0,6
6638,796610,6,0,1,0,1,0,0,0,0,0,4,0,0,0,0,0,0
6638,796607,21,3,6,2,4,1,2,0,0,2,1,1,2,0,1,0,7
6638,796606,21,2,4,2,3,0,1,3,4,2,2,3,2,2,0,0,7
6639,797258,20,1,3,1,3,0,0,0,0,3,4,0,1,2,0,1,2
6639,786080,27,0,6,0,3,0,3,2,2,0,2,1,1,0,4,1,2
6639,791348,30,6,13,6,10,0,3,0,0,0,2,0,1,0,2,0,12
6639,791350,29,2,6,0,0,2,6,0,0,0,3,2,2,1,1,0,6
6639,786218,32,2,9,1,6,1,3,4,6,3,3,0,2,1,2,0,9
6639,786216,21,0,1,0,1,0,0,0,0,2,3,1,3,1,1,0,0
6639,797256,3,0,0,0,0,0,0,0,0,1,0,0,0,0,0,0,0
6639,786221,1,0,1,0,0,0,1,0,0,0,0,0,0,0,0,0,0
6639,781645,20,3,8,2,4,1,4,3,8,0,1,1,1,0,1,0,10
6639,780150,17,1,3,0,1,1,2,0,0,0,1,1,1,0,1,0,3
6640,790909,40,7,20,2,6,5,14,3,3,0,2,2,2,1,0,0,22
6640,781393,40,9,19,7,12,2,7,0,0,1,3,4,3,1,1,0,20
6640,775351,40,4,9,4,9,0,0,2,6,4,6,2,2,3,2,0,10
6640,787175,34,3,9,0,0,3,9,0,1,1,7,1,3,1,3,1,9
6640,796455,36,2,5,2,5,0,0,2,2,4,6,0,1,0,0,2,6
6640,782126,10,1,3,0,0,1,3,0,0,0,1,1,0,1,0,1,3
6640,796456,0,0,0,0,0,0,0,0,0,0,0,0,0,0,0,0,0
6640,790910,0,0,0,0,0,0,0,0,0,0,0,0,0,0,0,0,0
6640,796454,0,0,0,0,0,0,0,0,0,0,0,0,0,0,0,0,0
6641,774921,37,4,13,2,6,2,7,4,5,0,3,2,4,3,1,1,14
6641,786090,36,2,9,1,5,1,4,4,4,3,3,3,1,0,0,0,9
6641,791132,26,3,9,2,3,1,6,2,3,3,5,0,1,0,1,4,9
6641,786088,35,2,8,2,5,0,3,2,2,0,6,4,1,1,4,0,6
6641,791135,18,1,3,1,3,0,0,0,1,4,4,0,0,0,4,0,2
6641,791131,22,8,12,4,5,4,7,2,2,2,4,0,3,0,2,1,22
6641,796791,13,1,3,1,1,0,2,0,0,0,1,0,1,0,0,0,2
6641,791134,3,1,1,1,1,0,0,0,0,1,1,0,0,0,0,0,2
6641,785541,6,0,2,0,2,0,0,0,0,0,0,0,1,0,0,1,0
6641,791133,4,0,1,0,1,0,0,0,0,1,1,0,1,0,1,0,0
6641,786097,0,0,0,0,0,0,0,0,0,0,0,0,0,0,0,0,0
6642,798003,38,7,14,7,13,0,1,7,8,0,5,3,4,3,5,0,21
6642,792265,36,3,10,3,8,0,2,6,6,2,1,0,1,2,1,1,12
6642,786152,37,5,9,4,7,1,2,0,0,4,11,1,1,0,2,2,11
6642,792267,34,3,8,0,3,3,5,0,0,1,2,1,1,0,4,0,9
6642,792266,24,1,6,1,4,0,2,6,7,0,3,1,4,2,1,0,8
6642,792263,19,1,4,1,4,0,0,1,1,1,1,3,3,0,1,0,3
6642,798007,7,0,0,0,0,0,0,0,0,0,0,1,3,0,2,1,0
6642,798006,5,0,2,0,1,0,1,0,0,0,0,0,1,0,0,0,0
6643,781504,32,3,10,2,6,1,4,4,6,0,2,2,2,2,4,1,11
6643,796609,31,3,10,2,7,1,3,4,6,1,3,4,2,0,1,0,11
6643,796611,27,4,5,4,4,0,1,2,2,0,1,1,2,0,2,1,10
6643,792869,27,3,6,0,3,3,3,0,0,1,2,3,2,1,0,0,9
6643,785664,19,1,5,1,5,0,0,2,5,3,5,0,3,0,1,2,4
6643,792232,18,5,5,1,1,4,4,0,0,0,6,2,2,2,0,1,14
6643,796613,14,5,7,3,3,2,4,0,0,0,2,1,2,0,2,0,12
6643,766623,19,2,3,2,3,0,0,2,3,2,2,2,2,1,0,0,6
6643,791312,13,1,3,1,3,0,0,0,0,1,0,1,1,0,1,0,2
6644,780631,15,2,6,2,2,0,4,1,2,3,1,0,0,0,2,0,5
6644,791827,37,7,16,7,16,0,0,3,4,3,13,1,5,2,3,4,17
6644,797391,22,2,4,0,1,2,3,0,0,1,1,0,1,0,2,0,6
6644,786625,39,1,10,0,3,1,7,0,0,0,1,4,3,1,3,1,3
6644,780625,33,3,11,2,5,1,6,0,1,0,4,3,2,2,1,0,7
6644,785481,18,2,4,2,3,0,1,0,0,1,3,2,5,0,0,1,4
6644,797395,34,7,13,6,10,1,3,1,2,2,2,3,0,1,2,0,16
6644,797394,8,1,1,0,0,1,1,0,0,0,0,1,1,0,1,0,3
6644,786630,19,2,4,2,4,0,0,1,2,1,4,0,4,1,0,0,5
6645,780686,35,7,17,7,17,0,0,1,3,3,1,1,2,3,5,0,15
6645,780683,36,3,10,3,8,0,2,5,6,8,16,1,2,0,2,2,11
6645,797680,23,1,4,1,2,0,2,0,0,0,3,0,1,0,1,1,2
6645,786112,41,7,17,6,12,1,5,6,7,2,3,3,2,3,2,0,21
6645,780688,35,4,6,3,5,1,1,6,9,2,4,1,1,1,1,0,15
6645,797683,7,0,2,0,1,0,1,0,0,0,1,0,3,0,0,0,0
6645,797679,13,2,3,0,0,2,3,0,0,0,0,0,0,2,1,0,6
6645,797677,11,0,4,0,3,0,1,0,0,0,1,0,0,1,0,0,0
6645,791942,12,0,0,0,0,0,0,0,0,0,1,0,2,0,1,0,0
6645,780689,12,0,1,0,0,0,1,0,0,0,1,0,4,1,1,0,0
6646,786792,23,2,2,2,2,0,0,3,4,5,3,2,1,0,0,0,7
6646,789020,37,2,8,1,4,1,4,5,5,0,2,1,1,3,0,0,10
6646,792091,26,9,14,3,4,6,10,0,0,1,5,1,1,0,2,0,24
6646,786787,35,7,17,3,9,4,8,8,8,1,2,4,1,3,4,0,26
6646,774954,29,3,4,3,4,0,0,4,4,2,2,4,1,2,2,0,10
6646,786795,5,0,2,0,0,0,2,0,0,0,0,1,0,1,0,0,0
6646,781497,12,0,0,0,0,0,0,0,0,0,4,0,1,1,0,1,0
6646,796878,3,0,0,0,0,0,0,0,0,0,0,1,0,1,0,0,0
6646,796876,6,0,3,0,0,0,3,0,0,0,0,0,1,1,1,0,0
6646,792414,21,2,5,1,1,1,4,1,2,1,1,1,4,0,0,1,6
6646,796875,3,0,1,0,1,0,0,0,0,0,2,0,0,0,1,0,0
6647,780521,24,0,3,0,0,0,3,1,2,2,3,2,4,0,2,0,1
6647,775163,20,4,6,4,6,0,0,2,2,0,1,0,0,1,1,1,10
6647,791370,27,5,8,2,4,3,4,0,0,0,2,0,3,0,4,0,13
6647,786199,31,5,11,2,4,3,7,0,0,0,5,4,2,3,4,0,13
6647,780991,35,5,8,3,3,2,5,0,0,0,4,5,1,0,1,2,12
6647,797269,3,0,0,0,0,0,0,0,0,0,0,0,0,0,1,0,0
6647,780145,14,0,2,0,2,0,0,0,0,2,0,0,2,0,0,0,0
6647,781611,3,0,0,0,0,0,0,0,0,0,0,0,0,0,0,0,0
6647,797271,18,3,6,2,3,1,3,0,0,0,1,3,1,0,2,0,7
6647,797270,3,0,0,0,0,0,0,0,0,0,0,0,0,0,0,0,0
6647,743593,13,0,4,0,3,0,1,0,0,0,1,1,4,0,2,0,0
6647,797268,2,0,1,0,1,0,0,0,0,0,0,0,0,0,0,0,0
6647,791371,7,0,1,0,0,0,1,0,0,0,1,0,2,0,1,0,0
6648,797849,32,6,10,4,5,2,5,6,6,0,1,2,1,2,2,0,20
6648,781537,28,2,8,1,3,1,5,0,0,3,7,1,3,0,2,0,5
6648,779986,16,1,4,1,4,0,0,0,2,3,3,1,2,0,0,0,2
6648,792202,29,3,9,2,4,1,5,0,0,0,3,2,0,0,0,0,7
6648,786079,37,5,9,4,6,1,3,1,2,1,2,6,2,0,1,0,12
6648,797842,26,4,9,3,8,1,1,0,0,1,3,3,2,3,2,0,9
6648,797838,1,0,1,0,0,0,1,0,0,0,0,0,1,0,0,0,0
6648,797848,10,0,3,0,3,0,0,3,4,3,2,1,2,0,0,1,3
6648,797847,19,3,8,1,3,2,5,0,0,0,1,0,2,0,0,0,8
6648,797835,2,0,0,0,0,0,0,0,0,0,0,0,0,0,0,0,0
6649,797824,28,4,8,0,1,4,7,2,2,1,7,1,1,2,2,2,14
6649,797825,11,3,4,3,4,0,0,1,2,0,0,0,4,0,1,0,7
6649,792190,39,5,12,2,5,3,7,2,2,0,3,6,0,2,0,0,15
6649,786664,37,5,14,4,7,1,7,3,6,1,1,5,2,0,1,0,14
6649,791928,23,2,3,2,2,0,1,2,2,0,4,2,0,0,0,0,6
6649,792191,25,1,3,1,2,0,1,1,3,3,2,1,0,0,3,0,3
6649,775116,16,2,4,1,1,1,3,0,0,0,1,0,4,0,2,0,5
6649,781266,4,0,1,0,0,0,1,0,0,0,0,0,0,0,0,0,0
6649,792192,17,0,2,0,2,0,0,0,0,3,4,0,3,0,1,1,0
6650,780269,36,8,17,6,12,2,5,0,1,0,3,3,2,1,5,0,18
6650,785700,29,2,3,1,2,1,1,4,4,0,1,4,4,5,2,0,9
6650,786721,17,1,4,0,1,1,3,0,0,1,1,1,4,0,2,0,3
6650,791171,15,1,3,1,3,0,0,1,2,0,2,0,3,0,0,0,3
6650,790511,14,0,6,0,6,0,0,1,2,1,1,0,1,1,0,1,1
6650,796837,29,6,8,4,4,2,4,2,5,1,6,0,1,1,1,0,16
6650,796833,19,1,6,0,0,1,6,4,4,2,1,0,1,0,0,0,7
6650,796838,17,2,3,2,3,0,0,0,0,2,3,1,2,0,1,4,4
6650,796834,13,1,3,1,3,0,0,0,0,0,2,0,0,1,0,0,2
6650,785706,11,0,2,0,0,0,2,0,0,0,1,0,1,0,0,0,0
6651,792304,36,7,10,3,5,4,5,0,0,2,7,1,4,2,1,0,18
6651,786286,35,4,12,0,3,4,9,0,0,1,5,1,1,0,2,0,12
6651,792301,31,3,8,3,7,0,1,4,5,0,0,3,2,1,2,0,10
6651,792299,26,3,6,2,4,1,2,1,3,3,7,6,3,1,1,2,8
6651,786181,22,3,4,3,4,0,0,2,2,2,4,0,2,0,6,0,8
6651,786278,28,5,13,4,9,1,4,3,3,4,2,2,3,2,3,0,14
6651,786280,11,2,6,2,6,0,0,0,0,2,3,0,0,0,0,0,4
6651,798093,7,0,2,0,1,0,1,1,2,1,0,0,0,0,1,1,1
6651,798092,4,0,0,0,0,0,0,0,0,0,0,0,2,0,0,0,0
6652,792288,35,6,9,6,9,0,0,1,2,1,5,1,2,1,0,0,13
6652,785227,30,2,8,2,8,0,0,3,4,0,3,0,4,0,2,0,7
6652,786237,25,3,7,3,7,0,0,0,2,2,5,1,1,1,1,0,6
6652,786232,28,0,2,0,0,0,2,1,2,0,3,2,2,0,0,0,1
6652,780287,27,7,11,6,9,1,2,4,6,0,2,3,1,0,0,0,19
6652,798067,9,0,1,0,1,0,0,0,0,1,2,0,1,0,0,1,0
6652,792278,26,6,8,1,1,5,7,2,2,0,0,1,2,2,4,0,19
6652,776309,20,4,6,2,4,2,2,0,3,0,4,2,0,1,1,0,10
6653,780095,26,0,1,0,1,0,0,0,0,2,1,1,3,0,2,1,0
6653,776321,26,3,12,2,8,1,4,6,6,2,5,0,2,1,0,0,13
6653,786081,36,4,10,3,8,1,2,2,3,1,7,1,2,0,2,0,11
6653,785431,31,2,5,2,4,0,1,0,0,0,2,4,5,1,4,1,4
6653,780232,37,5,15,3,7,2,8,5,6,0,5,4,4,1,5,0,17
6653,785356,28,5,6,0,1,5,5,0,0,0,3,0,0,0,0,0,15
6653,797918,9,0,1,0,1,0,0,0,0,0,0,1,0,0,0,0,0
6653,789040,7,0,0,0,0,0,0,0,0,0,1,0,1,0,2,0,0
6654,797050,32,3,6,2,3,1,3,1,2,1,5,1,2,1,0,0,8
6654,780394,36,5,10,2,3,3,7,1,1,2,5,3,2,1,2,0,14
6654,780391,27,5,5,5,5,0,0,0,0,1,1,3,4,2,3,3,10
6654,790871,29,6,11,3,4,3,7,1,3,0,1,1,4,0,4,0,16
6654,776473,34,1,7,0,3,1,4,3,4,0,6,3,3,0,2,1,6
6654,797048,8,0,2,0,0,0,2,0,0,0,3,0,0,0,0,0,0
6654,791573,5,1,1,1,1,0,0,1,1,0,0,1,2,0,0,0,3
6654,785783,12,1,5,0,1,1,4,1,2,0,0,1,1,0,0,0,4
6654,780392,17,2,5,2,3,0,2,3,3,0,1,0,0,0,0,0,7
6655,785714,25,6,7,6,7,0,0,2,5,1,7,2,4,0,1,0,14
6655,775894,38,5,11,5,9,0,2,3,4,3,5,6,2,2,3,1,13
6655,785711,35,5,15,3,8,2,7,1,3,1,2,2,3,3,0,0,13
6655,780985,33,4,8,3,6,1,2,0,0,0,6,2,2,0,1,0,9
6655,775266,32,1,6,0,4,1,2,2,2,1,3,2,3,1,3,0,5
6655,796829,15,5,7,5,7,0,0,1,1,4,1,1,0,0,0,1,11
6655,791167,8,0,1,0,0,0,1,0,0,1,2,0,1,0,1,0,0
6655,785378,2,0,1,0,0,0,1,0,0,0,0,1,2,0,0,0,0
6655,779994,12,2,2,0,0,2,2,0,0,0,0,1,1,0,1,0,6
6656,780753,28,7,9,6,6,1,3,1,1,0,4,2,1,1,5,0,16
6656,792318,27,5,9,5,9,0,0,2,6,4,7,0,1,2,3,2,12
6656,775329,21,3,10,0,2,3,8,2,2,1,1,1,4,0,1,0,11
6656,796519,29,3,7,0,2,3,5,1,2,1,2,2,4,0,5,1,10
6656,786717,17,1,7,1,5,0,2,2,2,3,2,2,4,0,2,0,4
6656,796516,29,1,3,1,3,0,0,5,8,1,2,2,3,1,3,2,7
6656,796520,20,3,7,2,3,1,4,0,0,0,1,0,2,3,0,0,7
6656,796517,17,2,6,0,3,2,3,0,0,1,1,1,2,2,0,0,6
6656,792308,6,0,1,0,1,0,0,0,0,1,0,0,2,0,0,1,0
6656,796518,4,0,0,0,0,0,0,0,0,0,1,0,0,0,1,0,0
6656,792315,2,0,0,0,0,0,0,0,0,0,0,0,0,0,0,0,0
6657,796693,25,3,5,2,2,1,3,10,12,0,2,5,2,4,4,0,17
6657,789484,35,5,12,4,10,1,2,1,2,1,7,1,1,0,5,2,12
6657,792422,30,3,6,3,6,0,0,3,5,2,2,1,4,1,2,1,9
6657,782654,25,3,4,3,4,0,0,3,4,2,3,0,5,2,3,1,9
6657,792418,14,2,4,2,3,0,1,0,0,0,1,2,5,0,3,2,4
6657,796691,30,4,11,2,5,2,6,4,4,2,2,1,1,0,2,0,14
6657,792423,15,1,4,1,4,0,0,0,0,2,1,0,1,2,2,0,2
6657,792424,14,0,2,0,2,0,0,0,0,0,3,0,3,0,0,0,0
6657,796692,8,0,1,0,0,0,1,0,0,0,2,0,0,0,1,0,0
6657,792419,3,0,0,0,0,0,0,0,0,0,0,0,1,0,0,0,0
6657,796694,1,0,1,0,1,0,0,0,0,0,0,0,0,0,0,0,0
6658,786311,36,8,14,1,5,7,9,0,0,1,3,1,0,0,1,0,23
6658,797210,33,4,7,1,4,3,3,4,6,1,0,3,2,2,5,0,15
6658,797208,19,4,6,4,6,0,0,0,0,0,2,1,1,0,2,0,8
6658,780201,35,2,8,2,8,0,0,2,2,0,5,1,4,0,6,1,6
6658,791469,25,1,3,1,3,0,0,0,0,3,7,2,4,0,0,3,2
6658,791467,23,1,3,1,3,0,0,1,3,0,3,2,2,2,3,0,3
6658,798344,14,1,1,1,1,0,0,1,4,0,3,0,2,0,0,0,3
6658,791470,4,1,3,1,3,0,0,0,0,2,0,0,0,0,0,0,2
6658,775516,9,0,0,0,0,0,0,0,0,0,1,1,0,0,0,0,0
6658,797209,2,0,0,0,0,0,0,0,0,0,0,0,0,0,0,0,0
6659,786803,22,5,6,2,3,3,3,0,0,0,1,1,1,2,1,0,13
6659,774936,23,5,10,5,10,0,0,2,2,2,2,1,0,0,1,1,12
6659,781345,35,3,4,2,2,1,2,0,1,0,3,5,1,2,1,0,7
6659,786805,21,2,6,2,4,0,2,1,4,2,4,0,0,0,1,0,5
6659,790933,17,1,3,0,0,1,3,0,0,0,0,1,1,0,1,0,3
6659,786804,22,6,9,3,4,3,5,2,2,1,4,1,3,0,0,1,17
6659,790932,31,5,12,3,8,2,4,1,3,0,1,4,2,1,2,0,13
6659,790934,14,2,6,1,4,1,2,0,0,0,4,2,4,3,0,0,5
6659,780033,11,1,3,1,2,0,1,0,0,3,0,3,2,2,0,0,2
6659,796487,4,0,2,0,2,0,0,0,0,1,1,2,0,1,0,0,0
6659,796488,0,0,0,0,0,0,0,0,0,0,1,0,0,0,0,0,0
6659,796490,0,0,0,0,0,0,0,0,0,0,0,0,0,0,0,0,0
6659,780030,0,0,0,0,0,0,0,0,0,0,0,0,0,0,0,0,0
6660,776351,35,8,20,4,5,4,15,0,0,3,7,1,3,3,4,0,20
6660,781341,35,5,11,0,1,5,10,0,0,0,3,6,2,2,1,0,15
6660,781335,31,5,10,3,6,2,4,0,2,4,7,1,2,0,5,1,12
6660,785775,28,1,3,1,2,0,1,3,4,1,0,2,3,1,0,2,5
6660,785770,33,1,9,1,5,0,4,0,0,3,3,2,3,1,3,0,2
6660,796542,13,4,4,4,4,0,0,0,0,1,0,1,2,1,1,0,8
6660,791284,12,1,5,0,0,1,5,0,0,0,2,1,0,1,0,0,3
6660,796538,10,1,2,1,1,0,1,0,0,0,1,1,2,1,0,0,2
6660,791283,3,0,0,0,0,0,0,0,0,0,0,0,0,1,1,0,0
6661,781337,38,9,13,5,6,4,7,2,2,0,4,6,2,2,2,0,24
6661,781339,25,3,9,0,0,3,9,2,2,0,3,3,0,1,4,0,11
6661,791964,29,2,8,1,4,1,4,3,4,1,5,3,2,2,1,0,8
6661,786056,31,2,4,1,2,1,2,1,3,1,5,4,1,2,4,0,6
6661,786054,18,3,7,3,7,0,0,0,0,4,1,0,0,1,0,0,6
6661,797712,15,5,6,5,6,0,0,1,2,1,3,1,2,1,0,1,11
6661,799737,10,2,3,1,2,1,1,0,0,0,1,1,0,1,0,0,5
6661,792041,10,2,3,2,3,0,0,0,0,1,1,0,0,0,1,1,4
6661,797711,24,0,4,0,2,0,2,0,0,0,3,1,0,2,2,0,0
6662,796404,25,3,4,3,4,0,0,0,0,0,7,2,2,1,0,0,6
6662,790853,23,3,6,3,6,0,0,0,0,0,2,1,2,0,1,0,6
6662,790850,37,4,7,3,4,1,3,3,4,0,1,3,2,1,3,0,12
6662,781164,25,3,4,1,1,2,3,3,4,0,5,0,1,0,2,0,11
6662,781163,23,3,10,3,7,0,3,6,7,1,3,3,3,1,3,0,12
6662,790854,4,0,0,0,0,0,0,0,0,0,0,0,2,0,1,0,0
6662,785434,18,2,7,1,5,1,2,1,2,0,0,0,0,0,1,0,6
6662,790849,23,1,2,0,0,1,2,3,4,0,0,4,1,0,3,0,6
6662,796406,14,1,2,1,2,0,0,4,6,2,3,1,2,0,0,1,6
6662,796405,2,0,1,0,1,0,0,1,2,1,0,0,0,1,0,0,1
6662,790848,6,0,0,0,0,0,0,2,2,1,0,0,0,0,0,0,2
6663,792283,31,5,10,1,3,4,7,0,0,4,3,0,4,0,0,0,14
6663,797823,25,5,10,5,8,0,2,2,2,2,5,0,5,0,1,2,12
6663,797829,17,2,3,2,3,0,0,2,2,2,2,0,1,0,1,2,6
6663,792280,32,5,13,5,10,0,3,2,2,1,3,2,4,2,2,0,12
6663,780505,35,2,14,1,10,1,4,2,3,1,4,8,3,1,4,1,7
6663,797831,15,0,3,0,0,0,3,0,0,1,0,2,1,0,1,0,0
6663,792286,11,0,0,0,0,0,0,0,0,0,1,0,2,1,0,0,0
6663,797826,3,0,1,0,1,0,0,0,0,0,0,0,1,0,2,0,0
6663,792284,28,5,7,2,2,3,5,2,2,1,1,2,3,0,1,0,15
6663,792287,3,0,0,0,0,0,0,0,0,0,1,0,2,0,0,0,0
6664,797695,26,6,11,6,11,0,0,1,3,3,6,2,3,0,4,0,13
6664,780846,36,3,8,3,6,0,2,3,4,0,6,0,3,0,1,0,9
6664,797699,23,4,12,4,8,0,4,0,1,0,0,4,5,1,2,0,8
6664,791954,28,2,5,1,1,1,4,1,2,1,1,2,0,3,0,0,6
6664,797692,35,2,8,1,1,1,7,0,0,0,2,1,4,1,2,0,5
6664,797694,33,3,7,0,0,3,7,4,4,0,3,0,1,0,1,0,13
6664,780844,15,1,3,0,1,1,2,0,0,0,0,0,3,2,2,0,3
6664,797698,4,0,0,0,0,0,0,2,2,1,0,0,0,0,1,0,2
6665,791145,26,5,7,5,6,0,1,5,6,1,10,1,4,1,3,0,15
6665,791146,37,4,12,3,8,1,4,5,6,1,3,0,1,1,4,0,14
6665,785777,29,3,7,2,4,1,3,2,2,0,1,1,3,2,2,0,9
6665,785782,34,2,4,2,2,0,2,0,3,0,8,1,1,1,3,0,4
6665,791144,16,2,3,2,2,0,1,0,0,2,2,0,1,1,2,0,4
6665,791148,25,4,5,3,3,1,2,1,2,2,2,1,2,2,1,0,10
6665,791147,16,2,3,2,2,0,1,4,4,1,0,1,3,0,1,0,8
6665,786748,14,1,4,1,1,0,3,2,2,0,2,2,1,0,0,0,4
6665,796804,3,0,0,0,0,0,0,0,0,0,0,0,0,0,0,0,0
6666,791302,25,3,9,3,7,0,2,4,6,1,7,1,2,0,3,2,10
6666,781622,31,5,6,1,1,4,5,0,0,0,1,1,3,0,2,1,14
6666,791309,36,8,10,8,9,0,1,0,1,0,3,9,2,2,3,0,16
6666,785835,16,0,1,0,1,0,0,0,0,1,3,1,1,1,2,1,0
6666,776334,26,3,6,1,1,2,5,2,2,0,2,1,1,1,4,0,10
6666,791301,4,0,0,0,0,0,0,0,0,0,1,0,0,0,0,0,0
6666,775862,17,2,4,2,4,0,0,1,2,1,3,0,3,0,1,0,5
6666,796601,19,1,4,0,2,1,2,0,0,0,1,2,4,3,5,0,3
6666,796602,7,2,3,2,3,0,0,4,5,0,1,0,1,0,0,0,8
6666,791304,15,3,3,3,3,0,0,1,2,1,0,0,1,1,0,0,7
6666,796604,4,0,0,0,0,0,0,0,0,0,0,0,0,0,0,0,0
6667,781605,17,1,1,1,1,0,0,1,2,0,2,0,2,0,0,0,3
6667,792306,29,5,8,4,6,1,2,4,6,4,2,1,3,2,2,3,15
6667,792300,28,5,9,5,8,0,1,2,2,1,4,3,3,3,3,1,12
6667,792303,31,3,12,3,10,0,2,6,9,0,1,5,2,4,4,0,12
6667,781603,28,3,6,0,0,3,6,1,2,3,0,1,1,2,2,0,10
6667,797912,9,0,1,0,0,0,1,0,0,0,1,0,0,0,0,0,0
6667,780456,13,1,3,0,2,1,1,0,0,1,2,1,2,0,2,0,3
6667,776424,16,0,1,0,0,0,1,1,2,0,0,0,1,2,0,0,1
6667,797914,17,3,7,1,2,2,5,0,0,0,0,1,3,2,0,0,8
6667,790813,12,2,5,0,1,2,4,0,0,0,1,0,0,0,0,0,6
6667,796155,0,0,0,0,0,0,0,0,0,0,0,0,0,0,0,0,0
6668,785294,26,2,5,2,3,0,2,6,8,2,5,2,2,1,0,2,10
6668,791085,36,9,15,3,6,6,9,4,5,0,3,1,2,2,2,1,28
6668,791080,34,6,13,5,9,1,4,4,4,2,3,0,1,0,0,0,17
6668,786446,21,1,4,1,2,0,2,2,2,0,3,3,4,2,2,0,4
6668,785675,34,3,7,2,3,1,4,2,2,2,6,1,1,1,2,0,9
6668,796511,14,0,3,0,1,0,2,0,0,0,4,0,1,0,1,1,0
6668,791083,9,0,2,0,1,0,1,0,0,0,1,0,1,1,0,1,0
6668,791081,4,0,0,0,0,0,0,1,2,2,1,0,2,0,2,1,1
6668,796512,20,0,7,0,3,0,4,0,0,0,3,1,1,1,0,0,0
6668,796515,2,0,0,0,0,0,0,0,0,0,0,0,0,0,0,0,0
6669,791787,15,6,10,6,9,0,1,0,1,2,0,1,5,0,3,0,12
6669,789048,30,5,9,5,9,0,0,0,0,3,7,2,3,1,3,0,10
6669,789046,26,3,11,1,3,2,8,0,0,2,6,0,1,0,1,1,8
6669,797630,19,0,6,0,1,0,5,0,0,0,0,0,1,0,0,0,0
6669,789041,28,2,10,2,4,0,6,3,4,3,3,2,0,2,2,0,7
6669,791785,20,1,4,1,3,0,1,0,0,0,1,1,1,0,1,0,2
6669,785540,15,3,6,3,6,0,0,3,4,3,5,1,1,0,2,1,9
6669,797631,12,3,4,2,3,1,1,0,0,0,1,2,4,0,1,0,7
6669,791786,31,1,5,0,1,1,4,0,0,0,3,4,1,0,1,0,3
6669,789044,4,0,1,0,0,0,1,2,2,0,1,0,1,0,0,0,2
6670,797483,15,2,4,1,2,1,2,0,0,1,2,0,1,0,0,1,5
6670,797482,33,6,11,5,8,1,3,2,2,0,5,2,2,0,3,0,15
6670,797485,25,0,4,0,1,0,3,0,0,1,2,3,4,0,1,1,0
6670,797481,21,4,9,2,4,2,5,6,8,1,2,1,0,0,0,1,16
6670,785944,35,7,14,6,8,1,6,4,4,1,1,4,2,0,3,0,19
6670,797484,15,0,0,0,0,0,0,2,2,0,2,0,0,0,0,0,2
6670,797480,16,2,8,2,6,0,2,2,2,0,2,2,2,1,0,0,6
6670,797479,20,2,6,1,2,1,4,0,0,0,0,0,1,0,1,0,5
6670,797478,2,0,0,0,0,0,0,0,0,0,1,0,0,0,1,0,0
6670,791873,2,0,0,0,0,0,0,0,0,0,1,1,1,0,1,0,0
6670,781217,13,1,2,1,1,0,1,0,0,0,2,2,2,1,1,0,2
6670,791875,3,0,0,0,0,0,0,0,0,0,0,0,0,0,0,0,0
6671,786566,35,5,15,4,11,1,4,0,0,3,7,2,1,3,2,1,11
6671,781204,33,3,6,1,1,2,5,2,2,2,8,0,0,0,1,1,10
6671,786568,9,3,3,3,3,0,0,1,2,1,0,0,3,0,1,1,7
6671,791993,28,6,10,5,7,1,3,0,1,0,2,3,4,1,0,2,13
6671,781188,39,8,13,4,5,4,8,4,4,1,2,12,2,1,1,1,24
6671,791997,16,3,8,2,4,1,4,2,2,2,2,0,3,0,1,0,9
6671,797493,2,0,0,0,0,0,0,1,2,0,1,0,0,0,0,0,1
6671,791995,2,1,2,0,0,1,2,0,0,0,1,0,0,0,0,0,3
6671,786563,7,0,1,0,1,0,0,0,0,0,0,0,0,0,0,0,0
6671,781189,29,6,10,5,7,1,3,0,2,1,5,3,2,1,1,0,13
6672,797222,12,2,2,2,2,0,0,0,0,1,0,0,2,0,0,0,4
6672,781526,27,5,9,3,7,2,2,2,2,1,4,1,4,1,4,1,14
6672,797217,33,5,7,4,5,1,2,3,3,0,5,4,1,2,2,0,14
6672,797218,26,2,11,2,9,0,2,2,2,2,2,0,3,0,1,0,6
6672,775697,27,1,8,1,4,0,4,2,2,0,2,3,3,1,1,1,4
6672,791454,35,8,16,8,14,0,2,7,8,3,8,1,1,1,2,1,23
6672,791453,19,1,6,0,1,1,5,0,0,0,1,0,2,0,1,0,3
6672,791846,15,1,3,1,3,0,0,1,2,0,3,1,1,0,1,1,3
6672,797223,6,0,3,0,3,0,0,0,0,2,0,0,1,0,1,0,0
6673,775954,10,0,3,0,3,0,0,0,0,0,3,1,4,0,0,0,0
6673,781006,32,3,8,3,5,0,3,0,0,2,3,0,2,1,1,1,6
6673,796194,24,1,3,0,1,1,2,0,0,0,2,5,2,1,3,0,3
6673,796464,28,9,16,9,15,0,1,9,11,0,4,3,3,1,0,1,27
6673,796459,35,9,17,8,13,1,4,4,4,0,5,0,4,1,4,2,23
6673,790918,3,1,2,1,2,0,0,0,0,0,0,0,2,0,0,0,2
6673,790917,29,4,10,2,4,2,6,0,0,3,7,0,2,1,2,2,10
6673,781157,24,4,8,3,5,1,3,0,0,1,3,1,1,0,0,0,9
6673,785238,3,0,0,0,0,0,0,0,0,1,0,0,1,0,0,0,0
6673,780648,12,1,1,1,1,0,0,0,0,0,0,0,1,0,1,0,2
6674,792067,8,1,3,1,3,0,0,0,0,2,1,0,1,1,3,1,2
6674,775523,29,3,8,3,6,0,2,3,7,2,7,0,0,1,5,2,9
6674,789028,23,4,6,4,6,0,0,0,0,1,0,6,4,2,1,0,8
6674,789029,15,1,4,1,2,0,2,0,0,1,2,1,2,0,1,0,2
6674,775323,36,4,13,0,5,4,8,0,0,2,6,1,3,2,0,0,12
6674,790779,10,0,0,0,0,0,0,0,0,0,2,0,0,0,2,1,0
6674,797649,33,10,17,6,11,4,6,3,8,2,2,0,1,3,2,0,27
6674,797651,16,1,5,0,1,1,4,0,0,0,1,6,1,1,2,0,3
6674,792058,5,1,2,1,2,0,0,1,2,1,0,1,1,0,0,0,3
6674,789053,25,1,4,0,2,1,2,0,0,0,1,6,1,1,1,0,3
6675,796637,33,10,17,10,17,0,0,1,2,1,13,3,1,2,3,1,21
6675,792632,27,0,4,0,4,0,0,0,2,1,6,1,2,2,0,0,0
6675,792631,26,3,5,1,2,2,3,0,0,0,0,2,1,5,1,0,8
6675,792626,4,0,0,0,0,0,0,0,0,0,1,2,2,0,2,0,0
6675,780250,26,3,7,0,3,3,4,1,2,0,2,0,3,1,2,0,10
6675,796634,3,0,0,0,0,0,0,0,0,0,0,1,1,0,0,0,0
6675,792627,24,2,6,2,5,0,1,2,2,1,4,1,0,0,0,0,6
6675,792629,36,8,11,7,9,1,2,5,6,1,3,1,2,3,4,0,22
6675,781491,21,2,4,2,3,0,1,1,3,1,2,0,2,1,3,1,5
6676,799000,26,6,10,6,10,0,0,4,7,2,2,0,4,0,1,3,16
6676,785471,20,2,6,2,6,0,0,1,4,3,1,0,2,0,1,1,5
6676,780263,31,10,14,8,10,2,4,4,7,2,3,3,0,2,2,1,26
6676,786697,32,1,9,1,7,0,2,1,1,0,8,5,4,1,3,0,3
6676,780571,29,1,7,0,1,1,6,3,4,0,1,3,1,2,1,0,6
6676,792399,20,2,2,2,2,0,0,0,1,1,2,0,1,0,3,1,4
6676,775198,27,2,5,1,2,1,3,2,2,1,3,2,1,0,1,0,7
6676,775547,11,4,6,4,5,0,1,2,2,2,1,0,3,0,1,0,10
6676,792397,4,0,0,0,0,0,0,0,0,0,0,0,0,0,0,0,0
6677,781319,19,5,12,5,11,0,1,0,2,2,5,0,4,1,1,1,10
6677,781408,20,4,5,3,3,1,2,1,2,0,2,0,2,0,0,0,10
6677,786691,19,2,6,0,4,2,2,0,2,0,3,0,2,1,1,0,6
6677,781329,33,3,8,2,5,1,3,3,4,1,5,7,2,3,3,0,10
6677,781455,15,0,0,0,0,0,0,0,2,1,0,0,1,0,0,0,0
6677,797876,14,4,7,3,6,1,1,4,4,1,2,0,3,0,2,0,13
6677,792219,7,1,2,1,2,0,0,0,0,0,0,0,1,0,1,1,2
6677,792222,4,0,3,0,1,0,2,0,0,1,0,1,0,0,0,0,0
6677,786656,13,1,2,1,2,0,0,2,2,2,2,0,1,0,0,1,4
6677,792046,20,6,8,3,4,3,4,0,0,2,1,0,2,0,2,0,15
6677,792221,3,0,1,0,1,0,0,0,0,0,0,0,0,0,0,0,0
6677,792220,11,0,4,0,1,0,3,0,0,0,1,0,0,0,0,0,0
6677,786693,22,2,5,1,2,1,3,0,0,0,4,0,1,0,1,1,5
6678,781462,34,6,14,6,14,0,0,0,0,5,3,0,1,0,1,1,12
6678,780876,27,7,12,7,10,0,2,2,2,0,1,2,4,0,5,1,16
6678,785353,34,7,9,4,5,3,4,2,4,0,2,2,2,1,1,0,19
6678,781673,31,3,6,2,3,1,3,1,1,0,3,5,3,1,0,0,8
6678,781457,40,8,13,5,9,3,4,0,0,0,6,5,3,6,1,0,19
6678,785355,14,2,3,2,3,0,0,0,2,0,3,0,1,1,1,0,4
6678,791305,7,0,0,0,0,0,0,0,0,0,1,1,1,0,0,0,0
6678,790895,13,2,3,2,2,0,1,0,0,0,1,0,1,0,0,0,4
6679,785423,35,11,13,7,7,4,6,1,2,1,2,1,0,0,1,2,27
6679,775676,25,8,9,8,9,0,0,2,3,2,5,3,1,0,3,1,18
6679,786210,18,0,4,0,3,0,1,0,0,0,0,0,0,0,0,0,0
6679,785425,38,4,6,3,4,1,2,4,4,0,3,3,1,1,0,0,13
6679,785422,40,6,15,4,9,2,6,1,2,0,3,10,1,2,5,1,15
6679,774957,17,1,2,1,1,0,1,0,0,0,2,0,3,1,0,0,2
6679,786298,27,2,5,2,3,0,2,1,2,0,6,3,3,1,2,0,5
6680,792035,26,7,16,7,16,0,0,7,10,5,3,2,4,3,1,0,21
6680,780833,31,10,11,10,11,0,0,1,6,1,4,0,4,1,2,0,21
6680,792034,37,6,12,4,6,2,6,5,6,0,8,9,0,2,0,0,19
6680,792033,35,3,12,2,5,1,7,3,5,1,3,3,4,1,1,1,10
6680,780830,29,3,8,1,3,2,5,0,0,0,3,1,1,0,0,0,8
6680,797645,9,0,2,0,2,0,0,1,2,1,1,0,2,0,1,0,1
6680,791688,22,2,4,0,2,2,2,2,2,1,3,1,3,3,0,1,8
6680,785381,11,0,4,0,2,0,2,1,2,0,0,1,1,1,0,0,1
6681,792029,21,3,6,3,5,0,1,0,0,0,4,0,2,0,0,0,6
6681,761149,34,4,6,4,5,0,1,0,0,1,7,2,2,0,2,0,8
6681,792032,38,3,11,2,5,1,6,13,13,0,2,5,3,1,5,0,20
6681,792031,34,1,3,0,1,1,2,1,2,0,4,4,5,0,2,0,4
6681,780828,35,13,24,12,18,1,6,7,8,0,4,3,3,0,3,0,34
6681,797641,15,3,3,3,3,0,0,0,1,2,7,0,4,0,2,4,6
6681,797640,8,0,0,0,0,0,0,0,0,0,2,0,1,0,0,0,0
6681,797637,9,0,0,0,0,0,0,0,0,0,0,0,1,0,2,0,0
6681,797636,6,0,1,0,1,0,0,0,0,0,0,0,2,0,0,0,0
6681,792030,0,0,0,0,0,0,0,0,0,0,0,0,0,0,0,0,0
6682,796892,12,1,4,1,4,0,0,0,0,2,2,0,1,1,1,1,2
6682,796891,35,7,11,7,10,0,1,1,3,1,6,2,4,1,2,0,15
6682,796884,31,2,9,2,7,0,2,1,2,4,6,3,4,1,2,0,5
6682,796882,30,4,11,2,5,2,6,7,9,0,0,2,3,3,6,0,17
6682,790447,22,2,6,2,6,0,0,0,0,0,3,1,1,1,2,0,4
6682,796890,6,0,2,0,1,0,1,0,0,0,2,0,0,0,0,0,0
6682,796896,24,1,5,1,3,0,2,5,6,1,4,0,2,2,4,1,7
6682,796894,1,0,0,0,0,0,0,0,0,0,0,0,0,0,0,0,0
6682,796888,15,1,2,0,0,1,2,0,0,0,2,0,2,1,3,0,3
6682,796887,16,0,5,0,3,0,2,0,0,0,1,0,3,0,2,0,0
6682,796881,7,1,2,0,0,1,2,0,0,1,1,1,2,1,1,0,3
6682,776336,1,0,0,0,0,0,0,0,0,0,0,0,0,0,0,0,0
6683,797325,33,2,2,2,2,0,0,0,2,3,4,4,3,0,3,0,4
6683,797329,35,3,9,2,5,1,4,1,2,1,10,1,4,1,2,2,8
6683,797327,14,1,4,1,3,0,1,2,2,0,1,0,0,0,0,0,4
6683,797323,39,11,20,6,12,5,8,3,4,0,2,1,4,3,8,1,30
6683,780759,40,4,10,3,4,1,6,7,9,0,1,1,2,2,3,0,16
6683,786246,1,0,0,0,0,0,0,0,0,0,0,0,0,0,0,0,0
6683,781002,8,0,0,0,0,0,0,0,2,1,0,1,2,0,1,0,0
6683,797324,2,0,3,0,1,0,2,0,0,0,0,0,0,0,0,0,0
6683,797322,13,0,3,0,2,0,1,6,6,0,5,0,0,2,0,0,6
6683,786233,15,3,6,0,1,3,5,0,0,1,2,0,5,3,0,0,9
6684,786404,26,2,6,1,4,1,2,3,3,2,8,1,4,0,5,0,8
6684,780378,31,7,9,7,9,0,0,6,11,2,7,3,4,1,1,1,20
6684,786378,40,1,7,0,1,1,6,4,4,1,2,4,3,4,2,0,7
6684,786374,37,6,18,3,12,3,6,1,1,5,4,1,2,0,2,1,16
6684,786253,38,4,11,4,10,0,1,3,4,0,5,6,1,1,4,0,11
6684,780382,14,0,1,0,1,0,0,0,0,2,4,0,2,0,2,1,0
6684,797065,4,0,1,0,1,0,0,0,0,1,0,0,2,0,0,0,0
6684,797061,17,1,5,1,3,0,2,0,2,0,4,1,4,0,3,0,2
6684,791562,5,0,0,0,0,0,0,0,0,0,0,0,2,0,1,0,0
6684,785798,12,2,5,1,2,1,3,0,0,0,1,0,1,0,0,0,5
6684,780381,1,0,0,0,0,0,0,0,0,0,0,0,0,0,0,0,0
6684,780121,0,0,0,0,0,0,0,0,0,0,0,0,1,0,0,0,0
6685,785693,29,3,3,3,3,0,0,1,3,4,7,1,4,1,0,4,7
6685,780494,35,4,14,2,11,2,3,4,6,4,6,3,4,1,2,1,14
6685,797276,12,2,5,2,5,0,0,2,2,1,1,0,4,2,3,0,6
6685,780496,36,3,7,1,2,2,5,4,5,1,5,1,1,0,0,0,12
6685,780495,37,4,18,3,7,1,11,6,7,1,1,0,1,0,0,2,15
6685,797274,1,0,0,0,0,0,0,0,2,1,0,0,1,0,0,0,0
6685,791645,5,1,2,1,2,0,0,0,0,0,0,0,4,1,1,1,2
6685,797275,4,0,1,0,0,0,1,0,0,0,0,0,1,1,0,0,0
6685,791643,12,0,2,0,2,0,0,0,1,3,0,1,0,1,4,0,0
6685,785692,32,2,6,2,5,0,1,0,0,0,3,4,3,4,2,0,4
6685,780497,22,4,11,4,11,0,0,3,4,1,5,1,2,0,0,0,11
6686,786296,17,2,3,2,2,0,1,0,0,0,1,0,1,0,0,0,4
6686,781530,27,4,10,3,9,1,1,5,7,0,8,2,2,0,2,1,14
6686,776423,28,2,7,2,7,0,0,0,2,1,3,1,2,0,1,1,4
6686,792307,18,0,0,0,0,0,0,1,2,0,0,1,2,0,0,0,1
6686,792319,17,3,5,1,3,2,2,0,0,0,2,1,1,2,1,0,8
6686,792314,10,2,3,2,3,0,0,4,4,1,0,0,1,0,0,0,8
6686,792320,12,1,1,1,1,0,0,1,2,0,3,0,0,0,0,0,3
6686,798106,15,0,1,0,0,0,1,0,0,0,0,1,2,0,0,0,0
6686,798104,20,1,6,0,2,1,4,1,2,0,2,3,3,1,3,0,4
6686,798096,23,3,3,2,2,1,1,2,2,0,1,0,2,0,2,1,9
6686,792309,10,1,3,1,1,0,2,0,0,0,1,2,0,0,0,0,2
6686,792321,3,0,1,0,1,0,0,0,0,0,0,0,1,0,0,0,0
6687,791053,27,4,8,3,6,1,2,3,5,0,3,2,2,0,0,0,12
6687,780739,33,6,12,6,12,0,0,3,4,2,3,2,0,0,0,0,15
6687,785524,33,1,4,1,3,0,1,4,5,2,3,3,3,2,0,1,6
6687,781115,31,2,5,2,5,0,0,1,1,0,1,4,3,1,1,0,5
6687,775456,16,2,8,2,8,0,0,2,3,2,1,0,3,2,1,0,6
6687,796731,7,1,1,1,1,0,0,0,0,0,0,0,5,0,0,0,2
6687,796730,2,0,1,0,0,0,1,0,0,0,0,0,0,0,0,0,0
6687,791051,13,1,6,1,6,0,0,0,0,6,3,0,1,1,0,0,2
6687,790819,11,1,1,0,0,1,1,2,2,0,0,1,1,0,3,0,5
6687,786310,4,0,2,0,1,0,1,0,0,1,0,0,0,0,0,0,0
6687,775094,23,3,9,1,6,2,3,1,2,1,3,0,2,0,0,0,9
6722,790863,23,6,11,5,7,1,4,0,1,1,8,0,2,1,1,2,13
6722,780021,27,3,7,3,7,0,0,3,3,3,5,2,3,0,1,2,9
6722,785412,24,3,6,3,4,0,2,3,3,0,5,1,3,4,3,0,9
6722,780099,37,5,14,4,6,1,8,1,3,0,2,2,1,5,2,0,12
6722,776214,36,7,19,6,13,1,6,1,2,0,8,4,3,1,6,0,16
6722,775686,21,3,3,3,3,0,0,0,0,4,4,0,3,0,2,2,6
6722,785413,2,0,0,0,0,0,0,0,0,0,0,0,1,0,0,0,0
6722,785417,8,0,0,0,0,0,0,1,2,0,1,0,0,0,0,2,1
6722,785411,4,0,0,0,0,0,0,0,0,0,0,0,2,0,0,0,0
6722,776221,18,1,2,1,2,0,0,0,0,0,1,2,0,0,1,1,2
6723,780058,17,1,7,0,2,1,5,0,0,1,1,0,2,0,0,0,3
6723,780059,22,3,7,2,6,1,1,0,2,1,4,1,4,1,2,0,7
6723,796494,28,0,0,0,0,0,0,0,1,1,4,1,3,0,1,0,0
6723,790944,32,4,12,3,8,1,4,6,7,3,1,1,0,1,2,0,15
6723,780061,32,4,12,1,6,3,6,0,0,2,4,1,1,4,4,2,11
6723,796496,22,4,7,3,5,1,2,3,4,1,4,0,2,3,1,0,12
6723,786754,21,5,13,3,9,2,4,0,0,0,1,1,3,0,3,0,12
6723,790943,13,1,5,1,2,0,3,0,3,1,5,0,2,1,0,0,2
6723,790941,10,0,2,0,2,0,0,3,4,1,3,1,0,1,0,0,3
6723,796495,3,0,1,0,1,0,0,0,0,0,0,0,0,0,0,0,0
6724,790821,38,1,7,1,4,0,3,2,3,1,2,1,2,0,0,1,4
6724,775585,39,3,5,3,5,0,0,4,4,3,9,1,2,0,1,1,10
6724,790822,39,4,12,1,5,3,7,8,9,0,8,6,1,2,2,0,19
6724,780982,41,6,11,4,6,2,5,5,6,0,4,1,4,2,2,0,19
6724,774980,42,7,15,6,11,1,4,3,4,0,4,2,1,1,3,0,18
6724,780445,10,1,4,1,4,0,0,0,0,1,0,0,1,0,2,0,2
6724,790820,16,2,4,2,3,0,1,0,0,0,1,1,1,0,1,0,4
6725,781342,43,5,13,5,8,0,5,6,7,1,5,5,4,1,1,1,16
6725,781593,39,9,14,8,12,1,2,3,5,2,7,7,1,2,3,0,22
6725,790901,32,4,6,2,3,2,3,0,0,0,2,2,2,2,1,0,10
6725,790903,5,0,2,0,1,0,1,0,0,0,1,0,0,0,0,0,0
6725,781620,37,2,5,1,1,1,4,0,0,0,4,5,2,1,1,2,5
6725,790902,35,4,11,0,3,4,8,2,2,1,2,1,1,0,2,2,14
6725,796449,25,5,10,5,10,0,0,1,1,0,2,3,4,1,0,0,11
6725,796450,9,1,2,1,2,0,0,0,0,1,1,2,1,0,0,0,2
6726,780406,21,5,8,2,2,3,6,0,0,1,6,1,4,0,1,0,13
6726,775087,26,5,12,5,12,0,0,2,2,5,6,1,2,0,1,0,12
6726,790984,34,5,12,1,2,4,10,0,0,0,3,4,2,2,1,0,14
6726,785296,32,6,12,3,5,3,7,4,6,1,8,4,1,0,3,0,19
6726,780212,34,3,13,1,6,2,7,2,2,1,1,1,1,1,2,0,10
6726,780215,10,0,0,0,0,0,0,0,0,0,2,1,3,0,0,0,0
6726,796596,12,1,2,0,0,1,2,0,0,0,1,1,2,0,1,0,3
6726,785297,31,2,8,0,3,2,5,4,6,1,7,3,2,1,1,0,10
6727,797972,30,5,11,4,7,1,4,2,2,2,3,2,3,1,0,1,13
6727,797967,36,4,10,4,7,0,3,3,3,1,7,1,3,3,3,0,11
6727,797970,31,1,11,0,5,1,6,5,6,2,5,0,1,0,1,0,8
6727,781453,31,4,11,3,5,1,6,2,2,2,5,4,5,0,4,0,11
6727,774869,34,3,11,1,3,2,8,1,2,0,4,0,1,1,1,0,9
6727,792254,15,1,4,1,2,0,2,1,1,0,1,2,0,0,0,0,3
6727,792256,1,0,0,0,0,0,0,0,0,0,0,0,0,0,0,0,0
6727,786098,21,4,9,2,6,2,3,2,3,0,4,1,2,2,0,0,12
6727,786106,1,0,0,0,0,0,0,0,0,0,0,0,0,0,0,0,0
6728,791276,29,5,8,5,8,0,0,3,4,5,8,0,4,0,2,2,13
6728,796529,29,0,5,0,4,0,1,2,2,0,1,6,4,0,5,0,2
6728,791275,32,4,7,3,3,1,4,6,6,1,2,4,1,5,5,0,15
6728,785746,39,4,9,2,2,2,7,3,3,0,3,0,2,0,2,1,13
6728,785741,34,4,8,2,4,2,4,4,4,0,4,4,3,2,2,0,14
6728,785755,11,0,2,0,2,0,0,1,2,0,2,0,0,0,0,0,1
6728,796526,1,0,0,0,0,0,0,0,0,0,0,0,0,0,0,0,0
6728,785748,25,6,9,0,0,6,9,0,0,0,2,3,1,1,1,0,18
6729,780122,33,3,6,3,5,0,1,0,0,4,4,1,1,0,2,0,6
6729,797215,25,3,6,2,4,1,2,1,2,0,2,4,2,2,2,0,8
6729,791461,33,6,10,4,7,2,3,4,5,4,5,3,2,0,1,0,18
6729,791460,27,2,6,0,0,2,6,0,0,0,4,3,3,0,4,0,6
6729,786295,33,6,15,4,9,2,6,2,4,1,3,2,4,2,1,0,16
6729,786299,4,0,1,0,1,0,0,0,0,0,0,0,1,0,0,0,0
6729,797214,20,2,3,2,3,0,0,2,3,0,0,1,3,2,1,0,6
6729,780792,25,3,7,1,1,2,6,0,0,0,1,2,2,1,4,0,8
6730,792249,16,1,3,1,3,0,0,0,0,2,1,1,3,0,1,2,2
6730,781430,40,8,17,7,12,1,5,4,7,2,13,3,3,3,2,0,21
6730,792248,31,1,5,1,2,0,3,0,0,0,3,1,2,1,1,0,2
6730,781445,40,7,15,2,5,5,10,0,0,1,4,2,1,0,0,0,19
6730,768845,25,3,11,1,5,2,6,6,6,0,2,10,3,0,2,0,14
6730,781448,24,5,5,5,5,0,0,2,2,2,3,2,2,0,2,1,12
6730,797941,9,1,2,1,1,0,1,0,0,0,3,0,1,0,0,0,2
6730,792250,15,1,3,1,2,0,1,0,0,0,0,0,3,1,0,0,2
6731,792140,20,2,4,2,4,0,0,0,0,0,4,1,2,1,2,0,4
6731,786596,34,7,15,7,13,0,2,3,3,0,8,2,0,2,3,0,17
6731,792144,20,3,5,3,3,0,2,0,0,3,0,1,1,0,1,0,6
6731,781429,35,2,7,0,0,2,7,3,4,0,3,1,1,0,0,1,9
6731,776092,30,6,10,5,7,1,3,5,7,0,1,1,3,1,5,0,18
6731,797791,5,1,4,1,4,0,0,0,0,2,2,0,1,0,0,0,2
6731,792146,9,0,0,0,0,0,0,0,0,0,1,0,3,0,2,0,0
6731,797793,16,0,4,0,1,0,3,0,0,0,0,0,0,1,0,0,0
6731,797787,1,0,0,0,0,0,0,0,0,0,0,0,1,0,0,0,0
6731,785976,30,3,10,2,5,1,5,0,0,2,6,0,2,0,0,0,7
6732,791723,26,5,8,5,7,0,1,1,2,0,2,0,2,0,1,0,11
6732,797310,28,2,7,2,6,0,1,0,0,1,2,5,2,2,1,0,4
6732,785580,37,10,15,10,14,0,1,0,1,4,3,3,1,0,2,0,20
6732,791724,17,0,3,0,1,0,2,0,0,0,2,2,2,0,1,1,0
6732,781617,27,7,11,6,7,1,4,0,0,0,1,1,0,1,3,0,15
6732,797312,8,1,1,1,1,0,0,0,0,0,0,0,1,0,1,0,2
6732,786277,6,0,0,0,0,0,0,0,0,1,0,0,0,0,0,0,0
6732,800056,5,0,0,0,0,0,0,0,0,1,0,0,0,0,1,0,0
6732,797308,32,1,3,0,1,1,2,0,2,0,0,2,1,1,3,0,3
6732,780706,14,2,8,1,6,1,2,2,2,0,1,1,2,1,2,0,7
6733,782133,10,1,4,1,2,0,2,0,1,0,1,0,0,0,0,0,2
6733,785123,24,9,11,9,11,0,0,4,6,1,3,1,0,1,3,0,22
6733,790990,23,3,6,2,3,1,3,0,0,0,1,5,2,1,0,0,7
6733,789219,26,2,6,0,0,2,6,0,0,0,0,5,0,3,1,0,6
6733,785059,29,5,6,5,5,0,1,0,0,2,4,12,0,3,2,0,10
6733,796624,6,4,5,2,2,2,3,0,0,0,0,0,0,0,0,0,10
6733,790989,13,3,5,3,4,0,1,0,0,2,1,2,2,0,0,0,6
6733,785305,4,1,1,1,1,0,0,0,0,0,0,0,0,0,0,0,2
6733,796622,11,1,1,1,1,0,0,0,0,1,2,1,1,0,0,0,2
6733,796623,18,4,6,2,3,2,3,3,3,0,0,2,1,0,2,0,13
6733,790988,16,3,4,2,2,1,2,0,0,0,2,2,2,0,2,0,7
6733,785303,11,1,2,1,1,0,1,2,2,0,2,1,0,0,0,0,4
6733,785122,9,1,1,0,0,1,1,0,0,1,1,0,0,0,0,0,3
6734,796860,33,5,8,4,7,1,1,2,4,0,6,2,0,0,3,0,13
6734,791187,25,3,6,3,6,0,0,1,2,0,4,0,2,1,3,2,7
6734,796861,28,5,6,3,3,2,3,5,5,0,2,1,4,2,0,0,17
6734,785650,25,1,2,0,0,1,2,1,2,0,0,3,2,0,2,1,4
6734,785649,39,8,15,4,7,4,8,3,3,2,2,2,4,0,4,0,23
6734,791183,17,2,5,2,5,0,0,2,2,2,1,1,1,2,0,0,6
6734,791185,12,0,0,0,0,0,0,2,2,0,3,2,0,0,0,0,2
6734,775208,3,0,0,0,0,0,0,2,2,1,0,0,1,0,0,0,2
6734,796857,3,1,1,1,1,0,0,0,0,0,0,0,0,0,0,0,2
6734,796856,12,2,9,1,4,1,5,0,0,0,1,1,3,2,1,0,5
6734,791184,28,1,5,1,3,0,2,2,2,1,6,6,3,1,3,0,4
6735,786481,24,7,14,7,14,0,0,2,3,1,5,0,5,0,4,1,16
6735,797626,38,5,12,4,9,1,3,3,4,2,0,6,4,1,3,1,14
6735,797624,32,3,8,1,2,2,6,5,5,2,9,0,2,1,0,1,13
6735,786480,34,3,7,1,1,2,6,3,6,0,1,0,2,2,0,1,11
6735,781032,40,4,7,2,2,2,5,5,5,0,1,3,3,2,6,1,15
6735,797628,21,2,6,1,4,1,2,0,0,1,1,0,4,2,1,0,5
6735,791791,15,0,1,0,0,0,1,0,0,0,0,1,1,0,1,0,0
6735,785965,18,3,5,2,2,1,3,0,0,0,3,1,2,0,1,0,7
6735,791793,3,0,0,0,0,0,0,0,0,0,0,0,0,0,0,0,0
6736,783072,11,1,4,1,3,0,1,0,0,0,1,1,3,0,1,1,2
6736,774879,35,5,8,4,5,1,3,6,6,2,3,1,3,0,2,2,17
6736,791540,32,7,9,2,3,5,6,6,6,0,3,4,3,0,0,0,25
6736,787782,35,3,10,2,6,1,4,8,8,0,2,1,1,2,5,0,15
6736,776068,36,4,11,3,6,1,5,2,4,0,3,2,3,4,1,0,11
6736,797817,22,2,3,2,3,0,0,2,2,2,9,3,4,1,2,0,6
6736,781463,19,1,3,1,1,0,2,2,2,0,6,1,2,0,0,1,4
6736,792153,9,0,3,0,0,0,3,2,2,0,1,0,1,0,1,0,2
6736,781202,1,0,0,0,0,0,0,0,0,0,0,0,0,0,0,0,0
6736,785647,0,0,0,0,0,0,0,0,0,0,0,0,0,0,0,0,0
6737,791652,32,5,10,5,10,0,0,2,3,6,5,0,5,0,5,2,12
6737,786495,20,1,3,1,3,0,0,2,2,1,3,1,1,0,1,0,4
6737,797285,32,2,7,0,0,2,7,0,0,0,2,0,3,0,0,0,6
6737,791650,31,7,13,7,12,0,1,5,6,1,4,3,4,1,1,1,19
6737,776384,25,6,14,4,11,2,3,4,5,0,2,1,5,0,2,0,18
6737,791653,19,0,2,0,2,0,0,0,0,2,3,0,2,0,0,0,0
6737,775705,8,0,1,0,1,0,0,0,0,1,1,1,2,0,1,0,0
6737,797286,21,5,11,3,7,2,4,0,0,0,1,3,3,3,1,0,12
6737,797283,11,1,3,0,1,1,2,0,0,0,0,0,2,0,0,0,3
6737,797289,1,0,0,0,0,0,0,0,0,0,0,0,0,0,0,0,0
6738,785495,25,4,13,3,10,1,3,0,0,3,2,3,1,2,2,1,9
6738,785958,23,5,9,5,8,0,1,5,7,1,4,1,1,1,1,0,15
6738,785659,13,1,1,1,1,0,0,1,2,1,4,0,2,0,0,1,3
6738,785494,25,2,8,1,5,1,3,0,0,0,2,9,0,1,0,0,5
6738,780698,31,6,10,4,5,2,5,2,3,2,2,7,0,0,1,1,16
6738,785490,19,6,8,4,4,2,4,0,0,2,1,0,0,3,0,0,14
6738,791034,23,6,8,3,3,3,5,1,2,3,8,0,3,2,1,1,16
6738,791130,16,3,6,2,4,1,2,0,1,2,0,1,3,0,2,0,7
6738,791033,5,0,0,0,0,0,0,0,0,0,0,1,1,1,0,0,0
6738,780427,18,1,4,0,2,1,2,0,0,0,4,1,2,0,1,0,3
6738,796704,2,0,0,0,0,0,0,0,0,0,0,0,0,0,0,0,0
6739,786434,2,0,0,0,0,0,0,0,0,0,0,0,0,0,0,0,0
6739,780440,25,2,8,2,2,0,6,0,0,2,3,2,0,0,0,0,4
6739,791621,30,6,14,0,5,6,9,0,0,0,4,0,2,0,5,0,18
6739,786432,23,2,6,2,4,0,2,0,0,0,2,1,0,0,0,0,4
6739,786431,31,4,10,2,6,2,4,2,2,1,2,3,2,0,3,0,12
6739,791619,6,0,3,0,0,0,3,0,0,0,0,0,0,0,0,0,0
6739,791620,6,0,1,0,0,0,1,0,0,0,0,0,2,0,1,0,0
6739,781125,26,10,14,10,14,0,0,4,4,2,6,1,3,1,1,1,24
6739,775620,11,0,0,0,0,0,0,0,0,0,2,0,3,0,1,1,0
6739,781088,24,1,4,1,2,0,2,0,0,0,0,6,0,1,3,0,2
6739,775622,13,0,2,0,0,0,2,0,0,0,3,0,2,0,0,0,0
6739,796975,2,0,0,0,0,0,0,0,0,0,0,0,0,0,0,0,0
6739,796977,1,0,0,0,0,0,0,0,0,0,0,0,0,0,0,0,0
6740,792373,30,7,14,7,12,0,2,2,2,2,1,2,2,0,2,0,16
6740,797960,28,1,3,0,0,1,3,0,0,0,2,1,3,0,0,0,3
6740,792370,33,3,9,3,8,0,1,0,1,2,5,4,4,0,0,1,6
6740,786739,25,3,9,2,5,1,4,0,0,1,1,4,0,2,1,0,7
6740,775303,34,4,6,1,1,3,5,0,0,1,6,3,2,0,0,0,11
6740,797958,10,4,6,1,2,3,4,0,0,0,2,0,1,0,0,1,11
6740,797951,26,6,15,2,5,4,10,4,7,0,2,2,1,2,0,0,20
6740,776491,14,1,3,1,3,0,0,1,2,0,0,3,4,2,2,0,3
6741,785863,37,9,16,9,16,0,0,0,1,2,10,2,1,0,2,1,18
6741,785631,27,4,7,2,4,2,3,1,2,3,8,0,4,0,1,2,11
6741,786248,28,4,6,4,6,0,0,0,0,2,5,3,3,0,2,0,8
6741,785630,26,3,8,2,4,1,4,3,5,2,1,0,1,0,2,0,10
6741,780777,31,3,10,2,7,1,3,3,4,1,3,7,4,2,2,0,10
6741,791197,6,1,2,1,2,0,0,1,2,0,0,0,0,0,0,0,3
6741,791200,20,5,9,4,6,1,3,1,1,0,2,1,1,0,1,0,12
6741,785632,22,4,4,4,4,0,0,0,1,2,4,0,1,0,1,0,8
6741,791198,3,0,0,0,0,0,0,0,0,0,0,0,0,0,0,0,0
6742,791980,21,1,4,0,1,1,3,0,0,0,3,0,2,0,1,0,3
6742,785972,37,4,9,3,7,1,2,1,2,2,3,2,4,1,2,1,10
6742,785967,26,8,12,8,12,0,0,3,5,3,6,1,3,2,2,1,19
6742,791976,31,9,17,5,10,4,7,3,3,0,2,3,1,0,2,0,25
6742,791978,38,9,16,5,11,4,5,9,9,2,5,7,1,3,2,0,31
6742,797800,4,0,1,0,1,0,0,0,0,1,0,1,0,0,0,0,0
6742,791977,22,1,4,0,0,1,4,0,0,1,0,1,2,2,0,0,3
6742,785973,6,0,1,0,1,0,0,0,0,0,0,0,0,0,1,0,0
6742,780160,15,0,0,0,0,0,0,0,0,0,2,3,2,1,2,0,0
6743,790810,40,6,13,4,8,2,5,2,5,5,9,4,4,0,3,0,16
6743,785362,28,6,11,6,11,0,0,5,6,6,3,1,2,0,3,0,17
6743,790808,35,3,11,1,4,2,7,3,3,2,5,3,5,3,2,0,11
6743,785361,39,5,11,2,5,3,6,0,0,0,2,1,1,0,2,1,13
6743,779997,33,7,14,7,12,0,2,4,4,1,0,3,4,1,3,0,18
6743,774854,5,0,1,0,1,0,0,0,0,0,0,0,2,0,1,0,0
6743,790811,9,2,2,2,2,0,0,0,0,1,1,0,0,1,1,0,4
6743,790809,9,0,1,0,1,0,0,0,0,0,0,0,1,0,2,0,0
6743,779999,2,0,0,0,0,0,0,0,0,0,0,0,2,0,0,0,0
6744,775738,15,1,2,1,1,0,1,1,2,3,1,2,1,0,1,0,3
6744,786091,19,4,7,2,4,2,3,0,0,2,2,0,0,1,0,0,10
6744,797666,25,3,7,3,3,0,4,4,5,0,5,2,1,2,1,0,10
6744,785904,18,4,10,3,5,1,5,1,1,1,4,2,3,3,5,0,10
6744,780892,18,3,5,0,1,3,4,2,2,0,2,3,1,1,0,0,11
6744,797670,3,1,1,1,1,0,0,2,2,1,2,0,0,0,0,0,4
6744,797665,11,0,3,0,0,0,3,0,0,0,1,0,1,0,0,0,0
6744,792087,17,1,3,0,0,1,3,0,0,0,9,2,1,1,1,0,3
6744,785734,16,5,7,4,4,1,3,4,6,0,1,1,0,1,1,0,15
6744,786788,21,6,8,5,6,1,2,5,8,2,3,0,0,1,1,0,18
6744,786096,20,5,9,4,7,1,2,0,1,2,5,1,2,0,2,0,11
6744,781030,17,7,10,6,7,1,3,0,0,0,3,1,4,0,0,0,15
6746,780651,16,0,3,0,3,0,0,0,0,3,4,3,2,1,2,1,0
6746,791815,36,6,15,2,5,4,10,5,6,0,6,4,2,2,1,0,21
6746,791810,33,2,7,0,4,2,3,1,2,0,5,4,1,1,3,0,7
6746,791814,20,2,6,0,1,2,5,2,2,0,0,0,0,0,0,0,8
6746,780650,32,4,8,4,5,0,3,1,4,2,4,2,1,2,3,0,9
6746,791809,5,1,2,1,2,0,0,0,0,1,1,0,1,0,1,0,2
6746,781596,19,4,4,4,4,0,0,0,0,2,1,0,3,1,1,2,8
6746,786645,14,1,2,1,2,0,0,2,2,0,1,3,1,0,0,0,4
6746,786644,25,3,6,0,0,3,6,2,2,0,2,1,2,1,0,0,11
6747,786123,37,1,3,1,3,0,0,5,6,2,6,2,2,0,3,5,7
6747,780437,39,3,9,1,6,2,3,2,2,2,3,1,3,0,2,0,10
6747,797673,26,5,12,4,7,1,5,1,2,1,5,1,3,1,2,0,12
6747,786118,38,3,8,0,0,3,8,0,0,1,4,2,5,1,2,0,9
6747,786117,40,6,17,6,15,0,2,5,5,1,4,5,4,5,2,0,17
6747,797675,3,1,1,1,1,0,0,0,0,0,1,0,0,0,0,0,2
6747,797672,3,0,1,0,1,0,0,0,0,0,0,0,1,0,0,0,0
6747,792093,14,1,4,1,3,0,1,0,0,0,0,0,0,0,0,0,2
6748,785224,7,1,2,1,2,0,0,0,0,0,2,0,0,0,3,0,2
6748,780879,31,7,9,6,7,1,2,3,4,2,9,0,3,0,5,1,18
6748,790767,20,2,7,0,1,2,6,1,2,0,1,1,3,1,0,1,7
6748,785743,24,5,8,0,0,5,8,0,0,0,0,1,2,0,0,0,15
6748,780875,36,1,4,1,3,0,1,0,0,2,6,11,2,2,5,0,2
6748,775785,16,2,2,2,2,0,0,2,2,0,6,0,1,0,1,1,6
6748,796326,13,3,5,3,5,0,0,0,0,2,1,0,2,0,0,0,6
6748,790769,4,0,0,0,0,0,0,0,0,0,0,0,0,0,1,1,0
6748,796324,15,3,6,3,5,0,1,3,3,3,2,0,3,0,0,0,9
6748,790768,16,2,4,0,1,2,3,2,2,0,0,1,0,0,2,0,8
6748,785226,18,1,4,1,2,0,2,3,4,0,3,5,1,1,0,1,5
6749,792181,34,3,11,3,9,0,2,2,4,3,3,0,3,0,1,0,8
6749,780986,37,3,5,3,5,0,0,4,5,1,3,1,2,2,0,0,10
6749,785902,26,2,13,1,9,1,4,7,7,3,0,0,2,1,2,2,12
6749,792179,25,7,13,5,7,2,6,3,5,0,0,2,1,3,2,0,19
6749,786662,35,3,13,1,6,2,7,0,0,0,1,0,0,1,1,1,8
6749,797796,28,0,3,0,3,0,0,3,4,2,3,3,1,6,1,0,3
6749,780989,11,0,0,0,0,0,0,1,2,0,0,0,4,0,1,1,1
6749,797794,4,0,2,0,1,0,1,0,0,0,0,0,1,0,0,0,0
6750,791416,28,10,13,10,13,0,0,3,6,4,10,0,1,0,2,1,23
6750,781614,24,2,5,1,2,1,3,0,0,1,3,0,0,1,0,0,5
6750,797096,26,2,5,0,1,2,4,0,0,0,0,1,2,2,1,0,6
6750,785906,35,6,12,6,12,0,0,9,11,1,11,12,0,2,7,0,21
6750,780096,36,3,9,2,2,1,7,1,2,1,1,2,1,2,2,0,8
6750,785907,17,3,4,3,4,0,0,1,2,1,1,0,1,0,1,0,7
6750,797093,8,0,2,0,2,0,0,0,0,0,1,1,2,0,4,0,0
6750,780100,22,2,3,1,1,1,2,0,0,2,7,0,3,1,1,0,5
6750,797094,4,0,0,0,0,0,0,0,0,0,0,0,0,0,0,0,0
6751,776004,19,4,12,4,7,0,5,0,0,0,1,0,2,1,4,1,8
6751,790930,31,2,3,2,3,0,0,3,6,0,3,0,2,2,1,1,7
6751,775011,22,1,4,1,2,0,2,0,1,1,0,3,3,1,2,0,2
6751,780357,24,0,6,0,1,0,5,0,0,1,3,2,1,0,1,0,0
6751,775018,38,9,18,7,11,2,7,2,2,0,2,1,0,4,2,0,22
6751,780358,21,5,10,4,6,1,4,0,0,0,2,0,4,2,0,2,11
6751,796480,26,3,6,2,5,1,1,0,0,0,4,0,3,0,1,0,7
6751,776270,19,1,1,1,1,0,0,1,2,0,2,0,1,0,0,0,3
6752,791842,34,6,15,2,5,4,10,4,4,1,8,3,1,0,4,0,20
6752,791839,28,6,9,6,9,0,0,4,5,2,6,5,3,1,2,2,16
6752,792381,37,3,8,0,3,3,5,2,2,0,4,4,1,1,3,0,11
6752,785322,35,3,11,0,1,3,10,0,0,0,2,1,0,1,0,0,9
6752,797444,27,3,5,0,1,3,4,0,0,4,1,2,1,0,0,0,9
6752,797443,12,1,3,1,3,0,0,4,4,1,5,1,3,0,2,0,6
6752,786736,20,1,4,0,1,1,3,0,0,0,1,3,3,0,4,0,3
6752,786613,7,1,1,1,1,0,0,0,0,0,1,2,0,0,1,0,2
6753,786067,33,12,21,12,21,0,0,5,8,4,6,0,3,2,2,1,29
6753,797661,25,4,11,3,7,1,4,0,0,0,0,2,0,3,0,0,9
6753,797662,26,3,6,3,5,0,1,1,2,3,4,3,2,1,1,0,7
6753,780258,24,1,5,0,1,1,4,0,0,0,3,4,4,0,1,0,3
6753,785591,15,1,6,0,2,1,4,0,0,1,2,2,1,2,1,0,3
6753,797660,25,4,6,4,5,0,1,0,0,0,2,3,2,2,0,2,8
6753,792083,15,2,4,2,3,0,1,0,0,0,0,5,2,0,1,0,4
6753,792078,16,1,2,1,2,0,0,1,2,0,2,0,0,1,1,0,3
6753,792082,16,1,5,1,3,0,2,0,0,1,3,2,1,0,1,0,2
6753,791952,5,0,0,0,0,0,0,0,0,0,0,0,3,0,1,0,0
6754,785911,12,0,0,0,0,0,0,0,0,0,1,1,3,0,1,0,0
6754,797105,30,2,5,2,4,0,1,0,0,1,3,1,3,0,0,1,4
6754,797100,25,0,1,0,0,0,1,0,0,1,5,2,3,1,4,1,0
6754,791413,35,6,14,3,7,3,7,2,4,2,4,1,2,0,4,0,17
6754,791411,34,8,18,5,13,3,5,4,4,1,3,3,1,1,1,0,23
6754,797103,28,5,8,5,8,0,0,2,3,4,4,0,3,1,3,0,12
6754,791414,8,0,0,0,0,0,0,2,2,0,1,0,3,0,0,0,2
6754,781209,28,4,13,3,5,1,8,0,1,0,1,0,4,0,1,0,9
6755,790870,31,5,9,5,9,0,0,4,6,2,9,2,4,1,0,0,14
6755,790869,34,7,11,5,7,2,4,3,5,1,5,6,3,1,3,0,19
6755,780116,24,1,4,1,3,0,1,3,4,0,1,0,3,0,2,1,5
6755,796421,39,6,9,5,7,1,2,2,3,1,0,4,0,1,3,1,15
6755,790866,30,1,4,1,1,0,3,1,2,0,4,2,3,1,2,0,3
6755,796426,9,1,3,1,3,0,0,1,1,0,1,0,1,0,0,0,3
6755,780493,26,5,12,1,2,4,10,1,1,0,2,0,1,1,1,1,15
6755,796427,7,0,1,0,0,0,1,0,0,0,0,0,1,0,0,0,0
6756,785563,33,8,14,6,11,2,3,2,2,1,4,4,1,0,0,0,20
6756,780313,36,6,11,3,6,3,5,4,7,1,3,4,2,1,4,1,19
6756,780758,35,4,6,1,2,3,4,1,2,0,5,0,3,0,3,2,12
6756,791069,27,4,11,3,5,1,6,0,2,1,1,4,4,1,3,0,9
6756,775489,34,2,4,1,3,1,1,0,2,1,7,1,4,0,4,1,5
6756,796750,6,1,1,0,0,1,1,0,0,0,0,0,0,0,0,0,3
6756,791088,21,0,3,0,2,0,1,1,2,1,5,2,3,1,2,0,1
6756,781208,3,0,0,0,0,0,0,1,2,1,0,0,0,0,0,0,1
6756,791087,5,0,0,0,0,0,0,0,0,0,0,0,2,0,0,1,0
6757,776011,37,8,14,6,12,2,2,0,0,2,5,9,2,1,3,0,18
6757,791613,22,3,7,1,5,2,2,0,1,0,2,1,1,1,2,0,8
6757,796996,28,2,7,2,7,0,0,2,2,1,4,2,2,2,0,0,6
6757,780471,26,2,4,2,4,0,0,2,2,1,6,4,5,0,3,1,6
6757,791608,15,2,8,0,0,2,8,0,0,1,1,0,3,0,0,0,6
6757,792071,20,4,7,0,0,4,7,1,2,0,1,0,2,2,1,0,13
6757,791610,26,4,6,4,6,0,0,3,3,1,4,2,2,1,0,0,11
6757,796994,18,3,5,0,0,3,5,0,1,0,0,3,1,2,1,0,9
6757,785680,4,1,1,0,0,1,1,0,0,0,0,0,0,0,2,0,3
6757,786413,4,0,1,0,1,0,0,0,0,0,0,0,0,0,0,0,0
6758,781244,25,3,9,3,7,0,2,5,5,1,2,1,2,0,3,1,11
6758,791243,19,4,6,3,3,1,3,1,2,0,2,2,0,2,2,0,10
6758,791241,26,7,12,6,10,1,2,2,2,2,5,2,1,1,3,0,17
6758,785537,30,5,11,4,8,1,3,5,5,0,1,5,3,2,0,0,16
6758,781243,19,1,5,1,2,0,3,3,4,3,8,1,3,0,2,0,5
6758,796940,5,1,1,1,1,0,0,0,0,0,2,1,1,0,0,0,2
6758,791245,19,3,7,1,1,2,6,0,0,0,2,2,2,0,0,0,8
6758,791246,18,2,3,0,0,2,3,0,0,0,2,2,1,1,0,1,6
6758,785529,9,1,4,0,0,1,4,0,0,0,2,0,0,0,1,0,3
6758,776205,26,3,4,1,2,2,2,1,2,1,4,3,2,1,2,1,9
6758,796943,3,0,0,0,0,0,0,3,4,0,1,0,0,0,0,0,3
6758,785535,1,0,0,0,0,0,0,0,0,0,0,0,0,0,0,0,0
6759,780180,24,0,3,0,3,0,0,0,0,1,5,0,4,2,1,2,0
6759,781650,16,4,6,4,6,0,0,1,2,0,3,0,3,0,2,0,9
6759,791432,38,4,9,3,5,1,4,2,2,1,1,3,2,1,2,0,11
6759,777865,25,3,9,3,5,0,4,3,4,0,2,2,2,1,3,0,9
6759,791429,23,6,13,6,11,0,2,1,4,2,0,2,1,0,2,0,13
6759,797066,22,0,1,0,1,0,0,4,4,2,1,0,5,1,0,1,4
6759,797067,16,2,9,2,6,0,3,2,2,1,4,0,1,0,2,0,6
6759,797070,16,0,4,0,1,0,3,2,2,0,3,1,1,0,1,0,2
6759,797068,20,4,7,2,4,2,3,0,0,0,3,2,2,2,2,0,10
6760,791230,27,5,8,2,2,3,6,0,0,0,3,0,1,0,3,0,13
6760,785557,34,7,18,7,13,0,5,3,4,3,2,0,3,1,1,3,17
6760,791228,21,1,7,1,5,0,2,0,0,1,6,1,4,1,2,0,2
6760,796932,39,10,16,9,11,1,5,3,6,2,2,8,2,1,4,0,24
6760,785624,40,2,9,0,3,2,6,0,0,1,3,1,2,0,1,1,6
6760,796933,13,0,3,0,3,0,0,0,0,0,2,1,1,0,0,0,0
6760,791226,7,0,0,0,0,0,0,0,0,0,1,0,2,0,0,0,0
6760,781201,6,0,0,0,0,0,0,0,0,0,3,1,1,0,0,0,0
6760,781198,13,1,1,1,1,0,0,0,0,1,1,0,1,1,2,0,2
6760,791229,0,0,0,0,0,0,0,0,0,0,0,0,0,0,0,0,0
6761,791669,28,3,5,3,5,0,0,4,4,1,1,2,2,0,0,0,10
6761,785762,35,8,14,8,11,0,3,2,3,2,7,1,1,2,2,0,18
6761,797407,12,1,2,0,1,1,1,0,2,0,3,2,4,1,1,0,3
6761,791666,37,9,14,6,8,3,6,2,2,0,3,2,1,0,6,0,23
6761,780531,39,4,10,1,3,3,7,2,4,1,9,5,1,0,3,0,13
6761,780534,15,3,4,3,4,0,0,1,2,0,6,1,0,2,0,0,7
6761,797409,24,0,3,0,1,0,2,0,0,0,1,5,5,0,1,0,0
6761,797415,7,0,0,0,0,0,0,2,2,0,2,0,3,2,1,0,2
6761,780535,3,0,1,0,0,0,1,0,0,0,0,0,0,0,0,0,0
6762,791220,26,2,2,2,2,0,0,0,0,2,1,0,0,0,1,0,4
6762,791219,29,6,16,1,6,5,10,5,7,1,6,1,1,0,2,0,22
6762,776217,25,3,3,3,3,0,0,3,3,1,2,0,1,0,1,1,9
6762,786396,13,1,2,1,2,0,0,0,0,0,0,0,2,0,0,0,2
6762,780730,29,3,10,1,5,2,5,0,0,0,4,0,3,0,4,0,8
6762,786824,26,2,7,0,3,2,4,0,0,0,3,1,2,2,0,0,6
6762,791221,8,0,0,0,0,0,0,0,0,0,3,2,1,0,0,0,0
6762,796923,7,0,0,0,0,0,0,0,0,1,3,0,2,0,0,1,0
6762,796921,5,0,1,0,1,0,0,0,1,1,1,1,0,0,0,0,0
6762,790818,32,5,8,2,4,3,4,1,2,0,2,8,3,1,4,0,14
6763,786646,26,2,6,2,3,0,3,2,2,0,2,2,3,1,1,0,6
6763,780890,24,2,5,1,3,1,2,1,1,1,1,2,0,0,0,1,6
6763,786066,35,7,12,6,10,1,2,3,4,0,7,2,1,1,2,0,18
6763,780167,30,6,12,5,10,1,2,1,2,3,3,1,3,1,0,0,14
6763,775574,34,7,13,3,6,4,7,0,0,2,3,2,5,3,1,0,18
6763,791123,17,1,3,1,2,0,1,0,2,0,2,0,2,0,0,0,2
6763,785636,34,1,5,0,1,1,4,0,0,0,5,2,1,1,1,0,3
6764,791011,28,3,6,0,1,3,5,0,0,0,2,0,1,0,0,0,9
6764,780303,32,4,10,2,8,2,2,5,6,2,10,0,2,4,1,3,15
6764,786349,23,1,4,0,1,1,3,2,2,0,3,4,2,0,2,0,5
6764,781221,30,1,5,1,3,0,2,2,2,0,1,1,2,0,0,1,4
6764,781385,32,7,10,4,5,3,5,6,6,1,5,3,3,0,4,1,23
6764,796671,13,0,2,0,2,0,0,2,2,1,4,3,1,0,0,0,2
6764,785337,8,3,3,3,3,0,0,0,0,1,2,0,4,0,3,0,6
6764,796668,4,1,1,0,0,1,1,0,0,0,0,0,0,0,0,0,3
6764,791012,30,2,8,2,3,0,5,3,3,1,2,3,2,0,1,0,7
6765,784640,21,3,9,2,5,1,4,1,2,1,3,3,4,2,1,0,8
6765,797655,27,3,7,3,7,0,0,3,6,3,6,2,4,1,0,0,9
6765,797657,35,5,9,2,4,3,5,1,2,1,3,0,4,0,2,0,14
6765,792072,36,2,5,0,1,2,4,1,2,0,2,2,1,0,0,0,7
6765,792069,27,4,10,0,4,4,6,3,5,0,2,2,2,1,5,0,15
6765,786025,6,0,1,0,1,0,0,0,0,0,0,0,0,0,0,0,0
6765,797652,26,1,3,1,2,0,1,0,0,0,2,2,1,2,2,0,2
6765,785572,21,4,7,3,5,1,2,0,0,0,2,1,3,2,1,1,9
6765,774844,1,0,0,0,0,0,0,2,2,0,0,0,0,0,0,0,2
6766,786164,25,2,4,2,3,0,1,0,0,3,2,0,2,1,1,0,4
6766,781560,26,8,10,8,10,0,0,0,1,1,1,0,4,2,1,0,16
6766,796477,28,4,6,3,4,1,2,2,3,0,3,5,0,1,1,0,11
6766,791375,38,2,10,1,2,1,8,4,4,0,1,1,0,0,2,0,9
6766,785482,39,9,14,9,13,0,1,4,5,3,10,5,2,1,2,1,22
6766,780837,17,1,4,1,2,0,2,0,0,1,1,1,1,0,1,0,2
6766,796479,27,1,1,1,1,0,0,2,2,0,3,2,4,2,1,0,4
6767,792473,21,2,6,0,2,2,4,0,0,0,3,1,2,0,1,0,6
6767,780036,27,2,7,1,3,1,4,2,4,2,2,5,1,1,2,0,7
6767,799276,27,1,3,1,2,0,1,0,0,1,2,2,5,0,1,0,2
6767,785249,40,6,12,0,2,6,10,0,0,0,1,2,3,0,1,0,18
6767,780035,30,5,8,1,1,4,7,0,0,0,0,1,0,1,4,0,14
6767,785251,15,2,4,1,1,1,3,0,0,1,1,2,2,0,1,0,5
6767,780043,25,2,5,1,3,1,2,0,1,0,3,2,0,1,2,1,5
6767,792478,15,0,1,0,0,0,1,1,2,0,3,0,3,0,0,0,1
6768,790839,26,4,4,1,1,3,3,0,0,1,1,3,4,0,3,0,11
6768,785388,16,4,9,4,9,0,0,0,0,1,2,3,4,0,2,0,8
6768,790840,25,4,7,2,3,2,4,0,0,0,3,1,1,1,1,0,10
6768,796395,36,6,14,4,7,2,7,6,6,1,6,3,0,2,0,0,20
6768,785386,32,2,6,1,3,1,3,4,4,0,2,1,3,4,2,0,9
6768,780370,15,0,2,0,0,0,2,1,2,0,3,1,2,0,0,0,1
6768,796393,23,2,6,2,6,0,0,8,8,5,6,1,1,1,0,4,12
6768,790841,13,0,2,0,1,0,1,0,0,0,1,0,0,0,0,0,0
6768,780373,14,0,4,0,1,0,3,4,4,0,0,1,0,2,1,0,4
6769,786526,37,8,12,5,7,3,5,1,2,2,6,0,4,1,2,1,20
6769,786525,31,2,9,1,5,1,4,0,0,1,2,1,2,0,0,0,5
6769,786856,28,4,7,4,6,0,1,2,2,0,2,2,4,0,4,1,10
6769,786030,36,7,15,4,7,3,8,1,2,2,4,6,3,1,2,0,18
6769,781109,18,0,0,0,0,0,0,0,0,0,2,1,1,0,1,0,0
6769,791917,11,1,3,1,2,0,1,1,2,0,1,0,2,0,1,0,3
6769,797551,2,0,1,0,1,0,0,0,0,0,0,0,1,0,0,1,0
6769,797550,10,2,3,1,1,1,2,1,1,1,1,0,3,1,0,0,6
6769,791914,27,2,9,0,2,2,7,2,2,0,4,6,2,0,4,0,8
6770,797861,29,2,3,2,3,0,0,1,1,3,5,1,0,0,0,1,5
6770,792208,37,3,10,3,9,0,1,2,2,1,4,2,1,1,2,0,8
6770,792204,25,1,8,1,4,0,4,0,0,1,2,4,2,3,1,0,2
6770,786262,27,3,4,1,1,2,3,0,0,1,3,1,1,0,2,0,8
6770,781314,33,6,12,3,6,3,6,1,2,1,7,2,3,0,1,1,16
6770,776018,13,3,5,3,5,0,0,0,0,0,3,0,3,1,1,1,6
6770,797859,28,2,10,2,4,0,6,2,4,0,3,3,3,1,4,0,6
6770,781317,8,1,1,1,1,0,0,0,0,0,0,0,1,1,2,0,2
6770,797856,0,0,0,0,0,0,0,0,0,0,0,0,0,0,0,0,0
6771,797111,35,1,4,0,2,1,2,0,0,1,5,1,3,0,0,0,3
6771,797110,11,1,2,0,0,1,2,0,0,0,1,1,3,0,1,0,3
6771,791407,31,5,15,3,11,2,4,5,5,0,3,2,0,0,3,1,17
6771,785928,40,3,7,2,2,1,5,0,0,0,5,0,2,0,0,0,7
6771,785923,30,1,5,1,4,0,1,2,2,0,2,2,1,0,2,0,4
6771,791403,23,3,11,3,11,0,0,3,4,2,7,0,4,1,2,0,9
6771,797114,15,3,6,2,5,1,1,2,2,2,2,1,1,1,1,0,9
6771,791406,5,0,0,0,0,0,0,0,0,0,1,2,0,2,0,0,0
6771,791404,10,2,4,0,0,2,4,0,0,0,0,1,0,0,0,0,6
6772,787239,23,2,2,2,2,0,0,0,0,2,4,0,3,1,0,2,4
6772,785286,10,0,4,0,3,0,1,0,0,0,1,1,1,0,1,0,0
6772,789058,31,6,10,3,6,3,4,4,5,2,10,0,2,1,1,1,19
6772,792237,24,5,9,3,4,2,5,2,2,0,2,3,1,0,3,0,14
6772,797898,29,6,17,5,12,1,5,0,0,1,2,3,0,0,1,0,13
6772,797897,7,0,3,0,1,0,2,0,0,0,0,0,0,0,0,0,0
6772,797895,3,0,2,0,2,0,0,0,0,1,1,0,2,0,3,0,0
6772,792240,21,1,4,0,2,1,2,1,2,1,3,1,2,2,2,0,4
6772,792236,28,1,7,1,4,0,3,1,2,1,4,3,0,2,0,0,3
6772,792238,20,0,0,0,0,0,0,1,2,4,0,0,2,2,0,0,1
6772,785818,4,0,0,0,0,0,0,0,0,1,0,0,0,0,0,0,0
6772,785986,0,0,0,0,0,0,0,0,0,0,1,0,0,0,0,0,0
6773,778442,35,4,16,3,9,1,7,3,4,1,9,4,5,1,2,0,12
6773,791511,28,3,5,3,5,0,0,1,2,1,5,1,0,0,1,2,7
6773,786637,37,3,10,1,2,2,8,0,0,2,4,4,1,3,2,0,8
6773,780946,29,0,4,0,2,0,2,0,0,0,3,4,1,1,2,0,0
6773,797150,19,3,4,1,1,2,3,0,0,0,1,3,1,0,0,0,8
6773,797151,17,5,5,5,5,0,0,0,0,3,0,0,3,0,2,0,10
6773,791513,24,2,11,0,4,2,7,1,2,1,0,1,2,0,0,0,7
6773,791514,11,0,2,0,0,0,2,0,0,0,0,0,1,1,0,0,0
6773,791515,0,0,0,0,0,0,0,0,0,0,0,0,0,0,0,0,0
6774,785935,44,7,14,4,7,3,7,4,4,0,3,4,4,2,2,0,21
6774,792223,42,7,17,3,7,4,10,3,3,1,5,4,1,2,2,1,21
6774,792227,36,4,5,2,2,2,3,2,2,1,3,4,1,4,1,1,12
6774,781352,21,2,3,2,3,0,0,0,0,2,2,0,4,0,1,0,4
6774,781340,37,1,5,1,5,0,0,0,0,2,0,2,0,3,1,0,2
6774,797881,16,4,4,4,4,0,0,3,4,0,1,0,2,0,0,0,11
6774,781351,9,2,3,2,2,0,1,0,0,1,1,0,3,0,0,0,4
6774,786453,9,1,1,1,1,0,0,0,0,1,1,1,0,0,2,0,2
6774,797889,8,0,3,0,3,0,0,0,0,0,0,2,2,0,1,0,0
6774,797882,3,0,0,0,0,0,0,0,0,0,0,0,0,0,0,0,0
6775,789036,28,4,7,4,6,0,1,4,6,0,2,1,5,1,2,0,12
6775,791493,40,3,6,3,6,0,0,4,4,2,7,1,4,2,4,1,10
6775,776494,43,2,6,1,3,1,3,1,2,1,2,6,1,1,0,0,6
6775,791494,9,2,5,2,5,0,0,0,0,1,0,0,0,0,1,0,4
6775,797191,16,0,0,0,0,0,0,0,2,0,1,0,2,0,4,0,0
6775,791492,36,7,10,1,2,6,8,1,2,1,2,1,1,1,1,0,21
6775,778888,19,2,5,0,3,2,2,0,0,0,0,1,0,0,3,0,6
6775,791495,15,2,4,1,1,1,3,0,0,0,0,1,0,0,0,0,5
6775,780504,19,0,0,0,0,0,0,3,4,0,2,1,1,0,1,0,3
6776,781511,35,2,6,1,3,1,3,15,16,1,4,4,1,0,2,0,20
6776,796650,32,6,9,6,8,0,1,6,7,3,6,1,2,0,1,2,18
6776,791320,38,3,11,3,10,0,1,7,8,0,4,2,2,1,1,1,13
6776,791323,29,2,3,1,1,1,2,0,0,0,5,2,2,0,2,3,5
6776,796657,16,0,3,0,1,0,2,0,0,0,3,0,3,0,0,0,0
6776,785912,22,3,9,3,7,0,2,6,6,0,3,1,0,3,1,0,12
6776,791321,16,4,8,4,7,0,1,1,1,1,1,0,3,0,1,3,9
6776,796653,5,1,2,1,2,0,0,0,0,0,0,0,1,0,0,0,2
6776,796651,4,0,1,0,0,0,1,0,0,1,0,0,0,0,1,0,0
6776,796654,3,0,0,0,0,0,0,0,0,0,0,0,1,0,0,0,0
6776,796655,0,0,0,0,0,0,0,0,0,0,0,0,0,0,0,0,0
6776,796652,0,0,0,0,0,0,0,0,0,0,0,0,0,0,0,0,0
6776,796656,0,0,0,0,0,0,0,0,0,0,0,0,0,0,0,0,0
6777,780128,35,8,23,5,11,3,12,2,2,1,1,6,5,1,2,1,21
6777,775458,37,5,16,2,8,3,8,6,8,0,7,2,5,0,5,1,19
6777,775110,37,5,10,5,10,0,0,3,4,3,9,0,2,1,2,0,13
6777,785936,34,2,3,0,0,2,3,0,0,1,1,1,4,0,0,0,6
6777,791392,35,2,7,1,3,1,4,0,0,3,3,1,5,0,0,0,5
6777,797135,7,1,1,0,0,1,1,0,0,1,0,0,4,0,0,0,3
6777,785264,7,1,5,0,1,1,4,0,0,0,0,1,1,0,0,0,3
6777,797138,5,1,1,1,1,0,0,0,0,0,0,0,1,0,0,0,2
6777,786062,2,0,0,0,0,0,0,0,0,0,0,0,0,0,0,0,0
6777,781353,1,0,0,0,0,0,0,0,0,0,0,0,2,0,0,0,0
6778,791811,14,1,3,1,3,0,0,0,0,1,6,0,2,0,2,1,2
6778,796927,11,1,1,0,0,1,1,1,2,0,0,0,3,0,1,0,4
6778,796929,36,5,9,0,0,5,9,1,2,0,2,1,0,0,5,1,16
6778,791224,36,9,12,7,10,2,2,5,6,0,6,10,2,3,8,0,25
6778,785564,34,3,7,0,2,3,5,0,0,1,3,2,1,1,4,0,9
6778,791225,27,6,8,6,8,0,0,1,1,2,8,2,3,1,1,2,13
6778,775324,28,6,7,6,7,0,0,5,7,0,3,2,2,0,0,2,17
6778,796926,10,0,2,0,1,0,1,0,0,0,0,0,0,0,0,0,0
6778,791222,4,0,1,0,1,0,0,0,0,0,0,0,1,0,0,0,0
6779,792186,30,4,7,4,7,0,0,1,2,6,6,2,5,1,1,1,9
6779,781447,21,3,6,3,6,0,0,1,2,3,2,1,4,0,2,1,7
6779,792188,36,4,14,1,4,3,10,1,2,1,3,1,1,1,2,0,12
6779,792183,38,8,19,5,11,3,8,9,10,0,1,1,1,4,4,0,28
6779,786675,15,2,5,2,3,0,2,0,0,1,0,2,1,0,2,0,4
6779,797819,27,3,7,3,7,0,0,0,1,1,3,1,2,3,0,3,6
6779,780433,6,1,3,1,3,0,0,0,1,0,0,0,0,0,1,0,2
6779,792187,7,0,0,0,0,0,0,0,0,0,0,1,0,1,0,0,0
6779,792185,20,2,9,2,5,0,4,0,0,0,1,1,1,2,0,0,4
6780,791936,33,8,11,8,11,0,0,2,2,5,3,1,3,2,3,1,18
6780,797527,35,6,8,5,7,1,1,1,3,2,5,1,5,3,0,1,14
6780,797532,38,5,10,5,8,0,2,2,3,0,8,6,2,1,4,0,12
6780,797529,27,5,9,4,6,1,3,1,3,1,4,1,0,0,2,0,12
6780,785688,12,0,2,0,0,0,2,0,0,0,0,0,0,1,2,0,0
6780,785988,33,5,10,1,1,4,9,4,5,1,1,2,1,1,1,1,18
6780,791932,15,2,6,2,4,0,2,0,0,0,1,3,1,0,0,0,4
6780,791933,7,0,1,0,0,0,1,0,0,0,0,0,1,1,1,0,0
6780,791935,0,0,0,0,0,0,0,0,0,0,0,0,1,0,0,0,0
6781,796789,38,8,15,4,4,4,11,0,0,0,3,2,2,1,1,0,20
6781,791126,29,6,9,6,9,0,0,1,1,4,3,2,2,0,3,0,13
6781,780050,35,5,15,5,12,0,3,2,2,4,5,5,2,2,3,1,12
6781,785681,23,6,9,6,9,0,0,0,1,3,1,3,3,3,0,1,12
6781,791124,32,0,6,0,3,0,3,4,4,0,2,4,2,1,2,0,4
6781,796784,17,3,6,1,3,2,3,0,1,0,2,2,2,0,1,0,8
6781,796782,8,2,2,1,1,1,1,0,0,0,2,0,0,0,0,0,5
6781,775813,14,2,3,2,3,0,0,0,0,2,0,0,2,2,1,0,4
6781,796786,4,1,3,1,1,0,2,0,0,0,1,0,0,0,0,0,2
6781,796783,0,0,0,0,0,0,0,0,0,0,0,0,0,0,0,0,0
6782,791737,31,5,9,4,7,1,2,2,5,0,4,1,3,1,1,0,13
6782,797331,31,4,8,0,3,4,5,0,0,0,3,0,1,0,0,0,12
6782,781516,13,2,8,2,8,0,0,1,2,1,2,1,4,0,1,0,5
6782,780561,25,1,5,0,1,1,4,1,2,1,5,0,1,2,2,0,4
6782,783524,25,0,9,0,4,0,5,2,2,0,1,1,1,0,2,0,2
6782,786220,23,3,4,2,2,1,2,1,5,0,0,2,0,0,1,0,8
6782,797332,14,1,4,1,4,0,0,2,3,1,1,0,2,0,2,0,4
6782,786223,15,1,3,1,2,0,1,1,3,2,2,0,2,0,0,0,3
6782,791734,6,0,1,0,1,0,0,3,4,1,2,1,2,0,0,0,3
6782,797333,13,0,0,0,0,0,0,0,0,0,3,1,2,1,3,0,0
6782,795372,4,0,0,0,0,0,0,0,0,0,0,0,0,0,0,0,0
6783,797247,35,7,12,7,8,0,4,2,3,0,8,7,4,1,2,3,16
6783,776297,32,5,13,4,6,1,7,2,3,1,5,1,2,2,3,0,13
6783,791352,29,2,5,1,2,1,3,1,2,5,4,0,1,0,4,0,6
6783,797251,23,2,5,1,2,1,3,0,1,2,3,2,2,0,1,2,5
6783,780455,10,2,6,2,6,0,0,0,0,2,3,0,3,0,1,2,4
6783,785837,13,5,7,5,5,0,2,2,3,0,2,0,5,0,1,1,12
6783,791355,13,2,6,1,1,1,5,0,0,0,0,0,2,0,0,0,5
6783,791354,11,1,1,1,1,0,0,2,2,1,1,0,2,0,0,0,4
6783,797248,27,0,3,0,2,0,1,1,2,0,2,2,2,1,3,0,1
6783,797249,4,0,0,0,0,0,0,0,0,0,0,1,0,0,0,0,0
6783,786227,3,0,0,0,0,0,0,0,0,0,0,0,2,0,0,0,0
6784,776200,24,1,3,1,3,0,0,1,4,3,0,4,2,1,0,0,3
6784,796979,28,3,10,3,8,0,2,0,1,2,2,0,0,0,0,1,6
6784,781034,35,4,11,1,5,3,6,6,6,0,1,4,2,0,3,0,17
6784,786437,23,2,5,2,3,0,2,1,2,1,1,1,5,1,1,0,5
6784,780925,34,3,6,1,2,2,4,0,0,0,4,5,2,2,2,0,8
6784,791625,12,5,6,2,3,3,3,0,0,0,2,0,0,1,2,0,13
6784,791622,16,2,2,2,2,0,0,0,0,0,1,1,2,0,0,0,4
6784,791624,7,1,2,1,1,0,1,0,0,0,0,1,1,0,1,0,2
6784,791637,21,4,5,0,1,4,4,3,4,3,5,1,1,1,0,1,15
6785,780824,33,6,6,6,6,0,0,2,4,6,3,0,3,1,0,1,14
6785,791118,38,4,17,3,12,1,5,5,6,1,0,3,2,0,1,0,14
6785,785947,28,2,5,2,3,0,2,0,0,0,3,1,1,0,0,2,4
6785,774974,36,3,7,2,6,1,1,6,6,1,4,1,1,1,1,0,13
6785,785676,33,2,7,1,3,1,4,0,0,1,4,2,2,0,4,1,5
6785,791117,25,3,5,1,1,2,4,2,2,0,2,0,1,1,3,0,10
6785,791115,7,0,1,0,1,0,0,0,0,1,1,1,2,0,1,0,0
6786,796568,15,1,2,1,2,0,0,0,1,0,3,0,3,0,0,0,2
6786,796566,33,6,8,6,8,0,0,2,2,4,6,1,2,2,1,3,14
6786,790969,28,2,8,2,6,0,2,6,6,0,2,4,3,1,2,0,10
6786,780166,37,3,11,1,8,2,3,7,7,0,4,10,2,3,5,0,15
6786,775107,19,4,9,1,6,3,3,0,0,0,1,1,1,0,0,0,11
6786,790971,8,1,1,1,1,0,0,0,0,1,2,2,1,0,1,0,2
6786,796569,5,0,2,0,2,0,0,0,0,0,0,0,0,0,0,1,0
6786,796563,19,3,4,2,2,1,2,1,2,1,3,1,3,0,2,0,8
6786,790968,17,4,5,1,1,3,4,2,2,0,1,1,0,0,1,0,13
6786,790967,19,3,6,1,1,2,5,0,0,0,1,2,0,1,1,0,8
6787,792334,28,1,6,1,5,0,1,4,4,2,6,1,3,1,2,1,6
6787,786575,31,2,3,2,3,0,0,6,7,5,2,1,2,1,4,2,10
6787,791636,18,2,7,2,3,0,4,0,0,0,2,2,3,2,0,0,4
6787,792338,36,6,15,6,13,0,2,0,0,1,5,2,1,3,3,0,12
6787,781666,35,11,19,6,10,5,9,3,4,1,2,0,4,1,1,0,30
6787,798097,7,0,2,0,2,0,0,0,0,0,0,0,1,0,0,0,0
6787,785531,14,1,2,1,1,0,1,2,2,1,4,1,3,0,2,0,4
6787,798095,10,2,2,0,0,2,2,0,0,0,0,0,1,0,0,0,6
6787,798100,5,0,0,0,0,0,0,0,0,0,1,2,0,0,0,0,0
6787,799842,16,2,6,2,5,0,1,1,1,1,0,0,2,1,3,0,5
6788,792167,28,2,7,2,7,0,0,0,0,4,3,1,3,0,3,1,4
6788,797766,32,3,9,2,6,1,3,0,1,3,4,1,1,1,1,0,7
6788,791372,34,6,14,3,4,3,10,0,0,0,3,1,0,3,3,0,15
6788,792164,27,6,15,4,6,2,9,0,0,0,2,1,4,2,2,0,14
6788,780974,17,1,3,0,1,1,2,0,0,0,2,1,1,0,2,1,3
6788,792170,9,2,3,2,3,0,0,0,0,1,1,0,4,0,1,0,4
6788,797767,29,2,3,0,1,2,2,0,0,1,3,7,3,2,1,0,6
6788,797772,5,0,0,0,0,0,0,0,0,0,0,1,0,0,0,0,0
6788,792163,15,2,3,0,0,2,3,0,0,0,1,0,1,0,1,0,6
6788,797764,4,0,0,0,0,0,0,2,3,0,0,0,0,1,0,1,2
6789,780229,27,3,6,3,6,0,0,3,4,1,5,5,1,1,4,1,9
6789,795572,36,7,13,6,11,1,2,5,5,1,11,5,2,1,3,0,20
6789,791483,25,1,5,1,3,0,2,5,5,0,2,1,0,1,2,0,7
6789,786322,13,0,3,0,0,0,3,0,0,0,1,0,3,0,0,0,0
6789,780228,35,3,6,0,0,3,6,1,2,0,0,1,3,0,0,0,10
6789,791484,21,3,6,3,4,0,2,0,0,0,1,0,0,1,0,2,6
6789,781592,24,6,7,4,4,2,3,0,0,0,1,2,1,0,1,0,14
6789,797193,15,1,3,0,1,1,2,0,0,0,2,2,0,0,0,0,3
6789,791485,4,0,1,0,1,0,0,0,0,0,0,0,0,0,1,0,0
6790,791989,20,5,11,4,6,1,5,2,4,1,1,7,0,3,0,0,13
6790,791988,20,6,11,6,11,0,0,1,2,5,5,0,0,3,1,0,13
6790,796507,27,3,12,1,6,2,6,2,2,2,7,1,1,1,0,0,10
6790,791987,26,3,5,2,4,1,1,0,0,0,2,7,2,0,0,0,7
6790,792443,15,2,7,2,7,0,0,1,3,3,5,0,3,0,2,1,5
6790,796503,27,6,7,3,3,3,4,0,0,0,4,6,1,3,3,0,15
6790,780077,12,5,7,2,3,3,4,0,0,0,1,2,1,0,0,0,13
6790,796508,16,4,10,3,4,1,6,0,0,4,2,0,0,0,0,0,9
6790,796506,15,2,4,2,4,0,0,0,0,2,1,0,2,0,1,1,4
6790,796509,11,2,2,2,2,0,0,0,0,0,0,1,0,0,0,0,4
6790,785258,11,0,3,0,1,0,2,0,0,1,2,0,0,1,1,0,0
6791,792634,37,6,14,1,4,5,10,0,0,2,3,2,1,1,2,0,17
6791,799129,33,4,11,2,4,2,7,2,2,1,3,5,3,1,3,0,12
6791,800005,29,4,6,4,6,0,0,1,2,1,4,0,1,2,2,1,9
6791,799130,28,3,11,0,3,3,8,0,1,0,3,0,1,1,4,0,9
6791,800091,26,2,12,2,11,0,1,3,7,5,5,2,3,1,4,1,7
6791,799136,12,2,2,2,2,0,0,0,0,0,1,0,0,0,0,1,4
6791,799128,17,0,0,0,0,0,0,0,0,0,1,2,1,0,1,0,0
6791,799133,10,0,2,0,1,0,1,0,0,1,2,0,1,0,2,0,0
6791,799134,7,0,2,0,0,0,2,0,0,0,0,0,0,0,1,0,0
6791,799135,1,0,0,0,0,0,0,0,0,0,0,0,0,0,0,0,0
6791,799132,0,0,0,0,0,0,0,0,0,0,1,0,0,0,0,0,0
6792,786130,33,8,21,4,9,4,12,3,4,1,6,0,3,0,2,0,23
6792,797369,31,6,8,5,6,1,2,2,3,0,4,8,4,4,2,0,15
6792,797367,29,5,7,5,7,0,0,1,1,5,8,2,3,4,3,1,11
6792,791807,37,3,13,1,3,2,10,2,2,0,1,2,1,3,4,0,10
6792,797366,25,2,5,2,4,0,1,1,4,6,4,2,3,1,0,0,5
6792,797363,20,2,8,2,8,0,0,2,3,0,1,2,1,0,3,0,6
6792,797365,11,1,3,0,0,1,3,1,2,0,0,0,2,1,1,0,4
6792,797364,10,1,3,1,3,0,0,0,1,2,1,1,2,0,3,2,2
6792,797368,4,0,0,0,0,0,0,2,2,0,0,0,0,0,0,0,2
6793,797601,36,7,12,6,8,1,4,4,4,0,6,4,1,4,5,0,19
6793,775119,25,5,13,4,9,1,4,2,3,1,5,6,1,0,4,0,13
6793,797604,33,2,10,2,5,0,5,3,5,5,4,2,3,1,1,0,7
6793,781011,21,1,2,1,2,0,0,2,2,1,3,1,3,1,7,1,4
6793,781012,31,1,8,0,4,1,4,0,0,0,2,3,2,2,0,0,3
6793,775806,27,6,10,2,3,4,7,4,7,1,1,2,4,2,3,0,20
6793,775563,17,1,4,1,4,0,0,1,2,0,3,0,4,1,3,0,3
6793,797602,8,1,3,1,3,0,0,0,0,2,3,0,4,0,0,0,2
6793,775188,2,0,0,0,0,0,0,0,0,1,1,0,0,0,1,0,0
6793,786466,0,0,0,0,0,0,0,0,0,0,0,0,0,0,0,0,0
6794,791905,31,4,8,2,4,2,4,0,0,3,6,2,1,1,1,1,10
6794,781103,31,5,9,5,9,0,0,1,2,3,7,3,1,0,7,1,11
6794,797568,25,1,6,0,1,1,5,3,4,0,4,1,3,0,2,0,6
6794,797566,34,3,9,2,5,1,4,0,0,1,1,1,2,1,1,1,7
6794,781191,25,4,13,2,7,2,6,1,2,2,0,2,4,0,2,1,11
6794,797569,21,1,5,0,2,1,3,2,3,0,2,2,3,2,1,0,5
6794,791907,9,1,2,1,2,0,0,0,0,1,2,1,1,0,3,0,2
6794,781364,3,0,2,0,1,0,1,0,0,0,3,0,1,0,0,0,0
6794,781102,21,2,4,2,3,0,1,1,4,2,1,0,0,4,0,0,5
6795,791391,35,2,4,2,3,0,1,0,1,2,3,1,4,3,2,2,4
6795,797156,18,2,6,1,3,1,3,0,0,0,2,2,2,1,1,0,5
6795,791390,31,2,7,2,6,0,1,4,4,2,2,4,3,3,1,1,8
6795,780133,30,2,9,0,2,2,7,0,1,0,4,3,3,1,0,0,6
6795,780130,35,12,18,10,11,2,7,5,6,1,6,0,1,0,4,1,31
6795,791388,11,1,3,1,3,0,0,0,0,0,0,0,0,1,0,0,2
6795,775743,18,0,3,0,1,0,2,0,0,1,3,0,1,0,1,0,0
6795,780407,22,2,4,1,1,1,3,0,0,1,2,1,0,0,0,0,5
6796,785913,9,1,3,1,3,0,0,0,0,0,1,0,2,0,1,0,2
6796,786516,11,1,4,0,0,1,4,0,0,0,2,0,2,0,0,0,3
6796,781464,33,3,5,2,2,1,3,0,0,1,2,2,2,1,1,2,7
6796,781502,36,4,10,1,4,3,6,3,3,0,6,5,1,0,5,0,14
6796,780259,37,3,13,2,8,1,5,1,1,1,7,4,2,2,3,1,8
6796,792274,8,1,2,1,2,0,0,0,0,1,2,0,0,0,2,0,2
6796,792277,9,0,2,0,2,0,0,0,2,3,3,0,1,0,2,0,0
6796,781501,28,5,5,5,5,0,0,2,2,1,3,3,3,0,1,0,12
6796,785282,25,3,6,1,2,2,4,2,2,0,1,1,2,0,1,0,10
6796,798051,3,0,0,0,0,0,0,0,0,0,0,0,0,0,0,0,0
6796,798058,1,0,0,0,0,0,0,0,0,0,0,0,0,0,0,0,0
6797,790846,30,0,4,0,4,0,0,1,2,0,3,0,2,1,0,1,1
6797,796755,7,0,2,0,1,0,1,2,2,0,3,0,3,0,1,1,2
6797,791099,25,2,10,1,3,1,7,2,2,0,1,1,0,1,1,0,7
6797,785470,32,5,9,0,0,5,9,0,0,0,3,2,0,2,0,0,15
6797,780298,33,6,10,1,2,5,8,1,2,1,2,2,0,3,3,0,18
6797,780315,21,2,5,2,5,0,0,0,0,3,0,3,3,0,1,0,4
6797,780814,18,2,5,1,4,1,1,0,0,1,2,1,3,0,1,0,5
6797,785586,19,3,5,2,3,1,2,2,2,0,4,2,0,2,1,0,9
6797,796754,15,2,3,2,3,0,0,0,2,1,0,1,0,1,1,0,4
6798,790761,30,6,9,5,6,1,3,2,3,1,4,4,2,1,2,0,15
6798,790764,21,3,6,2,2,1,4,0,0,0,3,0,5,0,0,0,7
6798,796322,15,1,2,1,2,0,0,0,0,4,4,0,1,0,1,3,2
6798,796319,23,5,10,4,9,1,1,0,0,0,2,2,2,1,3,1,11
6798,796320,27,7,14,5,8,2,6,0,0,0,0,5,1,3,2,0,16
6798,779993,25,2,3,1,2,1,1,2,2,0,2,4,2,4,2,0,7
6798,796321,5,0,1,0,0,0,1,0,0,0,0,0,1,0,1,0,0
6798,796318,24,6,12,4,10,2,2,0,0,2,3,5,3,1,2,1,14
6798,785219,18,4,8,1,1,3,7,0,0,0,1,1,0,0,2,1,11
6798,796323,12,2,2,2,2,0,0,0,2,1,1,2,1,0,0,1,4
6799,790856,25,6,12,6,12,0,0,4,7,2,4,1,2,2,1,1,16
6799,780452,35,5,9,5,9,0,0,2,4,1,5,4,1,2,2,1,12
6799,796413,23,4,4,0,0,4,4,0,0,0,2,1,1,1,1,0,12
6799,796408,31,9,16,5,11,4,5,3,3,0,2,7,1,1,5,0,25
6799,796407,24,4,4,3,3,1,1,3,4,1,2,4,4,1,1,0,12
6799,796411,2,0,3,0,3,0,0,0,0,1,1,0,0,0,0,0,0
6799,796410,17,5,5,5,5,0,0,1,4,4,5,0,1,1,3,0,11
6799,796409,15,0,5,0,2,0,3,0,0,0,2,2,0,0,0,0,0
6799,780450,13,1,4,0,2,1,2,0,0,0,1,0,1,0,2,1,3
6799,790858,15,0,2,0,2,0,0,0,0,2,0,1,2,2,1,0,0
6800,785375,13,2,4,2,3,0,1,2,2,1,3,1,0,3,0,2,6
6800,785372,32,6,14,5,10,1,4,3,3,1,5,5,1,2,3,2,16
6800,786384,14,0,3,0,2,0,1,0,0,0,1,0,5,0,2,0,0
6800,785371,18,0,3,0,0,0,3,6,6,0,2,4,3,1,1,0,6
6800,774905,24,7,12,3,6,4,6,0,1,0,5,0,3,0,3,0,18
6800,790825,16,2,5,1,2,1,3,0,0,0,3,3,2,0,5,0,5
6800,785374,7,0,0,0,0,0,0,0,0,0,2,0,1,0,1,0,0
6800,796385,14,1,5,1,3,0,2,0,0,1,2,2,2,0,1,1,2
6800,790827,24,1,4,1,3,0,1,0,0,1,3,1,1,1,3,1,2
6800,785373,18,3,6,3,4,0,2,0,0,1,6,0,0,0,0,1,6
6800,790828,11,0,2,0,2,0,0,3,4,2,2,0,4,0,1,0,3
6800,796387,8,1,1,1,1,0,0,0,0,1,1,0,2,0,0,0,2
6800,780007,1,0,0,0,0,0,0,0,0,0,0,0,0,0,0,0,0
6801,781007,23,1,2,1,2,0,0,2,4,0,4,2,4,1,1,2,4
6801,781322,25,4,10,2,3,2,7,0,0,1,3,0,1,0,2,1,10
6801,785989,26,2,7,2,5,0,2,2,3,1,5,1,5,1,4,2,6
6801,786571,32,5,9,5,8,0,1,3,5,0,4,3,2,3,3,0,13
6801,781439,23,1,10,1,8,0,2,1,2,1,2,2,2,2,3,0,3
6801,781419,24,1,6,0,3,1,3,1,3,1,0,1,0,1,0,0,4
6801,791690,14,2,4,2,4,0,0,0,3,1,2,0,0,1,0,0,4
6801,781207,19,3,7,3,5,0,2,2,4,1,3,2,1,2,3,1,8
6801,780563,14,2,3,2,3,0,0,0,0,0,0,0,2,1,1,0,4
6802,786542,28,4,10,4,7,0,3,5,6,0,8,1,2,1,2,0,13
6802,786540,17,2,5,1,2,1,3,0,0,0,0,0,4,0,1,1,5
6802,792016,34,3,10,2,5,1,5,5,5,1,3,6,3,2,0,1,12
6802,791845,30,2,8,2,7,0,1,5,7,4,5,1,1,1,1,1,9
6802,775995,32,1,10,1,7,0,3,1,2,0,3,1,1,1,0,0,3
6802,785364,26,8,12,8,12,0,0,0,6,6,2,0,1,1,2,1,16
6802,781147,16,2,3,1,1,1,2,0,0,0,1,0,0,0,0,0,5
6802,797515,13,1,6,1,3,0,3,2,2,1,2,3,0,1,1,0,4
6802,797513,4,0,1,0,0,0,1,0,0,1,2,1,0,0,1,0,0
6803,797047,10,1,1,1,1,0,0,3,4,0,1,1,5,0,0,0,5
6803,775515,22,3,6,2,2,1,4,0,0,0,6,1,3,0,2,1,7
6803,791579,35,6,11,3,5,3,6,3,3,1,6,8,1,1,1,0,18
6803,786387,35,8,11,7,10,1,1,0,0,1,5,4,1,0,2,0,17
6803,780399,34,6,10,1,4,5,6,1,4,1,3,6,2,1,3,0,18
6803,786846,13,3,6,1,2,2,4,0,0,0,3,1,3,0,1,0,8
6803,780400,19,1,2,0,1,1,1,1,2,0,3,0,3,1,1,0,4
6803,791575,13,5,10,5,10,0,0,0,0,1,7,0,1,0,0,0,10
6803,797046,13,0,5,0,1,0,4,0,0,0,0,1,1,0,0,0,0
6803,791574,1,0,1,0,0,0,1,0,0,0,0,0,0,0,0,0,0
6803,791577,1,0,0,0,0,0,0,0,0,0,0,0,0,0,0,0,0
6803,786391,2,0,0,0,0,0,0,0,0,0,0,0,0,0,0,0,0
6803,786390,2,0,0,0,0,0,0,0,0,0,1,0,1,0,0,0,0
6804,785914,10,0,2,0,1,0,1,1,2,1,0,0,5,0,2,0,1
6804,780105,35,6,12,4,6,2,6,2,2,1,6,1,1,2,4,1,16
6804,785637,28,5,10,3,7,2,3,2,3,0,1,2,1,2,1,0,14
6804,785915,29,0,3,0,0,0,3,0,0,0,0,0,2,0,0,0,0
6804,781131,37,6,17,6,15,0,2,1,4,1,9,2,3,0,3,0,13
6804,791408,18,4,6,4,6,0,0,0,0,1,4,0,5,0,1,1,8
6804,785916,14,1,3,1,1,0,2,0,0,0,0,0,5,0,1,1,2
6804,780106,2,0,0,0,0,0,0,0,0,0,0,0,0,0,0,0,0
6804,797108,2,0,0,0,0,0,0,0,0,0,0,0,0,0,0,0,0
6804,797106,0,0,0,0,0,0,0,0,0,0,0,0,0,0,0,0,0
6804,791409,2,0,0,0,0,0,0,0,0,0,0,0,0,0,0,0,0
6804,797107,1,0,0,0,0,0,0,0,0,0,1,0,0,0,0,0,0
6804,785894,22,1,4,0,0,1,4,0,0,0,2,1,0,0,0,0,3
6805,786059,31,7,10,5,8,2,2,1,4,0,5,0,1,1,1,0,17
6805,776174,30,6,12,6,12,0,0,6,8,4,6,3,4,1,7,0,18
6805,791958,34,5,13,4,11,1,2,5,6,2,6,2,0,0,1,0,16
6805,791960,23,3,7,2,5,1,2,0,0,0,0,1,4,1,0,0,7
6805,785861,36,3,6,3,5,0,1,0,0,2,8,3,2,2,1,0,6
6805,786063,1,0,1,0,1,0,0,0,0,0,0,0,1,0,0,0,0
6805,781334,2,0,1,0,1,0,0,1,2,0,0,0,0,0,0,0,1
6805,797706,1,0,0,0,0,0,0,0,0,0,0,0,0,0,0,0,0
6805,797704,13,1,3,0,0,1,3,0,0,0,2,1,0,0,0,0,3
6805,791957,1,0,0,0,0,0,0,0,0,0,0,0,0,0,0,0,0
6805,791959,1,0,0,0,0,0,0,0,0,1,0,0,0,0,0,0,0
6805,781332,27,3,8,1,4,2,4,1,2,1,1,3,1,1,0,0,9
6806,780570,30,6,13,6,13,0,0,0,0,3,3,0,1,1,2,0,12
6806,780569,36,2,5,2,5,0,0,1,5,5,11,0,2,0,1,5,5
6806,791697,28,5,15,2,8,3,7,0,1,1,1,1,3,0,2,0,13
6806,791696,28,3,9,3,9,0,0,6,7,1,1,3,3,3,1,0,12
6806,780565,39,8,11,6,7,2,4,3,4,0,3,3,2,0,3,0,21
6806,797433,3,0,0,0,0,0,0,0,0,0,0,0,2,0,0,0,0
6806,797436,15,2,4,2,3,0,1,2,3,0,2,1,0,2,3,0,6
6806,791695,12,0,2,0,2,0,0,0,0,0,2,0,3,2,0,0,0
6806,785824,2,0,1,0,1,0,0,0,0,1,0,0,0,0,0,0,0
6806,781556,7,2,3,2,3,0,0,0,0,0,0,1,3,1,0,1,4
6807,797779,39,7,18,5,11,2,7,6,7,0,3,0,4,1,1,0,22
6807,785568,36,2,5,2,5,0,0,2,2,4,11,1,2,0,1,0,6
6807,797778,19,3,7,1,3,2,4,0,0,1,2,1,2,0,1,1,8
6807,786256,25,2,6,2,6,0,0,0,0,1,1,1,2,0,4,0,4
6807,797774,22,3,9,2,5,1,4,4,4,0,2,4,4,2,3,0,11
6807,797770,16,1,5,1,5,0,0,2,2,2,2,0,1,0,1,0,4
6807,797771,4,0,0,0,0,0,0,0,0,0,1,0,1,0,0,0,0
6807,797768,16,3,5,2,2,1,3,4,4,1,1,3,1,1,1,0,11
6807,775106,23,3,8,3,8,0,0,3,3,1,1,1,3,1,1,0,9
6808,775640,15,2,6,1,4,1,2,0,0,1,1,0,4,0,0,1,5
6808,780919,27,7,9,7,9,0,0,7,7,3,0,0,3,1,2,1,21
6808,785803,33,3,5,1,2,2,3,0,0,0,0,4,3,2,2,0,8
6808,780920,39,6,10,5,7,1,3,4,4,0,2,6,1,1,3,0,17
6808,780914,26,3,7,1,3,2,4,1,2,0,2,4,2,0,2,0,9
6808,775816,19,4,7,2,3,2,4,0,0,1,2,0,3,1,0,0,10
6808,791142,15,1,3,0,1,1,2,0,0,0,2,0,1,0,0,0,3
6808,796799,13,2,3,1,2,1,1,1,2,0,2,0,3,1,0,0,6
6808,791141,7,1,2,0,1,1,1,0,0,0,0,1,0,0,0,0,3
6808,775639,6,0,0,0,0,0,0,0,2,0,1,0,1,0,0,0,0
6809,796334,35,7,11,5,6,2,5,2,2,0,2,3,0,1,2,0,18
6809,790776,21,2,3,2,3,0,0,2,2,3,2,1,3,1,1,1,6
6809,796332,14,1,3,1,2,0,1,0,0,1,2,0,1,0,0,0,2
6809,785813,33,4,12,4,10,0,2,8,8,1,1,7,1,1,3,0,16
6809,796337,31,2,5,2,5,0,0,1,2,0,3,3,2,2,1,0,5
6809,796330,31,7,9,3,4,4,5,4,5,0,3,1,3,1,1,0,22
6809,785827,18,3,7,3,7,0,0,1,4,3,1,2,3,0,0,1,7
6809,796336,16,1,4,0,0,1,4,0,0,1,0,1,2,0,0,0,3
6809,779975,1,0,1,0,1,0,0,0,0,0,0,0,0,0,0,0,0
6810,781407,24,12,17,12,17,0,0,2,2,4,10,1,2,2,1,1,26
6810,791583,31,5,13,5,12,0,1,3,6,2,0,1,1,2,0,5,13
6810,797445,27,4,7,4,6,0,1,0,0,2,1,3,2,1,4,0,8
6810,786110,17,0,6,0,4,0,2,0,0,1,2,1,1,0,1,1,0
6810,776150,34,2,10,2,6,0,4,0,0,0,4,6,1,0,0,0,4
6810,797448,13,1,4,1,2,0,2,0,0,1,1,0,1,0,1,0,2
6810,786608,9,0,2,0,2,0,0,0,0,2,0,1,0,0,1,0,0
6810,785623,9,0,1,0,1,0,0,1,2,0,4,0,0,0,1,0,1
6810,786659,9,0,1,0,1,0,0,0,0,0,2,0,2,1,2,0,0
6810,780580,27,3,5,3,5,0,0,3,4,0,3,3,1,3,3,0,9
6811,797028,35,5,13,4,9,1,4,0,0,0,6,1,3,0,3,0,11
6811,775047,28,5,7,4,6,1,1,0,0,2,3,4,4,2,1,1,11
6811,797025,26,3,13,2,9,1,4,1,2,0,2,2,0,1,1,2,8
6811,791600,25,3,8,3,4,0,4,0,0,1,2,1,0,0,1,0,6
6811,780410,36,7,15,2,5,5,10,0,0,0,5,5,2,1,0,0,19
6811,797026,7,1,2,1,2,0,0,1,1,1,0,0,0,0,1,0,3
6811,785687,7,1,1,1,1,0,0,2,2,1,0,0,2,0,1,0,4
6811,797027,29,5,9,4,8,1,1,0,0,4,7,3,1,3,2,3,11
6811,791597,7,1,1,1,1,0,0,0,0,0,0,2,1,0,3,0,2
6812,781044,31,9,17,8,11,1,6,1,1,1,3,1,1,0,2,0,20
6812,791795,23,1,4,1,1,0,3,3,6,3,9,0,5,0,2,1,5
6812,786489,33,5,10,4,5,1,5,0,0,0,3,3,3,0,2,0,11
6812,786488,34,6,12,5,10,1,2,1,3,4,6,2,3,1,1,0,14
6812,781038,35,3,8,1,4,2,4,1,2,2,3,5,3,0,0,0,9
6812,797620,19,2,4,1,2,1,2,1,2,2,4,0,0,0,1,0,6
6812,797619,11,1,3,1,3,0,0,0,0,0,0,1,2,0,1,0,2
6812,786487,14,3,8,2,4,1,4,0,0,0,1,0,1,0,1,0,7
6813,786860,16,0,3,0,2,0,1,0,0,0,0,0,2,1,0,1,0
6813,786544,38,9,19,7,10,2,9,3,4,3,14,3,3,0,1,1,23
6813,792012,40,7,18,2,7,5,11,6,6,0,7,4,1,0,1,0,25
6813,786546,28,2,6,0,3,2,3,2,2,0,1,1,1,0,0,2,8
6813,775084,33,4,7,4,6,0,1,2,2,0,2,2,0,1,0,0,10
6813,786547,26,3,4,3,3,0,1,2,3,2,2,1,3,1,1,0,8
6813,797507,19,2,5,2,3,0,2,2,2,1,1,1,2,1,1,0,6
6814,791763,6,0,1,0,0,0,1,0,0,0,1,0,2,1,0,0,0
6814,781577,31,7,9,6,7,1,2,4,5,1,3,3,0,2,1,0,19
6814,786451,30,2,5,1,1,1,4,0,0,1,2,3,1,1,1,0,5
6814,780600,24,7,10,3,3,4,7,2,2,0,3,2,2,0,0,0,20
6814,781387,28,5,8,3,5,2,3,1,2,0,1,3,3,3,1,0,13
6814,800084,5,1,4,1,1,0,3,0,0,0,1,0,0,0,0,0,2
6814,790888,6,3,6,2,3,1,3,1,1,1,2,0,2,0,0,0,8
6814,786456,18,5,6,4,5,1,1,1,3,0,1,0,3,0,2,1,12
6814,780268,3,0,0,0,0,0,0,2,2,0,0,0,1,0,0,0,2
6814,775910,20,2,6,2,5,0,1,1,2,4,2,2,3,3,1,0,5
6814,797561,9,0,0,0,0,0,0,0,0,0,1,1,2,0,0,0,0
6814,780020,18,5,7,5,7,0,0,1,3,0,1,0,1,0,2,0,11
6814,793065,1,0,0,0,0,0,0,0,0,0,0,0,0,0,0,0,0
6814,786457,1,0,0,0,0,0,0,0,0,0,0,0,0,0,0,0,0
6815,774806,22,4,9,4,9,0,0,5,6,2,2,1,3,0,2,2,13
6815,775823,26,4,7,2,5,2,2,4,5,1,3,0,2,1,3,0,14
6815,791041,36,0,4,0,1,0,3,4,4,0,0,0,3,0,2,0,4
6815,791038,30,0,6,0,4,0,2,1,2,0,5,1,1,2,1,0,1
6815,789023,36,9,14,6,10,3,4,1,1,0,0,5,4,0,6,0,22
6815,796716,3,0,0,0,0,0,0,3,4,0,1,0,0,0,1,0,3
6815,796714,18,1,1,1,1,0,0,2,2,0,2,0,1,0,0,0,4
6815,796712,3,0,0,0,0,0,0,0,0,0,1,0,1,0,0,0,0
6815,796711,3,1,1,1,1,0,0,0,0,0,0,0,0,0,0,0,2
6815,791346,3,2,2,2,2,0,0,0,1,1,0,0,0,0,1,0,4
6815,775205,20,1,3,0,2,1,1,0,0,0,0,0,3,1,1,0,3
6816,791868,12,2,3,2,3,0,0,1,2,0,0,0,0,1,0,0,5
6816,797808,17,4,10,4,10,0,0,0,0,2,2,3,2,5,0,0,8
6816,797809,21,6,7,6,7,0,0,3,5,3,2,2,2,3,4,1,15
6816,797807,12,0,2,0,0,0,2,0,0,0,1,2,0,2,0,0,0
6816,786058,36,3,6,3,6,0,0,2,2,0,4,4,2,2,0,0,8
6816,797812,34,10,15,10,14,0,1,0,2,4,4,1,1,2,2,0,20
6816,797804,4,0,1,0,0,0,1,0,0,0,0,0,0,0,0,0,0
6816,797810,5,1,2,1,1,0,1,0,0,0,1,1,0,0,0,0,2
6816,797798,9,3,4,3,4,0,0,1,2,4,0,1,0,2,1,0,7
6816,797811,13,2,6,2,6,0,0,3,7,2,3,2,1,2,0,1,7
6816,792264,18,5,10,4,8,1,2,4,6,4,4,7,2,8,2,0,15
6816,781113,19,5,8,5,7,0,1,0,0,3,1,3,1,1,0,0,10
6818,796444,33,4,6,4,6,0,0,1,2,3,6,3,3,0,1,4,9
6818,790893,31,2,4,2,3,0,1,1,2,4,7,2,1,0,2,0,5
6818,786615,20,1,4,1,2,0,2,0,0,0,2,2,1,3,2,0,2
6818,786732,15,1,5,1,3,0,2,0,0,1,1,1,2,0,2,0,2
6818,775260,30,6,16,3,8,3,8,1,2,1,1,1,1,0,1,0,16
6818,790889,18,0,3,0,1,0,2,4,6,1,2,2,1,0,1,0,4
6818,775536,16,1,2,1,2,0,0,4,4,3,4,1,4,0,1,1,6
6818,790890,24,7,12,2,5,5,7,0,0,0,2,2,0,0,1,0,19
6818,780702,13,1,4,0,0,1,4,0,0,0,1,1,0,0,0,0,3
6819,785478,12,0,1,0,1,0,0,0,0,1,0,0,0,0,0,1,0
6819,790925,29,3,8,3,6,0,2,1,1,4,2,1,1,1,1,0,7
6819,791456,36,6,21,6,16,0,5,1,1,3,10,4,0,1,3,0,13
6819,785476,32,3,10,2,5,1,5,0,0,0,1,4,2,0,1,0,7
6819,785474,22,1,6,1,4,0,2,1,4,0,0,1,3,2,0,0,3
6819,785480,9,0,2,0,1,0,1,0,0,0,2,1,2,0,0,0,0
6819,796470,15,1,4,0,3,1,1,0,0,2,1,0,2,0,0,0,3
6819,790926,18,3,5,2,2,1,3,0,0,0,0,0,1,0,0,0,7
6819,800121,27,4,5,4,5,0,0,0,2,1,4,0,1,1,4,2,8
6820,780256,33,3,5,2,4,1,1,4,7,2,6,1,1,1,1,0,11
6820,785874,16,1,5,1,4,0,1,0,0,2,1,0,5,0,1,1,2
6820,796883,19,1,4,1,1,0,3,1,1,0,2,7,2,2,0,0,3
6820,791757,25,4,7,2,4,2,3,0,0,0,0,1,3,0,1,0,10
6820,791334,33,7,8,3,4,4,4,0,0,0,3,1,1,1,2,0,18
6820,791760,18,8,10,7,9,1,1,3,3,2,3,0,4,0,1,0,20
6820,785876,2,0,0,0,0,0,0,0,0,0,1,0,1,0,0,0,0
6820,796879,19,3,5,3,5,0,0,0,0,0,3,2,1,0,2,0,6
6820,796885,2,0,1,0,1,0,0,0,0,0,1,0,0,0,1,0,0
6820,796880,22,3,8,3,5,0,3,0,0,0,1,1,2,0,2,0,6
6820,781590,11,2,5,1,3,1,2,0,0,1,2,1,0,0,1,1,5
6821,791042,27,7,10,7,10,0,0,4,6,4,1,0,4,0,1,0,18
6821,774834,14,0,0,0,0,0,0,0,0,0,2,0,5,0,1,0,0
6821,791043,35,6,15,6,13,0,2,4,5,2,3,0,0,1,0,1,16
6821,776374,31,3,8,2,6,1,2,0,0,0,2,4,1,1,3,0,7
6821,775412,30,1,4,0,0,1,4,2,2,0,3,2,2,0,1,0,5
6821,796723,19,4,4,4,4,0,0,4,4,0,1,0,0,3,2,0,12
6821,796719,8,1,2,1,1,0,1,0,0,2,2,0,0,0,0,0,2
6821,785512,11,1,5,1,5,0,0,0,0,0,0,0,3,0,1,0,2
6821,796718,3,0,1,0,1,0,0,0,3,0,0,0,0,0,0,0,0
6821,796717,17,0,5,0,4,0,1,2,3,0,3,1,2,1,0,0,2
6821,796720,4,0,1,0,1,0,0,0,0,0,0,0,0,0,1,0,0
6821,796722,1,0,0,0,0,0,0,0,0,0,0,0,0,0,0,0,0
6838,791548,34,6,16,3,9,3,7,6,6,0,10,3,1,0,1,2,21
6838,791550,16,2,4,2,4,0,0,0,0,2,3,1,0,0,1,1,4
6838,786368,18,3,5,2,2,1,3,0,0,0,1,2,2,0,1,0,7
6838,786364,35,2,9,2,7,0,2,2,2,0,1,3,2,1,1,0,6
6838,780330,28,2,6,2,5,0,1,2,2,2,4,1,1,2,1,0,6
6838,797082,24,5,7,5,6,0,1,3,3,3,9,0,3,0,2,1,13
6838,780332,7,0,1,0,1,0,0,0,0,0,0,0,1,0,0,0,0
6838,797080,3,0,0,0,0,0,0,0,0,0,0,0,1,0,1,0,0
6838,786365,18,3,5,1,1,2,4,1,2,0,0,2,1,2,2,0,9
6838,780329,17,3,6,2,5,1,1,2,2,0,3,1,2,0,1,0,9
6839,798342,28,2,9,1,7,1,2,2,2,2,0,2,3,1,2,0,7
6839,791465,21,5,9,5,9,0,0,2,4,2,1,4,3,0,4,0,12
6839,791464,16,1,2,1,2,0,0,2,2,0,2,0,2,0,1,0,4
6839,786304,36,2,6,0,3,2,3,1,2,0,4,4,2,1,1,0,7
6839,780197,36,4,12,3,6,1,6,3,3,0,4,2,2,1,2,0,12
6839,786303,17,1,1,1,1,0,0,0,0,0,3,0,2,0,0,1,2
6839,780200,9,0,3,0,3,0,0,0,0,0,1,1,1,0,0,0,0
6839,780196,33,7,18,4,10,3,8,1,2,0,4,2,1,4,1,0,18
6839,780616,4,0,0,0,0,0,0,0,0,0,0,0,0,0,0,0,0
6840,792271,28,2,5,2,4,0,1,6,8,3,6,2,2,3,2,0,10
6840,791686,17,2,6,2,5,0,1,4,5,1,3,0,3,0,2,0,8
6840,798028,31,2,6,1,4,1,2,4,5,1,2,2,3,2,2,1,9
6840,790940,34,5,11,4,6,1,5,4,6,1,4,0,2,0,4,0,15
6840,780770,38,6,14,5,13,1,1,0,0,0,2,4,2,3,4,0,13
6840,786060,8,0,3,0,2,0,1,0,0,0,0,1,1,0,1,0,0
6840,792270,20,2,4,2,3,0,1,0,0,3,3,0,2,3,1,2,4
6840,792269,23,1,1,1,1,0,0,0,0,0,2,1,0,0,0,1,2
6840,798022,1,0,0,0,0,0,0,0,0,0,0,0,0,0,0,0,0
6841,781107,16,2,5,2,5,0,0,2,3,2,2,1,5,0,1,0,6
6841,791972,28,2,6,1,3,1,3,0,0,1,3,2,1,0,2,0,5
6841,796777,14,0,1,0,1,0,0,0,0,0,0,1,0,2,2,0,0
6841,785366,36,3,11,1,6,2,5,4,4,1,6,4,1,1,3,0,12
6841,780863,28,9,21,8,18,1,3,1,2,3,0,1,2,2,0,1,20
6841,791973,6,0,0,0,0,0,0,0,0,0,0,0,1,1,1,0,0
6841,796778,25,6,9,6,9,0,0,1,3,5,4,3,2,2,4,1,13
6841,796780,19,1,4,0,1,1,3,0,1,1,2,2,4,1,1,0,3
6841,791974,24,2,4,1,2,1,2,0,0,0,1,1,1,2,1,0,5
6841,780873,4,0,0,0,0,0,0,0,0,0,0,1,1,0,1,0,0
6842,775820,26,1,3,0,2,1,1,0,0,0,6,1,4,2,0,3,3
6842,775538,31,0,1,0,1,0,0,0,0,1,4,0,1,0,0,1,0
6842,791110,25,3,7,3,6,0,1,3,3,2,1,3,3,0,5,0,9
6842,785603,32,7,13,4,8,3,5,0,0,1,6,1,1,0,2,0,17
6842,776425,35,5,8,2,4,3,4,0,0,0,1,3,0,1,2,1,13
6842,791107,8,0,2,0,2,0,0,1,2,0,3,0,2,0,1,0,1
6842,791106,15,4,6,3,5,1,1,0,0,1,1,0,2,1,2,0,9
6842,786494,28,4,6,4,5,0,1,6,6,0,6,1,3,1,2,0,14
6843,792261,39,4,11,4,11,0,0,3,4,6,4,0,4,0,1,3,11
6843,792258,27,1,5,0,0,1,5,1,2,0,0,3,3,1,1,0,4
6843,786122,33,4,13,3,7,1,6,4,4,0,3,0,0,2,0,0,13
6843,786331,27,3,8,3,8,0,0,0,1,1,3,0,4,2,1,0,6
6843,776284,31,5,16,5,12,0,4,2,2,2,2,2,0,1,1,0,12
6843,797980,5,0,0,0,0,0,0,2,2,0,0,0,2,0,1,0,2
6843,797982,6,0,1,0,0,0,1,0,0,0,0,0,1,1,0,0,0
6843,786113,10,0,3,0,3,0,0,2,2,2,0,2,1,1,0,0,2
6843,780308,22,1,2,0,0,1,2,0,2,1,2,2,0,1,2,0,3
6844,792373,24,5,7,5,7,0,0,5,6,0,1,0,3,0,0,3,15
6844,792370,35,1,6,1,5,0,1,7,9,1,13,1,4,0,4,1,9
6844,797951,36,4,14,3,7,1,7,2,2,0,5,2,2,3,3,1,11
6844,786739,27,3,7,3,6,0,1,2,3,2,3,4,1,2,1,0,8
6844,775303,40,3,4,2,2,1,2,2,3,0,9,2,1,2,1,1,9
6844,797958,15,4,7,3,5,1,2,2,2,0,0,0,0,0,0,0,11
6844,776491,13,2,4,2,4,0,0,2,2,0,1,4,1,3,0,0,6
6844,790499,5,0,1,0,0,0,1,0,0,0,2,0,1,0,1,1,0
6844,781598,5,1,1,0,0,1,1,2,2,0,0,0,0,0,0,0,5
6845,785863,35,6,8,6,8,0,0,0,1,4,6,2,4,1,4,2,12
6845,785631,15,1,6,0,3,1,3,0,0,0,1,0,5,0,0,0,3
6845,786248,20,2,4,2,4,0,0,1,1,0,7,2,1,0,2,0,5
6845,785630,31,2,11,1,6,1,5,0,0,0,1,2,1,2,2,0,5
6845,780777,28,8,17,8,15,0,2,3,5,1,4,4,5,0,3,0,19
6845,785632,23,1,3,1,3,0,0,2,4,0,5,0,0,1,1,1,4
6845,791200,29,3,12,3,9,0,3,3,4,1,2,0,4,1,1,0,9
6845,791198,8,0,1,0,0,0,1,0,0,0,0,0,1,0,0,0,0
6845,791197,2,0,0,0,0,0,0,0,2,1,0,0,0,0,1,0,0
6845,791199,8,0,0,0,0,0,0,0,0,0,1,0,0,0,0,1,0
6845,791196,1,0,1,0,0,0,1,0,0,0,0,0,0,0,0,0,0
6846,775897,37,3,5,3,5,0,0,8,10,2,9,2,1,1,3,0,14
6846,780324,31,6,8,6,8,0,0,5,7,2,4,6,1,2,5,0,17
6846,791543,26,4,7,3,6,1,1,2,3,0,1,0,5,0,0,0,11
6846,786530,37,6,9,4,6,2,3,5,8,0,2,0,2,0,2,0,19
6846,780317,32,1,6,1,3,0,3,2,2,0,4,3,2,3,0,0,4
6846,791546,7,0,0,0,0,0,0,0,0,0,0,1,0,0,0,0,0
6846,797091,16,2,2,2,2,0,0,0,0,0,1,0,1,0,2,0,4
6846,786360,4,0,0,0,0,0,0,0,0,0,0,1,0,1,1,0,0
6846,784246,10,0,1,0,1,0,0,0,0,0,2,1,1,0,2,0,0
6847,781249,17,0,3,0,2,0,1,0,0,0,4,4,4,1,3,0,0
6847,775165,35,1,2,1,1,0,1,0,0,0,1,0,2,2,0,1,2
6847,785514,30,8,11,8,8,0,3,0,0,0,3,3,4,1,0,0,16
6847,785515,36,5,13,3,10,2,3,5,5,1,1,3,4,2,4,0,17
6847,781253,37,5,11,1,6,4,5,0,0,1,1,0,2,1,0,0,14
6847,796953,22,0,4,0,1,0,3,2,2,0,3,1,3,0,2,1,2
6847,796951,8,1,2,0,0,1,2,0,0,0,1,0,2,0,0,0,3
6847,791687,15,1,4,1,1,0,3,2,2,0,2,0,0,2,2,0,4
6848,791838,15,1,3,0,0,1,3,0,2,2,0,1,0,0,0,0,3
6848,786620,34,3,10,0,2,3,8,5,6,0,3,4,2,2,3,0,14
6848,781606,25,1,6,1,4,0,2,0,0,0,1,1,2,0,2,0,2
6848,781263,22,2,7,2,5,0,2,1,2,0,4,1,1,2,1,0,5
6848,781257,35,7,13,6,10,1,3,3,5,0,2,1,1,1,3,0,18
6848,796956,2,1,1,1,1,0,0,1,2,0,0,0,0,0,0,0,3
6848,796955,16,1,3,1,3,0,0,2,4,4,6,0,3,0,3,0,4
6848,791256,2,0,0,0,0,0,0,0,0,0,0,0,0,0,0,0,0
6848,791255,19,2,3,1,2,1,1,1,2,2,0,1,2,1,1,0,6
6848,791257,17,3,4,3,4,0,0,0,0,3,4,0,2,0,1,0,6
6848,780900,12,0,3,0,2,0,1,2,4,4,0,1,0,0,2,0,2
6848,796029,1,0,0,0,0,0,0,0,0,0,0,0,0,0,0,0,0
6849,780377,34,7,11,2,4,5,7,1,1,0,4,0,3,1,0,1,20
6849,791852,30,5,5,5,5,0,0,1,2,1,1,1,1,0,0,1,11
6849,797460,27,2,9,1,4,1,5,0,0,0,4,2,4,2,2,0,5
6849,786601,20,1,5,0,2,1,3,0,0,0,1,1,1,0,2,0,3
6849,786600,14,2,4,2,3,0,1,0,0,1,3,1,4,1,1,1,4
6849,791851,18,1,3,1,1,0,2,1,2,1,4,2,0,0,5,0,3
6849,791853,10,2,3,2,3,0,0,0,0,1,0,0,1,0,0,0,4
6849,797461,29,8,10,6,8,2,2,2,5,0,4,10,4,1,3,0,20
6849,796247,1,0,0,0,0,0,0,0,0,0,0,0,0,0,0,0,0
6849,786604,1,0,0,0,0,0,0,0,0,0,0,0,0,0,0,0,0
6849,786599,16,3,4,1,2,2,2,0,0,1,2,0,3,1,0,0,8
6850,786029,24,5,9,5,9,0,0,1,1,1,6,0,4,0,3,0,11
6850,781398,32,5,9,3,3,2,6,0,0,1,2,0,2,0,0,2,12
6850,792114,38,6,12,2,4,4,8,4,5,0,3,5,1,1,1,0,20
6850,786018,19,2,3,0,1,2,2,4,4,2,1,0,4,0,0,0,10
6850,775678,29,2,7,2,5,0,2,2,2,0,3,2,1,0,2,0,6
6850,797746,16,0,2,0,1,0,1,2,2,2,3,0,0,1,1,0,2
6850,792112,5,0,1,0,1,0,0,0,0,0,1,0,0,0,0,0,0
6850,797745,1,0,0,0,0,0,0,0,0,0,0,0,1,0,0,0,0
6850,797740,25,2,9,1,7,1,2,2,4,0,2,1,1,1,1,0,7
6850,797737,11,1,3,1,3,0,0,0,0,0,2,0,0,0,1,0,2
6851,785930,23,5,11,5,11,0,0,1,2,2,4,0,2,0,0,1,11
6851,780996,25,3,6,2,3,1,3,0,0,1,4,0,2,0,1,1,7
6851,780995,27,2,4,1,2,1,2,1,2,1,3,3,3,0,3,0,6
6851,796468,35,5,9,4,7,1,2,0,0,2,3,3,0,2,1,1,11
6851,790920,32,5,14,5,11,0,3,12,12,4,3,3,1,1,0,0,22
6851,796466,7,2,3,2,3,0,0,0,1,1,0,0,0,0,0,0,4
6851,796467,7,0,1,0,0,0,1,0,0,0,1,0,0,0,0,0,0
6851,791035,25,2,14,2,8,0,6,0,0,2,2,2,2,0,3,0,4
6851,775709,19,1,3,1,1,0,2,0,0,0,1,2,1,1,0,1,2
6852,791011,24,5,8,1,2,4,6,0,0,0,8,0,0,2,1,0,14
6852,780303,31,2,10,2,8,0,2,3,4,2,4,1,2,0,1,1,7
6852,786349,26,2,5,2,2,0,3,0,0,2,2,4,1,2,2,0,4
6852,781221,26,3,8,2,4,1,4,0,0,0,2,3,3,0,0,0,7
6852,781385,26,3,8,2,4,1,4,0,0,0,0,5,0,1,2,0,7
6852,796671,7,2,2,2,2,0,0,0,0,0,1,0,0,0,0,1,4
6852,785337,28,5,7,5,6,0,1,7,8,1,4,1,2,1,2,0,17
6852,796668,4,0,1,0,1,0,0,0,0,0,0,0,0,0,0,0,0
6852,791013,2,0,1,0,1,0,0,0,0,0,0,0,0,0,0,0,0
6852,791012,26,3,5,1,1,2,4,0,0,0,0,0,1,2,2,0,8
6853,784640,21,5,9,5,7,0,2,0,0,1,5,0,3,0,3,0,10
6853,797655,30,3,6,3,6,0,0,3,4,4,5,3,2,0,1,0,9
6853,797657,36,4,12,1,3,3,9,0,0,0,3,0,1,0,0,0,11
6853,792072,38,5,11,1,1,4,10,0,0,2,0,4,0,2,2,0,14
6853,792069,37,2,9,0,2,2,7,1,2,0,5,4,1,2,4,0,7
6853,786025,5,2,2,2,2,0,0,0,0,0,0,0,0,0,0,0,4
6853,797652,11,1,1,1,1,0,0,0,0,1,2,3,0,1,0,0,2
6853,785572,22,5,7,3,4,2,3,0,0,0,2,4,3,1,2,0,12
6854,797523,26,3,7,2,2,1,5,0,0,0,2,1,4,0,1,0,7
6854,785402,24,4,8,4,8,0,0,2,4,3,7,1,4,0,1,1,10
6854,797524,21,2,4,1,3,1,1,0,0,0,4,1,5,1,2,0,5
6854,792118,38,9,18,6,12,3,6,8,8,0,6,8,1,2,3,0,29
6854,782593,29,8,16,7,12,1,4,0,0,0,5,0,3,1,3,0,17
6854,785828,12,2,3,2,3,0,0,0,0,0,2,0,4,0,1,1,4
6854,791699,14,0,2,0,0,0,2,0,2,1,5,1,3,1,3,1,0
6854,791702,5,0,0,0,0,0,0,0,0,0,0,1,1,0,0,0,0
6854,797525,1,0,0,0,0,0,0,0,0,0,0,0,0,0,0,0,0
6854,797526,1,0,0,0,0,0,0,0,0,0,0,0,0,0,0,0,0
6854,792663,1,0,0,0,0,0,0,0,0,0,0,0,0,0,0,0,0
6854,791700,28,0,2,0,1,0,1,1,2,0,2,1,1,0,2,1,1
6855,781174,28,4,8,4,8,0,0,4,4,3,5,0,4,0,3,2,12
6855,781159,24,1,6,0,3,1,3,2,4,1,4,2,3,2,0,0,5
6855,791001,29,1,6,0,3,1,3,2,2,0,0,5,2,1,0,0,5
6855,781215,23,1,4,1,3,0,1,2,3,0,2,2,3,2,5,0,4
6855,775255,33,5,10,2,4,3,6,4,6,0,3,1,0,1,3,0,17
6855,796643,0,0,0,0,0,0,0,0,0,0,0,0,1,0,0,0,0
6855,785320,20,1,7,0,2,1,5,0,0,1,2,1,2,1,0,0,3
6855,785231,18,0,1,0,1,0,0,3,4,0,5,0,3,0,1,0,3
6855,779972,25,5,10,4,7,1,3,2,4,0,5,2,3,1,2,0,13
6872,791401,34,7,12,7,12,0,0,3,7,3,9,1,2,0,2,1,17
6872,780125,30,5,10,5,10,0,0,5,7,3,3,0,3,1,1,4,15
6872,791400,23,2,10,2,6,0,4,0,0,3,3,5,4,0,1,0,4
6872,785931,22,1,8,0,4,1,4,0,0,0,4,3,2,2,1,0,3
6872,780118,33,1,8,0,5,1,3,6,7,1,1,1,3,1,0,0,9
6872,797132,15,2,3,0,0,2,3,0,0,1,3,1,0,3,1,0,6
6872,797126,16,3,5,3,4,0,1,0,1,0,2,1,3,0,0,0,6
6872,797130,15,1,6,0,0,1,6,0,0,0,0,3,1,1,2,0,3
6872,797125,12,1,2,0,0,1,2,1,2,1,2,0,1,0,1,0,4
6873,797175,16,2,3,1,1,1,2,5,5,2,4,0,5,2,1,1,10
6873,780027,27,6,14,6,14,0,0,6,8,0,2,0,2,0,2,1,18
6873,786176,38,7,12,4,5,3,7,1,1,0,8,0,3,2,2,1,18
6873,780028,24,1,1,0,0,1,1,0,0,0,2,1,4,0,0,0,3
6873,774828,34,3,9,0,2,3,7,2,2,0,7,2,2,0,1,0,11
6873,780029,25,0,5,0,3,0,2,2,2,3,4,1,1,1,1,2,2
6873,791379,11,0,5,0,3,0,2,0,0,0,1,1,2,0,0,0,0
6873,791380,4,0,1,0,1,0,0,0,0,0,0,0,0,0,2,0,0
6873,797178,15,0,0,0,0,0,0,3,4,1,1,0,1,0,1,0,3
6873,797179,6,0,1,0,1,0,0,0,0,0,1,0,0,0,0,0,0
6873,780026,0,0,0,0,0,0,0,0,0,0,0,0,0,0,0,0,0
6874,792171,35,6,16,3,10,3,6,2,2,2,3,0,3,1,2,8,17
6874,780049,25,2,8,2,7,0,1,0,0,3,2,2,3,0,1,1,4
6874,780527,13,2,5,1,2,1,3,4,4,3,3,0,3,0,0,0,9
6874,797784,35,5,10,3,5,2,5,5,6,1,4,2,2,0,3,0,17
6874,789059,27,5,12,4,8,1,4,0,1,2,5,2,3,0,2,0,11
6874,797783,13,0,0,0,0,0,0,0,0,0,2,1,1,0,2,0,0
6874,792174,8,0,2,0,1,0,1,1,2,0,0,0,2,0,0,0,1
6874,792173,26,1,7,0,0,1,7,3,4,3,1,1,1,0,2,1,6
6874,780980,18,0,2,0,1,0,1,0,0,0,3,3,0,4,0,0,0
6875,781158,20,2,4,2,4,0,0,0,1,1,1,1,3,2,1,0,4
6875,781652,35,6,15,4,10,2,5,2,3,4,11,3,2,3,2,1,16
6875,786034,35,3,7,1,4,2,3,1,1,0,5,0,0,0,1,1,9
6875,786419,33,7,16,4,11,3,5,6,9,3,3,3,3,2,2,0,23
6875,781283,26,4,7,2,2,2,5,4,6,0,2,2,4,1,0,0,14
6875,791614,3,0,1,0,0,0,1,0,0,0,0,0,0,0,0,0,0
6875,781653,19,1,1,1,1,0,0,0,1,1,3,0,2,0,2,1,2
6875,791615,21,1,4,0,1,1,3,0,0,2,1,4,0,2,4,0,3
6875,785277,8,0,1,0,0,0,1,0,0,0,1,0,0,0,1,0,0
6876,791344,24,7,8,6,6,1,2,0,1,0,1,1,4,0,1,1,15
6876,781425,32,5,9,5,9,0,0,6,7,5,11,1,1,0,1,0,16
6876,791343,37,4,10,3,9,1,1,2,2,0,5,8,0,4,3,0,11
6876,781602,31,1,11,0,6,1,5,2,2,0,1,2,2,0,2,0,5
6876,775746,27,6,8,4,5,2,3,3,3,2,1,1,2,0,1,1,17
6876,781601,8,1,1,1,1,0,0,0,0,1,0,0,3,0,0,1,2
6876,797001,22,4,8,2,5,2,3,0,0,0,4,1,0,0,1,0,10
6876,797000,14,1,3,0,1,1,2,0,0,0,1,0,2,0,1,0,3
6876,796998,5,0,2,0,1,0,1,0,0,0,0,0,0,0,0,0,0
6877,791201,26,6,7,6,7,0,0,6,6,1,3,3,0,0,1,1,18
6877,775767,34,7,13,7,13,0,0,2,4,2,11,1,3,1,2,0,16
6877,796902,27,6,8,2,3,4,5,0,0,0,0,5,1,0,0,0,16
6877,785628,39,6,14,5,9,1,5,1,2,0,3,6,2,0,1,0,14
6877,785627,13,0,1,0,0,0,1,1,2,0,1,0,3,0,2,0,1
6877,796904,3,0,0,0,0,0,0,0,0,0,0,0,0,0,1,1,0
6877,781135,3,0,0,0,0,0,0,0,2,1,3,0,2,0,0,0,0
6877,796903,15,0,2,0,1,0,1,0,0,0,0,1,2,1,0,0,0
6877,796901,14,4,9,3,6,1,3,0,1,0,1,0,1,0,0,0,9
6877,785629,26,0,1,0,0,0,1,0,0,0,0,4,2,1,1,0,0
6878,776285,27,3,6,3,6,0,0,0,0,3,1,2,4,1,0,2,6
6878,791780,13,0,2,0,1,0,1,0,0,0,1,0,4,1,0,0,0
6878,791777,38,11,20,10,17,1,3,8,8,3,5,7,2,2,3,0,31
6878,781025,26,3,8,3,7,0,1,0,0,0,3,1,2,0,0,0,6
6878,786474,30,5,16,5,9,0,7,0,0,4,6,0,2,2,5,0,10
6878,791781,8,0,1,0,1,0,0,0,0,0,0,0,1,0,1,0,0
6878,786476,5,1,1,1,1,0,0,2,2,2,1,0,0,0,0,0,4
6878,791783,6,1,2,1,2,0,0,0,0,0,0,1,1,0,0,0,2
6878,791829,20,4,8,1,3,3,5,3,3,0,5,1,2,0,2,0,14
6878,780488,6,1,2,0,0,1,2,0,0,0,1,1,1,0,0,0,3
6878,775503,21,2,5,1,1,1,4,3,6,1,5,0,4,1,1,1,8
6878,797612,0,0,0,0,0,0,0,0,0,0,0,0,0,0,0,0,0
6879,786690,21,1,2,0,1,1,1,0,0,0,7,0,2,0,3,4,3
6879,780629,33,5,9,3,5,2,4,5,11,0,4,1,2,0,4,0,17
6879,796816,34,5,9,4,6,1,3,8,10,1,3,0,2,3,4,0,19
6879,774845,40,5,10,2,4,3,6,5,5,0,2,7,1,3,3,0,18
6879,775888,38,3,8,1,3,2,5,4,8,0,6,4,1,0,5,0,12
6879,791161,17,1,2,0,1,1,1,0,0,0,2,0,2,1,1,0,3
6879,791159,6,0,2,0,0,0,2,0,0,0,0,0,1,0,0,0,0
6879,785346,11,0,1,0,0,0,1,0,0,0,2,0,4,0,0,0,0
6880,780023,26,2,5,2,5,0,0,3,4,2,2,1,4,0,2,3,7
6880,792493,31,4,6,0,0,4,6,0,0,0,1,1,0,2,1,0,12
6880,792495,39,7,14,4,5,3,9,4,8,0,5,3,2,2,8,1,21
6880,792491,37,1,6,1,6,0,0,6,10,0,4,5,3,0,3,2,8
6880,781144,21,2,6,1,2,1,4,1,1,0,0,0,5,0,0,0,6
6880,798960,0,0,0,0,0,0,0,0,0,0,1,0,0,0,0,0,0
6880,798959,4,0,0,0,0,0,0,0,0,0,1,0,3,0,0,0,0
6880,792490,21,1,6,1,4,0,2,0,0,0,6,0,2,0,0,4,2
6880,788128,12,1,2,1,1,0,1,0,0,0,1,0,1,0,0,0,2
6880,786832,8,0,3,0,1,0,2,0,0,0,1,2,4,0,0,0,0
6880,798957,1,0,0,0,0,0,0,0,0,0,0,0,0,0,0,0,0
6881,797877,29,6,13,6,12,0,1,2,4,3,5,0,3,0,0,1,14
6881,797873,18,2,5,2,5,0,0,1,4,3,1,0,3,0,1,1,5
6881,797872,25,2,8,1,4,1,4,10,10,4,1,2,4,1,0,0,15
6881,791338,26,1,3,1,3,0,0,5,5,2,7,6,4,3,3,0,7
6881,791339,38,7,22,5,13,2,9,8,10,2,6,2,1,0,1,0,24
6881,791337,18,1,4,1,4,0,0,0,0,3,5,0,3,0,1,0,2
6881,785881,4,0,1,0,0,0,1,0,0,0,1,1,1,0,1,0,0
6881,781599,14,0,5,0,5,0,0,0,0,4,2,0,1,0,1,0,0
6881,797875,2,0,1,0,1,0,0,0,0,1,0,0,0,0,1,0,0
6881,797874,1,0,0,0,0,0,0,1,2,0,0,0,0,0,0,0,1
6881,781595,25,1,6,1,2,0,4,2,2,2,4,1,0,2,1,0,4
6882,791981,38,5,13,5,10,0,3,4,4,2,4,5,2,1,2,1,14
6882,780342,32,10,17,4,10,6,7,6,6,2,4,5,3,3,3,0,32
6882,791982,36,3,9,2,5,1,4,3,4,0,5,4,3,0,1,1,10
6882,780333,33,4,7,2,2,2,5,2,2,2,1,5,2,0,2,0,12
6882,781493,29,2,4,0,1,2,3,2,2,0,0,1,2,0,2,0,8
6882,791984,3,1,1,1,1,0,0,0,0,0,0,0,0,0,0,0,2
6882,786756,24,2,3,0,0,2,3,0,0,3,1,1,0,2,0,0,6
6882,786755,5,0,1,0,0,0,1,0,0,0,0,0,0,0,0,0,0
6883,786857,25,4,7,2,4,2,3,2,4,2,1,2,5,1,2,0,12
6883,781403,36,4,8,4,7,0,1,4,4,3,5,3,2,0,2,1,12
6883,792654,28,8,11,8,11,0,0,1,2,2,5,0,2,1,3,1,17
6883,797301,37,3,6,2,3,1,3,0,0,0,1,4,2,1,1,0,7
6883,781400,39,7,20,3,7,4,13,0,0,1,3,5,3,1,2,1,18
6883,797302,5,0,0,0,0,0,0,0,0,0,2,0,0,0,0,0,0
6883,797306,3,0,0,0,0,0,0,0,0,0,0,0,0,0,1,0,0
6883,792653,5,0,2,0,2,0,0,0,0,1,1,0,1,0,0,0,0
6883,780524,22,3,3,3,3,0,0,2,2,0,0,1,1,0,2,0,8
6883,797303,0,0,0,0,0,0,0,0,0,0,0,0,0,0,0,0,0
6884,785911,15,1,3,1,1,0,2,0,0,1,2,0,1,0,0,2,2
6884,797105,34,2,4,2,3,0,1,2,2,3,3,0,2,1,0,1,6
6884,797100,26,2,4,1,1,1,3,0,0,0,2,3,0,2,1,0,5
6884,791413,30,4,17,3,13,1,4,0,0,1,3,2,2,0,2,0,9
6884,791411,33,7,18,3,11,4,7,0,0,0,2,2,0,1,2,0,18
6884,797103,25,2,3,2,3,0,0,1,2,6,9,2,3,0,0,1,5
6884,791414,6,1,1,0,0,1,1,0,0,0,1,0,0,0,0,1,3
6884,785776,24,4,11,1,3,3,8,3,3,0,2,2,2,1,3,0,14
6884,781209,7,0,2,0,1,0,1,0,0,0,1,0,0,0,0,0,0
6885,790870,27,7,14,7,14,0,0,2,2,4,2,2,4,1,1,1,16
6885,790869,40,8,23,5,13,3,10,5,6,1,7,7,3,1,2,0,24
6885,780116,25,3,3,2,2,1,1,0,0,2,3,0,2,1,1,0,7
6885,796421,40,2,6,0,2,2,4,0,0,1,4,7,1,0,0,0,6
6885,790866,38,4,10,2,3,2,7,0,0,0,7,2,1,0,2,0,10
6885,780493,26,3,7,0,0,3,7,0,0,0,4,1,0,0,0,0,9
6885,796426,4,0,0,0,0,0,0,0,0,0,0,0,0,0,0,0,0
6886,791905,40,8,18,3,9,5,9,4,5,2,11,3,2,2,3,2,25
6886,781103,32,6,8,5,6,1,2,4,5,2,6,2,1,0,3,1,17
6886,797568,28,3,6,1,2,2,4,0,0,0,2,3,3,1,5,0,8
6886,797566,28,0,4,0,3,0,1,2,2,0,2,0,1,0,1,0,2
6886,781191,32,2,8,0,5,2,3,4,4,0,1,5,4,0,2,1,10
6886,797569,12,0,0,0,0,0,0,0,0,1,2,3,1,0,0,0,0
6886,791904,8,1,3,1,3,0,0,1,2,3,1,0,3,0,0,0,3
6886,781102,20,2,2,1,1,1,1,0,2,2,3,0,2,0,1,0,5
6887,791391,35,2,5,2,5,0,0,1,2,3,4,3,4,3,1,1,5
6887,797156,29,5,10,2,6,3,4,1,2,1,1,2,2,3,0,0,14
6887,791390,36,5,11,5,9,0,2,4,4,6,4,4,2,2,1,1,14
6887,780133,35,3,13,0,5,3,8,0,0,0,2,3,2,1,0,0,9
6887,780130,36,6,18,4,13,2,5,4,5,3,4,2,1,1,1,0,18
6887,791388,7,0,2,0,2,0,0,0,0,2,1,0,2,0,1,0,0
6887,775743,9,1,4,1,2,0,2,0,0,0,0,0,3,0,1,0,2
6887,780407,12,2,5,1,2,1,3,0,0,0,1,0,0,0,0,0,5
6887,797158,1,0,0,0,0,0,0,0,0,0,0,0,0,0,0,0,0
6888,792143,32,2,6,2,4,0,2,3,3,0,7,2,4,0,0,0,7
6888,786302,25,5,6,5,6,0,0,2,7,2,4,0,4,0,0,1,12
6888,786293,32,3,9,3,7,0,2,4,6,0,0,2,2,3,4,0,10
6888,780953,38,9,15,8,12,1,3,4,5,0,6,1,2,0,2,4,23
6888,797750,32,4,5,4,5,0,0,3,5,1,8,2,1,2,3,0,11
6888,786287,15,3,3,3,3,0,0,0,2,0,1,2,0,1,1,0,6
6888,797751,17,2,4,1,2,1,2,0,0,1,1,0,1,0,1,0,5
6888,797748,8,0,0,0,0,0,0,2,2,0,0,0,2,0,0,0,2
6888,792147,1,0,0,0,0,0,0,0,0,0,0,0,0,0,0,0,0
6889,791058,12,0,1,0,1,0,0,0,0,0,2,0,4,0,0,0,0
6889,785532,28,3,12,3,12,0,0,2,4,4,5,0,3,0,1,0,8
6889,791055,34,3,6,2,4,1,2,5,6,1,3,4,5,1,2,0,12
6889,785530,35,5,13,3,6,2,7,3,3,1,1,2,0,1,1,0,15
6889,775926,32,5,9,3,3,2,6,0,0,0,2,1,4,0,1,0,12
6889,791280,13,3,7,2,3,1,4,6,6,0,1,1,1,0,2,0,13
6889,791059,4,0,2,0,2,0,0,0,0,0,1,0,0,0,0,0,0
6889,775573,2,0,0,0,0,0,0,0,0,0,0,1,1,0,0,0,0
6889,780063,30,3,9,1,4,2,5,0,0,1,5,3,2,1,1,0,8
6889,796734,10,1,2,1,2,0,0,0,0,2,0,0,0,0,0,0,2
6894,792171,31,5,9,3,6,2,3,4,4,2,9,2,2,1,2,2,16
6894,780049,21,1,7,1,7,0,0,0,0,0,3,0,0,0,1,0,2
6894,797784,37,3,11,0,4,3,7,0,0,0,3,3,2,2,2,0,9
6894,789059,29,3,6,2,4,1,2,0,0,1,3,0,1,0,2,0,7
6894,780980,26,2,7,1,3,1,4,0,0,0,0,5,2,1,2,0,5
6894,797783,11,0,1,0,0,0,1,2,2,0,1,0,2,0,0,0,2
6894,792174,6,0,1,0,0,0,1,0,0,0,0,1,1,0,1,0,0
6894,792173,12,0,2,0,0,0,2,0,0,0,0,0,2,0,0,0,0
6894,780527,27,2,6,1,1,1,5,2,2,0,2,1,1,1,0,0,7
6895,781158,25,1,4,1,4,0,0,0,0,4,7,4,1,1,2,0,2
6895,781652,40,4,11,3,5,1,6,4,5,2,5,2,2,0,3,0,13
6895,786034,34,5,8,2,3,3,5,0,0,1,0,0,0,0,0,0,13
6895,786419,35,5,9,5,7,0,2,1,2,0,7,3,2,1,1,0,11
6895,781283,28,5,11,1,5,4,6,0,0,0,1,0,1,1,1,0,14
6895,781653,13,0,0,0,0,0,0,2,2,0,3,1,1,1,2,0,2
6895,791615,19,2,7,1,3,1,4,0,0,1,2,3,1,0,1,0,5
6895,785277,6,0,1,0,1,0,0,0,0,0,2,0,1,0,2,0,0
6896,791257,21,4,4,4,4,0,0,4,4,3,3,1,4,1,1,0,12
6896,791838,22,1,3,1,1,0,2,0,0,1,1,3,4,2,1,0,2
6896,786620,34,3,9,2,5,1,4,8,10,1,3,3,1,1,3,0,15
6896,781606,23,1,3,0,2,1,1,2,3,1,2,2,4,0,1,0,5
6896,781257,37,8,12,5,5,3,7,4,5,1,6,3,3,0,1,0,23
6896,796955,18,3,4,3,4,0,0,0,0,0,8,0,2,0,1,3,6
6896,791255,20,1,8,1,5,0,3,2,2,0,3,2,1,0,0,0,4
6896,780900,1,0,0,0,0,0,0,0,0,0,1,0,0,0,0,0,0
6896,781263,24,5,8,5,7,0,1,0,0,0,2,2,4,3,3,0,10
6897,780377,37,4,9,1,2,3,7,6,8,1,5,2,1,0,1,0,17
6897,791852,26,2,3,2,3,0,0,2,3,1,0,1,5,1,0,0,6
6897,797460,28,7,11,1,4,6,7,1,2,2,3,0,3,2,2,0,21
6897,786601,23,1,3,0,1,1,2,2,4,0,2,2,5,2,2,0,5
6897,786600,21,2,5,1,4,1,1,1,2,0,3,1,3,0,1,0,6
6897,791851,10,0,3,0,2,0,1,0,0,0,1,0,0,0,1,0,0
6897,791853,12,3,4,3,4,0,0,0,0,2,0,0,0,0,1,0,6
6897,797461,29,2,13,1,8,1,5,4,9,0,2,7,4,0,2,0,9
6897,786599,14,0,2,0,1,0,1,0,0,0,3,0,0,0,2,0,0
6898,780023,32,1,4,1,4,0,0,0,0,3,7,0,2,0,2,7,2
6898,792493,27,3,5,0,0,3,5,0,0,1,4,2,3,1,0,0,9
6898,792495,37,11,20,9,13,2,7,4,6,1,3,4,5,1,3,1,28
6898,792491,37,3,9,3,9,0,0,3,5,0,6,7,3,2,1,0,9
6898,781144,38,5,13,1,3,4,10,6,6,0,7,0,1,0,1,0,20
6898,798960,4,0,1,0,1,0,0,0,0,1,0,0,0,0,0,0,0
6898,798959,12,2,2,0,0,2,2,0,0,0,1,0,0,0,0,0,6
6898,792490,5,0,0,0,0,0,0,2,2,1,0,0,0,0,1,0,2
6898,788128,2,0,2,0,1,0,1,0,0,0,0,0,0,0,0,0,0
6898,786832,6,0,1,0,0,0,1,0,0,0,0,0,1,0,1,0,0
6899,797877,30,4,13,4,11,0,2,2,2,3,5,1,1,1,0,0,10
6899,797873,23,3,9,3,9,0,0,3,4,3,1,1,3,0,0,0,9
6899,797872,25,1,7,1,5,0,2,0,0,3,0,0,2,1,0,1,2
6899,791338,27,3,5,3,4,0,1,1,1,0,6,2,3,1,1,1,7
6899,791339,31,5,16,3,6,2,10,8,9,2,7,2,4,0,1,0,20
6899,791337,11,1,3,1,3,0,0,0,0,2,1,0,3,0,0,1,2
6899,785881,7,0,0,0,0,0,0,0,0,1,0,2,0,0,2,0,0
6899,781599,16,1,4,1,3,0,1,0,0,1,3,0,0,0,0,0,2
6899,797875,20,6,10,1,2,5,8,0,0,0,3,3,0,1,2,0,17
6899,781595,10,1,3,1,1,0,2,0,0,0,2,1,1,0,2,0,2
6899,797874,0,0,0,0,0,0,0,0,0,0,0,0,0,0,0,0,0
6900,796542,23,3,5,3,5,0,0,1,2,1,7,0,1,1,1,1,7
6900,781335,28,2,8,2,5,0,3,0,2,2,9,4,4,0,1,2,4
6900,791284,13,0,1,0,0,0,1,0,0,0,0,0,1,0,0,0,0
6900,785770,28,5,12,5,10,0,2,2,2,3,1,2,2,1,6,0,12
6900,781341,37,8,15,5,7,3,8,0,0,0,6,5,3,1,4,0,19
6900,791285,4,0,1,0,0,0,1,2,2,1,0,1,0,1,0,0,2
6900,785775,21,5,6,3,4,2,2,2,2,0,6,3,1,1,2,5,14
6900,776351,30,3,4,2,2,1,2,0,0,0,5,0,2,1,1,0,7
6900,796538,8,0,2,0,0,0,2,0,0,0,0,0,0,0,3,0,0
6900,785767,7,1,3,0,1,1,2,0,0,0,1,0,1,0,0,0,3
6900,785773,1,0,0,0,0,0,0,0,0,0,0,0,0,0,0,0,0
6901,785800,22,1,6,0,2,1,4,0,0,1,3,0,1,0,2,0,3
6901,785799,17,1,4,1,4,0,0,1,2,0,4,0,3,0,3,0,3
6901,791676,22,4,11,3,7,1,4,2,2,0,1,2,1,2,4,0,11
6901,780554,27,1,10,1,7,0,3,4,4,0,4,0,0,2,1,0,6
6901,780553,30,7,18,7,17,0,1,0,0,2,1,1,1,6,2,0,14
6901,797426,9,0,0,0,0,0,0,4,5,0,0,0,0,0,1,0,4
6901,791678,6,1,1,1,1,0,0,0,0,0,0,0,1,0,0,0,2
6901,785807,14,1,1,1,1,0,0,0,0,1,0,1,0,0,0,0,2
6901,780760,21,1,5,1,2,0,3,0,0,1,5,0,1,1,0,2,2
6901,797427,19,1,5,1,2,0,3,0,0,1,2,0,3,0,1,0,2
6901,791677,13,0,1,0,1,0,0,0,0,1,1,1,1,1,1,0,0
6902,785589,37,6,18,6,18,0,0,11,13,2,7,0,3,1,2,0,23
6902,791209,10,1,2,1,2,0,0,0,0,0,1,0,2,0,0,1,2
6902,791215,26,0,6,0,2,0,4,0,0,0,3,3,4,0,2,0,0
6902,791213,34,3,9,1,4,2,5,3,4,4,2,1,2,3,3,0,11
6902,791214,28,2,6,2,4,0,2,3,3,0,2,2,1,0,1,1,7
6902,791216,31,1,4,1,3,0,1,5,7,1,5,2,4,2,3,3,7
6902,776313,25,2,7,2,5,0,2,0,2,2,1,1,3,0,1,1,4
6902,791212,8,1,1,1,1,0,0,0,2,2,1,0,1,0,1,0,2
6902,791210,1,0,0,0,0,0,0,0,0,0,0,0,0,0,0,0,0
6903,786041,32,3,6,2,4,1,2,2,2,2,7,0,3,0,1,0,9
6903,780881,22,2,7,2,3,0,4,2,3,1,2,1,4,0,1,1,6
6903,780275,22,1,3,1,3,0,0,0,0,0,5,1,3,1,2,2,2
6903,792075,22,2,4,2,2,0,2,0,0,1,2,1,3,1,2,1,4
6903,786686,37,9,17,9,14,0,3,7,7,0,2,8,2,3,3,0,25
6903,780882,10,0,3,0,2,0,1,0,0,1,1,0,1,1,0,0,0
6903,775222,19,2,5,1,1,1,4,6,6,1,5,0,3,0,4,0,11
6903,780884,10,1,2,1,2,0,0,0,0,1,0,0,1,0,0,0,2
6903,792074,11,1,3,1,1,0,2,2,2,0,0,0,2,0,0,0,4
6903,780052,15,3,6,1,2,2,4,0,0,0,2,1,1,0,3,0,8
6904,775640,19,5,6,5,6,0,0,2,3,1,6,1,4,0,3,1,12
6904,780919,12,0,0,0,0,0,0,1,2,0,1,2,3,0,1,0,1
6904,785803,26,4,6,4,5,0,1,0,0,1,1,3,0,1,0,1,8
6904,780920,25,3,8,3,7,0,1,0,1,0,3,4,1,2,2,1,6
6904,780914,22,3,6,1,3,2,3,0,0,0,2,1,3,0,1,0,8
6904,775816,23,6,8,5,6,1,2,3,3,0,7,2,0,2,3,1,16
6904,796799,20,6,6,6,6,0,0,3,4,2,2,1,1,0,1,0,15
6904,791141,19,0,4,0,2,0,2,2,2,1,2,1,2,0,1,0,2
6904,791142,20,1,4,0,1,1,3,0,0,0,0,2,1,0,0,0,3
6904,775639,4,0,1,0,1,0,0,0,0,1,0,0,1,0,0,1,0
6904,796801,4,0,2,0,2,0,0,4,6,0,3,1,0,1,0,0,4
6904,796796,4,1,1,0,0,1,1,0,0,0,0,0,1,1,0,0,3
6904,796800,2,0,0,0,0,0,0,0,0,0,0,0,0,0,0,0,0
6905,796404,25,2,7,2,6,0,1,1,2,3,3,1,2,2,2,0,5
6905,790853,16,3,4,3,4,0,0,1,3,4,1,0,2,0,2,0,7
6905,790850,23,2,10,2,8,0,2,0,0,1,2,0,1,0,2,0,4
6905,781164,22,2,5,2,3,0,2,0,0,0,0,3,1,0,2,0,4
6905,781163,31,3,9,2,6,1,3,3,3,0,2,1,2,1,3,0,10
6905,790854,11,2,3,2,3,0,0,0,0,0,0,0,3,0,2,0,4
6905,785434,12,1,6,0,3,1,3,0,0,0,2,0,0,0,1,0,3
6905,790848,8,0,1,0,0,0,1,1,2,0,1,0,2,0,2,0,1
6905,790849,24,1,5,1,3,0,2,2,2,0,3,2,1,0,1,0,4
6905,796405,8,0,0,0,0,0,0,0,2,0,2,0,2,0,1,1,0
6905,796406,10,0,3,0,3,0,0,1,2,3,1,0,1,0,0,0,1
6905,790852,1,0,0,0,0,0,0,0,0,0,1,0,0,0,0,0,0
6905,781223,9,2,2,0,0,2,2,0,0,0,0,0,0,0,0,0,6
6906,780197,34,7,14,4,7,3,7,11,12,1,2,2,3,2,5,0,28
6906,798342,33,7,11,4,6,3,5,3,6,2,4,3,1,1,1,0,20
6906,791465,26,8,13,8,13,0,0,0,1,1,5,7,1,0,0,3,16
6906,791464,30,0,3,0,2,0,1,4,4,1,1,2,3,2,0,0,4
6906,786304,24,1,5,0,2,1,3,0,0,2,2,2,2,2,1,0,3
6906,780196,28,1,7,1,3,0,4,4,4,0,7,3,2,1,2,0,6
6906,780616,7,1,2,0,0,1,2,0,0,0,2,0,3,0,0,0,3
6906,780200,12,0,2,0,2,0,0,0,1,2,1,0,1,0,1,1,0
6906,798343,4,0,1,0,1,0,0,0,0,0,0,0,1,0,0,0,0
6906,786303,2,0,0,0,0,0,0,0,0,0,0,0,2,0,0,0,0
6907,791548,34,11,20,8,14,3,6,5,5,2,8,4,4,1,1,2,30
6907,786364,28,5,12,4,6,1,6,4,6,0,0,4,2,0,2,1,15
6907,786368,27,5,8,3,3,2,5,0,1,0,3,1,1,1,0,0,12
6907,791550,23,4,5,4,5,0,0,1,2,3,5,3,5,0,2,1,9
6907,780330,33,0,2,0,2,0,0,0,0,0,3,0,2,1,1,1,0
6907,780332,10,2,2,1,1,1,1,0,0,1,1,0,0,1,1,0,5
6907,780329,20,0,4,0,1,0,3,3,4,0,1,0,3,0,3,0,3
6907,797082,17,1,3,1,3,0,0,0,2,2,1,0,3,0,1,0,2
6907,786365,8,0,3,0,1,0,2,0,0,0,1,1,2,0,1,0,0
6907,797080,0,0,0,0,0,0,0,0,0,0,0,0,0,0,0,0,0
6908,791777,38,7,21,6,17,1,4,1,3,4,5,8,3,1,3,0,16
6908,781025,29,7,12,6,10,1,2,0,0,0,3,1,5,1,2,1,15
6908,786474,22,3,10,1,5,2,5,0,0,1,3,0,3,0,0,0,8
6908,776285,24,1,10,1,10,0,0,0,0,5,4,0,1,0,3,0,2
6908,791780,11,0,2,0,1,0,1,0,0,0,4,0,2,0,0,0,0
6908,791776,25,3,7,0,0,3,7,4,4,0,4,0,4,1,0,0,13
6908,775503,22,2,8,0,2,2,6,0,0,1,4,0,2,0,1,0,6
6908,791829,11,2,4,2,2,0,2,0,0,0,1,1,1,0,1,1,4
6908,791783,9,0,2,0,0,0,2,0,0,1,1,0,0,0,1,0,0
6908,786476,5,0,0,0,0,0,0,0,0,1,0,0,0,0,0,0,0
6908,791778,4,0,1,0,1,0,0,0,0,1,0,0,1,0,1,0,0
6909,780629,38,5,11,4,8,1,3,3,8,2,9,1,1,0,1,0,14
6909,774845,32,3,4,2,2,1,2,7,10,0,6,3,4,0,1,0,14
6909,775888,36,3,10,2,7,1,3,5,11,1,6,4,2,1,7,4,12
6909,796816,30,4,7,2,3,2,4,2,2,0,3,2,3,2,3,1,12
6909,786690,15,2,3,1,1,1,2,0,0,0,3,1,2,1,0,0,5
6909,785346,29,5,13,0,2,5,11,2,2,0,3,0,0,1,1,0,17
6909,796815,15,0,1,0,0,0,1,0,0,0,4,2,1,0,0,0,0
6909,791159,5,0,2,0,0,0,2,0,0,0,1,0,0,0,0,0,0
6910,776462,36,3,9,1,5,2,4,5,6,7,3,1,2,0,0,0,13
6910,785635,14,2,5,2,3,0,2,3,4,1,7,0,5,0,1,3,7
6910,791629,23,3,7,1,2,2,5,0,0,0,1,1,3,0,0,0,8
6910,786440,31,3,13,2,4,1,9,3,5,2,3,1,2,1,2,0,10
6910,781199,19,7,11,6,7,1,4,6,6,0,2,8,4,2,2,0,21
6910,775642,22,3,3,3,3,0,0,0,0,0,5,2,4,0,0,0,6
6910,786720,18,1,6,0,1,1,5,0,0,0,4,2,1,0,1,0,3
6910,796974,29,5,16,4,10,1,6,0,1,0,3,0,3,0,2,1,11
6910,791628,4,0,2,0,1,0,1,0,0,0,0,0,0,1,1,0,0
6910,791626,4,0,0,0,0,0,0,0,0,1,0,0,0,0,0,0,0
6911,784248,5,0,0,0,0,0,0,0,0,0,0,0,1,0,0,0,0
6911,781007,15,1,5,1,5,0,0,2,4,1,3,0,4,1,3,1,4
6911,781322,23,5,9,2,3,3,6,2,2,0,6,0,5,1,1,0,15
6911,785989,32,3,9,3,7,0,2,3,3,0,5,6,3,1,5,1,9
6911,786571,30,2,9,2,8,0,1,3,5,2,4,3,3,1,3,0,7
6911,781207,31,5,10,5,9,0,1,4,6,2,4,0,4,1,5,2,14
6911,791690,13,0,1,0,1,0,0,0,2,2,1,0,0,1,1,0,0
6911,780563,15,2,6,2,3,0,3,1,1,1,1,1,1,0,0,0,5
6911,781419,23,3,7,3,5,0,2,1,2,0,2,0,0,0,0,0,7
6911,797299,13,0,1,0,1,0,0,0,0,0,3,2,1,0,0,1,0
6912,780087,34,5,13,4,10,1,3,5,6,3,8,0,2,2,2,0,16
6912,786309,22,2,9,1,4,1,5,3,4,4,1,0,5,0,0,0,8
6912,776136,30,2,7,0,2,2,5,0,0,1,1,3,3,1,2,0,6
6912,790952,18,2,8,1,4,1,4,0,0,0,1,2,4,1,2,1,5
6912,790951,5,0,1,0,1,0,0,0,0,0,0,0,4,2,1,0,0
6912,796540,27,4,4,4,4,0,0,1,2,2,2,0,1,0,0,2,9
6912,776076,27,4,7,4,7,0,0,0,0,0,2,6,3,0,3,0,8
6912,796544,19,3,9,1,1,2,8,0,0,1,1,1,1,1,3,0,8
6912,775037,12,1,1,1,1,0,0,0,0,1,2,0,2,0,0,1,2
6912,790954,5,0,2,0,0,0,2,0,0,0,1,0,0,0,0,0,0
6912,796545,1,0,0,0,0,0,0,0,0,0,0,0,0,0,0,0,0
6913,792629,33,4,6,4,6,0,0,6,12,0,1,5,4,2,2,0,14
6913,780250,31,2,9,0,3,2,6,3,4,0,8,1,4,1,1,1,9
6913,792632,34,2,4,2,4,0,0,4,8,3,3,0,1,0,3,0,8
6913,792631,22,2,6,1,4,1,2,2,2,0,1,2,0,1,0,0,7
6913,796637,20,1,3,1,3,0,0,0,0,0,3,1,3,0,4,0,2
6913,796634,8,5,6,5,6,0,0,0,0,1,0,0,0,1,2,0,10
6913,781491,20,2,3,1,1,1,2,2,3,1,2,0,2,2,2,0,7
6913,796642,19,2,3,2,2,0,1,2,2,0,1,0,0,0,0,0,6
6913,792627,13,1,5,1,4,0,1,2,2,1,0,1,1,0,0,0,4
6914,790810,36,4,12,4,9,0,3,3,4,2,9,1,4,0,4,1,11
6914,785362,29,7,16,7,16,0,0,9,12,3,7,3,2,0,1,2,23
6914,790808,32,4,7,1,2,3,5,4,4,4,6,2,3,3,2,0,15
6914,785361,39,3,10,1,4,2,6,2,2,1,1,2,3,4,4,0,10
6914,779997,39,5,7,5,7,0,0,7,8,1,5,4,2,0,5,0,17
6914,774854,9,0,2,0,2,0,0,1,2,1,1,0,0,0,0,3,1
6914,790811,10,0,2,0,1,0,1,1,2,1,0,1,1,2,1,0,1
6914,790809,3,0,0,0,0,0,0,0,0,0,0,0,0,0,1,0,0
6914,796368,3,0,0,0,0,0,0,0,0,0,0,0,0,0,0,0,0
6915,790884,18,3,4,3,4,0,0,2,2,0,4,0,2,1,0,4,8
6915,791635,29,1,6,0,2,1,4,0,0,0,0,1,2,0,3,1,3
6915,790883,28,4,9,3,6,1,3,4,4,1,4,3,4,1,4,0,13
6915,796436,37,7,18,3,10,4,8,8,10,3,6,1,4,2,7,2,26
6915,785436,32,5,13,5,11,0,2,0,0,2,3,4,4,1,2,0,10
6915,796439,9,0,0,0,0,0,0,0,0,1,1,0,3,0,1,0,0
6915,796438,22,0,7,0,3,0,4,1,2,0,2,1,2,2,1,0,1
6915,781262,16,2,6,1,1,1,5,0,0,0,0,0,0,0,0,0,5
6915,796442,9,0,0,0,0,0,0,0,0,1,0,0,3,0,0,0,0
6916,791585,32,4,7,3,5,1,2,2,2,0,4,1,1,2,6,0,11
6916,785228,25,0,6,0,3,0,3,2,2,1,2,0,0,1,0,0,2
6916,780062,17,3,4,3,4,0,0,1,1,1,2,0,3,0,1,2,7
6916,786395,30,3,12,1,6,2,6,5,6,0,7,0,3,1,1,0,13
6916,786394,34,6,15,5,11,1,4,4,5,3,2,6,4,0,1,0,17
6916,791581,27,2,6,1,2,1,4,2,2,0,5,1,0,1,0,0,7
6916,780404,30,4,5,4,5,0,0,0,0,0,4,3,2,0,3,0,8
6916,797041,4,0,0,0,0,0,0,0,0,0,0,0,1,0,0,0,0
6916,799920,1,0,0,0,0,0,0,0,0,0,0,0,0,0,0,0,0
6917,790873,25,2,8,2,7,0,1,3,4,1,5,0,3,0,2,3,7
6917,785429,30,4,9,1,1,3,8,0,0,0,4,1,2,1,0,0,11
6917,780054,17,0,3,0,3,0,0,0,0,0,3,1,3,2,0,0,0
6917,781140,34,7,12,6,10,1,2,3,3,2,2,1,3,1,0,2,18
6917,786851,31,7,15,4,5,3,10,1,2,1,3,4,2,1,4,0,18
6917,776245,11,2,4,0,0,2,4,0,0,0,0,1,1,0,0,0,6
6917,796433,7,0,0,0,0,0,0,0,0,0,2,0,1,0,0,0,0
6917,781139,10,1,1,1,1,0,0,0,0,0,2,3,3,1,0,0,2
6917,776357,30,2,4,1,3,1,1,6,6,0,2,3,2,0,3,0,11
6917,799973,3,0,0,0,0,0,0,0,0,0,0,0,0,0,1,0,0
6917,796432,2,0,0,0,0,0,0,0,0,0,0,1,0,1,0,0,0
6918,786157,22,5,11,5,11,0,0,2,3,7,2,0,2,3,2,1,12
6918,791756,23,4,8,4,7,0,1,2,2,0,3,5,1,2,1,0,10
6918,780992,24,1,5,0,1,1,4,0,0,0,1,1,2,0,0,0,3
6918,780677,25,5,10,1,3,4,7,9,9,0,3,0,2,3,0,1,23
6918,780673,24,1,5,0,0,1,5,2,2,0,2,5,1,0,1,0,5
6918,797350,7,0,5,0,2,0,3,1,2,1,0,0,1,2,0,0,1
6918,791754,18,3,9,3,8,0,1,2,3,6,7,0,1,0,0,0,8
6918,786150,11,3,4,3,4,0,0,0,2,5,0,0,3,1,0,0,6
6918,775533,19,2,4,2,3,0,1,8,10,5,2,0,3,0,0,0,12
6918,797353,1,0,0,0,0,0,0,0,0,0,0,0,0,0,0,0,0
6918,791753,2,1,1,1,1,0,0,0,0,0,1,0,0,1,0,0,2
6918,797348,21,1,9,1,4,0,5,1,2,0,5,2,2,1,1,0,3
6918,791730,2,0,0,0,0,0,0,0,0,0,0,0,0,0,0,0,0
6918,797351,1,0,0,0,0,0,0,0,0,0,0,1,0,0,0,0,0
6919,791743,31,3,6,3,6,0,0,1,2,0,5,1,2,0,3,1,7
6919,797340,30,4,13,1,5,3,8,2,2,0,2,1,1,2,3,0,13
6919,791746,27,1,5,1,3,0,2,2,4,2,2,3,1,0,3,0,4
6919,786193,31,4,9,2,4,2,5,2,2,0,3,2,2,0,0,1,12
6919,780711,19,2,3,2,3,0,0,2,2,2,1,0,3,0,1,0,6
6919,797344,17,1,2,1,2,0,0,3,4,0,2,0,4,1,1,0,5
6919,797343,13,0,4,0,2,0,2,1,2,0,2,1,1,0,2,3,1
6919,797342,7,0,0,0,0,0,0,0,0,0,0,0,4,0,0,0,0
6919,797341,20,2,8,0,4,2,4,0,0,0,3,1,5,0,2,0,6
6919,791744,5,0,0,0,0,0,0,0,0,0,0,0,0,0,0,0,0
6924,780686,24,4,12,4,12,0,0,0,0,2,7,1,4,1,5,0,8
6924,780683,30,6,7,5,5,1,2,3,4,1,6,0,2,2,2,1,16
6924,797680,20,2,5,1,3,1,2,0,0,0,2,0,1,1,2,1,5
6924,786112,28,3,12,2,9,1,3,5,5,1,0,5,3,0,3,0,12
6924,780688,30,2,6,2,5,0,1,0,0,0,2,1,0,3,1,0,4
6924,797683,10,1,4,1,3,0,1,0,0,2,0,0,4,0,0,2,2
6924,797679,17,4,6,3,3,1,3,2,2,0,0,0,1,1,1,0,11
6924,797677,4,0,1,0,0,0,1,0,0,0,0,0,0,0,0,0,0
6924,791942,13,0,2,0,1,0,1,0,0,0,3,3,0,0,2,0,0
6924,780772,8,1,2,1,2,0,0,0,0,0,1,0,0,0,0,0,2
6924,780689,16,0,5,0,5,0,0,0,0,0,3,1,1,1,0,0,0
6926,791723,27,3,5,3,5,0,0,4,4,1,3,2,3,1,1,2,10
6926,797310,34,3,8,3,6,0,2,1,2,0,6,4,2,1,3,0,7
6926,785580,33,1,9,0,6,1,3,2,4,0,2,9,2,1,4,0,5
6926,791724,27,4,9,3,7,1,2,2,3,3,4,1,2,3,4,1,11
6926,781617,34,8,11,4,6,4,5,3,3,0,4,0,4,1,1,1,23
6926,780956,24,6,9,5,7,1,2,1,2,2,3,2,0,0,3,1,14
6926,797308,18,1,3,1,3,0,0,0,0,1,0,2,1,0,1,0,2
6926,780706,3,0,1,0,1,0,0,2,2,0,0,0,0,0,0,0,2
6927,791230,30,4,7,2,4,2,3,0,0,3,3,2,2,1,0,0,10
6927,785557,30,2,8,2,7,0,1,8,10,1,4,3,3,3,2,1,12
6927,791228,25,4,10,4,8,0,2,2,2,3,4,1,2,1,3,0,10
6927,796932,31,6,14,3,9,3,5,3,4,1,4,2,2,0,8,0,18
6927,785624,26,4,6,2,2,2,4,0,0,0,2,1,3,1,0,0,10
6927,796935,14,2,8,1,2,1,6,0,0,3,1,0,2,0,0,0,5
6927,796933,19,3,6,3,5,0,1,3,4,0,0,2,1,2,1,0,9
6927,791226,10,0,0,0,0,0,0,4,4,0,4,0,1,0,1,0,4
6927,781201,4,0,0,0,0,0,0,0,0,0,0,0,0,0,0,1,0
6927,781198,11,0,3,0,3,0,0,0,0,1,2,1,3,1,0,0,0
6928,785948,31,4,5,4,5,0,0,4,5,1,4,1,2,1,1,0,12
6928,785946,9,1,3,1,2,0,1,0,0,1,2,0,2,1,2,0,2
6928,792020,33,6,14,4,6,2,8,5,6,1,3,2,1,1,2,0,19
6928,785939,33,4,10,3,5,1,5,2,2,0,2,4,2,1,3,0,11
6928,785938,25,1,4,0,1,1,3,4,4,0,3,4,2,1,2,0,7
6928,792026,8,2,4,2,4,0,0,0,0,1,2,0,1,0,0,0,4
6928,792025,17,2,3,2,3,0,0,4,4,0,5,0,2,0,2,0,8
6928,792023,15,2,3,1,2,1,1,0,0,0,1,1,1,4,0,0,5
6928,785941,29,3,9,0,1,3,8,0,0,0,4,1,2,0,1,1,9
6929,791289,23,4,9,4,9,0,0,2,2,1,5,2,4,1,1,2,10
6929,796574,27,4,9,2,5,2,4,2,2,1,1,1,2,2,4,0,12
6929,796571,29,1,2,1,2,0,0,0,0,1,1,2,1,1,2,0,2
6929,796572,22,0,1,0,1,0,0,5,6,0,3,0,4,0,0,1,5
6929,781346,32,6,11,3,4,3,7,2,3,0,3,3,1,1,2,0,17
6929,785786,17,3,5,3,5,0,0,0,0,1,1,0,2,0,2,1,6
6929,796576,32,6,13,2,3,4,10,1,2,0,5,2,2,1,2,0,17
6929,791290,18,0,6,0,1,0,5,0,0,1,3,0,2,1,0,0,0
6930,775556,32,8,13,7,11,1,2,3,3,1,3,6,2,2,5,1,20
6930,780234,31,9,12,7,8,2,4,2,5,2,9,4,2,1,2,3,22
6930,786411,18,4,5,1,2,3,3,0,0,1,1,0,0,0,0,1,11
6930,780046,30,8,13,5,6,3,7,4,4,0,2,3,4,0,2,0,23
6930,781104,26,3,11,1,4,2,7,0,0,0,2,4,0,0,2,0,8
6930,797188,3,1,1,1,1,0,0,0,0,0,0,0,1,0,1,0,2
6930,781110,5,0,0,0,0,0,0,0,0,0,1,0,1,0,1,0,0
6930,786328,9,0,1,0,1,0,0,0,0,0,0,0,3,0,0,0,0
6930,797185,20,2,3,2,3,0,0,2,3,1,3,4,0,1,0,0,6
6930,786405,26,0,7,0,7,0,0,4,4,1,5,7,2,1,1,0,4
6931,797701,19,6,10,6,10,0,0,0,0,0,2,2,5,1,0,0,12
6931,792101,33,4,12,4,8,0,4,2,2,0,2,2,3,0,0,0,10
6931,792102,31,2,11,2,8,0,3,2,4,1,2,1,1,0,1,1,6
6931,775564,25,2,8,2,8,0,0,0,0,2,3,3,1,2,1,1,4
6931,776386,35,10,12,6,6,4,6,0,0,2,3,3,1,1,1,0,24
6931,797700,24,10,16,10,16,0,0,1,3,3,8,2,3,1,2,2,21
6931,797697,6,0,0,0,0,0,0,0,0,0,0,0,2,0,1,0,0
6931,791856,1,1,1,0,0,1,1,0,0,0,0,0,0,0,0,0,3
6931,786156,1,0,0,0,0,0,0,0,0,0,0,0,1,0,1,0,0
6931,786160,24,1,4,1,2,0,2,2,2,1,2,4,2,2,2,0,4
6931,792103,1,0,0,0,0,0,0,0,0,0,0,0,0,0,0,0,0
6932,781656,30,6,8,6,8,0,0,0,0,0,5,2,2,1,0,2,12
6932,781658,32,4,6,4,6,0,0,0,0,1,4,1,3,0,4,0,8
6932,796962,23,2,5,1,4,1,1,0,0,0,1,2,3,2,0,0,5
6932,786798,38,3,13,3,13,0,0,1,3,0,4,9,4,2,5,0,7
6932,780129,30,1,5,0,2,1,3,2,2,0,4,0,3,0,1,0,5
6932,798206,11,1,3,1,2,0,1,0,0,3,1,2,1,0,1,0,2
6932,791263,10,2,4,2,4,0,0,0,0,1,2,1,3,0,1,0,4
6932,796967,20,5,10,1,2,4,8,2,3,1,1,0,0,0,0,0,16
6932,796964,6,0,1,0,0,0,1,0,0,0,1,0,0,0,0,0,0
6932,796966,0,0,0,0,0,0,0,0,0,0,0,0,0,0,0,0,0
6933,781149,11,1,3,1,3,0,0,0,0,1,1,0,2,0,1,0,2
6933,792670,21,0,3,0,1,0,2,3,6,2,0,1,1,0,0,1,3
6933,782157,11,1,1,1,1,0,0,0,0,0,3,2,0,1,1,0,2
6933,780193,28,3,11,2,5,1,6,0,0,1,0,1,3,0,2,0,7
6933,774985,37,4,8,4,6,0,2,5,8,0,8,1,0,0,2,0,13
6933,786163,25,5,10,5,8,0,2,0,1,2,3,1,2,1,1,0,10
6933,792666,14,2,4,2,3,0,1,0,0,1,1,0,2,0,1,0,4
6933,780852,10,1,3,1,3,0,0,0,0,1,0,0,1,0,1,0,2
6933,798152,5,1,2,1,2,0,0,0,0,1,1,0,1,1,0,0,2
6933,792669,12,1,3,0,1,1,2,0,0,0,0,0,2,0,1,0,3
6933,775276,7,0,1,0,0,0,1,0,0,0,0,0,1,0,0,0,0
6933,786214,16,1,5,1,4,0,1,0,0,0,3,0,0,0,2,0,2
6933,798153,3,0,0,0,0,0,0,0,0,0,0,0,0,0,0,0,0
6934,775604,44,9,13,3,4,6,9,1,2,1,4,3,0,1,0,0,25
6934,785505,45,3,11,1,5,2,6,10,14,1,4,6,2,5,5,1,18
6934,796981,33,5,11,3,8,2,3,3,5,0,3,3,2,2,4,0,15
6934,791616,35,5,9,5,8,0,1,2,3,1,2,0,3,2,1,2,12
6934,780797,26,1,4,0,1,1,3,0,0,2,6,3,5,2,0,0,3
6934,780555,35,4,9,3,4,1,5,2,4,0,3,3,2,6,2,0,11
6934,791618,8,1,3,0,2,1,1,0,0,0,1,0,0,0,2,0,3
6934,796986,5,1,3,1,1,0,2,0,0,0,1,0,0,0,0,0,2
6934,796983,10,0,2,0,2,0,0,0,0,1,1,0,5,0,0,1,0
6934,776418,7,0,2,0,2,0,0,0,0,1,1,0,0,0,0,0,0
6934,796984,2,0,1,0,0,0,1,0,0,0,0,0,0,0,1,0,0
6935,797357,41,6,8,4,4,2,4,4,5,1,4,2,5,2,4,0,18
6935,776236,40,8,17,8,14,0,3,1,1,1,3,1,2,1,6,0,17
6935,786136,34,5,13,5,10,0,3,2,2,1,4,0,5,2,3,1,12
6935,797358,35,1,11,1,6,0,5,6,7,1,8,2,5,2,3,0,8
6935,785669,18,0,4,0,3,0,1,0,0,0,1,0,0,0,2,0,0
6935,775747,33,6,8,6,7,0,1,4,6,4,8,1,4,0,4,1,16
6935,786578,16,3,5,3,5,0,0,2,2,0,2,1,2,0,2,1,8
6935,791365,18,1,2,0,0,1,2,0,0,1,0,0,0,0,0,0,3
6935,775195,8,0,1,0,0,0,1,0,0,0,1,1,1,0,0,0,0
6935,797359,7,0,0,0,0,0,0,0,0,0,2,0,1,0,2,0,0
6935,791802,0,0,0,0,0,0,0,0,0,0,0,0,0,0,0,0,0
6935,786140,0,0,0,0,0,0,0,0,0,0,0,0,0,0,0,0,0
6936,781537,28,8,11,5,6,3,5,3,3,0,6,1,4,0,2,0,22
6936,792202,36,4,10,1,3,3,7,4,4,0,1,3,2,0,2,0,15
6936,797849,32,2,4,1,1,1,3,0,0,0,4,1,2,1,0,0,5
6936,786079,24,2,6,1,4,1,2,0,0,2,3,5,4,1,3,0,5
6936,779986,17,2,3,2,3,0,0,0,0,0,0,0,1,0,0,0,4
6936,797847,13,5,7,2,2,3,5,2,2,0,2,0,3,0,1,0,15
6936,797846,13,2,4,2,4,0,0,2,2,1,1,1,0,0,1,1,6
6936,797842,27,2,7,2,6,0,1,0,0,4,1,7,3,1,2,0,4
6936,797848,8,0,2,0,2,0,0,0,0,0,1,0,2,0,0,1,0
6936,797838,2,0,1,0,1,0,0,0,0,0,0,0,0,0,1,0,0
6937,791306,15,4,4,4,4,0,0,0,0,3,4,0,3,2,0,0,8
6937,780210,37,5,17,5,14,0,3,7,8,8,4,0,1,2,3,0,17
6937,792432,33,2,5,2,4,0,1,2,2,1,3,6,3,1,1,0,6
6937,796594,39,7,13,5,7,2,6,2,3,0,2,3,2,1,0,0,18
6937,792427,36,4,14,2,4,2,10,2,2,1,1,2,0,1,2,0,12
6937,796592,28,4,5,3,3,1,2,2,2,1,4,0,3,0,3,1,11
6937,786422,12,1,1,1,1,0,0,1,3,1,2,3,1,0,0,0,3
6938,797859,38,8,11,5,5,3,6,10,10,1,2,0,3,0,4,1,29
6938,797861,24,4,7,4,7,0,0,0,0,2,3,1,2,0,6,0,8
6938,781314,36,3,10,2,6,1,4,0,0,0,5,4,3,2,3,0,7
6938,792208,32,2,10,2,10,0,0,3,4,1,2,2,0,0,1,0,7
6938,786262,27,1,3,0,1,1,2,0,0,0,1,2,4,0,0,0,3
6938,776018,19,5,5,5,5,0,0,3,4,1,3,1,4,0,2,0,13
6938,786983,8,0,1,0,1,0,0,2,2,0,3,0,1,0,0,0,2
6938,781317,9,0,1,0,0,0,1,0,0,0,3,0,0,0,0,0,0
6938,797856,7,0,1,0,1,0,0,0,0,0,0,1,1,0,0,0,0
6939,786805,27,9,15,7,11,2,4,2,4,2,7,1,2,2,3,1,22
6939,774936,24,6,15,5,13,1,2,0,1,2,2,4,3,1,1,1,13
6939,790933,22,3,5,2,4,1,1,2,4,0,2,1,1,1,0,0,9
6939,781345,36,2,3,1,1,1,2,3,4,1,4,5,4,2,1,0,8
6939,786803,22,3,4,3,3,0,1,0,0,2,0,5,0,1,0,0,6
6939,790932,30,4,9,3,8,1,1,3,4,3,1,0,1,0,0,0,12
6939,786804,15,1,5,1,2,0,3,4,4,0,2,0,0,0,1,1,6
6939,790934,15,2,2,2,2,0,0,0,0,0,1,1,3,1,2,0,4
6939,780033,9,1,2,1,1,0,1,0,0,0,0,3,2,0,0,0,2
6939,796487,0,0,0,0,0,0,0,0,0,0,1,0,0,0,0,0,0
6939,796488,0,0,0,0,0,0,0,0,0,0,0,0,0,0,0,0,0
6939,796489,0,0,0,0,0,0,0,0,0,0,0,0,0,0,0,0,0
6939,796490,0,0,0,0,0,0,0,0,0,0,0,0,0,0,0,0,0
6939,780030,0,0,0,0,0,0,0,0,0,0,0,0,0,0,0,0,0
6940,791988,25,10,18,10,18,0,0,2,2,5,2,0,3,0,0,1,22
6940,791989,38,2,8,1,3,1,5,1,2,0,6,1,1,2,1,0,6
6940,796507,21,2,5,2,3,0,2,1,2,1,1,1,0,0,3,1,5
6940,791987,27,1,3,1,2,0,1,2,2,0,2,3,3,1,4,0,4
6940,792443,25,0,3,0,3,0,0,0,0,1,4,0,2,0,2,1,0
6940,796503,24,3,10,3,8,0,2,4,4,2,6,2,0,0,0,0,10
6940,785258,12,1,1,1,1,0,0,3,6,0,2,0,1,1,1,0,5
6940,780077,17,1,7,0,6,1,1,1,2,1,1,1,2,0,0,0,4
6940,796508,6,0,1,0,0,0,1,0,0,0,1,0,0,1,1,0,0
6940,796506,5,0,1,0,1,0,0,0,0,0,1,0,3,0,0,1,0
6941,789484,24,1,12,0,8,1,4,8,10,0,4,0,4,1,0,0,11
6941,782654,18,4,7,3,6,1,1,1,2,4,0,1,4,0,2,1,10
6941,792418,24,3,9,2,8,1,1,2,3,3,5,0,0,1,1,4,9
6941,796693,32,2,10,2,6,0,4,1,1,0,5,2,4,0,3,0,5
6941,796691,33,1,6,0,2,1,4,0,0,0,2,1,1,1,1,0,3
6941,792422,30,5,11,5,11,0,0,1,2,3,5,0,3,2,1,1,11
6941,792424,13,2,3,2,3,0,0,0,0,3,1,0,4,0,1,0,4
6941,796695,4,1,1,1,1,0,0,0,0,0,0,0,0,0,0,0,2
6941,792423,10,0,1,0,1,0,0,0,0,0,0,0,0,0,0,0,0
6941,792419,6,0,1,0,0,0,1,0,0,0,0,1,1,0,0,0,0
6941,800100,4,0,1,0,0,0,1,0,0,0,0,0,1,0,0,0,0
6941,796692,1,0,1,0,0,0,1,0,0,0,0,0,0,0,0,0,0
6941,796694,1,0,0,0,0,0,0,0,0,0,0,0,0,0,0,0,0
6942,780753,34,8,16,7,12,1,4,4,5,1,7,3,3,1,2,0,21
6942,792318,30,5,7,5,7,0,0,7,13,4,9,0,4,2,3,0,17
6942,786717,35,5,10,5,10,0,0,1,1,2,8,3,2,1,1,0,11
6942,796519,19,0,3,0,1,0,2,0,0,0,0,1,4,0,2,0,0
6942,775329,19,0,3,0,0,0,3,0,0,0,1,0,1,0,1,0,0
6942,796517,27,3,9,2,5,1,4,0,0,1,1,0,2,0,1,0,7
6942,796516,21,2,5,2,5,0,0,3,4,1,0,1,4,0,1,0,7
6942,796518,5,1,2,1,1,0,1,0,0,0,1,0,0,0,1,0,2
6942,792308,5,0,1,0,1,0,0,0,0,1,0,1,0,0,0,0,0
6942,792315,5,0,2,0,0,0,2,0,0,0,1,1,0,1,0,0,0
6943,799130,37,11,18,3,4,8,14,4,5,2,3,4,2,0,1,1,34
6943,792634,38,4,12,3,6,1,6,4,6,0,2,7,3,1,0,0,13
6943,800091,38,5,15,5,14,0,1,2,4,5,3,0,0,2,1,0,12
6943,799129,37,3,9,2,6,1,3,2,2,1,9,1,2,0,2,0,9
6943,800005,17,0,0,0,0,0,0,0,0,1,3,0,5,0,2,1,0
6943,799133,13,0,1,0,0,0,1,0,2,0,1,0,2,0,1,0,0
6943,799134,6,0,1,0,0,0,1,0,0,0,1,1,3,0,4,0,0
6943,799136,6,0,0,0,0,0,0,0,0,0,0,0,4,0,0,0,0
6943,799128,5,0,0,0,0,0,0,0,0,0,0,0,2,0,0,0,0
6943,799135,3,0,0,0,0,0,0,0,0,0,0,0,0,0,0,0,0
6944,789028,29,5,9,5,9,0,0,1,4,2,3,5,2,1,1,0,11
6944,792067,19,2,6,1,4,1,2,5,7,1,5,2,4,2,1,0,10
6944,792058,21,3,7,3,6,0,1,2,3,0,1,0,1,1,0,2,8
6944,797649,39,1,9,1,7,0,2,3,4,2,4,0,1,5,2,0,5
6944,775523,19,1,6,1,4,0,2,0,0,3,3,0,3,0,2,0,2
6944,789053,23,1,3,1,3,0,0,4,4,0,0,1,2,1,2,0,6
6944,789029,22,3,11,3,9,0,2,0,0,0,4,1,2,1,0,0,6
6944,790779,21,2,3,2,3,0,0,1,2,0,4,0,4,0,2,1,5
6944,797651,7,0,0,0,0,0,0,0,0,0,0,0,2,0,2,0,0
6945,789177,32,4,7,4,7,0,0,7,7,5,10,0,4,1,4,3,15
6945,791340,38,5,10,4,9,1,1,0,3,1,4,1,2,0,5,0,11
6945,780181,22,5,16,5,11,0,5,1,1,1,2,1,2,0,5,0,11
6945,776089,28,3,7,3,4,0,3,2,2,1,3,0,3,2,0,0,8
6945,780227,14,0,3,0,3,0,0,0,2,1,1,0,4,1,0,0,0
6945,791336,29,1,6,1,6,0,0,3,4,0,2,0,1,2,1,0,5
6945,775758,25,1,1,1,1,0,0,3,7,1,3,0,1,0,2,1,5
6945,797260,3,1,2,1,2,0,0,0,0,1,0,0,0,0,0,0,2
6945,789178,9,0,0,0,0,0,0,0,0,1,3,0,2,0,2,0,0
6946,786164,20,2,7,2,6,0,1,0,0,1,1,0,3,0,1,0,4
6946,781560,36,2,6,2,6,0,0,4,7,2,7,1,2,2,1,4,8
6946,796477,24,1,1,0,0,1,1,2,2,0,3,1,2,0,2,0,5
6946,791375,35,2,6,1,1,1,5,1,1,0,3,4,2,0,1,0,6
6946,785482,27,7,9,7,9,0,0,0,1,0,2,4,4,0,5,0,14
6946,780837,30,9,14,3,6,6,8,2,3,0,1,0,0,0,1,1,26
6946,796479,28,2,2,1,1,1,1,1,1,3,3,3,3,0,1,0,6
6947,792473,18,7,12,4,7,3,5,1,1,0,1,2,4,0,0,0,18
6947,780036,30,3,6,1,2,2,4,0,1,0,4,2,2,2,1,1,8
6947,799276,30,2,3,2,3,0,0,0,0,0,0,3,4,0,0,0,4
6947,785249,40,7,11,5,7,2,4,4,5,1,2,4,1,1,1,1,20
6947,780035,19,1,3,1,2,0,1,0,0,0,0,1,1,0,2,0,2
6947,785251,20,1,7,1,3,0,4,0,0,0,3,2,0,1,1,0,2
6947,780043,25,2,4,1,3,1,1,2,2,0,4,1,2,0,0,0,7
6947,792474,7,0,0,0,0,0,0,0,0,0,0,0,2,0,1,0,0
6947,792478,11,1,2,0,0,1,2,0,0,1,1,1,2,1,2,1,3
6948,796673,20,2,3,1,2,1,1,0,0,0,2,0,3,0,2,0,5
6948,796674,32,3,5,2,4,1,1,2,4,3,5,0,2,0,2,0,9
6948,779857,16,0,1,0,1,0,0,0,0,1,0,1,3,0,2,1,0
6948,779976,33,9,16,8,11,1,5,1,2,1,3,5,4,2,4,0,20
6948,774990,26,6,15,4,8,2,7,0,0,0,3,6,1,1,3,0,14
6948,781586,14,1,2,1,2,0,0,0,0,0,5,0,5,0,2,0,2
6948,785961,24,4,7,3,4,1,3,2,2,1,3,1,3,1,2,1,11
6948,785339,17,1,4,1,3,0,1,2,2,0,0,0,1,0,1,0,4
6948,791014,15,2,5,0,2,2,3,0,0,0,1,1,0,0,1,0,6
6948,785126,3,0,0,0,0,0,0,0,0,0,1,0,1,1,0,0,0
6949,790798,34,8,12,7,10,1,2,3,9,3,10,1,2,2,3,1,20
6949,780140,37,4,10,2,6,2,4,3,4,1,0,3,2,1,2,1,13
6949,796355,27,10,18,8,14,2,4,2,4,0,5,3,3,2,2,0,24
6949,785245,32,6,10,5,6,1,4,2,2,1,2,2,4,4,2,0,15
6949,780137,39,1,6,1,3,0,3,2,2,1,6,4,1,0,2,0,4
6949,796354,7,0,2,0,1,0,1,0,0,0,0,0,1,0,0,0,0
6949,775553,8,0,1,0,1,0,0,0,0,0,0,0,1,0,0,0,0
6949,790799,15,3,3,3,3,0,0,0,0,2,0,1,1,1,1,0,6
6949,790796,1,0,1,0,1,0,0,0,0,0,0,0,1,0,0,0,0
6962,791316,25,3,5,3,5,0,0,0,0,3,4,0,2,0,3,2,6
6962,780870,33,8,10,8,10,0,0,2,4,5,4,0,3,0,0,3,18
6962,781079,36,7,12,6,8,1,4,0,0,0,5,3,1,0,0,0,15
6962,781443,38,2,15,1,6,1,9,3,4,0,7,5,1,2,7,0,8
6962,775822,37,3,7,2,2,1,5,5,5,0,3,4,0,1,2,0,12
6962,796621,17,3,7,1,1,2,6,0,0,0,1,2,3,0,3,0,8
6962,791314,4,0,1,0,0,0,1,0,0,0,1,0,0,0,0,0,0
6962,785831,10,0,2,0,2,0,0,0,0,0,0,0,1,2,0,0,0
6963,796455,27,2,4,2,4,0,0,0,2,4,2,1,3,1,1,0,4
6963,787175,34,2,10,1,2,1,8,0,0,0,5,0,3,2,0,2,5
6963,790909,40,6,14,4,5,2,9,2,4,2,4,4,2,1,2,0,16
6963,781393,26,6,14,3,4,3,10,2,3,0,0,1,3,2,1,1,17
6963,775351,30,3,7,3,7,0,0,0,2,1,3,1,1,1,6,0,6
6963,790907,7,1,1,1,1,0,0,2,2,0,1,0,0,0,0,0,4
6963,782126,36,6,12,4,6,2,6,4,4,3,3,2,2,1,0,0,18
6964,790761,35,9,16,7,11,2,5,4,4,3,7,3,1,0,0,1,24
6964,790764,32,5,10,4,6,1,4,2,2,1,3,3,4,1,2,0,13
6964,796322,19,4,7,4,7,0,0,0,1,1,3,1,2,0,0,2,8
6964,796319,22,4,8,2,4,2,4,0,0,1,2,3,1,1,4,0,10
6964,796320,37,7,12,5,8,2,4,0,0,0,2,2,4,2,1,0,16
6964,796318,15,3,6,1,4,2,2,0,0,0,0,0,2,1,3,1,8
6964,796323,4,1,1,1,1,0,0,1,1,2,0,0,0,0,1,0,3
6964,779993,20,2,4,2,4,0,0,0,0,1,4,4,2,2,1,0,4
6964,785219,16,1,5,0,2,1,3,0,0,0,0,0,3,0,0,0,3
6965,785423,29,3,4,2,3,1,1,4,4,2,0,1,3,0,0,0,11
6965,775676,26,6,6,6,6,0,0,1,2,2,3,0,2,0,0,3,13
6965,786298,36,10,16,6,9,4,7,4,5,0,2,1,1,3,2,1,28
6965,785425,36,3,10,1,3,2,7,4,4,1,6,0,2,1,1,0,12
6965,785422,36,5,12,2,6,3,6,2,2,0,3,8,2,0,4,0,15
6965,774957,13,2,3,2,2,0,1,3,3,1,1,0,2,1,0,0,7
6965,786210,24,3,7,2,4,1,3,0,0,0,5,6,2,0,0,0,7
6966,786123,39,5,5,5,5,0,0,7,8,1,7,2,3,0,4,3,17
6966,780437,38,7,9,7,9,0,0,6,7,2,6,1,2,1,1,0,20
6966,797673,38,6,10,3,7,3,3,0,0,0,5,2,3,0,0,0,15
6966,786118,32,3,9,1,4,2,5,2,2,1,4,2,2,1,2,0,10
6966,786117,40,5,8,2,5,3,3,5,6,0,1,8,2,2,2,0,18
6966,797672,2,0,0,0,0,0,0,0,0,1,1,0,1,0,0,0,0
6966,792093,10,2,5,1,2,1,3,1,2,0,0,1,1,0,0,0,6
6966,797675,1,0,0,0,0,0,0,0,0,0,0,0,1,0,1,0,0
6967,780122,22,1,7,1,4,0,3,2,2,2,3,2,2,0,1,2,4
6967,797215,28,5,6,2,3,3,3,0,0,0,1,3,2,1,1,1,13
6967,791461,32,4,11,4,9,0,2,1,2,6,5,2,2,2,1,0,9
6967,791460,36,5,7,1,2,4,5,8,13,0,1,1,1,3,1,0,22
6967,786295,28,3,16,0,5,3,11,0,0,0,0,4,1,0,0,0,9
6967,797216,6,1,1,1,1,0,0,0,0,0,0,1,3,0,0,0,2
6967,786299,11,0,2,0,2,0,0,0,0,2,2,0,0,0,0,0,0
6967,797214,13,1,5,1,4,0,1,0,0,1,1,0,1,0,0,0,2
6967,780792,24,5,9,3,3,2,6,0,0,0,0,1,3,1,1,0,12
6968,781656,26,2,4,2,4,0,0,2,2,1,3,1,3,0,1,2,6
6968,781658,37,3,5,3,5,0,0,2,3,3,5,2,2,0,3,0,8
6968,796962,28,3,8,2,3,1,5,0,0,0,2,1,0,1,3,1,7
6968,786798,35,5,9,5,8,0,1,4,4,0,6,3,3,0,1,0,14
6968,780129,26,4,6,3,4,1,2,0,3,0,1,1,4,2,1,0,9
6968,798206,12,3,5,1,1,2,4,0,0,1,0,0,2,0,1,0,8
6968,791263,17,2,4,2,4,0,0,2,2,0,2,0,2,0,1,0,6
6968,796967,14,0,4,0,0,0,4,0,0,0,2,0,2,0,2,0,0
6968,791264,3,1,2,1,1,0,1,0,0,0,2,0,2,0,0,0,2
6968,796964,2,0,0,0,0,0,0,0,0,0,0,0,0,0,0,0,0
6969,792666,23,0,5,0,4,0,1,0,0,1,5,0,1,0,2,0,0
6969,780852,23,1,4,1,4,0,0,1,2,3,0,0,4,1,0,0,3
6969,792670,30,6,17,4,8,2,9,1,3,2,2,1,2,1,0,0,15
6969,782157,34,3,3,3,3,0,0,2,5,0,2,1,3,1,3,0,8
6969,774985,36,7,15,6,13,1,2,4,7,2,5,0,4,0,3,1,19
6969,798153,18,1,3,1,3,0,0,0,0,3,0,0,3,1,3,0,2
6969,786214,6,0,1,0,1,0,0,0,0,0,1,0,0,0,0,0,0
6969,798152,6,0,3,0,2,0,1,0,0,0,1,0,2,0,0,0,0
6969,780193,9,0,0,0,0,0,0,0,0,0,1,0,1,0,0,0,0
6969,775276,15,0,3,0,2,0,1,0,0,1,1,0,0,0,1,0,0
6970,785409,27,4,6,4,6,0,0,0,0,2,5,0,2,0,4,3,8
6970,785408,33,3,9,2,7,1,2,4,4,1,3,3,4,2,4,0,11
6970,796416,30,2,6,0,1,2,5,0,0,1,1,2,2,0,3,0,6
6970,780539,34,1,4,0,1,1,3,4,5,1,1,5,2,1,2,0,7
6970,780560,35,4,10,0,2,4,8,5,6,0,3,2,1,1,2,0,17
6970,785407,23,4,6,4,6,0,0,6,7,2,4,1,2,2,3,0,14
6970,796415,12,2,4,2,3,0,1,0,0,0,2,2,2,0,2,0,4
6970,790861,6,0,0,0,0,0,0,1,2,0,1,0,0,0,0,0,1
6971,792181,35,6,12,5,9,1,3,1,2,5,2,1,5,2,0,1,14
6971,780986,40,2,6,2,6,0,0,2,2,1,5,3,2,1,3,1,6
6971,785902,40,9,17,5,10,4,7,0,0,2,2,1,3,3,3,1,22
6971,792179,20,2,6,2,3,0,3,2,3,0,4,1,2,1,1,0,6
6971,786662,35,6,11,3,7,3,4,1,2,1,2,3,4,1,1,0,16
6971,797796,25,2,5,2,5,0,0,4,5,1,1,4,0,3,4,1,8
6971,786661,5,1,2,0,0,1,2,2,2,1,1,0,1,0,0,0,5
6972,797222,17,3,7,3,7,0,0,3,6,0,3,1,5,0,0,2,9
6972,781526,31,4,9,1,4,3,5,2,2,7,3,4,3,0,3,0,13
6972,797217,25,3,8,1,3,2,5,3,4,0,1,6,0,0,1,0,11
6972,797218,34,6,10,2,5,4,5,1,2,0,7,3,2,0,1,0,17
6972,775697,33,3,9,0,2,3,7,2,2,0,3,2,2,1,2,0,11
6972,791454,24,3,11,3,10,0,1,4,7,2,5,0,5,0,1,0,10
6972,791453,9,0,2,0,1,0,1,0,0,0,0,0,0,0,1,0,0
6972,791846,22,3,5,1,3,2,2,1,2,1,5,1,1,0,2,0,9
6972,797223,5,0,0,0,0,0,0,0,0,0,1,1,0,0,0,0,0
6973,785536,16,4,7,2,3,2,4,2,2,0,4,0,2,0,0,2,12
6973,780119,33,4,10,4,9,0,1,1,2,1,3,3,4,2,0,0,9
6973,796558,17,2,5,2,5,0,0,0,0,0,2,3,2,2,0,0,4
6973,796559,29,4,9,0,3,4,6,2,2,1,6,0,3,1,0,0,14
6973,776097,37,5,10,5,8,0,2,5,5,1,3,3,2,1,4,0,15
6973,785280,10,1,2,1,1,0,1,0,2,0,0,1,1,0,1,0,2
6973,796560,23,2,4,2,3,0,1,5,6,1,6,0,3,0,0,1,9
6973,780149,26,3,11,1,5,2,6,3,4,1,1,2,2,1,0,0,11
6973,775679,9,2,4,1,1,1,3,0,0,0,3,0,0,1,0,0,5
6974,780291,31,6,14,3,7,3,7,0,1,3,5,0,4,1,2,0,15
6974,785607,14,0,1,0,1,0,0,0,0,0,2,2,0,1,0,0,0
6974,796665,28,3,8,2,3,1,5,0,0,1,3,4,0,1,1,0,7
6974,785333,28,0,3,0,1,0,2,0,0,1,0,2,2,2,2,1,0
6974,775305,39,7,19,6,12,1,7,3,4,0,3,5,2,1,2,0,18
6974,796663,12,2,3,2,3,0,0,1,1,0,2,1,2,0,1,1,5
6974,791004,24,6,11,2,4,4,7,2,2,2,3,1,1,1,0,0,18
6974,791006,13,2,3,2,3,0,0,0,0,2,5,0,3,1,1,0,4
6974,796666,4,0,0,0,0,0,0,0,0,0,0,0,1,0,0,1,0
6974,796664,5,0,2,0,1,0,1,0,0,1,0,0,0,0,2,0,0
6974,791005,2,0,1,0,0,0,1,0,0,0,0,0,0,0,0,0,0
6975,781558,32,7,13,5,9,2,4,2,3,3,1,4,1,0,2,0,18
6975,780993,15,2,4,2,4,0,0,0,0,0,1,0,1,0,0,0,4
6975,775248,34,6,15,4,8,2,7,2,2,3,8,1,0,1,5,1,16
6975,797225,35,3,10,3,8,0,2,0,0,4,6,5,4,2,2,1,6
6975,791452,39,2,9,0,3,2,6,0,0,0,4,3,1,2,1,1,6
6975,797230,16,4,4,4,4,0,0,2,2,0,5,0,3,0,2,0,10
6975,797231,1,0,1,0,0,0,1,0,0,0,0,0,0,0,0,0,0
6975,791449,27,2,4,1,2,1,2,6,6,0,2,1,0,2,0,0,11
6975,797226,1,0,0,0,0,0,0,0,0,0,0,0,0,0,0,0,0
6976,792306,38,9,14,9,11,0,3,0,2,2,8,1,2,3,6,1,18
6976,776424,27,2,5,2,4,0,1,0,0,0,4,0,2,0,0,5,4
6976,792300,32,4,10,2,8,2,2,4,6,2,1,3,3,2,4,0,14
6976,792303,24,3,8,2,7,1,1,5,8,1,3,1,5,1,4,0,12
6976,781603,32,2,4,0,1,2,3,1,3,0,6,4,3,2,0,0,7
6976,796155,6,0,1,0,0,0,1,0,0,1,0,0,0,0,1,0,0
6976,790813,13,3,6,1,1,2,5,0,0,0,3,0,1,0,0,1,8
6976,780456,9,0,1,0,1,0,0,0,0,0,0,0,2,0,1,0,0
6976,797914,12,1,5,0,0,1,5,0,1,0,0,0,2,0,0,0,3
6976,797912,2,0,1,0,0,0,1,0,0,0,0,0,0,0,0,0,0
6976,781605,5,0,0,0,0,0,0,1,2,1,1,0,1,0,0,0,1
6977,796699,20,1,6,1,4,0,2,0,0,1,5,0,1,0,1,1,2
6977,790983,29,2,7,2,4,0,3,0,0,3,7,2,4,0,5,1,4
6977,790978,28,4,9,1,3,3,6,0,0,2,1,0,0,0,1,1,11
6977,790979,29,2,9,2,7,0,2,6,8,0,7,5,2,2,5,0,10
6977,796697,29,4,9,3,6,1,3,10,11,0,3,7,3,0,0,0,19
6977,796701,17,1,2,1,2,0,0,0,0,2,1,0,1,0,1,1,2
6977,788820,25,5,10,0,2,5,8,4,5,1,2,1,3,0,0,0,19
6977,796698,10,1,3,0,1,1,2,0,0,1,0,0,2,0,3,0,3
6977,790976,7,0,1,0,1,0,0,0,0,1,1,0,2,0,0,0,0
6977,790980,6,1,3,1,2,0,1,1,1,1,2,0,0,1,0,1,3
6978,780874,29,2,5,1,2,1,3,2,2,2,5,1,2,0,0,2,7
6978,781326,23,5,10,5,10,0,0,0,4,7,4,0,2,0,1,0,10
6978,792215,32,4,12,3,7,1,5,2,2,1,4,4,3,1,2,0,11
6978,792210,24,4,9,2,6,2,3,1,1,2,3,1,4,0,2,1,11
6978,781323,40,4,16,3,11,1,5,11,13,0,6,7,2,1,4,1,20
6978,785638,11,0,0,0,0,0,0,2,2,0,0,0,1,0,0,0,2
6978,785430,16,3,6,3,6,0,0,3,4,4,4,0,3,1,1,2,9
6978,797868,21,3,7,1,4,2,3,0,1,2,2,1,1,1,0,1,8
6978,792213,3,0,0,0,0,0,0,1,2,1,1,0,0,0,0,0,1
6978,797869,1,0,0,0,0,0,0,0,0,0,0,0,0,0,0,0,0
6979,781480,37,2,10,1,5,1,5,4,4,1,2,5,2,0,1,2,9
6979,774846,20,2,7,2,7,0,0,1,1,0,2,0,4,0,1,2,5
6979,797273,28,4,7,2,4,2,3,0,0,0,5,1,4,2,3,0,10
6979,786558,34,6,14,5,10,1,4,13,13,1,5,5,4,2,2,0,26
6979,766611,21,4,9,2,6,2,3,2,4,1,1,0,4,0,1,0,12
6979,786185,20,2,3,2,3,0,0,0,1,4,2,0,1,1,1,1,4
6979,797272,10,2,5,1,2,1,3,1,1,0,0,1,1,0,0,0,6
6979,791376,30,2,7,2,2,0,5,0,0,1,4,1,2,1,0,0,4
6979,791377,0,0,0,0,0,0,0,0,0,1,0,0,0,0,0,0,0
6980,785498,26,5,9,5,8,0,1,1,2,2,3,1,3,1,0,0,11
6980,776469,40,8,13,7,10,1,3,2,5,4,6,1,1,1,3,0,19
6980,781169,41,4,9,2,5,2,4,2,3,3,5,3,4,0,3,0,12
6980,780701,43,6,11,6,10,0,1,5,6,0,4,10,2,2,5,1,17
6980,776322,39,1,8,0,0,1,8,0,0,2,4,0,1,1,0,1,3
6980,796705,17,2,9,1,3,1,6,0,0,0,2,0,2,0,1,0,5
6980,796708,16,3,4,2,3,1,1,2,2,1,1,1,1,1,2,0,9
6980,796706,0,0,0,0,0,0,0,0,0,0,0,0,0,1,0,0,0
6980,780704,3,0,0,0,0,0,0,0,0,0,0,0,0,0,0,0,0
6981,786180,7,1,2,1,2,0,0,2,2,2,0,0,3,0,0,0,4
6981,792104,42,6,13,4,6,2,7,5,5,0,8,1,3,1,5,2,19
6981,797709,23,1,4,1,3,0,1,0,0,1,1,1,0,0,1,0,2
6981,797708,33,4,10,4,7,0,3,0,0,2,1,0,4,2,0,0,8
6981,775779,38,6,13,6,12,0,1,0,1,0,3,5,1,1,1,0,12
6981,786204,16,2,6,1,3,1,3,0,1,0,5,1,3,0,1,2,5
6981,797707,28,3,9,3,9,0,0,1,2,2,1,6,2,0,3,0,7
6981,786198,16,1,2,0,0,1,2,0,0,0,0,1,1,0,1,0,3
6981,785608,22,5,6,5,6,0,0,3,4,0,2,1,1,0,0,0,13
6994,775738,11,1,3,1,3,0,0,2,2,2,1,1,0,1,0,0,4
6994,786091,14,3,5,1,2,2,3,0,0,1,0,0,0,1,0,0,8
6994,797666,13,3,5,1,1,2,4,1,1,0,4,1,3,1,0,0,9
6994,785904,14,4,7,3,5,1,2,1,1,2,2,3,1,0,3,0,10
6994,780892,16,7,9,5,6,2,3,5,6,1,3,5,1,2,1,0,21
6994,786350,8,1,1,1,1,0,0,0,0,0,1,0,0,0,1,0,2
6994,797669,6,1,2,1,1,0,1,0,0,0,1,1,0,1,1,0,2
6994,797670,11,1,3,1,3,0,0,0,0,1,1,1,1,1,0,0,2
6994,797665,12,1,2,0,0,1,2,0,0,0,1,2,0,1,0,0,3
6994,792087,12,3,6,2,4,1,2,0,0,2,8,3,2,2,2,2,7
6994,785734,16,5,8,2,2,3,6,1,1,0,2,3,3,1,0,0,14
6994,786788,12,0,3,0,1,0,2,0,0,0,2,0,0,1,1,0,0
6994,786728,21,3,3,3,3,0,0,0,2,0,2,2,1,0,1,1,6
6994,786096,18,6,10,6,7,0,3,2,2,3,4,3,1,0,2,0,14
6994,781030,16,3,8,2,4,1,4,0,0,0,2,1,0,1,0,0,7
6996,799906,27,1,3,0,1,1,2,2,2,1,4,1,2,0,2,1,5
6996,775833,33,4,7,4,7,0,0,6,8,5,7,1,2,0,6,0,14
6996,785439,39,4,8,2,5,2,3,0,0,0,0,3,0,0,1,0,10
6996,781036,40,3,11,2,6,1,5,1,3,0,5,8,4,0,3,0,8
6996,774894,30,7,10,2,3,5,7,1,1,1,3,1,2,0,2,0,20
6996,796846,12,2,5,2,4,0,1,3,4,1,0,0,3,1,1,0,7
6996,796847,12,0,0,0,0,0,0,0,0,0,0,1,1,0,1,0,0
6996,796845,7,1,1,0,0,1,1,0,0,0,0,0,0,0,0,0,3
6997,792378,26,1,4,1,3,0,1,0,0,1,3,4,2,0,2,2,2
6997,786746,36,7,14,2,6,5,8,0,0,1,3,3,2,2,1,0,19
6997,780178,22,5,6,5,6,0,0,0,0,1,0,0,2,2,0,0,10
6997,792376,40,6,11,3,6,3,5,4,5,0,5,3,1,1,0,1,19
6997,797883,26,4,9,2,5,2,4,0,0,1,1,3,3,2,3,0,10
6997,797890,21,1,5,1,4,0,1,6,6,0,0,0,2,2,1,0,8
6997,797888,4,1,1,0,0,1,1,0,0,0,0,0,1,0,0,0,3
6997,797885,8,1,2,0,0,1,2,0,0,0,0,1,1,0,0,0,3
6997,786747,14,1,2,1,1,0,1,0,0,0,3,1,1,0,1,0,2
6997,785744,3,0,0,0,0,0,0,0,0,0,0,0,0,0,0,0,0
6998,785523,15,0,3,0,3,0,0,0,0,1,1,2,4,0,3,0,0
6998,791250,34,3,13,2,5,1,8,0,2,2,11,1,4,1,2,1,7
6998,796947,30,4,11,3,8,1,3,0,0,1,3,2,4,0,1,1,9
6998,791249,35,4,13,1,4,3,9,2,2,0,1,1,3,1,1,0,13
6998,775358,25,2,10,2,4,0,6,0,0,1,2,3,4,0,1,0,4
6998,796949,17,2,3,2,3,0,0,5,6,3,4,1,4,0,2,6,9
6998,785522,6,0,1,0,0,0,1,2,2,1,0,0,0,0,0,0,2
6998,781247,30,5,9,0,2,5,7,2,5,5,2,0,4,1,3,0,17
6998,796944,8,0,0,0,0,0,0,0,0,0,1,1,1,0,1,0,0
6999,797241,25,2,6,2,6,0,0,3,6,3,4,2,3,1,0,0,7
6999,791366,22,1,6,1,4,0,2,2,4,2,7,0,2,1,1,0,4
6999,797244,20,0,3,0,2,0,1,2,2,2,1,1,3,0,0,0,2
6999,785742,36,6,13,4,8,2,5,3,4,0,6,3,2,0,4,0,17
6999,780163,39,8,18,6,12,2,6,4,7,0,6,2,2,1,2,0,22
6999,791361,18,1,4,0,1,1,3,1,4,0,0,0,3,2,2,0,4
6999,780170,15,4,5,4,5,0,0,0,0,2,3,0,1,0,1,1,8
6999,797243,7,0,2,0,1,0,1,0,0,0,0,0,0,0,0,0,0
6999,791363,7,0,1,0,1,0,0,0,0,0,1,0,1,0,1,0,0
6999,786340,11,2,4,1,1,1,3,1,1,1,0,0,3,0,1,0,6
7000,790914,18,3,7,3,7,0,0,3,4,3,2,1,3,0,2,1,9
7000,780798,38,6,12,5,6,1,6,2,2,4,3,2,2,1,0,2,15
7000,785455,27,1,5,1,2,0,3,0,0,1,2,5,3,2,4,1,2
7000,785453,32,8,18,3,5,5,13,0,0,0,6,1,2,2,2,0,21
7000,774940,20,5,8,5,8,0,0,1,2,0,2,4,4,1,1,0,11
7000,785458,27,7,11,7,11,0,0,2,6,3,3,1,2,3,5,0,16
7000,790915,14,1,7,1,7,0,0,0,0,0,0,1,4,0,1,3,2
7000,785456,2,0,0,0,0,0,0,0,0,0,0,0,0,1,0,0,0
7000,790913,8,0,0,0,0,0,0,0,0,1,2,0,1,1,4,0,0
7000,785454,14,1,4,1,1,0,3,0,0,0,0,0,1,1,0,0,2
7001,790941,2,1,2,1,2,0,0,0,0,1,0,0,1,0,1,0,2
7001,780059,29,1,7,0,6,1,1,0,0,1,4,7,5,1,4,2,3
7001,796494,28,3,10,0,2,3,8,3,4,2,1,2,1,0,2,1,12
7001,790944,27,3,10,3,6,0,4,4,4,1,3,1,1,1,1,0,10
7001,780061,36,7,15,4,5,3,10,3,3,4,4,1,2,1,4,2,20
7001,796496,16,2,5,1,2,1,3,1,2,0,3,3,2,3,2,1,6
7001,780058,20,3,7,2,4,1,3,2,2,3,1,1,0,0,1,1,9
7001,786754,23,5,8,2,3,3,5,0,1,1,0,1,3,1,4,0,13
7001,790943,18,1,4,1,4,0,0,4,4,1,3,0,3,1,3,1,6
7001,796495,1,0,0,0,0,0,0,0,0,0,0,0,1,0,0,0,0
7002,791868,23,8,10,8,10,0,0,4,4,2,2,1,1,0,2,1,20
7002,797809,17,1,4,1,4,0,0,0,0,2,3,3,2,0,0,2,2
7002,797807,33,5,9,4,7,1,2,3,4,1,6,14,1,8,1,0,14
7002,792264,32,4,9,3,8,1,1,0,0,1,6,2,2,1,0,0,9
7002,786058,26,4,9,4,9,0,0,0,0,0,2,3,0,4,0,0,8
7002,797812,14,6,6,6,6,0,0,7,7,4,5,0,3,0,0,0,19
7002,795730,20,9,13,7,9,2,4,2,2,1,3,0,2,0,0,0,22
7002,797806,3,0,1,0,0,0,1,0,0,0,0,1,0,0,0,0,0
7002,797802,9,4,5,4,5,0,0,0,0,0,1,1,2,2,0,0,8
7002,797810,3,1,1,1,1,0,0,0,0,0,0,0,1,0,0,0,2
7002,797798,5,0,1,0,1,0,0,2,2,1,0,1,0,2,0,0,2
7002,797808,2,0,1,0,1,0,0,0,0,0,1,0,0,0,0,0,0
7002,797811,7,3,5,3,4,0,1,0,0,0,1,0,1,2,0,0,6
7002,781113,6,0,0,0,0,0,0,0,0,0,0,1,1,0,1,1,0
7004,790827,20,3,4,3,3,0,1,4,7,0,5,1,2,1,1,0,10
7004,785375,18,1,1,1,1,0,0,4,5,1,8,0,2,1,0,1,6
7004,785372,34,9,19,7,16,2,3,0,0,1,3,3,1,0,3,1,20
7004,785371,25,0,2,0,2,0,0,0,0,1,0,3,1,0,1,0,0
7004,774905,26,2,9,1,4,1,5,0,1,1,2,1,0,0,0,0,5
7004,785374,8,1,1,1,1,0,0,0,0,0,2,1,3,1,0,0,2
7004,786384,21,4,8,3,5,1,3,2,2,1,1,3,0,1,1,0,11
7004,785373,11,0,2,0,1,0,1,0,0,0,1,0,1,0,0,0,0
7004,796385,10,0,1,0,1,0,0,0,0,0,2,1,2,0,0,0,0
7004,790828,8,1,2,1,2,0,0,0,0,3,2,0,2,0,1,1,2
7004,790825,17,2,6,2,4,0,2,0,0,1,0,2,1,1,1,0,4
7004,796387,2,0,0,0,0,0,0,0,0,0,0,0,0,0,1,0,0
7005,792005,12,0,4,0,2,0,2,0,0,1,2,0,3,0,0,0,0
7005,781175,30,6,8,6,8,0,0,5,7,3,11,4,4,1,2,0,17
7005,786553,32,5,12,4,7,1,5,4,4,1,1,0,0,2,1,0,15
7005,780895,36,1,8,1,7,0,1,2,2,0,4,3,3,1,0,0,4
7005,781172,31,2,4,2,2,0,2,2,2,1,2,2,3,1,2,0,6
7005,786555,28,3,12,1,4,2,8,0,0,0,1,0,0,0,1,1,8
7005,781177,14,0,1,0,0,0,1,0,0,0,1,0,2,0,1,0,0
7005,785312,17,3,9,1,5,2,4,0,0,1,1,3,1,0,2,0,8
7006,796372,23,4,4,4,4,0,0,1,3,1,3,0,4,0,1,1,9
7006,790814,37,3,6,3,5,0,1,2,4,5,4,0,3,1,1,1,8
7006,796377,30,2,4,1,3,1,1,1,2,0,1,5,1,1,3,0,6
7006,796379,36,7,14,4,6,3,8,5,7,0,5,2,4,0,0,0,22
7006,780176,32,5,13,2,4,3,9,5,6,0,5,4,4,0,2,0,18
7006,796374,11,2,5,1,2,1,3,0,0,0,0,0,1,0,0,1,5
7006,786013,14,1,1,1,1,0,0,2,2,0,1,0,5,0,1,0,4
7006,796378,17,2,4,1,3,1,1,0,0,0,1,1,0,0,1,0,5
7007,796469,24,6,8,2,3,4,5,1,1,0,7,2,4,1,2,0,17
7007,779981,28,0,1,0,1,0,0,4,7,1,8,0,2,1,2,0,4
7007,785463,37,6,14,4,9,2,5,0,0,1,1,5,3,0,3,0,14
7007,779978,24,2,3,1,2,1,1,5,6,0,3,7,4,0,0,0,10
7007,776003,34,8,14,4,7,4,7,4,4,1,2,2,1,1,0,0,24
7007,790923,20,1,2,1,2,0,0,1,2,2,1,0,2,0,1,0,3
7007,785466,11,0,1,0,0,0,1,0,0,1,0,0,1,1,1,0,0
7007,779979,17,2,6,1,1,1,5,0,0,0,0,0,1,0,0,0,5
7007,785467,5,1,2,0,0,1,2,0,1,0,0,0,1,0,0,0,3
7008,780323,14,3,4,3,4,0,0,0,0,0,0,1,5,0,1,0,6
7008,797894,18,4,5,4,5,0,0,0,0,1,2,1,3,1,1,0,8
7008,792229,31,3,6,3,5,0,1,2,4,1,0,1,4,3,2,2,8
7008,785954,36,3,6,3,4,0,2,5,5,0,7,6,1,3,0,0,11
7008,785811,32,7,16,4,11,3,5,0,0,1,3,2,5,1,3,0,17
7008,792233,23,3,14,2,7,1,7,6,9,1,3,1,2,1,4,1,13
7008,792230,6,0,1,0,0,0,1,0,0,1,0,1,3,0,0,0,0
7008,792234,11,0,2,0,2,0,0,0,0,1,2,0,0,0,0,1,0
7008,786016,20,3,4,2,3,1,1,1,2,2,0,2,2,0,1,0,8
7008,797891,4,0,0,0,0,0,0,0,0,1,0,0,0,0,0,0,0
7008,781356,5,0,0,0,0,0,0,0,0,0,0,0,2,0,0,0,0
7009,791980,30,2,4,1,1,1,3,4,4,3,3,1,3,0,1,0,9
7009,785972,35,1,6,1,5,0,1,0,2,1,3,1,2,2,3,1,2
7009,785967,25,4,9,4,9,0,0,7,9,1,7,0,4,0,2,0,15
7009,791977,36,8,11,3,4,5,7,5,6,1,0,0,2,0,2,0,26
7009,791978,29,6,12,5,10,1,2,7,8,1,2,4,2,0,4,0,20
7009,780160,13,0,0,0,0,0,0,5,8,0,1,2,5,1,1,0,5
7009,785973,18,2,4,2,3,0,1,0,0,0,0,1,2,1,1,0,4
7009,797800,14,0,1,0,1,0,0,1,2,1,1,0,0,1,1,0,1
7010,786857,24,2,8,0,1,2,7,0,0,3,3,2,3,1,6,0,6
7010,781403,39,5,14,1,5,4,9,2,2,1,11,0,1,4,1,0,16
7010,792654,25,3,7,3,7,0,0,0,0,5,3,0,2,0,4,0,6
7010,797301,29,2,8,1,3,1,5,2,2,2,3,2,2,2,4,0,7
7010,781400,35,3,12,1,4,2,8,0,0,0,3,5,2,2,3,0,8
7010,792653,5,0,0,0,0,0,0,0,0,0,0,0,1,0,2,1,0
7010,780524,18,0,5,0,3,0,2,0,0,0,2,3,0,2,1,0,0
7010,797302,9,0,2,0,2,0,0,3,4,1,1,0,0,0,2,0,3
7010,797305,3,0,1,0,1,0,0,0,0,0,1,0,1,0,1,0,0
7010,797306,4,0,0,0,0,0,0,0,0,0,0,0,0,1,0,1,0
7010,797304,5,1,1,1,1,0,0,0,0,0,0,0,0,0,0,0,2
7010,797303,4,0,0,0,0,0,0,0,0,0,0,1,0,0,0,0,0
7011,785714,28,8,11,8,10,0,1,1,2,1,8,1,1,2,2,2,17
7011,775894,32,6,8,6,8,0,0,0,0,2,4,4,0,2,0,0,12
7011,785711,32,3,9,2,5,1,4,2,3,2,4,4,2,2,3,0,9
7011,780985,27,5,10,1,1,4,9,0,0,0,3,0,0,4,2,1,14
7011,775266,33,1,9,0,1,1,8,2,2,1,5,1,0,4,2,0,5
7011,796829,9,1,4,1,4,0,0,0,2,0,0,0,1,0,1,0,2
7011,779994,13,1,4,1,3,0,1,0,0,0,2,0,1,1,0,0,2
7011,791167,15,1,3,1,1,0,2,0,0,0,0,1,4,3,3,0,2
7011,785378,7,0,1,0,1,0,0,0,0,1,0,1,2,1,3,0,0
7011,780988,3,0,0,0,0,0,0,0,0,0,0,0,0,0,1,0,0
7011,785710,1,0,0,0,0,0,0,0,0,0,0,0,0,0,0,0,0
7022,785913,22,3,5,3,5,0,0,1,3,1,2,0,2,0,1,0,7
7022,781464,29,0,5,0,2,0,3,0,0,0,4,6,2,0,1,0,0
7022,781501,26,3,6,3,6,0,0,1,3,0,2,2,2,3,4,0,7
7022,781502,32,4,8,3,4,1,4,0,0,0,2,2,3,2,1,0,9
7022,780259,39,6,12,4,4,2,8,0,1,1,9,3,3,0,1,1,14
7022,792277,9,2,4,2,4,0,0,0,0,1,2,0,2,1,0,1,4
7022,786516,14,0,4,0,1,0,3,0,0,0,2,1,0,0,1,0,0
7022,785282,28,3,5,2,2,1,3,0,0,0,1,0,2,1,2,0,7
7022,798056,1,0,0,0,0,0,0,0,0,0,0,0,0,0,0,0,0
7023,792271,18,2,5,2,5,0,0,0,1,2,5,0,2,0,1,0,4
7023,791686,27,2,6,1,4,1,2,0,0,0,6,4,2,1,1,0,5
7023,790940,39,5,13,3,6,2,7,8,9,0,6,0,0,1,1,0,20
7023,786060,24,2,3,0,1,2,2,0,0,1,1,1,0,0,2,0,6
7023,780770,37,1,7,1,5,0,2,3,3,0,2,7,1,0,4,0,5
7023,798028,20,0,1,0,1,0,0,2,3,0,0,2,3,2,0,0,2
7023,792270,4,0,0,0,0,0,0,0,0,0,0,0,1,0,0,0,0
7023,798022,14,5,10,2,4,3,6,0,0,0,2,0,1,0,0,0,13
7023,792269,17,1,1,1,1,0,0,1,1,2,1,1,4,0,0,0,3
7024,791750,30,3,5,2,3,1,2,2,2,3,5,3,4,0,1,1,9
7024,786177,30,1,6,0,0,1,6,2,2,0,7,0,3,1,1,1,5
7024,780244,22,2,4,2,3,0,1,0,0,0,2,1,2,0,0,0,4
7024,786179,37,8,19,5,10,3,9,1,1,1,2,1,3,2,1,0,20
7024,780238,24,2,7,2,5,0,2,0,0,0,1,0,1,4,1,0,4
7024,791749,20,3,6,1,2,2,4,5,5,0,3,0,0,1,1,0,13
7024,791752,2,0,0,0,0,0,0,0,0,0,1,0,0,0,2,0,0
7024,785909,3,0,0,0,0,0,0,0,0,0,0,0,2,0,0,0,0
7024,790773,10,2,3,1,1,1,2,0,0,1,1,0,0,0,0,0,5
7024,781500,22,4,13,4,10,0,3,0,0,2,0,2,3,0,2,1,8
7025,786566,38,4,10,1,6,3,4,2,2,1,10,1,0,0,2,0,13
7025,781204,19,1,4,1,3,0,1,0,0,1,3,2,3,0,1,0,2
7025,786568,9,2,2,2,2,0,0,0,0,0,1,0,0,1,3,0,4
7025,791993,33,7,10,7,9,0,1,1,1,0,2,0,3,0,1,0,15
7025,781188,36,9,14,7,11,2,3,2,4,0,3,6,4,1,2,0,22
7025,791997,28,6,9,4,5,2,4,0,1,1,2,0,1,0,1,1,14
7025,797493,2,0,0,0,0,0,0,0,0,0,0,0,0,0,0,0,0
7025,786563,5,0,1,0,1,0,0,0,0,0,0,1,0,0,0,0,0
7025,781189,30,2,9,2,8,0,1,2,2,2,7,5,2,2,2,0,6
7026,780824,13,0,1,0,1,0,0,0,0,0,5,3,4,1,2,0,0
7026,791118,43,11,19,9,15,2,4,2,2,1,3,3,0,1,1,0,26
7026,785947,27,0,2,0,2,0,0,0,0,1,2,5,1,1,2,1,0
7026,785676,36,5,11,2,3,3,8,1,2,0,2,2,2,1,0,1,14
7026,774974,35,2,6,1,5,1,1,5,6,0,1,2,4,1,2,0,10
7026,796771,18,2,6,2,4,0,2,0,0,2,2,0,3,1,2,0,4
7026,791115,14,3,4,3,4,0,0,1,2,1,1,1,4,0,2,0,7
7026,800022,11,1,3,1,3,0,0,0,0,2,2,0,0,0,0,0,2
7026,791117,28,5,8,2,4,3,4,0,0,0,2,0,2,0,1,0,13
7027,786542,36,2,4,1,2,1,2,1,2,1,5,4,0,0,3,1,6
7027,786540,29,10,11,10,11,0,0,2,5,0,4,0,1,3,2,4,22
7027,792019,33,4,5,3,3,1,2,0,0,0,3,3,3,0,0,0,9
7027,792015,34,7,13,7,10,0,3,7,8,0,4,5,3,0,3,0,21
7027,775995,42,0,3,0,1,0,2,2,2,0,3,3,2,0,4,1,2
7027,785364,16,5,7,5,7,0,0,2,6,1,3,0,0,2,2,1,12
7027,792016,20,0,2,0,1,0,1,1,2,0,0,2,0,1,2,0,1
7027,791845,15,1,2,0,0,1,2,2,2,0,0,0,0,0,0,0,5
7028,792140,25,10,15,10,15,0,0,3,4,0,5,1,3,2,2,1,23
7028,786596,27,4,5,3,4,1,1,4,5,0,7,3,3,0,3,0,13
7028,797786,16,1,4,1,1,0,3,2,3,0,5,1,2,1,0,0,4
7028,785976,24,1,6,0,2,1,4,0,0,1,1,1,1,1,0,0,3
7028,797791,3,1,1,1,1,0,0,0,0,1,0,0,0,0,0,0,2
7028,792146,13,0,2,0,2,0,0,0,0,1,0,0,1,0,2,0,0
7028,797793,8,0,1,0,0,0,1,0,1,0,1,0,1,0,0,0,0
7028,781429,35,1,6,0,0,1,6,0,0,0,2,1,1,1,2,0,3
7028,792144,10,1,2,1,1,0,1,0,0,0,2,0,1,0,0,1,2
7028,797789,8,2,3,1,1,1,2,0,0,2,1,0,1,0,0,2,5
7028,776092,31,7,17,6,14,1,3,4,4,2,4,5,3,2,3,0,19
7029,786765,32,6,13,3,7,3,6,2,3,1,5,4,4,0,4,1,17
7029,792379,33,4,10,2,3,2,7,0,0,0,10,2,2,1,5,0,10
7029,792380,38,6,15,1,2,5,13,0,1,0,2,1,2,1,1,0,17
7029,781672,30,2,6,2,6,0,0,1,2,1,6,1,1,3,1,0,5
7029,781669,36,6,13,6,10,0,3,0,0,2,2,5,3,1,2,1,12
7029,797860,7,0,1,0,1,0,0,0,0,0,0,0,2,0,0,0,0
7029,797854,3,0,0,0,0,0,0,0,0,0,0,0,0,0,0,0,0
7029,797852,21,4,5,2,3,2,2,1,3,3,2,0,5,1,0,0,11
7030,785863,23,4,8,4,8,0,0,0,0,2,7,0,1,0,3,0,8
7030,785631,27,7,9,5,5,2,4,2,3,0,3,2,2,0,0,2,18
7030,786248,17,2,6,2,6,0,0,0,0,2,4,0,4,0,0,0,4
7030,785630,28,6,7,5,6,1,1,2,2,0,4,2,2,2,3,0,15
7030,780777,29,2,9,1,6,1,3,1,2,1,3,6,1,1,3,0,6
7030,791200,22,4,11,3,7,1,4,9,9,0,0,1,3,1,1,0,18
7030,785632,23,2,6,2,5,0,1,0,0,2,3,1,0,2,0,1,4
7030,791197,7,0,2,0,2,0,0,0,0,2,2,0,0,0,0,0,0
7030,791199,16,2,2,2,2,0,0,0,0,2,3,1,1,0,0,1,4
7030,796898,2,0,0,0,0,0,0,0,0,0,1,0,0,0,0,0,0
7030,791198,2,1,2,0,0,1,2,0,0,0,0,0,0,0,0,0,3
7030,791196,2,0,1,0,0,0,1,0,0,0,0,1,1,0,0,0,0
7030,781129,2,0,0,0,0,0,0,0,0,0,0,0,0,0,0,0,0
7031,791905,33,3,7,2,3,1,4,2,2,0,4,1,3,0,2,0,9
7031,781103,22,4,10,4,8,0,2,2,2,1,5,1,2,1,1,1,10
7031,797568,31,4,11,3,7,1,4,1,2,0,0,3,1,0,2,0,10
7031,797566,30,2,5,1,3,1,2,0,0,0,1,1,3,2,0,1,5
7031,781191,34,5,12,3,7,2,5,2,2,1,3,3,2,1,5,0,14
7031,797569,11,0,2,0,0,0,2,1,2,1,0,2,2,2,0,0,1
7031,781102,15,1,2,1,2,0,0,0,0,1,2,0,1,0,0,0,2
7031,791904,5,1,2,1,1,0,1,0,0,0,0,0,0,0,0,0,2
7031,791907,12,3,4,3,4,0,0,0,1,0,1,1,1,1,0,0,6
7031,781364,2,0,1,0,1,0,0,0,1,0,1,0,0,0,0,0,0
7031,791909,3,0,0,0,0,0,0,0,0,0,1,0,0,0,0,0,0
7031,797570,2,0,0,0,0,0,0,0,0,0,0,0,0,0,0,0,0
7032,776345,18,1,8,1,8,0,0,0,0,0,4,1,2,0,0,2,2
7032,796579,29,4,8,1,2,3,6,0,0,0,4,2,3,2,2,1,11
7032,785794,32,7,11,6,8,1,3,1,2,1,2,4,0,1,0,0,16
7032,785792,23,3,5,1,2,2,3,0,0,0,4,2,1,1,0,0,8
7032,781373,20,5,7,1,2,4,5,0,0,0,2,1,3,3,4,0,14
7032,796578,2,0,0,0,0,0,0,1,2,0,2,0,0,0,0,0,1
7032,792660,2,1,1,1,1,0,0,0,0,0,0,0,0,0,0,0,2
7032,791295,16,2,5,2,5,0,0,4,5,2,4,4,1,1,1,0,8
7032,781379,6,1,2,1,2,0,0,0,2,0,0,0,0,0,0,0,2
7032,796577,12,3,4,2,2,1,2,2,2,0,3,0,2,1,0,1,9
7032,791294,3,0,0,0,0,0,0,0,0,0,0,0,0,0,0,0,0
7032,791292,8,0,0,0,0,0,0,0,0,1,3,1,0,0,1,0,0
7032,791293,15,0,0,0,0,0,0,0,0,0,1,2,0,0,2,0,0
7032,796580,8,0,2,0,1,0,1,2,2,0,1,1,2,1,0,0,2
7032,781372,3,0,0,0,0,0,0,2,3,0,1,0,0,0,0,0,2
7032,800145,2,0,1,0,0,0,1,0,0,0,0,0,1,0,1,0,0
7032,800146,1,0,0,0,0,0,0,0,0,0,1,0,0,0,0,0,0
7033,791276,30,7,12,7,12,0,0,1,2,2,5,1,4,0,1,0,15
7033,796529,30,4,10,1,4,3,6,0,0,0,1,2,0,0,2,0,11
7033,791275,30,0,6,0,3,0,3,2,3,0,6,1,2,1,6,0,2
7033,785746,37,4,8,4,5,0,3,0,0,0,4,1,4,0,1,0,8
7033,785741,30,1,8,0,5,1,3,2,2,1,7,2,1,2,4,0,5
7033,785755,10,0,0,0,0,0,0,0,0,0,1,0,5,0,1,0,0
7033,796526,7,1,3,1,2,0,1,0,0,1,1,0,0,0,0,0,2
7033,796527,3,0,2,0,2,0,0,0,0,0,0,1,0,0,0,0,0
7033,791272,2,0,0,0,0,0,0,0,0,0,0,0,1,0,0,0,0
7033,785753,1,0,0,0,0,0,0,0,0,0,0,0,0,0,0,0,0
7033,785748,20,0,5,0,2,0,3,2,3,0,1,0,2,1,0,0,2
7034,790774,26,2,6,1,3,1,3,0,0,1,0,0,0,1,0,0,5
7034,790771,38,5,11,3,6,2,5,5,5,2,12,1,2,1,0,2,17
7034,780271,38,2,11,1,3,1,8,3,4,2,3,3,2,2,0,0,8
7034,790772,36,8,22,5,13,3,9,1,1,1,4,1,2,2,2,0,20
7034,780375,30,4,12,3,6,1,6,4,4,0,3,4,4,2,2,0,13
7034,780022,27,1,5,1,3,0,2,0,2,0,3,1,4,1,0,0,2
7034,792438,5,0,0,0,0,0,0,0,0,0,2,0,0,0,0,0,0
7035,785442,23,4,4,2,2,2,2,0,0,2,6,1,2,0,1,0,10
7035,796447,7,0,0,0,0,0,0,0,0,0,4,0,1,0,0,1,0
7035,799907,23,3,3,3,3,0,0,0,0,0,5,2,0,0,3,0,6
7035,785579,30,0,4,0,1,0,3,4,6,0,3,0,2,0,1,1,4
7035,775959,8,0,3,0,1,0,2,0,0,0,1,1,1,0,0,0,0
7035,790899,25,4,6,4,6,0,0,5,6,3,7,0,4,1,4,1,13
7035,781628,28,6,15,4,9,2,6,3,6,0,5,3,3,1,1,1,17
7035,790898,20,4,10,4,6,0,4,0,1,1,3,1,0,0,2,0,8
7035,775737,18,3,5,0,0,3,5,0,0,0,2,1,1,1,0,0,9
7035,790897,18,1,8,1,4,0,4,0,1,2,3,1,3,0,1,0,2
7036,785996,29,5,7,4,5,1,2,3,4,3,4,0,2,0,0,0,14
7036,780858,26,2,7,1,1,1,6,1,2,0,1,0,3,1,2,1,6
7036,797646,22,3,9,3,7,0,2,0,0,0,2,2,1,1,3,0,6
7036,780849,24,0,4,0,3,0,1,2,2,1,0,1,0,0,0,0,2
7036,780853,34,6,9,5,8,1,1,5,7,2,3,4,3,2,3,0,18
7036,792235,11,2,4,2,4,0,0,3,6,0,5,0,1,0,2,0,7
7036,785990,18,1,3,0,1,1,2,0,0,0,1,2,1,0,3,0,3
7036,786010,16,0,1,0,1,0,0,0,0,0,2,2,3,0,1,0,0
7036,792039,6,0,0,0,0,0,0,2,2,0,0,0,0,1,1,0,2
7036,780776,7,0,2,0,2,0,0,1,2,0,0,0,0,0,0,0,1
7036,785998,7,2,3,0,0,2,3,0,0,0,1,0,0,0,0,0,6
7037,776286,28,4,7,3,3,1,4,2,5,2,6,2,1,2,2,0,11
7037,775557,19,2,2,2,2,0,0,0,0,1,2,0,1,0,1,3,4
7037,791445,34,3,9,3,3,0,6,1,1,0,2,7,2,3,0,0,7
7037,785357,35,10,21,4,11,6,10,3,5,1,3,2,3,1,1,0,29
7037,775560,31,8,13,7,10,1,3,0,0,1,3,8,2,2,2,0,17
7037,797010,14,1,3,1,3,0,0,2,2,1,1,0,2,2,1,0,4
7037,785895,6,0,2,0,0,0,2,0,0,0,1,0,1,0,0,0,0
7037,791444,12,2,2,2,2,0,0,0,1,1,0,0,1,0,0,1,4
7037,785287,21,3,3,3,3,0,0,0,1,2,4,0,5,0,1,1,6
7038,792158,22,2,8,1,7,1,1,2,2,4,3,1,4,6,3,0,7
7038,780138,30,10,12,10,12,0,0,3,4,4,6,1,2,4,2,0,23
7038,792154,32,5,7,4,4,1,3,1,1,0,1,4,3,1,5,0,12
7038,786014,32,5,10,3,6,2,4,2,2,0,1,2,0,1,1,0,14
7038,780581,29,4,7,2,4,2,3,0,0,1,2,10,1,2,3,1,10
7038,797755,8,0,1,0,1,0,0,0,0,0,1,0,2,1,3,0,0
7038,792162,1,0,1,0,1,0,0,0,0,0,0,0,0,0,0,0,0
7038,792157,19,6,8,6,8,0,0,2,2,2,1,0,1,3,2,0,14
7038,797756,21,0,3,0,2,0,1,0,0,0,1,5,1,0,1,0,0
7038,792159,5,0,1,0,0,0,1,0,0,0,0,0,1,0,0,0,0
7038,797759,1,0,0,0,0,0,0,0,0,0,0,0,1,0,0,0,0
7039,797861,9,1,1,1,1,0,0,0,0,0,1,1,1,0,0,0,2
7039,797859,18,1,4,0,2,1,2,2,2,0,0,0,2,0,2,0,5
7039,792208,22,3,4,3,4,0,0,0,2,0,3,0,2,1,3,0,6
7039,786262,10,0,2,0,0,0,2,0,0,0,0,0,0,0,0,0,0
7039,786983,25,8,8,8,8,0,0,4,4,2,3,1,1,3,1,1,20
7039,797862,5,0,0,0,0,0,0,0,0,0,0,0,0,0,0,1,0
7039,781314,13,1,3,1,2,0,1,0,0,0,1,0,0,1,4,0,2
7039,797863,5,1,1,0,0,1,1,0,0,0,0,0,0,0,1,0,3
7039,776018,18,4,4,4,4,0,0,0,0,2,0,1,3,0,0,0,8
7039,797858,18,3,7,2,4,1,3,4,5,1,2,1,0,1,3,0,11
7039,797856,20,0,2,0,2,0,0,1,2,1,0,3,1,3,1,0,1
7039,792206,5,1,2,1,2,0,0,0,0,0,0,1,1,0,1,0,2
7039,792204,16,1,5,1,1,0,4,0,0,0,0,1,0,1,4,0,2
7039,786682,13,2,4,0,0,2,4,0,0,0,1,1,1,0,1,0,6
7039,781317,3,0,0,0,0,0,0,0,0,0,0,0,0,0,2,0,0
7040,780201,32,1,8,1,8,0,0,5,8,0,5,0,2,2,2,1,7
7040,791469,31,2,6,2,6,0,0,2,6,4,9,0,3,0,2,4,6
7040,797210,39,7,13,7,11,0,2,10,10,1,2,5,3,1,3,0,24
7040,786311,38,4,13,1,6,3,7,3,3,1,2,2,1,1,1,0,14
7040,775516,18,2,5,2,2,0,3,1,2,2,2,2,1,2,1,0,5
7040,798344,23,2,5,2,4,0,1,2,2,1,4,1,3,0,0,0,6
7040,791467,19,4,10,3,7,1,3,0,0,2,1,0,3,0,0,0,9
7041,775563,32,4,13,4,11,0,2,3,4,3,7,2,3,0,4,1,11
7041,781011,27,7,11,7,11,0,0,2,3,5,5,1,4,1,0,2,16
7041,797601,28,2,6,1,1,1,5,0,0,0,1,2,1,1,2,0,5
7041,781012,36,6,10,1,2,5,8,1,2,0,5,3,3,1,1,0,18
7041,775119,28,5,9,4,7,1,2,1,1,0,3,4,4,0,3,0,12
7041,797602,5,0,3,0,1,0,2,0,0,1,1,0,1,0,0,0,0
7041,775806,23,5,10,5,8,0,2,0,2,1,4,1,2,0,1,0,10
7041,797604,10,0,0,0,0,0,0,0,0,1,2,1,2,0,0,0,0
7041,786466,11,1,3,1,2,0,1,2,3,0,0,0,0,0,0,0,4
7042,790870,23,5,6,5,6,0,0,0,0,1,4,5,3,2,1,1,10
7042,790869,38,6,13,6,9,0,4,0,0,0,8,2,2,2,6,0,12
7042,780116,33,5,7,3,4,2,3,6,8,0,6,0,1,0,1,3,18
7042,796421,35,3,5,3,5,0,0,0,0,1,6,5,4,0,3,0,6
7042,790866,35,3,8,1,3,2,5,5,5,0,2,0,0,0,2,0,13
7042,780493,27,2,6,0,0,2,6,0,0,1,3,0,2,0,0,1,6
7042,796427,9,0,4,0,3,0,1,0,0,0,1,0,0,0,1,0,0
7043,797655,13,1,4,1,4,0,0,1,2,0,3,1,2,0,0,0,3
7043,797657,35,2,7,0,1,2,6,2,2,1,3,0,0,0,2,0,8
7043,792072,39,1,4,1,1,0,3,0,0,0,3,2,3,0,0,0,2
7043,792069,36,3,14,1,10,2,4,5,7,1,1,3,1,2,0,0,13
7043,785572,24,2,7,2,5,0,2,2,2,1,4,2,1,0,1,1,6
7043,786025,2,0,0,0,0,0,0,0,0,0,0,0,0,0,0,0,0
7043,784640,23,4,8,3,6,1,2,0,2,0,2,1,2,1,2,2,9
7043,797652,28,5,8,5,7,0,1,2,4,0,6,0,5,1,3,0,12
7044,797111,22,3,3,3,3,0,0,0,0,1,3,1,0,1,2,0,6
7044,797110,15,3,6,1,1,2,5,0,0,1,0,0,4,0,2,0,8
7044,791407,38,8,16,4,9,4,7,0,0,0,3,1,1,2,4,0,20
7044,785928,40,4,6,2,2,2,4,2,2,1,4,4,2,2,1,0,12
7044,785923,31,3,5,3,5,0,0,0,0,0,2,4,2,2,5,0,6
7044,791403,30,4,9,4,9,0,0,2,2,0,4,2,5,1,1,0,10
7044,797114,6,0,2,0,2,0,0,0,0,0,1,1,3,0,2,0,0
7044,791406,4,0,0,0,0,0,0,0,0,0,0,0,0,0,0,0,0
7044,791404,14,2,4,1,1,1,3,0,0,0,1,2,0,0,0,0,5
7045,791923,33,7,10,7,10,0,0,1,2,1,3,2,1,2,1,1,15
7045,781122,16,3,4,3,4,0,0,0,0,0,1,0,2,1,1,0,6
7045,791925,31,3,6,3,5,0,1,0,1,0,9,3,2,0,3,0,6
7045,786527,27,3,4,1,1,2,3,2,2,2,1,1,1,1,0,0,10
7045,781112,15,0,1,0,0,0,1,1,2,0,1,3,2,0,2,0,1
7045,786529,13,0,0,0,0,0,0,0,0,0,1,1,3,0,0,0,0
7045,797541,15,5,7,5,7,0,0,1,2,2,2,0,0,0,2,0,11
7045,797542,12,2,4,2,4,0,0,1,2,0,0,0,0,0,2,0,5
7045,791927,8,1,3,1,2,0,1,1,2,0,0,0,0,0,1,0,3
7045,791926,8,0,2,0,0,0,2,0,0,0,1,1,0,1,0,0,0
7045,786858,22,5,10,4,8,1,2,0,0,0,1,2,1,1,1,0,11
7046,780651,30,4,8,4,8,0,0,1,4,1,12,3,2,0,2,1,9
7046,791815,36,6,18,4,12,2,6,2,2,1,4,0,3,0,1,0,16
7046,791810,7,0,1,0,0,0,1,0,0,0,0,2,0,0,0,1,0
7046,791814,33,4,10,1,4,3,6,2,2,0,2,3,1,1,0,1,13
7046,780650,36,5,12,3,9,2,3,5,8,3,8,6,1,6,0,0,17
7046,791809,3,0,1,0,1,0,0,0,0,0,0,0,0,0,0,1,0
7046,791812,9,1,2,1,1,0,1,1,1,0,1,0,2,0,1,1,3
7046,781596,5,0,0,0,0,0,0,0,0,0,1,0,2,0,0,0,0
7046,797373,6,0,2,0,0,0,2,0,0,0,0,1,0,1,0,0,0
7046,786645,26,3,7,3,6,0,1,3,3,3,1,1,2,1,0,0,9
7046,786644,9,0,2,0,0,0,2,0,0,0,0,0,0,0,0,0,0
7047,781407,21,3,5,3,4,0,1,1,4,1,5,0,2,0,1,1,7
7047,791583,18,3,6,3,6,0,0,4,4,2,6,1,5,1,1,1,10
7047,797445,24,0,8,0,6,0,2,0,0,2,2,1,2,0,2,1,0
7047,780580,34,4,14,2,6,2,8,5,6,0,7,1,2,1,4,0,15
7047,776150,33,5,12,2,6,3,6,3,4,1,3,3,0,1,0,0,16
7047,797448,12,0,1,0,0,0,1,0,1,2,2,1,2,0,0,1,0
7047,786608,14,1,2,0,1,1,1,0,0,2,1,0,0,0,1,0,3
7047,786110,16,1,6,0,2,1,4,0,0,0,0,1,2,0,0,1,3
7047,785623,25,2,3,0,1,2,2,0,0,0,4,0,2,0,2,0,6
7047,786659,3,0,1,0,1,0,0,0,0,0,1,0,0,0,1,0,0
7048,786132,27,0,1,0,0,0,1,5,6,2,4,4,0,1,1,0,5
7048,775074,12,3,4,3,4,0,0,0,0,0,2,2,4,1,2,0,6
7048,786448,31,6,7,5,5,1,2,2,2,1,5,1,3,1,0,0,15
7048,780731,36,8,14,7,10,1,4,4,4,1,2,3,0,0,2,0,21
7048,780462,35,5,12,0,3,5,9,0,0,0,2,3,3,1,3,0,15
7048,786447,26,3,4,3,4,0,0,3,5,2,4,4,4,3,2,2,9
7048,791632,15,2,4,2,2,0,2,0,0,1,2,1,2,1,0,1,4
7048,796971,16,2,5,1,3,1,2,0,0,0,3,3,0,0,1,0,5
7048,791631,2,0,0,0,0,0,0,0,0,0,0,0,0,1,0,0,0
7049,780021,25,2,4,2,4,0,0,2,6,1,5,2,3,0,3,1,6
7049,785412,24,3,11,3,6,0,5,0,0,0,0,2,0,1,4,0,6
7049,780099,29,1,2,1,1,0,1,1,3,0,1,2,4,1,0,0,3
7049,776214,32,6,15,1,6,5,9,0,0,0,2,3,2,3,1,0,17
7049,790863,24,4,6,3,4,1,2,0,2,1,2,0,3,0,1,0,9
7049,775686,15,1,1,1,1,0,0,1,2,0,0,2,1,0,1,0,3
7049,785413,17,4,6,2,4,2,2,0,0,0,0,1,1,0,0,1,10
7049,776221,12,0,0,0,0,0,0,0,0,0,1,3,1,0,1,0,0
7049,785417,10,2,2,2,2,0,0,1,2,1,1,0,0,0,0,0,5
7049,785411,12,0,0,0,0,0,0,0,0,0,0,0,0,1,1,0,0
7050,781007,17,0,0,0,0,0,0,1,3,3,3,2,3,2,2,0,1
7050,781322,34,6,12,4,6,2,6,0,0,1,6,1,1,0,2,0,14
7050,785989,33,2,9,2,6,0,3,2,4,2,8,5,2,0,3,1,6
7050,786571,29,2,8,2,7,0,1,2,4,0,4,2,0,1,2,0,6
7050,781439,25,4,10,1,5,3,5,1,2,1,1,2,4,0,5,0,12
7050,781207,13,1,3,1,3,0,0,1,2,0,5,0,2,2,2,0,3
7050,797299,10,1,1,1,1,0,0,0,0,0,1,0,5,0,0,1,2
7050,781419,19,1,4,1,4,0,0,0,0,0,2,0,0,0,0,0,2
7050,791690,9,1,1,1,1,0,0,0,2,1,2,1,2,0,1,0,2
7050,780563,10,0,1,0,1,0,0,0,0,0,0,0,0,0,0,0,0
7050,791691,0,0,0,0,0,0,0,0,0,0,0,0,0,0,0,0,0
7050,797300,1,0,0,0,0,0,0,0,0,0,0,0,0,0,0,0,0
7051,790930,27,1,8,1,3,0,5,1,2,0,4,1,2,2,1,0,3
7051,780358,24,2,8,2,5,0,3,4,4,3,2,2,2,0,0,1,8
7051,775011,27,3,12,2,7,1,5,2,2,1,3,1,2,0,0,0,9
7051,780357,29,3,7,0,1,3,6,0,0,1,2,3,3,3,2,0,9
7051,775018,37,3,14,1,7,2,7,1,2,1,7,3,2,2,0,0,9
7051,776004,15,1,2,1,2,0,0,3,4,1,1,1,1,0,2,1,5
7051,796480,18,4,7,3,4,1,3,1,1,0,3,1,3,2,2,1,10
7051,776270,18,3,4,1,1,2,3,0,0,0,2,0,0,0,0,0,8
7051,785496,1,0,0,0,0,0,0,0,0,0,1,0,0,0,0,0,0
7051,796483,1,0,0,0,0,0,0,0,0,0,0,0,1,0,0,0,0
7051,785491,1,0,0,0,0,0,0,0,2,0,0,0,0,0,0,0,0
7051,796485,1,0,0,0,0,0,0,0,0,0,0,0,0,0,0,0,0
7051,796486,1,0,0,0,0,0,0,0,0,0,0,0,0,0,0,0,0
7060,781046,37,3,7,2,4,1,3,2,3,2,8,2,1,0,1,0,9
7060,780025,32,6,8,6,8,0,0,5,9,2,4,2,2,1,0,1,17
7060,796391,33,2,5,2,3,0,2,3,4,0,4,1,1,2,1,0,7
7060,785385,38,3,11,1,6,2,5,2,3,3,4,6,1,0,1,0,10
7060,785383,36,5,14,3,9,2,5,5,7,2,4,2,3,3,4,0,17
7060,786297,6,2,4,2,4,0,0,0,0,2,0,0,0,0,1,1,4
7060,790837,8,1,1,1,1,0,0,1,1,0,0,1,4,0,0,1,3
7060,785382,7,1,3,0,1,1,2,0,0,0,0,0,0,0,0,0,3
7060,792180,3,0,0,0,0,0,0,0,0,0,0,0,1,0,1,0,0
7061,796812,28,4,9,4,9,0,0,1,1,2,6,0,4,2,0,5,9
7061,780952,29,2,4,2,4,0,0,0,0,2,4,0,5,1,0,1,4
7061,780950,21,2,12,1,4,1,8,0,0,1,1,0,0,0,0,0,5
7061,791156,16,2,5,2,4,0,1,0,0,0,0,1,4,0,2,0,4
7061,786609,28,5,12,3,7,2,5,1,2,3,6,0,5,1,2,1,13
7061,796810,31,5,12,4,9,1,3,3,6,0,2,6,2,2,5,0,14
7061,796814,28,3,6,3,3,0,3,0,0,0,4,2,2,0,2,1,6
7061,780945,6,2,2,2,2,0,0,0,0,1,0,0,1,0,0,0,4
7061,785752,13,0,0,0,0,0,0,0,0,0,0,0,0,0,0,0,0
7062,785800,26,3,8,2,3,1,5,1,2,1,1,0,1,1,1,0,8
7062,785799,21,3,8,3,8,0,0,2,4,1,2,0,2,1,2,2,8
7062,791676,22,2,4,0,0,2,4,5,5,0,1,1,3,1,2,0,11
7062,780554,32,0,3,0,0,0,3,0,1,1,0,1,2,0,2,0,0
7062,780553,35,10,17,10,16,0,1,2,2,3,5,3,1,3,4,0,22
7062,797426,9,0,0,0,0,0,0,0,0,0,0,1,1,0,0,0,0
7062,791678,6,1,2,1,2,0,0,2,2,1,1,1,0,0,0,0,4
7062,785807,13,0,1,0,0,0,1,0,0,0,3,0,2,0,0,0,0
7062,780760,13,2,3,0,1,2,2,2,4,0,1,0,3,0,0,0,8
7062,797427,8,0,1,0,0,0,1,0,0,0,0,0,0,1,0,0,0
7062,791677,15,1,1,0,0,1,1,0,0,0,3,2,1,0,0,0,3
7063,796542,19,1,1,1,1,0,0,2,2,0,0,0,0,0,2,0,4
7063,781335,23,2,11,0,4,2,7,1,2,0,3,4,2,0,4,0,7
7063,776351,35,6,14,3,6,3,8,4,5,6,10,1,3,1,4,1,19
7063,785770,36,2,10,1,5,1,5,4,4,6,2,1,2,0,2,0,9
7063,781341,34,2,10,0,2,2,8,0,0,1,2,2,1,2,2,0,6
7063,791285,4,0,0,0,0,0,0,0,0,0,0,0,1,0,0,0,0
7063,785775,22,3,6,3,4,0,2,1,3,3,3,1,4,1,2,1,7
7063,796538,6,0,0,0,0,0,0,0,0,0,0,0,2,0,0,0,0
7063,791284,6,0,1,0,0,0,1,0,0,2,0,0,0,1,0,0,0
7063,791283,5,0,1,0,0,0,1,0,0,0,0,0,1,0,0,1,0
7063,785767,10,2,3,1,1,1,2,1,2,0,1,1,1,1,2,0,6
7064,786526,30,5,10,5,7,0,3,2,3,0,7,0,3,0,1,2,12
7064,786525,42,2,8,0,3,2,5,0,0,0,2,0,5,3,3,0,6
7064,786856,40,5,11,5,11,0,0,1,1,2,3,5,4,0,0,1,11
7064,786030,42,7,15,4,7,3,8,2,3,1,2,4,4,4,5,2,19
7064,781109,25,2,4,1,2,1,2,0,0,0,5,2,1,0,0,2,5
7064,791914,28,0,8,0,3,0,5,2,3,1,2,3,2,0,0,0,2
7064,786524,19,4,5,3,3,1,2,0,0,0,5,2,5,1,1,0,9
7064,791917,24,4,7,1,2,3,5,1,2,1,1,0,2,0,1,0,12
7064,791920,0,0,0,0,0,0,0,0,0,0,0,0,0,0,0,0,0
7065,791401,43,5,11,5,11,0,0,0,2,4,10,1,1,0,2,0,10
7065,780125,33,2,6,2,6,0,0,3,5,4,3,2,3,1,1,0,7
7065,791400,44,6,15,2,7,4,8,7,8,0,5,3,3,4,4,1,23
7065,785931,31,0,5,0,1,0,4,2,5,0,1,5,4,0,1,1,2
7065,780118,40,5,12,2,7,3,5,11,12,1,1,2,3,3,2,0,24
7065,797130,14,0,3,0,1,0,2,0,0,0,1,3,1,0,2,0,0
7065,797126,8,2,4,2,3,0,1,0,1,1,2,0,1,0,0,0,4
7065,786837,17,2,5,1,2,1,3,2,2,0,5,0,1,0,1,0,7
7065,797132,15,0,1,0,0,0,1,2,3,1,1,1,1,1,0,0,2
7065,797125,5,0,0,0,0,0,0,0,0,0,0,0,0,0,0,0,0
7066,792249,28,4,4,4,4,0,0,1,2,2,8,3,0,0,1,4,9
7066,781430,36,8,11,8,9,0,2,5,7,1,11,6,2,2,4,2,21
7066,792248,34,5,10,2,3,3,7,4,6,0,4,3,1,0,3,0,17
7066,781445,34,6,18,4,6,2,12,0,0,1,1,1,2,2,1,0,14
7066,768845,32,2,6,2,5,0,1,3,4,1,3,5,1,0,2,3,7
7066,781448,16,0,1,0,1,0,0,2,2,0,2,2,3,0,0,1,2
7066,797941,12,0,3,0,3,0,0,0,0,1,1,0,3,0,0,0,0
7066,792250,8,3,4,0,0,3,4,0,0,1,0,1,1,0,0,0,9
7067,791220,21,5,7,3,5,2,2,1,2,2,1,1,3,3,2,0,13
7067,791219,28,0,7,0,4,0,3,0,0,3,5,1,4,0,2,0,0
7067,776217,26,2,5,2,5,0,0,0,0,5,3,2,0,3,0,2,4
7067,786396,28,3,10,2,6,1,4,2,2,1,4,2,3,0,1,0,9
7067,780730,35,9,21,6,11,3,10,0,1,0,3,3,3,1,2,1,21
7067,786824,15,2,6,1,4,1,2,0,0,0,4,0,2,0,0,1,5
7067,791221,12,1,2,1,1,0,1,2,2,0,4,0,1,0,0,1,4
7067,790818,28,6,15,5,12,1,3,2,2,0,0,3,3,0,0,0,15
7067,796921,7,0,0,0,0,0,0,0,0,0,0,0,0,0,0,0,0
7068,786054,14,2,5,2,5,0,0,2,5,0,1,0,1,1,0,0,6
7068,791964,37,6,12,6,8,0,4,6,8,0,4,0,2,2,2,0,18
7068,786056,15,0,3,0,1,0,2,0,0,0,0,2,0,0,0,0,0
7068,781339,18,1,4,0,1,1,3,0,0,0,1,1,1,0,2,0,3
7068,781337,31,0,5,0,3,0,2,0,0,0,2,1,1,0,2,0,0
7068,797713,2,0,0,0,0,0,0,0,0,0,0,0,1,0,0,0,0
7068,797712,7,1,1,1,1,0,0,0,0,0,2,0,1,0,2,2,2
7068,792041,17,3,6,1,2,2,4,0,0,1,1,1,2,1,1,0,8
7068,799737,18,0,2,0,0,0,2,0,0,0,0,1,1,1,3,0,0
7068,797711,28,6,9,4,6,2,3,1,1,0,5,2,3,2,0,0,15
7068,797710,13,5,6,2,2,3,4,1,1,0,1,2,3,0,1,0,14
7069,786646,22,1,4,0,2,1,2,4,4,0,4,0,3,1,0,0,7
7069,780890,25,6,7,6,6,0,1,4,4,0,2,0,4,1,0,0,16
7069,786066,37,7,14,4,9,3,5,4,6,2,3,7,1,2,4,1,21
7069,780167,35,2,7,1,4,1,3,2,2,1,4,2,3,0,2,0,7
7069,775574,37,7,13,2,4,5,9,2,2,1,6,1,0,1,2,1,21
7069,775757,5,1,1,1,1,0,0,1,2,0,0,1,3,0,0,0,3
7069,791123,11,0,1,0,1,0,0,0,0,1,0,0,1,0,1,0,0
7069,785636,28,1,5,0,0,1,5,0,0,0,5,0,1,1,2,0,3
7070,790846,23,3,5,2,4,1,1,0,0,3,2,1,3,1,1,2,7
7070,796755,10,0,2,0,2,0,0,0,0,1,1,0,2,0,1,0,0
7070,791099,27,1,3,0,0,1,3,0,0,0,2,0,2,3,0,0,3
7070,785470,35,2,11,1,7,1,4,2,2,0,6,1,0,0,0,1,7
7070,780298,37,10,19,5,9,5,10,2,3,1,3,2,3,0,1,0,27
7070,780315,11,0,2,0,1,0,1,0,0,0,0,0,1,0,1,0,0
7070,785586,30,3,7,3,6,0,1,3,6,3,3,1,1,0,1,0,9
7070,796754,17,2,4,2,3,0,1,1,2,3,2,0,2,0,1,0,5
7070,780814,10,1,2,1,1,0,1,0,0,1,0,0,2,0,0,0,2
7071,786029,25,5,7,5,7,0,0,2,2,1,2,0,3,1,2,0,12
7071,781398,30,2,5,2,4,0,1,1,2,2,3,1,1,0,1,0,5
7071,797737,15,0,2,0,2,0,0,0,0,0,0,2,1,0,1,1,0
7071,792114,33,1,8,0,4,1,4,2,4,1,2,2,0,0,0,0,5
7071,786018,36,4,13,2,7,2,6,6,6,3,7,1,1,0,0,2,16
7071,786022,11,0,1,0,1,0,0,0,0,0,1,0,2,0,0,0,0
7071,797746,10,1,3,0,2,1,1,3,5,4,0,0,2,0,0,0,6
7071,775678,25,6,10,3,6,3,4,2,2,0,1,2,2,1,3,0,17
7071,797740,11,0,2,0,1,0,1,0,0,0,0,0,1,0,0,0,0
7071,792112,4,0,0,0,0,0,0,0,0,0,0,0,1,0,2,0,0
7072,781462,31,4,11,4,9,0,2,0,0,2,4,1,2,1,2,0,8
7072,780876,35,4,9,4,6,0,3,4,5,0,3,4,1,0,0,1,12
7072,785353,34,1,10,1,5,0,5,0,0,0,3,3,0,0,2,1,2
7072,781673,35,1,4,0,1,1,3,2,2,0,3,0,2,3,0,0,5
7072,781457,40,7,12,5,7,2,5,2,2,0,3,2,1,1,4,0,18
7072,785355,14,1,4,0,1,1,3,0,0,0,0,0,2,1,0,0,3
7072,790895,11,0,0,0,0,0,0,1,2,0,0,1,1,0,0,0,1
7073,775510,40,4,7,4,6,0,1,0,0,0,10,5,1,1,1,0,8
7073,774976,38,3,5,3,3,0,2,0,0,1,8,1,3,1,2,4,6
7073,797865,24,3,7,2,4,1,3,0,0,0,5,2,1,0,4,2,7
7073,786614,38,7,11,5,7,2,4,2,2,1,4,1,3,0,3,1,18
7073,786759,38,5,13,1,5,4,8,0,0,1,2,6,1,0,1,0,14
7073,792293,2,0,1,0,0,0,1,0,0,0,0,0,0,0,1,0,0
7073,792291,18,2,5,2,4,0,1,0,0,0,1,1,0,0,0,0,4
7073,792292,2,0,0,0,0,0,0,0,0,0,0,0,0,0,0,0,0
7074,792373,29,3,9,3,9,0,0,0,1,1,2,0,2,0,1,1,6
7074,792370,38,5,13,2,7,3,6,4,5,1,3,1,3,0,4,2,17
7074,797951,28,3,7,1,2,2,5,2,3,0,5,1,0,3,4,0,10
7074,786739,18,1,5,1,5,0,0,0,0,0,0,2,2,1,1,0,2
7074,775303,34,2,5,2,3,0,2,1,1,1,7,0,1,2,2,1,5
7074,797958,15,0,4,0,1,0,3,0,0,0,1,0,0,0,1,0,0
7074,792369,1,0,0,0,0,0,0,0,0,0,0,0,0,0,0,0,0
7074,781598,9,2,4,1,1,1,3,0,0,0,0,0,3,0,1,0,5
7074,792371,1,0,1,0,1,0,0,0,0,0,0,1,0,0,0,0,0
7074,797949,1,0,0,0,0,0,0,0,0,0,0,0,0,0,0,0,0
7074,781597,2,1,1,0,0,1,1,0,1,0,1,0,0,0,0,0,3
7074,776491,24,2,5,2,5,0,0,0,0,2,5,2,1,0,0,0,4
7075,791011,28,4,6,2,3,2,3,0,1,2,5,0,4,0,1,1,10
7075,780303,30,4,11,4,10,0,1,3,4,0,8,1,1,0,2,1,11
7075,786349,25,3,4,2,3,1,1,0,1,0,3,1,2,3,1,0,7
7075,781221,28,3,10,1,3,2,7,2,2,0,1,5,0,0,1,0,10
7075,781385,27,5,12,2,4,3,8,0,0,0,1,4,3,2,4,0,13
7075,796670,6,0,1,0,1,0,0,0,0,0,1,0,0,0,1,0,0
7075,796671,2,0,0,0,0,0,0,0,0,0,1,0,0,0,0,0,0
7075,785337,24,4,6,3,5,1,1,2,2,2,3,2,1,0,1,0,11
7075,796668,1,0,0,0,0,0,0,0,0,0,0,0,0,0,0,0,0
7075,791008,1,0,1,0,1,0,0,0,0,0,0,0,0,0,0,0,0
7075,791013,1,0,0,0,0,0,0,0,0,0,0,0,0,0,0,0,0
7075,791012,27,5,11,1,2,4,9,0,0,4,4,2,1,1,1,0,14
7076,780027,35,8,20,7,16,1,4,5,6,4,6,2,2,1,1,2,22
7076,786176,35,9,14,4,7,5,7,3,4,0,10,1,2,1,0,0,26
7076,786173,17,0,3,0,2,0,1,0,0,0,2,3,3,0,0,0,0
7076,780028,13,0,1,0,1,0,0,0,0,0,1,1,2,0,1,0,0
7076,774828,32,3,6,0,1,3,5,3,4,0,1,7,0,0,4,0,12
7076,791379,14,2,3,1,1,1,2,0,0,0,1,3,0,2,0,1,5
7076,780029,11,1,4,1,2,0,2,2,2,3,2,0,0,1,2,1,4
7076,797175,27,3,6,2,4,1,2,3,4,4,2,1,0,1,0,1,10
7076,791380,5,0,1,0,1,0,0,0,0,0,0,1,1,0,1,0,0
7076,797178,6,0,1,0,1,0,0,0,0,1,1,1,2,0,0,0,0
7076,797179,4,0,1,0,1,0,0,0,0,0,0,0,1,0,0,0,0
7076,797176,1,0,0,0,0,0,0,0,0,0,0,0,0,0,0,0,0
7077,780634,12,1,3,1,3,0,0,0,0,1,0,0,3,0,0,1,2
7077,791826,28,3,5,2,3,1,2,0,1,2,1,2,1,2,2,1,7
7077,786785,27,4,9,4,5,0,4,1,1,1,2,2,3,0,2,1,9
7077,786783,28,3,11,2,4,1,7,0,0,3,4,4,0,1,0,0,7
7077,780633,30,5,12,4,6,1,6,0,0,0,5,5,1,0,1,1,11
7077,797389,22,4,5,4,5,0,0,0,0,2,3,0,3,0,0,0,8
7077,780635,5,2,2,2,2,0,0,0,0,0,1,0,1,0,0,0,4
7077,786784,15,1,5,1,3,0,2,2,2,0,3,0,4,1,2,0,4
7077,776009,25,4,10,2,5,2,5,0,0,0,0,4,3,2,1,0,10
7077,797387,4,0,0,0,0,0,0,1,2,1,0,0,0,0,1,0,1
7077,797390,1,0,0,0,0,0,0,0,0,0,0,0,1,0,0,0,0
7077,797388,1,1,1,0,0,1,1,0,0,0,0,0,0,0,0,0,3
7077,800144,2,0,1,0,0,0,1,0,0,0,0,1,0,0,0,0,0
7078,797367,13,1,2,1,2,0,0,2,4,2,0,2,4,1,0,2,4
7078,797369,28,2,5,1,3,1,2,0,1,0,1,1,4,0,3,0,5
7078,797366,32,2,6,2,5,0,1,7,10,4,5,2,4,4,2,0,11
7078,791807,37,4,11,1,3,3,8,5,6,0,5,2,3,2,0,0,16
7078,786130,19,1,7,1,2,0,5,0,0,1,1,0,1,0,2,0,2
7078,797371,12,2,3,2,3,0,0,0,0,2,3,1,3,1,0,2,4
7078,797368,5,2,2,2,2,0,0,1,1,0,1,1,3,0,1,0,5
7078,797364,9,2,2,2,2,0,0,0,1,1,0,0,2,0,0,0,4
7078,797365,14,0,2,0,0,0,2,0,0,0,1,0,2,0,1,1,0
7078,797363,27,7,11,3,5,4,6,8,8,0,1,4,2,0,3,0,26
7078,791808,4,1,1,1,1,0,0,0,0,0,1,1,1,0,0,0,2
7079,791512,18,0,5,0,5,0,0,1,4,3,5,0,2,0,0,1,1
7079,786338,32,6,11,4,8,2,3,4,10,4,8,0,1,0,2,0,18
7079,792050,32,3,6,3,3,0,3,5,7,4,4,0,2,2,5,0,11
7079,785347,13,3,7,3,5,0,2,0,0,1,0,0,5,0,2,0,6
7079,775601,33,3,5,2,3,1,2,7,7,0,1,2,3,0,4,0,14
7079,792048,1,0,1,0,1,0,0,0,0,0,0,0,0,0,0,0,0
7079,797648,9,0,0,0,0,0,0,0,0,1,0,1,1,0,1,0,0
7079,797647,5,0,0,0,0,0,0,0,0,0,0,0,0,1,0,0,0
7079,792052,15,0,3,0,2,0,1,2,2,1,1,0,1,0,2,0,2
7079,792047,24,2,9,2,7,0,2,4,6,4,1,1,2,1,3,0,8
7079,792051,6,0,1,0,1,0,0,1,2,1,0,0,4,0,0,0,1
7079,780862,9,0,2,0,0,0,2,0,0,0,0,1,1,0,0,0,0
7079,792045,3,0,0,0,0,0,0,0,0,0,0,0,0,0,0,0,0
7080,775954,36,2,3,2,3,0,0,0,0,3,5,4,2,0,2,1,4
7080,796194,35,4,9,1,2,3,7,8,8,0,6,3,4,1,5,0,19
7080,796464,26,5,11,4,10,1,1,0,0,0,2,3,3,0,4,1,11
7080,796459,35,9,11,6,7,3,4,9,12,1,3,2,4,3,5,0,30
7080,790917,36,5,8,3,4,2,4,6,7,1,5,3,5,2,0,2,18
7080,790916,2,0,0,0,0,0,0,0,0,0,0,0,0,2,0,0,0
7080,781157,22,2,10,1,2,1,8,2,2,0,1,1,1,0,1,0,7
7080,780648,8,0,0,0,0,0,0,0,0,0,0,0,0,2,0,0,0
7081,791302,32,5,7,4,6,1,1,3,4,2,6,1,1,0,3,0,14
7081,781622,31,3,8,1,3,2,5,0,0,1,1,1,3,1,1,1,8
7081,791309,37,4,11,4,9,0,2,3,3,1,3,5,5,0,7,0,11
7081,785835,16,3,8,3,6,0,2,2,2,2,0,1,2,1,0,0,8
7081,776334,25,1,8,1,3,0,5,7,8,0,3,2,2,2,3,0,9
7081,775862,12,1,2,1,1,0,1,2,2,0,2,0,2,2,3,0,4
7081,796601,22,9,15,8,13,1,2,3,6,1,2,0,3,3,1,0,22
7081,796602,3,0,1,0,1,0,0,0,0,0,0,0,0,1,0,0,0
7081,791304,19,2,2,1,1,1,1,0,0,1,2,2,4,0,0,0,5
7081,796604,3,0,0,0,0,0,0,0,0,0,0,1,0,0,0,0,0
7082,786136,29,3,8,0,2,3,6,1,3,1,2,0,3,0,2,1,10
7082,775747,27,6,11,6,8,0,3,1,3,2,3,1,2,0,4,2,13
7082,797358,38,4,12,3,6,1,6,3,4,1,4,0,1,3,3,1,12
7082,797357,38,3,3,2,2,1,1,0,0,0,4,7,3,1,3,0,7
7082,776236,39,7,14,6,9,1,5,3,6,2,6,4,2,2,5,0,18
7082,786140,3,0,0,0,0,0,0,0,0,0,0,0,0,0,0,0,0
7082,786578,10,0,0,0,0,0,0,0,0,1,1,0,0,0,1,0,0
7082,797359,16,3,3,2,2,1,1,1,1,0,0,0,2,1,0,0,8
7082,791365,18,0,3,0,1,0,2,0,0,0,1,0,0,0,0,0,0
7082,775195,7,0,1,0,1,0,0,2,3,1,0,1,2,0,1,0,2
7083,791616,21,1,2,1,2,0,0,0,0,1,1,0,3,0,1,2,2
7083,780797,28,2,9,1,4,1,5,0,0,0,6,6,1,0,1,1,5
7083,796981,33,5,14,5,10,0,4,3,4,1,2,1,1,3,2,0,13
7083,785505,38,10,14,9,12,1,2,2,4,3,3,4,1,3,5,0,23
7083,775604,30,5,8,4,5,1,3,2,2,1,2,2,3,0,2,0,13
7083,776418,19,3,8,3,8,0,0,0,0,4,3,0,2,1,1,1,6
7083,796983,6,1,1,1,1,0,0,0,0,0,2,0,1,0,1,0,2
7083,796984,4,0,1,0,1,0,0,0,0,1,0,0,1,0,0,0,0
7083,791618,9,1,1,1,1,0,0,0,0,0,0,1,2,0,1,0,2
7083,780555,37,3,8,0,1,3,7,2,2,1,4,3,1,3,0,0,11
7084,786805,17,3,6,3,6,0,0,2,3,1,1,2,0,0,1,0,8
7084,774936,11,5,11,5,10,0,1,0,1,4,4,2,2,2,1,1,10
7084,790932,19,2,4,1,1,1,3,0,0,0,0,4,2,2,1,0,5
7084,781345,24,5,6,2,3,3,3,2,2,2,2,3,2,2,1,1,15
7084,786803,19,2,8,1,3,1,5,0,0,1,2,2,3,6,2,0,5
7084,796490,7,0,3,0,3,0,0,0,0,1,0,0,1,0,0,0,0
7084,796488,12,2,7,1,4,1,3,0,0,1,3,1,1,0,2,0,5
7084,790934,14,2,2,2,2,0,0,1,2,1,3,1,1,3,2,1,5
7084,786804,19,7,11,5,6,2,5,0,1,0,2,4,2,0,3,1,16
7084,796489,8,0,1,0,1,0,0,0,2,0,0,1,0,0,0,0,0
7084,796487,12,2,3,0,1,2,2,0,1,1,2,1,3,1,2,0,6
7084,790933,17,2,7,0,3,2,4,1,2,3,1,3,1,0,2,0,7
7084,780033,14,1,2,0,0,1,2,0,0,2,2,2,4,1,1,0,3
7084,780030,7,0,0,0,0,0,0,3,4,0,1,0,0,1,1,0,3
7085,791443,22,1,2,1,1,0,1,0,0,0,1,0,1,1,0,0,2
7085,791440,10,1,2,1,2,0,0,0,0,1,0,0,1,0,3,2,2
7085,797019,16,0,2,0,2,0,0,1,2,0,3,0,3,1,2,0,1
7085,797016,24,1,5,1,2,0,3,0,1,0,0,3,1,2,3,0,2
7085,781378,27,4,12,3,8,1,4,1,1,2,3,0,0,2,5,1,10
7085,781629,15,2,4,2,3,0,1,0,2,5,3,1,2,0,1,1,4
7085,775739,14,3,3,3,3,0,0,3,4,1,4,0,2,0,1,2,9
7085,797015,18,3,8,2,6,1,2,7,9,1,4,2,0,2,4,0,14
7085,791441,22,1,6,1,4,0,2,3,4,0,1,4,2,2,1,0,5
7085,789009,4,0,0,0,0,0,0,0,0,0,0,0,1,0,0,0,0
7085,774959,14,2,4,1,2,1,2,0,0,0,4,1,2,3,2,0,5
7085,775267,14,2,8,1,2,1,6,0,0,0,0,0,2,1,2,0,5
7086,791981,32,10,11,5,6,5,5,2,2,1,7,1,1,3,1,0,27
7086,780342,30,4,6,3,4,1,2,5,6,0,4,3,3,1,3,0,14
7086,791982,28,5,10,3,5,2,5,0,0,0,0,2,2,1,1,1,12
7086,780333,32,5,10,3,6,2,4,4,4,1,2,11,1,3,2,0,16
7086,781493,26,4,9,2,5,2,4,2,2,0,1,2,3,1,1,0,12
7086,786756,21,1,2,1,1,0,1,2,2,0,3,4,1,0,1,0,4
7086,791984,6,2,2,2,2,0,0,0,0,0,0,0,3,0,0,0,4
7086,786755,18,3,4,2,3,1,1,0,0,2,1,1,0,0,0,0,7
7086,791986,5,0,0,0,0,0,0,0,0,0,0,1,0,0,0,0,0
7086,791985,2,0,0,0,0,0,0,0,0,0,0,0,0,0,0,0,0
7087,797050,35,9,15,8,13,1,2,9,10,5,1,0,1,0,0,0,28
7087,780394,20,2,5,1,3,1,2,0,0,0,2,0,3,0,2,0,5
7087,780391,31,4,6,4,6,0,0,0,0,2,2,1,4,2,1,2,8
7087,790871,35,5,9,4,5,1,4,2,4,2,5,4,2,1,6,0,13
7087,776473,34,2,7,0,4,2,3,1,2,0,1,3,3,1,1,1,7
7087,785783,23,1,3,0,1,1,2,0,0,0,2,0,1,0,3,0,3
7087,791573,8,0,2,0,2,0,0,0,0,0,0,2,0,0,0,0,0
7087,780392,9,0,2,0,1,0,1,0,0,0,0,0,0,0,2,0,0
7087,791570,5,0,1,0,1,0,0,0,0,0,0,0,1,0,0,0,0
7088,785999,36,10,11,10,11,0,0,4,5,5,6,2,3,0,2,1,24
7088,775654,25,0,0,0,0,0,0,2,2,3,3,3,3,0,2,0,2
7088,796399,30,5,8,3,4,2,4,0,1,0,1,1,0,1,3,0,12
7088,791639,33,5,14,3,8,2,6,4,6,0,0,4,0,0,3,0,16
7088,785389,37,2,8,1,3,1,5,0,0,0,1,4,2,1,1,0,5
7088,796401,27,8,12,4,5,4,7,0,0,2,5,2,3,1,2,1,20
7088,785255,5,0,1,0,1,0,0,0,0,0,1,1,1,0,0,0,0
7088,791640,7,0,2,0,0,0,2,1,2,0,0,1,1,0,0,0,1
7089,791522,36,7,14,7,12,0,2,0,0,1,0,3,3,2,2,0,14
7089,786351,29,6,10,2,4,4,6,0,1,4,7,0,4,1,0,1,16
7089,797146,39,9,16,6,9,3,7,4,5,1,3,4,0,1,0,0,25
7089,786348,18,3,5,2,2,1,3,0,1,1,2,0,1,0,0,0,7
7089,797143,40,8,10,6,7,2,3,4,4,0,4,11,2,1,2,0,22
7089,797148,6,0,0,0,0,0,0,0,0,0,0,0,1,0,0,0,0
7089,785816,19,4,4,4,4,0,0,0,0,0,2,0,2,1,2,0,8
7089,797147,13,1,3,1,2,0,1,0,0,0,0,4,1,0,0,0,2
7090,786157,21,2,4,2,4,0,0,0,2,1,4,1,0,0,0,2,4
7090,780676,28,3,11,3,8,0,3,1,3,1,6,3,2,0,0,0,7
7090,791756,22,2,9,2,7,0,2,0,0,1,4,5,2,3,1,0,4
7090,780992,28,5,11,3,5,2,6,1,2,0,5,3,2,0,1,0,13
7090,780677,29,8,17,2,4,6,13,2,2,2,2,2,2,1,1,0,24
7090,797350,3,0,3,0,2,0,1,0,0,0,0,0,1,1,0,0,0
7090,791754,15,1,3,1,3,0,0,1,2,0,1,0,0,0,2,1,3
7090,786150,19,2,3,2,2,0,1,0,2,3,3,1,4,0,0,0,4
7090,775533,16,3,4,2,3,1,1,0,0,3,3,1,2,1,1,1,7
7090,797348,16,3,5,2,3,1,2,4,4,0,5,2,3,2,0,0,11
7090,797349,3,0,3,0,0,0,3,0,0,0,0,0,0,0,0,0,0
7091,791743,32,1,5,1,3,0,2,2,2,0,7,1,3,0,3,1,4
7091,797340,23,1,9,0,2,1,7,0,0,0,0,1,2,0,4,0,3
7091,791746,30,2,6,2,6,0,0,2,4,0,5,4,3,2,2,0,6
7091,786193,40,5,13,1,7,4,6,8,10,1,7,0,1,0,0,0,22
7091,780711,31,1,4,0,2,1,2,0,0,0,5,0,4,1,1,0,3
7091,797344,6,0,0,0,0,0,0,1,2,0,1,1,2,0,0,0,1
7091,797343,2,0,0,0,0,0,0,2,2,0,1,0,0,0,0,0,2
7091,797342,2,0,0,0,0,0,0,0,0,0,0,0,1,0,0,0,0
7091,797341,34,4,14,0,3,4,11,2,3,0,7,1,2,0,4,2,14
7106,790880,17,1,5,1,5,0,0,0,0,1,2,1,1,0,1,0,2
7106,780210,28,5,15,4,11,1,4,5,6,6,5,0,2,3,1,0,16
7106,796594,35,4,7,0,2,4,5,0,0,0,3,2,2,0,4,0,12
7106,792432,30,3,7,0,3,3,4,8,8,0,4,3,1,2,0,0,17
7106,792427,23,4,7,4,5,0,2,0,0,0,1,3,1,2,4,0,8
7106,796595,4,0,0,0,0,0,0,0,0,0,0,0,1,0,1,0,0
7106,796592,14,0,2,0,2,0,0,0,0,2,1,0,4,0,0,0,0
7106,791306,19,5,8,4,7,1,1,2,2,3,2,0,2,2,1,0,13
7106,795353,6,0,0,0,0,0,0,0,0,0,0,1,0,0,0,0,0
7106,792989,3,0,1,0,1,0,0,0,0,0,0,0,1,0,0,0,0
7106,786422,21,1,5,1,3,0,2,1,3,0,3,1,2,0,2,0,3
7107,797849,20,1,6,1,4,0,2,1,2,0,2,0,3,1,3,0,3
7107,781537,25,1,7,1,4,0,3,0,0,0,1,0,2,0,1,1,2
7107,779986,18,1,4,1,4,0,0,2,2,3,1,0,2,0,1,0,4
7107,786079,25,1,4,1,4,0,0,1,2,1,2,1,1,1,3,0,3
7107,792202,23,1,7,1,4,0,3,0,0,0,2,1,1,2,0,0,2
7107,797848,13,1,2,0,1,1,1,0,0,0,4,0,2,0,1,1,3
7107,797842,18,3,4,3,4,0,0,8,11,3,6,1,4,1,2,1,14
7107,792201,6,1,1,1,1,0,0,1,2,0,0,0,0,0,0,1,3
7107,797836,6,0,2,0,1,0,1,0,0,0,1,2,1,0,2,0,0
7107,797847,17,2,6,1,2,1,4,0,0,1,1,0,2,1,1,0,5
7107,797838,3,0,0,0,0,0,0,0,0,0,0,1,0,1,2,0,0
7107,797835,10,2,2,0,0,2,2,0,0,1,1,0,1,1,1,0,6
7107,797846,16,2,3,2,3,0,0,1,1,0,2,0,1,0,1,0,5
7108,776462,34,7,9,7,7,0,2,1,3,3,4,2,2,1,2,1,15
7108,785635,30,4,11,4,8,0,3,3,4,4,6,3,4,1,5,4,11
7108,791629,15,1,2,1,2,0,0,0,0,0,2,1,2,0,0,0,2
7108,786440,38,5,10,1,3,4,7,2,2,1,7,0,2,0,1,0,16
7108,781199,35,7,18,4,11,3,7,2,2,2,2,5,2,1,1,0,19
7108,796974,24,3,7,3,5,0,2,0,1,0,0,2,1,0,0,0,6
7108,791628,6,0,1,0,0,0,1,0,0,0,0,0,0,0,0,0,0
7108,775642,10,0,1,0,0,0,1,2,2,0,0,0,1,1,1,0,2
7108,786720,8,0,1,0,0,0,1,0,0,0,0,0,0,0,0,0,0
7109,790839,25,2,5,1,2,1,3,0,0,3,5,2,5,1,0,0,5
7109,785388,24,11,21,11,21,0,0,2,2,5,5,0,3,1,2,2,24
7109,790840,26,2,7,1,4,1,3,0,0,1,3,2,2,2,0,0,5
7109,796395,26,1,8,1,4,0,4,2,2,2,3,4,0,0,4,0,4
7109,785386,34,6,8,6,6,0,2,2,2,0,2,3,1,0,1,1,14
7109,780370,15,1,4,1,1,0,3,0,2,0,1,1,0,2,0,1,2
7109,796393,16,4,6,4,6,0,0,5,6,1,1,0,0,0,1,1,13
7109,790841,8,0,0,0,0,0,0,1,2,0,1,1,2,0,0,0,1
7109,780373,21,0,3,0,1,0,2,0,0,0,1,2,1,0,1,0,0
7109,796396,5,0,0,0,0,0,0,0,0,0,1,0,0,0,0,0,0
7110,797873,30,3,5,3,5,0,0,4,4,1,5,0,2,0,2,1,10
7110,797877,30,6,10,4,8,2,2,0,0,4,5,0,3,0,1,0,14
7110,797872,16,3,6,3,4,0,2,1,3,1,1,0,4,1,3,0,7
7110,791338,28,6,9,6,9,0,0,4,5,1,1,5,0,3,0,1,16
7110,791339,35,8,19,5,11,3,8,5,7,0,5,4,3,5,2,0,24
7110,791337,8,0,3,0,3,0,0,0,0,2,2,1,4,0,0,1,0
7110,785881,10,0,3,0,3,0,0,0,2,0,1,0,1,0,0,0,0
7110,781599,9,0,1,0,1,0,0,0,1,1,1,0,1,0,1,0,0
7110,797875,13,1,3,1,1,0,2,0,0,1,0,0,0,0,1,1,2
7110,781595,15,2,5,2,3,0,2,0,0,1,0,2,0,1,0,0,4
7110,797874,6,0,0,0,0,0,0,0,0,0,0,0,0,0,0,0,0
7111,796766,18,4,6,3,3,1,3,1,1,1,1,1,1,0,2,1,10
7111,785614,21,1,3,1,2,0,1,4,5,1,2,0,3,0,1,0,6
7111,796767,22,3,8,1,5,2,3,0,0,2,2,1,5,0,4,0,8
7111,796765,30,2,4,2,3,0,1,0,0,0,1,5,5,3,0,0,4
7111,780812,32,10,22,6,12,4,10,2,2,1,10,3,3,0,5,4,26
7111,791113,19,4,7,3,4,1,3,0,0,0,1,1,3,0,1,1,9
7111,785618,26,0,4,0,0,0,4,1,2,1,3,1,2,1,0,2,1
7111,780813,32,2,4,1,3,1,1,4,6,3,5,6,1,3,4,1,9
7112,785622,30,4,10,1,3,3,7,2,3,0,3,0,3,1,3,0,13
7112,781058,30,1,3,1,3,0,0,0,4,4,4,1,3,1,2,1,2
7112,780327,24,4,5,4,5,0,0,0,0,0,1,2,1,1,2,0,8
7112,797458,23,1,3,1,2,0,1,0,0,0,1,0,4,0,5,0,2
7112,797451,33,7,14,5,10,2,4,7,7,0,2,4,1,5,2,0,23
7112,797455,17,4,6,4,6,0,0,0,0,1,2,0,2,0,1,0,8
7112,797456,3,0,0,0,0,0,0,0,0,0,0,0,0,0,0,0,0
7112,791847,3,0,1,0,0,0,1,0,0,0,2,0,2,0,0,0,0
7112,791848,8,0,0,0,0,0,0,0,0,0,0,0,0,0,0,0,0
7112,791849,16,3,4,1,2,2,2,0,0,0,2,2,0,0,0,0,8
7112,786607,13,0,2,0,1,0,1,0,0,0,0,1,0,0,0,1,0
7113,785459,17,9,13,9,13,0,0,0,0,2,1,2,4,0,1,0,18
7113,789102,35,4,10,3,6,1,4,6,9,2,6,7,0,3,4,0,15
7113,789101,25,2,4,1,2,1,2,0,0,0,2,1,4,0,3,0,5
7113,781371,27,2,8,1,3,1,5,1,2,3,2,3,1,0,0,0,6
7113,781367,18,2,4,2,3,0,1,0,0,0,1,1,2,1,2,0,4
7113,797731,6,0,1,0,1,0,0,0,0,1,1,1,1,0,0,0,0
7113,792066,27,4,6,4,5,0,1,2,2,3,2,1,0,1,0,0,10
7113,792064,22,6,11,1,2,5,9,0,0,0,4,0,1,1,0,0,17
7113,792063,9,1,2,0,1,1,1,0,0,1,0,1,0,0,2,0,3
7113,792061,14,1,4,1,2,0,2,0,0,1,2,0,0,0,1,0,2
7114,791316,24,2,3,2,3,0,0,4,4,1,5,0,2,1,3,2,8
7114,780870,31,6,11,6,11,0,0,2,4,7,5,1,1,0,2,1,14
7114,781079,36,7,16,5,11,2,5,5,5,1,3,3,1,0,1,0,21
7114,781443,30,4,12,3,9,1,3,4,7,1,2,5,2,2,3,0,13
7114,775822,36,7,17,4,7,3,10,2,2,3,4,2,1,1,1,0,19
7114,796625,6,0,0,0,0,0,0,0,0,0,1,0,0,0,0,0,0
7114,796621,17,2,5,2,4,0,1,0,0,0,2,0,1,1,1,0,4
7114,791314,18,0,0,0,0,0,0,0,0,3,0,3,0,0,0,0,0
7114,785380,2,0,0,0,0,0,0,0,0,0,0,0,1,0,0,0,0
7115,785664,18,1,3,1,3,0,0,0,0,2,4,1,4,1,0,1,2
7115,796609,31,4,10,3,6,1,4,2,2,0,2,3,3,3,2,0,11
7115,796611,24,3,11,1,5,2,6,0,0,1,1,5,0,0,0,0,8
7115,792869,23,5,9,0,1,5,8,2,3,0,0,2,1,0,0,0,17
7115,781504,34,10,15,9,12,1,3,0,0,1,2,2,3,0,3,1,21
7115,796613,15,2,5,1,4,1,1,0,0,2,1,0,1,0,2,0,5
7115,792232,11,2,5,2,4,0,1,0,0,1,3,1,2,0,0,0,4
7115,791312,12,0,1,0,1,0,0,0,0,1,0,1,2,0,0,0,0
7115,785841,16,1,5,0,2,1,3,2,2,1,2,0,0,0,2,0,5
7115,766623,16,1,2,1,1,0,1,0,0,1,1,0,0,0,0,0,2
7116,796455,9,1,1,1,1,0,0,0,0,1,1,1,0,0,0,0,2
7116,787175,31,3,4,0,0,3,4,2,3,0,7,1,4,1,1,0,11
7116,790909,39,5,13,4,8,1,5,3,4,2,5,7,3,1,3,0,14
7116,781393,40,7,20,6,14,1,6,3,3,2,5,1,1,1,0,0,18
7116,775351,32,7,9,7,9,0,0,0,0,1,3,1,4,2,1,1,14
7116,790907,14,2,3,2,3,0,0,2,4,1,1,1,3,2,1,1,6
7116,782126,35,4,10,4,6,0,4,0,0,1,3,3,2,1,2,6,8
7117,792265,36,7,11,5,6,2,5,4,5,4,3,1,1,0,0,1,20
7117,792266,27,3,11,0,4,3,7,3,4,2,1,3,2,1,1,0,12
7117,792267,29,2,6,0,1,2,5,1,2,0,1,0,1,0,1,0,7
7117,786152,27,4,9,4,9,0,0,0,0,0,5,3,3,0,1,1,8
7117,798003,35,6,12,5,9,1,3,1,2,0,4,6,1,4,4,1,14
7117,798007,16,2,3,2,3,0,0,2,2,1,5,0,1,0,1,1,6
7117,798009,11,0,2,0,0,0,2,0,0,0,1,2,0,0,1,0,0
7117,798006,6,0,1,0,1,0,0,0,0,0,0,0,1,0,0,0,0
7117,792263,13,1,3,1,2,0,1,1,3,1,2,2,3,0,0,0,3
7118,791652,19,3,6,3,6,0,0,2,2,2,2,3,3,1,2,1,8
7118,786495,23,2,8,1,4,1,4,3,4,1,6,3,3,1,0,0,8
7118,797285,19,2,6,0,0,2,6,0,0,1,0,0,3,1,0,0,6
7118,791650,35,6,18,6,16,0,2,4,4,5,4,1,0,1,3,0,16
7118,776384,27,3,11,2,9,1,2,2,3,0,2,0,3,0,2,0,9
7118,791653,17,2,5,1,1,1,4,0,0,0,3,1,1,0,1,0,5
7118,775705,13,0,0,0,0,0,0,1,2,4,1,0,2,0,0,0,1
7118,797286,18,4,9,3,6,1,3,3,3,1,1,4,1,0,0,0,12
7118,797283,22,4,7,1,3,3,4,0,0,1,1,0,3,0,1,0,11
7118,791654,7,0,1,0,1,0,0,1,2,1,0,0,2,1,0,0,1
7119,781244,34,8,13,7,11,1,2,9,9,1,11,1,3,1,1,0,26
7119,791243,13,0,2,0,1,0,1,0,0,0,1,2,1,0,1,0,0
7119,791241,27,2,4,2,4,0,0,3,4,1,0,1,2,0,2,0,7
7119,785537,40,7,13,5,8,2,5,5,5,2,0,1,3,1,2,1,21
7119,781243,28,5,9,3,4,2,5,8,8,0,8,3,2,1,3,0,20
7119,791245,26,3,6,1,2,2,4,2,2,0,3,4,4,0,1,0,10
7119,791246,7,1,2,0,1,1,1,0,0,0,1,0,0,0,0,0,3
7119,781237,18,2,3,0,0,2,3,0,0,0,3,3,2,1,2,0,6
7119,785529,7,0,1,0,1,0,0,0,0,0,1,0,0,0,0,0,0
7120,786131,28,2,5,1,3,1,2,6,6,2,5,1,2,1,0,0,11
7120,780904,25,3,6,3,6,0,0,2,7,1,7,1,1,1,3,0,8
7120,797685,39,3,8,2,5,1,3,3,6,0,4,3,1,1,1,2,10
7120,786145,35,3,13,2,5,1,8,1,1,0,0,1,2,0,0,0,8
7120,786128,36,8,13,8,11,0,2,3,3,2,2,4,4,3,5,0,19
7120,797684,3,0,0,0,0,0,0,0,0,1,0,0,0,0,1,2,0
7120,792100,12,1,1,1,1,0,0,2,4,1,3,0,4,0,1,0,4
7120,785884,15,2,4,1,2,1,2,2,2,1,2,0,1,0,2,2,7
7120,797686,7,0,1,0,1,0,0,0,0,0,0,0,4,1,3,0,0
7121,797701,15,1,5,1,5,0,0,5,6,1,0,0,4,1,1,1,7
7121,792101,31,0,4,0,3,0,1,0,0,1,2,1,2,0,2,0,0
7121,792102,9,1,4,0,1,1,3,0,0,0,1,0,1,0,1,0,3
7121,775564,35,4,7,2,3,2,4,1,2,1,4,1,0,0,2,0,11
7121,776386,24,8,12,6,9,2,3,0,0,0,6,2,4,1,2,1,18
7121,797700,16,3,6,3,6,0,0,3,4,2,2,0,4,1,0,0,9
7121,797697,8,1,4,1,4,0,0,0,0,1,0,0,2,0,0,0,2
7121,780922,18,1,1,1,1,0,0,0,0,1,3,1,3,0,0,0,2
7121,786160,13,2,4,0,1,2,3,0,0,2,1,2,2,2,2,0,6
7121,780923,31,4,12,4,9,0,3,4,4,0,4,4,1,3,2,0,12
7122,785740,31,6,7,6,7,0,0,1,4,1,11,1,0,0,2,1,13
7122,785809,36,4,11,3,6,1,5,0,0,0,4,4,0,1,3,1,9
7122,780530,39,7,11,7,10,0,1,0,1,3,8,4,2,0,1,0,14
7122,797402,36,3,10,1,2,2,8,0,0,0,1,1,1,0,3,0,8
7122,785738,34,3,8,2,6,1,2,8,8,1,5,6,4,2,3,0,15
7122,797396,3,1,1,1,1,0,0,0,0,0,1,0,0,0,0,0,2
7122,786144,21,1,6,1,3,0,3,3,4,1,3,0,4,1,1,0,5
7122,791664,0,0,1,0,0,0,1,0,0,0,0,0,1,0,0,0,0
7123,775556,31,5,15,5,12,0,3,1,1,3,7,4,4,0,1,1,11
7123,780234,34,4,12,4,8,0,4,2,2,6,6,0,5,1,2,3,10
7123,786411,29,1,5,1,2,0,3,0,0,1,2,0,2,0,0,0,2
7123,780046,28,5,10,2,4,3,6,0,0,0,1,3,3,3,2,0,13
7123,781104,36,6,16,2,11,4,5,3,3,1,2,2,2,0,2,0,19
7123,781110,13,0,3,0,1,0,2,1,2,1,4,0,0,0,1,0,1
7123,797185,12,1,3,1,2,0,1,0,0,1,0,1,2,2,0,0,2
7123,786405,17,1,7,1,7,0,0,0,0,0,2,0,2,0,1,0,2
7124,790810,25,7,10,6,8,1,2,1,2,4,7,1,1,0,1,0,16
7124,785362,18,5,10,5,10,0,0,2,3,3,3,2,3,0,1,2,12
7124,790808,29,6,12,3,4,3,8,3,3,0,5,6,1,2,2,0,18
7124,785361,32,7,13,2,3,5,10,0,1,0,3,0,0,1,1,0,19
7124,779997,28,3,7,3,6,0,1,2,3,0,3,3,1,4,1,1,8
7124,774854,18,1,3,1,3,0,0,1,2,0,3,0,1,0,0,0,3
7124,796370,19,4,7,4,6,0,1,0,0,0,4,3,2,0,0,2,8
7124,790809,9,1,2,0,1,1,1,0,0,0,1,1,1,1,0,0,3
7124,796368,5,2,3,1,2,1,1,0,0,0,1,0,0,1,0,0,5
7124,790811,8,1,3,1,3,0,0,0,0,2,0,0,1,0,1,0,2
7124,796371,4,0,0,0,0,0,0,0,0,0,1,0,0,0,0,0,0
7124,796369,4,1,2,0,0,1,2,0,0,0,1,0,1,0,0,0,3
7124,779999,1,0,0,0,0,0,0,0,0,0,0,1,0,0,0,0,0
7125,781480,25,2,9,2,4,0,5,0,0,1,1,2,1,0,1,1,4
7125,774846,25,5,12,5,12,0,0,0,0,1,2,0,2,0,1,0,10
7125,797273,29,4,12,4,10,0,2,0,0,1,3,3,3,3,0,0,8
7125,786558,23,3,6,1,4,2,2,1,2,0,4,0,1,0,3,0,9
7125,766611,27,6,11,3,4,3,7,5,5,0,3,0,1,1,2,0,20
7125,791376,18,1,7,1,2,0,5,1,3,0,4,2,3,1,0,1,3
7125,786185,14,1,2,1,2,0,0,0,0,1,2,0,1,0,0,1,2
7125,797182,15,0,1,0,1,0,0,0,0,0,0,0,0,0,1,0,0
7125,797272,16,2,6,2,2,0,4,4,4,2,2,1,0,0,1,0,8
7125,797181,6,0,0,0,0,0,0,0,0,0,0,0,0,0,0,1,0
7125,786190,1,0,0,0,0,0,0,0,0,0,0,0,0,0,0,0,0
7125,791377,1,0,0,0,0,0,0,0,0,0,0,0,0,0,0,0,0
7126,792334,18,5,9,4,7,1,2,1,1,2,2,0,4,1,3,0,12
7126,786575,29,4,6,4,6,0,0,2,2,7,5,0,1,1,3,1,10
7126,799842,33,2,7,2,5,0,2,2,2,3,4,2,4,1,2,0,6
7126,792338,32,5,13,4,10,1,3,2,4,2,3,3,2,0,1,3,13
7126,781666,37,5,15,4,10,1,5,2,2,0,3,1,0,2,2,0,13
7126,798097,10,0,2,0,2,0,0,1,2,1,2,0,2,0,1,0,1
7126,785531,15,2,4,1,3,1,1,3,4,1,3,0,0,0,0,0,8
7126,798095,23,1,4,0,1,1,3,0,0,0,1,0,2,0,0,0,3
7126,798100,3,0,2,0,2,0,0,0,0,0,0,0,0,0,0,0,0
7127,791511,16,1,2,1,2,0,0,0,0,2,2,2,3,0,1,2,2
7127,778442,36,6,16,3,8,3,8,2,4,2,8,1,2,1,2,1,17
7127,797150,25,2,6,1,3,1,3,0,0,1,2,0,2,0,4,0,5
7127,780946,36,2,4,0,1,2,3,6,7,0,2,5,3,3,2,0,12
7127,786637,34,6,12,3,5,3,7,0,0,0,1,2,2,1,1,0,15
7127,797151,23,5,8,5,8,0,0,1,2,0,3,0,2,0,0,0,11
7127,791515,4,0,1,0,0,0,1,2,2,0,1,0,0,0,0,0,2
7127,797154,3,0,1,0,1,0,0,0,0,0,0,1,1,0,0,0,0
7127,791514,4,1,1,0,0,1,1,0,0,0,1,0,1,0,0,0,3
7127,791513,19,2,4,1,1,1,3,0,0,2,1,1,2,1,0,0,5
7128,782133,21,5,11,2,4,3,7,1,2,1,2,2,1,1,2,0,14
7128,785123,23,6,9,6,8,0,1,3,3,2,5,0,0,0,0,2,15
7128,790990,28,10,16,5,7,5,9,0,0,2,8,1,3,3,1,0,25
7128,789219,30,2,5,2,2,0,3,4,4,0,3,9,2,3,1,0,8
7128,785059,30,4,8,3,6,1,2,0,0,5,4,4,0,2,3,1,9
7128,796624,1,0,0,0,0,0,0,0,0,0,0,0,0,0,0,0,0
7128,790989,2,1,1,0,0,1,1,1,2,0,1,0,0,0,0,0,4
7128,785305,8,0,1,0,1,0,0,0,0,0,2,0,1,0,1,0,0
7128,796622,10,0,3,0,3,0,0,0,0,0,2,2,0,0,1,1,0
7128,796623,17,3,5,3,3,0,2,5,9,0,1,2,3,1,6,0,11
7128,790988,6,0,1,0,0,0,1,0,0,0,2,0,0,0,1,0,0
7128,785303,9,1,1,0,0,1,1,0,0,0,0,1,1,0,1,1,3
7128,785122,15,1,1,0,0,1,1,0,0,0,0,1,0,0,0,0,3
7129,791230,19,1,4,0,2,1,2,0,0,1,3,0,2,2,2,0,3
7129,785557,15,4,11,4,10,0,1,0,0,1,0,0,5,1,4,0,8
7129,791228,13,2,2,2,2,0,0,0,0,0,0,0,3,0,1,0,4
7129,796932,21,1,10,0,7,1,3,0,0,0,1,1,1,2,2,0,3
7129,785624,27,2,4,1,2,1,2,2,3,0,1,5,3,1,1,0,7
7129,796935,19,4,13,0,3,4,10,0,0,0,2,0,0,2,0,0,12
7129,796933,14,3,5,3,4,0,1,1,2,3,3,2,0,1,2,1,7
7129,791226,21,4,5,4,5,0,0,0,0,1,7,0,1,0,1,2,8
7129,791229,1,0,2,0,2,0,0,0,0,0,0,0,0,0,0,0,0
7129,791227,24,4,7,1,1,3,6,0,0,1,2,1,1,0,1,0,11
7129,781201,8,1,1,0,0,1,1,0,0,0,0,0,1,1,1,0,3
7129,781198,18,3,5,3,5,0,0,2,2,0,0,4,1,1,1,0,8
7130,797819,24,1,7,1,3,0,4,0,0,1,2,2,4,3,0,0,2
7130,792186,33,6,9,6,9,0,0,6,7,2,3,0,3,0,3,0,18
7130,781447,26,4,7,4,7,0,0,3,3,1,5,2,2,2,5,2,11
7130,792188,29,5,7,1,1,4,6,0,0,1,2,3,3,2,3,1,14
7130,792183,39,5,17,3,8,2,9,0,0,0,4,3,2,0,0,0,12
7130,780433,9,0,3,0,3,0,0,0,0,0,2,0,4,0,0,1,0
7130,796255,2,0,1,0,1,0,0,0,0,0,0,1,0,0,0,0,0
7130,792185,10,0,0,0,0,0,0,0,0,0,0,1,2,0,2,0,0
7130,786675,25,3,8,0,1,3,7,0,0,1,3,2,1,2,2,0,9
7130,797820,1,0,0,0,0,0,0,0,0,0,0,0,0,0,0,0,0
7130,792187,2,0,0,0,0,0,0,0,0,0,0,0,0,0,0,0,0
7131,797292,32,9,12,9,12,0,0,2,2,5,7,2,3,2,2,1,20
7131,780509,31,3,9,3,8,0,1,3,7,3,2,1,4,0,1,1,9
7131,797290,36,2,5,0,0,2,5,2,4,0,6,3,2,1,4,0,8
7131,791660,39,5,11,2,7,3,4,4,6,2,2,7,2,4,5,1,17
7131,786064,33,5,11,2,4,3,7,6,8,2,6,0,0,0,2,0,19
7131,791658,7,1,1,1,1,0,0,0,0,0,1,0,1,0,0,0,2
7131,791663,1,0,0,0,0,0,0,0,0,0,1,0,0,0,0,0,0
7131,785658,9,2,4,2,3,0,1,0,0,1,0,0,1,2,1,0,4
7131,797295,10,0,3,0,1,0,2,0,0,0,1,1,0,0,1,0,0
7131,791661,1,0,0,0,0,0,0,0,0,0,0,0,0,0,0,0,0
7131,797293,1,0,0,0,0,0,0,0,0,0,0,0,0,0,0,0,0
7132,780037,36,9,22,5,12,4,10,8,9,2,3,2,1,1,6,0,30
7132,790785,27,2,12,0,6,2,6,0,0,0,2,3,0,0,0,0,6
7132,796340,17,0,4,0,2,0,2,0,0,1,3,0,1,0,1,1,0
7132,780040,36,1,6,1,6,0,0,1,2,5,7,1,5,1,2,0,3
7132,790781,26,4,6,4,6,0,0,0,0,3,6,1,2,0,1,1,8
7132,781232,21,2,7,1,4,1,3,2,2,1,3,2,0,4,0,0,7
7132,796339,23,3,7,1,3,2,4,0,0,1,2,3,2,0,3,0,8
7132,790783,10,1,1,1,1,0,0,0,0,1,1,0,0,0,0,1,2
7132,790780,4,0,1,0,0,0,1,0,0,0,1,1,1,0,1,0,0
7132,780045,0,0,0,0,0,0,0,0,0,0,0,0,0,0,0,0,0
7132,792440,0,0,0,0,0,0,0,0,0,0,0,0,0,0,0,0,0
7133,790843,34,7,12,3,4,4,8,0,0,0,7,4,0,3,3,1,18
7133,786212,33,6,11,2,4,4,7,0,0,2,1,3,4,2,0,0,16
7133,775142,27,7,14,6,11,1,3,3,3,4,6,3,3,3,4,0,18
7133,790844,21,2,4,2,4,0,0,0,0,1,1,1,1,0,0,1,4
7133,781563,25,2,8,2,6,0,2,0,0,0,2,3,1,0,0,0,4
7133,785392,25,4,8,1,2,3,6,4,5,0,2,3,3,0,3,0,15
7133,780094,15,0,6,0,4,0,2,0,0,2,7,1,0,0,0,0,0
7133,796914,12,0,3,0,1,0,2,0,0,0,4,3,1,0,1,0,0
7133,799986,8,0,0,0,0,0,0,0,0,0,0,1,1,0,0,1,0
7134,781215,27,3,3,1,1,2,2,0,0,0,3,2,3,0,1,1,8
7134,791001,15,1,6,0,2,1,4,0,0,0,2,0,1,0,0,0,3
7134,775255,32,2,6,2,3,0,3,5,6,0,1,3,2,1,1,0,9
7134,781159,34,4,10,2,4,2,6,4,4,0,6,0,2,1,1,0,14
7134,781174,30,4,8,4,8,0,0,5,7,4,4,2,2,0,2,1,13
7134,796644,10,1,3,1,3,0,0,2,2,0,3,0,3,0,0,0,4
7134,785320,4,1,1,0,0,1,1,0,0,0,0,0,0,0,0,0,3
7134,779972,31,7,10,6,7,1,3,1,2,0,5,3,1,2,2,0,16
7134,785231,17,3,5,2,4,1,1,1,1,0,1,0,0,0,0,0,8
7135,791375,35,5,10,1,2,4,8,0,0,0,2,1,2,0,1,1,14
7135,785482,29,10,21,6,13,4,8,2,4,1,1,2,4,1,3,0,26
7135,796477,27,3,7,1,3,2,4,0,0,1,3,1,0,0,3,0,8
7135,786164,24,0,2,0,1,0,1,0,0,1,6,1,2,0,0,1,0
7135,781560,32,1,5,1,5,0,0,2,5,2,1,0,2,2,0,0,4
7135,796479,20,1,1,1,1,0,0,0,0,2,3,1,5,0,3,0,2
7135,780837,29,5,15,3,8,2,7,0,0,1,1,1,1,1,2,0,12
7135,796476,1,0,0,0,0,0,0,0,0,0,0,0,1,0,0,0,0
7135,796473,3,0,0,0,0,0,0,0,0,0,1,1,1,0,0,0,0
7136,792283,36,4,7,1,2,3,5,0,0,1,3,3,1,0,0,1,11
7136,797823,22,1,2,1,1,0,1,5,6,0,3,0,3,3,2,1,7
7136,792284,35,1,5,1,4,0,1,3,5,1,7,8,4,0,3,0,5
7136,792280,13,2,4,1,3,1,1,3,3,0,1,1,5,0,3,0,8
7136,780505,37,8,18,4,11,4,7,6,9,1,4,5,4,1,4,0,26
7136,785950,28,4,9,1,4,3,5,2,3,4,4,0,2,0,0,0,13
7136,797829,16,1,2,1,2,0,0,1,2,0,2,0,2,0,0,1,3
7136,797826,12,3,4,1,2,2,2,0,0,1,1,0,0,0,2,0,8
7136,797833,1,0,0,0,0,0,0,0,0,0,0,0,0,0,0,0,0
7137,780283,9,2,3,2,3,0,0,0,0,1,0,0,5,0,2,1,4
7137,790925,22,3,6,3,5,0,1,1,1,2,3,0,5,2,0,1,7
7137,791456,38,7,18,4,9,3,9,8,8,1,6,2,1,0,1,0,25
7137,785480,15,1,5,0,0,1,5,0,0,0,1,1,1,0,1,0,3
7137,785476,36,6,9,6,7,0,2,5,9,0,3,5,1,4,4,0,17
7137,800121,14,0,1,0,1,0,0,0,2,2,3,0,1,0,0,0,0
7137,790926,15,2,4,1,2,1,2,0,0,0,0,1,1,0,1,0,5
7137,785474,26,2,9,2,8,0,1,2,2,0,1,1,4,1,0,0,6
7137,796470,22,3,4,3,4,0,0,0,1,1,4,2,3,0,1,2,6
7137,785478,3,0,0,0,0,0,0,0,0,0,0,0,1,0,0,0,0
7150,797174,21,0,0,0,0,0,0,0,0,1,5,0,3,0,0,0,0
7150,791510,28,2,10,1,5,1,5,1,2,1,3,2,2,1,1,0,6
7150,786699,23,1,2,1,2,0,0,0,0,4,1,3,1,1,1,1,2
7150,785593,32,7,15,0,4,7,11,3,4,3,2,1,2,0,2,0,24
7150,775357,35,1,11,0,3,1,8,0,0,0,5,4,1,1,3,0,3
7150,791507,17,1,5,1,5,0,0,1,2,1,0,0,1,0,2,0,3
7150,797168,26,4,10,0,5,4,5,3,4,1,2,2,1,1,3,0,15
7150,791504,18,1,3,1,3,0,0,2,2,2,0,1,2,0,2,0,4
7151,791289,18,2,6,2,6,0,0,0,0,1,3,0,1,1,1,2,4
7151,796574,19,2,7,2,2,0,5,0,0,0,2,1,2,1,3,0,4
7151,796571,26,3,8,3,6,0,2,1,1,3,1,2,0,1,1,0,7
7151,796572,23,1,4,1,4,0,0,2,4,0,4,0,2,0,0,1,4
7151,781346,32,3,12,3,7,0,5,2,2,0,5,4,2,1,2,0,8
7151,785786,22,2,2,2,2,0,0,2,2,1,2,0,2,1,0,1,6
7151,796576,31,4,7,1,1,3,6,2,2,0,1,1,2,3,1,0,13
7151,791290,17,1,2,1,1,0,1,1,2,0,2,0,2,0,1,1,3
7151,791291,12,2,4,1,1,1,3,0,0,0,2,0,4,0,2,0,5
7152,792388,21,1,2,1,2,0,0,0,2,0,1,1,1,0,1,0,2
7152,797845,27,2,7,0,1,2,6,0,0,1,0,1,2,0,2,0,6
7152,797851,38,4,8,1,5,3,3,5,6,0,4,6,0,2,3,1,16
7152,792391,26,8,12,8,12,0,0,1,1,2,3,4,4,2,4,1,17
7152,792395,35,5,8,3,6,2,2,0,0,0,4,8,3,0,2,0,12
7152,781533,31,4,9,0,3,4,6,0,0,0,0,0,2,1,2,0,12
7152,792393,20,5,7,4,5,1,2,0,0,1,2,3,1,1,1,0,11
7152,786115,2,0,0,0,0,0,0,0,0,0,0,0,0,0,0,0,0
7153,796959,15,2,3,2,3,0,0,0,0,1,0,0,2,0,0,2,4
7153,781272,30,4,6,4,4,0,2,3,4,3,5,1,2,2,4,1,11
7153,791261,36,6,13,2,4,4,9,4,4,0,4,2,3,4,0,1,20
7153,785501,27,2,7,1,2,1,5,1,3,0,3,4,1,0,1,0,6
7153,781270,35,5,9,2,3,3,6,2,2,0,3,4,2,2,4,0,15
7153,791260,15,4,5,4,5,0,0,4,4,2,1,0,0,0,0,0,12
7153,785503,2,0,0,0,0,0,0,0,0,0,0,0,0,0,1,0,0
7153,785502,1,0,0,0,0,0,0,0,0,0,1,0,1,0,0,0,0
7153,796958,20,1,5,1,3,0,2,2,2,1,1,3,1,1,2,0,4
7153,791258,19,0,2,0,1,0,1,0,0,0,0,0,2,0,1,0,0
7154,786550,34,8,13,4,6,4,7,1,2,2,4,0,3,3,1,1,21
7154,776054,25,8,12,6,8,2,4,0,0,1,8,0,2,1,2,1,18
7154,792007,27,3,5,3,5,0,0,5,6,4,4,0,4,0,1,1,11
7154,792009,27,3,8,3,5,0,3,2,2,1,5,4,0,2,0,0,8
7154,792006,25,3,6,3,6,0,0,0,0,1,3,8,1,0,0,1,6
7154,792011,4,0,0,0,0,0,0,0,0,0,1,1,0,0,0,0,0
7154,780177,2,0,0,0,0,0,0,0,0,1,0,0,3,0,2,0,0
7154,792008,4,0,1,0,1,0,0,0,0,0,0,0,1,0,0,0,0
7154,797506,5,2,4,1,1,1,3,2,2,0,1,0,0,0,0,0,7
7154,791689,13,1,3,1,2,0,1,1,2,0,1,0,2,0,2,0,3
7154,786552,19,0,4,0,1,0,3,0,0,0,0,4,1,1,2,0,0
7154,776273,15,4,6,2,4,2,2,0,0,0,1,3,2,0,0,0,10
7155,797482,23,3,10,0,4,3,6,0,0,1,2,1,2,0,4,0,9
7155,797485,22,4,6,1,1,3,5,2,2,0,1,1,1,0,0,0,13
7155,797481,24,2,5,1,3,1,2,2,2,0,4,1,1,1,5,1,7
7155,797480,22,4,7,3,6,1,1,1,3,0,4,0,4,1,4,0,10
7155,797479,15,0,3,0,0,0,3,0,0,0,1,1,2,0,0,0,0
7155,797484,11,0,0,0,0,0,0,0,0,0,1,0,0,0,0,0,0
7155,797483,8,1,1,1,1,0,0,1,2,0,0,0,0,0,0,1,3
7155,786579,11,2,6,0,0,2,6,0,1,0,0,0,1,0,0,0,6
7155,797478,15,0,3,0,2,0,1,4,4,2,2,1,3,1,2,0,4
7155,791875,21,1,4,1,4,0,0,1,2,0,3,3,1,2,2,2,3
7155,786574,9,1,1,1,1,0,0,0,0,0,2,0,1,0,0,0,2
7155,781217,19,0,3,0,1,0,2,0,0,0,0,2,1,0,0,1,0
7156,785532,32,6,8,6,8,0,0,5,6,4,2,2,4,1,1,1,17
7156,780063,35,7,12,3,6,4,6,0,0,0,8,1,2,3,3,0,18
7156,796734,18,1,2,1,2,0,0,0,0,0,2,1,2,0,0,0,2
7156,785530,31,7,12,6,8,1,4,5,5,1,4,1,3,0,3,0,20
7156,791058,10,0,1,0,1,0,0,0,0,0,1,0,3,0,0,0,0
7156,775926,4,0,1,0,0,0,1,0,0,0,1,0,0,0,0,0,0
7156,791057,7,0,2,0,1,0,1,0,0,0,0,0,0,0,1,0,0
7156,775573,20,5,9,3,3,2,6,0,0,0,0,2,3,0,3,0,12
7156,791059,4,1,1,1,1,0,0,0,0,0,0,0,1,0,0,0,2
7156,791280,14,0,1,0,0,0,1,0,0,1,0,2,1,0,1,0,0
7156,791055,25,1,5,0,2,1,3,1,2,1,2,2,4,1,1,0,4
7157,792351,30,0,0,0,0,0,0,6,6,2,0,3,3,2,0,1,6
7157,786723,40,6,11,5,10,1,1,5,9,0,4,2,2,0,5,0,18
7157,792349,27,6,10,5,9,1,1,0,1,0,1,0,3,0,0,3,13
7157,798060,37,3,7,3,4,0,3,5,6,0,2,3,2,1,3,0,11
7157,792355,24,3,10,0,3,3,7,0,0,0,2,1,0,0,1,0,9
7157,786724,18,1,2,0,0,1,2,0,0,1,2,1,1,1,0,0,3
7157,786726,5,0,0,0,0,0,0,0,0,0,0,0,1,0,0,0,0
7157,798061,19,5,7,4,6,1,1,5,5,1,4,1,1,0,0,1,16
7158,780023,24,3,4,3,4,0,0,1,2,2,4,0,4,0,1,2,7
7158,792493,34,4,7,0,1,4,6,0,1,0,0,0,2,1,2,1,12
7158,792495,35,4,11,3,5,1,6,4,4,0,7,3,4,3,3,0,13
7158,792491,34,1,5,1,5,0,0,5,7,1,1,5,3,2,4,0,7
7158,781144,34,3,14,1,4,2,10,0,0,0,3,1,0,0,1,0,8
7158,798960,0,0,0,0,0,0,0,0,0,0,0,0,0,0,0,0,0
7158,798959,12,2,3,1,1,1,2,2,3,0,1,3,2,0,0,0,7
7158,788128,3,1,1,1,1,0,0,0,0,0,0,0,0,0,0,0,2
7158,786832,24,4,6,4,5,0,1,6,6,1,5,1,1,1,1,0,14
7159,797466,25,6,11,6,11,0,0,2,4,3,5,1,3,0,2,0,14
7159,791858,33,4,8,4,6,0,2,0,0,3,2,4,1,0,1,0,8
7159,797463,36,9,15,4,6,5,9,1,1,0,1,3,2,0,2,0,24
7159,791109,27,0,0,0,0,0,0,4,5,0,5,4,4,2,3,0,4
7159,785625,28,8,13,6,9,2,4,0,0,3,4,1,3,0,0,0,18
7159,797464,27,4,9,4,8,0,1,3,6,2,9,3,1,2,2,1,11
7159,797465,17,3,6,3,5,0,1,0,0,1,0,1,3,1,2,0,6
7159,791854,7,0,0,0,0,0,0,0,0,0,3,1,4,0,2,0,0
7160,787239,27,1,1,1,1,0,0,0,0,2,4,0,2,0,1,5,2
7160,789058,14,1,3,0,1,1,2,1,2,1,3,0,5,0,2,1,4
7160,797898,35,8,19,6,11,2,8,2,2,2,1,4,2,2,3,0,20
7160,792236,35,6,10,6,7,0,3,5,7,1,5,4,0,0,3,0,17
7160,792237,33,3,16,1,9,2,7,0,0,1,2,0,0,1,2,0,8
7160,797895,12,0,2,0,1,0,1,0,0,1,3,0,0,0,1,0,0
7160,792238,17,0,0,0,0,0,0,0,0,1,0,1,3,1,0,2,0
7160,785286,7,1,1,1,1,0,0,0,0,1,1,0,0,0,1,0,2
7160,792240,19,1,4,0,1,1,3,0,0,1,3,0,2,1,0,0,3
7160,792359,1,0,1,0,0,0,1,0,0,0,0,0,1,0,0,0,0
7161,792227,32,4,9,4,9,0,0,0,0,2,5,3,1,2,1,1,8
7161,781352,25,4,10,4,10,0,0,4,4,3,3,0,1,1,1,0,12
7161,792223,33,4,11,3,7,1,4,3,3,0,5,2,4,1,4,0,12
7161,785935,40,6,11,3,4,3,7,4,7,1,5,7,1,1,2,0,19
7161,781340,37,4,9,4,8,0,1,0,0,3,2,1,1,3,0,0,8
7161,797881,13,1,1,1,1,0,0,2,2,0,2,0,3,1,0,0,4
7161,797889,2,0,1,0,1,0,0,0,0,0,0,0,0,0,0,0,0
7161,781351,10,0,3,0,2,0,1,0,0,0,0,0,0,0,0,0,0
7161,786453,8,0,0,0,0,0,0,0,0,0,1,1,1,0,1,0,0
7162,791647,16,1,6,1,6,0,0,0,0,2,0,0,4,1,0,1,2
7162,791648,35,11,16,7,11,4,5,1,1,0,2,0,2,0,1,1,27
7162,786195,18,2,3,2,3,0,0,5,6,2,2,1,4,0,1,1,9
7162,791649,23,1,3,0,1,1,2,2,2,0,4,2,1,0,4,0,5
7162,797280,32,1,9,1,6,0,3,2,2,2,4,6,2,0,1,1,4
7162,797281,31,6,6,5,5,1,1,0,0,0,4,3,2,2,1,0,13
7162,785694,3,0,0,0,0,0,0,0,0,0,0,0,1,1,0,1,0
7162,797279,18,2,7,1,2,1,5,0,0,0,2,1,2,0,1,0,5
7162,786640,24,6,7,4,5,2,2,1,2,0,2,6,4,1,1,0,15
7163,783072,14,0,3,0,3,0,0,0,0,1,5,1,1,0,1,2,0
7163,774879,33,4,10,4,7,0,3,5,6,1,5,1,1,0,1,0,13
7163,791540,38,8,13,6,9,2,4,1,2,0,2,1,2,0,0,1,19
7163,787782,37,3,11,2,7,1,4,3,3,0,3,0,2,0,3,0,10
7163,776068,29,3,7,3,5,0,2,6,6,1,0,5,2,1,3,0,12
7163,797817,28,4,5,4,5,0,0,3,5,1,4,2,4,1,2,0,11
7163,781463,14,0,1,0,0,0,1,2,3,1,3,1,2,0,1,1,2
7163,792153,7,0,0,0,0,0,0,0,0,0,0,0,0,0,0,0,0
7164,792143,25,2,3,0,0,2,3,2,2,1,1,1,4,0,2,1,8
7164,786302,9,0,0,0,0,0,0,0,0,0,0,0,0,0,0,0,0
7164,786293,31,2,8,2,7,0,1,2,2,1,2,2,0,0,4,0,6
7164,780953,39,8,17,8,14,0,3,6,7,2,4,0,2,1,1,3,22
7164,797750,34,1,5,1,4,0,1,0,0,0,4,3,0,1,1,0,2
7164,797753,29,3,8,2,3,1,5,0,0,0,3,1,1,0,3,1,7
7164,786287,25,2,4,2,4,0,0,0,0,0,4,1,1,1,1,0,4
7164,797748,3,1,3,1,1,0,2,0,0,0,0,0,1,1,0,0,2
7164,792147,4,0,0,0,0,0,0,0,0,0,1,0,0,0,0,0,0
7164,797751,1,0,0,0,0,0,0,0,0,0,0,0,0,0,0,0,0
7165,775640,9,2,3,1,2,1,1,0,0,0,5,0,3,0,0,1,5
7165,780919,18,4,8,4,8,0,0,0,0,4,2,1,4,1,3,0,8
7165,785803,29,3,4,1,1,2,3,2,2,0,1,1,0,1,1,0,10
7165,780920,33,7,17,7,15,0,2,0,0,0,9,9,1,0,1,0,14
7165,780914,32,3,7,2,3,1,4,2,2,0,4,1,1,0,2,0,9
7165,791142,24,2,4,0,0,2,4,0,0,0,1,0,0,1,0,0,6
7165,775816,30,4,8,3,5,1,3,0,0,1,4,0,3,0,1,0,9
7165,796799,22,3,5,2,3,1,2,1,2,1,0,1,2,1,1,0,8
7165,791141,3,0,1,0,1,0,0,0,0,0,0,1,0,0,0,0,0
7166,791089,20,0,2,0,2,0,0,1,2,1,6,1,3,0,2,0,1
7166,791094,28,0,2,0,1,0,1,2,2,1,5,0,1,0,4,0,2
7166,791091,20,1,5,1,4,0,1,0,1,1,1,0,1,0,2,0,2
7166,791093,23,5,6,5,6,0,0,3,3,1,3,0,3,1,4,0,13
7166,785569,25,1,7,0,2,1,5,5,5,1,3,1,5,2,1,0,8
7166,791097,15,2,6,2,6,0,0,0,0,1,1,2,1,0,2,2,4
7166,796753,21,0,4,0,2,0,2,0,0,1,2,1,0,0,1,0,0
7166,796752,20,3,3,2,2,1,1,6,8,1,0,2,1,1,1,0,13
7166,791090,23,1,8,1,3,0,5,1,2,0,2,1,2,0,2,0,3
7166,791092,5,0,0,0,0,0,0,0,1,1,1,0,0,0,0,0,0
7167,792593,20,6,8,6,8,0,0,3,4,0,5,0,5,0,3,1,15
7167,792594,26,2,8,1,4,1,4,1,2,1,3,1,0,0,2,1,6
7167,792588,29,4,7,2,2,2,5,4,4,0,2,3,1,2,1,0,14
7167,792595,32,3,7,3,5,0,2,1,4,0,2,5,2,1,0,0,7
7167,792583,27,1,3,0,0,1,3,0,0,0,2,0,1,0,2,0,3
7167,792580,17,0,0,0,0,0,0,1,2,0,5,1,4,2,4,0,1
7167,796987,18,5,10,4,9,1,1,0,0,0,0,2,2,3,3,0,11
7167,792591,23,1,3,1,1,0,2,0,1,0,2,1,1,0,0,0,2
7167,796989,4,0,0,0,0,0,0,0,0,0,0,0,2,0,0,0,0
7167,792586,2,0,0,0,0,0,0,0,0,0,0,0,1,0,0,0,0
7167,796988,2,1,1,0,0,1,1,0,0,0,0,0,0,0,1,0,3
7168,791062,31,3,9,3,7,0,2,10,10,2,3,0,1,2,1,0,16
7168,791063,15,2,5,1,3,1,2,2,2,2,5,1,4,0,0,2,7
7168,796735,10,0,2,0,1,0,1,0,0,0,1,1,2,0,0,0,0
7168,785542,36,1,2,1,2,0,0,4,9,1,2,4,0,0,1,1,6
7168,780743,36,4,8,1,4,3,4,3,4,0,1,2,1,1,2,0,14
7168,796741,0,0,0,0,0,0,0,0,0,0,0,0,0,0,0,0,0
7168,785548,25,0,4,0,1,0,3,0,0,0,4,2,3,1,1,0,0
7168,796736,6,2,2,1,1,1,1,0,0,0,0,1,1,0,0,0,5
7168,791064,27,7,14,2,5,5,9,0,0,0,0,1,2,0,1,0,19
7168,780055,14,2,3,1,1,1,2,0,0,0,0,1,0,0,0,0,5
7169,785948,36,4,7,4,7,0,0,5,5,2,3,0,2,0,1,0,13
7169,792020,34,4,13,2,6,2,7,0,0,1,0,3,3,0,2,0,10
7169,785946,17,1,1,1,1,0,0,0,0,1,3,0,4,0,1,0,2
7169,785939,35,8,13,7,10,1,3,3,3,0,6,3,2,1,3,0,20
7169,785938,31,2,2,0,0,2,2,1,2,0,6,5,3,1,3,0,7
7169,792025,18,5,7,5,7,0,0,1,2,1,3,0,2,0,1,0,11
7169,792023,5,0,1,0,0,0,1,0,0,0,1,2,2,0,0,0,0
7169,785941,24,3,6,1,1,2,5,0,0,0,1,0,5,0,1,0,8
7170,796334,21,3,7,3,6,0,1,0,0,5,5,3,4,1,4,0,6
7170,790776,22,2,5,2,5,0,0,5,6,5,3,1,1,1,0,1,9
7170,796330,30,5,11,2,5,3,6,1,2,1,1,1,2,0,0,0,14
7170,796336,19,2,7,0,1,2,6,2,2,0,0,1,1,0,1,0,8
7170,785813,36,5,12,3,8,2,4,2,2,0,3,3,0,0,5,0,14
7170,785827,22,2,4,2,4,0,0,5,10,1,6,0,1,0,0,2,9
7170,796337,29,1,4,1,3,0,1,5,8,0,7,6,0,0,0,0,7
7170,796332,21,0,0,0,0,0,0,3,4,2,6,0,3,0,3,0,3
7171,796404,23,5,10,5,10,0,0,0,2,2,4,0,4,2,0,2,10
7171,790853,8,0,1,0,1,0,0,0,2,0,2,0,3,0,0,1,0
7171,790850,30,5,12,3,4,2,8,1,1,0,3,1,2,0,1,0,13
7171,781164,30,2,5,1,1,1,4,0,0,0,3,3,1,0,1,0,5
7171,781163,34,5,12,4,9,1,3,2,2,1,4,1,3,2,0,0,13
7171,785434,17,1,6,0,3,1,3,2,2,2,1,0,2,0,0,0,5
7171,796406,10,0,2,0,2,0,0,0,0,1,2,0,3,1,1,0,0
7171,790849,23,5,10,3,7,2,3,0,0,2,2,2,2,2,1,0,12
7171,790854,18,1,4,1,4,0,0,1,1,1,0,0,5,0,1,1,3
7171,781223,6,0,1,0,0,0,1,0,0,0,0,1,1,0,0,0,0
7171,790848,1,0,1,0,0,0,1,0,0,0,1,0,0,0,0,0,0
7172,791352,32,6,11,3,5,3,6,2,2,2,4,1,1,1,0,1,17
7172,780455,19,4,6,4,6,0,0,1,1,2,9,1,1,0,1,2,9
7172,797251,31,1,7,1,4,0,3,1,2,2,6,2,1,0,1,2,3
7172,797247,35,3,7,2,5,1,2,7,9,1,5,8,1,0,4,0,14
7172,776297,34,4,7,1,1,3,6,7,9,0,8,1,2,1,2,0,18
7172,791355,1,0,0,0,0,0,0,0,0,0,0,0,1,0,0,0,0
7172,791354,5,0,3,0,3,0,0,2,2,1,0,0,0,0,0,1,2
7172,785837,24,4,9,3,7,1,2,2,2,0,2,1,3,0,2,0,11
7172,797248,19,1,7,1,3,0,4,0,0,0,1,3,1,1,0,0,2
7173,796927,14,1,4,1,1,0,3,0,0,0,4,0,2,0,0,0,2
7173,775324,18,2,11,2,11,0,0,0,0,5,3,1,3,2,2,1,4
7173,796929,24,2,6,0,0,2,6,1,2,0,0,1,1,0,0,0,7
7173,791224,36,8,22,8,18,0,4,5,5,3,1,5,0,2,2,0,21
7173,781181,31,4,13,3,7,1,6,1,1,1,7,3,5,2,1,0,10
7173,791225,27,0,3,0,3,0,0,1,4,2,3,0,1,0,0,1,1
7173,791811,13,0,2,0,2,0,0,0,0,0,2,0,2,0,0,0,0
7173,791222,16,2,3,2,2,0,1,0,0,0,3,3,0,0,1,0,4
7173,785564,21,5,13,1,3,4,10,1,1,0,1,1,2,0,1,0,15
7174,797824,22,2,6,2,4,0,2,3,3,1,0,1,2,0,1,0,7
7174,797825,14,1,2,1,2,0,0,0,2,1,1,1,3,2,3,0,2
7174,797822,25,3,10,2,6,1,4,0,0,0,5,2,3,1,3,0,7
7174,792190,37,2,9,2,5,0,4,1,2,0,6,8,2,1,1,0,5
7174,786664,37,9,19,8,14,1,5,0,0,0,2,3,0,3,0,0,19
7174,797828,3,0,1,0,1,0,0,0,0,0,1,0,0,0,0,0,0
7174,775116,24,3,7,2,4,1,3,0,0,2,4,0,0,0,1,0,7
7174,792191,21,4,4,4,4,0,0,0,0,1,1,2,0,1,2,2,8
7174,791928,14,3,4,1,2,2,2,0,0,0,1,0,0,0,2,0,8
7174,781266,3,0,0,0,0,0,0,0,0,0,0,1,0,0,0,0,0
7175,791723,18,3,4,3,4,0,0,0,0,0,0,1,3,1,1,1,6
7175,797310,34,7,11,3,5,4,6,0,0,0,3,5,1,1,2,1,18
7175,785580,35,5,7,4,6,1,1,2,2,1,6,9,0,1,1,0,13
7175,791724,27,5,8,3,5,2,3,3,4,1,2,4,3,1,1,1,15
7175,797308,24,2,4,1,2,1,2,0,0,1,1,1,0,0,1,0,5
7175,797312,8,1,1,1,1,0,0,0,0,0,0,0,0,0,0,0,2
7175,780956,26,2,9,2,6,0,3,1,1,0,6,1,1,1,6,1,5
7175,786277,2,0,0,0,0,0,0,0,0,0,0,0,0,0,1,0,0
7175,800056,3,0,0,0,0,0,0,0,0,0,0,0,0,0,0,0,0
7175,781617,23,6,9,2,4,4,5,1,2,0,6,4,1,1,2,0,17
7176,785509,20,2,6,2,3,0,3,2,5,1,6,1,0,0,0,1,6
7176,791424,29,6,10,6,9,0,1,0,0,2,5,1,0,3,1,0,12
7176,797085,32,4,11,3,7,1,4,0,0,5,6,2,0,1,5,0,9
7176,791421,30,5,9,2,4,3,5,1,2,0,4,1,3,1,2,0,14
7176,785899,31,4,10,1,2,3,8,1,2,0,2,2,2,0,0,0,12
7176,797079,2,0,1,0,1,0,0,0,0,0,0,0,1,0,0,0,0
7176,797081,2,0,1,0,1,0,0,0,0,0,0,0,0,0,0,0,0
7176,791425,18,3,5,3,5,0,0,5,8,2,2,2,0,3,1,3,11
7176,797086,6,0,0,0,0,0,0,0,0,0,0,0,1,0,0,0,0
7176,797090,9,0,2,0,2,0,0,0,0,0,2,0,1,0,2,0,0
7176,797084,2,0,0,0,0,0,0,0,0,0,0,0,0,0,0,0,0
7176,797083,3,0,1,0,0,0,1,0,0,0,0,0,1,0,0,0,0
7176,797088,16,2,3,1,1,1,2,0,0,1,2,2,1,0,0,1,5
7177,781650,19,1,3,1,3,0,0,0,0,1,3,0,3,0,1,0,2
7177,797067,28,3,7,3,7,0,0,1,2,1,3,0,1,0,2,0,7
7177,797068,30,2,8,0,5,2,3,0,0,0,3,0,1,1,2,0,6
7177,791432,25,1,9,1,6,0,3,0,0,0,2,1,4,1,3,0,2
7177,791429,25,3,6,3,5,0,1,3,5,1,3,3,0,1,3,0,9
7177,797066,21,3,6,3,6,0,0,0,0,0,2,0,4,1,0,1,6
7177,791431,7,1,2,1,2,0,0,0,0,0,2,0,0,0,0,0,2
7177,797070,23,2,7,1,4,1,3,0,0,0,0,0,1,0,1,0,5
7177,777865,22,2,6,2,6,0,0,0,0,0,5,1,1,2,1,0,4
7178,792473,20,3,5,2,4,1,1,0,0,0,2,0,5,0,3,0,7
7178,780036,16,1,6,1,4,0,2,2,2,0,0,1,1,1,0,1,4
7178,799276,20,0,2,0,2,0,0,3,4,1,0,2,0,0,1,0,3
7178,785249,40,8,16,2,4,6,12,11,11,0,1,3,2,5,3,1,33
7178,780035,25,1,2,0,0,1,2,1,2,1,0,2,2,2,2,0,4
7178,785251,19,1,3,0,0,1,3,1,2,0,4,1,5,0,1,0,4
7178,780043,24,1,2,0,0,1,2,0,0,0,3,1,1,1,2,1,3
7178,792478,22,0,3,0,0,0,3,0,0,0,0,3,3,0,1,0,0
7178,792474,14,1,1,0,0,1,1,2,2,1,0,0,3,2,1,0,5
7179,791281,25,1,1,1,1,0,0,4,5,1,5,1,3,0,5,0,6
7179,792276,23,3,4,2,3,1,1,2,2,2,3,0,4,2,2,0,9
7179,791278,32,2,5,1,2,1,3,0,0,1,2,2,1,0,1,0,5
7179,786026,15,2,4,2,2,0,2,2,2,0,3,0,2,0,1,0,6
7179,785507,28,4,6,1,1,3,5,6,8,0,3,0,4,0,3,0,17
7179,796534,11,0,0,0,0,0,0,0,0,0,1,2,1,1,1,0,0
7179,785764,16,3,6,3,6,0,0,5,6,2,3,1,1,0,1,0,11
7179,796536,2,0,0,0,0,0,0,0,0,0,0,0,1,0,0,0,0
7179,796535,17,2,2,1,1,1,1,0,0,0,0,2,2,1,2,0,5
7179,785398,12,2,4,2,4,0,0,0,0,0,0,1,0,1,1,0,4
7179,775814,19,2,3,2,3,0,0,2,4,0,0,0,1,0,3,1,6
7180,786769,38,3,7,2,4,1,3,3,4,0,2,1,2,0,2,0,10
7180,786024,19,1,6,0,2,1,4,0,0,0,3,1,2,1,2,2,3
7180,780002,36,8,15,8,13,0,2,0,1,0,3,4,1,1,7,0,16
7180,786772,25,2,2,2,2,0,0,0,0,0,4,0,3,0,0,0,4
7180,781484,23,3,9,2,3,1,6,2,2,1,3,0,5,2,0,1,9
7180,786773,6,0,0,0,0,0,0,0,0,0,1,1,0,0,0,1,0
7180,791967,14,1,7,0,3,1,4,0,0,0,1,0,0,0,0,0,3
7180,790823,23,3,6,2,3,1,3,0,0,1,1,0,2,0,1,0,7
7180,797840,16,1,2,1,2,0,0,0,0,0,2,1,1,0,2,0,2
7181,775260,30,3,10,2,6,1,4,3,3,0,2,4,1,0,0,0,10
7181,786732,23,4,6,4,5,0,1,1,2,3,3,1,1,2,2,0,9
7181,786615,26,2,6,2,4,0,2,2,2,0,3,0,1,0,2,0,6
7181,796444,33,8,11,8,11,0,0,1,3,0,7,3,2,1,3,4,17
7181,790893,29,5,10,5,10,0,0,2,6,7,5,1,2,2,1,0,12
7181,790889,16,1,2,1,2,0,0,0,0,0,3,1,2,1,2,0,2
7181,775536,15,5,9,5,9,0,0,1,1,0,1,0,0,0,1,0,11
7181,790890,23,0,3,0,3,0,0,2,3,0,0,4,2,1,1,0,2
7181,780702,5,0,0,0,0,0,0,0,0,0,0,0,1,0,0,0,0
7190,775110,36,9,15,9,14,0,1,2,3,3,8,0,2,0,2,1,20
7190,791392,37,2,3,2,2,0,1,1,1,0,5,14,3,0,0,0,5
7190,785936,32,1,1,0,0,1,1,0,0,2,2,0,3,1,1,0,3
7190,780128,30,7,12,2,5,5,7,3,3,0,0,3,1,1,3,0,22
7190,775458,35,15,20,11,15,4,5,2,2,0,5,3,2,3,3,0,36
7190,797134,2,0,0,0,0,0,0,0,0,0,1,0,0,0,0,0,0
7190,791394,3,0,0,0,0,0,0,0,0,0,1,0,2,0,0,0,0
7190,786062,2,0,0,0,0,0,0,0,0,0,0,0,0,0,1,0,0
7190,781353,2,0,0,0,0,0,0,0,0,0,0,0,0,0,0,0,0
7190,797138,11,0,4,0,3,0,1,0,0,1,1,0,1,0,1,0,0
7190,785264,10,1,6,0,2,1,4,0,0,0,1,1,0,2,2,0,3
7191,786183,13,1,3,1,2,0,1,0,0,0,1,0,2,0,1,0,2
7191,780105,30,5,11,4,5,1,6,2,3,0,3,2,1,2,1,0,13
7191,785637,34,5,9,1,3,4,6,1,1,0,0,2,2,2,4,0,15
7191,785915,30,0,1,0,0,0,1,0,0,0,3,0,1,0,0,0,0
7191,781131,34,8,14,7,11,1,3,2,3,2,3,6,0,0,3,0,19
7191,791408,6,1,1,1,1,0,0,0,0,1,1,1,1,0,2,0,2
7191,785916,16,4,10,2,4,2,6,4,4,3,2,0,4,0,2,2,14
7191,785914,3,0,0,0,0,0,0,0,0,0,1,0,0,0,0,0,0
7191,780106,4,1,1,1,1,0,0,0,0,1,1,0,0,0,1,0,2
7191,797108,7,1,1,1,1,0,0,0,2,0,0,0,0,0,1,0,2
7191,791409,4,0,2,0,1,0,1,0,0,0,0,0,0,1,0,0,0
7191,785894,19,0,4,0,0,0,4,0,0,0,1,0,0,0,0,0,0
7192,786131,30,3,8,2,4,1,4,2,2,1,4,2,0,0,4,1,9
7192,780904,23,4,6,4,6,0,0,3,4,1,5,1,2,0,1,0,11
7192,797685,37,8,12,6,8,2,4,2,2,2,4,3,1,0,2,1,20
7192,786145,19,1,3,1,1,0,2,0,0,0,0,0,0,1,0,0,2
7192,786128,37,5,13,5,9,0,4,11,11,0,6,4,1,0,2,0,21
7192,797684,1,0,0,0,0,0,0,0,1,0,0,0,0,0,0,0,0
7192,792100,16,3,3,3,3,0,0,1,2,2,5,0,3,1,1,1,7
7192,785884,31,2,5,0,2,2,3,2,2,1,0,0,3,0,0,1,8
7192,797686,2,1,1,1,1,0,0,0,0,0,0,1,0,0,0,0,2
7192,792099,1,0,0,0,0,0,0,0,0,0,0,0,0,0,0,0,0
7192,792098,1,0,0,0,0,0,0,0,0,0,0,0,0,0,0,0,0
7192,786141,1,0,0,0,0,0,0,0,0,0,0,0,0,0,0,0,0
7192,780906,1,0,0,0,0,0,0,0,0,0,0,0,0,0,0,0,0
7193,797701,14,0,0,0,0,0,0,0,0,0,1,2,3,0,2,0,0
7193,792101,30,5,11,4,6,1,5,0,0,0,2,1,2,0,0,0,11
7193,792102,16,2,3,1,1,1,2,0,0,0,2,0,1,0,1,0,5
7193,775564,26,5,12,5,11,0,1,0,2,1,2,1,2,1,0,0,10
7193,776386,27,4,12,4,9,0,3,3,3,4,2,3,0,1,0,0,11
7193,797700,22,2,8,2,7,0,1,2,2,1,5,1,4,2,2,0,6
7193,797697,2,1,1,1,1,0,0,0,0,0,1,0,1,0,0,0,2
7193,791856,2,0,1,0,1,0,0,0,0,0,0,0,0,0,0,0,0
7193,780922,26,1,1,1,1,0,0,0,0,0,4,1,1,0,1,1,2
7193,797703,1,1,1,1,1,0,0,0,0,1,0,1,0,0,0,0,2
7193,786165,2,1,1,0,0,1,1,0,0,0,0,0,0,0,0,0,3
7193,786160,6,1,2,1,2,0,0,0,0,0,0,1,2,1,0,0,2
7193,780923,24,5,9,3,6,2,3,0,0,0,0,2,0,1,3,1,12
7193,786156,1,0,0,0,0,0,0,0,0,0,0,0,0,0,0,0,0
7193,792103,1,0,0,0,0,0,0,0,0,0,0,0,0,0,0,0,0
7194,797174,23,0,5,0,4,0,1,0,1,0,2,1,3,0,0,0,0
7194,791510,24,0,3,0,1,0,2,6,6,2,7,1,3,1,0,0,6
7194,786699,23,2,4,2,4,0,0,3,4,0,4,0,4,0,0,0,7
7194,785593,27,6,9,2,4,4,5,2,2,0,2,0,4,1,3,0,18
7194,775357,32,3,9,1,4,2,5,7,8,0,3,2,3,2,2,0,15
7194,791507,17,2,4,2,4,0,0,0,0,1,1,0,1,2,1,0,4
7194,797168,29,9,16,7,12,2,4,5,5,0,2,4,1,0,2,1,25
7194,791508,3,0,0,0,0,0,0,0,0,0,1,0,1,0,0,0,0
7194,791504,22,1,4,1,3,0,1,1,2,1,1,1,3,2,1,0,3
7195,791289,1,0,1,0,1,0,0,0,0,0,0,0,1,0,0,1,0
7195,796574,29,3,8,1,2,2,6,0,0,0,3,3,3,0,2,0,8
7195,796571,11,0,2,0,2,0,0,2,2,0,4,0,1,0,0,0,2
7195,796572,30,0,3,0,3,0,0,2,5,3,5,1,4,0,4,0,2
7195,781346,36,11,16,5,7,6,9,4,5,0,1,1,1,1,4,0,32
7195,785786,32,1,1,1,1,0,0,4,7,3,4,1,3,1,1,1,6
7195,791287,2,1,1,1,1,0,0,0,0,0,0,0,1,0,0,0,2
7195,796576,29,5,11,4,5,1,6,3,5,0,4,4,2,2,4,0,14
7195,791290,16,1,6,1,3,0,3,1,2,0,3,0,3,0,0,0,3
7195,791291,14,0,4,0,1,0,3,2,2,0,1,0,2,0,0,0,2
7196,796657,21,1,2,1,2,0,0,0,0,1,0,0,0,0,1,0,2
7196,796650,36,8,9,8,8,0,1,8,8,6,3,3,3,1,2,1,24
7196,791323,40,3,8,1,1,2,7,0,0,0,3,8,4,0,0,2,8
7196,791320,42,5,16,4,11,1,5,1,2,2,2,3,4,1,4,0,12
7196,785912,37,6,18,2,6,4,12,11,12,2,7,6,3,2,2,1,27
7196,796651,9,0,2,0,1,0,1,0,0,0,1,0,1,0,0,0,0
7196,796654,13,3,4,1,2,2,2,0,0,0,0,0,1,0,1,0,8
7196,791321,25,2,4,2,4,0,0,1,4,3,4,1,4,0,0,0,5
7196,796656,2,0,0,0,0,0,0,0,0,0,1,0,0,0,0,0,0
7197,786519,33,5,9,5,9,0,0,2,5,5,11,0,5,1,0,0,12
7197,791911,30,2,2,0,0,2,2,0,0,0,3,2,4,1,0,0,6
7197,797556,38,6,11,4,7,2,4,2,2,0,0,2,1,0,3,1,16
7197,791913,39,7,14,5,9,2,5,6,7,0,2,4,1,0,0,0,22
7197,786520,37,3,13,3,12,0,1,5,7,1,3,3,1,1,3,0,11
7197,797558,10,1,2,0,0,1,2,0,2,0,0,0,0,0,2,0,3
7197,791912,6,1,1,1,1,0,0,0,0,0,1,0,3,0,0,0,2
7197,797560,5,0,0,0,0,0,0,0,0,0,0,0,0,0,1,0,0
7197,797559,4,0,0,0,0,0,0,0,0,1,0,0,0,0,0,0,0
7197,797555,13,2,5,2,4,0,1,2,3,2,1,1,2,0,1,0,6
7197,781105,10,1,2,0,0,1,2,1,2,1,1,0,2,1,0,0,4
7198,797163,28,5,9,5,8,0,1,5,7,1,6,1,5,0,2,4,15
7198,797164,17,1,1,1,1,0,0,0,2,2,4,3,5,0,3,0,2
7198,786450,26,6,11,3,7,3,4,1,1,3,5,1,3,3,1,0,16
7198,776396,29,3,5,1,2,2,3,3,3,0,1,2,4,2,3,0,11
7198,776199,33,4,11,3,5,1,6,4,5,0,2,5,1,1,3,0,13
7198,797167,12,1,1,1,1,0,0,0,0,0,2,0,3,0,1,0,2
7198,791385,20,1,2,0,1,1,1,3,4,1,3,3,2,0,4,1,6
7198,797166,0,0,0,0,0,0,0,0,0,0,0,0,1,0,0,0,0
7198,797161,10,1,5,1,3,0,2,2,2,0,1,3,1,2,0,0,4
7198,797165,17,3,5,1,2,2,3,5,6,1,2,0,1,0,3,1,13
7198,791382,5,0,1,0,1,0,0,0,0,0,0,0,0,0,0,0,0
7198,791386,3,1,1,0,0,1,1,0,0,0,0,0,0,0,0,0,3
7199,786404,30,4,6,4,5,0,1,6,6,4,4,1,0,2,3,1,14
7199,780378,21,5,10,5,10,0,0,2,6,3,5,0,4,3,2,4,12
7199,786378,21,0,4,0,1,0,3,0,0,1,1,2,2,1,1,0,0
7199,786374,26,4,11,3,9,1,2,6,6,2,3,3,5,4,1,3,15
7199,786253,27,5,13,5,12,0,1,2,8,0,0,2,1,0,2,0,12
7199,780382,16,2,2,2,2,0,0,0,0,2,1,1,3,0,2,0,4
7199,797065,14,0,3,0,0,0,3,0,0,0,1,1,0,1,0,0,0
7199,797061,11,1,2,0,0,1,2,1,2,0,0,1,2,1,3,0,4
7199,791562,12,0,1,0,0,0,1,3,4,0,0,1,2,1,0,0,3
7199,785798,12,0,3,0,0,0,3,0,0,0,0,0,4,0,2,0,0
7199,780381,7,0,0,0,0,0,0,0,0,0,0,0,0,1,0,0,0
7199,780121,3,1,2,0,0,1,2,0,1,0,0,0,0,0,0,0,3
7200,791669,26,3,7,3,7,0,0,0,0,0,4,1,1,0,0,1,6
7200,785762,24,7,10,7,8,0,2,3,3,1,6,1,3,0,6,0,17
7200,797407,18,0,1,0,1,0,0,1,2,0,0,0,2,0,1,0,1
7200,791666,31,9,13,5,8,4,5,0,0,0,2,3,0,1,3,0,22
7200,780531,35,5,10,2,3,3,7,2,2,0,7,9,1,1,0,0,15
7200,797414,13,1,2,1,2,0,0,1,3,0,0,0,3,0,1,1,3
7200,797411,2,0,0,0,0,0,0,1,2,0,2,0,0,0,1,0,1
7200,780534,15,3,4,3,4,0,0,1,2,1,3,1,0,0,1,0,7
7200,797409,20,2,4,1,1,1,3,0,0,0,1,1,1,2,0,0,5
7200,791671,2,0,1,0,0,0,1,0,0,0,0,0,1,0,0,0,0
7200,797415,4,0,0,0,0,0,0,0,0,1,1,0,0,0,1,0,0
7200,785760,8,1,1,0,0,1,1,0,0,0,0,0,0,1,0,0,3
7200,780535,2,0,0,0,0,0,0,0,0,0,0,0,0,0,0,0,0
7201,781516,11,1,2,1,2,0,0,0,0,0,1,0,2,0,0,0,2
7201,797331,29,3,8,1,2,2,6,0,0,0,3,0,0,0,1,0,8
7201,791737,25,2,5,2,3,0,2,2,3,1,1,3,1,1,3,0,6
7201,783524,23,1,7,1,3,0,4,0,0,0,1,2,1,2,2,0,2
7201,780561,23,2,6,1,1,1,5,0,0,0,4,1,0,1,2,0,5
7201,791734,17,3,7,3,7,0,0,2,6,2,3,0,2,0,1,0,8
7201,791736,2,0,1,0,1,0,0,0,0,1,1,0,0,0,0,0,0
7201,775913,13,5,9,5,9,0,0,0,0,2,1,0,1,0,0,0,10
7201,797333,16,2,2,0,0,2,2,0,0,0,2,0,2,0,1,1,6
7201,786223,14,1,3,1,2,0,1,0,0,1,0,0,1,0,0,0,2
7201,786220,21,3,8,2,6,1,2,4,4,1,4,2,0,3,3,1,11
7201,795372,6,0,0,0,0,0,0,0,0,0,0,0,0,0,0,0,0
7202,797235,30,4,5,4,5,0,0,0,2,3,3,1,2,1,1,0,8
7202,797232,38,3,11,2,4,1,7,0,0,0,1,2,2,0,1,1,7
7202,797237,13,0,3,0,2,0,1,0,2,1,0,1,0,0,0,0,0
7202,797234,14,2,3,2,3,0,0,2,2,2,2,3,5,0,1,0,6
7202,797239,37,6,16,1,7,5,9,0,0,0,1,3,3,0,1,0,17
7202,797233,10,0,0,0,0,0,0,0,0,0,0,0,1,0,0,0,0
7202,791368,23,3,3,3,3,0,0,2,2,2,4,1,3,0,1,0,8
7202,786535,4,1,1,1,1,0,0,0,0,1,0,0,1,0,0,0,2
7202,797240,2,0,1,0,0,0,1,0,0,0,0,0,0,0,0,0,0
7202,785446,2,0,2,0,1,0,1,0,0,0,0,0,1,0,1,0,0
7202,791367,27,5,13,5,10,0,3,3,4,0,2,3,1,2,1,0,13
7203,792167,28,4,8,4,8,0,0,4,4,3,7,0,2,0,0,1,12
7203,797766,20,1,4,1,3,0,1,0,2,3,1,0,3,0,1,0,2
7203,791372,36,6,11,3,4,3,7,2,2,0,1,2,2,0,1,0,17
7203,792164,33,5,13,4,8,1,5,2,2,1,4,3,1,0,5,0,13
7203,780974,36,6,13,5,9,1,4,7,7,1,5,0,1,1,1,0,20
7203,797767,28,3,3,3,3,0,0,1,1,0,1,4,1,1,3,0,7
7203,797772,8,1,1,0,0,1,1,0,0,1,1,1,0,0,0,0,3
7203,792163,10,0,1,0,0,0,1,0,0,1,1,1,3,0,0,0,0
7203,797764,1,0,0,0,0,0,0,0,0,0,1,0,2,0,0,0,0
7204,792299,27,2,6,2,4,0,2,1,2,0,3,5,3,0,2,1,5
7204,786181,26,5,12,5,11,0,1,0,7,7,2,3,2,2,0,0,10
7204,792304,34,3,8,0,3,3,5,5,6,2,4,0,2,4,3,1,14
7204,792301,36,7,13,6,10,1,3,4,6,0,5,6,2,1,3,0,19
7204,786286,32,1,4,0,1,1,3,1,2,0,3,0,1,1,0,0,4
7204,798092,2,0,1,0,0,0,1,0,0,0,1,0,0,0,1,0,0
7204,792302,6,2,2,2,2,0,0,0,0,0,0,0,2,2,0,0,4
7204,798093,4,0,0,0,0,0,0,0,0,0,0,0,0,0,0,0,0
7204,786280,16,2,4,2,4,0,0,0,0,1,0,0,2,1,1,0,4
7204,786278,17,3,9,1,2,2,7,0,0,0,1,0,4,0,1,0,8
7205,774812,30,7,10,7,10,0,0,5,8,0,6,1,3,1,5,2,19
7205,791498,14,1,1,1,1,0,0,0,0,1,2,0,3,0,1,2,2
7205,797180,18,2,4,0,0,2,4,0,0,0,1,1,2,1,2,1,6
7205,791497,33,3,7,2,4,1,3,2,3,0,1,1,1,1,2,0,9
7205,781486,30,7,13,6,10,1,3,0,2,2,3,2,4,3,4,1,15
7205,791500,6,0,0,0,0,0,0,0,0,0,2,0,0,0,0,0,0
7205,791502,1,0,0,0,0,0,0,0,0,0,0,0,0,0,0,0,0
7205,786842,31,4,8,4,6,0,2,0,0,4,4,3,4,0,3,1,8
7205,780240,14,0,4,0,2,0,2,0,2,0,3,3,0,0,2,0,0
7205,776379,23,2,5,2,2,0,3,3,3,0,1,3,0,0,0,0,7
7206,791787,25,2,7,0,2,2,5,4,4,2,2,2,4,0,4,2,10
7206,789048,29,4,6,4,6,0,0,0,2,2,8,1,3,1,2,0,8
7206,789046,32,5,8,2,2,3,6,0,0,2,3,1,2,0,1,0,13
7206,791786,29,3,8,3,5,0,3,0,0,1,1,4,2,1,6,0,6
7206,789041,25,2,6,0,0,2,6,2,2,0,4,3,3,0,1,0,8
7206,791785,6,0,3,0,2,0,1,0,0,0,0,1,2,0,0,0,0
7206,785540,11,0,0,0,0,0,0,2,2,0,0,0,2,0,1,0,2
7206,797631,9,1,1,1,1,0,0,0,0,0,0,1,1,0,1,0,2
7206,797630,20,3,7,0,2,3,5,1,2,0,0,0,0,1,0,0,10
7206,797629,7,1,2,1,2,0,0,0,0,0,0,0,2,1,1,0,2
7206,789044,7,1,3,0,1,1,2,0,0,1,1,0,1,0,0,0,3
7207,796617,13,1,1,1,1,0,0,0,0,1,0,0,3,0,2,2,2
7207,775131,35,2,9,1,2,1,7,0,0,1,1,1,4,0,3,0,5
7207,796616,34,4,10,2,3,2,7,2,2,0,1,0,1,0,0,0,12
7207,796612,32,4,10,4,9,0,1,1,3,1,1,3,2,2,4,0,9
7207,785562,34,7,12,6,10,1,2,9,9,1,8,0,3,2,3,1,24
7207,792429,8,3,3,1,1,2,2,0,0,0,0,1,0,1,0,0,8
7207,796614,2,0,1,0,0,0,1,0,0,0,1,0,0,0,0,0,0
7207,796607,18,1,1,0,0,1,1,3,4,0,3,4,5,0,2,0,6
7207,796606,24,0,1,0,1,0,0,0,0,1,4,3,1,1,1,0,0
7208,781624,26,5,8,3,5,2,3,2,2,2,6,1,2,0,0,0,14
7208,792246,33,13,21,13,21,0,0,0,1,5,7,0,2,0,0,3,26
7208,797925,22,0,3,0,1,0,2,0,0,1,1,0,2,1,0,0,0
7208,781420,38,1,10,1,7,0,3,4,4,0,2,6,0,1,1,0,6
7208,781405,38,11,21,7,14,4,7,4,4,0,6,6,3,0,4,0,30
7208,797924,5,0,2,0,1,0,1,0,0,0,1,1,1,0,0,0,0
7208,780615,7,1,1,1,1,0,0,0,0,0,3,1,2,0,1,0,2
7208,791701,10,3,3,3,3,0,0,0,0,0,1,0,0,0,0,0,6
7208,792245,21,0,3,0,1,0,2,0,0,0,4,3,3,2,0,0,0
7209,776253,14,0,5,0,3,0,2,0,0,2,0,1,2,0,1,1,0
7209,775651,25,5,9,4,7,1,2,2,2,1,2,0,3,0,3,1,13
7209,791070,26,6,11,3,6,3,5,5,7,3,7,3,1,0,1,0,20
7209,791627,28,1,9,0,3,1,6,2,2,0,2,4,2,0,3,0,5
7209,785665,36,6,13,2,3,4,10,2,2,2,4,4,2,0,0,0,18
7209,796505,8,0,2,0,2,0,0,0,0,0,2,1,0,0,0,0,0
7209,791071,4,1,1,1,1,0,0,0,1,0,1,0,0,0,0,0,2
7209,785660,3,0,0,0,0,0,0,0,1,0,0,0,0,0,0,0,0
7209,796504,23,4,9,1,3,3,6,0,0,2,2,0,3,0,0,0,11
7209,796501,15,2,2,1,1,1,1,2,2,0,2,1,0,1,1,0,7
7209,776178,18,2,7,2,5,0,2,0,0,1,3,1,2,1,1,0,4
7209,796502,0,0,0,0,0,0,0,0,0,0,0,0,0,0,0,0,0
7210,791053,20,2,3,2,3,0,0,0,0,0,1,1,4,0,1,0,4
7210,780739,30,7,10,7,10,0,0,0,2,6,2,2,2,1,0,0,14
7210,785524,30,1,8,1,2,0,6,3,4,3,2,1,4,0,2,0,5
7210,781115,30,2,5,2,5,0,0,0,1,0,2,5,1,2,1,1,4
7210,775456,26,7,11,5,8,2,3,2,2,2,3,5,0,0,4,1,18
7210,796731,11,1,1,1,1,0,0,0,0,1,1,0,1,1,0,0,2
7210,796730,10,0,4,0,0,0,4,0,0,0,1,0,0,0,0,0,0
7210,790819,25,9,10,4,4,5,6,1,3,1,4,4,0,2,1,0,24
7210,786310,3,1,3,0,0,1,3,0,0,0,0,0,0,0,0,0,3
7210,775094,13,1,6,1,2,0,4,0,0,0,3,1,2,2,1,0,2
7210,791052,2,0,0,0,0,0,0,0,0,0,0,0,0,0,0,0,0
7211,780913,16,1,4,0,0,1,4,0,0,1,1,1,3,1,1,0,3
7211,798119,24,7,9,3,3,4,6,0,0,0,3,0,1,0,0,0,18
7211,798117,28,1,7,1,4,0,3,0,0,1,0,6,3,0,5,0,2
7211,780594,32,5,9,3,3,2,6,0,0,0,1,1,3,0,2,0,12
7211,775664,30,4,7,1,1,3,6,0,0,0,4,2,2,0,1,0,11
7211,798123,29,6,12,5,9,1,3,7,8,4,8,2,3,1,3,0,20
7211,769332,4,0,1,0,0,0,1,0,0,0,0,0,1,0,0,0,0
7211,798124,29,1,4,1,2,0,2,0,0,0,1,4,0,0,1,0,2
7211,798121,8,1,1,0,0,1,1,0,0,0,1,0,0,0,1,0,3
7212,786059,28,6,9,4,6,2,3,1,1,2,3,3,3,0,3,1,15
7212,776174,29,6,9,6,9,0,0,9,13,2,7,2,3,3,7,0,21
7212,791958,32,6,12,6,11,0,1,5,8,2,3,4,5,0,0,0,17
7212,791960,34,4,12,2,6,2,6,0,0,1,1,7,3,1,0,0,10
7212,785861,36,3,7,0,1,3,6,0,0,0,8,0,1,0,1,0,9
7212,797704,14,2,2,0,0,2,2,0,0,0,1,2,2,1,0,0,6
7212,781332,27,4,6,2,2,2,4,4,4,1,4,5,2,0,2,0,14
7213,792036,20,1,3,1,3,0,0,1,1,2,1,1,2,0,0,0,3
7213,792043,24,5,9,2,5,3,4,1,1,0,2,2,0,0,0,0,14
7213,786266,36,10,17,5,9,5,8,4,5,0,8,2,2,2,2,1,29
7213,797718,29,2,5,2,5,0,0,0,0,0,3,7,2,1,2,0,4
7213,775028,22,3,8,3,8,0,0,0,0,0,1,2,4,1,4,0,6
7213,797728,11,1,4,1,2,0,2,2,2,0,2,0,1,0,1,0,4
7213,797726,15,3,8,2,5,1,3,1,2,1,1,0,4,1,1,0,8
7213,786039,10,0,1,0,1,0,0,0,0,2,1,0,5,0,2,0,0
7213,792040,31,5,9,5,8,0,1,3,8,2,3,2,1,1,1,0,13
7213,797723,2,0,0,0,0,0,0,0,0,0,0,0,0,0,0,0,0
7214,791089,30,3,6,3,5,0,1,1,2,1,3,2,1,1,4,0,7
7214,791094,18,0,4,0,2,0,2,0,0,1,1,0,2,0,1,0,0
7214,791091,15,0,2,0,1,0,1,0,0,0,2,0,3,1,4,1,0
7214,791093,29,4,8,4,7,0,1,3,4,1,4,2,4,2,0,0,11
7214,785569,20,1,6,0,1,1,5,2,6,1,0,1,2,0,1,0,5
7214,791097,12,4,5,4,5,0,0,0,0,1,0,0,1,0,0,1,8
7214,791092,2,0,0,0,0,0,0,0,0,0,1,0,0,0,0,0,0
7214,796753,29,4,8,0,0,4,8,2,2,0,1,0,2,1,1,0,14
7214,796752,28,1,3,1,2,0,1,0,0,0,3,5,4,0,1,0,2
7214,791090,17,2,10,1,5,1,5,0,0,1,0,0,1,0,2,0,5
7215,792593,27,4,7,4,7,0,0,2,2,4,3,0,2,1,4,1,10
7215,792594,26,4,6,4,5,0,1,7,7,1,8,2,3,3,3,1,15
7215,792588,33,4,11,0,2,4,9,0,1,0,5,1,3,3,0,0,12
7215,792595,34,6,9,3,4,3,5,0,0,1,2,6,3,2,5,0,15
7215,792583,23,2,5,1,2,1,3,0,0,0,1,3,3,1,1,0,5
7215,796989,2,0,0,0,0,0,0,0,0,0,0,0,0,0,0,0,0
7215,792580,11,0,0,0,0,0,0,0,0,0,2,0,4,0,1,0,0
7215,796988,3,0,0,0,0,0,0,0,0,0,2,0,0,0,0,0,0
7215,796987,21,2,3,2,2,0,1,1,3,0,2,6,1,0,3,0,5
7215,792591,16,1,4,0,0,1,4,4,4,0,1,0,0,0,0,0,7
7215,792592,2,0,2,0,2,0,0,0,0,0,0,0,0,0,0,0,0
7215,792586,2,1,1,0,0,1,1,0,0,0,0,0,0,0,0,0,3
7216,781107,23,4,7,4,7,0,0,0,2,1,2,1,4,0,2,6,8
7216,780863,19,2,4,1,2,1,2,2,2,1,3,1,4,0,2,0,7
7216,796777,4,0,1,0,0,0,1,0,0,0,0,0,0,0,0,0,0
7216,785366,34,2,10,2,5,0,5,5,6,0,8,4,2,2,4,0,9
7216,791972,35,5,12,3,5,2,7,0,1,1,7,6,2,0,1,0,12
7216,796778,7,2,2,2,2,0,0,0,0,1,2,0,5,0,1,1,4
7216,791971,18,2,5,1,4,1,1,3,3,0,0,1,0,2,0,0,8
7216,796780,17,1,4,1,1,0,3,5,7,0,2,2,2,0,1,0,7
7216,791974,32,4,8,2,4,2,4,2,2,0,5,1,1,2,2,0,12
7216,780867,8,2,2,2,2,0,0,0,0,1,0,0,0,0,1,0,4
7216,791973,3,0,0,0,0,0,0,0,0,0,0,0,0,0,0,0,0
7217,785930,27,3,8,3,8,0,0,3,4,0,7,0,0,0,2,2,9
7217,780995,23,1,5,1,3,0,2,4,5,2,1,3,2,2,1,0,6
7217,780996,28,4,8,2,4,2,4,0,0,1,7,1,3,2,1,1,10
7217,790920,12,0,3,0,1,0,2,0,0,0,1,0,2,0,1,0,0
7217,796468,33,7,11,6,9,1,2,1,2,2,0,4,2,2,2,0,16
7217,796466,9,0,2,0,2,0,0,0,0,1,2,0,1,0,0,0,0
7217,791035,32,4,12,3,7,1,5,2,2,0,4,1,4,0,2,0,11
7217,775709,28,3,8,0,2,3,6,8,8,1,2,1,2,1,1,0,17
7217,796467,8,0,2,0,0,0,2,0,0,0,2,0,1,0,0,0,0
7218,790846,24,3,6,3,4,0,2,0,0,1,2,1,0,2,1,4,6
7218,796754,20,1,8,1,7,0,1,0,0,3,5,1,2,0,3,1,2
7218,796755,18,2,3,2,3,0,0,0,0,3,1,0,3,0,0,0,4
7218,791099,40,6,15,0,5,6,10,0,0,0,4,1,3,0,1,1,18
7218,780298,38,5,15,2,5,3,10,1,1,0,6,5,2,3,6,1,14
7218,780315,25,1,1,0,0,1,1,0,0,1,1,4,2,0,2,0,3
7218,780814,13,1,1,1,1,0,0,0,0,0,2,2,0,0,0,0,2
7218,785586,22,2,4,2,3,0,1,0,1,1,4,2,2,2,1,0,4
7219,792271,14,4,6,4,6,0,0,0,0,4,1,0,1,1,2,0,8
7219,791686,26,0,2,0,2,0,0,0,0,1,1,1,1,0,2,1,0
7219,790940,36,5,15,4,8,1,7,3,3,2,6,0,3,3,1,0,14
7219,786060,35,4,12,3,8,1,4,0,0,1,3,1,0,0,0,0,9
7219,780770,36,4,12,2,7,2,5,4,5,1,1,5,3,1,6,0,14
7219,792269,27,0,3,0,2,0,1,1,2,0,4,1,2,1,0,1,1
7219,798028,17,0,1,0,1,0,0,0,0,1,2,0,0,0,0,0,0
7219,798022,8,1,4,0,2,1,2,0,0,0,0,0,0,0,0,0,3
7219,792270,1,0,1,0,0,0,1,0,0,0,0,0,0,0,0,0,0
7219,798020,0,0,1,0,0,0,1,0,0,0,0,0,0,0,0,0,0
7220,791524,30,4,10,3,5,1,5,0,0,0,5,2,1,2,1,0,9
7220,797139,27,8,15,8,15,0,0,5,6,4,8,0,4,1,1,1,21
7220,775394,28,2,5,2,3,0,2,3,3,0,2,2,1,0,1,0,7
7220,791526,33,6,8,4,5,2,3,1,1,1,0,4,2,0,4,0,15
7220,780272,25,3,7,3,4,0,3,0,0,1,4,3,3,0,1,0,6
7220,786354,9,1,2,1,2,0,0,0,0,0,2,0,2,0,1,0,2
7220,797141,0,0,1,0,0,0,1,0,0,0,1,0,0,0,0,0,0
7220,791523,12,1,1,0,0,1,1,0,0,1,0,1,1,1,0,0,3
7220,797137,0,0,0,0,0,0,0,0,0,0,0,0,0,0,0,0,0
7220,780273,21,0,2,0,1,0,1,0,0,1,1,2,0,1,1,0,0
7220,775592,15,2,6,1,3,1,3,2,2,0,2,0,1,0,3,0,7
7221,792288,25,2,4,2,4,0,0,0,0,0,3,0,3,0,2,0,4
7221,785227,22,0,4,0,4,0,0,0,4,3,5,3,3,0,2,2,0
7221,786237,27,4,8,4,8,0,0,3,4,0,2,6,0,2,3,0,11
7221,786232,21,4,6,3,4,1,2,0,0,0,0,0,2,0,1,0,9
7221,780287,27,4,12,3,8,1,4,1,2,0,1,0,1,1,2,0,10
7221,798072,3,2,2,2,2,0,0,1,1,0,0,0,1,0,0,0,5
7221,798067,17,2,3,2,3,0,0,0,0,2,3,1,4,0,0,0,4
7221,798084,5,1,1,0,0,1,1,0,0,0,1,0,0,0,0,0,3
7221,792278,31,3,9,1,1,2,8,0,0,0,0,2,1,0,2,0,8
7221,776309,22,2,5,2,4,0,1,0,0,0,4,1,0,4,0,0,4
7222,797662,20,3,7,3,4,0,3,0,0,1,4,0,0,0,1,1,6
7222,786067,34,4,7,4,7,0,0,1,2,0,4,1,1,1,0,0,9
7222,797661,21,3,8,2,4,1,4,0,0,0,1,4,3,1,2,0,7
7222,785591,27,0,5,0,2,0,3,2,2,0,1,0,2,2,3,0,2
7222,780258,28,3,7,2,5,1,2,0,0,2,2,2,2,0,3,0,7
7222,792082,12,1,5,1,2,0,3,0,0,0,1,1,0,0,1,0,2
7222,792078,11,2,4,2,4,0,0,0,0,2,1,0,0,1,1,0,4
7222,791952,5,0,0,0,0,0,0,0,0,0,0,0,1,0,0,0,0
7222,797660,25,4,5,4,5,0,0,1,2,1,2,2,4,3,2,0,9
7222,792083,17,1,3,1,3,0,0,1,2,0,0,1,3,2,2,0,3
7223,791883,24,3,6,2,2,1,4,2,2,2,3,2,3,0,5,1,9
7223,781066,24,4,5,4,5,0,0,0,0,2,5,2,4,0,5,0,8
7223,797594,26,2,6,0,0,2,6,3,4,1,1,2,1,1,1,1,9
7223,791884,27,6,10,6,9,0,1,4,5,0,3,2,1,0,2,0,16
7223,780695,25,4,8,3,4,1,4,0,0,2,2,2,0,1,1,0,9
7223,797600,7,0,2,0,0,0,2,0,0,0,1,0,0,2,0,0,0
7223,797598,15,2,3,2,3,0,0,1,2,2,5,0,2,1,2,0,5
7223,797597,3,0,1,0,0,0,1,0,0,0,2,0,1,0,0,0,0
7223,791885,3,0,1,0,1,0,0,0,0,0,0,0,0,0,0,0,0
7223,797596,24,2,5,0,0,2,5,0,0,0,0,3,1,1,1,0,6
7223,786496,22,1,3,0,1,1,2,0,2,1,1,1,0,2,0,0,3
7224,776100,22,3,6,2,5,1,1,0,1,0,2,0,0,0,3,0,7
7224,785991,34,7,10,7,10,0,0,4,4,3,9,0,4,1,5,2,18
7224,797762,25,2,7,2,4,0,3,2,2,2,2,9,1,1,0,0,6
7224,781406,37,7,13,4,7,3,6,0,1,2,3,1,1,0,2,1,17
7224,781401,32,6,11,3,7,3,4,2,2,1,4,3,2,2,4,0,17
7224,797758,6,1,1,1,1,0,0,2,2,0,1,0,0,0,0,0,4
7224,781029,29,3,8,1,1,2,7,0,0,1,2,6,2,1,1,0,8
7224,775317,15,0,1,0,0,0,1,0,5,0,1,1,3,2,1,0,0
7225,791839,28,1,2,1,2,0,0,0,0,3,6,4,5,2,3,4,2
7225,785322,30,5,8,2,2,3,6,0,0,1,5,0,1,0,3,0,13
7225,797444,29,3,6,1,3,2,3,1,1,2,1,1,2,2,1,0,9
7225,792381,30,7,17,2,9,5,8,0,0,0,4,2,2,1,3,0,19
7225,791842,35,7,22,4,11,3,11,1,1,1,1,1,1,1,3,0,18
7225,797443,13,0,0,0,0,0,0,2,2,2,3,0,3,0,1,0,2
7225,786613,12,0,1,0,1,0,0,2,2,0,3,1,3,0,0,0,2
7225,786736,23,2,5,2,5,0,0,2,2,0,0,3,1,1,4,0,6
7226,797779,37,9,13,6,6,3,7,6,8,1,6,0,3,0,5,0,27
7226,785568,38,2,4,2,3,0,1,7,7,3,10,0,4,1,1,2,11
7226,797778,17,0,6,0,2,0,4,4,4,0,2,0,3,1,1,1,4
7226,786256,33,5,7,5,7,0,0,2,2,5,9,1,3,1,7,3,12
7226,797774,26,3,8,2,4,1,4,5,7,0,6,2,0,1,3,0,12
7226,797770,7,0,0,0,0,0,0,0,2,0,2,0,1,0,1,0,0
7226,797776,10,1,3,1,2,0,1,1,4,0,1,2,0,1,2,0,3
7226,797768,6,0,4,0,2,0,2,0,0,0,0,0,1,0,1,0,0
7226,775106,24,2,3,1,2,1,1,1,2,0,2,2,2,1,5,0,6
7226,797771,2,0,0,0,0,0,0,0,0,0,0,0,0,0,0,0,0
7227,796860,31,6,13,6,11,0,2,1,2,2,4,1,5,0,2,1,13
7227,791187,16,2,3,2,3,0,0,1,2,0,5,0,5,0,0,0,5
7227,796857,5,0,1,0,1,0,0,0,0,0,0,0,0,0,0,0,0
7227,785650,17,0,1,0,1,0,0,0,0,0,2,0,3,1,1,0,0
7227,785649,35,10,20,7,10,3,10,2,3,1,2,3,3,4,3,0,25
7227,791183,12,0,3,0,3,0,0,1,2,0,1,1,4,1,0,0,1
7227,791185,18,2,9,1,7,1,2,2,2,1,2,0,4,2,2,0,7
7227,796861,19,0,3,0,3,0,0,0,0,0,0,2,1,0,0,0,0
7227,796856,19,6,11,4,5,2,6,0,1,0,0,2,3,2,1,0,14
7227,791184,28,1,2,0,0,1,2,1,2,0,3,7,1,1,4,0,4
7228,796568,25,4,5,4,5,0,0,0,0,0,4,0,3,0,1,0,8
7228,796566,30,3,7,3,7,0,0,5,7,5,6,1,3,2,2,2,11
7228,790969,35,3,11,3,7,0,4,7,9,0,2,6,0,2,0,0,13
7228,780166,30,4,7,2,5,2,2,7,7,0,0,8,2,1,0,0,17
7228,775107,19,1,4,1,2,0,2,0,0,0,1,1,2,1,1,0,2
7228,796564,4,0,0,0,0,0,0,0,0,0,1,0,0,0,0,0,0
7228,790971,11,0,0,0,0,0,0,0,0,0,2,0,4,0,0,0,0
7228,796569,7,2,2,2,2,0,0,0,2,0,0,0,0,1,1,0,4
7228,796563,7,2,3,2,3,0,0,0,0,0,0,0,3,0,1,0,4
7228,790968,16,2,4,0,0,2,4,0,0,0,2,3,0,2,1,0,6
7228,790967,16,3,5,1,1,2,4,0,0,0,3,0,1,0,1,0,8
7229,791493,33,4,5,4,5,0,0,3,6,4,9,4,2,0,2,3,11
7229,789036,28,2,7,2,6,0,1,2,2,0,1,1,3,2,4,0,6
7229,797191,13,0,2,0,1,0,1,0,0,0,2,1,2,1,1,0,0
7229,791494,14,1,4,1,3,0,1,0,0,0,2,1,2,1,1,0,2
7229,776494,34,7,11,2,3,5,8,3,4,1,0,1,4,0,2,0,22
7229,780504,14,3,3,3,3,0,0,1,2,0,1,1,2,0,1,0,7
7229,791495,18,1,3,1,1,0,2,0,2,0,3,0,2,0,0,0,2
7229,778888,27,2,5,2,2,0,3,2,2,0,3,7,1,0,1,0,6
7229,791492,19,2,6,0,2,2,4,0,1,0,1,0,2,2,1,0,6
7230,785681,24,0,1,0,1,0,0,0,0,0,7,0,0,0,2,1,0
7230,796789,27,5,13,4,7,1,6,0,0,1,2,1,4,3,2,1,11
7230,791126,25,2,5,2,4,0,1,4,8,2,4,4,5,0,2,0,8
7230,791124,27,3,5,3,5,0,0,2,2,0,1,4,4,0,1,0,8
7230,780050,37,13,19,10,13,3,6,4,4,1,5,3,3,1,2,0,33
7230,784479,7,1,4,1,2,0,2,1,2,0,2,0,1,0,0,0,3
7230,796786,11,3,6,1,1,2,5,1,1,1,1,1,1,0,0,0,9
7230,775813,9,1,3,1,3,0,0,3,5,2,1,1,2,0,1,0,5
7230,796784,16,1,2,1,1,0,1,0,0,0,0,3,1,0,0,0,2
7230,796782,17,2,3,2,2,0,1,0,0,0,1,0,1,2,1,0,4
7230,792711,0,0,0,0,0,0,0,0,0,0,0,0,0,0,0,0,0
7230,796783,0,0,0,0,0,0,0,0,0,0,0,0,0,0,0,0,0
7231,786792,33,4,5,4,5,0,0,1,2,2,4,1,3,2,1,0,9
7231,792414,34,5,7,0,0,5,7,2,5,0,5,0,3,0,2,2,17
7231,789020,33,6,9,3,5,3,4,3,4,3,5,3,4,2,4,1,18
7231,786787,39,9,21,5,11,4,10,13,13,0,6,6,0,3,2,0,35
7231,774954,22,1,3,1,3,0,0,0,0,0,2,2,2,0,2,0,2
7231,786795,9,1,2,1,1,0,1,1,1,1,1,1,2,0,0,0,3
7231,781497,0,0,0,0,0,0,0,0,0,0,0,0,2,0,0,0,0
7231,792091,26,1,9,0,5,1,4,2,2,1,2,1,3,0,1,0,5
7231,781456,4,0,1,0,1,0,0,0,0,0,0,0,0,0,0,0,0
7232,781007,23,2,3,2,3,0,0,1,1,4,4,3,5,0,0,2,5
7232,781322,38,5,12,2,4,3,8,3,3,0,4,0,1,1,0,0,16
7232,785989,32,2,7,2,4,0,3,1,6,2,4,1,4,1,2,2,5
7232,786571,35,5,20,4,16,1,4,4,6,2,3,2,3,1,3,0,15
7232,781439,36,5,12,5,11,0,1,5,5,3,5,1,1,1,2,0,15
7232,797299,11,0,1,0,1,0,0,2,2,0,3,1,2,0,1,0,2
7232,781207,10,2,3,1,2,1,1,0,0,1,0,2,0,0,3,0,5
7232,780563,18,3,5,1,2,2,3,0,0,0,1,1,1,2,0,1,8
7232,791690,11,0,1,0,1,0,0,1,2,0,0,0,3,1,0,0,1
7232,781419,11,0,1,0,1,0,0,0,0,0,0,1,0,0,0,0,0
7233,791416,40,7,8,7,8,0,0,7,12,3,10,0,2,0,1,4,21
7233,781614,5,0,1,0,1,0,0,0,0,0,0,1,1,1,1,0,0
7233,797096,36,4,10,2,3,2,7,0,0,0,7,1,4,0,0,1,10
7233,785906,43,12,23,10,17,2,6,5,8,2,1,6,1,4,4,0,31
7233,780096,41,3,8,1,2,2,6,2,2,0,3,1,3,1,3,0,10
7233,797094,10,2,5,1,4,1,1,0,0,2,0,0,1,0,0,1,5
7233,785907,5,0,0,0,0,0,0,0,0,0,0,0,3,0,0,0,0
7233,797093,14,0,3,0,2,0,1,0,0,0,2,4,2,0,3,0,0
7233,780100,31,0,0,0,0,0,0,0,0,1,4,2,2,0,0,2,0
7234,780256,26,2,10,2,6,0,4,3,3,1,0,1,2,2,1,0,7
7234,785874,20,1,3,0,2,1,1,0,0,1,5,0,1,0,1,0,3
7234,796883,23,2,3,2,3,0,0,0,0,0,3,1,1,0,2,0,4
7234,791757,21,2,8,1,4,1,4,0,0,2,1,0,2,0,1,0,5
7234,791334,35,3,7,3,4,0,3,2,2,0,3,1,1,0,1,0,8
7234,791760,19,3,12,3,11,0,1,4,4,1,3,0,2,0,2,1,10
7234,796879,14,2,3,1,2,1,1,0,0,1,2,1,4,0,2,0,5
7234,796880,27,2,6,1,3,1,3,0,0,0,3,1,3,1,1,1,5
7234,781590,15,1,2,1,1,0,1,1,2,1,2,0,1,0,1,0,3
7235,786704,28,6,9,6,9,0,0,2,3,1,3,0,3,0,3,0,14
7235,785395,28,1,6,1,5,0,1,0,0,1,6,2,3,1,0,3,2
7235,775840,30,1,4,1,4,0,0,4,4,2,2,2,1,2,1,0,6
7235,775955,35,4,16,2,10,2,6,4,5,0,3,4,1,0,1,0,14
7235,775811,15,0,2,0,0,0,2,1,2,1,3,1,2,0,0,0,1
7235,792327,2,0,0,0,0,0,0,0,0,0,0,0,0,0,0,0,0
7235,786706,9,2,3,2,3,0,0,1,1,2,3,0,3,0,0,2,5
7235,775287,12,1,4,1,2,0,2,0,0,0,0,0,0,0,0,0,2
7235,790921,15,5,9,4,6,1,3,0,0,1,2,1,1,3,2,1,11
7235,786551,26,2,7,2,5,0,2,0,0,1,1,1,0,0,0,0,4
7244,780377,33,6,10,1,1,5,9,0,0,1,4,2,4,2,1,1,17
7244,791852,31,3,5,3,5,0,0,3,4,0,10,2,2,1,0,4,9
7244,797460,22,4,7,2,4,2,3,0,0,1,2,0,3,1,1,1,10
7244,797461,24,1,12,1,9,0,3,0,1,1,2,3,1,0,4,2,2
7244,786601,16,2,8,0,2,2,6,0,0,0,7,0,2,0,3,1,6
7244,791851,26,1,2,0,1,1,1,0,0,0,2,5,3,0,3,0,3
7244,791853,9,0,3,0,3,0,0,2,4,2,1,0,3,0,0,0,2
7244,786600,27,6,11,5,9,1,2,3,6,3,2,3,4,1,4,0,16
7244,786599,12,1,3,1,3,0,0,0,0,1,0,0,2,0,0,0,2
7245,791067,31,4,7,4,7,0,0,10,13,5,4,2,1,0,0,2,18
7245,780751,14,2,7,2,6,0,1,0,0,1,4,3,0,0,1,2,4
7245,796743,28,5,11,2,5,3,6,3,4,0,4,5,3,0,2,0,16
7245,791068,27,3,6,1,3,2,3,1,2,1,2,0,2,1,0,0,9
7245,785551,28,1,7,1,6,0,1,0,0,2,5,1,3,1,2,0,2
7245,785642,5,1,2,1,2,0,0,2,2,1,0,0,3,0,0,0,4
7245,780512,24,4,12,4,10,0,2,3,3,3,6,1,2,2,1,1,11
7245,780756,6,0,4,0,3,0,1,0,0,0,1,0,0,0,1,0,0
7245,796744,9,0,4,0,3,0,1,2,2,2,0,0,0,1,1,0,2
7245,791066,22,3,10,2,5,1,5,1,2,1,3,0,2,2,1,0,8
7245,791065,6,0,2,0,1,0,1,0,0,0,0,0,0,0,0,0,0
7246,780023,34,1,6,1,6,0,0,0,0,0,4,2,4,3,0,4,2
7246,792493,31,1,5,0,1,1,4,0,0,1,0,1,3,0,1,0,3
7246,792495,39,9,15,6,9,3,6,4,7,1,7,3,1,3,2,0,25
7246,792491,38,4,7,4,6,0,1,7,10,1,5,1,1,2,3,1,15
7246,781144,20,1,5,1,2,0,3,0,0,0,3,0,2,0,3,0,2
7246,798959,7,0,1,0,0,0,1,0,0,0,0,1,0,0,1,1,0
7246,788128,3,0,1,0,0,0,1,0,0,0,1,0,0,0,0,0,0
7246,786832,28,2,4,1,3,1,1,10,10,1,5,0,4,3,3,0,15
7247,797466,31,6,11,6,10,0,1,4,8,4,5,1,2,1,0,0,16
7247,791858,34,3,10,3,4,0,6,0,0,1,4,1,2,0,0,0,6
7247,797463,33,5,16,5,11,0,5,5,5,1,4,4,1,1,2,0,15
7247,791109,31,3,6,3,5,0,1,1,4,3,3,1,5,0,5,1,7
7247,785625,34,1,7,1,3,0,4,0,0,3,3,1,5,2,1,0,2
7247,797464,15,0,3,0,3,0,0,1,2,0,3,1,4,2,2,0,1
7247,797465,13,2,3,2,3,0,0,1,1,1,2,0,1,2,1,0,5
7247,791854,9,2,4,1,1,1,3,0,0,0,1,0,0,0,2,0,5
7248,785740,20,3,8,3,8,0,0,0,0,4,4,0,4,0,0,0,6
7248,785809,36,5,13,4,8,1,5,4,4,2,4,2,2,3,3,1,15
7248,780530,38,6,11,5,9,1,2,2,2,2,7,1,2,1,2,2,15
7248,797402,34,3,6,1,2,2,4,0,0,0,7,0,1,1,1,0,8
7248,785738,37,5,10,3,8,2,2,4,6,0,4,9,2,0,0,0,16
7248,797396,5,0,0,0,0,0,0,0,0,1,0,0,2,0,1,0,0
7248,785739,2,0,0,0,0,0,0,1,2,1,0,0,0,0,0,0,1
7248,786144,24,1,6,0,2,1,4,0,0,0,0,1,0,0,0,0,3
7248,791664,2,0,0,0,0,0,0,0,0,0,0,0,0,0,1,0,0
7248,780526,1,0,1,0,1,0,0,0,0,0,0,0,0,0,0,0,0
7248,797401,1,0,0,0,0,0,0,0,0,0,0,0,0,0,0,0,0
7249,775556,34,5,9,4,5,1,4,0,0,2,5,0,2,1,2,2,11
7249,780234,28,2,9,2,7,0,2,2,2,1,8,0,1,0,1,0,6
7249,786411,23,0,4,0,1,0,3,4,4,2,1,0,3,1,1,0,4
7249,780046,30,3,8,3,6,0,2,0,0,0,3,1,2,1,2,0,6
7249,781104,40,5,13,4,9,1,4,2,2,1,0,3,3,0,3,0,13
7249,781110,15,0,1,0,0,0,1,0,0,0,3,0,4,0,1,1,0
7249,797185,18,2,4,2,3,0,1,0,0,2,1,0,1,0,1,0,4
7249,786405,12,1,6,1,5,0,1,0,2,0,1,0,1,2,1,0,2
7250,780686,31,6,13,6,12,0,1,2,4,3,4,5,2,1,1,0,14
7250,780683,34,6,10,3,5,3,5,8,8,4,9,1,2,0,0,1,23
7250,797680,18,0,4,0,3,0,1,0,0,1,2,1,2,0,0,0,0
7250,786112,29,4,11,2,7,2,4,3,3,1,4,6,1,4,4,0,13
7250,780688,32,8,13,6,6,2,7,0,0,0,4,0,2,0,0,0,18
7250,797683,2,0,0,0,0,0,0,0,0,0,0,0,2,0,0,0,0
7250,797682,4,0,0,0,0,0,0,0,0,1,0,0,2,0,0,0,0
7250,797681,29,5,9,2,4,3,5,0,0,0,0,4,3,1,1,0,13
7250,797677,1,0,1,0,0,0,1,0,0,0,0,0,0,0,0,0,0
7250,791942,7,0,0,0,0,0,0,0,0,0,0,1,1,0,1,0,0
7250,780689,10,1,5,0,3,1,2,0,0,1,1,1,1,0,0,0,3
7250,797679,3,0,0,0,0,0,0,0,0,0,0,0,0,0,0,0,0
7251,780521,22,1,5,0,1,1,4,0,0,0,3,1,2,0,0,0,3
7251,775163,14,2,3,2,3,0,0,0,0,2,1,1,0,1,2,0,4
7251,791370,31,5,11,5,5,0,6,0,0,1,2,1,3,0,0,0,10
7251,786199,36,8,14,5,8,3,6,5,6,0,5,4,3,2,1,0,24
7251,780991,36,8,13,6,9,2,4,0,0,1,4,2,1,0,4,0,18
7251,780145,8,0,0,0,0,0,0,1,2,1,0,1,2,0,1,1,1
7251,781611,18,1,1,1,1,0,0,3,5,1,4,0,1,1,1,0,5
7251,797271,21,0,5,0,2,0,3,0,0,0,2,1,2,0,1,1,0
7251,743593,14,2,3,2,3,0,0,1,2,0,1,0,3,0,1,0,5
7251,791371,0,0,0,0,0,0,0,0,0,0,0,0,0,0,0,0,0
7252,797873,30,3,5,3,4,0,1,0,0,3,4,1,2,0,0,1,6
7252,797877,26,4,14,4,11,0,3,0,1,2,2,1,3,0,1,0,8
7252,797872,31,4,7,3,5,1,2,2,2,5,1,4,3,0,2,0,11
7252,791338,30,4,6,4,6,0,0,4,4,0,6,2,4,1,1,0,12
7252,791339,30,6,15,3,9,3,6,3,3,3,1,4,3,3,2,2,18
7252,791337,16,1,5,1,5,0,0,2,2,1,3,1,1,0,0,0,4
7252,785881,11,1,2,1,2,0,0,0,0,3,0,0,1,1,3,0,2
7252,781599,9,0,1,0,1,0,0,0,0,0,1,2,0,0,1,0,0
7252,781595,17,3,8,2,4,1,4,0,1,0,0,0,1,1,0,0,7
7253,796766,17,0,2,0,1,0,1,4,6,0,0,0,2,0,0,0,4
7253,785614,20,1,3,1,3,0,0,0,0,2,0,0,2,1,0,1,2
7253,796767,31,4,10,1,5,3,5,3,4,2,3,1,0,0,1,1,14
7253,796765,29,4,6,2,2,2,4,0,0,0,0,2,5,1,4,0,10
7253,780812,37,10,20,6,11,4,9,5,6,2,10,1,1,3,3,2,29
7253,791113,20,0,2,0,1,0,1,0,0,2,1,0,3,0,1,1,0
7253,785618,23,0,5,0,1,0,4,0,0,0,3,1,1,0,0,0,0
7253,780813,23,4,7,4,5,0,2,2,3,2,2,2,2,1,1,0,10
7254,791482,27,4,7,4,5,0,2,3,4,3,3,8,2,0,2,0,11
7254,786319,19,5,9,5,9,0,0,4,5,4,6,2,1,0,2,0,14
7254,797199,19,4,4,3,3,1,1,0,0,0,1,2,0,1,0,0,9
7254,786318,31,1,6,0,1,1,5,2,2,0,7,4,1,4,1,0,5
7254,780223,26,4,6,1,2,3,4,0,0,0,1,2,0,0,1,0,11
7254,797198,3,0,0,0,0,0,0,0,0,0,2,0,1,0,0,0,0
7254,791481,18,2,5,1,4,1,1,1,1,0,6,0,0,0,0,0,6
7254,780225,24,4,8,3,4,1,4,0,0,0,2,0,3,0,0,0,9
7254,797200,7,1,3,0,0,1,3,0,0,0,0,0,2,0,0,0,3
7254,797201,1,0,0,0,0,0,0,0,0,0,0,0,1,0,1,0,0
7254,784268,25,1,5,0,2,1,3,2,2,0,1,1,2,0,4,0,5
7255,791882,23,2,4,2,4,0,0,0,1,1,3,0,2,0,1,0,4
7255,786493,30,7,14,1,4,6,10,4,5,0,2,1,3,0,0,0,24
7255,786491,25,3,8,3,7,0,1,1,1,2,4,2,2,0,4,0,7
7255,791881,29,1,4,1,3,0,1,0,0,0,1,5,2,1,2,0,2
7255,786420,31,4,10,1,3,3,7,2,2,0,3,3,0,0,1,0,13
7255,797616,15,1,4,1,4,0,0,1,2,1,3,0,2,0,1,1,3
7255,797613,21,3,6,1,2,2,4,0,0,0,0,0,2,3,1,1,8
7255,781258,2,0,0,0,0,0,0,0,1,0,0,0,0,0,0,0,0
7255,781052,20,0,2,0,0,0,2,0,0,0,2,0,2,0,0,0,0
7255,797618,2,0,0,0,0,0,0,0,0,0,0,0,0,0,0,0,0
7255,797615,1,0,0,0,0,0,0,0,0,0,0,0,0,0,0,0,0
7255,797617,1,0,0,0,0,0,0,0,0,0,0,0,0,0,0,0,0
7256,797047,19,1,5,1,5,0,0,3,4,1,3,0,1,1,0,0,5
7256,775515,26,2,3,1,1,1,2,0,0,1,6,0,2,2,0,2,5
7256,791579,26,7,12,5,8,2,4,0,0,0,3,8,0,1,2,1,16
7256,786387,32,10,15,9,13,1,2,4,6,0,5,2,0,0,2,0,25
7256,780399,28,7,9,6,7,1,2,0,0,1,3,8,3,1,3,0,15
7256,786846,21,2,6,0,2,2,4,0,0,0,0,2,1,0,0,0,6
7256,780400,16,3,5,1,1,2,4,0,0,1,4,1,1,1,0,0,8
7256,791575,11,4,6,4,6,0,0,1,1,0,2,0,1,0,0,0,9
7256,797046,13,5,8,0,1,5,7,0,1,0,4,1,1,0,1,0,15
7256,791574,2,1,1,0,0,1,1,0,0,0,0,0,0,0,0,0,3
7256,791577,2,0,0,0,0,0,0,0,0,1,1,1,0,0,0,0,0
7256,786391,2,0,1,0,0,0,1,0,0,0,0,0,0,0,0,0,0
7256,786390,2,0,0,0,0,0,0,0,0,0,1,0,0,0,0,0,0
7257,796979,24,2,7,1,2,1,5,0,0,0,1,3,2,3,1,0,5
7257,776200,21,0,7,0,7,0,0,1,2,0,4,0,0,0,1,0,1
7257,786437,21,4,6,3,4,1,2,0,0,0,4,2,2,0,2,0,9
7257,780925,30,7,11,2,3,5,8,3,4,1,2,1,2,1,1,0,22
7257,781034,34,5,11,5,10,0,1,3,3,1,4,1,1,0,2,0,13
7257,791625,16,2,8,2,5,0,3,0,2,2,3,2,2,0,0,0,4
7257,796978,5,2,5,1,1,1,4,0,1,1,2,0,0,0,0,0,5
7257,791622,14,1,1,1,1,0,0,0,0,0,2,0,2,0,2,0,2
7257,791624,26,4,8,2,2,2,6,0,2,1,3,4,4,0,0,0,10
7257,791637,9,3,5,1,1,2,4,0,0,0,0,0,0,1,1,0,8
7258,797258,8,0,1,0,1,0,0,0,0,0,1,0,0,0,2,0,0
7258,786080,39,9,17,4,5,5,12,3,4,0,7,0,2,0,5,2,26
7258,791348,19,1,5,1,4,0,1,0,0,1,2,0,4,1,2,0,2
7258,791350,27,3,4,2,3,1,1,0,0,0,3,4,4,2,0,0,7
7258,786218,34,5,8,4,4,1,4,4,5,0,2,1,1,1,4,0,15
7258,786216,32,4,8,4,7,0,1,4,4,1,8,1,1,0,2,1,12
7258,781645,21,1,1,1,1,0,0,2,4,0,3,1,1,1,2,1,4
7258,780156,9,0,0,0,0,0,0,0,0,1,1,1,0,0,0,0,0
7258,780150,11,0,1,0,0,0,1,0,0,0,0,0,0,0,0,0,0
7259,780229,36,11,16,11,16,0,0,1,3,5,4,3,2,2,0,0,23
7259,795572,40,3,9,2,6,1,3,2,2,0,3,4,2,2,4,0,9
7259,791483,34,5,12,5,6,0,6,2,2,1,2,4,1,1,2,0,12
7259,786322,20,0,4,0,3,0,1,0,0,0,2,0,3,0,1,0,0
7259,780228,29,3,9,0,0,3,9,1,3,0,2,0,2,1,0,0,10
7259,791484,2,0,1,0,0,0,1,0,0,0,0,0,1,0,0,0,0
7259,781592,22,1,3,1,2,0,1,1,2,0,3,2,3,1,1,1,3
7259,797193,13,1,2,0,0,1,2,0,0,0,2,0,1,1,0,0,3
7259,786323,4,0,0,0,0,0,0,0,0,0,0,0,1,1,1,0,0
7260,785622,30,4,7,4,5,0,2,0,0,0,1,0,1,0,2,0,8
7260,781058,28,1,4,1,3,0,1,0,1,0,10,0,4,0,2,0,2
7260,780327,17,3,5,3,5,0,0,0,2,1,1,0,3,1,0,0,6
7260,797458,32,1,2,1,2,0,0,2,2,0,3,1,3,0,2,0,4
7260,797451,35,6,15,5,11,1,4,1,2,0,2,3,3,3,2,0,14
7260,797455,16,3,6,3,6,0,0,1,1,3,3,0,2,0,2,2,7
7260,797456,11,0,2,0,1,0,1,0,0,0,2,0,0,0,0,0,0
7260,797453,6,3,3,3,3,0,0,0,0,0,0,0,1,0,0,0,6
7260,791848,7,0,2,0,0,0,2,0,0,0,1,0,0,0,0,0,0
7260,791849,10,0,3,0,0,0,3,0,0,0,2,2,1,0,1,1,0
7260,786607,8,0,3,0,3,0,0,0,0,0,1,0,1,0,1,0,0
7261,785459,20,4,9,4,9,0,0,1,2,1,6,0,3,0,1,0,9
7261,789102,37,5,11,3,7,2,4,0,0,1,7,6,1,1,6,0,12
7261,789101,19,0,3,0,2,0,1,2,2,0,0,1,4,0,1,0,2
7261,781371,27,1,5,0,0,1,5,2,2,0,3,2,0,2,3,0,5
7261,781367,26,3,7,0,3,3,4,5,8,1,4,0,0,1,0,0,14
7261,797731,12,2,2,2,2,0,0,0,0,0,1,0,1,0,1,0,4
7261,792066,22,1,4,1,4,0,0,0,2,4,2,0,2,1,0,0,2
7261,792064,20,0,6,0,3,0,3,0,0,2,3,2,1,1,0,0,0
7261,792063,12,2,6,0,1,2,5,1,2,0,2,0,0,1,0,0,7
7261,792061,5,0,1,0,0,0,1,0,0,0,1,0,0,0,0,0,0
7262,786434,9,3,5,3,5,0,0,1,2,0,0,0,4,0,0,0,7
7262,780440,34,2,6,1,2,1,4,0,0,3,7,1,1,0,0,1,5
7262,791621,31,2,6,1,4,1,2,4,4,0,1,3,2,0,1,0,9
7262,786432,30,2,3,1,2,1,1,2,2,0,2,0,5,1,0,0,7
7262,786431,33,8,14,6,10,2,4,6,7,1,2,3,3,1,2,0,24
7262,791619,3,0,1,0,0,0,1,0,0,0,1,0,0,0,0,0,0
7262,791620,3,0,1,0,1,0,0,0,0,0,0,0,0,0,0,0,0
7262,781125,26,5,6,5,6,0,0,0,0,2,5,0,1,1,2,0,10
7262,775620,5,1,1,1,1,0,0,0,0,0,1,0,0,0,0,0,2
7262,781088,20,4,7,4,5,0,2,4,4,0,1,2,2,0,3,0,12
7262,775622,6,0,1,0,1,0,0,0,0,0,0,0,0,0,0,0,0
7263,790935,23,3,9,1,5,2,4,0,0,4,1,2,2,2,1,1,8
7263,792442,25,4,5,4,5,0,0,1,1,3,4,0,2,0,0,2,9
7263,780933,31,5,13,2,4,3,9,2,2,1,4,1,1,0,1,0,15
7263,775340,37,10,18,6,7,4,11,1,2,0,3,3,3,1,2,0,25
7263,774826,29,2,3,0,0,2,3,2,3,2,2,5,2,1,1,0,8
7263,796190,9,1,2,0,0,1,2,0,0,0,0,0,0,0,0,0,3
7263,790937,14,2,2,2,2,0,0,3,4,1,1,0,3,0,1,1,7
7263,785445,13,3,6,1,1,2,5,0,0,1,0,0,2,1,2,0,8
7263,796493,1,0,1,0,1,0,0,0,0,0,0,0,0,0,0,0,0
7263,790938,16,0,2,0,2,0,0,0,0,0,1,1,3,0,0,0,0
7263,796492,2,0,0,0,0,0,0,0,0,0,0,0,0,0,0,0,0
7264,776344,22,5,7,4,5,1,2,1,2,2,6,4,2,2,1,0,12
7264,775821,26,6,14,3,7,3,7,1,2,0,4,1,1,1,1,0,16
7264,792453,34,5,8,5,8,0,0,2,3,1,3,6,3,3,1,0,12
7264,785131,27,3,5,2,4,1,1,1,1,0,3,2,1,1,2,0,8
7264,781538,28,8,10,2,2,6,8,0,0,0,2,2,1,2,0,0,22
7264,798113,14,0,2,0,1,0,1,2,2,2,2,0,3,0,1,0,2
7264,785152,16,0,3,0,3,0,0,0,0,0,5,1,4,0,0,1,0
7264,798115,16,3,5,1,1,2,4,1,2,0,1,0,2,0,1,0,9
7264,792322,1,0,0,0,0,0,0,0,0,0,0,0,0,0,0,0,0
7264,792324,2,0,1,0,0,0,1,0,0,0,0,0,0,0,0,0,0
7264,776233,13,1,4,0,2,1,2,2,2,0,1,0,1,0,2,0,5
7264,786696,1,0,0,0,0,0,0,0,0,0,0,0,0,0,0,0,0
7265,781530,23,5,11,4,8,1,3,0,2,0,5,3,2,1,1,0,11
7265,776423,23,2,5,2,5,0,0,0,0,1,6,0,1,0,1,0,4
7265,798096,22,1,4,1,3,0,1,2,2,0,2,0,1,1,1,0,4
7265,792307,17,2,5,0,2,2,3,0,0,0,0,1,0,1,1,0,6
7265,792319,20,1,4,1,4,0,0,0,0,0,2,1,0,0,0,0,2
7265,792316,5,0,1,0,1,0,0,1,2,0,0,0,1,0,0,0,1
7265,792314,15,2,7,2,7,0,0,1,1,3,2,0,2,0,2,1,5
7265,786296,12,1,3,1,2,0,1,2,4,0,1,0,2,0,0,0,4
7265,792320,12,2,2,2,2,0,0,0,0,0,1,0,2,0,1,0,4
7265,798106,17,0,2,0,2,0,0,1,2,1,2,1,1,1,2,0,1
7265,798104,20,8,13,6,8,2,5,3,3,0,1,0,2,0,2,0,21
7265,792309,9,0,2,0,1,0,1,2,2,0,0,0,0,1,1,0,2
7265,798102,3,0,0,0,0,0,0,0,0,0,0,0,0,0,0,0,0
7265,792321,2,0,0,0,0,0,0,0,0,0,0,0,0,0,0,0,0
7266,785481,37,6,12,6,11,0,1,4,7,5,10,1,2,0,1,3,16
7266,780631,17,5,8,3,6,2,2,0,0,1,0,1,5,1,2,0,12
7266,797391,19,3,7,0,1,3,6,0,0,0,1,1,0,1,0,0,9
7266,786625,43,3,6,1,2,2,4,2,2,0,5,8,4,2,5,0,10
7266,780625,44,2,10,0,3,2,7,4,4,0,1,6,2,2,1,0,10
7266,797397,10,0,1,0,1,0,0,0,2,1,2,0,0,0,1,1,0
7266,791830,2,0,0,0,0,0,0,0,0,0,0,0,1,0,0,1,0
7266,797395,36,4,7,3,5,1,2,1,2,0,2,3,1,2,4,0,10
7266,797394,20,5,6,3,3,2,3,3,10,1,1,1,3,2,0,0,15
7266,786630,22,3,5,3,5,0,0,0,0,0,5,0,2,0,3,0,6
7267,797529,40,2,5,2,4,0,1,2,3,4,6,0,4,2,1,0,6
7267,797527,44,6,8,6,8,0,0,3,4,4,2,0,4,1,1,0,15
7267,791936,46,8,11,8,11,0,0,9,12,6,14,2,2,0,3,0,25
7267,797532,50,2,17,1,10,1,7,4,5,1,0,10,4,2,4,0,9
7267,785688,42,7,23,1,6,6,17,2,3,0,3,0,0,2,3,0,22
7267,797528,4,0,1,0,1,0,0,0,0,0,2,0,2,0,1,0,0
7267,791932,15,0,1,0,0,0,1,0,0,0,1,1,2,1,1,0,0
7267,791933,1,0,1,0,1,0,0,0,0,0,0,0,0,0,0,0,0
7267,785988,8,1,2,0,1,1,1,2,2,0,1,0,2,0,1,0,5
7267,797530,0,0,0,0,0,0,0,0,0,0,0,0,0,0,0,0,0
7268,791062,27,10,15,9,12,1,3,1,2,1,3,1,3,1,0,0,22
7268,791063,19,1,2,1,2,0,0,0,0,0,6,2,4,0,3,1,2
7268,796735,12,1,3,0,1,1,2,0,0,0,1,0,1,0,0,0,3
7268,785542,35,1,1,1,1,0,0,3,3,1,5,3,0,1,0,0,5
7268,780743,37,6,14,5,9,1,5,2,2,0,8,1,1,2,3,0,15
7268,796741,1,0,0,0,0,0,0,0,2,0,1,0,0,0,0,0,0
7268,785548,20,3,4,2,3,1,1,0,0,0,2,1,3,0,1,0,7
7268,796736,6,0,1,0,0,0,1,0,0,0,1,0,0,0,0,0,0
7268,791064,28,4,7,4,4,0,3,2,2,0,1,2,1,2,1,0,10
7268,780055,14,0,2,0,0,0,2,0,0,0,0,1,0,0,0,0,0
7268,796737,1,0,0,0,0,0,0,0,0,0,0,0,0,0,0,0,0
7269,785948,33,2,4,2,4,0,0,4,6,2,7,1,2,1,4,1,8
7269,792020,34,5,12,3,5,2,7,0,0,0,2,1,0,1,1,0,12
7269,785946,17,0,3,0,0,0,3,0,0,0,2,1,0,0,0,0,0
7269,785939,30,3,11,2,6,1,5,2,2,1,1,0,2,1,0,0,9
7269,785938,25,5,9,3,5,2,4,0,0,0,2,3,2,1,1,0,12
7269,792026,18,4,5,4,5,0,0,0,1,2,1,0,1,0,1,0,8
7269,792025,10,0,2,0,2,0,0,0,0,0,2,0,0,0,0,0,0
7269,797635,1,0,0,0,0,0,0,0,0,0,0,0,1,0,0,0,0
7269,797634,3,0,1,0,0,0,1,0,0,0,0,0,1,0,0,0,0
7269,792024,1,0,1,0,1,0,0,0,0,0,1,0,0,0,0,0,0
7269,792023,27,0,2,0,1,0,1,0,2,1,2,1,2,1,2,0,0
7269,785941,1,0,0,0,0,0,0,0,0,0,0,0,0,0,0,1,0
7270,792378,23,3,6,3,6,0,0,0,1,2,3,0,4,1,1,1,6
7270,786746,31,3,11,3,7,0,4,5,6,5,4,1,3,1,0,0,11
7270,780178,22,3,8,3,8,0,0,2,3,2,1,0,2,0,1,0,8
7270,792376,37,5,16,2,4,3,12,9,10,0,8,1,2,1,3,0,22
7270,797883,37,3,10,2,7,1,3,0,0,4,2,4,0,2,3,0,7
7270,797890,17,2,6,2,5,0,1,2,4,0,0,1,2,0,0,0,6
7270,797888,5,0,0,0,0,0,0,1,2,0,2,0,2,0,0,0,1
7270,775075,16,2,2,2,2,0,0,0,0,4,3,0,2,0,1,0,4
7270,797885,3,0,1,0,1,0,0,0,0,0,0,0,0,0,0,0,0
7270,786747,9,1,1,1,1,0,0,0,0,0,0,1,0,1,0,0,2
7271,786123,37,5,9,5,9,0,0,1,1,2,6,2,5,0,2,5,11
7271,780437,36,9,13,9,12,0,1,5,6,2,6,1,4,0,4,0,23
7271,797673,26,1,6,0,3,1,3,1,3,1,1,0,4,0,4,0,4
7271,786118,40,3,11,1,2,2,9,2,3,2,5,3,4,1,0,0,10
7271,786117,38,3,6,3,5,0,1,2,5,1,2,3,3,1,3,0,8
7271,797672,4,0,1,0,1,0,0,0,0,1,0,0,1,1,0,0,0
7271,792093,19,1,4,1,3,0,1,6,7,1,2,0,3,0,2,0,8
7272,780085,24,4,6,4,6,0,0,1,3,5,0,1,0,0,0,0,9
7272,774874,38,6,14,6,14,0,0,1,3,2,3,2,1,0,1,0,13
7272,796531,35,1,6,1,6,0,0,3,4,1,3,5,2,1,0,0,5
7272,785270,32,9,18,4,7,5,11,2,3,0,1,0,4,0,2,0,25
7272,775468,33,5,12,4,10,1,2,1,2,0,1,2,3,3,4,0,12
7272,790946,19,2,3,2,2,0,1,0,0,1,3,2,0,0,1,0,4
7272,786037,2,0,1,0,1,0,0,0,0,1,0,0,1,0,0,0,0
7272,780084,9,1,4,0,1,1,3,0,0,0,2,0,4,0,1,0,3
7272,776038,8,0,1,0,1,0,0,0,0,0,2,0,0,0,0,0,0
7273,791606,37,8,14,5,8,3,6,0,0,1,3,4,3,1,1,3,19
7273,786410,36,3,7,3,6,0,1,3,4,0,2,4,3,1,3,1,9
7273,775095,9,3,4,3,4,0,0,0,1,1,0,0,3,0,4,0,6
7273,791605,30,5,7,2,2,3,5,1,1,0,2,2,3,0,2,0,14
7273,786406,40,6,9,4,6,2,3,3,5,1,4,9,1,3,2,0,17
7273,797020,4,0,1,0,1,0,0,0,0,0,0,0,2,0,1,0,0
7273,792392,27,6,8,6,8,0,0,0,0,1,8,0,1,0,1,3,12
7273,797021,15,0,2,0,1,0,1,0,0,1,1,2,1,0,1,0,0
7273,791843,2,1,1,1,1,0,0,0,0,0,2,0,2,0,1,0,2
7274,781454,26,6,9,6,8,0,1,5,9,1,4,5,3,0,2,1,17
7274,786424,25,6,11,6,11,0,0,1,3,2,11,2,1,0,4,2,13
7274,792366,28,5,8,5,8,0,0,2,6,1,7,7,3,4,2,2,12
7274,791015,27,0,3,0,1,0,2,1,2,0,3,6,1,3,1,0,1
7274,785483,28,7,11,5,6,2,5,2,5,0,4,2,2,2,3,1,18
7274,797991,4,0,1,0,1,0,0,0,0,0,0,0,0,0,0,0,0
7274,785959,15,3,6,3,6,0,0,0,1,4,2,0,1,0,0,2,6
7274,797988,14,2,4,2,3,0,1,0,0,0,0,1,3,2,2,0,4
7274,797979,19,3,4,1,1,2,3,0,0,0,3,0,1,0,0,0,8
7274,792279,10,0,2,0,1,0,1,2,4,0,1,4,1,0,0,0,2
7274,775335,3,2,4,0,0,2,4,0,0,0,0,0,0,0,1,0,6
7274,797983,1,0,0,0,0,0,0,0,0,0,0,0,0,0,0,0,0
7275,796891,19,3,10,2,8,1,2,0,0,0,2,0,4,1,2,0,7
7275,796884,20,1,6,1,3,0,3,5,7,2,4,2,4,3,2,0,7
7275,796896,18,2,8,2,4,0,4,0,0,0,4,4,3,0,2,0,4
7275,796882,23,3,8,3,6,0,2,3,3,0,1,3,1,2,5,0,9
7275,790447,16,0,6,0,5,0,1,0,0,2,0,3,0,1,2,1,0
7275,796890,22,6,10,4,7,2,3,4,4,0,9,0,2,0,1,3,18
7275,796886,22,3,6,2,4,1,2,0,0,2,5,0,3,0,1,0,7
7275,796894,3,1,2,1,2,0,0,0,0,0,0,0,0,1,0,0,2
7275,796888,17,2,3,2,2,0,1,0,0,1,0,3,2,0,1,0,4
7275,796887,27,5,10,2,4,3,6,1,2,1,2,0,2,0,1,0,14
7275,796881,13,0,0,0,0,0,0,0,0,0,0,7,2,0,0,0,0
7276,785224,13,1,4,1,3,0,1,2,2,1,1,0,0,0,1,0,4
7276,780879,33,9,16,6,12,3,4,4,5,1,2,3,3,1,2,1,25
7276,790767,15,0,3,0,3,0,0,2,2,0,2,0,2,0,1,0,2
7276,785743,35,5,7,3,5,2,2,0,0,0,1,3,2,2,1,0,12
7276,780875,32,2,7,0,3,2,4,0,0,0,8,3,4,1,3,0,6
7276,796324,14,1,2,0,1,1,1,2,2,1,1,1,0,0,0,0,5
7276,790769,9,0,1,0,0,0,1,0,0,1,1,1,1,0,1,0,0
7276,790768,24,3,7,2,3,1,4,1,2,0,2,1,1,0,3,0,8
7276,796326,6,0,0,0,0,0,0,2,2,1,0,0,0,0,1,0,2
7276,785226,7,1,3,1,2,0,1,0,0,0,1,0,0,0,0,0,2
7276,775785,12,2,2,2,2,0,0,4,4,1,1,1,2,0,0,1,8
7277,781462,30,6,7,6,7,0,0,3,3,2,3,1,4,1,2,4,15
7277,780876,37,5,9,4,6,1,3,1,3,1,5,2,1,2,3,1,12
7277,785353,40,7,12,6,9,1,3,8,8,0,2,6,2,5,3,0,23
7277,781673,38,4,9,3,4,1,5,3,3,0,3,1,4,1,2,0,12
7277,781457,37,3,11,1,4,2,7,0,2,1,3,0,0,0,1,0,8
7277,785355,6,0,1,0,0,0,1,0,0,0,1,0,2,0,1,0,0
7277,790895,5,1,1,1,1,0,0,0,0,0,3,0,1,0,0,0,2
7277,791305,7,0,0,0,0,0,0,0,0,0,0,0,3,0,0,0,0
7278,792340,15,0,3,0,3,0,0,2,2,0,2,1,5,1,2,0,2
7278,792341,31,4,7,3,3,1,4,0,0,1,0,0,2,0,0,0,9
7278,792342,29,2,7,2,6,0,1,3,4,0,0,3,3,3,0,0,7
7278,792346,30,1,4,1,4,0,0,0,0,0,7,1,3,3,2,0,2
7278,781552,40,11,19,8,14,3,5,4,7,1,3,5,3,4,2,0,29
7278,798085,1,0,0,0,0,0,0,0,0,0,1,0,1,0,0,0,0
7278,775599,27,4,12,3,8,1,4,0,0,0,5,0,2,1,0,1,9
7278,792345,27,0,5,0,4,0,1,4,4,1,3,1,1,0,3,1,4
7279,780570,19,0,3,0,3,0,0,1,2,0,5,0,2,0,3,0,1
7279,780569,35,8,12,8,12,0,0,0,2,5,9,1,0,1,5,4,16
7279,797436,31,2,6,1,2,1,4,2,2,0,7,2,2,0,3,0,7
7279,791696,30,5,9,5,7,0,2,2,3,0,0,2,4,0,6,0,12
7279,780565,39,4,11,1,6,3,5,4,4,0,2,4,1,2,3,1,15
7279,797433,14,0,0,0,0,0,0,1,2,2,2,0,3,0,1,1,1
7279,791693,1,0,0,0,0,0,0,0,0,0,0,0,0,0,0,1,0
7279,791694,1,0,1,0,1,0,0,0,0,0,0,0,0,0,0,0,0
7279,791695,10,0,1,0,1,0,0,0,0,0,4,0,3,0,1,1,0
7279,785824,20,0,3,0,3,0,0,0,2,1,2,0,1,1,1,0,0
7280,785495,26,4,10,4,8,0,2,2,2,0,3,1,1,2,3,1,10
7280,785958,26,5,6,5,6,0,0,5,7,4,8,3,2,2,4,0,15
7280,785659,18,1,2,1,2,0,0,4,4,4,1,0,5,1,1,0,6
7280,785494,24,4,10,3,5,1,5,0,0,1,3,5,0,2,1,0,9
7280,780698,29,7,14,5,8,2,6,0,2,1,2,4,2,1,1,1,16
7280,796704,4,1,1,1,1,0,0,0,0,0,1,0,0,0,0,0,2
7280,785490,17,4,7,1,2,3,5,0,0,1,6,0,1,2,0,0,11
7280,791034,19,0,2,0,1,0,1,0,0,0,4,0,5,0,0,1,0
7280,791033,10,1,4,0,0,1,4,0,0,1,0,2,0,1,1,0,3
7280,785486,6,0,3,0,3,0,0,0,0,2,0,1,1,0,0,0,0
7280,780427,21,6,12,5,8,1,4,1,1,1,4,2,2,1,3,2,14
7281,775455,26,4,10,4,8,0,2,1,4,1,8,0,2,0,3,0,9
7281,792124,17,2,3,2,3,0,0,2,7,2,1,1,1,1,0,1,6
7281,792123,31,7,14,3,5,4,9,0,0,1,1,2,2,2,3,0,18
7281,786005,19,1,5,1,4,0,1,2,2,1,2,0,1,1,0,0,4
7281,781397,22,0,3,0,3,0,0,2,2,0,3,0,1,0,2,0,2
7281,797754,15,1,3,1,3,0,0,2,4,0,2,1,1,0,2,0,4
7281,792119,3,1,1,1,1,0,0,1,1,1,1,0,0,0,0,0,3
7281,786003,10,0,3,0,3,0,0,0,0,0,1,1,2,1,1,0,0
7281,786009,5,0,1,0,1,0,0,2,2,0,0,1,1,0,0,0,2
7281,797749,21,1,3,0,0,1,3,1,3,0,2,0,0,0,2,0,4
7281,797747,13,1,3,1,3,0,0,0,0,0,1,1,2,0,3,0,2
7281,792120,7,0,2,0,1,0,1,0,0,0,2,1,2,0,1,0,0
7281,786002,11,0,1,0,1,0,0,0,0,0,0,2,1,2,1,0,0
7282,797325,25,6,6,6,6,0,0,0,0,0,4,2,4,1,2,0,12
7282,797329,34,3,13,2,8,1,5,2,2,2,4,3,3,0,2,2,9
7282,797323,36,9,15,7,11,2,4,2,2,0,2,5,3,1,2,0,22
7282,786236,38,3,8,1,5,2,3,2,2,4,4,2,1,0,1,1,10
7282,780759,37,4,7,0,1,4,6,0,1,0,1,1,1,1,0,0,12
7282,776478,17,2,6,1,1,1,5,2,2,1,3,0,4,0,0,0,7
7282,797327,7,3,4,1,2,2,2,0,0,0,0,0,1,0,0,0,8
7282,797322,2,0,0,0,0,0,0,0,0,0,0,0,0,0,0,0,0
7282,786233,4,1,1,0,0,1,1,0,0,0,0,0,0,0,0,0,3
7283,791763,15,2,3,2,2,0,1,0,0,1,0,1,2,0,1,1,4
7283,781577,33,6,11,5,7,1,4,3,5,4,5,2,1,1,1,1,16
7283,786451,28,3,10,0,2,3,8,0,0,2,2,0,1,0,0,0,9
7283,780600,35,2,6,2,3,0,3,3,4,1,2,6,1,0,1,0,7
7283,781387,26,2,5,2,3,0,2,4,5,0,0,3,1,0,3,0,8
7283,800084,2,0,1,0,1,0,0,0,0,0,0,2,0,0,0,0,0
7283,790888,2,0,0,0,0,0,0,0,0,0,0,0,0,0,0,0,0
7283,786456,12,1,1,1,1,0,0,1,1,2,1,1,2,0,2,0,3
7283,780268,4,1,2,1,2,0,0,3,3,1,3,0,1,0,1,0,5
7283,775910,15,2,4,0,0,2,4,1,2,0,3,1,3,0,1,1,7
7283,797561,14,2,5,1,2,1,3,0,0,0,1,1,1,1,1,0,5
7283,780020,14,3,8,1,4,2,4,0,0,0,2,0,1,0,1,0,8
7284,780095,31,2,4,2,4,0,0,1,2,1,3,3,2,0,1,0,5
7284,776321,32,2,7,2,6,0,1,1,2,2,4,2,0,2,4,0,5
7284,786081,27,7,10,5,6,2,4,1,4,3,3,1,2,2,2,0,17
7284,785431,29,1,5,0,2,1,3,0,0,0,4,2,0,1,3,0,3
7284,780232,31,8,16,3,9,5,7,1,2,0,3,3,1,1,0,0,22
7284,785356,14,3,6,0,0,3,6,0,0,0,3,0,3,1,0,1,9
7284,781328,3,1,1,1,1,0,0,0,0,0,0,0,1,0,0,0,2
7284,797918,6,0,0,0,0,0,0,0,0,0,2,2,0,0,1,0,0
7284,789040,25,3,6,2,3,1,3,5,6,0,3,3,2,0,0,0,12
7284,797911,1,0,0,0,0,0,0,0,0,0,0,0,0,0,0,0,0
7284,789019,1,0,0,0,0,0,0,0,0,0,0,0,0,0,0,0,0
7285,791266,23,3,3,3,3,0,0,1,2,0,5,4,2,0,2,2,7
7285,791265,26,2,7,1,2,1,5,0,0,0,2,4,1,1,3,0,5
7285,791269,20,4,13,1,4,3,9,0,0,0,1,1,0,1,1,0,11
7285,785685,32,3,8,2,5,1,3,2,3,1,3,5,4,3,4,0,9
7285,781294,23,4,5,2,2,2,3,0,0,1,5,0,2,0,2,0,10
7285,796524,2,1,2,1,2,0,0,0,1,0,1,0,0,0,0,0,2
7285,796523,11,1,3,0,0,1,3,0,0,0,1,0,1,0,2,0,3
7285,796522,23,4,7,1,2,3,5,0,0,0,2,1,0,0,1,0,11
7285,796525,4,0,0,0,0,0,0,0,0,0,0,0,1,0,0,0,0
7285,791270,15,0,2,0,2,0,0,0,0,1,1,0,1,0,0,0,0
7285,791271,15,0,1,0,1,0,0,1,2,1,2,0,3,0,1,0,1
7285,781313,6,0,0,0,0,0,0,0,0,0,0,0,0,0,0,0,0
7286,790784,29,9,16,3,4,6,12,1,2,2,4,2,0,1,0,1,25
7286,786235,23,2,5,2,5,0,0,3,4,1,6,1,1,0,2,0,7
7286,797475,27,5,9,1,2,4,7,1,2,2,0,1,1,3,0,0,15
7286,786229,13,1,4,0,1,1,3,0,0,3,0,1,0,1,0,1,3
7286,775229,16,1,8,1,5,0,3,0,0,0,1,1,0,1,1,0,2
7286,786583,4,0,0,0,0,0,0,0,0,0,1,1,1,0,0,0,0
7286,776219,12,3,5,3,5,0,0,0,0,2,1,1,1,1,0,0,6
7286,797477,3,1,1,0,0,1,1,0,0,1,0,0,0,0,0,0,3
7286,791871,24,3,5,2,2,1,3,0,0,1,3,11,3,2,2,1,7
7286,786581,21,8,15,8,14,0,1,0,0,3,7,6,0,0,1,0,16
7286,786770,13,5,8,4,6,1,2,0,0,1,1,1,4,1,1,0,11
7286,786719,4,0,0,0,0,0,0,0,0,0,0,0,0,0,1,0,0
7286,781518,8,0,2,0,0,0,2,0,0,0,1,0,0,0,1,0,0
7286,797476,3,2,4,2,3,0,1,0,0,0,0,1,0,0,0,0,4
7312,786646,24,5,12,5,7,0,5,3,4,2,9,0,1,1,1,0,13
7312,780890,24,3,7,2,6,1,1,0,0,1,3,1,2,1,1,1,7
7312,786066,33,6,15,4,10,2,5,3,4,1,9,1,2,2,0,0,17
7312,780167,35,3,7,3,6,0,1,6,7,2,0,3,2,1,2,2,12
7312,775574,37,2,9,1,5,1,4,1,2,0,2,2,2,1,1,0,6
7312,775757,7,4,5,4,5,0,0,0,2,2,1,0,1,1,1,1,8
7312,791123,8,0,1,0,1,0,0,0,0,0,1,2,0,0,0,0,0
7312,785636,32,2,5,0,0,2,5,1,2,1,2,1,1,1,2,2,7
7313,792249,25,1,2,1,2,0,0,0,0,0,2,1,2,0,1,1,2
7313,781430,30,5,13,5,9,0,4,3,4,4,11,5,3,1,1,1,13
7313,792248,36,4,8,2,4,2,4,0,0,0,0,2,1,2,1,1,10
7313,781445,35,8,17,2,3,6,14,0,0,0,4,2,2,0,3,0,22
7313,768845,29,4,10,4,9,0,1,0,0,0,2,3,2,1,2,0,8
7313,792253,2,0,0,0,0,0,0,0,0,0,0,0,1,0,0,0,0
7313,781448,23,4,9,4,9,0,0,3,4,3,7,1,4,1,2,1,11
7313,797941,9,0,2,0,0,0,2,0,0,0,0,2,0,0,0,0,0
7313,792250,11,0,2,0,1,0,1,0,0,0,1,0,0,0,1,0,0
7314,780598,25,3,7,0,3,3,4,3,4,4,4,1,3,0,1,0,12
7314,781300,37,7,10,7,10,0,0,10,10,4,8,4,3,1,0,3,24
7314,781305,20,3,3,0,0,3,3,0,0,0,0,1,1,0,1,0,9
7314,790801,17,0,1,0,1,0,0,0,0,0,0,0,0,0,0,2,0
7314,781304,37,5,14,2,7,3,7,1,4,0,2,5,3,2,3,1,14
7314,796364,6,1,1,1,1,0,0,2,2,1,1,0,3,0,3,0,4
7314,796360,33,4,12,4,9,0,3,5,8,1,3,4,2,2,0,0,13
7314,781302,30,4,8,1,1,3,7,1,2,0,5,2,3,2,2,1,12
7314,796363,10,0,3,0,2,0,1,0,0,0,0,0,0,0,0,0,0
7314,796362,7,0,0,0,0,0,0,2,2,1,0,0,0,0,1,0,2
7314,790802,3,0,0,0,0,0,0,2,3,1,1,0,0,0,1,0,2
7315,790899,29,2,6,2,6,0,0,2,3,3,4,0,5,0,0,0,6
7315,785442,18,1,5,0,2,1,3,1,2,0,1,0,1,0,2,0,4
7315,799907,30,2,5,1,3,1,2,1,2,1,0,9,1,0,3,0,6
7315,785579,39,5,13,3,7,2,6,1,2,0,1,0,2,1,1,0,13
7315,781628,32,6,9,5,6,1,3,5,8,1,3,5,5,2,3,0,18
7315,796447,8,0,0,0,0,0,0,2,2,1,0,0,5,0,1,0,2
7315,775737,25,7,10,0,2,7,8,2,2,0,8,0,4,0,0,0,23
7315,790898,10,1,2,1,2,0,0,0,0,0,1,2,1,0,2,0,2
7315,790897,9,1,4,1,2,0,2,0,0,0,2,0,1,0,0,0,2
7315,775959,25,2,6,1,3,1,3,4,4,2,2,1,0,0,2,2,9
7316,790873,31,6,12,4,8,2,4,5,6,1,3,2,1,1,2,1,19
7316,785429,20,1,4,0,0,1,4,2,2,0,0,0,4,1,0,0,5
7316,780054,33,6,10,5,9,1,1,3,3,5,5,1,0,0,2,0,16
7316,781140,25,3,7,3,6,0,1,2,2,1,6,2,4,1,0,0,8
7316,786851,30,4,8,2,4,2,4,2,2,0,3,0,3,0,2,0,12
7316,796433,13,3,5,3,5,0,0,0,0,5,3,1,3,0,3,2,6
7316,776357,26,3,6,2,4,1,2,3,4,0,1,4,0,2,0,0,10
7316,776245,8,1,2,1,2,0,0,0,0,0,1,0,1,0,0,0,2
7316,799973,6,0,1,0,1,0,0,0,0,0,0,0,0,2,1,0,0
7316,796432,5,0,1,0,1,0,0,0,0,0,1,0,1,0,0,0,0
7316,781139,2,0,0,0,0,0,0,0,0,0,0,0,2,0,0,0,0
7316,790527,1,0,0,0,0,0,0,0,0,0,0,0,1,0,0,0,0
7317,791401,33,10,14,10,14,0,0,3,5,6,3,2,2,1,0,0,23
7317,780125,24,3,8,3,7,0,1,3,4,2,3,1,4,0,1,0,9
7317,791400,27,1,4,0,2,1,2,0,0,0,1,1,4,1,4,0,3
7317,785931,19,2,5,1,1,1,4,2,2,0,0,1,0,0,0,0,7
7317,780118,30,2,8,1,5,1,3,2,4,0,3,3,2,0,3,0,7
7317,797126,7,0,1,0,1,0,0,0,3,2,1,0,1,0,0,0,0
7317,797130,18,0,2,0,1,0,1,0,0,0,2,3,1,0,4,0,0
7317,786837,23,3,7,1,3,2,4,2,4,1,1,0,4,0,2,0,10
7317,797125,13,0,1,0,1,0,0,0,0,0,0,2,2,1,0,0,0
7317,797132,6,0,0,0,0,0,0,0,0,0,0,0,0,0,0,0,0
7318,791851,21,3,7,3,7,0,0,1,1,0,3,3,1,1,1,0,7
7318,780377,31,3,9,2,5,1,4,2,2,0,2,0,3,0,0,0,9
7318,791852,18,4,5,3,4,1,1,0,0,0,2,1,2,2,0,2,9
7318,797460,25,3,8,3,6,0,2,2,2,1,3,0,4,1,0,0,8
7318,786600,24,7,12,6,11,1,1,0,0,1,2,2,0,1,1,0,15
7318,791853,8,1,1,1,1,0,0,0,0,0,0,0,1,0,2,0,2
7318,797461,19,2,10,1,9,1,1,3,4,1,1,0,3,0,2,0,8
7318,797459,6,0,1,0,1,0,0,1,2,1,0,2,0,0,0,0,1
7318,786602,17,1,6,1,2,0,4,0,1,1,1,0,0,0,0,0,2
7318,786601,16,1,3,1,1,0,2,0,0,0,2,0,1,1,2,1,2
7318,786599,15,2,3,1,1,1,2,2,4,0,5,0,3,0,2,0,7
7319,791067,35,4,7,3,6,1,1,4,6,0,3,2,4,1,1,1,13
7319,780751,12,1,2,0,1,1,1,0,0,1,1,0,2,1,1,0,3
7319,796743,23,3,5,2,3,1,2,1,2,0,5,6,2,2,2,0,8
7319,791068,19,1,6,1,3,0,3,2,3,1,2,0,4,0,2,0,4
7319,785551,29,4,16,1,7,3,9,2,2,3,5,2,0,0,2,1,13
7319,785642,6,2,3,1,2,1,1,0,0,0,1,0,0,0,1,0,5
7319,780512,13,3,5,3,4,0,1,2,2,2,5,0,4,0,2,0,8
7319,780756,5,1,1,1,1,0,0,0,0,0,0,0,0,0,0,0,2
7319,796746,3,0,0,0,0,0,0,0,0,0,0,1,1,0,0,0,0
7319,796744,11,2,2,2,2,0,0,4,4,1,2,1,2,0,0,0,8
7319,791066,22,7,12,6,7,1,5,2,2,0,5,1,1,0,1,4,17
7319,791065,22,3,3,2,2,1,1,1,1,1,1,1,0,0,0,0,8
7320,791639,37,9,13,8,10,1,3,0,0,0,6,1,1,2,4,0,19
7320,785389,33,3,10,0,2,3,8,0,0,0,1,3,2,2,3,0,9
7320,796401,17,1,5,1,3,0,2,0,0,0,2,0,1,1,1,0,2
7320,775654,21,2,3,2,3,0,0,0,0,0,1,0,2,1,1,2,4
7320,785999,29,3,5,3,5,0,0,1,1,1,5,0,2,0,4,1,7
7320,785255,10,0,0,0,0,0,0,1,2,1,1,1,1,0,0,0,1
7320,796398,7,0,0,0,0,0,0,0,0,0,0,2,1,0,1,1,0
7320,796399,29,4,11,3,8,1,3,0,1,0,6,6,2,1,2,0,9
7320,791640,15,0,5,0,2,0,3,0,0,1,2,1,1,1,1,1,0
7320,775171,2,0,0,0,0,0,0,0,0,0,0,0,0,0,0,0,0
7321,792306,31,2,7,0,3,2,4,2,2,3,7,1,3,0,0,0,8
7321,792303,33,7,15,3,7,4,8,0,0,0,3,9,0,3,4,0,18
7321,781603,31,6,11,2,3,4,8,4,5,1,3,1,0,1,3,1,20
7321,792300,25,1,2,0,1,1,1,0,0,1,4,1,3,1,2,0,3
7321,776424,31,6,7,6,7,0,0,3,3,0,2,0,0,5,2,0,15
7321,780456,15,1,4,1,2,0,2,0,0,1,3,1,2,1,1,0,2
7321,797912,8,1,2,0,0,1,2,0,0,1,1,0,0,0,1,0,3
7321,797914,9,1,4,0,1,1,3,0,0,0,1,0,1,0,0,0,3
7321,790813,7,0,2,0,0,0,2,0,0,0,0,2,0,1,0,0,0
7321,786618,10,0,1,0,1,0,0,0,2,0,2,1,0,1,0,0,0
7322,792261,26,1,2,1,2,0,0,2,2,0,1,0,5,0,2,0,4
7322,786124,30,4,6,4,6,0,0,1,4,3,3,0,1,1,1,0,9
7322,792258,33,5,12,3,7,2,5,2,3,0,1,0,4,1,1,0,14
7322,786122,23,1,6,1,5,0,1,2,2,0,5,0,1,1,2,1,4
7322,776284,26,5,15,3,12,2,3,2,6,1,2,3,2,0,1,0,14
7322,797980,7,0,2,0,2,0,0,0,0,1,0,0,1,0,0,0,0
7322,780877,6,1,2,1,2,0,0,0,0,3,1,0,0,0,1,1,2
7322,797982,4,0,0,0,0,0,0,0,0,0,2,0,0,1,2,0,0
7322,786113,23,3,5,3,5,0,0,3,5,3,1,1,1,0,1,0,9
7322,786331,19,4,5,3,4,1,1,2,3,0,2,0,1,1,0,0,11
7322,780308,3,0,1,0,1,0,0,0,0,0,0,0,1,0,0,0,0
7323,780098,31,6,7,6,7,0,0,1,2,1,4,0,4,1,2,0,13
7323,797591,16,1,3,1,1,0,2,2,2,0,2,0,0,0,2,1,4
7323,781071,24,5,7,3,5,2,2,0,1,1,6,1,3,1,0,0,12
7323,791890,37,13,20,6,8,7,12,3,4,1,0,5,2,2,4,0,36
7323,780719,38,1,6,1,3,0,3,2,2,1,4,3,2,1,2,1,4
7323,785424,6,0,0,0,0,0,0,0,0,0,0,0,1,0,1,1,0
7323,797589,24,1,5,1,4,0,1,0,1,0,2,2,2,0,1,1,2
7323,791889,24,1,2,0,0,1,2,2,2,0,1,1,4,1,0,0,5
7324,791980,48,4,11,4,7,0,4,0,0,5,6,2,1,1,1,1,8
7324,785972,31,3,7,3,5,0,2,0,0,2,0,2,3,0,1,1,6
7324,785967,32,13,23,13,23,0,0,3,7,2,12,1,1,1,2,0,29
7324,791977,46,7,14,2,4,5,10,2,2,1,3,0,2,0,0,0,21
7324,791978,45,6,19,4,15,2,4,5,8,2,5,8,2,0,0,0,19
7324,780160,20,1,2,1,2,0,0,0,2,3,3,3,3,1,0,1,2
7324,791976,16,2,7,2,5,0,2,1,2,0,2,2,0,0,1,0,5
7324,785973,5,0,1,0,0,0,1,0,0,0,1,0,1,0,0,0,0
7324,797800,7,0,1,0,0,0,1,0,0,0,0,1,1,0,0,1,0
7325,779985,39,4,8,1,1,3,7,0,0,2,7,2,4,1,0,0,11
7325,790876,41,6,13,5,9,1,4,0,0,0,5,1,0,1,3,0,13
7325,785699,42,5,13,4,9,1,4,1,1,3,6,2,5,0,2,0,12
7325,781062,49,7,15,2,5,5,10,0,0,1,1,0,0,0,0,0,19
7325,774987,46,10,20,9,14,1,6,7,7,2,7,7,4,1,4,0,28
7325,790877,16,1,5,1,4,0,1,0,0,1,2,0,1,0,0,0,2
7325,785432,9,1,3,1,3,0,0,0,0,0,2,0,0,0,0,1,2
7325,790882,6,1,1,1,1,0,0,2,2,0,2,1,3,0,1,0,4
7325,790879,2,0,0,0,0,0,0,0,0,0,0,0,2,0,1,0,0
7326,791522,36,4,8,4,8,0,0,1,2,1,3,2,1,1,2,1,9
7326,786351,27,6,10,4,4,2,6,0,0,0,5,1,4,2,0,0,14
7326,797146,36,6,16,4,8,2,8,11,11,0,3,4,3,0,2,0,25
7326,786348,27,2,4,0,1,2,3,2,2,0,8,1,3,0,0,0,8
7326,797143,35,8,13,7,9,1,4,3,3,0,5,2,1,0,5,0,20
7326,797142,8,0,0,0,0,0,0,0,0,0,0,0,0,1,0,0,0
7326,785816,17,0,0,0,0,0,0,0,0,3,2,0,2,1,0,3,0
7326,797147,14,1,1,1,1,0,0,0,0,0,0,1,1,2,1,0,2
7327,796194,28,4,9,1,1,3,8,2,2,0,3,2,2,1,2,0,13
7327,796464,31,5,15,3,9,2,6,0,0,1,3,1,4,2,5,0,12
7327,796459,37,6,14,4,10,2,4,7,9,0,6,7,2,0,1,1,21
7327,790917,33,3,9,2,3,1,6,2,2,2,4,1,2,2,0,1,9
7327,781006,24,1,5,1,3,0,2,1,2,3,1,0,1,0,1,1,3
7327,775954,24,2,5,2,5,0,0,0,0,3,2,1,2,1,1,0,4
7327,781157,12,0,3,0,2,0,1,0,0,0,1,1,2,0,1,0,0
7327,780648,3,0,1,0,1,0,0,0,0,1,0,0,0,0,0,0,0
7327,790918,7,1,1,1,1,0,0,0,0,1,1,0,0,0,0,0,2
7327,790916,1,0,0,0,0,0,0,1,2,0,1,0,0,0,0,0,1
7328,788113,27,2,2,1,1,1,1,0,0,1,3,1,3,0,2,0,5
7328,776497,29,3,14,1,7,2,7,5,7,2,1,1,4,1,5,0,13
7328,785731,20,2,3,2,3,0,0,3,5,1,4,0,5,1,1,0,7
7328,785729,22,1,3,1,2,0,1,1,2,0,1,5,2,0,4,0,3
7328,780864,30,2,7,1,2,1,5,2,4,0,5,1,2,0,2,0,7
7328,799881,5,0,0,0,0,0,0,1,2,0,1,0,3,0,1,0,1
7328,792405,3,0,1,0,1,0,0,0,0,1,0,1,0,0,0,0,0
7328,792402,15,0,2,0,1,0,1,1,2,0,4,0,0,2,0,0,1
7328,796211,5,0,0,0,0,0,0,1,2,0,0,0,0,1,0,0,1
7328,786231,27,7,13,5,9,2,4,9,10,3,3,1,0,3,2,0,25
7328,785443,16,2,4,1,3,1,1,1,2,1,0,1,0,0,0,0,6
7328,785725,1,0,0,0,0,0,0,0,0,0,0,0,0,0,0,0,0
7329,776285,23,2,5,2,5,0,0,0,1,3,1,0,4,1,3,2,4
7329,781025,20,2,4,1,3,1,1,1,2,2,1,2,4,0,1,0,6
7329,791777,39,7,16,7,16,0,0,6,8,0,3,3,1,1,3,1,20
7329,786474,25,5,12,2,6,3,6,5,5,0,5,0,3,1,2,0,18
7329,775503,27,6,9,2,2,4,7,2,3,1,4,0,2,1,2,0,18
7329,791778,17,1,1,1,1,0,0,2,2,0,2,0,4,1,2,0,4
7329,791780,6,0,0,0,0,0,0,0,0,0,0,0,1,0,1,0,0
7329,791776,11,0,2,0,0,0,2,2,2,0,1,0,1,0,0,0,2
7329,791829,16,1,5,1,4,0,1,0,1,1,3,2,4,2,3,0,2
7329,780488,16,0,2,0,0,0,2,0,0,0,1,0,3,0,1,0,0
7330,792417,9,1,2,1,2,0,0,1,2,1,0,0,2,0,4,0,3
7330,786861,40,4,11,3,5,1,6,1,2,4,8,4,1,0,3,0,10
7330,786867,36,6,7,1,1,5,6,0,0,1,5,0,0,1,2,0,17
7330,780387,25,3,9,3,6,0,3,0,0,1,2,3,3,1,1,0,6
7330,767033,37,2,14,0,2,2,12,0,0,1,3,6,3,1,4,1,6
7330,796870,24,4,5,4,5,0,0,2,2,4,4,1,2,0,3,1,10
7330,796867,2,0,0,0,0,0,0,0,0,0,0,0,0,1,0,0,0
7330,792416,18,2,6,2,3,0,3,1,2,0,0,1,1,1,0,0,5
7330,786866,9,0,4,0,0,0,4,0,0,0,0,0,2,0,0,0,0
7331,785843,17,0,2,0,2,0,0,2,2,0,1,2,2,0,0,1,2
7331,780578,30,5,7,4,6,1,1,0,0,0,2,3,2,1,4,0,11
7331,797537,17,0,1,0,1,0,0,1,2,0,0,0,1,1,0,1,1
7331,797538,16,2,6,1,1,1,5,0,0,0,1,1,2,0,2,0,5
7331,780579,36,9,16,7,11,2,5,4,5,1,7,1,0,3,3,0,24
7331,785845,29,3,6,3,6,0,0,2,2,0,2,0,4,0,0,0,8
7331,797535,6,0,2,0,1,0,1,1,2,1,2,0,1,0,2,0,1
7331,785293,24,3,5,2,3,1,2,0,0,0,3,3,1,2,3,0,7
7331,785847,25,3,4,1,1,2,3,0,2,1,6,3,0,2,1,0,8
7332,796334,35,7,11,4,6,3,5,3,4,2,5,1,1,0,1,0,20
7332,790776,22,0,3,0,3,0,0,2,3,2,1,0,2,0,0,0,2
7332,796330,32,2,10,2,4,0,6,2,2,1,3,3,0,0,2,0,6
7332,796336,23,4,9,0,0,4,9,0,0,0,1,5,3,0,2,0,12
7332,785813,34,3,10,1,8,2,2,0,1,0,3,2,1,1,0,0,8
7332,785827,19,4,7,4,7,0,0,1,1,1,2,1,0,0,0,2,9
7332,796337,25,2,6,2,5,0,1,0,0,1,4,3,1,1,0,0,4
7332,796332,10,0,1,0,1,0,0,0,0,0,0,2,3,0,0,0,0
7333,790844,27,2,3,2,3,0,0,2,4,4,1,0,3,0,0,0,6
7333,775142,36,7,14,5,10,2,4,3,4,0,4,1,3,0,2,0,19
7333,790843,34,4,14,2,7,2,7,0,0,0,6,4,2,2,1,1,10
7333,786212,34,5,8,2,4,3,4,0,0,2,4,1,1,0,1,0,13
7333,785392,35,2,8,2,5,0,3,0,0,2,3,4,1,0,2,0,4
7333,799986,17,3,3,3,3,0,0,1,3,2,1,0,2,0,0,1,7
7333,781563,14,2,4,2,3,0,1,0,0,1,1,0,2,0,1,0,4
7333,796914,3,0,1,0,0,0,1,0,0,0,0,0,2,0,0,0,0
7334,791616,21,3,6,3,5,0,1,0,0,1,2,1,1,1,1,0,6
7334,780797,20,2,5,2,3,0,2,0,0,1,4,3,0,1,2,0,4
7334,796981,27,5,10,1,4,4,6,3,5,0,2,2,1,0,0,0,17
7334,785505,26,4,9,4,7,0,2,1,3,0,3,5,4,0,5,0,9
7334,775604,33,6,14,3,5,3,9,0,0,1,3,3,4,0,1,1,15
7334,776418,22,1,3,1,3,0,0,1,2,3,3,1,3,0,0,1,3
7334,791618,16,2,4,1,3,1,1,1,2,0,2,0,1,1,1,0,6
7334,780555,35,3,5,1,2,2,3,6,6,0,2,4,2,1,0,0,14
7335,785800,24,5,9,0,0,5,9,1,2,0,7,0,1,1,1,0,16
7335,785799,20,2,3,2,3,0,0,1,2,4,6,2,3,1,3,0,5
7335,791676,26,3,5,2,3,1,2,0,0,1,0,6,3,1,0,1,7
7335,780554,29,4,8,3,5,1,3,2,3,0,5,2,2,0,1,0,11
7335,780553,25,6,16,6,15,0,1,3,7,2,5,4,4,2,3,0,15
7335,797426,10,0,2,0,1,0,1,0,0,0,0,0,0,0,0,1,0
7335,791678,4,0,2,0,1,0,1,0,0,0,0,0,0,0,0,0,0
7335,785807,12,1,2,0,0,1,2,0,0,3,0,0,1,0,0,0,3
7335,780760,21,4,7,3,5,1,2,0,0,3,1,4,1,0,0,0,9
7335,797427,17,3,8,2,3,1,5,0,0,0,2,1,0,1,2,0,7
7335,791677,12,2,4,2,3,0,1,0,0,0,0,1,0,1,0,0,4
7336,796542,16,1,5,1,5,0,0,2,2,1,1,2,3,0,2,0,4
7336,781335,24,7,8,5,5,2,3,0,0,0,8,3,1,0,0,0,16
7336,776351,26,5,10,2,3,3,7,1,1,0,2,1,0,1,0,0,14
7336,785770,19,2,6,1,1,1,5,0,0,0,1,1,4,0,0,0,5
7336,781341,26,2,5,1,1,1,4,0,0,1,3,5,1,0,0,0,5
7336,791282,2,0,0,0,0,0,0,0,0,0,0,0,1,0,0,0,0
7336,791285,16,4,8,1,1,3,7,0,0,2,1,1,2,2,0,0,11
7336,785775,21,7,11,5,9,2,2,0,0,1,5,2,4,1,4,1,16
7336,796538,16,1,2,1,1,0,1,0,0,0,0,3,1,1,1,0,2
7336,791284,13,2,5,1,3,1,2,0,0,1,0,1,1,1,0,0,5
7336,791283,5,1,3,1,3,0,0,2,3,0,0,0,0,0,0,0,4
7336,785767,16,2,6,1,1,1,5,1,2,0,2,1,4,2,0,0,6
7337,792140,29,7,8,7,8,0,0,1,1,3,4,2,3,0,3,1,15
7337,786596,30,4,9,3,6,1,3,2,3,0,8,3,2,2,3,1,11
7337,797786,10,0,2,0,1,0,1,0,0,0,1,1,0,0,1,0,0
7337,785976,32,5,7,2,3,3,4,0,0,0,1,1,1,0,2,0,13
7337,781429,32,3,7,1,1,2,6,3,4,0,3,1,2,0,0,0,11
7337,797791,2,1,1,1,1,0,0,1,2,0,0,0,0,0,0,0,3
7337,792146,4,0,1,0,1,0,0,1,3,2,1,0,0,0,1,0,1
7337,797793,6,0,0,0,0,0,0,0,0,0,0,0,0,0,1,0,0
7337,792144,17,2,5,2,4,0,1,0,1,1,2,0,4,1,3,0,4
7337,797789,4,0,1,0,0,0,1,1,2,0,1,0,0,0,1,1,1
7337,776092,34,4,10,3,6,1,4,2,5,0,4,4,3,0,3,0,11
7338,797972,32,6,13,4,8,2,5,0,0,1,3,2,4,2,2,0,14
7338,797967,36,6,12,5,7,1,5,2,3,2,5,0,2,1,3,1,15
7338,797970,29,3,12,3,6,0,6,2,2,1,2,3,3,1,3,1,8
7338,781453,38,9,17,5,6,4,11,5,5,3,11,8,1,0,3,1,27
7338,774869,37,4,9,1,2,3,7,0,0,2,1,2,3,1,0,0,11
7338,792254,12,2,4,1,2,1,2,1,1,1,3,0,0,0,0,0,6
7338,786098,16,0,3,0,1,0,2,0,0,0,2,1,3,0,1,0,0
7339,780291,37,7,10,5,5,2,5,6,6,2,7,2,3,1,1,0,22
7339,785607,9,1,1,1,1,0,0,0,0,1,3,0,1,0,0,0,2
7339,796665,32,6,12,4,6,2,6,0,0,1,4,4,0,4,1,0,14
7339,785333,10,0,2,0,1,0,1,0,0,0,2,0,0,0,1,0,0
7339,775305,32,6,17,3,13,3,4,6,8,0,5,2,2,0,2,1,21
7339,796663,3,0,1,0,1,0,0,0,0,0,1,0,2,0,0,0,0
7339,791004,30,5,9,2,2,3,7,4,6,2,2,1,1,0,2,0,17
7339,791006,18,1,2,1,2,0,0,0,0,0,2,0,1,0,0,0,2
7339,796666,4,0,0,0,0,0,0,0,0,0,1,0,0,0,0,0,0
7339,796664,25,5,9,5,8,0,1,0,2,0,4,4,2,1,1,0,10
7340,785509,14,1,2,0,0,1,2,0,0,1,0,0,4,0,0,0,3
7340,791424,36,2,4,2,3,0,1,5,6,2,3,2,4,0,1,5,9
7340,797085,34,2,7,2,5,0,2,0,0,1,4,1,4,1,3,0,4
7340,791421,41,7,17,4,11,3,6,5,8,1,4,2,3,1,5,0,22
7340,785899,42,3,4,1,1,2,3,2,2,1,2,0,4,0,1,0,10
7340,791425,31,3,7,3,7,0,0,2,5,2,6,1,0,0,1,1,8
7340,797086,1,0,0,0,0,0,0,0,0,0,0,0,0,0,0,0,0
7340,797090,9,0,0,0,0,0,0,2,2,0,1,0,2,0,1,0,2
7340,797088,17,2,3,0,0,2,3,0,0,0,0,0,0,1,1,0,6
7341,797066,29,2,8,2,7,0,1,0,0,5,3,0,3,0,0,1,4
7341,780180,33,1,4,0,3,1,1,0,0,1,4,0,3,0,2,0,3
7341,797068,41,3,8,1,3,2,5,2,4,0,2,3,3,1,2,0,10
7341,791432,39,4,8,2,4,2,4,4,4,0,3,0,1,1,3,0,14
7341,791429,37,1,8,0,6,1,2,1,6,0,4,3,2,1,3,1,4
7341,781650,15,4,8,4,8,0,0,4,5,0,0,0,5,0,0,0,12
7341,797067,18,3,5,3,5,0,0,2,2,0,1,1,2,0,1,1,8
7341,797070,13,1,1,0,0,1,1,0,0,0,0,1,4,0,0,0,3
7342,790827,13,0,0,0,0,0,0,1,2,1,2,0,2,1,1,0,1
7342,785375,13,1,4,1,4,0,0,0,1,0,2,0,0,0,0,1,2
7342,785372,22,5,11,5,10,0,1,3,4,2,2,2,2,0,1,0,13
7342,785371,20,0,4,0,1,0,3,0,0,1,0,5,0,0,0,0,0
7342,774905,28,4,8,3,5,1,3,2,3,0,4,1,3,1,1,0,11
7342,790828,7,0,1,0,1,0,0,0,0,1,2,0,2,0,0,0,0
7342,785374,8,1,2,1,2,0,0,0,0,2,0,1,2,0,0,0,2
7342,786384,24,4,12,3,7,1,5,0,1,2,5,0,4,0,1,0,9
7342,790825,10,1,5,0,2,1,3,0,0,0,2,2,0,0,0,0,3
7342,796385,15,0,4,0,3,0,1,0,0,0,0,5,0,1,2,0,0
7342,785373,21,6,10,3,5,3,5,0,0,0,2,1,0,0,1,1,15
7342,796387,12,0,1,0,1,0,0,1,2,1,2,0,3,0,0,0,1
7342,780007,3,0,0,0,0,0,0,1,2,0,1,1,1,0,0,0,1
7342,796386,2,0,0,0,0,0,0,0,1,0,0,0,0,0,0,0,0
7342,790826,2,0,0,0,0,0,0,0,0,0,0,0,0,0,0,0,0
7343,797175,16,3,3,1,1,2,2,0,0,2,1,0,4,0,0,0,8
7343,780027,23,3,11,3,10,0,1,2,7,2,6,3,3,1,1,2,8
7343,786176,28,7,13,2,6,5,7,2,2,0,7,3,2,1,0,1,21
7343,780028,23,6,8,2,2,4,6,0,0,0,2,2,3,0,2,0,16
7343,774828,27,1,5,0,0,1,5,3,3,0,0,3,0,1,0,0,6
7343,780029,26,7,11,6,9,1,2,3,3,2,9,6,1,0,0,1,18
7343,791379,19,3,7,3,6,0,1,0,0,1,4,1,0,1,0,0,6
7343,797178,10,0,0,0,0,0,0,1,2,0,3,1,1,0,1,1,1
7343,791380,12,1,2,1,2,0,0,0,0,0,0,4,0,0,0,0,2
7343,797179,7,0,1,0,1,0,0,0,0,1,2,0,1,0,0,0,0
7343,780026,2,1,2,1,2,0,0,0,0,0,0,0,0,0,0,0,2
7343,797176,3,0,1,0,0,0,1,0,0,0,0,1,0,0,0,0,0
7343,797177,2,0,1,0,1,0,0,0,2,1,1,0,2,0,0,0,0
7343,786170,2,0,0,0,0,0,0,0,0,0,0,0,1,0,0,0,0
7344,775823,26,4,4,4,4,0,0,3,5,2,0,2,4,1,4,0,11
7344,774806,31,4,8,4,8,0,0,3,4,3,11,2,4,0,1,1,11
7344,791041,37,8,17,5,9,3,8,0,0,0,5,6,2,0,1,0,19
7344,791038,29,2,6,2,5,0,1,4,6,0,6,3,4,2,2,1,8
7344,789023,39,7,15,2,6,5,9,3,5,1,1,6,1,0,1,0,22
7344,775205,26,4,6,0,0,4,6,0,0,0,0,2,3,1,2,0,12
7344,796711,1,0,0,0,0,0,0,0,0,0,0,0,0,0,0,0,0
7344,796712,1,0,0,0,0,0,0,0,0,0,0,0,0,0,0,0,0
7344,796714,9,0,1,0,1,0,0,0,2,1,5,1,2,0,1,0,0
7344,796716,1,0,0,0,0,0,0,0,0,0,0,0,0,0,0,0,0
7345,786635,36,8,16,8,14,0,2,6,8,1,6,1,1,1,3,0,22
7345,781543,26,3,6,3,6,0,0,1,5,2,3,4,1,2,2,1,7
7345,791822,37,3,6,0,1,3,5,0,0,0,4,1,1,0,0,0,9
7345,780642,33,3,10,3,9,0,1,5,5,1,2,6,5,3,2,0,11
7345,776449,29,3,8,2,6,1,2,1,2,1,6,1,3,0,2,0,8
7345,797384,1,1,1,1,1,0,0,0,0,0,1,0,0,0,0,0,2
7345,786182,19,4,9,4,8,0,1,3,3,2,0,1,4,0,0,0,11
7345,791821,12,0,0,0,0,0,0,1,2,0,1,0,1,1,0,0,1
7345,786632,6,0,1,0,0,0,1,0,0,0,0,0,1,0,0,0,0
7345,785830,1,0,0,0,0,0,0,0,0,0,0,0,0,0,0,0,0
7346,781480,27,2,4,1,2,1,2,0,0,0,4,1,5,0,3,1,5
7346,774846,25,4,10,4,10,0,0,0,0,1,4,0,0,0,2,0,8
7346,797273,39,1,2,1,2,0,0,0,0,0,14,4,1,1,6,0,2
7346,786558,30,3,8,3,7,0,1,7,8,0,1,0,4,0,5,0,13
7346,766611,34,6,14,3,7,3,7,5,5,2,3,0,3,0,4,0,20
7346,786185,15,1,3,1,3,0,0,0,0,2,1,1,4,0,2,2,2
7346,791376,20,0,1,0,1,0,0,0,0,0,0,0,0,0,0,0,0
7346,797272,10,0,3,0,2,0,1,0,0,1,0,1,0,0,0,0,0
7347,790810,39,7,15,3,7,4,8,4,5,3,7,4,0,0,1,0,22
7347,785362,21,6,12,6,12,0,0,1,2,6,2,2,5,2,3,1,13
7347,790808,28,5,11,4,6,1,5,0,0,1,1,0,0,0,1,0,11
7347,785361,37,3,10,2,4,1,6,2,3,0,0,2,1,3,0,2,9
7347,779997,33,1,4,1,2,0,2,2,2,0,3,5,4,5,2,0,4
7347,774854,15,1,6,1,6,0,0,0,0,0,2,0,1,0,0,0,2
7347,796370,15,0,5,0,4,0,1,0,0,1,1,1,1,0,0,0,0
7347,796368,4,0,1,0,1,0,0,0,0,0,2,0,1,0,1,0,0
7347,790811,6,1,3,0,2,1,1,0,0,2,1,1,0,0,0,0,3
7347,790809,2,0,0,0,0,0,0,0,0,0,0,0,0,0,0,0,0
7348,776174,36,11,16,11,16,0,0,7,8,3,9,3,1,0,2,1,29
7348,791958,29,3,11,3,10,0,1,8,9,4,5,3,3,0,4,0,14
7348,791960,31,3,11,0,5,3,6,4,4,0,3,4,2,0,1,0,13
7348,785861,39,2,9,1,6,1,3,4,4,6,6,1,3,0,2,0,9
7348,786059,21,2,4,1,2,1,2,0,0,1,2,0,2,0,1,3,5
7348,781332,29,7,8,3,4,4,4,1,1,0,1,2,4,1,2,0,19
7348,797704,15,1,3,0,0,1,3,0,0,0,1,1,2,2,1,0,3
7349,786266,32,7,12,4,9,3,3,3,4,1,7,0,4,1,1,0,20
7349,775028,32,5,11,5,8,0,3,3,5,1,0,7,2,0,2,0,13
7349,797718,16,2,3,0,1,2,2,2,2,1,1,2,0,2,0,0,8
7349,786039,23,0,0,0,0,0,0,0,0,1,3,0,2,1,0,0,0
7349,792043,12,0,4,0,1,0,3,0,0,0,0,0,1,1,0,0,0
7349,792040,29,11,16,11,15,0,1,2,2,3,1,1,2,1,3,0,24
7349,797726,22,5,14,3,9,2,5,0,0,1,3,1,4,0,0,0,12
7349,797728,25,0,5,0,2,0,3,3,4,1,4,1,3,1,0,0,3
7349,797723,8,1,1,1,1,0,0,0,0,1,0,0,1,0,0,0,2
7349,797719,1,0,0,0,0,0,0,0,0,0,0,0,0,0,0,0,0
7350,780058,19,2,4,1,1,1,3,2,2,1,4,1,1,0,1,0,7
7350,780059,29,7,9,4,5,3,4,4,7,0,5,4,1,0,0,3,21
7350,796494,23,6,9,3,5,3,4,4,4,1,3,0,2,1,2,0,19
7350,790944,28,5,7,3,4,2,3,6,7,0,3,4,3,0,2,0,18
7350,780061,32,5,9,2,2,3,7,0,0,0,2,2,2,0,4,1,13
7350,790943,16,1,3,1,2,0,1,3,3,0,1,1,3,1,2,0,5
7350,796495,4,2,3,1,1,1,2,2,2,1,3,0,3,0,2,0,7
7350,796496,19,3,4,2,2,1,2,1,1,1,3,3,4,2,2,0,8
7350,786754,21,5,8,1,4,4,4,2,2,0,1,4,3,1,3,0,16
7350,796497,3,0,0,0,0,0,0,0,0,0,1,0,2,0,0,1,0
7350,785097,2,0,0,0,0,0,0,1,2,0,2,0,1,0,0,0,1
7350,788853,2,0,0,0,0,0,0,0,0,0,1,0,0,0,0,0,0
7350,796499,2,0,0,0,0,0,0,0,0,0,0,0,0,0,0,0,0
7351,791302,31,5,11,5,9,0,2,2,2,5,8,5,4,1,0,2,12
7351,781622,20,0,3,0,1,0,2,0,0,1,0,0,4,0,0,0,0
7351,791309,30,6,11,6,9,0,2,4,4,1,1,3,5,3,4,0,16
7351,785835,24,5,9,5,8,0,1,1,2,0,0,0,2,1,2,1,11
7351,776334,24,1,6,1,3,0,3,1,2,2,3,2,2,0,2,0,3
7351,775862,14,2,4,2,4,0,0,3,3,1,0,0,3,0,2,0,7
7351,796601,29,6,15,4,8,2,7,10,15,0,2,2,4,4,3,0,24
7351,791304,20,3,5,3,4,0,1,3,3,1,1,0,0,1,0,0,9
7351,796603,2,0,1,0,0,0,1,0,0,0,0,0,0,0,0,1,0
7351,796605,1,0,0,0,0,0,0,0,0,0,0,0,1,0,0,0,0
7351,796604,5,0,0,0,0,0,0,0,0,0,0,0,0,0,0,0,0
7352,789484,34,5,11,4,8,1,3,10,11,1,5,2,5,1,3,0,21
7352,782654,29,5,5,5,5,0,0,3,4,1,1,1,4,2,5,3,13
7352,792418,25,3,7,3,7,0,0,3,4,1,5,0,4,2,4,4,9
7352,796691,30,3,6,1,2,2,4,2,2,0,2,3,0,0,1,0,10
7352,796693,36,1,8,1,5,0,3,3,4,2,2,7,2,3,2,0,5
7352,792421,15,2,6,0,2,2,4,0,0,0,0,2,2,1,0,0,6
7352,792424,15,2,3,2,3,0,0,0,1,1,0,0,5,0,1,0,4
7352,792423,5,1,1,1,1,0,0,0,0,0,0,0,0,0,0,0,2
7352,792422,19,0,1,0,1,0,0,1,2,1,4,0,1,0,0,0,1
7352,796692,8,0,0,0,0,0,0,0,0,1,0,1,1,0,1,0,0
7352,792419,6,0,0,0,0,0,0,0,0,0,0,0,1,0,1,0,0
7352,800100,3,0,0,0,0,0,0,0,0,0,0,0,0,0,1,0,0
7353,797649,31,6,11,3,5,3,6,4,5,2,3,1,4,2,0,1,19
7353,789028,27,5,10,5,10,0,0,1,4,3,1,2,2,0,1,0,11
7353,790779,18,3,3,3,3,0,0,3,4,2,1,2,3,0,3,1,9
7353,792067,28,2,6,2,6,0,0,4,7,2,2,1,4,0,3,0,8
7353,792058,13,0,1,0,0,0,1,0,0,1,1,0,3,1,0,0,0
7353,775523,25,6,11,6,10,0,1,7,9,2,1,1,4,1,0,1,19
7353,792059,15,1,4,1,3,0,1,1,2,4,0,0,2,3,2,0,3
7353,789053,32,1,3,1,2,0,1,0,0,0,2,5,0,1,3,1,2
7353,786836,13,1,3,1,3,0,0,0,0,0,2,1,1,1,0,0,2
7353,789029,21,0,5,0,3,0,2,0,1,2,3,2,1,2,2,0,0
7353,792062,2,0,1,0,1,0,0,0,0,0,0,0,0,0,1,0,0
7354,791220,16,0,0,0,0,0,0,0,0,1,0,0,1,0,1,1,0
7354,791219,25,3,6,3,4,0,2,2,2,1,5,1,3,1,1,0,8
7354,776217,22,0,3,0,3,0,0,0,0,0,1,3,2,1,1,0,0
7354,790818,24,5,10,3,5,2,5,4,4,0,3,5,4,0,1,0,16
7354,780730,34,11,14,5,5,6,9,2,2,1,3,0,0,3,4,1,30
7354,800086,2,0,1,0,1,0,0,0,0,0,0,0,0,0,1,0,0
7354,796919,2,0,0,0,0,0,0,0,0,0,0,0,0,0,0,1,0
7354,786824,22,2,5,2,4,0,1,0,2,0,3,1,0,1,3,1,4
7354,791221,11,1,3,1,1,0,2,3,3,1,0,0,1,0,0,1,5
7354,796923,4,0,1,0,1,0,0,0,0,0,1,0,0,0,1,0,0
7354,796924,2,0,0,0,0,0,0,0,0,0,1,0,1,0,0,0,0
7354,796920,2,1,1,1,1,0,0,0,0,0,0,0,0,0,0,0,2
7354,792496,2,0,0,0,0,0,0,0,0,0,0,0,1,0,0,0,0
7354,786396,25,1,5,1,4,0,1,4,5,0,8,1,3,2,0,0,6
7354,796921,7,0,0,0,0,0,0,0,0,0,0,0,0,0,0,0,0
7355,786054,17,3,3,3,3,0,0,3,4,2,1,1,5,1,2,0,9
7355,791964,29,1,6,1,3,0,3,0,0,3,3,1,4,3,2,0,2
7355,786056,14,0,3,0,1,0,2,0,0,0,1,1,1,0,1,0,0
7355,781339,26,3,10,1,2,2,8,0,0,0,6,0,2,0,2,0,8
7355,781337,34,4,10,1,1,3,9,0,1,0,2,5,0,0,3,0,11
7355,797712,10,1,2,1,2,0,0,1,2,1,1,1,2,1,0,0,3
7355,792041,20,0,4,0,2,0,2,0,0,1,1,0,2,0,2,0,0
7355,799737,8,1,2,0,0,1,2,0,0,0,1,0,0,0,0,0,3
7355,797711,23,2,4,1,1,1,3,2,4,0,4,0,3,1,2,0,7
7355,797710,19,2,6,1,3,1,3,1,1,0,2,1,0,0,1,0,6
7356,781624,12,4,7,3,5,1,2,1,2,1,1,0,4,0,3,0,10
7356,792246,28,3,11,3,11,0,0,3,4,3,4,0,3,0,0,0,9
7356,797925,21,2,3,1,2,1,1,0,0,1,0,3,4,0,0,0,5
7356,781420,38,5,10,3,6,2,4,2,4,0,4,5,0,0,2,0,14
7356,781405,38,8,13,6,9,2,4,2,2,0,7,9,3,0,2,0,20
7356,780615,12,1,1,1,1,0,0,0,0,1,3,1,2,1,0,0,2
7356,791701,28,6,11,5,8,1,3,2,2,1,4,1,1,2,1,0,15
7356,792245,23,4,9,1,2,3,7,0,0,0,1,1,2,0,0,0,11
7357,775651,26,6,10,4,6,2,4,1,2,4,5,0,1,1,3,1,15
7357,791070,23,6,12,6,7,0,5,3,4,3,2,3,4,1,2,0,15
7357,791627,27,1,5,1,4,0,1,2,2,1,4,1,1,0,0,1,4
7357,785665,34,3,11,2,3,1,8,2,3,0,3,1,3,0,2,0,9
7357,776178,28,3,6,2,5,1,1,1,4,1,4,4,4,3,4,0,8
7357,796505,11,5,7,5,7,0,0,0,3,2,1,0,1,0,3,0,10
7357,791071,3,0,1,0,1,0,0,0,0,0,1,0,0,0,0,0,0
7357,796504,9,0,1,0,1,0,0,1,3,1,1,0,1,0,0,0,1
7357,796502,12,1,2,1,2,0,0,0,0,2,1,1,0,0,0,0,2
7357,796501,24,3,7,1,2,2,5,3,4,0,5,3,1,0,1,0,11
7357,785660,3,0,0,0,0,0,0,0,0,0,0,0,0,0,0,0,0
7358,797047,14,1,3,1,2,0,1,2,2,0,1,0,0,0,1,0,4
7358,775515,28,3,6,2,2,1,4,2,3,0,4,0,2,1,2,4,9
7358,791579,25,4,7,3,3,1,4,1,1,0,4,9,3,2,2,1,10
7358,786387,40,11,15,10,12,1,3,2,3,2,3,4,1,1,2,1,25
7358,780399,40,10,16,5,7,5,9,4,4,1,3,6,1,3,3,0,29
7358,786846,22,4,7,3,3,1,4,0,0,0,3,3,3,0,2,1,9
7358,780400,15,2,4,2,2,0,2,1,1,0,2,0,0,0,1,0,5
7358,791575,5,1,2,1,2,0,0,0,0,3,0,0,1,0,1,0,2
7358,797046,11,1,1,0,0,1,1,0,0,0,0,0,0,0,1,0,3
7359,796979,36,6,10,4,5,2,5,2,2,2,1,0,2,2,1,1,16
7359,776200,33,6,11,6,11,0,0,3,3,2,7,3,1,0,2,0,15
7359,786437,28,4,13,4,10,0,3,1,2,4,3,0,2,2,2,0,9
7359,780925,35,9,11,2,4,7,7,0,0,0,2,3,2,4,3,0,25
7359,781034,37,7,15,5,8,2,7,1,2,1,2,4,1,2,3,0,17
7359,791625,5,0,0,0,0,0,0,0,0,0,0,0,0,0,0,0,0
7359,791622,6,0,1,0,1,0,0,0,0,0,0,0,2,0,2,0,0
7359,791624,12,0,2,0,2,0,0,0,0,0,2,2,2,0,1,0,0
7359,791637,8,1,3,0,1,1,2,0,0,1,1,0,2,0,1,0,3
7360,797235,38,2,6,2,6,0,0,1,4,0,5,2,1,2,0,0,5
7360,797232,34,6,12,4,9,2,3,0,1,1,6,3,3,3,2,1,14
7360,797237,34,5,9,1,3,4,6,3,6,1,1,0,2,0,2,0,17
7360,797234,24,2,5,2,3,0,2,4,5,1,5,3,3,1,4,0,8
7360,797239,39,7,13,2,4,5,9,8,11,0,4,3,2,2,3,0,27
7360,791368,15,0,0,0,0,0,0,2,2,2,1,0,5,0,1,1,2
7360,791367,16,3,6,3,5,0,1,4,7,1,2,3,3,1,2,0,10
7361,792167,31,4,5,4,5,0,0,2,7,0,6,0,2,0,4,0,10
7361,797766,14,1,2,1,2,0,0,1,2,1,1,0,4,0,0,0,3
7361,791372,34,4,12,2,4,2,8,0,0,0,1,1,5,2,3,0,10
7361,792164,38,8,17,6,8,2,9,5,6,0,3,2,2,1,3,1,23
7361,780974,36,6,10,6,7,0,3,3,4,3,13,3,3,3,3,0,15
7361,797767,29,3,7,1,4,2,3,5,6,0,2,1,5,2,2,0,13
7361,797772,4,0,1,0,0,0,1,0,0,0,1,0,2,0,0,0,0
7361,792163,12,0,1,0,0,0,1,1,2,1,0,0,2,0,0,0,1
7361,797764,2,0,0,0,0,0,0,0,0,0,0,0,0,0,0,0,0
7362,790863,23,2,5,2,3,0,2,2,4,2,7,1,1,0,3,0,6
7362,780099,28,0,8,0,3,0,5,4,4,2,4,0,2,0,1,1,4
7362,785412,30,7,13,2,5,5,8,4,5,0,3,3,4,1,1,0,23
7362,776214,43,5,12,3,8,2,4,3,4,0,4,7,2,1,6,0,15
7362,775686,27,3,7,1,2,2,5,0,0,3,4,0,5,1,1,0,8
7362,785413,8,1,3,1,2,0,1,0,0,0,1,1,2,0,2,0,2
7362,776221,15,3,4,2,2,1,2,1,2,0,1,2,0,0,1,0,8
7362,785411,25,3,5,0,0,3,5,0,0,1,1,0,1,3,0,1,9
7362,785417,26,3,4,3,4,0,0,0,2,1,2,1,3,0,0,1,6
7363,785536,12,5,7,3,3,2,4,0,0,1,3,2,3,0,3,2,12
7363,780119,37,6,10,5,7,1,3,6,7,1,5,3,2,2,0,0,19
7363,796558,32,3,10,3,10,0,0,2,2,1,3,3,2,0,0,1,8
7363,796559,34,4,7,2,3,2,4,6,6,0,5,1,4,2,4,2,16
7363,776097,40,5,9,4,7,1,2,3,4,2,2,4,4,1,2,1,14
7363,785280,20,3,7,3,5,0,2,2,2,1,3,2,1,0,2,0,8
7363,780149,13,1,5,1,4,0,1,0,0,0,1,0,0,1,0,0,2
7363,796560,29,1,3,0,1,1,2,1,2,0,2,3,4,0,1,0,4
7363,775679,8,1,4,0,1,1,3,0,0,0,1,0,1,0,1,0,3
7364,796585,11,0,0,0,0,0,0,0,2,1,1,0,2,0,1,0,0
7364,780192,31,5,12,2,6,3,6,1,2,3,2,2,2,0,2,0,14
7364,798139,30,4,12,3,7,1,5,4,6,0,2,4,0,0,2,0,13
7364,786818,29,4,10,2,5,2,5,0,2,3,1,0,1,2,2,0,10
7364,780182,35,5,13,4,7,1,6,3,4,0,7,2,4,0,1,0,14
7364,796587,4,0,1,0,1,0,0,0,0,0,1,0,0,0,0,1,0
7364,780186,21,5,7,4,6,1,1,0,0,0,8,3,0,0,0,0,11
7364,798138,13,1,2,0,0,1,2,0,0,1,0,1,1,2,0,0,3
7364,796582,10,1,2,1,2,0,0,0,1,0,1,0,2,0,1,0,2
7364,780188,2,0,0,0,0,0,0,0,0,0,0,0,0,0,0,0,0
7364,780184,14,2,6,1,4,1,2,2,2,0,0,0,1,1,1,0,7
7365,791140,21,2,3,2,3,0,0,0,0,2,3,2,1,2,2,2,4
7365,791138,25,4,6,3,3,1,3,0,0,0,3,0,0,0,0,0,9
7365,786084,31,4,9,2,3,2,6,2,2,0,11,6,2,1,3,0,12
7365,780910,28,5,10,1,5,4,5,2,2,0,4,4,3,1,2,0,16
7365,780288,27,6,10,3,3,3,7,1,1,0,5,3,4,1,0,0,16
7365,796794,5,0,2,0,2,0,0,0,0,0,1,0,0,0,0,0,0
7365,791137,1,0,0,0,0,0,0,0,0,0,0,0,0,0,0,0,0
7365,796795,17,4,6,4,6,0,0,2,4,0,1,1,1,0,2,1,10
7365,796793,1,0,0,0,0,0,0,0,0,0,0,0,0,0,0,0,0
7365,786082,1,0,0,0,0,0,0,0,0,1,0,0,0,0,0,0,0
7365,780912,8,1,4,1,2,0,2,0,0,1,0,0,2,0,1,0,2
7365,780911,23,5,10,2,5,3,5,2,3,0,5,1,0,0,0,1,15
7365,781635,12,0,0,0,0,0,0,0,0,0,1,1,2,0,2,0,0
7366,786805,19,3,4,3,3,0,1,1,3,1,3,0,1,0,0,1,7
7366,774936,14,6,10,6,10,0,0,4,5,2,2,0,2,1,1,1,16
7366,790932,25,4,7,2,3,2,4,0,0,0,2,1,1,0,0,1,10
7366,781345,27,0,0,0,0,0,0,4,6,0,6,3,2,3,0,2,4
7366,786803,20,0,5,0,1,0,4,2,2,0,0,2,2,2,2,0,2
7366,796490,4,2,2,2,2,0,0,0,0,0,1,0,1,0,0,0,4
7366,796488,7,2,2,1,1,1,1,2,2,0,0,1,1,0,0,1,7
7366,790934,14,3,7,3,6,0,1,1,1,1,2,2,4,4,3,0,7
7366,786804,22,6,11,3,4,3,7,6,6,1,4,4,1,2,2,0,21
7366,796489,2,0,0,0,0,0,0,0,0,0,0,1,0,0,0,0,0
7366,796487,13,1,5,0,0,1,5,0,0,0,2,1,1,0,3,0,3
7366,790933,15,0,1,0,0,0,1,2,2,0,0,1,4,0,2,0,2
7366,780033,13,0,1,0,0,0,1,0,0,0,1,2,4,1,0,0,0
7366,780030,5,0,1,0,0,0,1,0,0,0,2,1,0,0,0,0,0
7367,797861,26,5,7,5,7,0,0,5,6,0,7,0,0,1,1,0,15
7367,797859,16,0,4,0,2,0,2,0,0,1,2,1,3,0,1,0,0
7367,792208,21,2,8,2,7,0,1,0,2,0,4,0,3,1,3,0,4
7367,792204,24,0,5,0,4,0,1,0,0,2,1,2,2,0,3,1,0
7367,786262,26,2,7,0,2,2,5,10,10,0,2,0,2,0,0,1,16
7367,786983,13,0,1,0,1,0,0,0,0,1,1,0,3,0,1,0,0
7367,797862,4,1,2,1,2,0,0,0,0,0,0,0,0,0,1,0,2
7367,776018,16,1,3,1,3,0,0,4,4,2,3,0,2,1,3,0,6
7367,797858,11,0,3,0,2,0,1,0,1,0,1,1,2,1,3,0,0
7367,797856,15,3,5,3,5,0,0,3,7,0,2,0,3,0,0,0,9
7367,786682,14,0,3,0,1,0,2,0,0,1,0,2,1,0,1,0,0
7367,781317,14,1,3,0,1,1,2,0,0,0,1,1,0,2,6,0,3
7368,792265,27,3,9,2,4,1,5,0,1,0,4,0,3,0,1,1,7
7368,792266,28,3,10,1,6,2,4,0,0,0,3,1,3,0,1,1,8
7368,786152,35,6,12,5,9,1,3,1,5,6,12,1,2,0,4,1,14
7368,798003,33,5,13,5,9,0,4,0,0,1,4,7,2,3,5,0,10
7368,792267,29,1,5,0,2,1,3,0,0,0,1,1,3,1,2,0,3
7368,798007,18,0,1,0,1,0,0,2,2,0,2,0,0,1,0,0,2
7368,798009,19,2,8,1,6,1,2,0,0,0,3,1,2,2,3,0,5
7368,792263,10,0,2,0,1,0,1,2,2,0,1,0,2,0,0,0,2
7368,798005,1,0,0,0,0,0,0,0,0,0,0,0,0,0,0,0,0
7369,787175,38,4,10,0,1,4,9,2,2,1,7,0,3,2,2,0,14
7369,782126,38,5,15,4,11,1,4,0,0,7,8,1,1,0,0,1,11
7369,790909,39,3,9,1,4,2,5,3,4,0,5,6,3,2,2,0,11
7369,781393,40,2,13,2,9,0,4,4,5,0,7,0,2,2,4,0,8
7369,775351,35,6,9,6,9,0,0,2,3,1,5,4,2,3,2,0,14
7369,790907,10,0,2,0,2,0,0,0,0,0,1,0,2,1,1,1,0
7370,791352,22,4,7,4,6,0,1,1,2,3,3,2,0,0,1,0,9
7370,780455,23,4,7,4,7,0,0,5,6,2,7,1,0,1,2,1,13
7370,797251,24,3,6,3,3,0,3,0,0,3,2,4,2,1,1,0,6
7370,797247,32,4,8,2,4,2,4,1,1,0,1,6,1,1,2,0,11
7370,776297,35,4,13,2,6,2,7,0,0,0,4,4,2,1,2,0,10
7370,797250,2,0,1,0,1,0,0,0,0,0,0,1,1,0,0,0,0
7370,791355,3,1,1,0,0,1,1,0,0,0,1,0,0,0,0,1,3
7370,791354,16,0,0,0,0,0,0,1,2,1,0,2,2,1,0,0,1
7370,785837,16,6,12,5,10,1,2,3,4,3,3,1,1,0,1,1,16
7370,786227,0,0,0,0,0,0,0,0,0,0,0,0,1,0,0,0,0
7370,797255,0,0,0,0,0,0,0,0,0,0,0,0,0,0,0,0,0
7370,797249,8,0,0,0,0,0,0,0,0,0,1,0,0,0,0,0,0
7370,797248,19,4,8,1,1,3,7,0,0,0,2,0,1,0,0,0,11
7371,791723,32,2,5,2,5,0,0,0,0,2,2,0,3,1,3,2,4
7371,797310,35,4,9,2,5,2,4,0,0,3,2,4,1,0,2,0,10
7371,785580,8,0,1,0,0,0,1,0,0,0,1,0,0,0,0,0,0
7371,791724,31,4,10,2,4,2,6,1,2,2,2,0,3,1,3,0,11
7371,781617,36,5,13,2,6,3,7,0,0,1,7,2,2,1,0,1,13
7371,797312,3,0,0,0,0,0,0,0,0,0,0,0,0,0,0,0,0
7371,780956,29,6,15,4,9,2,6,3,3,0,2,1,2,0,2,0,17
7371,786277,3,0,0,0,0,0,0,0,0,0,0,0,1,0,0,0,0
7371,800056,2,0,0,0,0,0,0,0,0,0,0,0,0,0,0,0,0
7371,797308,4,0,0,0,0,0,0,0,0,0,1,0,0,0,3,0,0
7371,780706,17,2,4,2,4,0,0,1,2,0,0,2,1,0,1,0,5
7372,797824,24,2,5,1,2,1,3,0,0,3,3,1,1,0,1,1,5
7372,775116,31,7,11,3,3,4,8,2,3,1,10,8,2,2,2,0,20
7372,797822,24,3,5,2,2,1,3,2,2,0,6,1,4,1,2,0,9
7372,791928,21,0,1,0,0,0,1,2,4,0,2,4,1,1,0,0,2
7372,786664,35,9,16,5,7,4,9,0,0,1,1,3,0,1,2,0,22
7372,797828,1,0,0,0,0,0,0,0,0,0,0,0,0,0,0,0,0
7372,797825,10,1,4,1,4,0,0,0,0,1,0,0,0,0,1,0,2
7372,792191,18,1,1,1,1,0,0,0,2,0,2,2,2,0,0,0,2
7372,792190,33,5,10,3,7,2,3,6,6,0,5,6,0,1,3,0,18
7372,781266,3,0,0,0,0,0,0,0,0,0,0,0,1,0,0,0,0
7373,791225,33,10,16,9,14,1,2,0,1,2,5,3,2,0,0,1,21
7373,775324,8,2,2,2,2,0,0,0,0,0,2,0,2,0,1,0,4
7373,796929,29,1,5,1,1,0,4,0,0,0,1,2,0,1,0,0,2
7373,791224,32,9,16,8,14,1,2,0,1,1,1,4,4,1,6,1,19
7373,781181,34,4,10,1,3,3,7,0,0,0,4,4,2,3,1,0,11
7373,796927,24,2,5,1,1,1,4,0,0,0,5,3,3,0,1,0,5
7373,796930,1,0,1,0,1,0,0,0,0,0,0,0,0,0,0,0,0
7373,791222,20,2,5,1,3,1,2,0,0,0,2,2,2,1,0,0,5
7373,785564,18,0,1,0,1,0,0,0,0,0,0,2,1,0,2,0,0
7373,796928,1,0,0,0,0,0,0,0,0,0,0,0,0,0,0,0,0
7374,791952,17,0,0,0,0,0,0,1,2,1,2,3,2,2,1,0,1
7374,786067,34,4,10,4,10,0,0,4,4,1,6,0,3,3,2,0,12
7374,797660,32,5,10,5,8,0,2,6,6,2,4,2,3,0,1,0,16
7374,785591,25,1,5,1,5,0,0,0,0,0,1,0,3,1,2,0,2
7374,780258,21,0,5,0,2,0,3,0,0,0,0,2,0,2,2,0,0
7374,797662,25,5,8,3,5,2,3,1,5,3,3,1,2,0,1,0,13
7374,792082,13,0,0,0,0,0,0,0,0,0,2,1,1,0,2,0,0
7374,792078,4,0,1,0,1,0,0,0,0,0,1,0,0,0,1,0,0
7374,797661,25,3,6,3,5,0,1,6,6,1,0,0,3,0,1,0,12
7374,792079,0,0,0,0,0,0,0,0,0,0,1,0,0,0,0,0,0
7374,792083,4,0,0,0,0,0,0,0,0,0,0,0,0,0,0,0,0
7375,791883,21,4,5,2,2,2,3,0,0,1,4,0,4,1,1,0,10
7375,781066,32,7,8,7,8,0,0,3,4,4,2,3,1,0,4,0,17
7375,797594,17,1,3,0,0,1,3,1,2,0,0,0,3,2,1,0,4
7375,791884,31,7,10,6,7,1,3,6,8,0,2,2,3,0,2,0,21
7375,780695,32,5,12,3,4,2,8,0,0,0,8,1,2,3,0,0,12
7375,797600,8,0,1,0,1,0,0,1,2,0,2,0,0,0,1,0,1
7375,797598,8,1,2,1,2,0,0,1,3,0,1,0,2,0,0,0,3
7375,797596,22,0,4,0,2,0,2,0,0,0,0,1,1,0,1,0,0
7375,786496,27,0,1,0,0,0,1,0,0,0,1,3,0,1,3,0,0
7375,791885,2,0,0,0,0,0,0,0,0,0,0,0,0,0,0,0,0
7376,797163,23,3,3,3,3,0,0,5,7,3,3,1,4,0,3,1,11
7376,797164,18,0,3,0,2,0,1,1,2,0,5,1,3,0,2,0,1
7376,786450,40,6,12,5,7,1,5,3,3,2,5,2,5,3,2,1,16
7376,776396,37,6,14,4,9,2,5,5,5,2,3,1,0,3,1,0,19
7376,776199,26,1,6,1,4,0,2,2,2,0,0,4,1,1,3,0,4
7376,797167,16,3,6,3,4,0,2,3,4,1,2,2,1,2,1,0,9
7376,791385,18,0,0,0,0,0,0,2,4,0,2,1,3,0,2,0,2
7376,797161,3,0,0,0,0,0,0,0,0,0,0,0,1,0,0,0,0
7376,797165,16,3,6,1,2,2,4,0,0,1,0,2,1,0,1,0,8
7376,791382,3,0,0,0,0,0,0,0,0,0,0,0,0,0,0,0,0
7377,786404,30,1,4,0,1,1,3,6,8,1,1,2,5,1,3,0,9
7377,780378,34,4,9,4,9,0,0,4,8,8,2,1,3,0,2,2,12
7377,786378,29,4,7,3,5,1,2,2,2,0,1,2,5,2,1,0,11
7377,786374,38,9,18,6,12,3,6,5,6,5,8,7,2,2,2,0,26
7377,786253,35,3,10,1,6,2,4,4,6,0,2,4,0,1,3,0,12
7377,797062,4,0,0,0,0,0,0,0,0,0,0,0,3,1,0,0,0
7377,797065,12,1,2,0,0,1,2,0,0,0,0,0,3,0,2,0,3
7377,785798,13,1,2,1,1,0,1,2,2,0,2,0,0,1,1,0,4
7377,780381,5,0,0,0,0,0,0,0,0,0,1,0,2,0,0,0,0
7377,780121,0,0,0,0,0,0,0,0,0,0,0,0,1,0,0,0,0
7378,785714,30,6,7,6,7,0,0,4,7,3,7,1,3,1,2,2,16
7378,775894,36,3,6,1,4,2,2,2,2,1,9,3,3,0,2,0,10
7378,785711,37,10,18,7,9,3,9,2,2,0,3,5,0,0,3,0,25
7378,780985,36,7,9,1,1,6,8,0,0,0,4,3,1,2,0,0,20
7378,775266,25,3,8,2,4,1,4,0,0,0,2,1,2,0,1,0,7
7378,796829,10,1,1,1,1,0,0,0,0,1,1,1,1,0,1,0,2
7378,791167,9,1,2,1,1,0,1,2,2,0,0,2,1,0,0,0,4
7378,785378,6,1,2,1,1,0,1,0,0,0,0,0,0,1,0,0,2
7378,779994,11,0,1,0,0,0,1,0,0,0,1,0,0,0,0,0,0
7379,791981,36,3,13,3,9,0,4,2,2,1,6,2,4,2,0,1,8
7379,780342,29,6,10,3,6,3,4,1,2,3,3,1,1,0,1,2,16
7379,791982,36,7,16,3,7,4,9,3,3,0,3,2,2,2,3,0,21
7379,780333,33,3,12,1,4,2,8,0,0,2,4,3,1,1,1,0,8
7379,781493,23,2,5,2,3,0,2,2,2,2,0,3,3,0,1,0,6
7379,786756,16,0,0,0,0,0,0,0,0,0,1,1,1,0,1,0,0
7379,786755,25,3,5,2,3,1,2,4,4,3,1,1,2,1,0,0,11
7379,791986,2,0,3,0,0,0,3,0,0,0,0,1,0,0,0,0,0
7380,791923,29,6,12,6,12,0,0,0,1,1,3,1,3,0,4,1,12
7380,781122,21,3,4,3,4,0,0,2,4,1,1,0,3,2,3,0,8
7380,791925,24,4,7,2,5,2,2,0,0,0,2,1,3,2,5,0,10
7380,786527,20,3,6,2,3,1,3,1,1,2,0,2,0,2,0,0,8
7380,781112,18,0,1,0,1,0,0,0,0,0,0,2,1,1,0,0,0
7380,786529,11,0,1,0,1,0,0,0,0,1,1,2,0,0,0,1,0
7380,797541,18,3,6,3,6,0,0,0,0,1,3,0,1,0,1,2,6
7380,797542,15,5,9,2,4,3,5,4,5,0,0,1,0,1,2,0,17
7380,791927,10,0,1,0,1,0,0,0,0,0,1,1,0,0,0,1,0
7380,791926,13,0,3,0,0,0,3,0,0,0,1,0,1,0,0,0,0
7380,786858,21,2,3,0,1,2,2,2,2,1,1,4,2,1,1,0,8
7381,796996,31,9,12,9,12,0,0,2,2,1,0,2,2,0,1,0,20
7381,780471,34,7,11,7,10,0,1,0,0,2,7,4,3,4,5,1,14
7381,796994,36,1,5,1,2,0,3,2,2,0,5,11,2,1,4,0,4
7381,791613,28,3,9,2,6,1,3,0,1,1,4,1,3,1,4,0,7
7381,791608,28,1,5,0,0,1,5,3,3,1,0,2,2,1,0,0,6
7381,791610,10,1,1,1,1,0,0,0,0,0,1,1,2,0,3,0,2
7381,786413,9,3,6,2,5,1,1,0,0,4,1,0,2,0,2,0,7
7381,792071,19,2,4,0,0,2,4,0,0,0,2,0,0,0,0,0,6
7381,785680,3,0,0,0,0,0,0,0,0,0,0,0,0,0,1,0,0
7381,780417,2,0,0,0,0,0,0,0,0,0,0,0,1,0,0,0,0
7382,780686,32,8,17,8,17,0,0,6,8,3,4,5,3,0,1,0,22
7382,780683,30,0,3,0,1,0,2,0,0,1,8,1,0,0,1,1,0
7382,797680,17,1,5,1,2,0,3,2,2,1,2,0,1,0,2,0,4
7382,786112,28,2,11,1,3,1,8,6,7,1,0,0,2,2,1,0,11
7382,780688,27,6,9,4,6,2,3,2,2,2,1,2,3,2,1,0,16
7382,797683,5,0,0,0,0,0,0,0,0,0,1,0,1,0,0,0,0
7382,797682,4,0,0,0,0,0,0,0,0,0,1,0,2,0,0,0,0
7382,797681,32,5,13,2,5,3,8,2,3,1,0,4,3,1,2,0,15
7382,797679,2,0,1,0,0,0,1,0,0,0,0,0,0,0,0,0,0
7382,791942,19,2,3,2,2,0,1,0,0,1,1,0,1,0,0,0,4
7382,780689,4,0,0,0,0,0,0,0,0,1,1,0,0,0,0,0,0
7383,780521,31,4,4,1,1,3,3,4,4,0,2,0,3,0,0,0,15
7383,775163,11,1,3,1,3,0,0,0,0,0,1,1,1,0,1,2,2
7383,791370,27,2,6,0,2,2,4,0,2,1,4,0,2,0,3,0,6
7383,786199,34,6,12,5,8,1,4,4,4,0,3,6,3,2,2,0,17
7383,780991,36,6,11,5,8,1,3,3,4,0,7,5,3,1,3,0,16
7383,780145,17,0,0,0,0,0,0,1,2,0,2,0,1,0,1,2,1
7383,781611,12,2,2,2,2,0,0,0,0,1,2,0,2,0,0,0,4
7383,797271,17,3,8,2,4,1,4,0,0,0,4,1,2,1,2,1,7
7383,743593,3,0,0,0,0,0,0,0,2,0,0,0,0,0,0,0,0
7383,791371,12,1,1,1,1,0,0,0,0,0,0,1,0,1,2,0,2
7384,800091,25,2,5,2,4,0,1,4,10,0,1,1,4,1,6,0,8
7384,800005,19,0,0,0,0,0,0,0,0,0,2,0,1,0,2,1,0
7384,799129,36,5,11,2,4,3,7,0,0,1,3,2,4,0,2,1,13
7384,799130,35,5,9,2,4,3,5,0,0,1,3,0,1,0,4,0,13
7384,792634,38,7,11,5,6,2,5,1,1,0,3,4,2,1,5,0,17
7384,799135,3,0,0,0,0,0,0,0,0,0,0,0,0,0,0,0,0
7384,799136,3,0,0,0,0,0,0,0,0,0,0,0,2,0,0,0,0
7384,799128,11,0,0,0,0,0,0,2,2,0,1,4,1,1,0,0,2
7384,799133,4,0,0,0,0,0,0,0,0,0,1,0,0,0,0,0,0
7384,799134,26,1,4,0,2,1,2,0,0,0,2,3,2,0,3,0,3
7385,790951,22,3,4,3,4,0,0,1,4,2,5,1,0,2,0,0,7
7385,786309,29,3,5,1,1,2,4,1,2,1,2,3,2,4,0,0,9
7385,780087,28,8,15,7,14,1,1,5,6,1,2,2,2,1,2,0,22
7385,776076,30,0,5,0,4,0,1,5,6,0,3,3,3,2,3,0,5
7385,776136,36,5,12,4,5,1,7,3,3,0,2,5,4,1,0,0,14
7385,796543,19,1,2,1,2,0,0,1,2,4,1,0,3,1,2,0,3
7385,796540,2,0,1,0,1,0,0,0,0,0,0,0,0,0,0,0,0
7385,796545,9,2,4,2,2,0,2,0,0,0,5,1,0,1,1,0,4
7385,786089,25,2,7,0,1,2,6,0,0,0,1,2,3,0,1,0,6
7386,776100,29,6,7,4,5,2,2,0,0,3,4,1,2,2,2,3,14
7386,785991,25,9,10,7,8,2,2,1,2,2,2,0,1,0,2,1,21
7386,797762,25,3,6,1,4,2,2,0,0,2,1,9,0,1,0,0,8
7386,781406,31,6,11,5,7,1,4,3,4,1,3,7,1,1,2,0,16
7386,781401,26,0,7,0,3,0,4,0,0,0,3,2,1,2,2,0,0
7386,797763,1,0,0,0,0,0,0,0,0,0,0,0,1,0,0,0,0
7386,797760,6,0,0,0,0,0,0,0,0,0,1,0,0,0,0,0,0
7386,792129,6,1,1,1,1,0,0,0,0,0,4,1,0,0,2,0,2
7386,797758,11,3,6,2,3,1,3,1,2,0,2,1,1,0,1,0,8
7386,792130,2,0,0,0,0,0,0,0,0,0,0,0,0,0,1,0,0
7386,792133,7,1,3,0,1,1,2,0,0,0,1,0,1,0,0,0,3
7386,781029,17,5,10,0,1,5,9,0,0,0,0,0,1,2,0,0,15
7386,775317,14,1,1,1,1,0,0,0,0,0,1,3,1,0,0,0,2
7387,791839,27,5,6,5,6,0,0,0,0,1,1,0,2,0,3,0,10
7387,785322,22,0,6,0,0,0,6,0,0,0,4,1,0,1,1,0,0
7387,797444,25,4,8,2,3,2,5,1,2,2,3,0,0,0,3,2,11
7387,792381,36,3,13,2,7,1,6,1,1,1,2,2,0,1,1,1,8
7387,791842,30,5,13,1,4,4,9,0,0,1,1,1,2,1,1,0,14
7387,797443,14,2,2,2,2,0,0,2,3,0,1,1,3,2,2,0,6
7387,797442,4,0,1,0,0,0,1,0,0,0,1,0,2,0,0,0,0
7387,786613,18,2,6,2,5,0,1,1,1,2,2,1,0,1,1,0,5
7387,776341,2,0,1,0,0,0,1,0,0,0,0,0,0,0,0,0,0
7387,786736,22,4,5,2,2,2,3,2,2,3,4,3,3,0,3,1,12
7388,791306,22,2,5,1,3,1,2,4,4,1,1,1,1,1,0,1,9
7388,780210,38,12,18,10,13,2,5,6,9,6,8,2,1,2,3,2,32
7388,796594,29,5,11,3,5,2,6,2,4,0,3,1,2,3,2,0,14
7388,792432,32,3,9,2,5,1,4,3,3,0,1,2,1,3,2,0,10
7388,792427,20,1,4,1,3,0,1,0,0,0,1,1,2,1,1,0,2
7388,796592,19,1,2,1,2,0,0,1,2,0,2,3,2,0,1,0,3
7388,790880,1,0,0,0,0,0,0,0,0,0,0,0,1,0,0,0,0
7388,792433,16,1,5,1,3,0,2,0,0,2,2,1,2,1,2,0,2
7388,786422,10,1,1,1,1,0,0,0,0,0,0,0,2,0,1,0,2
7388,775005,13,1,2,0,0,1,2,1,2,0,1,0,2,1,0,0,4
7389,781516,12,2,3,2,3,0,0,2,2,0,2,1,1,0,0,0,6
7389,797331,33,9,16,6,10,3,6,0,0,1,4,2,1,0,4,0,21
7389,791737,35,2,7,2,6,0,1,2,2,0,4,3,3,2,5,0,6
7389,783524,29,3,10,2,5,1,5,2,2,1,0,2,2,1,2,0,9
7389,780561,23,2,5,0,0,2,5,0,0,0,6,1,4,0,1,1,6
7389,791734,17,4,6,4,6,0,0,1,3,4,1,0,0,1,0,0,9
7389,775913,11,1,3,1,3,0,0,0,0,0,0,0,3,0,1,0,2
7389,797333,9,0,1,0,0,0,1,0,0,0,0,0,2,2,5,0,0
7389,795372,8,0,0,0,0,0,0,0,0,0,1,0,0,0,0,0,0
7389,786223,23,2,5,2,4,0,1,0,0,1,6,3,4,1,3,0,4
7389,791736,0,0,0,0,0,0,0,0,0,0,0,0,0,0,0,0,0
7390,797367,19,2,4,2,4,0,0,0,0,1,5,3,3,0,1,2,4
7390,797369,27,6,11,5,6,1,5,1,1,0,1,6,2,5,2,0,14
7390,797366,16,0,1,0,1,0,0,0,0,1,2,1,3,2,0,0,0
7390,791807,29,2,6,1,2,1,4,0,0,0,2,1,0,0,1,0,5
7390,786130,30,8,14,5,8,3,6,4,4,2,6,2,2,1,1,2,23
7390,797371,4,2,2,2,2,0,0,0,0,0,2,0,2,0,0,0,4
7390,797368,8,0,0,0,0,0,0,2,2,1,2,1,2,0,0,0,2
7390,797364,13,2,3,1,2,1,1,0,1,2,3,1,2,0,0,0,5
7390,786127,4,0,1,0,0,0,1,0,0,0,2,0,1,0,0,1,0
7390,797370,3,2,2,2,2,0,0,0,0,0,1,0,0,0,0,0,4
7390,797365,19,6,10,2,3,4,7,2,2,0,2,0,3,1,1,0,18
7390,797363,18,4,10,2,4,2,6,3,4,0,1,2,2,1,2,0,13
7390,791805,4,0,0,0,0,0,0,0,0,0,0,1,0,0,0,0,0
7390,791808,6,1,1,0,0,1,1,2,2,0,0,5,0,0,0,0,5
7391,780758,14,0,2,0,2,0,0,0,0,1,2,0,4,0,2,0,0
7391,775489,25,2,4,2,3,0,1,2,4,2,3,0,1,0,1,0,6
7391,785563,32,4,8,4,6,0,2,3,5,1,4,3,2,2,3,0,11
7391,791069,27,3,8,2,4,1,4,0,0,0,1,4,2,2,3,0,7
7391,780313,31,5,15,3,7,2,8,1,3,1,2,2,1,0,7,1,13
7391,781208,9,0,1,0,1,0,0,0,0,2,2,0,4,0,1,0,0
7391,791087,11,0,0,0,0,0,0,1,2,0,1,0,1,0,0,0,1
7391,796750,3,1,1,0,0,1,1,0,0,0,0,0,0,0,0,0,3
7391,796749,3,0,1,0,0,0,1,0,0,0,0,0,0,0,1,0,0
7391,796748,3,0,0,0,0,0,0,0,0,0,0,1,0,0,0,0,0
7391,791088,9,1,1,1,1,0,0,0,1,2,0,1,1,1,1,0,2
7391,785560,16,2,5,0,0,2,5,0,0,0,4,1,1,0,1,1,6
7391,785561,17,1,7,1,6,0,1,6,8,1,6,0,1,0,0,0,8
7392,797258,6,0,0,0,0,0,0,0,0,0,0,0,2,0,0,1,0
7392,786080,37,9,18,2,3,7,15,7,8,0,5,0,2,1,3,0,32
7392,791348,28,1,4,1,3,0,1,1,2,0,3,2,1,0,2,1,3
7392,791350,38,3,7,2,4,1,3,0,0,0,3,1,5,2,1,1,7
7392,786218,35,4,11,4,9,0,2,1,2,4,2,6,0,0,2,0,9
7392,786216,28,5,8,5,7,0,1,0,1,1,7,1,3,3,0,0,10
7392,781645,19,3,8,2,4,1,4,1,2,0,2,2,0,0,0,0,8
7392,780156,6,0,2,0,0,0,2,0,0,1,1,0,0,0,0,0,0
7392,780150,3,0,1,0,0,0,1,0,0,0,0,0,1,0,0,0,0
7393,780229,30,12,17,12,17,0,0,2,2,5,3,4,2,1,0,0,26
7393,795572,25,2,9,2,5,0,4,0,2,0,7,0,2,1,0,2,4
7393,791483,39,6,14,4,9,2,5,5,8,0,5,7,0,1,2,0,19
7393,786322,25,0,3,0,0,0,3,2,2,1,3,0,1,0,1,0,2
7393,780228,33,1,4,0,0,1,4,0,0,0,3,0,4,1,2,0,3
7393,791484,10,1,2,1,1,0,1,0,0,0,2,0,1,0,1,0,2
7393,781592,22,1,1,1,1,0,0,5,6,1,5,0,3,3,2,2,7
7393,797194,8,3,4,1,1,2,3,0,0,1,1,0,0,1,0,0,8
7393,797193,8,0,1,0,1,0,0,0,0,0,0,0,1,0,0,0,0
7394,775510,36,5,14,1,8,4,6,3,4,2,3,2,1,1,1,0,17
7394,774976,34,6,10,3,5,3,5,3,5,2,10,0,1,0,0,4,18
7394,797865,32,0,3,0,2,0,1,1,2,0,8,7,2,1,1,1,1
7394,786614,25,4,5,2,2,2,3,2,2,0,0,1,2,2,0,0,12
7394,786759,34,2,8,2,5,0,3,2,4,0,2,5,1,0,4,0,6
7394,792292,6,0,0,0,0,0,0,0,0,0,0,0,3,0,0,0,0
7394,792291,20,1,5,0,1,1,4,0,0,0,2,1,1,0,0,0,3
7394,786761,3,0,0,0,0,0,0,1,2,1,1,0,1,0,0,0,1
7394,792293,8,1,3,1,3,0,0,0,0,0,1,0,2,0,0,0,2
7394,797864,1,0,0,0,0,0,0,0,0,0,0,0,0,0,0,0,0
7394,797867,1,0,0,0,0,0,0,0,0,0,0,0,0,0,0,0,0
7395,790856,24,3,7,3,7,0,0,1,3,2,8,2,3,0,0,1,7
7395,780452,24,2,7,2,7,0,0,1,2,1,5,1,2,0,1,0,5
7395,796413,26,3,7,1,1,2,6,0,0,0,1,0,0,1,1,0,8
7395,796408,25,2,9,2,6,0,3,0,0,1,4,3,2,1,1,0,4
7395,796407,19,0,4,0,1,0,3,0,0,1,2,1,2,0,0,0,0
7395,796410,19,3,8,3,8,0,0,0,1,2,5,3,1,1,1,1,6
7395,790858,11,0,1,0,0,0,1,1,2,0,0,0,2,1,1,0,1
7395,796409,24,3,8,3,6,0,2,0,0,1,0,0,2,2,2,0,6
7395,780450,13,0,1,0,0,0,1,0,0,0,0,1,1,0,0,0,0
7395,796411,11,3,5,3,5,0,0,3,4,2,3,0,3,0,0,0,9
7395,780454,1,0,0,0,0,0,0,0,0,0,1,0,0,0,0,0,0
7395,796414,1,1,1,1,1,0,0,0,0,0,0,0,0,0,0,0,2
7395,798137,1,0,0,0,0,0,0,0,0,0,0,0,0,0,0,0,0
7395,781286,1,0,0,0,0,0,0,0,0,0,0,0,0,0,0,0,0
7396,796959,13,2,2,1,1,1,1,0,0,0,1,1,0,0,2,1,5
7396,781272,39,11,18,7,13,4,5,1,3,3,10,1,3,1,3,3,27
7396,796958,27,5,9,2,5,3,4,1,4,1,1,3,2,1,1,0,14
7396,791261,27,3,9,1,4,2,5,2,2,1,1,3,0,1,1,1,10
7396,781270,35,1,10,1,6,0,4,4,6,1,1,11,1,3,3,0,6
7396,791260,7,1,1,1,1,0,0,0,0,0,0,0,2,0,1,0,2
7396,785503,2,1,2,1,2,0,0,0,0,0,0,0,0,0,0,0,2
7396,799825,2,0,0,0,0,0,0,0,0,0,0,0,2,0,0,0,0
7396,791258,15,2,3,0,1,2,2,0,0,1,1,2,1,0,0,0,6
7396,785501,33,4,11,0,5,4,6,2,3,2,3,2,5,2,2,0,14
7396,785502,0,0,0,0,0,0,0,0,0,0,0,0,0,0,0,0,0
7397,792388,26,4,4,4,4,0,0,4,5,4,9,1,4,0,2,0,12
7397,797845,18,1,4,0,0,1,4,0,0,0,2,0,1,1,1,1,3
7397,797851,40,4,9,1,4,3,5,3,6,0,4,7,3,2,4,0,14
7397,792391,35,9,14,9,14,0,0,4,6,2,3,1,3,1,2,2,22
7397,792395,33,8,15,5,11,3,4,4,6,1,6,6,2,2,1,0,23
7397,781533,16,0,2,0,0,0,2,0,0,0,1,1,2,0,0,0,0
7397,792393,32,9,15,8,12,1,3,2,4,2,2,4,1,0,3,1,21
7398,791787,16,0,2,0,1,0,1,2,2,1,2,0,3,0,5,0,2
7398,789048,27,3,6,3,6,0,0,4,4,3,7,1,1,0,4,0,10
7398,789046,7,0,2,0,0,0,2,0,0,0,0,0,3,1,2,0,0
7398,791786,21,0,2,0,0,0,2,0,0,2,2,3,1,0,3,1,0
7398,789041,20,2,4,0,1,2,3,0,0,0,1,2,1,0,4,0,6
7398,799762,12,3,7,1,3,2,4,0,0,1,1,1,0,0,1,1,8
7398,785540,13,0,1,0,1,0,0,2,2,0,3,1,1,0,2,1,2
7398,797631,19,2,2,1,1,1,1,0,0,0,0,2,0,0,2,0,5
7398,797630,29,7,11,1,2,6,9,2,2,0,1,0,1,0,2,0,22
7398,797629,14,1,3,1,3,0,0,0,0,0,0,0,3,0,1,0,2
7398,789044,22,2,6,0,0,2,6,0,0,2,0,3,3,0,1,0,6
7399,796617,13,2,2,2,2,0,0,0,0,2,1,1,2,2,1,0,4
7399,775131,25,6,10,3,3,3,7,0,0,1,1,1,3,0,1,0,15
7399,796616,26,4,7,2,5,2,2,1,2,1,5,1,0,1,0,0,11
7399,796612,31,7,15,6,12,1,3,2,2,2,2,5,0,2,1,2,17
7399,785562,18,4,6,4,5,0,1,6,7,0,2,3,4,2,3,0,14
7399,792429,6,2,3,1,1,1,2,0,0,0,0,0,2,0,0,0,5
7399,796618,5,0,1,0,0,0,1,0,0,0,0,0,1,0,0,0,0
7399,796619,5,1,2,0,1,1,1,0,0,1,0,0,0,0,0,0,3
7399,796614,16,4,7,4,5,0,2,0,0,0,3,2,1,1,0,0,8
7399,796610,6,1,2,0,0,1,2,0,0,1,1,0,0,0,2,0,3
7399,796607,23,2,2,2,2,0,0,0,0,0,0,1,1,0,0,0,4
7399,796606,26,1,4,1,3,0,1,1,2,3,0,5,2,2,1,0,3
7400,791537,24,5,7,3,4,2,3,5,6,2,3,1,0,0,0,0,17
7400,775846,16,1,3,1,2,0,1,1,2,1,1,1,2,0,0,0,3
7400,780306,38,8,16,7,12,1,4,7,10,2,5,4,3,1,3,0,24
7400,797116,38,4,7,1,3,3,4,0,0,0,1,9,3,0,1,0,11
7400,780312,36,4,7,0,0,4,7,1,2,0,2,4,4,1,2,0,13
7400,791535,4,0,0,0,0,0,0,0,0,0,0,1,0,0,0,0,0
7400,786358,20,1,2,0,0,1,2,0,0,0,1,1,3,1,3,0,3
7400,775418,24,3,5,3,5,0,0,3,4,3,3,0,0,0,0,0,9
7401,786550,37,10,16,4,5,6,11,2,2,0,4,1,5,2,2,0,28
7401,776054,31,0,8,0,4,0,4,0,0,2,3,4,4,0,0,1,0
7401,792007,34,7,11,6,7,1,4,2,2,1,2,4,4,1,0,0,17
7401,792009,27,6,10,6,9,0,1,0,1,1,3,2,1,1,2,0,12
7401,792006,18,2,2,2,2,0,0,3,4,1,0,3,3,0,0,0,7
7401,780177,11,2,2,2,2,0,0,0,1,1,2,0,4,0,1,1,4
7401,786552,18,1,4,1,2,0,2,0,0,0,1,2,1,0,1,0,2
7401,776273,24,2,4,1,1,1,3,1,2,1,1,6,0,0,1,0,6
7402,792283,20,2,4,1,1,1,3,1,2,2,0,0,3,0,0,0,6
7402,797823,17,1,5,1,3,0,2,1,2,2,5,1,0,0,2,1,3
7402,797829,30,8,12,8,12,0,0,2,2,3,2,0,4,0,2,0,18
7402,792280,26,2,13,2,8,0,5,0,0,2,1,4,3,0,2,2,4
7402,780505,36,6,17,6,11,0,6,5,7,0,4,5,1,4,3,0,17
7402,792284,31,3,8,2,3,1,5,0,0,1,3,4,4,2,1,1,7
7402,792286,9,0,1,0,1,0,0,0,0,0,2,0,1,0,0,0,0
7402,797826,8,0,0,0,0,0,0,2,2,0,0,1,3,0,2,0,2
7402,785950,23,2,6,1,2,1,4,3,3,0,4,1,3,1,0,0,8
7403,790893,25,1,4,1,4,0,0,5,8,0,6,1,3,0,1,0,7
7403,796444,35,7,13,7,13,0,0,6,9,1,10,1,2,2,3,6,20
7403,786615,23,1,5,1,3,0,2,0,0,1,5,3,1,1,5,0,2
7403,786732,22,2,5,0,2,2,3,1,2,2,1,0,1,0,0,0,7
7403,775260,36,10,16,8,11,2,5,7,8,1,1,2,0,0,2,0,29
7403,775536,18,0,0,0,0,0,0,0,0,1,2,0,1,0,3,0,0
7403,790890,21,2,4,2,4,0,0,0,1,0,3,5,4,1,1,0,4
7403,790889,8,0,1,0,1,0,0,0,0,0,1,0,3,0,1,1,0
7403,780702,11,2,2,1,1,1,1,0,1,0,0,0,0,1,0,0,5
7403,796445,1,1,1,1,1,0,0,0,0,0,0,0,0,0,0,0,2
7404,792340,40,8,14,7,10,1,4,4,9,0,11,5,3,1,3,0,21
7404,792341,29,0,2,0,1,0,1,2,2,0,1,0,2,0,1,0,2
7404,792342,38,0,5,0,0,0,5,2,2,0,4,4,2,1,3,0,2
7404,792346,29,3,5,1,3,2,2,0,0,1,6,1,3,1,2,0,8
7404,781552,33,7,11,5,9,2,2,1,1,0,5,1,0,2,5,0,17
7404,792345,15,1,3,1,3,0,0,0,0,1,1,1,4,0,0,0,2
7404,792344,16,1,2,0,0,1,2,0,0,0,1,0,2,0,1,0,3
7405,780570,29,3,9,3,9,0,0,0,0,1,3,1,2,2,2,2,6
7405,780569,27,2,4,2,4,0,0,1,3,1,4,0,4,1,3,0,5
7405,797436,21,1,6,0,3,1,3,0,0,0,0,2,1,1,0,0,3
7405,791696,29,3,8,3,7,0,1,2,2,0,0,2,1,1,2,0,8
7405,780565,35,6,13,5,8,1,5,3,4,1,4,2,0,2,2,0,16
7405,797433,6,0,0,0,0,0,0,2,4,2,0,0,2,0,0,0,2
7405,791695,14,1,4,1,4,0,0,0,0,0,4,0,4,1,1,1,2
7405,785824,20,0,2,0,0,0,2,2,2,0,4,0,1,0,0,0,2
7405,781556,19,1,4,0,2,1,2,0,0,0,4,0,2,1,0,0,3
7406,791512,30,5,6,5,6,0,0,1,4,2,3,0,4,0,0,2,11
7406,786338,40,5,12,2,6,3,6,6,8,3,8,1,0,1,1,0,19
7406,792050,36,3,7,2,4,1,3,0,0,0,4,4,4,0,7,0,7
7406,785347,24,1,5,1,2,0,3,3,5,0,2,2,5,1,2,0,5
7406,775601,43,4,11,2,5,2,6,7,8,1,1,4,2,1,3,0,17
7406,797647,20,2,4,0,1,2,3,0,0,0,3,0,0,1,0,0,6
7406,792052,2,0,0,0,0,0,0,0,0,1,0,0,0,0,1,0,0
7406,792047,23,5,12,4,8,1,4,8,8,2,3,0,5,1,2,0,19
7406,792051,7,0,0,0,0,0,0,0,0,0,0,0,2,0,0,0,0
7406,780862,0,0,0,0,0,0,0,0,0,0,0,0,0,0,0,0,0
7407,775806,35,6,10,3,7,3,3,0,0,0,3,2,3,2,3,0,15
7407,775563,41,12,20,12,19,0,1,6,8,0,7,1,3,1,3,1,30
7407,781011,10,1,1,1,1,0,0,1,2,0,0,1,5,0,2,0,3
7407,781012,43,3,7,1,2,2,5,3,5,2,4,3,1,0,2,1,11
7407,797602,5,0,1,0,0,0,1,0,0,0,1,0,1,0,0,0,0
7407,775188,8,1,1,1,1,0,0,0,2,0,1,0,5,0,0,0,2
7407,797601,34,4,11,3,5,1,6,0,2,2,2,0,1,0,2,0,9
7407,786466,5,2,2,1,1,1,1,0,0,0,0,0,3,0,0,0,5
7407,775119,41,2,6,1,2,1,4,6,6,0,5,6,0,3,1,0,11
7407,797604,3,0,0,0,0,0,0,0,0,0,0,0,0,0,0,0,0
7408,781454,23,2,5,2,4,0,1,2,4,2,3,3,3,1,0,3,6
7408,786424,33,7,13,7,13,0,0,4,10,12,13,3,3,1,4,1,18
7408,792366,35,6,13,6,13,0,0,5,7,3,1,0,5,2,2,1,17
7408,791015,25,1,3,1,1,0,2,1,2,0,0,7,4,1,0,0,3
7408,785483,34,9,20,8,14,1,6,8,8,0,4,3,0,3,5,0,27
7408,785959,10,2,2,2,2,0,0,0,0,0,0,0,3,0,1,1,4
7408,797988,6,2,3,2,3,0,0,2,2,0,0,1,0,0,0,0,6
7408,797979,20,1,4,1,4,0,0,0,0,0,0,3,2,0,1,0,2
7408,792279,4,0,1,0,0,0,1,0,0,0,0,0,0,0,0,0,0
7408,775335,10,2,2,0,0,2,2,0,0,0,1,0,2,0,1,0,6
7409,796891,27,11,16,11,14,0,2,9,10,2,5,3,4,1,1,0,31
7409,796886,20,2,4,1,2,1,2,0,0,0,4,3,4,1,1,0,5
7409,796884,30,3,5,1,1,2,4,11,11,0,1,4,1,1,0,0,19
7409,796882,34,4,13,2,9,2,4,4,4,1,2,1,3,4,5,0,14
7409,796881,30,0,1,0,0,0,1,0,0,0,3,8,1,0,4,0,0
7409,796890,13,3,6,3,5,0,1,0,0,0,3,0,5,0,1,1,6
7409,796896,9,1,2,1,1,0,1,1,2,0,1,1,2,0,0,0,3
7409,796887,20,3,6,1,3,2,3,1,2,2,3,0,3,0,0,0,9
7409,790447,17,3,5,3,5,0,0,0,0,0,1,1,1,0,1,0,6
7410,791669,23,5,5,5,5,0,0,0,0,2,2,0,4,0,0,0,10
7410,785762,32,5,12,5,11,0,1,5,9,3,13,0,3,3,2,0,15
7410,797407,25,1,1,1,1,0,0,4,6,0,1,5,1,1,2,0,6
7410,791666,31,7,14,6,7,1,7,2,2,0,2,4,0,1,2,0,17
7410,780531,31,8,11,2,2,6,9,3,4,0,6,3,0,2,0,1,25
7410,797414,11,0,0,0,0,0,0,1,2,1,3,0,5,0,1,0,1
7410,780534,12,2,3,2,3,0,0,0,0,1,3,0,1,0,0,1,4
7410,797409,15,0,2,0,2,0,0,0,0,1,1,3,1,1,2,1,0
7410,791671,2,0,0,0,0,0,0,0,0,0,0,0,0,0,0,0,0
7410,797415,7,0,1,0,1,0,0,0,0,0,1,0,2,0,0,0,0
7410,785760,9,1,4,0,0,1,4,0,0,0,0,1,2,0,1,0,3
7410,780535,2,1,2,1,1,0,1,1,1,0,1,0,0,0,0,0,3
7411,797849,23,2,4,1,1,1,3,2,2,0,2,1,1,0,1,0,7
7411,781537,26,2,5,0,2,2,3,2,2,0,2,1,3,2,2,1,8
7411,779986,16,1,3,1,3,0,0,0,0,1,1,0,2,0,1,1,2
7411,786079,20,0,3,0,1,0,2,0,0,0,0,0,2,0,4,0,0
7411,792202,20,1,6,0,2,1,4,0,0,0,2,0,1,1,0,0,3
7411,797848,3,0,1,0,1,0,0,0,0,0,1,0,1,0,0,0,0
7411,797842,28,7,13,6,10,1,3,4,5,6,8,0,3,2,2,1,19
7411,792201,4,1,1,1,1,0,0,0,2,0,0,0,0,0,1,0,2
7411,797836,17,2,4,0,2,2,2,0,1,0,0,0,2,0,0,0,6
7411,797847,17,1,5,1,3,0,2,2,4,0,0,0,0,0,2,0,4
7411,797846,20,1,7,1,4,0,3,0,0,0,2,1,3,0,1,0,2
7411,797835,6,0,1,0,0,0,1,2,3,0,0,0,2,0,0,0,2
7412,781215,29,1,6,1,3,0,3,0,0,0,6,1,3,1,1,0,2
7412,791001,14,1,8,0,4,1,4,0,0,0,2,0,1,0,1,1,3
7412,775255,39,8,16,2,8,6,8,5,6,1,2,0,3,0,2,1,27
7412,781159,20,1,4,1,3,0,1,3,5,2,1,1,5,1,0,0,5
7412,781174,32,3,7,3,7,0,0,2,3,7,6,2,0,1,1,0,8
7412,779972,27,2,7,1,4,1,3,0,1,0,1,2,0,1,4,2,5
7412,796644,8,1,1,1,1,0,0,0,0,0,2,1,1,0,1,0,2
7412,785231,22,4,6,4,5,0,1,1,2,0,2,0,1,0,1,0,9
7412,785320,9,0,1,0,0,0,1,0,0,0,0,0,0,0,1,0,0
7413,791375,39,4,11,1,2,3,9,0,0,0,1,2,1,2,2,0,11
7413,785482,29,6,18,5,12,1,6,0,0,2,5,4,3,1,2,0,13
7413,796477,19,1,4,1,3,0,1,0,0,0,1,1,1,0,1,0,2
7413,786164,13,0,0,0,0,0,0,0,0,0,5,0,4,0,1,1,0
7413,781560,38,4,8,4,8,0,0,0,1,4,3,2,4,2,4,2,8
7413,796479,27,0,2,0,2,0,0,6,6,1,7,0,5,2,0,0,6
7413,780837,33,7,12,3,6,4,6,1,3,1,1,2,1,0,3,0,19
7413,796476,2,0,0,0,0,0,0,0,0,1,0,0,1,0,0,0,0
7414,785532,33,2,4,2,4,0,0,1,2,1,9,1,4,1,0,2,5
7414,780063,23,2,8,2,6,0,2,0,0,1,4,1,4,0,0,1,4
7414,796734,33,3,5,0,0,3,5,4,4,0,4,0,4,1,1,1,13
7414,791055,21,0,2,0,2,0,0,0,0,0,0,4,4,4,4,0,0
7414,785530,31,9,17,7,12,2,5,9,10,3,5,2,1,0,1,0,29
7414,791057,14,1,2,1,1,0,1,2,4,0,4,2,2,0,0,0,4
7414,775573,17,2,5,1,3,1,2,3,4,0,0,1,0,0,0,0,8
7414,791058,6,1,2,1,2,0,0,0,0,3,2,0,1,0,0,0,2
7414,775926,16,2,8,1,1,1,7,0,0,0,1,1,0,0,0,0,5
7414,791280,6,0,2,0,2,0,0,1,4,0,0,1,0,0,0,0,1
7415,780919,24,2,6,2,6,0,0,5,7,1,4,0,4,0,1,0,9
7415,775816,29,2,5,1,2,1,3,3,4,2,10,0,2,1,1,0,8
7415,785803,32,4,5,2,2,2,3,0,0,0,1,0,5,0,2,0,10
7415,780920,32,3,11,3,9,0,2,7,8,0,2,3,2,2,3,0,13
7415,780914,35,3,11,3,5,0,6,0,2,1,5,0,2,2,1,0,6
7415,775640,12,2,5,2,4,0,1,0,0,0,2,0,0,0,0,2,4
7415,791142,12,1,3,1,3,0,0,0,0,0,2,1,1,0,0,0,2
7415,791141,8,2,4,2,4,0,0,0,0,0,0,1,0,0,1,0,4
7415,796799,16,3,5,3,5,0,0,0,0,3,1,0,3,0,1,0,6
7416,776344,28,7,12,4,7,3,5,0,0,1,4,1,4,1,5,1,17
7416,781538,28,3,6,2,2,1,4,3,3,0,5,2,2,0,0,0,10
7416,792453,32,2,8,1,6,1,2,3,5,0,3,4,0,1,0,0,8
7416,785131,29,2,4,1,1,1,3,2,2,1,5,2,2,1,1,2,7
7416,775821,26,2,9,1,3,1,6,0,0,1,1,2,2,1,1,0,5
7416,776233,13,3,7,1,2,2,5,0,0,1,0,1,3,1,0,0,8
7416,798115,19,2,6,0,2,2,4,0,0,1,2,2,1,0,2,0,6
7416,798113,14,1,4,1,2,0,2,1,2,0,2,0,0,0,0,0,3
7416,785152,11,1,2,0,0,1,2,0,0,0,1,0,1,0,0,0,3
7417,781530,30,10,17,8,11,2,6,5,6,1,12,0,2,1,0,0,27
7417,776423,19,5,11,5,11,0,0,0,0,4,3,1,2,2,2,0,10
7417,792319,25,2,5,0,3,2,2,2,3,1,2,4,0,0,0,0,8
7417,792307,21,2,6,0,3,2,3,0,0,0,2,1,2,0,0,0,6
7417,798096,27,2,6,2,5,0,1,0,0,2,0,2,1,1,0,0,4
7417,798104,21,2,5,1,2,1,3,2,2,1,1,2,0,0,4,0,7
7417,792314,11,1,3,1,3,0,0,2,2,2,1,0,2,0,1,2,4
7417,786296,16,1,3,1,3,0,0,1,2,3,1,0,1,1,0,0,3
7417,792320,13,1,4,1,3,0,1,0,0,0,6,0,1,0,2,0,2
7417,798106,8,1,1,1,1,0,0,0,0,0,0,0,0,1,0,0,2
7417,792321,4,0,1,0,1,0,0,0,0,0,0,0,2,0,0,0,0
7417,792316,3,0,0,0,0,0,0,0,0,0,1,1,1,0,0,0,0
7417,792309,2,0,0,0,0,0,0,0,0,0,0,0,1,0,0,0,0
7440,790883,33,3,10,3,8,0,2,2,2,0,3,4,2,1,0,1,8
7440,796436,32,5,13,2,7,3,6,2,2,0,4,5,1,1,5,0,15
7440,796438,36,3,7,1,1,2,6,2,2,1,5,1,1,3,3,1,10
7440,791635,25,3,7,1,2,2,5,2,2,1,2,2,2,1,1,0,10
7440,790884,24,3,4,3,4,0,0,0,0,2,7,1,3,0,4,3,6
7440,796439,16,3,7,3,7,0,0,0,0,1,3,1,1,0,1,1,6
7440,781262,18,3,10,0,1,3,9,0,0,1,1,0,0,1,0,0,9
7440,796442,8,1,1,1,1,0,0,1,1,0,1,0,2,0,1,0,3
7440,790885,7,0,0,0,0,0,0,0,0,0,1,1,1,0,1,0,0
7440,790520,1,0,0,0,0,0,0,0,0,0,0,0,0,0,0,0,0
7441,780176,39,2,7,1,2,1,5,3,4,1,3,2,1,2,3,0,8
7441,796377,19,0,7,0,4,0,3,0,0,0,1,3,3,1,3,0,0
7441,790814,37,7,13,6,11,1,2,0,0,6,8,0,1,1,2,0,15
7441,796372,29,5,9,5,9,0,0,0,2,2,4,0,0,0,1,1,10
7441,796379,36,5,16,2,9,3,7,1,1,0,1,3,0,2,3,0,14
7441,786013,11,4,5,4,5,0,0,0,0,0,3,0,3,0,1,0,8
7441,796378,9,1,3,1,2,0,1,0,0,0,3,1,2,2,1,1,2
7441,796374,20,0,1,0,0,0,1,3,5,0,2,2,1,1,0,0,3
7442,775110,29,5,8,5,8,0,0,2,2,1,11,4,4,0,2,0,12
7442,791392,38,3,7,2,4,1,3,2,2,1,8,5,2,0,0,0,9
7442,785936,31,4,7,4,5,0,2,0,2,1,2,1,2,1,2,0,8
7442,780128,37,6,12,1,2,5,10,6,9,0,3,3,1,0,4,0,23
7442,775458,39,12,19,9,14,3,5,7,7,0,4,3,1,3,4,1,34
7442,791394,2,0,0,0,0,0,0,0,0,0,0,1,0,0,0,0,0
7442,786062,12,0,0,0,0,0,0,0,0,2,2,0,0,0,0,1,0
7442,797138,4,0,0,0,0,0,0,0,0,0,0,0,1,0,1,0,0
7442,785264,8,1,1,1,1,0,0,0,0,1,2,0,4,0,2,0,2
7442,797134,0,0,0,0,0,0,0,0,0,0,0,0,0,0,0,0,0
7443,785916,18,3,5,3,3,0,2,0,0,1,2,0,3,1,2,0,6
7443,780105,35,5,13,5,8,0,5,0,0,4,2,3,3,1,2,1,10
7443,785637,33,2,9,0,1,2,8,2,2,0,0,3,0,1,1,0,8
7443,785915,33,2,9,0,0,2,9,0,0,0,5,1,3,1,0,0,6
7443,781131,33,8,16,8,13,0,3,5,6,1,5,5,4,1,2,0,21
7443,791408,15,5,6,5,6,0,0,5,7,1,2,0,0,0,0,0,15
7443,785894,32,4,9,0,0,4,9,3,4,1,2,0,5,1,1,0,15
7443,785914,1,0,0,0,0,0,0,0,0,0,0,0,0,0,0,0,0
7444,791949,37,13,26,11,19,2,7,2,3,3,12,1,4,1,3,1,30
7444,776014,22,0,5,0,4,0,1,0,0,1,1,0,0,0,1,0,0
7444,785304,27,2,5,0,1,2,4,0,0,0,0,3,4,1,0,1,6
7444,780747,35,3,10,2,5,1,5,2,3,1,3,12,4,4,3,1,9
7444,776363,33,4,8,0,1,4,7,2,2,3,3,1,3,0,1,0,14
7444,797690,21,0,2,0,2,0,0,5,8,1,2,2,2,1,0,0,5
7444,797691,10,1,2,1,2,0,0,0,0,0,0,0,1,0,1,0,2
7444,791948,4,0,0,0,0,0,0,1,2,1,0,0,0,0,0,0,1
7444,797689,11,2,4,1,1,1,3,0,0,0,2,0,0,0,0,0,5
7445,796812,23,2,4,2,4,0,0,0,0,3,5,2,2,0,2,1,4
7445,780952,32,4,9,3,7,1,2,3,4,2,8,4,3,1,2,5,12
7445,796814,24,2,7,1,1,1,6,0,0,1,3,3,4,0,1,0,5
7445,791156,20,1,6,0,3,1,3,0,1,0,1,2,2,1,1,0,3
7445,786609,29,6,11,6,9,0,2,3,5,2,7,2,2,1,3,1,15
7445,791154,10,3,4,2,2,1,2,0,0,0,0,1,0,0,0,1,7
7445,796810,35,7,14,2,7,5,7,5,6,0,4,7,3,2,1,0,24
7445,780950,27,3,8,1,4,2,4,2,2,2,0,0,1,0,1,0,10
7446,785631,27,3,6,2,4,1,2,2,2,2,1,0,0,1,1,2,9
7446,786248,19,5,7,5,7,0,0,2,2,0,4,0,5,0,3,1,12
7446,785630,27,1,5,1,2,0,3,0,0,0,0,0,3,1,0,0,2
7446,785632,34,4,5,4,5,0,0,2,2,2,4,1,3,1,0,0,10
7446,780777,27,2,13,1,11,1,2,0,0,0,1,6,3,1,3,0,5
7446,791200,28,3,8,2,6,1,2,2,3,1,0,0,2,1,0,0,9
7446,791199,16,2,2,2,2,0,0,1,2,0,4,0,3,1,0,0,5
7446,791198,13,0,2,0,0,0,2,0,0,0,0,0,1,0,0,0,0
7446,791196,3,0,1,0,0,0,1,0,0,0,0,0,0,0,0,0,0
7446,796898,2,1,2,1,2,0,0,0,0,0,1,0,2,0,0,0,2
7446,791197,2,0,0,0,0,0,0,0,0,0,0,0,0,0,0,0,0
7446,781129,2,0,1,0,0,0,1,0,0,0,0,0,0,0,0,0,0
7447,775897,30,8,10,8,9,0,1,4,5,1,4,0,4,1,1,0,20
7447,780324,30,5,10,5,10,0,0,0,2,4,6,4,0,0,3,0,10
7447,791543,22,2,4,1,1,1,3,1,2,0,2,3,3,1,1,1,6
7447,786530,30,3,5,2,3,1,2,4,4,0,2,1,2,1,1,0,11
7447,780317,25,3,5,2,3,1,2,0,1,1,0,1,2,1,1,0,7
7447,791545,19,4,6,4,6,0,0,1,1,0,3,2,2,0,2,0,9
7447,784246,22,2,3,1,1,1,2,4,6,0,3,2,1,0,1,0,9
7447,791546,9,2,3,1,2,1,1,0,0,0,1,1,2,0,0,0,5
7447,797091,6,0,0,0,0,0,0,2,4,1,1,0,0,0,0,0,2
7447,791547,2,1,1,1,1,0,0,0,0,0,0,0,0,0,0,0,2
7447,797092,2,0,0,0,0,0,0,0,0,0,0,0,0,0,0,0,0
7447,786360,2,0,0,0,0,0,0,0,0,0,0,0,0,0,0,0,0
7447,775437,1,0,0,0,0,0,0,0,0,0,0,0,0,0,0,0,0
7448,797222,31,5,8,5,8,0,0,8,11,5,6,0,1,0,0,2,18
7448,781526,23,3,7,2,4,1,3,2,4,2,1,3,2,0,4,4,9
7448,797217,33,3,8,2,7,1,1,2,2,1,4,4,1,1,2,1,9
7448,797218,30,5,12,0,4,5,8,2,2,0,0,3,2,4,0,1,17
7448,775697,26,3,8,1,2,2,6,1,2,0,0,1,4,1,2,0,9
7448,797223,4,0,0,0,0,0,0,0,0,0,0,0,0,0,1,0,0
7448,791454,26,5,12,4,8,1,4,1,2,3,2,4,3,2,3,1,12
7448,791846,18,2,5,2,5,0,0,1,2,1,6,0,2,0,1,0,5
7448,791453,9,1,3,0,1,1,2,0,0,0,1,0,0,0,0,1,3
7449,796699,28,8,11,3,5,5,6,3,3,4,5,1,3,1,1,2,24
7449,790983,26,3,8,2,4,1,4,0,0,2,2,1,3,0,2,2,7
7449,790978,23,2,7,2,5,0,2,0,0,2,2,0,1,2,0,0,4
7449,790979,31,8,13,7,8,1,5,6,7,0,5,0,2,0,5,0,23
7449,796697,36,6,23,4,15,2,8,0,0,2,4,8,2,0,6,1,14
7449,796701,10,0,0,0,0,0,0,0,0,2,0,0,5,1,1,0,0
7449,796698,8,1,1,1,1,0,0,0,0,2,0,1,1,0,0,1,2
7449,788820,22,2,7,0,2,2,5,0,0,1,1,1,1,1,0,0,6
7449,790976,10,0,2,0,2,0,0,0,0,1,0,0,2,0,0,1,0
7449,790980,6,0,1,0,1,0,0,0,0,1,3,0,0,0,1,1,0
7450,775820,26,2,6,1,2,1,4,0,1,0,4,2,2,0,0,3,5
7450,775538,12,1,1,1,1,0,0,0,0,0,2,0,1,1,0,0,2
7450,791110,30,2,5,1,3,1,2,6,8,1,1,1,2,0,3,1,11
7450,785603,31,5,12,1,3,4,9,2,2,0,3,4,3,0,1,0,16
7450,776425,27,1,8,0,4,1,4,0,0,0,5,1,0,5,0,1,3
7450,796763,5,0,2,0,1,0,1,0,0,1,0,0,2,0,1,0,0
7450,791107,15,4,7,3,5,1,2,1,2,0,3,0,5,0,0,0,10
7450,791106,20,3,3,1,1,2,2,0,0,2,4,0,1,3,1,0,8
7450,780801,2,1,3,1,3,0,0,0,0,1,0,0,0,0,0,0,2
7450,791108,2,0,0,0,0,0,0,0,0,0,0,0,1,0,0,0,0
7450,796762,11,1,1,0,0,1,1,2,3,0,3,2,0,1,1,0,5
7450,786494,19,3,7,2,4,1,3,2,2,0,3,1,0,1,0,0,9
7451,785523,14,1,4,1,4,0,0,0,0,1,1,2,2,0,2,0,2
7451,791250,24,1,6,0,2,1,4,0,0,0,6,0,2,0,2,1,3
7451,796947,25,4,7,3,5,1,2,3,5,1,3,1,1,2,1,0,12
7451,791249,27,2,8,0,3,2,5,0,0,2,3,1,2,0,6,0,6
7451,775358,33,4,12,2,6,2,6,2,4,0,4,3,1,0,3,1,12
7451,796949,13,3,4,3,4,0,0,3,4,1,3,0,0,0,0,1,9
7451,785522,13,0,0,0,0,0,0,0,0,0,1,0,3,0,0,0,0
7451,781247,19,0,1,0,0,0,1,0,0,0,4,1,2,0,1,0,0
7451,796948,3,0,0,0,0,0,0,2,2,0,1,1,0,0,0,0,2
7451,796946,3,0,0,0,0,0,0,0,0,0,0,0,1,0,0,0,0
7451,796945,2,0,1,0,0,0,1,0,0,0,0,0,0,0,0,0,0
7451,796944,20,2,7,1,6,1,1,2,2,2,4,0,3,0,1,1,7
7451,791247,4,0,1,0,1,0,0,0,0,0,0,0,0,0,1,0,0
7452,786765,30,1,3,1,2,0,1,12,14,2,3,4,3,0,1,0,14
7452,792379,31,8,13,2,2,6,11,0,0,0,8,1,1,0,0,1,22
7452,792380,31,5,11,0,0,5,11,2,2,0,2,4,0,1,0,0,17
7452,781672,18,3,6,3,6,0,0,0,0,3,7,3,2,0,3,1,6
7452,781669,29,3,11,1,4,2,7,0,1,1,5,4,1,1,2,0,8
7452,797857,2,0,1,0,1,0,0,0,0,2,0,0,2,0,1,0,0
7452,781668,3,0,3,0,2,0,1,0,0,0,1,0,1,0,0,0,0
7452,797860,8,0,0,0,0,0,0,0,0,0,1,1,1,2,1,0,0
7452,797854,9,1,3,1,1,0,2,0,0,0,3,0,0,0,0,0,2
7452,797853,8,1,3,1,2,0,1,0,0,0,0,0,1,0,1,0,2
7452,797852,27,5,10,3,5,2,5,2,2,1,4,4,2,1,2,0,14
7452,781671,4,0,0,0,0,0,0,0,0,0,0,0,0,0,1,0,0
7453,786136,12,2,7,1,3,1,4,2,4,1,3,1,4,0,2,1,7
7453,775747,18,3,3,2,2,1,1,1,2,0,2,2,3,0,2,0,8
7453,797357,27,5,8,4,5,1,3,0,0,1,6,2,2,1,2,0,11
7453,797359,30,2,10,2,4,0,6,0,0,2,1,3,2,1,0,0,4
7453,776236,31,3,11,2,6,1,5,1,3,2,2,1,0,1,0,0,8
7453,791802,5,1,2,1,2,0,0,0,0,0,0,0,0,0,1,0,2
7453,797362,7,0,2,0,0,0,2,0,0,0,0,0,0,0,0,0,0
7453,786140,5,0,0,0,0,0,0,0,0,1,2,0,2,0,1,1,0
7453,786578,13,2,6,2,3,0,3,2,2,0,5,0,0,0,0,0,6
7453,797358,26,2,11,0,5,2,6,2,3,0,4,1,1,3,0,0,8
7453,791365,15,0,3,0,0,0,3,0,0,0,0,1,0,0,0,0,0
7453,775195,11,1,5,1,3,0,2,0,0,0,0,0,1,0,1,0,2
7454,786857,31,4,7,2,4,2,3,7,7,1,5,2,4,1,2,2,17
7454,781403,37,4,6,1,1,3,5,2,2,2,5,4,3,4,4,0,13
7454,792654,29,4,5,4,5,0,0,4,6,3,6,0,4,0,2,2,12
7454,797301,34,4,8,3,5,1,3,0,0,0,6,4,1,1,1,0,9
7454,781400,37,6,14,3,6,3,8,2,3,2,5,6,2,2,9,0,17
7454,797302,6,0,1,0,0,0,1,0,0,0,0,0,0,0,0,1,0
7454,792653,8,0,2,0,2,0,0,0,0,0,1,0,1,0,0,0,0
7454,780524,18,2,3,0,1,2,2,4,4,1,1,0,0,1,2,0,10
7454,797306,0,0,0,0,0,0,0,0,0,0,0,0,0,0,1,0,0
7455,785498,26,5,8,5,8,0,0,2,2,1,2,2,2,1,2,0,12
7455,776469,17,2,8,2,8,0,0,0,0,1,2,0,2,1,1,1,4
7455,781169,34,5,12,3,7,2,5,0,0,0,5,1,3,1,1,1,12
7455,780701,35,1,2,1,2,0,0,0,0,0,1,11,3,2,5,0,2
7455,776322,27,2,7,0,1,2,6,1,1,0,1,1,4,2,0,0,7
7455,780704,18,3,4,0,0,3,4,0,0,0,1,3,3,0,0,0,9
7455,796705,23,4,13,3,7,1,6,3,4,2,0,0,1,2,2,0,12
7455,796708,14,1,5,0,2,1,3,2,2,1,0,0,2,3,2,0,5
7455,791036,4,0,0,0,0,0,0,0,0,0,0,1,1,0,0,0,0
7455,796706,2,0,0,0,0,0,0,0,0,0,0,0,0,0,0,0,0
7456,781612,21,4,6,2,2,2,4,0,1,0,2,0,3,0,1,1,10
7456,786459,31,5,10,5,10,0,0,3,3,3,5,2,4,1,2,0,13
7456,781609,37,7,14,6,11,1,3,5,6,0,11,1,2,2,1,0,20
7456,797004,21,0,1,0,0,0,1,6,6,0,1,6,5,0,2,0,6
7456,791360,30,4,5,2,2,2,3,3,4,1,2,1,1,1,1,0,13
7456,797005,25,3,5,0,2,3,3,0,0,0,2,0,2,1,2,0,9
7456,797008,5,0,0,0,0,0,0,0,0,0,1,0,0,0,0,0,0
7456,797006,19,2,4,2,2,0,2,2,2,0,0,2,1,0,1,0,6
7456,797003,11,2,2,1,1,1,1,0,0,0,0,1,3,1,3,0,5
7457,780282,27,5,12,5,12,0,0,2,3,5,1,1,2,0,1,0,12
7457,780277,31,6,11,5,7,1,4,3,5,3,4,0,2,1,1,0,16
7457,785327,28,1,6,0,3,1,3,3,4,2,1,0,2,2,1,0,6
7457,785326,18,1,3,1,3,0,0,2,2,0,0,1,4,0,2,0,4
7457,780280,33,5,11,4,9,1,2,5,6,1,1,1,3,0,2,0,16
7457,785329,15,1,2,1,2,0,0,0,0,0,1,0,1,0,0,0,2
7457,796662,6,1,1,0,0,1,1,0,0,0,0,0,1,0,0,0,3
7457,791003,15,0,4,0,3,0,1,0,0,0,7,0,3,2,2,0,0
7457,791002,13,0,2,0,0,0,2,4,4,0,0,1,3,1,2,0,4
7457,785330,14,0,3,0,1,0,2,2,2,0,1,0,1,1,0,0,2
7458,781616,31,7,12,5,6,2,6,6,8,0,1,2,2,2,1,1,22
7458,786752,33,7,12,6,9,1,3,6,10,3,9,3,1,0,1,2,21
7458,776350,25,4,6,3,5,1,1,4,4,0,2,4,4,1,0,0,13
7458,781384,34,3,7,2,5,1,2,3,4,1,1,1,3,0,0,1,10
7458,792329,29,1,2,1,1,0,1,1,2,0,6,2,4,0,0,0,3
7458,781615,22,4,5,2,2,2,3,0,0,0,3,2,2,1,1,0,10
7458,781075,5,2,3,2,3,0,0,0,0,0,0,0,0,0,1,0,4
7458,786749,14,1,2,0,0,1,2,0,0,1,2,3,0,0,1,1,3
7458,785435,7,0,1,0,0,0,1,0,0,0,0,0,1,0,0,0,0
7459,780049,22,6,9,6,9,0,0,4,4,2,3,1,2,0,0,3,16
7459,797784,36,6,15,5,11,1,4,1,1,0,2,6,3,0,1,0,14
7459,792171,34,5,8,3,6,2,2,1,1,1,7,2,3,0,2,0,13
7459,789059,30,3,9,1,3,2,6,0,0,1,3,0,2,0,2,0,8
7459,780980,16,0,2,0,1,0,1,0,0,0,1,3,2,0,0,0,0
7459,780527,24,5,9,4,5,1,4,4,4,2,1,1,1,1,0,2,15
7459,785674,21,3,9,1,4,2,5,4,4,0,2,1,3,1,0,0,12
7459,797782,9,0,2,0,2,0,0,0,0,1,1,0,2,0,0,0,0
7459,792173,5,0,1,0,0,0,1,0,0,0,0,1,0,0,0,0,0
7459,797783,3,0,0,0,0,0,0,0,0,0,0,0,2,0,0,0,0
7460,792181,35,3,8,3,8,0,0,6,9,1,8,1,3,3,2,4,12
7460,780986,37,3,7,3,7,0,0,7,8,0,4,3,4,0,2,0,13
7460,785902,31,5,10,3,7,2,3,2,2,2,6,2,4,2,2,2,14
7460,792179,36,7,13,5,9,2,4,0,0,1,5,2,1,3,4,0,16
7460,786662,37,5,10,4,7,1,3,2,2,0,2,4,1,1,2,0,13
7460,797796,15,3,6,3,6,0,0,0,0,1,2,0,0,1,0,0,6
7460,786661,6,0,0,0,0,0,0,1,2,0,2,0,2,0,3,0,1
7460,792176,2,0,0,0,0,0,0,0,0,0,0,0,1,0,0,0,0
7460,792177,1,0,0,0,0,0,0,0,0,0,0,0,0,0,0,0,0
7461,790774,12,1,3,0,0,1,3,0,0,0,0,0,1,0,1,0,3
7461,790771,34,4,14,3,12,1,2,0,0,3,9,1,5,1,1,1,9
7461,780271,39,3,7,1,3,2,4,4,4,5,5,4,4,2,1,1,12
7461,790772,35,6,13,6,7,0,6,0,0,0,0,1,1,2,3,1,12
7461,780375,32,5,13,1,1,4,12,0,0,0,1,3,3,0,1,1,14
7461,796328,20,3,6,3,6,0,0,4,5,1,3,0,1,1,3,0,10
7461,780022,27,1,7,0,3,1,4,4,4,0,3,4,3,2,4,0,7
7461,792438,1,0,0,0,0,0,0,0,0,0,0,1,0,0,0,0,0
7462,798342,44,3,13,1,7,2,6,2,4,5,7,1,3,1,3,2,10
7462,791465,24,4,7,4,7,0,0,2,2,2,5,2,4,0,0,1,10
7462,791464,31,0,6,0,3,0,3,0,0,1,6,1,4,0,2,0,0
7462,786304,35,4,11,2,5,2,6,0,0,1,3,3,1,1,1,1,10
7462,780197,52,10,22,9,16,1,6,12,12,0,5,3,3,5,4,0,33
7462,786303,11,0,1,0,1,0,0,1,4,0,1,0,1,0,0,1,1
7462,780200,20,0,0,0,0,0,0,0,0,3,3,2,5,0,1,0,0
7462,780616,11,3,6,2,4,1,2,0,0,1,0,0,1,0,0,0,7
7462,780196,46,11,19,10,15,1,4,3,3,1,7,2,3,0,3,0,26
7462,798343,1,0,0,0,0,0,0,0,0,0,0,0,0,0,0,0,0
7463,791548,51,13,30,12,22,1,8,3,5,7,15,2,4,0,3,2,30
7463,791550,42,4,10,4,10,0,0,4,10,6,6,5,3,1,3,1,12
7463,786368,30,4,9,3,6,1,3,1,2,0,1,1,2,0,1,0,10
7463,786364,49,4,16,3,9,1,7,3,5,2,8,2,2,3,1,0,12
7463,780330,42,3,6,3,5,0,1,1,1,3,0,0,2,4,2,1,7
7463,797082,7,1,2,1,2,0,0,0,0,0,1,0,3,0,1,1,2
7463,780332,11,2,2,2,2,0,0,2,2,0,1,0,2,0,2,0,6
7463,797080,11,0,1,0,0,0,1,2,2,0,2,0,0,1,0,0,2
7463,780329,32,5,9,4,5,1,4,2,2,0,2,0,2,0,0,0,13
7464,797241,21,7,9,7,9,0,0,1,1,2,3,0,4,1,1,0,15
7464,791366,17,5,8,4,6,1,2,2,2,1,3,2,3,0,2,1,13
7464,797244,18,0,2,0,1,0,1,0,0,0,3,2,4,1,2,0,0
7464,785742,36,3,7,1,3,2,4,0,1,0,2,4,2,1,2,0,8
7464,780163,39,6,14,5,7,1,7,7,8,1,4,7,2,3,2,1,20
7464,791361,23,6,11,4,5,2,6,2,2,3,5,1,0,2,1,0,16
7464,780170,19,4,8,4,8,0,0,0,0,1,1,0,1,0,0,0,8
7464,797243,18,4,7,3,5,1,2,0,0,1,3,1,0,0,0,0,9
7464,786340,9,1,3,1,1,0,2,2,2,0,1,1,2,0,0,0,4
7465,791344,22,3,6,1,3,2,3,0,0,2,2,2,3,1,2,0,8
7465,781425,33,3,5,3,5,0,0,0,0,1,7,0,3,0,2,0,6
7465,791343,34,3,8,2,2,1,6,0,3,0,1,8,5,1,7,0,7
7465,781602,35,8,15,3,4,5,11,5,6,0,3,4,2,0,1,0,26
7465,775746,32,10,17,5,8,5,9,3,3,2,5,1,2,4,1,0,28
7465,781601,7,1,1,1,1,0,0,0,0,1,0,0,1,0,0,1,2
7465,797001,14,1,2,0,0,1,2,0,0,0,4,2,0,0,3,0,3
7465,797000,10,2,4,0,0,2,4,0,0,0,2,0,0,0,0,0,6
7465,786611,13,1,5,0,1,1,4,0,0,0,1,2,2,0,0,1,3
7466,796469,30,4,8,1,5,3,3,2,2,0,6,0,2,2,4,0,13
7466,779981,28,4,5,4,5,0,0,3,4,3,5,2,3,0,1,1,11
7466,785463,32,2,8,2,5,0,3,1,2,1,1,5,1,0,1,0,5
7466,779978,35,6,8,4,5,2,3,1,3,1,3,4,2,1,3,0,15
7466,776003,27,9,16,9,12,0,4,1,2,0,4,1,4,0,1,0,19
7466,785466,9,0,2,0,0,0,2,0,0,2,1,1,0,0,1,1,0
7466,790923,27,3,7,2,3,1,4,0,0,0,0,1,1,1,0,1,7
7466,785467,2,0,0,0,0,0,0,0,0,0,1,0,0,0,0,0,0
7466,779979,10,0,3,0,1,0,2,0,0,1,1,1,1,2,0,1,0
7467,780874,12,1,4,0,2,1,2,0,0,0,0,0,1,0,1,0,3
7467,781326,22,1,3,1,3,0,0,1,2,0,3,0,3,2,3,1,3
7467,797870,34,4,13,4,8,0,5,2,2,0,3,2,0,1,2,1,10
7467,792210,26,2,6,1,2,1,4,3,3,0,3,1,1,1,1,0,8
7467,781323,37,5,16,2,10,3,6,2,4,2,5,1,0,0,2,0,15
7467,785638,6,0,0,0,0,0,0,0,0,1,0,0,0,1,1,0,0
7467,797868,26,3,6,1,2,2,4,0,0,0,2,0,1,0,1,0,8
7467,785430,18,2,3,2,3,0,0,0,0,3,2,0,4,0,1,0,4
7467,792215,19,1,1,1,1,0,0,2,2,0,2,2,3,0,2,0,4
7468,781558,23,1,4,1,3,0,1,7,8,3,5,0,2,0,1,1,9
7468,780993,19,5,8,5,8,0,0,2,3,3,3,2,2,0,0,2,12
7468,775248,29,3,15,0,7,3,8,2,2,2,6,4,3,0,3,0,11
7468,797225,24,6,8,5,6,1,2,0,1,1,2,5,3,2,1,1,13
7468,791452,35,3,6,0,0,3,6,2,2,0,1,6,2,2,0,0,11
7468,797230,16,3,4,3,4,0,0,0,0,0,2,0,1,0,0,0,6
7468,791446,5,1,2,0,0,1,2,0,0,0,0,0,1,0,0,0,3
7468,797226,12,1,3,1,2,0,1,0,0,1,3,0,3,0,2,0,2
7468,797231,12,0,4,0,1,0,3,0,0,0,2,2,1,0,0,0,0
7468,797229,2,0,0,0,0,0,0,2,2,0,1,0,0,0,1,0,2
7468,791449,23,3,7,0,4,3,3,2,2,1,0,1,1,2,2,0,11
7469,791903,25,1,8,1,5,0,3,2,4,5,4,1,1,1,0,0,4
7469,797575,18,4,4,4,4,0,0,0,0,1,2,0,1,0,1,2,8
7469,791899,29,5,17,4,15,1,2,2,4,4,4,0,2,2,0,0,13
7469,786512,30,5,13,2,6,3,7,0,1,0,2,2,4,1,3,1,13
7469,786032,29,3,10,2,9,1,1,0,0,2,3,6,2,1,1,0,7
7469,797573,20,1,5,1,5,0,0,2,5,4,3,1,2,0,1,2,4
7469,791900,2,0,0,0,0,0,0,0,0,0,0,0,1,0,0,1,0
7469,786513,9,0,2,0,1,0,1,0,2,0,1,0,1,0,4,0,0
7469,797571,12,0,1,0,1,0,0,0,0,0,1,0,2,0,1,0,0
7469,786435,26,3,7,2,5,1,2,2,3,0,3,0,1,0,3,0,9
7470,791652,21,4,10,4,9,0,1,3,4,0,1,1,0,0,0,0,11
7470,776384,26,3,6,1,1,2,5,2,2,0,3,3,3,0,2,0,10
7470,791650,23,2,9,2,7,0,2,1,2,0,4,1,2,2,1,0,5
7470,786495,19,2,4,1,3,1,1,0,1,1,4,2,1,2,5,0,5
7470,797285,13,0,2,0,1,0,1,0,0,0,0,0,1,1,1,0,0
7470,797286,20,3,6,3,4,0,2,4,4,0,0,1,2,0,0,0,10
7470,797284,10,2,5,1,1,1,4,2,2,1,1,1,0,1,0,0,7
7470,791654,8,3,3,3,3,0,0,0,0,0,1,0,2,0,1,0,6
7470,775705,18,2,2,2,2,0,0,1,3,1,0,0,1,0,0,0,5
7470,791653,16,1,2,1,2,0,0,3,4,4,2,0,1,0,3,0,5
7470,797289,11,1,1,1,1,0,0,3,4,0,1,0,1,1,1,0,5
7470,797283,12,0,0,0,0,0,0,0,0,0,0,0,1,0,0,0,0
7470,797288,3,0,0,0,0,0,0,0,0,0,0,1,0,0,0,0,0
7471,781244,21,7,9,5,6,2,3,0,0,0,3,0,4,0,1,1,16
7471,785537,27,6,12,4,8,2,4,1,1,0,2,2,2,0,1,0,15
7471,781243,33,4,10,2,3,2,7,2,2,6,7,3,3,1,1,0,12
7471,791243,26,2,4,1,3,1,1,6,6,0,2,3,1,1,3,0,11
7471,791241,16,2,5,2,4,0,1,0,0,0,0,3,3,0,0,0,4
7471,791245,29,3,7,1,3,2,4,2,2,2,8,2,2,3,2,0,10
7471,785529,15,3,6,1,3,2,3,1,2,0,0,2,1,0,1,0,9
7471,791246,12,2,2,0,0,2,2,0,0,0,1,1,4,1,2,0,6
7471,781237,12,1,3,1,1,0,2,0,0,0,0,1,0,0,0,0,2
7471,785528,4,0,0,0,0,0,0,0,0,0,0,0,0,0,1,0,0
7471,796940,3,0,0,0,0,0,0,0,0,0,0,1,0,0,0,0,0
7471,785535,2,0,0,0,0,0,0,0,2,0,1,0,1,0,0,0,0
7472,792473,20,5,7,5,6,0,1,3,4,1,1,1,5,2,0,1,13
7472,780036,23,3,7,2,4,1,3,2,4,0,1,1,4,0,1,0,9
7472,785249,38,3,9,2,5,1,4,1,1,0,1,3,2,1,2,1,8
7472,780043,34,1,3,1,2,0,1,6,8,1,5,1,1,2,1,1,8
7472,780035,31,3,8,3,6,0,2,2,2,1,5,0,2,0,4,0,8
7472,792478,17,3,5,1,2,2,3,0,0,1,1,1,2,0,1,1,8
7472,792474,10,2,3,1,1,1,2,0,0,0,2,0,0,0,0,0,5
7472,785251,20,1,3,0,1,1,2,0,0,0,1,1,4,2,1,0,3
7472,799281,3,1,1,1,1,0,0,0,0,1,2,0,0,0,0,0,2
7472,799276,2,0,0,0,0,0,0,0,0,0,0,0,1,0,0,0,0
7472,792477,2,0,0,0,0,0,0,0,0,0,0,0,0,0,1,0,0
7473,791281,28,6,12,6,12,0,0,9,10,5,6,1,2,0,2,0,21
7473,792276,29,3,9,1,5,2,4,2,2,2,3,0,1,2,2,0,10
7473,786026,20,4,8,4,8,0,0,2,5,1,3,1,5,0,2,0,10
7473,791278,24,2,3,2,2,0,1,4,5,0,0,1,3,0,2,0,8
7473,785507,35,0,2,0,0,0,2,0,0,0,1,0,0,1,1,0,0
7473,796536,11,4,6,4,6,0,0,2,4,3,0,0,2,0,0,0,10
7473,796534,13,2,2,2,2,0,0,0,0,1,1,2,2,2,0,0,4
7473,775814,15,1,3,1,2,0,1,0,1,0,2,1,2,1,0,0,2
7473,785398,11,1,2,1,2,0,0,0,1,0,1,1,0,0,0,0,2
7473,785764,11,0,2,0,2,0,0,0,0,1,4,0,1,0,0,0,0
7473,796535,3,0,1,0,0,0,1,0,0,0,0,0,1,0,1,0,0
7474,780085,21,2,6,2,6,0,0,4,4,3,5,1,4,1,0,0,8
7474,774874,33,6,12,6,11,0,1,4,5,3,4,1,3,0,5,0,16
7474,796531,29,4,9,3,8,1,1,5,5,0,3,3,2,5,2,1,14
7474,785270,39,6,14,3,6,3,8,2,2,1,2,3,2,3,2,0,17
7474,775468,22,1,4,1,3,0,1,3,4,0,6,2,2,1,3,0,5
7474,796530,9,2,3,2,3,0,0,2,2,1,0,1,3,1,1,0,6
7474,790946,20,0,4,0,1,0,3,1,2,0,3,1,2,1,0,1,1
7474,786037,7,2,2,2,2,0,0,0,0,0,3,0,2,0,0,0,4
7474,780084,15,3,7,1,3,2,4,2,2,0,2,1,2,2,0,0,10
7474,776038,5,0,2,0,2,0,0,0,0,0,0,0,0,0,0,0,0
7475,791606,32,4,11,3,7,1,4,0,1,0,9,3,5,1,6,1,9
7475,786410,33,5,15,4,9,1,6,0,2,3,1,2,4,0,2,0,11
7475,775095,12,2,3,2,3,0,0,1,1,1,4,0,1,1,1,1,5
7475,791605,31,7,15,3,5,4,10,1,2,0,3,2,4,1,2,1,19
7475,786406,38,4,9,4,7,0,2,1,4,2,1,4,1,1,4,0,9
7475,797020,17,2,3,2,3,0,0,3,6,3,7,1,3,1,2,4,7
7475,792392,8,0,0,0,0,0,0,0,0,1,1,0,1,0,1,1,0
7475,797021,29,2,6,1,3,1,3,4,5,0,2,0,2,1,1,0,9
7476,792227,34,6,9,5,8,1,1,8,8,3,8,3,1,0,0,2,21
7476,781352,22,3,8,3,8,0,0,2,3,2,3,0,1,2,0,0,8
7476,792223,38,8,15,5,9,3,6,1,1,3,2,3,2,3,2,0,20
7476,785935,38,1,3,1,3,0,0,2,3,0,1,6,1,0,2,0,4
7476,786453,21,2,7,2,6,0,1,0,0,2,4,4,1,0,2,0,4
7476,797881,18,4,7,4,7,0,0,2,2,3,3,2,2,0,0,0,10
7476,781351,6,0,3,0,2,0,1,0,0,0,0,0,0,0,1,0,0
7476,797882,9,3,4,0,0,3,4,0,2,0,0,0,2,1,0,0,9
7476,792228,14,0,2,0,2,0,0,3,4,1,2,1,1,2,3,0,3
7477,787239,27,1,2,1,2,0,0,0,0,1,3,0,2,0,0,4,2
7477,789058,27,3,8,1,1,2,7,1,2,1,2,0,4,1,2,0,9
7477,797898,31,6,14,1,6,5,8,0,0,0,2,6,4,2,4,1,17
7477,792236,34,4,5,3,4,1,1,2,2,1,3,2,4,1,3,0,11
7477,792237,27,3,7,1,2,2,5,2,2,0,1,3,0,1,2,0,10
7477,797895,8,0,3,0,3,0,0,2,4,2,0,2,0,1,1,0,2
7477,792238,13,1,2,1,2,0,0,0,0,0,1,0,3,0,0,0,2
7477,785286,16,3,9,0,3,3,6,3,3,0,2,2,2,0,0,0,12
7477,792240,9,1,1,0,0,1,1,0,0,0,0,0,1,0,0,0,3
7477,792359,4,0,0,0,0,0,0,0,0,0,0,0,0,0,0,0,0
7477,785986,4,0,1,0,0,0,1,0,0,0,0,0,0,0,0,0,0
7478,791276,18,1,7,1,7,0,0,2,6,4,2,1,5,0,2,0,4
7478,796529,31,1,5,1,3,0,2,2,4,0,1,3,3,1,0,0,4
7478,791275,29,1,7,1,4,0,3,0,1,0,3,0,0,1,0,0,2
7478,785746,40,5,11,4,7,1,4,3,3,0,4,0,2,1,1,1,14
7478,785741,40,4,10,4,9,0,1,1,2,0,3,1,1,2,4,0,9
7478,785755,22,0,4,0,4,0,0,2,2,1,4,0,0,2,1,2,2
7478,796526,7,0,1,0,1,0,0,2,2,0,1,0,0,0,1,0,2
7478,796527,3,0,0,0,0,0,0,0,0,0,1,0,0,0,0,0,0
7478,785748,10,1,2,0,0,1,2,0,0,0,2,0,0,0,0,0,3
7479,780651,24,2,5,2,5,0,0,1,2,6,5,3,1,2,0,0,5
7479,791815,24,8,14,5,6,3,8,0,0,2,2,2,1,1,0,0,19
7479,791814,34,5,12,1,2,4,10,0,1,0,7,2,1,2,1,0,14
7479,786645,18,2,7,2,6,0,1,0,0,3,1,2,2,0,1,0,4
7479,780650,27,5,8,4,5,1,3,1,1,1,9,5,2,0,1,0,12
7479,791809,11,0,0,0,0,0,0,0,0,1,1,0,0,0,1,0,0
7479,797374,3,0,1,0,0,0,1,0,0,0,1,0,1,0,0,0,0
7479,791812,11,1,4,1,2,0,2,0,0,3,1,1,2,2,2,0,2
7479,781596,7,1,3,1,3,0,0,0,0,1,2,0,3,0,0,0,2
7479,797373,19,2,7,1,2,1,5,0,0,0,1,2,3,0,2,0,5
7479,797372,7,1,1,1,1,0,0,1,2,1,0,0,0,0,0,0,3
7479,791813,1,0,0,0,0,0,0,0,0,0,0,0,0,0,1,0,0
7479,786644,13,0,4,0,1,0,3,2,2,0,1,1,1,0,0,0,2
7479,789086,1,0,0,0,0,0,0,0,0,0,0,0,0,0,0,0,0
7480,786481,34,5,13,4,12,1,1,2,4,3,8,1,1,1,3,1,13
7480,797626,30,1,4,0,3,1,1,0,0,2,5,8,2,2,1,0,3
7480,797624,20,3,4,1,2,2,2,3,3,1,3,1,5,0,0,0,11
7480,786480,33,9,14,5,7,4,7,3,3,0,3,1,1,0,2,0,25
7480,781032,31,5,9,2,3,3,6,2,6,0,0,3,0,0,2,1,15
7480,797628,19,2,7,1,4,1,3,3,4,3,1,0,2,2,0,0,8
7480,791791,16,2,2,0,0,2,2,0,0,0,0,1,2,0,0,0,6
7480,785965,17,1,6,1,5,0,1,2,2,1,1,2,0,1,0,0,4
7481,792029,16,1,6,1,4,0,2,0,0,3,3,0,4,0,1,0,2
7481,761149,32,1,2,1,1,0,1,0,0,0,5,0,4,1,0,1,2
7481,792032,40,9,19,4,10,5,9,4,4,2,1,3,1,2,5,0,27
7481,792031,36,4,9,1,4,3,5,0,0,0,2,1,1,0,0,0,11
7481,780828,34,9,20,9,18,0,2,8,9,2,11,3,4,3,3,0,26
7481,797641,15,3,7,3,7,0,0,0,0,2,3,1,2,1,1,0,6
7481,797640,11,0,1,0,1,0,0,0,0,5,0,1,0,0,0,0,0
7481,797636,16,1,1,1,1,0,0,0,0,0,0,0,2,1,1,0,2
7482,796637,17,2,2,2,2,0,0,2,2,1,2,1,2,0,0,0,6
7482,792632,36,3,5,3,4,0,1,1,1,1,3,1,4,4,2,0,7
7482,792629,30,4,13,3,11,1,2,4,4,1,2,6,1,2,2,0,13
7482,792631,13,1,5,1,4,0,1,0,0,0,3,1,1,1,0,0,2
7482,780250,16,4,8,3,4,1,4,2,2,0,2,0,4,1,0,0,11
7482,796634,6,0,1,0,0,0,1,2,2,0,0,0,0,0,0,0,2
7482,796638,4,0,1,0,0,0,1,0,0,0,0,0,0,0,1,0,0
7482,796642,4,0,1,0,1,0,0,0,0,0,0,0,0,0,0,0,0
7482,792626,26,4,7,3,5,1,2,5,8,0,6,7,0,1,3,0,14
7482,781491,28,4,10,3,7,1,3,6,8,2,3,0,4,0,1,1,15
7482,792627,20,1,3,1,3,0,0,1,2,0,0,0,1,0,2,0,3
7483,799000,26,4,6,4,6,0,0,5,7,6,8,1,3,0,4,3,13
7483,785471,19,1,4,1,4,0,0,2,4,0,0,1,4,0,2,0,4
7483,780263,31,3,8,1,5,2,3,1,1,1,3,0,4,0,3,0,9
7483,786697,36,7,12,5,6,2,6,2,2,1,2,9,1,2,1,3,18
7483,775628,27,2,5,1,2,1,3,0,0,0,6,3,5,1,4,0,5
7483,792399,17,3,4,2,2,1,2,2,2,0,4,0,0,2,1,0,9
7483,775198,33,5,11,4,7,1,4,4,4,2,4,3,3,1,1,0,15
7483,792397,7,0,2,0,0,0,2,2,2,0,0,0,1,0,0,0,2
7483,780571,4,0,3,0,0,0,3,0,0,0,0,1,0,0,1,0,0
7484,797655,27,6,9,6,9,0,0,1,4,3,7,2,1,0,2,1,13
7484,797657,28,3,7,2,2,1,5,0,0,0,5,1,4,0,1,0,7
7484,792072,32,2,7,1,1,1,6,2,2,0,0,1,2,0,0,0,7
7484,792069,24,1,6,1,3,0,3,0,0,0,2,2,0,1,3,0,2
7484,785572,26,4,11,2,6,2,5,4,4,0,2,5,2,0,1,0,14
7484,786025,7,1,2,1,2,0,0,0,2,0,2,1,2,1,0,0,2
7484,784640,17,1,5,1,3,0,2,0,0,0,5,1,1,0,1,0,2
7484,797654,1,0,1,0,0,0,1,0,0,0,0,0,0,0,0,0,0
7484,797652,28,2,5,0,1,2,4,0,3,0,3,3,1,0,4,0,6
7484,797653,4,0,0,0,0,0,0,0,0,0,0,0,0,0,0,0,0
7484,774844,6,1,2,1,2,0,0,0,0,1,0,1,0,0,1,0,2
7485,785911,19,3,6,1,2,2,4,0,0,0,5,0,2,1,0,2,8
7485,797105,24,4,7,2,3,2,4,1,1,2,8,4,0,0,0,0,11
7485,797100,26,0,3,0,2,0,1,0,0,1,2,6,3,1,1,0,0
7485,791413,23,2,10,2,6,0,4,0,0,0,0,0,3,0,3,0,4
7485,791411,21,6,12,3,4,3,8,2,2,1,3,3,4,3,1,0,17
7485,797102,3,0,0,0,0,0,0,0,0,0,0,0,0,0,0,0,0
7485,797103,9,2,2,2,2,0,0,1,2,2,3,1,2,0,1,0,5
7485,797099,11,1,2,1,2,0,0,2,2,2,4,0,1,0,0,1,4
7485,791414,17,4,6,4,5,0,1,0,0,1,3,2,2,1,0,0,8
7485,797101,3,0,0,0,0,0,0,0,0,0,0,0,1,0,0,0,0
7485,797104,2,0,0,0,0,0,0,0,1,0,0,0,1,0,0,0,0
7485,785776,21,4,5,2,2,2,3,2,2,0,3,2,0,1,1,1,12
7485,781209,21,4,14,3,9,1,5,2,2,1,2,3,0,1,0,0,11
7486,791524,26,2,7,1,4,1,3,0,0,1,2,1,2,0,3,2,5
7486,797139,30,3,7,3,7,0,0,7,8,2,5,3,2,2,2,2,13
7486,775394,29,4,9,4,5,0,4,0,0,0,6,0,3,0,2,0,8
7486,791526,33,4,7,2,3,2,4,6,10,0,2,5,2,2,0,1,16
7486,780272,27,3,8,3,4,0,4,0,0,0,2,4,0,2,1,1,6
7486,786354,9,3,3,3,3,0,0,0,0,0,0,0,2,0,1,1,6
7486,791523,8,1,3,1,1,0,2,0,0,0,0,0,1,0,1,0,2
7486,780273,19,2,2,1,1,1,1,1,2,0,3,5,1,1,0,0,6
7486,775592,19,3,7,2,4,1,3,0,0,0,5,0,0,0,1,0,7
7487,785227,28,3,6,3,6,0,0,0,0,2,7,0,4,0,1,0,6
7487,786237,37,8,14,8,14,0,0,3,6,3,5,2,2,0,3,0,19
7487,786232,27,1,4,1,3,0,1,4,4,0,3,2,2,2,2,0,6
7487,780287,28,4,9,3,4,1,5,0,0,0,1,3,2,0,2,1,9
7487,776309,35,5,8,3,5,2,3,0,0,1,3,2,1,3,2,1,12
7487,798072,5,1,2,1,2,0,0,0,0,0,0,0,0,0,0,0,2
7487,792288,14,2,3,2,2,0,1,1,4,2,3,0,1,1,1,1,5
7487,798067,7,0,4,0,4,0,0,0,0,0,0,1,0,0,1,0,0
7487,792278,19,2,7,1,1,1,6,0,0,0,2,1,3,1,2,0,5
7488,786542,21,3,6,3,4,0,2,0,0,0,3,1,2,1,0,0,6
7488,786540,20,6,6,5,5,1,1,0,1,1,4,2,3,0,0,1,13
7488,792019,34,5,14,5,7,0,7,1,2,1,3,3,1,1,0,0,11
7488,792015,30,1,5,1,4,0,1,0,0,0,1,4,0,3,1,0,2
7488,775995,25,3,7,1,4,2,3,0,0,2,6,1,1,0,5,0,8
7488,797514,2,0,1,0,1,0,0,0,0,0,0,0,0,0,0,0,0
7488,785364,18,2,6,2,6,0,0,2,2,2,5,2,0,3,3,1,6
7488,781147,2,0,1,0,1,0,0,0,0,0,0,0,0,0,0,0,0
7488,797513,2,0,0,0,0,0,0,0,0,0,0,0,0,0,1,0,0
7488,792016,27,4,7,3,5,1,2,2,2,0,3,3,2,2,1,0,11
7488,791845,17,3,4,2,3,1,1,0,1,1,2,0,3,1,1,0,7
7488,797515,2,0,0,0,0,0,0,0,0,0,0,0,0,0,0,0,0
7489,780824,6,0,3,0,3,0,0,0,0,1,1,0,0,0,3,0,0
7489,791118,40,2,9,2,5,0,4,6,6,0,2,2,0,1,6,0,10
7489,785947,19,2,7,2,4,0,3,2,2,1,5,2,0,2,1,0,6
7489,785676,45,4,8,1,2,3,6,0,0,0,3,0,2,1,1,1,11
7489,774974,19,1,8,1,4,0,4,0,0,0,3,2,1,1,2,0,2
7489,796771,14,2,4,1,1,1,3,0,0,1,1,0,2,0,1,1,5
7489,791115,40,1,3,1,3,0,0,0,0,1,3,2,2,1,1,0,2
7489,796768,2,1,1,1,1,0,0,2,2,0,0,0,0,0,0,0,4
7489,794654,2,0,1,0,0,0,1,0,0,0,2,0,0,0,0,0,0
7489,791117,13,1,5,1,3,0,2,3,3,1,4,1,1,1,0,0,5
7489,780826,0,0,0,0,0,0,0,0,0,0,0,0,1,0,0,0,0
7490,792299,33,2,6,2,4,0,2,2,2,1,4,1,4,1,2,0,6
7490,786181,15,1,5,1,5,0,0,2,4,2,0,0,4,0,2,0,4
7490,792304,41,11,22,5,12,6,10,4,5,2,3,0,2,5,5,0,32
7490,792301,33,3,9,3,9,0,0,5,5,1,3,3,3,1,1,1,11
7490,786286,31,2,8,1,1,1,7,1,2,0,3,1,2,0,0,0,6
7490,792302,14,0,4,0,4,0,0,2,2,1,1,1,0,1,0,1,2
7490,798093,3,0,0,0,0,0,0,0,0,0,0,0,2,0,0,0,0
7490,786280,28,4,8,4,8,0,0,1,1,1,2,0,0,0,0,0,9
7490,786278,27,3,5,2,4,1,1,1,4,4,5,2,3,0,4,1,8
7491,774812,27,4,13,3,11,1,2,3,4,2,7,1,4,0,3,1,12
7491,791498,17,1,2,1,2,0,0,0,0,5,2,0,1,0,2,1,2
7491,797180,42,7,12,5,6,2,6,4,4,1,6,0,1,2,0,3,20
7491,791497,27,5,8,4,5,1,3,1,2,0,0,1,4,2,4,0,12
7491,781486,21,0,1,0,1,0,0,0,2,0,4,6,3,1,3,0,0
7491,791500,16,2,3,1,2,1,1,1,3,1,2,1,4,0,1,0,6
7491,791502,5,0,1,0,0,0,1,0,0,0,0,0,2,0,0,0,0
7491,786842,2,0,0,0,0,0,0,0,0,0,1,0,0,0,0,0,0
7491,780240,35,2,5,2,5,0,0,4,5,1,6,2,2,0,5,0,8
7491,776379,33,4,10,4,8,0,2,8,8,0,3,1,0,2,3,0,16
7492,785409,36,4,6,4,6,0,0,0,2,2,5,0,1,2,2,4,8
7492,785408,33,5,11,4,8,1,3,0,0,1,4,1,4,1,2,0,11
7492,785407,35,5,11,5,11,0,0,1,2,2,3,0,3,2,2,0,11
7492,796415,23,5,8,4,6,1,2,2,2,0,2,1,2,3,2,1,13
7492,780560,26,2,6,2,4,0,2,0,0,0,1,4,0,0,2,0,4
7492,780539,12,1,2,1,1,0,1,0,1,1,0,1,0,0,3,0,2
7492,796416,22,1,6,1,5,0,1,2,2,0,2,1,2,1,4,0,4
7492,790861,13,0,1,0,1,0,0,0,0,1,2,0,1,0,1,0,0
7492,796417,0,0,0,0,0,0,0,0,0,0,0,0,0,0,0,0,0
7493,790761,31,2,7,2,4,0,3,1,2,0,2,6,3,3,2,0,5
7493,796322,27,5,9,5,9,0,0,3,4,3,2,2,2,1,5,5,13
7493,796319,30,5,9,3,6,2,3,0,0,1,1,3,0,1,1,0,12
7493,796320,33,1,3,1,1,0,2,0,0,0,3,2,4,0,2,0,2
7493,779993,26,1,4,1,3,0,1,2,2,1,2,4,3,3,1,0,4
7493,790764,26,8,10,2,3,6,7,2,2,1,2,0,2,2,0,1,24
7493,796318,8,0,2,0,2,0,0,3,5,0,0,0,0,1,1,0,3
7493,796323,5,0,0,0,0,0,0,0,0,0,0,0,0,0,1,0,0
7493,796321,14,2,6,1,4,1,2,1,2,2,4,0,0,0,0,0,6
7494,791647,10,0,2,0,2,0,0,0,0,0,1,0,3,0,1,0,0
7494,791648,31,5,9,5,7,0,2,2,2,3,1,1,3,0,0,0,12
7494,786195,12,1,5,1,5,0,0,1,2,1,1,0,2,0,2,0,3
7494,791649,28,6,11,3,5,3,6,2,2,1,3,1,2,1,1,0,17
7494,797280,34,2,6,2,6,0,0,6,6,1,1,4,3,2,2,0,10
7494,797281,23,4,7,4,7,0,0,2,2,1,3,1,3,0,0,0,10
7494,785694,14,2,2,2,2,0,0,2,2,2,1,0,4,1,1,0,6
7494,797279,15,2,6,1,3,1,3,4,4,0,0,0,5,0,1,0,9
7494,786640,33,5,11,2,6,3,5,2,2,0,0,7,0,0,1,0,15
7495,783072,12,3,4,3,4,0,0,0,0,1,2,1,2,0,1,0,6
7495,774879,30,5,10,5,8,0,2,3,6,1,2,0,1,1,3,1,13
7495,791540,37,3,4,3,3,0,1,8,10,0,6,7,2,1,3,0,14
7495,787782,27,3,6,3,4,0,2,0,1,1,0,1,3,0,3,0,6
7495,776068,33,6,8,4,6,2,2,7,7,0,2,0,2,0,2,0,21
7495,797817,18,3,6,3,6,0,0,7,8,4,4,2,4,1,3,0,13
7495,781463,19,4,5,2,2,2,3,3,4,0,1,0,1,0,0,0,13
7495,792153,24,1,2,0,0,1,2,2,2,1,2,2,1,0,0,0,5
7495,781202,0,0,0,0,0,0,0,0,0,0,0,0,0,0,0,0,0
7496,796657,15,2,5,2,5,0,0,0,0,1,1,0,1,0,0,0,4
7496,796650,32,2,5,2,5,0,0,0,0,1,2,2,1,0,1,1,4
7496,791320,38,5,10,5,9,0,1,2,2,4,3,0,2,0,1,0,12
7496,785912,35,8,17,4,7,4,10,6,8,0,4,3,1,1,3,0,26
7496,781511,33,3,9,1,5,2,4,0,0,0,3,5,2,0,1,0,8
7496,796656,7,1,1,1,1,0,0,0,0,0,1,0,0,0,0,0,2
7496,796653,4,0,1,0,0,0,1,0,0,0,1,1,1,0,0,0,0
7496,796654,2,0,1,0,1,0,0,0,0,0,0,0,0,0,0,0,0
7496,791323,14,1,2,1,1,0,1,0,0,0,4,6,1,0,2,2,2
7496,791321,20,3,4,3,4,0,0,2,4,2,2,2,1,0,0,0,8
7497,786519,30,3,5,3,5,0,0,1,2,1,5,0,2,1,1,1,7
7497,791911,13,0,4,0,0,0,4,0,0,2,1,0,0,0,0,0,0
7497,797556,35,9,16,8,12,1,4,0,0,0,3,2,2,2,2,1,19
7497,791913,31,1,4,1,2,0,2,2,2,0,2,3,1,1,1,0,4
7497,786520,31,9,17,6,12,3,5,0,0,1,0,1,1,0,1,0,21
7497,797558,18,4,6,4,6,0,0,0,0,2,5,1,1,0,0,0,8
7497,797560,10,1,2,1,2,0,0,1,2,0,3,0,2,0,0,1,3
7497,797559,11,0,1,0,0,0,1,0,0,0,0,2,0,0,0,0,0
7497,797557,9,1,1,1,1,0,0,0,0,0,1,0,1,1,1,0,2
7497,797555,12,2,2,2,2,0,0,3,4,0,1,0,1,0,0,0,7
7498,785481,28,4,8,4,8,0,0,0,0,5,4,2,4,0,1,2,8
7498,780631,27,5,15,4,11,1,4,1,2,4,3,1,3,0,1,0,12
7498,797391,11,0,0,0,0,0,0,0,0,0,1,1,4,0,1,0,0
7498,786625,36,5,10,3,7,2,3,4,6,2,1,7,3,4,5,0,16
7498,780625,37,7,10,0,0,7,10,1,2,0,3,6,3,0,0,0,22
7498,797397,9,2,2,2,2,0,0,3,4,1,0,0,1,0,0,1,7
7498,797395,30,3,7,2,5,1,2,0,0,0,1,1,1,1,3,0,7
7498,797394,9,0,2,0,1,0,1,0,0,0,3,0,0,2,2,0,0
7498,786630,13,3,4,3,4,0,0,3,4,0,1,1,4,0,3,1,9
7499,797529,32,4,7,3,6,1,1,0,0,4,5,1,5,0,0,0,9
7499,797527,35,3,4,2,2,1,2,11,15,4,3,2,4,4,3,0,18
7499,791936,34,8,14,8,14,0,0,3,9,4,3,2,2,2,3,0,19
7499,797532,31,1,6,1,3,0,3,7,7,0,6,8,2,0,5,0,9
7499,785688,29,8,17,1,4,7,13,0,0,0,2,1,0,3,0,0,23
7499,791931,0,0,0,0,0,0,0,0,0,0,0,0,0,0,1,0,0
7499,797531,0,0,0,0,0,0,0,0,0,0,0,0,1,0,1,0,0
7499,791932,15,0,1,0,1,0,0,0,0,1,0,1,1,1,1,0,0
7499,791933,1,0,0,0,0,0,0,0,0,0,0,0,1,0,0,0,0
7499,791935,1,0,1,0,1,0,0,0,0,0,0,0,0,0,0,0,0
7499,785988,22,3,5,1,1,2,4,0,0,1,1,1,2,1,1,1,8
7499,797530,0,0,0,0,0,0,0,0,0,0,0,0,0,0,0,0,0
7500,797819,23,1,1,1,1,0,0,3,4,1,1,0,2,0,1,1,5
7500,792186,31,5,11,5,9,0,2,6,8,2,8,2,2,1,1,3,16
7500,797816,28,3,9,1,3,2,6,2,2,0,1,0,3,1,2,0,10
7500,792188,33,4,6,1,1,3,5,2,2,0,5,2,1,1,2,0,13
7500,792183,35,4,13,3,8,1,5,5,7,0,8,9,3,3,4,0,14
7500,797821,3,0,0,0,0,0,0,0,0,0,0,0,1,0,1,0,0
7500,781447,20,3,6,3,5,0,1,2,3,2,1,0,2,0,2,1,8
7500,781490,3,0,0,0,0,0,0,0,0,0,0,0,0,0,0,0,0
7500,792185,16,1,6,0,2,1,4,2,4,0,3,0,1,1,0,0,5
7500,786675,8,1,4,1,1,0,3,0,0,0,0,0,3,0,0,0,2
7501,791230,21,3,6,1,3,2,3,0,0,1,2,0,1,1,2,0,8
7501,785557,28,5,10,5,10,0,0,4,4,0,3,1,3,0,1,1,14
7501,791228,26,4,10,4,6,0,4,4,4,2,9,4,2,0,1,0,12
7501,796932,30,6,13,5,12,1,1,4,4,1,6,5,2,0,3,0,17
7501,785624,17,3,3,1,1,2,2,0,0,0,0,2,4,0,1,0,8
7501,796935,18,5,9,2,2,3,7,2,2,0,2,2,3,1,1,0,15
7501,796933,11,0,1,0,1,0,0,0,0,1,6,1,1,0,0,0,0
7501,791226,12,2,2,2,2,0,0,4,4,1,2,0,2,0,1,2,8
7501,791229,2,2,2,2,2,0,0,1,2,0,0,0,0,0,0,0,5
7501,791227,20,2,6,2,2,0,4,0,0,0,0,1,3,2,1,0,4
7501,781201,5,0,2,0,1,0,1,0,0,0,0,1,0,0,0,0,0
7501,781198,10,1,2,1,1,0,1,0,1,0,2,2,3,0,0,0,2
7502,782133,19,3,7,3,4,0,3,3,4,1,7,1,1,0,1,0,9
7502,785123,28,6,12,6,12,0,0,1,2,2,6,0,3,2,1,4,13
7502,790990,24,1,4,1,1,0,3,0,2,1,1,0,2,0,1,0,2
7502,789219,34,4,9,2,2,2,7,0,0,0,1,2,0,1,2,0,10
7502,785059,32,5,8,4,5,1,3,2,2,2,10,10,4,3,3,2,13
7502,790989,6,0,1,0,1,0,0,0,0,1,0,0,0,0,0,0,0
7502,785305,3,0,0,0,0,0,0,0,0,0,1,0,1,0,0,0,0
7502,796622,8,2,3,2,3,0,0,0,0,0,0,0,3,0,0,1,4
7502,796623,25,7,15,4,11,3,4,2,2,0,1,1,3,1,0,0,19
7502,790988,2,0,0,0,0,0,0,0,0,0,0,0,0,0,0,0,0
7502,785122,19,1,2,0,0,1,2,0,0,0,4,1,0,0,0,0,3
7503,797292,29,4,13,4,13,0,0,3,5,5,8,0,1,1,1,2,11
7503,780509,24,1,2,1,1,0,1,0,0,1,1,0,3,0,1,0,2
7503,797290,33,4,14,1,4,3,10,0,0,1,3,6,2,0,1,1,11
7503,797291,31,2,13,1,10,1,3,0,0,1,2,4,2,0,1,0,5
7503,786064,27,3,7,1,3,2,4,3,3,0,1,1,4,0,1,0,11
7503,791658,10,0,0,0,0,0,0,0,0,2,4,0,1,0,1,0,0
7503,785658,16,1,3,1,3,0,0,0,1,0,4,0,0,1,2,0,2
7503,791660,30,6,11,4,7,2,4,2,4,1,1,5,1,2,2,1,16
7504,791511,11,1,2,1,2,0,0,0,0,1,0,3,2,1,0,2,2
7504,778442,30,8,14,7,10,1,4,0,0,0,3,0,3,1,6,0,17
7504,797150,28,2,6,2,4,0,2,1,2,0,0,3,0,2,0,0,5
7504,780946,37,5,11,2,6,3,5,2,2,0,2,5,1,1,3,0,15
7504,786637,31,3,8,3,5,0,3,0,0,0,3,3,1,0,2,1,6
7504,797151,16,3,3,3,3,0,0,0,0,1,1,0,2,0,1,0,6
7504,791515,14,3,4,2,2,1,2,1,1,2,0,2,2,0,0,0,8
7504,797152,3,0,1,0,1,0,0,0,0,0,1,0,0,0,0,0,0
7504,791516,9,1,1,1,1,0,0,1,2,0,1,2,2,1,1,0,3
7504,791513,21,3,8,3,6,0,2,4,4,0,3,1,3,1,2,0,10
7505,792334,17,2,5,0,2,2,3,0,0,2,3,2,4,0,3,0,6
7505,786575,29,6,12,5,11,1,1,3,4,4,3,3,2,0,3,2,16
7505,799842,35,7,9,2,4,5,5,0,0,0,3,2,0,1,3,0,19
7505,792338,38,6,10,5,6,1,4,7,7,1,5,7,2,2,3,1,20
7505,781666,30,2,4,0,1,2,3,0,0,1,2,2,1,2,2,0,6
7505,798097,11,2,3,2,3,0,0,0,0,0,1,0,0,0,2,0,4
7505,792336,1,0,0,0,0,0,0,0,0,0,0,0,1,0,0,0,0
7505,785531,15,2,4,1,1,1,3,4,5,1,3,0,2,1,0,0,9
7505,798095,20,3,5,1,2,2,3,0,0,0,0,1,2,3,1,0,8
7505,798100,4,0,1,0,1,0,0,0,0,0,0,0,1,0,1,0,0
7506,792131,21,4,7,4,7,0,0,0,0,3,4,0,4,1,1,0,8
7506,786838,22,3,5,3,4,0,1,0,0,0,3,2,5,0,3,2,6
7506,797736,13,2,5,2,3,0,2,0,0,0,2,1,3,0,1,1,4
7506,792132,28,3,9,2,4,1,5,4,4,2,2,2,2,2,2,0,11
7506,792127,36,4,14,3,11,1,3,1,1,0,4,2,1,3,4,1,10
7506,792128,30,0,3,0,2,0,1,2,2,1,2,1,2,1,1,0,2
7506,799908,7,1,2,1,2,0,0,0,0,1,0,0,0,0,0,0,2
7506,797739,6,0,1,0,0,0,1,0,0,0,0,0,0,0,0,0,0
7506,792126,25,0,3,0,0,0,3,5,5,0,5,0,3,1,1,0,5
7506,791668,12,0,3,0,2,0,1,2,2,0,1,0,1,1,0,0,2
7507,791257,26,5,7,5,7,0,0,3,6,2,5,0,0,2,0,3,13
7507,791838,24,2,4,2,2,0,2,2,2,3,3,0,1,0,1,0,6
7507,786620,23,3,8,0,3,3,5,1,2,0,1,1,3,0,3,0,10
7507,781606,39,0,7,0,2,0,5,0,0,0,0,4,3,0,0,0,0
7507,781257,38,7,14,5,9,2,5,4,4,1,4,2,2,2,2,0,20
7507,796955,12,0,3,0,3,0,0,0,2,4,4,0,2,0,5,2,0
7507,791255,14,0,0,0,0,0,0,1,2,2,3,1,0,0,3,0,1
7507,780900,4,0,1,0,1,0,0,0,0,0,1,0,0,0,0,0,0
7507,781263,20,2,7,1,4,1,3,0,1,0,5,0,1,0,3,0,5
7508,791482,32,5,7,5,7,0,0,0,0,2,6,5,1,1,1,0,10
7508,786319,19,1,5,1,5,0,0,6,6,4,2,0,4,1,2,0,8
7508,786318,30,8,15,2,4,6,11,0,0,0,2,3,2,0,0,0,22
7508,784268,20,4,6,1,1,3,5,2,3,0,1,1,1,0,2,0,13
7508,780223,28,2,6,1,2,1,4,3,3,0,8,1,1,1,1,2,8
7508,797198,3,1,1,1,1,0,0,1,1,0,1,0,0,0,0,0,3
7508,791481,14,4,4,4,4,0,0,1,5,1,2,0,3,0,1,1,9
7508,780225,27,2,5,2,4,0,1,0,0,0,1,3,3,0,1,0,4
7508,797200,3,1,2,0,0,1,2,0,0,0,0,0,0,0,0,0,3
7508,797199,18,0,0,0,0,0,0,0,0,0,3,2,2,0,0,0,0
7508,797201,2,0,0,0,0,0,0,0,0,0,0,0,1,0,0,0,0
7508,796079,2,0,0,0,0,0,0,0,0,0,0,0,0,0,0,0,0
7508,786320,2,0,0,0,0,0,0,0,0,0,0,1,0,0,0,0,0
7509,791882,19,3,6,3,6,0,0,0,0,1,1,1,2,0,1,0,6
7509,786493,35,6,16,3,9,3,7,3,4,0,5,3,3,0,1,0,18
7509,786491,18,4,4,4,4,0,0,0,0,0,0,1,5,0,1,0,8
7509,791881,32,2,7,0,2,2,5,2,2,1,3,1,2,1,3,0,8
7509,786420,34,5,10,4,5,1,5,0,0,0,2,1,1,0,0,0,11
7509,797618,8,1,3,1,3,0,0,0,1,1,1,1,0,0,0,0,2
7509,797616,12,0,2,0,1,0,1,1,2,0,1,0,1,0,0,0,1
7509,797617,2,1,1,1,1,0,0,1,1,1,0,0,1,0,0,0,3
7509,797613,12,0,3,0,0,0,3,0,0,0,2,0,3,0,0,0,0
7509,786492,2,0,0,0,0,0,0,0,0,0,0,0,0,0,0,0,0
7509,781258,3,0,1,0,1,0,0,0,0,0,0,0,0,0,0,0,0
7509,781052,23,1,3,0,0,1,3,0,0,0,2,0,0,1,0,0,3
7510,780634,32,5,6,5,6,0,0,2,3,5,9,0,2,0,0,4,12
7510,791826,26,1,3,1,2,0,1,4,4,0,2,2,2,0,1,0,6
7510,786785,33,5,12,5,9,0,3,4,5,1,10,2,1,0,5,2,14
7510,786783,31,3,10,1,5,2,5,2,2,1,6,3,2,2,0,0,10
7510,780633,32,2,4,1,2,1,2,0,0,0,2,1,2,2,3,2,5
7510,797389,8,1,1,1,1,0,0,0,0,0,1,0,1,0,0,0,2
7510,786784,14,0,4,0,4,0,0,0,0,1,1,0,2,0,1,0,0
7510,776009,24,6,16,5,8,1,8,2,2,0,2,1,1,2,2,0,15
7511,786526,32,3,11,3,10,0,1,2,3,1,6,1,2,0,0,2,8
7511,786525,31,2,9,1,2,1,7,2,3,0,1,2,1,1,0,0,7
7511,786856,30,3,8,3,8,0,0,2,2,0,2,0,2,3,2,2,8
7511,786030,34,4,11,2,8,2,3,1,2,1,3,2,2,2,3,1,11
7511,781109,26,4,10,2,5,2,5,1,1,1,5,1,2,0,1,1,11
7511,791917,18,1,1,1,1,0,0,0,0,1,1,0,0,1,1,0,2
7511,786524,6,0,0,0,0,0,0,0,0,0,0,0,3,0,1,0,0
7511,791914,23,1,5,0,2,1,3,0,1,0,3,3,2,1,3,1,3
7512,786860,19,1,5,0,2,1,3,0,0,1,3,0,2,0,1,1,3
7512,786544,32,6,13,3,8,3,5,3,3,1,10,3,4,0,2,1,18
7512,797507,30,2,5,2,5,0,0,0,0,0,1,3,0,4,4,0,4
7512,792012,38,14,20,9,12,5,8,9,10,0,4,3,2,2,4,0,42
7512,786546,34,5,7,2,3,3,4,0,0,0,1,2,2,0,1,0,13
7512,786547,12,1,3,0,0,1,3,0,0,0,0,0,5,0,0,0,3
7512,797510,28,5,9,2,2,3,7,3,3,0,4,2,1,2,0,0,16
7512,792013,5,1,3,1,3,0,0,2,2,0,1,0,2,1,0,0,4
7512,797508,2,0,0,0,0,0,0,0,0,0,0,0,0,0,0,0,0
7513,792035,30,5,8,5,8,0,0,5,10,3,1,2,3,4,4,1,15
7513,780833,25,7,10,7,10,0,0,2,2,2,4,2,1,0,2,0,16
7513,792034,35,5,11,2,4,3,7,2,2,0,10,4,0,2,4,0,15
7513,792033,17,0,7,0,2,0,5,2,2,0,3,2,1,0,2,0,2
7513,780830,29,4,7,3,5,1,2,2,2,1,2,1,3,1,1,0,11
7513,797645,14,3,6,3,6,0,0,2,4,1,2,0,3,2,2,1,8
7513,785982,2,1,1,1,1,0,0,0,0,0,0,0,0,0,0,0,2
7513,797644,2,0,2,0,2,0,0,0,0,0,1,0,0,0,0,0,0
7513,791688,16,3,5,1,2,2,3,1,1,0,0,0,4,2,0,0,9
7513,785980,9,0,0,0,0,0,0,0,0,0,0,1,2,0,0,0,0
7513,785381,21,3,5,1,2,2,3,0,0,0,1,1,0,0,3,0,8
7514,796516,36,0,1,0,1,0,0,2,4,2,6,0,4,0,1,3,2
7514,792318,32,8,14,8,14,0,0,7,8,1,3,4,2,0,1,0,23
7514,786717,36,6,14,3,9,3,5,3,4,2,5,1,1,1,1,2,18
7514,780753,34,7,14,4,10,3,4,0,4,0,3,4,1,1,4,0,17
7514,775329,15,1,7,0,3,1,4,0,0,1,4,0,2,0,1,0,3
7514,796519,28,4,6,3,4,1,2,0,0,0,3,4,4,2,0,0,9
7514,796518,6,0,0,0,0,0,0,0,1,1,1,0,2,0,0,0,0
7514,796517,13,0,2,0,0,0,2,0,0,1,0,2,1,1,1,0,0
7514,792315,0,0,0,0,0,0,0,0,0,0,0,0,0,0,0,0,0
7515,791988,15,1,2,1,2,0,0,5,6,2,3,0,5,0,2,0,7
7515,792443,15,0,2,0,2,0,0,0,2,1,1,1,3,0,1,0,0
7515,796507,31,5,10,4,8,1,2,0,3,3,2,0,1,0,1,1,11
7515,791989,25,2,11,1,7,1,4,2,2,1,2,2,0,1,3,0,7
7515,791987,27,3,6,2,5,1,1,7,8,1,3,1,4,1,3,1,14
7515,780077,11,1,2,1,2,0,0,0,0,1,3,0,0,0,0,0,2
7515,796506,20,2,2,2,2,0,0,1,2,0,2,1,3,1,0,2,5
7515,796508,19,2,8,0,1,2,7,0,0,0,2,0,0,0,0,0,6
7515,796503,21,2,8,2,8,0,0,0,0,0,6,3,2,0,3,0,4
7515,785258,16,1,3,1,3,0,0,0,0,2,3,0,2,1,2,1,2
7516,786179,24,3,16,0,3,3,13,5,6,0,1,1,3,2,3,0,14
7516,780238,34,6,10,6,9,0,1,2,2,0,0,3,0,0,5,0,14
7516,791750,33,0,4,0,1,0,3,0,0,3,2,0,0,0,2,0,0
7516,786177,23,2,7,1,2,1,5,0,0,0,3,0,2,2,2,1,5
7516,780244,19,1,3,1,2,0,1,0,0,1,4,0,5,0,0,1,2
7516,790773,23,3,7,1,2,2,5,2,2,0,2,0,3,0,1,0,10
7516,785909,12,2,2,2,2,0,0,1,2,2,2,0,2,0,0,1,5
7516,797346,19,3,9,2,5,1,4,1,1,0,1,1,3,1,2,0,8
7516,791749,10,1,2,1,1,0,1,1,1,1,1,0,1,0,0,0,3
7516,791752,3,0,0,0,0,0,0,0,1,0,0,0,0,0,0,0,0
7517,796355,28,2,5,1,2,1,3,6,6,0,5,5,2,2,1,1,11
7517,790798,22,11,12,9,10,2,2,4,7,2,8,1,3,1,3,2,28
7517,785245,30,3,7,1,3,2,4,0,0,0,2,5,2,0,1,0,8
7517,780137,30,6,10,6,8,0,2,0,0,0,5,1,2,1,1,0,12
7517,780140,29,4,10,3,7,1,3,3,3,1,3,1,1,2,2,1,12
7517,775553,14,4,5,3,3,1,2,3,3,0,0,4,1,3,1,0,12
7517,790799,17,2,3,2,3,0,0,0,0,0,0,2,2,1,1,1,4
7517,796354,12,1,3,0,1,1,2,2,2,0,2,0,0,0,0,0,5
7517,799892,5,1,2,0,0,1,2,0,0,0,1,0,0,0,1,1,3
7517,796359,7,2,2,1,1,1,1,0,0,0,1,0,2,0,0,0,5
7517,790795,3,0,0,0,0,0,0,0,0,0,1,0,0,0,0,0,0
7517,788844,3,0,0,0,0,0,0,0,0,0,0,0,1,0,0,0,0
7518,791440,21,5,9,5,9,0,0,3,4,0,3,2,4,0,4,2,13
7518,797019,33,1,3,1,3,0,0,1,3,3,2,5,1,2,2,0,3
7518,797016,25,1,4,1,3,0,1,0,0,2,0,2,0,1,1,0,2
7518,781378,36,6,11,2,6,4,5,5,8,2,7,2,0,1,2,1,21
7518,775267,27,5,12,2,7,3,5,1,2,1,6,1,1,0,2,0,14
7518,781629,8,1,3,1,3,0,0,0,0,3,1,0,0,0,0,0,2
7518,775739,7,0,0,0,0,0,0,0,0,0,0,1,5,0,0,0,0
7518,797015,8,0,2,0,1,0,1,0,0,0,1,1,0,1,0,0,0
7518,791441,19,5,9,4,8,1,1,5,6,0,1,0,4,2,4,0,16
7518,774959,16,4,7,3,6,1,1,0,0,0,2,0,1,0,1,0,9
7519,780201,26,3,4,3,4,0,0,5,5,4,2,0,4,3,3,1,11
7519,797210,25,4,10,3,7,1,3,5,6,1,0,2,3,1,3,0,14
7519,791467,30,6,14,3,6,3,8,2,2,1,5,0,4,3,1,0,17
7519,786311,37,4,11,1,5,3,6,2,2,2,1,2,2,2,5,0,13
7519,775516,31,3,8,2,6,1,2,1,1,2,1,6,4,1,2,0,8
7519,798344,19,2,6,2,4,0,2,4,4,0,5,0,1,0,1,1,8
7519,791470,3,0,1,0,1,0,0,0,0,0,1,0,0,0,0,1,0
7519,791469,25,1,6,1,6,0,0,0,0,2,6,0,2,0,0,4,2
7519,791471,4,1,2,1,2,0,0,0,0,1,0,0,0,1,0,0,2
7520,790870,34,9,11,9,11,0,0,2,3,1,4,4,0,1,1,1,20
7520,790869,36,2,4,2,3,0,1,0,0,0,3,7,2,3,5,1,4
7520,780116,20,1,3,1,2,0,1,0,0,0,4,0,2,1,2,0,2
7520,796421,34,3,5,0,2,3,3,0,0,0,5,6,3,1,2,0,9
7520,783997,11,0,1,0,0,0,1,0,0,0,0,0,2,0,0,0,0
7520,796426,4,0,2,0,2,0,0,0,0,1,2,0,1,0,1,0,0
7520,796425,3,2,5,2,5,0,0,0,0,4,0,0,2,0,0,0,4
7520,780493,19,4,8,0,0,4,8,0,0,0,2,1,0,1,1,3,12
7520,796427,7,1,3,1,3,0,0,0,0,1,1,2,1,0,1,0,2
7520,796424,3,0,0,0,0,0,0,0,0,1,0,0,0,0,0,0,0
7520,796422,3,1,2,1,2,0,0,1,1,0,0,0,0,0,0,0,3
7520,790866,26,8,10,1,1,7,9,1,1,0,0,1,1,0,0,0,24
7521,791011,30,2,6,1,3,1,3,0,0,1,6,0,2,0,1,0,5
7521,796671,27,5,9,5,9,0,0,0,0,2,1,0,0,0,2,1,10
7521,796668,24,2,10,2,6,0,4,3,3,0,0,1,2,1,2,0,7
7521,791012,29,5,8,4,4,1,4,2,3,1,0,1,2,0,2,0,13
7521,781221,33,3,8,3,6,0,2,0,0,0,3,1,1,0,2,0,6
7521,796670,12,0,1,0,1,0,0,2,2,2,3,0,3,2,1,0,2
7521,796669,3,1,1,0,0,1,1,0,0,0,0,0,1,0,0,0,3
7521,791594,20,3,4,3,4,0,0,2,2,0,1,1,1,1,1,0,8
7521,791013,19,2,5,2,5,0,0,0,0,0,1,2,1,0,3,0,4
7521,791008,3,0,0,0,0,0,0,0,0,0,0,0,0,0,0,0,0
7522,791493,34,5,9,5,9,0,0,3,6,2,3,3,3,1,2,1,13
7522,789036,38,6,9,6,8,0,1,4,5,0,3,2,2,1,1,1,16
7522,791492,31,6,11,4,5,2,6,0,0,0,3,2,3,1,2,0,14
7522,778888,39,5,16,1,6,4,10,1,2,1,2,3,1,0,1,0,15
7522,776494,40,3,9,2,5,1,4,0,0,3,5,4,4,2,0,1,7
7522,797191,1,0,0,0,0,0,0,0,0,0,0,0,0,0,1,0,0
7522,791495,11,0,1,0,0,0,1,0,0,1,0,0,2,0,1,0,0
7522,780504,6,0,0,0,0,0,0,0,0,0,0,0,0,0,0,0,0
7523,796568,32,4,5,4,5,0,0,0,0,0,2,1,3,1,1,0,8
7523,796566,17,2,2,2,2,0,0,0,0,1,5,1,5,0,3,1,4
7523,790969,16,1,1,0,0,1,1,0,0,0,0,1,0,0,3,0,3
7523,780166,35,8,14,6,9,2,5,5,6,0,4,5,3,0,2,0,23
7523,775107,34,5,11,3,8,2,3,0,2,0,5,4,1,1,2,1,12
7523,796564,5,0,1,0,1,0,0,0,0,0,1,0,1,0,0,0,0
7523,790971,22,2,4,2,4,0,0,0,0,3,4,0,1,0,0,0,4
7523,796569,3,0,1,0,1,0,0,0,0,0,0,0,0,0,0,0,0
7523,790968,21,3,4,1,1,2,3,0,0,0,2,1,2,0,1,0,8
7523,790967,15,2,6,1,2,1,4,0,0,0,0,0,0,0,0,0,5
7524,785453,36,6,19,2,7,4,12,6,8,2,5,2,2,2,1,0,22
7524,785455,8,0,1,0,0,0,1,0,0,0,3,0,0,1,3,0,0
7524,780798,35,1,5,1,4,0,1,3,4,3,6,0,2,3,1,0,5
7524,790914,18,6,7,6,7,0,0,1,4,0,0,0,3,0,0,3,13
7524,774940,22,2,7,2,6,0,1,0,0,1,1,1,5,1,4,0,4
7524,790915,15,1,3,1,3,0,0,1,2,1,0,0,2,2,3,0,3
7524,785456,7,1,1,0,0,1,1,0,0,0,0,1,1,0,0,0,3
7524,785458,29,3,6,3,5,0,1,3,3,1,4,3,5,2,3,0,9
7524,790913,18,2,4,2,4,0,0,8,8,1,0,4,2,2,4,0,12
7524,785454,10,1,3,0,2,1,1,0,0,1,0,1,3,1,0,0,3
7524,790911,2,0,1,0,1,0,0,0,0,0,0,0,0,0,0,0,0
7525,775074,33,5,9,5,9,0,0,4,6,2,3,1,4,0,2,0,14
7525,780462,34,8,13,6,8,2,5,13,16,0,7,4,3,2,7,2,31
7525,786448,21,2,5,2,3,0,2,2,2,0,3,1,5,3,2,1,6
7525,786132,16,2,3,2,3,0,0,3,3,1,2,0,1,0,0,0,7
7525,780731,36,1,8,1,7,0,1,4,6,0,4,1,1,3,4,0,6
7525,786447,24,3,3,2,2,1,1,5,8,3,1,2,0,1,1,0,12
7525,796971,10,0,1,0,1,0,0,0,0,1,0,1,2,2,2,0,0
7525,791632,9,1,1,1,1,0,0,1,1,0,1,1,2,0,1,0,3
7525,791631,17,0,1,0,0,0,1,2,2,0,2,0,3,0,0,0,2
7526,791051,27,0,4,0,4,0,0,0,0,5,10,1,2,1,2,2,0
7526,780739,24,3,7,3,7,0,0,0,0,3,2,1,0,1,0,0,6
7526,785524,25,6,12,1,4,5,8,2,2,2,2,0,4,0,1,0,19
7526,781115,30,4,7,4,7,0,0,4,4,1,2,11,0,1,2,0,12
7526,775456,26,3,7,2,4,1,3,0,0,1,2,5,1,2,1,3,7
7526,796731,15,3,6,3,6,0,0,0,0,2,2,0,0,1,0,0,6
7526,796730,7,0,4,0,0,0,4,0,0,0,1,0,0,0,2,0,0
7526,785784,9,1,1,1,1,0,0,0,0,0,2,0,1,1,0,0,2
7526,790819,22,4,10,1,2,3,8,0,0,0,2,0,0,0,0,0,11
7526,775094,12,0,5,0,2,0,3,2,2,1,0,2,1,0,0,0,2
7526,791052,3,0,0,0,0,0,0,0,0,0,0,0,0,0,0,0,0
7527,798123,22,4,9,4,7,0,2,1,4,1,1,2,1,0,3,1,9
7527,798119,24,2,4,0,0,2,4,0,0,0,1,1,1,0,1,0,6
7527,798117,27,2,6,2,6,0,0,0,0,0,1,2,1,1,2,0,4
7527,780594,23,2,3,1,1,1,2,0,0,0,5,1,0,0,2,0,5
7527,775664,22,1,5,0,1,1,4,0,2,1,2,3,0,0,0,0,3
7527,798127,12,2,4,0,0,2,4,0,0,0,2,0,0,1,0,0,6
7527,798118,3,1,1,0,0,1,1,0,0,0,1,0,0,0,0,0,3
7527,769332,13,2,4,1,1,1,3,0,0,0,0,2,0,0,0,2,5
7527,780913,11,1,3,1,2,0,1,0,0,0,1,1,2,0,2,0,2
7527,798124,25,2,7,2,6,0,1,0,0,0,4,0,0,0,2,0,4
7527,798121,18,1,2,0,0,1,2,0,0,0,3,0,1,0,1,0,3
7528,785681,37,3,4,3,4,0,0,1,2,1,11,0,2,0,2,5,7
7528,796789,6,0,4,0,2,0,2,0,0,1,0,0,0,0,0,0,0
7528,791126,22,2,6,2,5,0,1,1,3,0,2,3,4,0,2,0,5
7528,791124,25,4,6,2,2,2,4,0,0,0,2,2,1,0,3,0,10
7528,780050,35,6,10,5,6,1,4,2,2,1,7,3,1,1,2,0,15
7528,784479,9,3,4,3,4,0,0,0,0,0,2,0,0,0,0,0,6
7528,775813,8,2,4,2,4,0,0,1,2,1,1,0,3,0,1,1,5
7528,796784,25,2,5,0,1,2,4,2,2,1,0,5,2,1,1,0,8
7528,796782,33,4,9,1,3,3,6,4,5,0,1,1,3,0,2,0,15
7528,796783,0,0,0,0,0,0,0,0,0,0,0,0,0,0,0,0,0
7529,786792,34,5,8,5,8,0,0,2,4,5,2,0,2,1,0,0,12
7529,792414,38,2,7,0,1,2,6,1,2,2,5,0,4,1,0,1,7
7529,789020,40,4,12,2,5,2,7,4,4,1,4,2,1,1,3,1,14
7529,792091,32,2,6,2,3,0,3,2,2,2,3,1,3,1,1,0,6
7529,786787,38,10,24,7,14,3,10,0,0,0,4,4,3,2,3,0,23
7529,786795,8,0,1,0,0,0,1,0,0,1,0,1,2,0,1,0,0
7529,781456,10,0,2,0,2,0,0,2,2,0,0,0,0,0,1,0,2
7530,786772,16,2,5,2,5,0,0,2,3,2,2,0,4,0,0,0,6
7530,781484,27,2,3,2,2,0,1,3,3,2,5,0,5,1,1,1,7
7530,786769,37,2,10,1,8,1,2,0,0,0,4,2,0,1,0,0,5
7530,786024,28,2,8,1,4,1,4,0,0,0,4,3,5,3,2,0,5
7530,780002,37,5,13,3,9,2,4,2,4,0,5,4,2,0,3,0,14
7530,791967,23,7,15,1,6,6,9,2,3,0,1,1,0,0,1,0,22
7530,797840,14,0,3,0,2,0,1,0,1,0,2,0,0,1,0,0,0
7530,790823,13,0,0,0,0,0,0,0,0,0,1,1,1,0,0,0,0
7530,786773,5,1,1,1,1,0,0,0,0,1,0,0,1,1,2,0,2
7531,780283,25,2,7,2,7,0,0,1,6,1,3,1,4,1,3,1,5
7531,790925,33,1,1,0,0,1,1,0,3,1,9,4,2,1,2,1,3
7531,791456,39,12,23,7,11,5,12,3,4,1,6,3,1,0,2,1,32
7531,785476,27,1,5,1,5,0,0,0,0,0,0,4,5,0,2,0,2
7531,785474,30,5,9,3,7,2,2,2,2,2,4,0,3,0,3,0,14
7531,800121,11,1,1,1,1,0,0,0,3,0,2,0,0,0,0,0,2
7531,796470,11,0,0,0,0,0,0,0,0,0,2,0,0,0,1,0,0
7531,790926,7,0,2,0,0,0,2,0,0,0,1,1,1,0,1,0,0
7531,785480,17,2,3,0,0,2,3,0,0,0,2,0,1,0,0,0,6
7532,797779,39,7,13,3,5,4,8,3,4,0,5,0,2,0,0,1,21
7532,785568,33,3,8,3,7,0,1,7,9,6,7,0,3,3,3,0,13
7532,797778,21,4,8,2,3,2,5,0,0,0,6,0,3,1,1,0,10
7532,786256,27,2,3,2,3,0,0,3,5,1,4,1,3,2,5,2,7
7532,797774,30,1,7,0,0,1,7,4,6,0,1,3,2,0,2,0,7
7532,797770,13,4,7,4,6,0,1,2,3,1,2,1,1,1,0,0,10
7532,797780,1,0,0,0,0,0,0,2,2,0,0,0,0,0,1,0,2
7532,797776,7,0,1,0,1,0,0,3,4,0,1,1,1,0,0,0,3
7532,797771,5,0,0,0,0,0,0,0,0,0,0,0,1,0,0,0,0
7532,797768,13,2,3,1,1,1,2,2,2,0,2,0,1,0,1,0,7
7532,775106,10,1,2,1,2,0,0,0,0,0,0,1,1,0,3,0,2
7532,797781,0,0,0,0,0,0,0,0,0,0,0,0,0,0,0,0,0
7532,797775,1,0,0,0,0,0,0,0,0,0,0,0,0,0,0,0,0
7533,796860,26,3,6,3,6,0,0,0,0,1,2,1,5,1,2,0,6
7533,791187,30,4,7,4,7,0,0,0,0,2,4,0,4,0,2,0,8
7533,796861,25,4,10,2,5,2,5,2,2,0,5,2,2,0,0,0,12
7533,785650,28,2,4,1,2,1,2,2,4,1,2,3,4,0,0,0,7
7533,785649,33,5,14,2,8,3,6,2,2,0,5,4,3,4,2,0,15
7533,791183,10,1,2,1,2,0,0,2,2,1,0,1,3,1,1,0,4
7533,791185,11,1,3,0,0,1,3,0,0,1,2,0,1,0,1,1,3
7533,796856,16,5,13,3,7,2,6,5,5,1,1,2,3,1,1,0,17
7533,791184,19,1,2,0,0,1,2,0,0,0,2,3,1,0,4,0,3
7533,796857,2,0,0,0,0,0,0,0,0,0,0,0,0,0,0,0,0
7534,780384,16,2,6,2,6,0,0,1,2,1,3,0,3,0,2,1,5
7534,780159,14,0,2,0,2,0,0,0,0,1,0,0,1,1,0,0,0
7534,796863,32,2,10,1,7,1,3,0,0,1,2,3,0,0,1,0,5
7534,786738,26,3,11,3,11,0,0,1,2,0,3,1,1,1,3,0,7
7534,775694,25,1,7,0,5,1,2,3,4,1,4,1,4,1,2,0,6
7534,791194,32,2,8,2,8,0,0,0,0,2,5,1,1,0,3,0,4
7534,791193,24,4,5,4,5,0,0,0,0,3,8,1,3,0,1,3,8
7534,800119,18,4,10,3,7,1,3,1,2,1,3,0,1,1,1,0,10
7534,796865,9,0,1,0,0,0,1,0,0,1,1,0,2,0,0,0,0
7534,799890,4,1,2,1,2,0,0,0,0,0,0,0,0,0,0,0,2
7535,781046,36,2,8,1,3,1,5,1,2,1,10,1,3,1,1,4,6
7535,780025,23,2,8,2,8,0,0,0,1,2,4,2,4,0,0,4,4
7535,796391,34,4,8,3,4,1,4,0,0,0,1,1,0,1,1,0,9
7535,785385,35,5,12,2,5,3,7,0,0,1,1,1,2,1,5,0,13
7535,785383,35,5,13,3,7,2,6,5,6,6,7,4,4,1,6,1,17
7535,790837,20,2,5,2,3,0,2,2,2,1,2,0,0,1,0,0,6
7535,785382,3,0,1,0,1,0,0,0,1,0,0,0,0,0,0,0,0
7535,786297,7,1,3,1,3,0,0,0,0,2,2,0,0,1,0,0,2
7535,786228,7,0,2,0,2,0,0,0,0,0,1,1,0,0,1,0,0
7536,786566,40,5,12,4,8,1,4,4,4,2,3,1,4,1,4,0,15
7536,781204,23,0,2,0,1,0,1,2,6,1,6,0,4,1,1,0,2
7536,786568,5,0,4,0,4,0,0,0,0,2,2,0,1,1,2,1,0
7536,791993,37,4,9,4,6,0,3,1,3,0,2,1,3,2,1,2,9
7536,781188,37,2,9,1,6,1,3,5,6,1,4,10,3,1,3,0,10
7536,791997,30,4,9,3,5,1,4,2,2,1,10,0,3,0,2,0,11
7536,781189,28,5,6,3,4,2,2,1,2,1,5,1,4,1,2,1,13
7537,792121,30,1,4,1,1,0,3,1,2,2,3,1,2,1,1,0,3
7537,786257,32,8,13,8,12,0,1,1,2,3,4,0,4,0,3,0,17
7537,786263,21,1,6,1,2,0,4,2,3,2,4,0,3,1,2,0,4
7537,785661,35,4,7,3,4,1,3,3,6,0,5,1,4,0,1,1,12
7537,775825,34,3,13,3,9,0,4,5,5,0,5,5,2,0,2,0,11
7537,797721,10,2,3,0,0,2,3,0,0,0,0,0,1,1,1,0,6
7537,797725,8,0,0,0,0,0,0,0,0,0,0,0,1,0,0,1,0
7537,792122,20,1,5,1,1,0,4,0,0,0,5,0,2,0,3,0,2
7537,786249,10,1,4,0,2,1,2,0,0,0,0,0,1,0,0,0,3
7538,791905,29,1,7,1,2,0,5,0,1,1,4,0,2,2,0,0,2
7538,781103,30,6,10,6,9,0,1,2,4,3,6,2,1,0,1,0,14
7538,797568,32,5,14,3,8,2,6,3,3,0,2,1,2,0,3,0,15
7538,797566,34,1,8,1,5,0,3,3,4,0,4,1,2,0,2,0,5
7538,781191,29,6,13,3,7,3,6,0,0,0,3,1,0,0,1,0,15
7538,797570,1,0,1,0,1,0,0,0,0,0,0,0,0,0,0,0,0
7538,797569,10,1,2,1,2,0,0,0,0,3,0,0,0,0,2,0,2
7538,791909,1,0,0,0,0,0,0,0,0,0,0,0,0,0,0,0,0
7538,791907,5,0,0,0,0,0,0,0,0,0,0,0,0,0,0,0,0
7538,791904,6,0,1,0,1,0,0,0,0,0,1,0,0,0,0,0,0
7538,781364,15,1,4,1,3,0,1,2,2,3,1,0,0,1,0,0,4
7538,781102,7,0,2,0,2,0,0,0,0,0,2,0,0,0,2,0,0
7538,791906,1,0,0,0,0,0,0,0,0,0,0,0,0,0,0,0,0
7539,792373,25,4,7,2,4,2,3,2,2,0,4,2,4,0,2,1,12
7539,781598,13,4,7,2,2,2,5,0,0,0,2,0,0,0,0,1,10
7539,797951,27,1,3,1,1,0,2,2,2,0,3,3,2,2,1,1,4
7539,786739,22,4,6,3,4,1,2,0,0,0,3,2,0,0,2,0,9
7539,775303,30,0,0,0,0,0,0,0,0,0,6,1,2,1,0,0,0
7539,797958,19,4,7,1,2,3,5,1,2,0,2,0,2,0,0,0,12
7539,792369,2,0,0,0,0,0,0,0,0,0,0,0,0,0,0,0,0
7539,792371,1,0,0,0,0,0,0,0,0,0,0,0,0,0,1,0,0
7539,797949,2,0,0,0,0,0,0,0,0,0,0,0,0,0,0,0,0
7539,792370,28,2,7,1,3,1,4,0,0,0,6,3,3,0,3,0,5
7539,790499,14,3,5,1,3,2,2,0,0,0,0,2,1,1,1,1,8
7539,781597,1,0,0,0,0,0,0,0,0,0,1,0,0,0,0,0,0
7539,776491,16,5,7,5,6,0,1,0,0,0,1,2,0,1,2,0,10
7540,780095,23,2,2,2,2,0,0,0,0,0,1,0,2,0,3,0,4
7540,776321,29,4,10,4,10,0,0,3,3,1,8,1,4,1,1,0,11
7540,786081,36,3,10,3,6,0,4,0,1,1,4,0,3,2,4,1,6
7540,785431,28,2,5,1,3,1,2,6,8,1,3,3,3,1,5,1,11
7540,780232,40,5,16,2,8,3,8,15,17,0,4,5,0,3,3,0,28
7540,785356,11,0,1,0,0,0,1,0,0,1,3,1,0,0,0,0,0
7540,781328,4,0,0,0,0,0,0,0,0,0,0,0,2,0,0,0,0
7540,797918,3,0,0,0,0,0,0,0,0,1,0,0,0,0,0,0,0
7540,789040,26,4,6,3,5,1,1,8,10,0,4,0,3,1,1,0,17
7541,791266,14,2,4,2,4,0,0,2,3,2,2,0,5,0,0,0,6
7541,791265,32,0,5,0,1,0,4,1,2,1,2,4,4,2,5,0,1
7541,791269,25,8,14,3,5,5,9,0,0,0,2,0,2,2,0,0,21
7541,785685,31,5,10,3,7,2,3,3,4,0,5,1,3,4,5,0,15
7541,781294,24,1,4,1,2,0,2,1,6,2,2,1,3,1,0,0,3
7541,796524,4,1,1,1,1,0,0,0,0,0,1,0,0,0,0,0,2
7541,796523,14,1,4,1,3,0,1,3,5,1,3,0,3,0,1,0,5
7541,796522,17,1,4,1,2,0,2,0,0,0,1,3,1,0,1,0,2
7541,796525,8,1,4,1,1,0,3,0,0,1,1,0,1,0,0,0,2
7541,791270,9,1,2,1,1,0,1,0,0,0,0,0,1,1,0,0,2
7541,791271,22,3,6,3,6,0,0,3,3,1,6,1,5,0,5,1,9
7542,797750,26,4,7,4,6,0,1,3,5,1,3,3,1,2,0,1,11
7542,786293,25,5,11,4,8,1,3,0,0,0,6,2,3,1,2,0,11
7542,780953,26,6,9,5,8,1,1,0,0,0,2,2,5,2,5,0,13
7542,792143,22,6,11,1,2,5,9,0,0,0,0,1,3,0,2,0,17
7542,786302,26,0,3,0,3,0,0,0,0,4,4,1,3,0,2,1,0
7542,797753,10,3,4,3,4,0,0,0,0,0,4,1,3,1,2,0,6
7542,786287,29,3,5,3,4,0,1,0,4,0,1,3,0,2,1,0,6
7542,780955,25,3,6,2,3,1,3,0,0,0,2,5,2,0,1,0,7
7542,797748,11,1,1,1,1,0,0,0,0,0,1,1,3,0,0,0,2
7543,798060,35,3,9,3,7,0,2,1,1,1,3,3,2,0,3,0,7
7543,792355,34,5,14,2,5,3,9,1,1,0,1,1,2,0,0,0,14
7543,786723,35,5,9,4,6,1,3,7,8,3,5,3,1,2,5,0,18
7543,786724,26,2,5,1,1,1,4,2,2,0,1,1,4,0,1,0,7
7543,792349,30,5,8,4,6,1,2,1,3,2,9,0,1,1,3,1,12
7543,786726,10,0,0,0,0,0,0,2,2,0,2,0,1,1,2,0,2
7543,798061,19,3,8,3,5,0,3,0,0,0,2,1,4,1,1,2,6
7543,798059,6,0,1,0,1,0,0,0,1,0,1,0,0,0,0,0,0
7543,792348,5,0,0,0,0,0,0,0,0,0,0,0,0,0,1,0,0
7544,797325,27,3,3,3,3,0,0,0,0,3,6,1,2,0,1,0,6
7544,797329,26,1,2,0,0,1,2,2,2,1,2,0,4,1,2,2,5
7544,797323,39,4,16,2,9,2,7,6,9,0,3,3,2,1,6,0,16
7544,786236,38,5,13,3,5,2,8,5,6,0,5,0,4,2,0,1,17
7544,780759,35,1,5,0,2,1,3,1,2,0,1,1,2,0,0,0,4
7544,776478,8,0,3,0,0,0,3,0,0,0,0,0,1,0,0,0,0
7544,797327,15,2,4,1,2,1,2,2,2,0,1,0,0,0,0,0,7
7544,797322,4,0,1,0,0,0,1,0,0,1,0,0,1,0,0,0,0
7544,786233,7,1,3,0,0,1,3,0,0,1,0,0,2,0,0,0,3
7544,786246,1,0,0,0,0,0,0,0,0,0,0,0,0,0,0,0,0
7545,781577,12,0,1,0,1,0,0,0,0,1,1,1,5,0,2,0,0
7545,775910,31,3,5,1,1,2,4,8,10,3,2,2,2,0,1,1,16
7545,786451,36,4,9,2,4,2,5,0,0,5,5,1,3,0,2,0,10
7545,780600,36,6,12,2,6,4,6,3,4,1,5,0,0,0,3,1,19
7545,781387,30,3,7,2,3,1,4,0,2,1,1,6,3,0,4,0,7
7545,800084,7,1,6,0,2,1,4,0,0,0,0,0,0,0,0,0,3
7545,791763,12,2,7,1,3,1,4,0,1,1,1,1,2,0,0,0,5
7545,790888,4,0,3,0,0,0,3,0,0,0,3,0,0,1,0,0,0
7545,786456,12,0,4,0,4,0,0,0,0,5,3,0,4,0,0,0,0
7545,797561,16,2,3,1,1,1,2,0,0,1,3,1,1,0,1,0,5
7545,780020,4,0,0,0,0,0,0,0,0,0,0,0,1,0,1,0,0
7546,780256,34,6,11,3,4,3,7,10,13,1,5,2,4,1,3,2,25
7546,796880,35,3,9,1,4,2,5,0,0,1,1,1,5,1,5,1,8
7546,791334,36,3,5,3,5,0,0,0,0,0,2,1,2,0,2,0,6
7546,785874,17,2,6,2,6,0,0,0,1,0,3,0,3,1,0,0,4
7546,796883,14,0,1,0,1,0,0,0,0,0,3,1,2,0,3,0,0
7546,791760,28,7,11,5,8,2,3,1,2,1,1,0,2,2,2,1,17
7546,796879,34,2,6,1,4,1,2,5,8,2,3,5,3,2,1,0,10
7546,791757,16,0,1,0,1,0,0,2,2,0,0,1,1,0,1,0,2
7546,781590,11,0,1,0,1,0,0,2,3,0,1,0,0,0,1,0,2
7547,775955,38,7,13,5,9,2,4,3,4,0,4,5,4,2,7,0,19
7547,775840,38,3,7,2,5,1,2,10,10,0,2,2,3,3,2,0,17
7547,786704,38,6,12,6,12,0,0,4,4,1,1,1,0,2,1,2,16
7547,785395,29,4,6,4,6,0,0,3,4,0,4,1,4,0,2,1,11
7547,775811,20,2,3,2,3,0,0,0,0,0,1,0,2,0,0,0,4
7547,786551,23,3,5,3,3,0,2,0,0,0,6,0,3,0,4,0,6
7547,775287,12,2,3,2,2,0,1,0,1,0,1,1,3,0,0,0,4
7547,790921,15,1,3,1,3,0,0,0,0,1,4,3,1,0,2,1,2
7547,786706,7,1,2,1,2,0,0,0,0,0,0,0,3,0,0,0,2
7547,786703,4,0,0,0,0,0,0,0,0,0,0,0,0,0,0,0,0
7547,786702,1,0,0,0,0,0,0,0,0,0,0,0,0,0,0,0,0
7556,790930,28,1,4,1,4,0,0,0,0,1,5,2,1,2,1,1,2
7556,780358,22,1,7,0,4,1,3,0,0,0,0,1,2,0,1,1,3
7556,775011,29,5,8,2,3,3,5,2,2,0,2,0,3,0,1,0,15
7556,780357,28,1,6,0,1,1,5,0,0,2,4,0,3,0,1,0,3
7556,775018,34,4,11,4,9,0,2,8,9,0,5,3,2,2,3,0,16
7556,776004,18,4,9,3,5,1,4,0,0,0,0,1,2,0,0,3,9
7556,796480,23,5,8,5,8,0,0,1,1,0,3,0,3,0,1,0,11
7556,776270,18,0,1,0,1,0,0,0,0,0,3,4,2,1,1,0,0
7557,780012,38,8,16,4,9,4,7,0,1,2,5,0,1,0,0,0,20
7557,796309,27,3,9,3,8,0,1,5,6,5,10,1,3,0,1,5,11
7557,790824,38,6,11,4,7,2,4,0,0,0,1,1,0,1,1,1,14
7557,780011,31,2,11,2,9,0,2,5,6,1,3,2,2,2,0,0,9
7557,775667,31,2,5,1,4,1,1,1,1,0,2,6,1,2,1,0,6
7557,774895,13,3,4,3,4,0,0,0,0,1,1,0,1,0,1,0,6
7557,781524,18,0,3,0,1,0,2,1,2,0,1,0,2,0,0,0,1
7557,785370,4,0,0,0,0,0,0,0,0,0,0,1,0,0,1,0,0
7558,775820,16,0,1,0,0,0,1,1,2,0,4,0,4,0,0,0,1
7558,775538,25,3,5,3,5,0,0,0,0,2,4,0,2,1,1,0,6
7558,791110,27,3,6,2,4,1,2,1,2,0,0,2,1,0,2,0,8
7558,785603,36,6,16,3,8,3,8,3,5,0,2,1,3,1,2,0,18
7558,776425,36,4,11,2,4,2,7,1,2,1,1,3,1,2,2,0,11
7558,791107,15,1,2,1,2,0,0,0,0,1,5,0,1,0,0,1,2
7558,791106,24,2,4,2,2,0,2,0,0,1,1,1,0,0,2,0,4
7558,786494,21,2,4,1,1,1,3,0,0,0,1,1,1,1,0,0,5
7559,785522,22,0,1,0,0,0,1,2,2,0,2,1,1,0,1,0,2
7559,781247,27,6,7,3,3,3,4,0,1,0,4,2,1,0,2,0,15
7559,796947,24,3,5,1,3,2,2,0,0,1,5,0,2,1,0,0,8
7559,791249,38,6,14,2,4,4,10,4,4,0,4,3,4,0,4,0,20
7559,775358,36,4,7,4,5,0,2,4,4,0,4,3,2,3,1,0,12
7559,796949,16,2,4,2,4,0,0,0,0,1,2,0,1,0,2,1,4
7559,785523,2,0,1,0,1,0,0,0,0,0,0,0,1,0,0,0,0
7559,796944,6,0,1,0,0,0,1,0,0,0,1,0,0,0,0,0,0
7559,791250,29,2,8,2,2,0,6,1,2,2,3,4,2,1,0,0,5
7560,797241,23,1,2,0,1,1,1,1,3,3,3,0,2,1,0,0,4
7560,791366,16,1,4,1,3,0,1,3,4,3,1,1,0,1,2,0,5
7560,797244,25,2,7,0,4,2,3,2,2,1,2,3,4,1,1,0,8
7560,785742,32,4,10,2,3,2,7,6,8,1,6,1,4,1,3,1,16
7560,780163,13,1,3,0,1,1,2,2,2,0,3,2,1,0,2,1,5
7560,791361,24,5,9,4,6,1,3,1,3,4,2,1,2,0,1,0,12
7560,780170,17,1,4,1,4,0,0,0,0,1,2,0,1,0,0,0,2
7560,797243,24,5,13,5,11,0,2,5,8,2,6,4,3,1,1,0,15
7560,786340,19,3,7,2,4,1,3,0,0,1,3,2,2,0,2,0,7
7560,791363,7,0,1,0,0,0,1,0,0,0,0,0,0,1,0,0,0
7561,791344,30,6,9,6,6,0,3,1,1,4,6,0,5,1,2,2,13
7561,781425,27,3,6,3,6,0,0,2,4,3,9,0,1,1,1,0,8
7561,791343,30,1,7,1,4,0,3,2,4,1,2,6,4,0,1,0,4
7561,781602,35,8,17,4,7,4,10,5,6,1,3,2,3,0,5,0,25
7561,775746,33,4,12,2,6,2,6,2,4,1,0,1,4,2,1,2,12
7561,781601,13,0,1,0,1,0,0,0,0,0,2,2,1,0,0,2,0
7561,797001,20,0,4,0,3,0,1,0,0,1,2,1,3,1,1,0,0
7561,797000,9,3,5,1,1,2,4,0,0,0,0,0,2,0,0,0,8
7561,786611,3,0,0,0,0,0,0,0,0,0,1,1,0,0,0,0,0
7562,792417,32,7,10,6,8,1,2,2,2,2,3,4,2,2,2,0,17
7562,786861,36,3,6,2,2,1,4,4,4,0,7,1,3,0,1,2,11
7562,786867,35,1,4,1,1,0,3,0,0,0,2,3,2,2,2,0,2
7562,780387,35,7,13,5,9,2,4,0,0,1,7,2,1,0,5,0,16
7562,767033,21,6,9,3,5,3,4,0,0,0,5,1,4,0,0,0,15
7562,796870,7,1,2,1,2,0,0,2,3,0,1,0,0,0,0,0,4
7562,792416,21,3,3,1,1,2,2,2,4,0,3,1,3,1,2,0,10
7562,796869,1,0,0,0,0,0,0,0,0,0,0,0,0,0,0,0,0
7562,785801,1,0,0,0,0,0,0,0,0,0,0,0,0,0,0,0,0
7562,796864,1,0,0,0,0,0,0,0,0,0,0,0,0,0,1,0,0
7562,796867,6,0,1,0,1,0,0,0,0,0,1,0,1,0,0,0,0
7562,796868,1,0,0,0,0,0,0,0,1,0,0,0,0,0,0,0,0
7562,786866,3,0,0,0,0,0,0,0,0,0,0,1,1,0,1,0,0
7563,785843,10,0,2,0,1,0,1,0,0,0,0,0,2,0,0,1,0
7563,780578,26,1,9,1,6,0,3,0,0,1,2,2,4,2,5,0,2
7563,797537,11,1,2,0,1,1,1,3,4,1,0,2,1,1,1,0,6
7563,797538,25,2,8,1,1,1,7,0,1,0,1,1,3,0,0,0,5
7563,780579,36,10,16,7,12,3,4,1,5,0,3,2,0,1,0,0,24
7563,785845,26,1,3,1,3,0,0,0,0,3,5,2,1,2,1,0,2
7563,785293,30,4,6,2,3,2,3,2,2,0,3,3,4,1,2,0,12
7563,785847,28,1,7,0,2,1,5,5,7,1,3,0,1,2,1,0,8
7563,791712,4,1,1,1,1,0,0,0,0,0,2,0,0,0,0,1,2
7563,797535,4,0,1,0,0,0,1,0,0,0,0,0,1,0,0,0,0
7564,774806,32,3,6,3,6,0,0,6,10,4,10,2,3,0,3,0,12
7564,775823,30,2,5,2,4,0,1,4,6,1,4,2,3,2,1,0,8
7564,791041,31,7,12,4,6,3,6,1,2,1,2,3,3,0,2,1,18
7564,791038,33,3,9,0,2,3,7,0,0,1,4,1,0,0,1,0,9
7564,789023,40,5,12,3,7,2,5,0,0,3,1,6,1,1,5,0,12
7564,796714,8,1,2,1,2,0,0,2,2,1,0,0,1,0,0,0,4
7564,775205,26,2,6,0,0,2,6,0,0,0,0,0,1,0,0,0,6
7565,786635,34,6,15,6,13,0,2,2,2,3,7,3,5,2,4,0,14
7565,791822,27,5,8,0,1,5,7,0,0,0,4,0,4,0,0,0,15
7565,781543,26,3,5,3,4,0,1,0,1,0,1,3,1,1,3,1,6
7565,780642,36,6,12,6,11,0,1,1,1,1,4,6,0,2,1,1,13
7565,776449,35,3,8,2,6,1,2,1,2,0,1,1,1,1,0,0,8
7565,791821,13,2,2,2,2,0,0,0,0,1,2,0,2,0,0,0,4
7565,786182,23,3,6,3,5,0,1,1,2,3,1,2,5,1,1,0,7
7565,786632,6,1,1,0,0,1,1,0,0,0,0,0,0,0,0,0,3
7566,785631,41,6,9,5,6,1,3,4,6,1,3,1,2,1,3,2,17
7566,786248,37,3,8,3,8,0,0,3,4,1,7,1,3,0,3,1,9
7566,785630,36,4,11,2,4,2,7,1,2,0,1,0,2,1,0,0,11
7566,785632,37,0,6,0,4,0,2,0,0,1,5,0,0,2,0,2,0
7566,780777,43,4,15,4,13,0,2,2,2,2,3,3,3,5,0,0,10
7566,791199,8,0,0,0,0,0,0,0,0,0,1,0,0,1,0,0,0
7566,791200,23,2,8,2,3,0,5,0,0,0,0,0,2,1,0,0,4
7567,775897,38,5,9,4,6,1,3,0,0,0,4,0,0,1,4,0,11
7567,780324,37,4,13,4,13,0,0,3,7,6,8,3,5,0,5,3,11
7567,791543,22,1,4,0,1,1,3,0,0,0,0,0,2,1,2,0,3
7567,786530,39,2,7,2,4,0,3,2,2,1,5,2,3,0,3,0,6
7567,780317,35,4,12,2,6,2,6,0,0,0,4,1,2,2,1,1,10
7567,791546,8,1,2,1,1,0,1,0,0,0,1,0,2,0,2,1,2
7567,784246,16,0,2,0,1,0,1,0,0,3,3,1,1,1,0,0,0
7567,791545,30,3,8,3,6,0,2,1,1,1,5,1,1,0,2,1,7
7568,786481,29,5,12,3,10,2,2,5,6,2,1,1,4,0,1,0,17
7568,781032,31,3,6,2,3,1,3,1,2,0,3,4,0,0,2,0,8
7568,797624,18,1,4,0,1,1,3,0,1,0,4,0,1,0,1,0,3
7568,786480,31,6,8,4,5,2,3,8,9,0,2,0,4,0,0,0,22
7568,797626,33,2,8,2,6,0,2,3,6,1,10,7,3,1,2,0,7
7568,797628,25,4,7,1,4,3,3,4,4,1,1,1,2,1,0,0,15
7568,791791,17,0,2,0,1,0,1,0,0,0,0,1,0,0,0,0,0
7568,785965,16,5,8,3,4,2,4,1,1,0,3,0,1,2,0,0,13
7569,792029,20,5,7,5,6,0,1,0,0,1,4,0,3,0,0,1,10
7569,761149,23,2,7,2,4,0,3,0,0,2,2,2,3,0,0,1,4
7569,792032,36,11,23,6,11,5,12,7,7,0,2,3,4,1,0,0,34
7569,792031,32,2,3,1,1,1,2,0,0,1,3,4,1,1,0,0,5
7569,780828,33,6,13,5,9,1,4,2,2,0,7,4,4,0,5,0,15
7569,797641,9,1,2,1,2,0,0,0,0,2,0,0,0,0,1,0,2
7569,785822,5,0,0,0,0,0,0,0,0,1,1,0,2,0,0,1,0
7569,797636,18,0,1,0,1,0,0,1,2,0,5,1,2,2,2,0,1
7569,792030,24,4,7,2,3,2,4,0,0,2,4,1,5,0,1,0,10
7570,790870,33,9,12,9,12,0,0,2,2,4,4,3,0,2,3,1,20
7570,790869,37,10,16,5,11,5,5,2,4,0,4,1,1,1,3,1,27
7570,780116,31,2,4,1,3,1,1,0,0,0,4,1,1,1,2,0,5
7570,796421,33,1,6,1,2,0,4,0,0,3,4,8,1,2,1,0,2
7570,783997,5,0,2,0,0,0,2,1,2,0,1,0,0,1,0,0,1
7570,796426,3,0,1,0,1,0,0,0,0,0,0,0,0,0,0,0,0
7570,780493,16,1,5,0,0,1,5,0,0,0,2,0,4,1,0,0,3
7570,796427,7,0,2,0,1,0,1,0,0,0,2,1,0,0,0,0,0
7570,790866,30,5,10,1,1,4,9,0,0,0,4,2,1,1,0,0,14
7570,796425,1,0,0,0,0,0,0,0,0,0,0,0,0,0,0,0,0
7570,796424,2,0,0,0,0,0,0,0,0,0,0,0,0,0,0,0,0
7570,796422,2,0,0,0,0,0,0,0,0,0,0,0,0,0,0,0,0
7571,791011,34,4,12,2,4,2,8,5,5,1,10,2,2,0,1,1,15
7571,796671,22,0,4,0,4,0,0,0,0,1,1,0,1,0,2,2,0
7571,796668,16,2,7,1,2,1,5,0,0,0,0,1,3,2,1,0,5
7571,791012,36,4,9,3,5,1,4,0,1,0,2,0,0,1,2,0,9
7571,781221,31,5,9,4,5,1,4,2,2,0,3,0,0,0,3,1,13
7571,796670,9,1,1,1,1,0,0,0,0,0,1,0,0,0,1,0,2
7571,791594,29,5,8,2,4,3,4,0,0,0,1,1,0,1,0,0,13
7571,791013,20,0,2,0,2,0,0,0,0,0,1,4,1,0,0,0,0
7571,796669,1,0,0,0,0,0,0,0,0,0,0,0,0,0,0,0,0
7571,791008,2,0,0,0,0,0,0,0,0,0,0,0,0,0,0,0,0
7572,785355,38,2,3,1,1,1,2,2,2,1,0,1,4,0,2,0,7
7572,781462,36,9,13,8,11,1,2,5,6,1,3,2,2,1,3,2,24
7572,780876,23,1,5,1,3,0,2,0,1,0,2,2,2,4,2,0,2
7572,785353,36,3,7,2,3,1,4,6,6,0,3,3,0,1,1,0,13
7572,781457,33,3,6,3,5,0,1,6,6,2,5,5,1,2,3,0,12
7572,791305,4,0,1,0,1,0,0,0,0,0,0,0,1,0,0,0,0
7572,790895,10,1,4,1,3,0,1,0,0,0,2,3,0,0,1,0,2
7572,781673,20,3,8,0,2,3,6,2,2,1,1,0,2,1,0,0,11
7573,791876,38,5,6,5,5,0,1,3,3,1,5,1,2,0,2,0,13
7573,791877,37,1,5,1,3,0,2,0,0,3,5,2,3,3,2,1,2
7573,785667,33,7,13,3,5,4,8,0,0,0,1,1,4,1,0,0,18
7573,786572,36,6,14,4,10,2,4,1,4,3,6,2,3,2,3,0,15
7573,786570,20,5,8,4,5,1,3,2,2,1,0,4,5,2,7,0,13
7573,781205,3,0,0,0,0,0,0,0,0,0,0,0,1,0,1,0,0
7573,797491,9,0,0,0,0,0,0,2,4,0,2,0,0,0,0,0,2
7573,797486,22,1,3,1,3,0,0,0,2,0,2,4,1,0,3,0,2
7573,780436,2,0,0,0,0,0,0,0,0,0,0,0,0,0,0,0,0
7574,792131,26,2,4,1,2,1,2,1,2,3,8,0,3,1,2,0,6
7574,786838,34,8,16,7,13,1,3,3,6,3,6,3,2,1,2,3,20
7574,797736,9,0,0,0,0,0,0,0,0,0,0,0,3,0,0,0,0
7574,792127,32,6,11,2,5,4,6,2,2,0,2,3,1,2,3,1,18
7574,791668,11,2,2,2,2,0,0,0,1,0,1,1,3,1,0,0,4
7574,792128,19,0,4,0,3,0,1,0,0,0,3,0,3,0,0,0,0
7574,799908,1,0,0,0,0,0,0,0,0,0,1,0,0,0,0,0,0
7574,797739,10,0,0,0,0,0,0,0,0,1,1,0,1,0,0,0,0
7574,792132,29,4,11,2,7,2,4,0,0,2,1,4,1,1,0,0,10
7574,792126,29,2,6,1,2,1,4,3,3,0,2,1,2,0,1,1,8
7574,799273,0,0,0,0,0,0,0,0,0,0,0,0,0,0,0,0,0
7575,791257,18,3,6,3,6,0,0,0,4,0,3,2,3,1,1,1,6
7575,791838,23,2,6,0,1,2,5,0,0,1,3,0,1,0,2,0,6
7575,786620,29,5,10,2,7,3,3,2,2,0,2,0,0,1,2,0,15
7575,781606,33,1,6,1,4,0,2,0,0,1,1,3,2,0,1,0,2
7575,781257,28,2,8,2,5,0,3,1,2,0,4,0,3,0,2,0,5
7575,796955,17,2,2,2,2,0,0,1,2,1,3,0,3,0,1,2,5
7575,791256,2,0,1,0,0,0,1,0,0,0,0,0,0,0,0,0,0
7575,791255,20,0,1,0,1,0,0,0,0,0,1,3,0,0,0,1,0
7575,796029,1,0,0,0,0,0,0,0,0,0,0,0,1,0,0,0,0
7575,781263,28,2,6,2,5,0,1,6,7,0,5,0,3,0,1,0,10
7575,791254,1,0,0,0,0,0,0,0,0,0,0,0,0,0,0,0,0
7576,780282,29,4,6,3,5,1,1,2,2,2,10,3,0,0,3,2,11
7576,780277,31,7,11,5,8,2,3,0,0,1,1,1,1,2,2,0,16
7576,791002,25,2,3,0,0,2,3,2,2,0,0,1,2,0,2,0,8
7576,785327,29,3,9,2,4,1,5,0,0,0,5,3,3,2,2,1,7
7576,780280,33,7,9,6,7,1,2,6,6,1,3,6,0,0,1,0,21
7576,785329,13,1,2,0,1,1,1,0,0,0,1,3,3,0,1,1,3
7576,791003,14,2,3,2,2,0,1,1,2,0,2,0,2,2,1,0,5
7576,785330,14,4,6,3,4,1,2,0,0,0,1,1,1,0,0,1,9
7576,785326,12,2,2,1,1,1,1,1,2,0,0,0,3,0,2,0,6
7577,786459,33,6,13,6,13,0,0,4,5,0,6,2,1,1,3,0,16
7577,781612,26,1,5,1,2,0,3,2,4,0,2,0,3,0,1,2,4
7577,797004,31,4,12,3,8,1,4,3,3,0,0,2,3,0,2,0,12
7577,791360,32,3,6,1,2,2,4,0,0,0,1,0,3,1,0,0,8
7577,781609,28,5,8,4,6,1,2,1,1,2,0,0,1,0,3,0,12
7577,797005,13,2,3,1,2,1,1,0,0,2,1,0,1,2,1,1,5
7577,797008,6,0,0,0,0,0,0,0,0,0,0,0,1,0,0,0,0
7577,797006,18,3,6,3,5,0,1,0,1,1,2,1,2,3,2,0,6
7577,797003,10,1,2,0,0,1,2,2,2,0,0,0,2,0,0,0,5
7577,797002,2,0,0,0,0,0,0,0,0,0,0,0,0,0,0,0,0
7577,791358,1,0,0,0,0,0,0,0,0,0,0,0,0,0,0,0,0
7578,796585,12,2,3,2,3,0,0,1,1,1,1,1,4,0,0,0,5
7578,780192,34,3,13,2,8,1,5,0,1,1,3,1,4,0,1,0,7
7578,798139,31,6,19,6,13,0,6,6,6,1,0,2,2,1,3,0,18
7578,786818,31,6,14,5,9,1,5,2,2,1,0,0,5,4,7,0,15
7578,780182,34,6,11,2,5,4,6,2,2,1,10,0,3,0,0,0,18
7578,780186,29,4,6,4,6,0,0,1,3,3,6,3,1,1,2,0,9
7578,798138,21,4,4,1,1,3,3,0,0,0,3,0,3,0,0,0,11
7578,780188,1,0,0,0,0,0,0,0,0,0,0,0,0,0,0,0,0
7578,780184,7,0,0,0,0,0,0,0,0,1,0,1,1,0,1,0,0
7579,791140,20,2,4,2,4,0,0,2,3,2,1,1,3,0,0,1,6
7579,791138,19,2,4,2,3,0,1,0,0,1,2,0,2,3,1,0,4
7579,786084,31,7,11,5,6,2,5,0,1,0,8,1,0,0,1,0,16
7579,780910,31,8,17,8,15,0,2,6,6,0,3,4,2,2,2,1,22
7579,780288,31,2,8,0,2,2,6,3,4,2,1,1,1,2,3,0,9
7579,796794,5,1,1,1,1,0,0,0,0,0,0,0,0,0,0,0,2
7579,796795,20,5,6,5,6,0,0,0,2,0,4,4,3,0,1,3,10
7579,780912,6,0,2,0,1,0,1,0,0,0,0,0,1,1,1,0,0
7579,780911,26,4,7,1,2,3,5,7,8,2,7,2,0,1,0,1,18
7579,781635,11,2,4,2,2,0,2,1,1,0,2,1,3,0,1,0,5
7580,791585,31,3,7,1,3,2,4,0,1,0,11,3,4,0,1,0,8
7580,791581,15,2,3,2,2,0,1,1,1,0,4,1,4,0,0,0,5
7580,786395,34,4,7,0,2,4,5,0,1,1,5,3,0,0,0,0,12
7580,786394,39,6,13,3,8,3,5,2,2,2,3,2,1,1,3,0,17
7580,780404,35,6,12,6,10,0,2,1,2,1,1,3,2,0,1,1,13
7580,780062,21,4,4,4,4,0,0,2,2,2,3,4,2,0,4,2,10
7580,785228,17,2,4,1,1,1,3,2,2,0,1,0,1,0,1,0,7
7580,797041,3,0,1,0,1,0,0,0,0,0,0,0,0,0,0,0,0
7580,780403,5,0,0,0,0,0,0,0,0,0,0,0,2,0,0,0,0
7581,776462,24,0,4,0,2,0,2,5,7,2,4,0,4,0,1,0,5
7581,785635,18,1,8,1,7,0,1,0,0,2,1,0,3,1,2,0,2
7581,791629,25,3,7,1,2,2,5,2,5,0,2,2,3,2,1,1,10
7581,786440,31,2,6,1,2,1,4,2,2,1,2,1,0,0,1,1,7
7581,781199,36,4,15,3,9,1,6,0,0,0,3,1,2,0,0,0,9
7581,796974,26,5,11,3,7,2,4,2,2,1,2,3,2,0,1,0,14
7581,791628,19,4,6,2,2,2,4,2,2,5,2,0,0,1,0,2,12
7581,775642,17,0,1,0,0,0,1,0,0,1,3,0,1,2,0,0,0
7581,786720,4,0,1,0,0,0,1,0,0,0,0,0,0,0,0,0,0
7582,790781,30,7,10,7,9,0,1,0,0,2,9,0,3,0,1,1,14
7582,780040,23,2,5,2,5,0,0,1,1,1,3,0,4,1,1,0,5
7582,790785,31,4,12,3,9,1,3,6,8,1,2,4,2,2,0,0,15
7582,781232,32,3,5,1,1,2,4,2,2,0,3,0,1,1,1,0,10
7582,780037,35,5,18,4,12,1,6,12,16,1,1,4,4,2,3,0,23
7582,796343,15,0,0,0,0,0,0,0,0,0,0,0,3,0,0,0,0
7582,796339,22,2,4,2,3,0,1,2,3,0,0,2,0,3,1,0,6
7582,790783,12,0,0,0,0,0,0,2,4,1,4,0,3,0,0,0,2
7582,792440,0,0,0,0,0,0,0,0,0,0,0,0,0,0,0,0,0
7583,796404,28,3,7,3,7,0,0,0,0,5,5,4,2,1,4,1,6
7583,790853,19,3,8,3,8,0,0,3,4,2,1,1,2,0,1,2,9
7583,790850,31,5,14,1,5,4,9,1,2,0,5,0,1,0,1,0,15
7583,781164,20,0,2,0,0,0,2,0,0,0,1,2,3,0,0,0,0
7583,781163,33,5,10,4,7,1,3,7,11,0,4,4,3,1,4,1,18
7583,790849,20,3,5,1,1,2,4,0,0,0,3,2,5,1,3,0,8
7583,790854,2,0,0,0,0,0,0,0,0,0,0,0,0,0,1,0,0
7583,785434,11,0,1,0,0,0,1,2,2,0,0,1,0,0,1,0,2
7583,796406,13,4,6,4,6,0,0,0,0,2,3,0,4,0,0,0,8
7583,796405,11,1,3,1,3,0,0,1,1,1,0,1,4,0,0,2,3
7583,781223,12,1,1,1,1,0,0,2,2,1,2,0,2,0,0,0,4
7583,790848,0,0,0,0,0,0,0,0,0,0,0,0,0,0,0,0,0
7590,792329,31,1,7,0,4,1,3,1,2,1,4,1,2,0,0,0,4
7590,786752,26,5,11,5,8,0,3,3,4,1,3,0,2,0,3,1,13
7590,781384,18,2,3,2,3,0,0,1,2,3,2,0,1,1,2,0,5
7590,781616,33,6,12,3,6,3,6,0,0,1,6,4,3,1,1,0,15
7590,776350,33,1,5,1,3,0,2,2,3,0,5,3,1,0,2,0,4
7590,781075,15,5,10,0,3,5,7,2,2,2,3,1,3,0,2,1,17
7590,781615,25,1,6,0,3,1,3,0,0,2,2,2,3,2,1,2,3
7590,792601,5,0,2,0,2,0,0,0,0,2,0,1,0,0,1,0,0
7590,786749,14,0,3,0,1,0,2,0,0,0,2,0,3,0,0,0,0
7591,792171,28,1,5,1,4,0,1,7,8,3,6,2,2,1,0,1,9
7591,780049,20,1,5,1,5,0,0,1,2,0,4,1,1,1,1,0,3
7591,797784,36,8,16,4,7,4,9,4,4,1,1,1,1,1,1,0,24
7591,789059,25,2,6,2,3,0,3,2,4,1,8,0,4,1,2,0,6
7591,780980,17,0,2,0,1,0,1,0,0,0,2,1,0,0,1,0,0
7591,797782,7,2,2,2,2,0,0,0,0,0,1,0,4,0,2,0,4
7591,785674,19,1,5,1,2,0,3,1,2,0,3,0,0,0,3,0,3
7591,792173,20,1,5,1,3,0,2,2,2,1,3,0,1,1,0,2,4
7591,780527,28,1,7,0,5,1,2,1,2,4,2,0,5,0,2,0,4
7592,781107,29,4,6,4,6,0,0,3,7,5,2,2,3,0,1,0,11
7592,791972,30,1,6,0,1,1,5,2,2,1,5,2,2,0,3,0,5
7592,796777,7,0,0,0,0,0,0,0,0,0,1,1,0,0,0,0,0
7592,785366,32,6,12,5,7,1,5,1,2,0,2,2,1,2,1,0,14
7592,780863,34,6,12,6,9,0,3,2,2,3,5,4,3,0,5,1,14
7592,796778,10,2,4,2,4,0,0,0,0,2,2,2,0,0,0,0,4
7592,791974,30,4,8,1,2,3,6,2,2,0,5,1,1,1,1,0,13
7592,796780,15,2,3,1,1,1,2,3,4,1,1,1,1,0,1,0,8
7592,791971,11,0,1,0,0,0,1,0,0,0,1,0,2,0,1,0,0
7592,780867,2,0,0,0,0,0,0,0,0,0,0,0,0,0,0,0,0
7593,790846,36,5,8,5,7,0,1,2,4,4,6,2,2,2,0,1,12
7593,796755,7,0,1,0,1,0,0,0,0,0,0,0,2,0,2,1,0
7593,791099,28,0,5,0,2,0,3,0,0,0,0,3,3,0,0,0,0
7593,785470,32,7,11,2,3,5,8,2,2,2,5,1,2,2,1,0,21
7593,780298,36,6,18,3,8,3,10,2,2,1,3,4,3,1,0,0,17
7593,796754,9,0,2,0,0,0,2,0,0,0,1,2,1,1,0,0,0
7593,780315,28,2,4,1,2,1,2,2,2,2,2,2,2,1,3,0,7
7593,785586,21,4,10,2,6,2,4,1,1,0,0,2,0,0,0,0,11
7593,780814,3,0,1,0,1,0,0,0,0,0,0,0,0,0,0,0,0
7594,792261,35,5,9,5,9,0,0,1,2,2,9,0,4,1,1,1,11
7594,786124,25,3,5,3,5,0,0,0,1,1,6,0,4,0,0,0,6
7594,792258,6,2,2,0,0,2,2,1,2,0,0,1,0,0,0,0,7
7594,786122,40,7,16,5,10,2,6,6,8,0,2,2,4,1,1,0,22
7594,786331,34,3,7,3,7,0,0,1,2,0,4,2,1,1,2,0,7
7594,797980,3,0,0,0,0,0,0,0,0,1,1,0,0,0,0,0,0
7594,780877,17,0,2,0,2,0,0,2,2,2,4,0,2,1,2,0,2
7594,797982,6,0,1,0,0,0,1,0,0,0,1,1,0,0,1,0,0
7594,786113,34,3,6,2,5,1,1,6,8,1,4,4,1,0,2,0,13
7595,780098,21,2,5,2,4,0,1,0,0,1,4,0,1,1,1,1,4
7595,797591,20,1,3,0,0,1,3,0,0,0,1,1,2,0,0,0,3
7595,781071,29,4,9,1,1,3,8,2,2,1,3,0,3,1,0,0,13
7595,791890,35,6,16,5,10,1,6,3,4,1,2,3,4,1,5,0,16
7595,780719,39,5,12,4,10,1,2,1,2,1,4,1,1,1,2,0,12
7595,797590,5,0,0,0,0,0,0,0,0,0,0,0,1,0,0,0,0
7595,797589,23,2,8,2,7,0,1,3,4,2,2,0,2,0,0,0,7
7595,791889,28,0,3,0,0,0,3,2,2,0,3,1,3,0,0,0,2
7596,785996,22,2,4,2,4,0,0,2,4,1,3,1,3,1,2,1,6
7596,780858,30,1,5,1,4,0,1,0,0,3,5,2,1,0,2,0,2
7596,797646,18,0,5,0,4,0,1,2,2,0,1,2,2,0,1,0,2
7596,780849,31,7,12,5,5,2,7,0,0,3,2,0,4,0,2,0,16
7596,780853,30,3,8,1,5,2,3,2,2,0,1,1,4,1,3,0,10
7596,792235,13,3,4,3,4,0,0,1,1,2,6,0,3,0,1,0,7
7596,785990,25,4,10,3,6,1,4,0,0,0,3,6,2,1,0,0,9
7596,786010,9,2,5,1,2,1,3,0,0,1,1,0,1,1,1,0,5
7596,792039,11,1,1,1,1,0,0,0,0,0,2,0,0,0,1,0,2
7596,785998,11,0,2,0,1,0,1,0,0,0,2,0,2,0,2,0,0
7597,791686,26,5,8,4,6,1,2,2,4,0,5,2,2,2,1,2,13
7597,798028,32,2,5,1,3,1,2,0,2,0,2,3,3,1,2,0,5
7597,790940,37,5,8,2,5,3,3,6,6,1,4,1,3,0,3,0,19
7597,786060,35,2,8,1,4,1,4,5,8,0,2,3,0,0,1,0,10
7597,780770,33,2,9,2,6,0,3,2,3,1,0,4,2,1,1,0,6
7597,792271,7,1,3,1,2,0,1,1,2,1,1,0,0,0,1,1,3
7597,792269,16,0,1,0,0,0,1,1,2,1,3,0,1,1,1,0,1
7597,798022,10,2,3,1,1,1,2,0,0,0,1,0,2,0,1,0,5
7597,792270,4,0,0,0,0,0,0,0,0,0,0,0,1,0,0,0,0
7598,792405,5,0,0,0,0,0,0,0,0,0,1,0,0,0,0,0,0
7598,776497,28,6,12,5,8,1,4,8,8,3,2,0,4,1,1,1,21
7598,785731,18,2,8,2,7,0,1,0,2,2,2,0,3,1,3,0,4
7598,785729,35,6,13,6,11,0,2,0,0,1,4,2,4,0,1,0,12
7598,780864,35,3,13,2,5,1,8,0,0,2,1,1,1,1,3,0,7
7598,788113,27,2,5,1,3,1,2,0,1,1,2,2,5,1,2,1,5
7598,792402,21,5,5,4,4,1,1,0,0,3,1,1,2,0,0,0,11
7598,796211,13,1,3,1,2,0,1,1,1,1,3,0,3,1,1,1,3
7598,786231,14,0,5,0,2,0,3,2,2,1,1,0,1,0,1,0,2
7598,785443,4,0,1,0,1,0,0,0,0,0,0,0,0,1,0,0,0
7599,776285,20,4,6,4,6,0,0,1,2,4,2,0,4,0,6,1,9
7599,781025,34,2,4,2,2,0,2,3,4,1,4,0,3,1,2,0,7
7599,791777,34,5,13,5,13,0,0,9,9,0,6,5,1,0,2,0,19
7599,786474,25,1,5,1,3,0,2,2,2,0,3,1,1,2,0,0,4
7599,775503,26,3,6,1,2,2,4,0,0,0,5,0,4,0,3,1,8
7599,791778,16,1,3,1,3,0,0,5,8,3,0,0,1,0,2,0,7
7599,786476,4,0,1,0,1,0,0,1,2,0,1,0,1,0,0,1,1
7599,791780,7,1,1,1,1,0,0,1,1,1,1,0,1,0,0,0,3
7599,791776,7,1,2,0,0,1,2,0,0,1,0,0,0,0,0,0,3
7599,791829,21,2,3,1,1,1,2,2,4,0,2,0,2,0,3,0,7
7599,780488,6,0,1,0,1,0,0,0,0,0,2,1,0,0,1,0,0
7600,780765,37,4,12,3,9,1,3,2,2,1,9,3,1,1,6,0,11
7600,781301,25,1,1,1,1,0,0,0,0,0,5,0,5,0,0,3,2
7600,786255,36,7,17,5,10,2,7,4,4,2,5,4,2,2,1,1,20
7600,780762,31,2,9,1,6,1,3,2,2,1,6,1,1,1,0,0,7
7600,780768,22,3,5,3,5,0,0,4,4,1,2,3,4,0,1,0,10
7600,791729,13,1,3,1,2,0,1,1,4,1,2,0,2,0,1,0,3
7600,780755,18,2,6,2,5,0,1,0,1,0,3,0,1,0,2,0,4
7600,797320,18,0,1,0,1,0,0,0,0,0,0,0,0,0,4,0,0
7601,797050,27,0,6,0,3,0,3,0,0,2,4,0,0,0,0,0,0
7601,780394,33,3,13,3,6,0,7,1,2,1,7,0,2,0,0,1,7
7601,780391,33,3,8,3,8,0,0,8,9,4,3,0,2,0,4,1,14
7601,790871,34,6,10,4,6,2,4,2,2,0,3,1,3,1,2,0,16
7601,776473,36,5,15,4,8,1,7,0,0,1,8,2,4,0,2,0,11
7601,791570,3,0,1,0,1,0,0,0,0,0,0,0,0,0,0,0,0
7601,785783,13,0,4,0,1,0,3,0,0,1,1,0,1,0,0,0,0
7601,780392,17,1,3,1,2,0,1,1,2,2,0,0,0,2,3,0,3
7601,791573,4,0,0,0,0,0,0,0,0,0,0,0,1,0,0,0,0
7602,781175,28,1,5,1,5,0,0,4,4,6,5,1,2,1,2,2,6
7602,786555,31,4,10,0,1,4,9,2,2,1,1,0,0,1,1,0,14
7602,786553,30,7,20,4,12,3,8,1,3,1,3,2,1,0,1,0,18
7602,780895,31,4,9,4,7,0,2,3,3,1,2,2,1,0,4,0,11
7602,781172,33,1,7,1,2,0,5,0,0,1,8,2,4,3,0,0,2
7602,785312,17,1,3,1,2,0,1,0,0,0,1,3,1,0,1,0,2
7602,792005,18,3,9,1,3,2,6,0,0,0,1,2,0,1,1,1,8
7602,781177,12,0,2,0,2,0,0,0,0,1,1,1,0,1,1,0,0
7603,781007,25,4,6,4,6,0,0,0,1,1,3,1,2,1,2,1,8
7603,781322,28,1,4,1,2,0,2,0,0,0,3,3,1,0,1,2,2
7603,785989,30,3,6,2,4,1,2,0,0,0,3,6,2,2,4,0,7
7603,786571,23,4,9,3,6,1,3,1,1,0,2,4,1,3,3,1,10
7603,781439,34,6,11,4,7,2,4,0,0,0,6,3,1,0,2,0,14
7603,797299,7,1,2,1,2,0,0,0,0,0,3,1,3,0,0,0,2
7603,781419,29,5,12,2,4,3,8,0,0,0,4,0,1,0,2,0,13
7603,781207,8,1,1,1,1,0,0,0,0,0,2,0,1,1,2,1,2
7603,791690,8,2,4,2,4,0,0,0,1,1,1,0,0,0,0,1,4
7603,780563,8,0,1,0,1,0,0,0,0,1,1,1,0,0,0,0,0
7604,797655,35,5,10,5,10,0,0,1,2,1,6,2,2,0,3,0,11
7604,797657,34,4,10,0,1,4,9,0,0,1,3,2,1,1,2,0,12
7604,792072,24,1,4,0,0,1,4,0,0,0,1,1,3,2,3,0,3
7604,792069,40,4,10,1,3,3,7,3,4,2,3,3,1,2,3,0,14
7604,785572,15,1,4,0,2,1,2,0,0,0,1,1,2,0,1,0,3
7604,784640,19,3,6,3,4,0,2,1,2,2,2,2,0,1,0,1,7
7604,797652,33,3,5,2,2,1,3,2,5,0,8,4,2,0,1,0,9
7605,785911,23,2,5,1,2,1,3,0,0,1,1,2,3,1,4,2,5
7605,797105,21,1,4,1,2,0,2,3,6,1,5,1,5,0,2,0,5
7605,797100,27,0,1,0,1,0,0,0,0,1,7,2,5,0,1,0,0
7605,791413,33,5,13,5,9,0,4,0,0,1,3,0,0,1,2,0,10
7605,791411,24,4,11,3,5,1,6,0,0,0,3,3,1,1,4,0,9
7605,797103,19,2,4,2,4,0,0,0,0,2,4,1,1,1,2,0,4
7605,791414,18,1,3,1,2,0,1,0,0,1,2,1,1,0,0,0,2
7605,785776,31,6,11,4,6,2,5,0,0,0,0,1,1,2,1,0,14
7605,781209,4,0,1,0,0,0,1,0,0,0,1,0,1,0,0,0,0
7606,781249,34,3,7,3,6,0,1,0,0,0,3,3,4,0,3,0,6
7606,775165,29,3,5,0,0,3,5,0,0,0,5,0,4,0,0,0,9
7606,785514,35,6,12,6,11,0,1,2,2,1,6,1,4,0,2,0,14
7606,785515,30,4,8,3,4,1,4,5,6,0,1,4,3,2,1,0,14
7606,781253,31,2,5,0,1,2,4,4,4,1,2,0,1,1,0,0,10
7606,796953,13,2,2,2,2,0,0,0,0,0,1,0,0,0,2,0,4
7606,796951,2,0,0,0,0,0,0,0,0,0,0,1,1,0,0,0,0
7606,791687,26,5,7,4,5,1,2,2,3,0,3,1,3,0,4,0,13
7607,791391,34,2,4,2,4,0,0,3,4,3,4,4,3,1,4,1,7
7607,797156,24,0,3,0,2,0,1,2,4,0,1,0,3,0,0,0,2
7607,791390,31,7,12,6,10,1,2,5,7,0,3,0,2,0,3,1,20
7607,775743,26,2,4,0,1,2,3,0,0,0,2,0,1,1,2,0,6
7607,780130,34,12,17,11,13,1,4,4,7,1,4,1,3,2,1,0,29
7607,791388,14,2,2,1,1,1,1,0,0,0,1,0,1,1,1,0,5
7607,776446,2,0,0,0,0,0,0,0,0,0,0,0,1,0,0,0,0
7607,780133,20,1,2,1,2,0,0,0,0,0,2,1,1,1,1,0,2
7607,780407,15,2,3,2,2,0,1,1,1,0,2,3,1,1,1,0,5
7608,791548,28,8,14,5,8,3,6,0,1,1,8,4,3,1,4,1,19
7608,791550,22,2,4,2,4,0,0,0,1,2,2,6,1,0,0,1,4
7608,786364,34,7,11,7,9,0,2,4,7,1,3,2,3,2,1,0,18
7608,780330,27,3,6,3,6,0,0,2,2,1,2,2,4,1,0,0,8
7608,780329,33,8,13,6,10,2,3,0,0,0,0,5,2,1,0,0,18
7608,797082,17,5,8,4,6,1,2,0,0,3,3,2,4,0,1,0,11
7608,789984,2,0,0,0,0,0,0,0,1,0,1,0,0,0,0,0,0
7608,780332,16,1,5,1,4,0,1,2,2,0,3,1,1,2,1,1,4
7608,791551,2,0,0,0,0,0,0,0,0,0,0,0,0,0,0,0,0
7608,797080,17,1,3,0,0,1,3,3,4,0,3,0,3,1,0,0,6
7608,781643,2,0,2,0,2,0,0,0,0,1,0,0,0,0,0,0,0
7609,798342,23,2,5,1,2,1,3,0,0,1,1,2,2,0,2,0,5
7609,791465,19,4,7,4,7,0,0,0,0,1,2,2,1,0,2,0,8
7609,791464,24,4,6,2,2,2,4,2,2,1,2,1,2,0,2,1,12
7609,780197,35,4,11,3,7,1,4,8,8,0,4,0,3,0,1,0,17
7609,780196,33,4,11,3,9,1,2,2,3,0,3,2,2,1,3,0,11
7609,786840,2,0,1,0,1,0,0,0,0,0,1,0,1,0,0,0,0
7609,786303,7,1,1,1,1,0,0,0,0,1,1,1,0,0,0,0,2
7609,780200,13,0,0,0,0,0,0,0,0,0,3,0,4,0,0,1,0
7609,780616,17,1,4,1,2,0,2,2,4,1,3,0,3,0,0,1,4
7609,798340,1,0,0,0,0,0,0,0,0,0,0,0,0,0,0,0,0
7609,798341,11,2,3,1,1,1,2,0,0,0,1,0,0,1,3,0,5
7609,798343,12,0,2,0,1,0,1,5,8,0,0,1,2,0,1,0,5
7609,786841,3,0,0,0,0,0,0,0,0,0,1,0,0,0,0,0,0
7610,786860,14,2,7,0,0,2,7,0,0,1,1,1,4,0,1,0,6
7610,786544,32,3,6,1,4,2,2,2,2,1,6,1,2,1,1,1,10
7610,797507,36,6,11,3,5,3,6,3,3,3,2,3,4,3,1,3,18
7610,792012,40,9,23,3,12,6,11,6,6,0,3,4,3,2,2,1,30
7610,786546,34,1,9,0,3,1,6,4,6,0,5,1,4,1,1,0,7
7610,786547,23,2,6,0,0,2,6,0,0,2,2,4,3,0,2,1,6
7610,797510,7,0,3,0,2,0,1,0,0,1,1,0,0,0,0,0,0
7610,792013,7,1,2,1,1,0,1,1,2,0,2,0,0,0,1,0,3
7610,787622,3,0,1,0,0,0,1,0,0,0,0,0,1,0,0,0,0
7610,797512,1,0,0,0,0,0,0,0,0,0,0,0,0,0,0,0,0
7610,797508,3,0,0,0,0,0,0,0,0,0,0,0,0,0,0,0,0
7611,792035,29,9,17,9,17,0,0,5,7,5,2,1,4,1,2,1,23
7611,780833,25,4,7,4,7,0,0,2,2,4,3,1,1,0,1,0,10
7611,792034,37,6,16,3,8,3,8,7,8,0,11,7,2,0,5,0,22
7611,791688,29,4,8,2,4,2,4,2,3,1,3,0,3,1,3,0,12
7611,780830,38,4,8,2,5,2,3,5,7,0,10,4,3,1,1,1,15
7611,797645,16,4,8,4,7,0,1,2,2,2,2,2,4,0,1,1,10
7611,785980,15,0,1,0,0,0,1,0,0,1,1,1,0,1,0,0,0
7611,785381,11,1,1,0,0,1,1,0,0,0,1,0,1,0,1,2,3
7612,785423,26,6,8,6,6,0,2,2,2,0,7,1,3,0,0,2,14
7612,775676,23,4,7,4,7,0,0,4,6,1,5,0,2,2,1,0,12
7612,786298,22,1,6,0,0,1,6,0,0,0,2,2,2,0,2,2,3
7612,785425,39,4,13,1,6,3,7,0,0,2,9,3,1,0,0,1,11
7612,785422,40,2,12,2,5,0,7,0,0,1,4,5,0,0,4,0,4
7612,774957,26,7,10,5,7,2,3,2,2,3,4,3,1,0,1,2,18
7612,786210,24,4,7,3,3,1,4,0,0,0,4,2,3,0,2,0,9
7613,775585,24,1,2,1,2,0,0,3,6,5,5,0,2,0,0,2,5
7613,790822,39,6,16,3,7,3,9,2,2,0,3,1,2,1,1,0,17
7613,790820,30,1,8,1,7,0,1,0,2,0,3,3,1,2,0,2,2
7613,780982,40,5,13,4,9,1,4,0,0,3,4,0,1,0,1,0,11
7613,774980,38,3,14,3,9,0,5,6,9,0,5,3,0,3,0,0,12
7613,790821,26,6,15,5,12,1,3,1,2,4,6,0,2,0,3,0,14
7613,780445,3,0,0,0,0,0,0,0,0,0,0,0,2,0,0,0,0
7614,791837,15,3,7,1,2,2,5,0,0,0,4,1,1,1,0,1,8
7614,780613,17,4,6,4,6,0,0,0,0,0,3,1,1,0,0,0,8
7614,775097,18,0,1,0,1,0,0,0,0,1,6,4,0,0,2,0,0
7614,780609,22,4,6,1,1,3,5,0,0,1,3,3,0,4,1,0,11
7614,776395,18,7,12,4,6,3,6,0,0,0,1,1,1,0,0,0,17
7614,786621,18,3,4,0,0,3,4,0,0,0,1,0,0,0,0,0,9
7614,786619,19,2,6,1,2,1,4,0,2,1,3,1,2,3,3,0,5
7614,797439,17,4,6,4,4,0,2,1,2,2,3,0,1,1,1,0,9
7614,797437,21,2,4,0,1,2,3,4,6,0,2,1,0,0,3,0,10
7614,786622,17,4,6,3,5,1,1,0,0,2,1,2,0,3,1,0,9
7614,780617,8,1,2,0,0,1,2,0,0,0,0,0,0,1,0,0,3
7614,780618,5,0,1,0,0,0,1,1,2,1,1,2,0,1,1,0,1
7614,791836,3,0,0,0,0,0,0,0,0,0,0,0,0,0,0,0,0
7614,797440,2,0,0,0,0,0,0,0,0,0,0,0,0,0,0,0,0
7616,791905,34,5,7,3,4,2,3,5,5,1,8,0,3,4,1,1,17
7616,781103,32,6,12,6,12,0,0,0,0,3,4,4,4,1,3,0,12
7616,797568,32,4,8,4,6,0,2,0,0,0,2,5,2,5,1,0,8
7616,797566,34,6,9,3,5,3,4,0,0,1,4,0,1,1,3,1,15
7616,781191,36,5,15,3,8,2,7,5,5,1,2,4,2,2,1,0,17
7616,797569,9,0,0,0,0,0,0,0,0,1,1,1,1,0,1,0,0
7616,791907,7,1,1,1,1,0,0,0,0,0,0,1,0,0,2,0,2
7616,781102,16,1,1,0,0,1,1,0,0,0,0,2,0,0,1,0,3
7617,792373,28,4,8,4,7,0,1,4,4,2,3,1,3,0,2,0,12
7617,781598,12,0,2,0,0,0,2,0,0,0,2,1,2,1,1,0,0
7617,797951,32,4,9,1,3,3,6,0,0,0,2,1,0,1,3,0,11
7617,786739,24,1,2,1,1,0,1,1,2,1,2,2,0,1,2,0,3
7617,775303,28,2,4,2,2,0,2,3,3,0,1,1,2,0,2,0,7
7617,797958,16,3,6,2,3,1,3,1,1,1,2,0,1,0,1,0,8
7617,792370,32,4,10,4,6,0,4,2,2,1,1,2,1,1,5,0,10
7617,790499,13,3,5,3,4,0,1,1,1,0,1,0,2,1,0,0,7
7617,776491,15,1,4,1,4,0,0,0,0,1,1,2,0,0,0,0,2
7624,780604,37,6,9,4,6,2,3,6,9,2,0,3,3,2,1,0,20
7624,791766,26,5,8,3,4,2,4,4,6,1,0,3,0,1,1,0,16
7624,780602,34,4,10,3,8,1,2,5,6,1,5,3,4,1,5,1,14
7624,786230,27,4,9,2,4,2,5,1,2,0,0,3,4,1,3,0,11
7624,786460,22,3,6,3,6,0,0,2,2,1,3,0,2,0,2,0,8
7624,791768,17,2,3,2,3,0,0,2,2,0,5,1,1,0,0,0,6
7624,791767,10,2,2,2,2,0,0,0,0,0,0,0,1,1,0,1,4
7624,780603,16,0,3,0,1,0,2,0,0,0,0,1,1,0,1,0,0
7624,786071,11,0,2,0,2,0,0,0,0,1,1,2,2,0,0,2,0
7625,780138,30,11,17,11,17,0,0,6,11,7,3,3,3,2,3,0,28
7625,780581,36,7,11,4,6,3,5,0,0,0,3,6,2,0,4,0,17
7625,786014,27,4,8,4,7,0,1,0,1,1,1,4,4,0,0,0,8
7625,792158,13,3,7,3,7,0,0,2,4,0,1,1,4,1,1,2,8
7625,792154,22,0,4,0,2,0,2,0,2,0,2,0,4,0,1,0,0
7625,792152,31,9,11,9,11,0,0,6,9,1,1,3,0,3,2,0,24
7625,797755,22,1,3,1,3,0,0,0,0,2,3,0,1,2,0,1,2
7625,792157,16,1,1,1,1,0,0,0,0,1,1,1,4,0,3,3,2
7625,792159,3,0,0,0,0,0,0,0,0,0,1,0,0,0,0,0,0
7626,797824,24,4,6,3,3,1,3,2,2,2,3,0,2,2,1,0,11
7626,775116,23,2,5,2,3,0,2,2,5,1,4,3,2,2,1,2,6
7626,797822,31,6,18,4,7,2,11,2,2,2,4,2,4,2,5,0,16
7626,792190,33,2,7,1,4,1,3,2,2,0,1,7,1,3,5,0,7
7626,786664,36,10,16,8,10,2,6,1,2,0,1,2,0,1,3,0,23
7626,797825,18,2,2,2,2,0,0,2,4,1,4,0,3,2,0,1,6
7626,792191,17,0,4,0,2,0,2,2,4,4,2,4,0,0,2,0,2
7626,791928,15,0,1,0,1,0,0,1,2,0,0,1,1,2,0,1,1
7626,781266,1,0,0,0,0,0,0,0,0,0,1,0,0,0,0,0,0
7626,797828,2,0,0,0,0,0,0,0,0,0,0,0,0,0,0,0,0
7627,791230,24,6,8,1,1,5,7,1,2,0,3,1,1,1,0,0,18
7627,785557,23,5,9,4,8,1,1,2,2,2,3,0,0,1,1,1,13
7627,791228,23,5,6,5,6,0,0,0,1,1,4,3,3,1,1,0,10
7627,796932,24,2,6,1,3,1,3,2,2,1,0,6,2,0,5,0,7
7627,785624,21,2,4,1,2,1,2,0,0,0,1,5,2,2,4,1,5
7627,796935,15,3,7,0,2,3,5,0,0,0,0,0,2,0,0,0,9
7627,796933,13,3,4,3,4,0,0,0,0,1,3,2,1,0,0,0,6
7627,791226,17,2,3,2,3,0,0,3,4,0,3,0,3,0,2,1,7
7627,791229,3,0,0,0,0,0,0,1,2,0,0,0,1,0,1,0,1
7627,791227,20,3,7,2,3,1,4,0,0,0,5,2,2,2,2,0,7
7627,781201,8,0,0,0,0,0,0,0,2,0,0,3,0,0,0,0,0
7627,781198,9,0,1,0,0,0,1,0,0,0,3,4,0,1,1,0,0
7628,797174,23,5,8,4,6,1,2,1,2,0,2,1,2,0,1,0,12
7628,791510,19,1,2,0,0,1,2,3,4,0,1,1,1,0,1,1,6
7628,786699,21,4,5,4,5,0,0,3,4,0,4,0,0,0,1,2,11
7628,785593,23,2,7,1,3,1,4,0,0,0,4,3,3,3,0,0,5
7628,775357,34,7,13,0,1,7,12,0,0,0,6,5,2,1,1,0,21
7628,791507,19,3,5,3,5,0,0,5,5,3,4,0,2,0,1,1,11
7628,797168,26,2,9,2,7,0,2,0,2,0,2,5,2,0,2,0,4
7628,791504,25,2,8,2,8,0,0,1,2,3,0,1,0,1,0,0,5
7628,791505,9,3,4,1,2,2,2,0,0,1,1,1,2,2,2,0,8
7628,791509,1,0,0,0,0,0,0,0,0,0,0,0,0,0,0,0,0
7629,780023,32,3,5,3,5,0,0,0,0,2,5,0,3,0,3,2,6
7629,792493,23,0,5,0,1,0,4,0,0,0,1,0,2,0,0,0,0
7629,792495,39,8,18,4,8,4,10,4,5,0,5,2,3,1,5,2,24
7629,792491,36,4,10,3,9,1,1,5,6,1,9,5,2,1,2,1,14
7629,781144,38,8,12,3,5,5,7,0,0,0,3,1,1,0,2,0,21
7629,798959,14,1,2,0,0,1,2,0,0,0,1,0,0,0,0,1,3
7629,786832,18,1,4,1,2,0,2,3,4,1,3,1,3,2,2,0,5
7630,786646,27,4,7,2,2,2,5,0,0,2,5,0,1,1,1,0,10
7630,780890,23,2,8,1,3,1,5,2,2,1,3,3,0,1,0,1,7
7630,786066,34,4,8,4,7,0,1,2,2,2,6,3,2,0,5,0,10
7630,780167,29,0,4,0,2,0,2,6,8,1,1,2,3,0,2,0,6
7630,775574,34,2,9,0,2,2,7,0,0,0,1,2,3,1,3,3,6
7630,775757,11,0,1,0,1,0,0,3,4,0,3,0,3,0,1,0,3
7630,791123,11,0,1,0,0,0,1,0,0,0,0,1,1,0,0,0,0
7630,785636,31,4,8,1,2,3,6,0,0,1,4,1,1,1,0,0,11
7631,791220,20,2,2,2,2,0,0,1,2,4,3,1,4,1,2,0,5
7631,791219,34,2,9,2,6,0,3,0,0,0,2,0,2,2,0,0,4
7631,776217,29,4,8,4,8,0,0,0,2,3,3,1,3,3,3,1,8
7631,790818,37,1,9,1,8,0,1,1,2,0,7,3,3,0,0,0,3
7631,780730,34,6,13,4,8,2,5,5,7,2,1,1,2,0,3,1,19
7631,786824,20,2,6,2,4,0,2,0,0,1,2,0,1,0,1,0,4
7631,791221,8,0,2,0,1,0,1,0,0,0,3,0,2,0,1,0,0
7631,796923,3,0,0,0,0,0,0,2,2,1,1,0,0,0,0,0,2
7631,786396,15,1,5,1,4,0,1,4,4,1,1,0,0,0,0,0,6
7631,796921,0,0,0,0,0,0,0,0,0,0,0,0,0,0,0,0,0
7632,792284,28,1,6,0,2,1,4,2,2,1,4,3,5,0,2,0,5
7632,792280,38,2,9,1,3,1,6,7,8,1,6,7,1,0,4,0,12
7632,797823,25,4,9,4,7,0,2,1,1,2,6,0,3,1,4,2,9
7632,792283,23,1,5,1,4,0,1,0,0,2,1,2,1,0,1,0,2
7632,797829,26,4,7,4,7,0,0,5,5,0,2,1,4,0,2,2,13
7632,797826,8,0,1,0,1,0,0,0,0,0,1,0,2,1,3,0,0
7632,785950,30,5,5,3,3,2,2,2,2,1,5,1,1,0,0,1,14
7632,799468,6,1,3,1,1,0,2,0,0,0,0,0,0,0,0,0,2
7632,797831,16,2,4,0,0,2,4,0,0,0,4,2,0,0,1,0,6
7632,797833,0,0,0,0,0,0,0,0,0,0,0,0,1,0,0,0,0
7633,791967,38,13,20,10,17,3,3,0,0,2,2,3,1,2,2,0,29
7633,786769,34,2,5,0,2,2,3,1,2,0,4,2,2,1,2,0,7
7633,786024,39,7,16,6,10,1,6,3,4,1,6,7,2,1,0,0,18
7633,786772,16,1,2,1,2,0,0,4,6,1,1,0,4,1,1,0,6
7633,781484,34,1,10,1,6,0,4,0,0,0,2,2,5,2,1,2,2
7633,790823,27,1,5,0,2,1,3,0,0,0,3,1,0,1,0,1,3
7633,797840,9,0,2,0,1,0,1,0,2,1,0,0,0,0,0,0,0
7633,786773,3,0,0,0,0,0,0,0,0,0,0,0,2,0,0,0,0
7640,785509,24,1,3,1,1,0,2,0,0,1,4,0,1,1,0,1,2
7640,791424,25,6,9,6,9,0,0,3,3,2,3,3,2,0,1,2,15
7640,797085,32,1,5,0,1,1,4,4,6,0,4,4,0,1,5,0,7
7640,791421,28,3,7,2,3,1,4,6,10,0,4,5,2,1,6,0,13
7640,785899,31,6,7,3,3,3,4,4,5,2,3,3,1,3,2,1,19
7640,797079,10,0,1,0,1,0,0,1,2,1,1,2,3,0,1,0,1
7640,797081,2,0,0,0,0,0,0,0,0,0,1,0,0,0,0,0,0
7640,791425,17,4,7,4,7,0,0,3,4,4,6,0,1,0,0,2,11
7640,797086,6,0,1,0,0,0,1,0,0,0,1,0,2,0,0,0,0
7640,797090,2,1,1,1,1,0,0,0,0,0,0,0,0,0,0,0,2
7640,797084,1,0,0,0,0,0,0,0,0,0,1,1,0,0,0,0,0
7640,797083,5,0,2,0,0,0,2,0,0,0,1,0,1,0,0,0,0
7640,797078,1,0,0,0,0,0,0,0,0,0,0,0,1,0,0,0,0
7640,797088,16,5,8,1,1,4,7,0,0,0,3,0,1,0,1,1,14
7642,791723,24,2,4,2,4,0,0,0,0,3,1,1,2,1,0,1,4
7642,797310,37,2,7,2,5,0,2,2,2,0,4,4,1,1,2,0,6
7642,791724,36,5,13,3,8,2,5,0,0,2,3,2,1,1,2,1,12
7642,797308,20,0,2,0,1,0,1,2,4,0,2,0,1,0,0,1,2
7642,781617,30,5,9,3,4,2,5,5,7,0,7,2,2,0,2,1,17
7642,797312,12,1,3,1,2,0,1,2,4,1,1,0,3,0,0,1,4
7642,780956,20,2,8,2,5,0,3,2,4,0,1,0,1,2,0,0,6
7642,780706,17,1,3,0,2,1,1,3,5,0,1,0,0,0,0,0,6
7642,800056,2,0,1,0,1,0,0,0,0,0,0,0,2,0,0,0,0
7642,786277,2,0,0,0,0,0,0,0,0,0,0,0,0,0,0,0,0
7643,791669,33,4,5,4,5,0,0,2,2,2,5,1,1,1,2,0,10
7643,785762,36,10,17,7,14,3,3,5,7,3,11,3,2,0,0,2,28
7643,797407,11,0,3,0,2,0,1,0,2,0,0,4,2,0,0,0,0
7643,791666,33,6,10,6,7,0,3,2,2,0,0,4,1,3,0,0,14
7643,780531,32,6,10,0,1,6,9,0,0,0,6,4,3,0,2,0,18
7643,797414,4,0,0,0,0,0,0,2,2,1,0,0,2,0,0,0,2
7643,780534,5,0,0,0,0,0,0,0,2,1,2,0,2,0,1,0,0
7643,797409,27,3,6,1,2,2,4,0,0,0,3,4,2,0,2,0,8
7643,785760,11,1,4,0,1,1,3,1,2,1,0,1,1,0,1,0,4
7643,797411,2,0,1,0,1,0,0,0,0,1,0,0,0,0,0,0,0
7643,791671,2,0,1,0,1,0,0,0,2,0,1,1,0,0,0,0,0
7643,780535,2,1,1,1,1,0,0,0,0,0,0,0,0,0,0,0,2
7643,797415,2,0,0,0,0,0,0,0,0,0,1,0,0,0,0,0,0
7644,797466,22,3,7,3,7,0,0,1,1,0,2,0,3,0,0,0,7
7644,791858,33,0,1,0,0,0,1,0,0,1,4,4,3,1,4,0,0
7644,797463,37,8,18,5,10,3,8,3,3,2,6,4,2,0,3,1,22
7644,791109,30,8,10,8,10,0,0,7,12,0,0,1,3,2,3,0,23
7644,785625,22,4,7,3,5,1,2,0,0,1,2,1,3,1,0,0,9
7644,797464,20,2,6,2,4,0,2,0,0,1,3,0,0,1,1,0,4
7644,797467,2,0,0,0,0,0,0,0,0,0,0,0,0,0,1,0,0
7644,797469,3,0,0,0,0,0,0,0,0,0,0,0,1,1,0,0,0
7644,797465,23,3,4,3,4,0,0,2,2,1,0,1,1,6,2,0,8
7644,791854,8,1,2,1,1,0,1,0,0,1,1,0,0,0,0,0,2
7645,785948,37,6,10,6,10,0,0,3,3,0,4,2,2,1,3,2,15
7645,785946,4,0,0,0,0,0,0,0,0,0,0,0,0,0,1,0,0
7645,792020,23,3,5,2,2,1,3,0,0,0,2,2,1,0,2,0,7
7645,785939,38,6,16,6,11,0,5,7,7,0,2,2,3,2,2,0,19
7645,785938,26,2,5,1,1,1,4,0,0,0,0,2,3,1,5,0,5
7645,792026,18,2,3,2,3,0,0,0,0,0,2,0,2,1,2,1,4
7645,792025,21,5,7,5,7,0,0,0,0,1,5,0,0,0,0,0,10
7645,797634,13,1,1,0,0,1,1,0,0,0,1,0,2,2,2,0,3
7645,792023,20,1,3,1,2,0,1,0,0,0,3,3,5,3,1,0,2
7646,780598,24,3,8,2,4,1,4,0,0,1,1,0,1,0,0,0,7
7646,781300,28,6,10,5,8,1,2,2,2,0,5,3,2,2,1,0,15
7646,790801,19,0,4,0,2,0,2,0,0,1,2,3,0,0,1,0,0
7646,781305,13,1,3,0,0,1,3,2,3,0,1,0,0,0,0,0,5
7646,781304,29,6,12,1,6,5,6,0,0,0,6,0,2,1,0,0,17
7646,796360,24,3,6,3,6,0,0,1,3,1,1,6,2,2,0,0,7
7646,781302,15,3,5,2,3,1,2,1,1,0,0,2,1,2,1,0,8
7646,796364,8,1,1,1,1,0,0,2,2,1,3,0,0,0,1,1,4
7646,790803,14,3,3,2,2,1,1,2,2,1,2,0,0,0,0,1,9
7646,796363,19,2,3,0,0,2,3,0,0,0,2,2,3,1,1,0,6
7646,796362,2,0,1,0,1,0,0,0,0,0,1,0,1,0,0,0,0
7646,790802,2,1,1,0,0,1,1,0,0,0,0,0,0,0,0,0,3
7646,781303,1,0,0,0,0,0,0,0,0,0,0,1,0,0,0,0,0
7646,776372,1,0,1,0,1,0,0,0,0,0,0,0,0,1,0,0,0
7646,776366,1,0,0,0,0,0,0,0,0,1,0,0,0,0,0,0,0
7647,775510,30,3,7,1,2,2,5,3,3,0,5,0,3,1,2,0,11
7647,774976,32,2,6,2,3,0,3,0,0,0,2,1,3,0,3,2,4
7647,797865,30,0,4,0,3,0,1,0,0,0,2,3,1,0,0,1,0
7647,786614,32,5,10,2,3,3,7,0,0,1,4,3,1,0,1,0,13
7647,786759,37,5,7,5,7,0,0,2,5,0,3,4,0,1,3,0,12
7647,792291,12,4,5,1,1,3,4,1,2,0,1,1,2,1,2,0,12
7647,792293,12,1,3,1,2,0,1,1,2,1,1,2,3,0,1,0,3
7647,792292,5,0,0,0,0,0,0,0,0,0,1,0,2,0,0,0,0
7647,792294,6,2,4,1,3,1,1,0,0,2,0,0,0,0,0,0,5
7647,797864,2,0,1,0,0,0,1,0,0,0,0,0,0,0,1,0,0
7647,786762,1,0,0,0,0,0,0,0,0,0,0,0,0,0,0,1,0
7647,797867,1,0,0,0,0,0,0,0,0,0,0,0,0,0,0,0,0
7654,790884,24,7,8,7,8,0,0,1,2,1,4,1,1,2,1,1,15
7654,791635,14,0,2,0,0,0,2,1,2,0,0,3,0,0,3,0,1
7654,796438,37,3,5,0,1,3,4,1,2,0,4,3,2,4,0,1,10
7654,790883,35,3,11,3,9,0,2,2,2,0,7,5,3,1,2,0,8
7654,796436,37,7,12,3,6,4,6,3,4,1,4,7,3,3,4,1,21
7654,781262,17,0,5,0,0,0,5,0,0,0,3,1,0,0,1,0,0
7654,796439,26,8,14,8,14,0,0,3,3,4,4,0,2,3,1,1,19
7654,796442,10,1,3,1,3,0,0,0,0,1,1,0,3,0,1,0,2
7655,781480,37,4,13,3,8,1,5,0,0,2,5,3,4,1,3,3,9
7655,774846,26,1,5,1,5,0,0,4,4,0,2,0,1,0,1,0,6
7655,797273,22,0,6,0,4,0,2,2,2,0,2,2,0,1,3,0,2
7655,786558,35,6,14,5,11,1,3,2,3,0,6,2,2,0,3,0,15
7655,766611,33,5,11,2,2,3,9,4,5,1,1,1,3,1,2,0,17
7655,786185,14,1,3,1,3,0,0,0,0,2,4,0,2,0,0,3,2
7655,791376,21,2,3,1,1,1,2,2,2,0,1,0,1,3,3,0,7
7655,797272,12,0,2,0,0,0,2,0,0,0,0,1,1,0,1,0,0
7656,781516,12,3,7,3,7,0,0,0,0,2,0,0,1,0,4,4,6
7656,797331,38,8,13,3,6,5,7,1,2,1,3,3,3,1,2,0,22
7656,791737,29,4,8,4,7,0,1,3,3,2,3,2,2,3,3,0,11
7656,783524,39,3,8,3,4,0,4,8,12,0,4,6,1,3,3,0,14
7656,780561,30,2,6,1,2,1,4,4,4,2,6,1,1,4,2,1,9
7656,791734,21,4,7,3,6,1,1,3,8,3,0,1,4,0,0,0,12
7656,797332,8,1,1,1,1,0,0,1,2,1,4,0,3,0,3,0,3
7656,797333,27,3,6,3,4,0,2,0,0,3,1,2,4,1,3,0,6
7656,795372,2,0,0,0,0,0,0,0,0,0,0,0,1,0,0,0,0
7656,786223,19,1,4,1,2,0,2,1,2,0,3,0,1,1,1,0,3
7657,791306,15,2,3,1,1,1,2,1,1,0,0,1,4,2,1,1,6
7657,780210,45,8,20,7,16,1,4,12,14,9,8,2,1,0,5,3,29
7657,796594,31,3,9,0,4,3,5,0,0,0,0,1,2,0,0,0,9
7657,792432,38,2,6,2,4,0,2,2,2,1,2,8,2,0,8,0,6
7657,775005,32,6,10,4,7,2,3,7,7,1,4,0,5,2,2,0,21
7657,796592,30,1,2,1,2,0,0,0,0,1,4,2,5,4,2,0,2
7657,792433,27,3,8,1,3,2,5,0,0,0,0,2,5,5,1,0,8
7657,786422,7,0,2,0,2,0,0,0,0,0,0,0,0,0,2,0,0
7658,790839,30,0,2,0,2,0,0,8,8,1,3,3,0,1,2,0,8
7658,785388,31,13,21,13,21,0,0,2,6,1,5,3,3,1,2,1,28
7658,790840,26,1,4,1,1,0,3,0,0,0,4,0,3,2,0,1,2
7658,796395,27,4,10,3,7,1,3,2,4,2,3,3,3,1,1,2,11
7658,785386,31,6,8,4,5,2,3,1,1,0,1,1,0,0,0,0,15
7658,796393,8,4,8,4,8,0,0,2,3,4,1,0,4,0,1,1,10
7658,780370,12,0,0,0,0,0,0,1,2,0,1,0,2,0,0,0,1
7658,790841,9,0,1,0,0,0,1,0,0,0,0,0,2,0,0,0,0
7658,780373,24,0,3,0,1,0,2,0,0,0,0,1,2,1,0,1,0
7658,796396,2,0,0,0,0,0,0,0,0,0,1,1,1,0,0,0,0
7659,790827,12,0,0,0,0,0,0,3,4,3,3,0,1,0,0,0,3
7659,785375,3,0,0,0,0,0,0,0,0,0,0,0,3,0,0,1,0
7659,785372,35,6,12,5,9,1,3,2,2,2,3,4,2,0,2,1,15
7659,796385,26,2,4,2,4,0,0,0,3,0,5,0,2,0,2,0,4
7659,774905,32,3,11,2,8,1,3,2,2,1,2,1,4,0,3,0,9
7659,785374,11,1,2,1,2,0,0,0,0,1,0,1,4,0,0,0,2
7659,786384,29,3,5,0,0,3,5,2,2,1,3,2,3,2,6,0,11
7659,790828,19,4,6,4,6,0,0,2,4,1,2,0,4,0,0,0,10
7659,785373,13,2,7,0,3,2,4,0,0,0,3,0,0,0,0,0,6
7659,796387,6,2,2,2,2,0,0,1,1,2,2,0,0,0,0,0,5
7659,790825,12,0,3,0,2,0,1,0,0,0,0,4,2,0,2,0,0
7659,785371,2,0,0,0,0,0,0,0,0,0,1,0,0,0,1,0,0
7660,791302,29,4,12,2,9,2,3,5,5,2,6,2,2,0,3,2,15
7660,781622,25,2,5,1,2,1,3,0,0,0,0,0,1,0,0,0,5
7660,791309,38,4,9,3,6,1,3,3,5,0,7,6,4,1,5,0,12
7660,785835,16,0,1,0,0,0,1,0,0,0,2,1,1,0,1,2,0
7660,776334,35,6,7,4,5,2,2,2,2,0,5,1,2,0,1,0,16
7660,775862,16,6,10,6,10,0,0,1,2,2,1,1,2,0,0,1,13
7660,796602,2,0,0,0,0,0,0,0,0,0,0,0,0,0,1,0,0
7660,796601,21,2,7,2,5,0,2,6,8,2,3,3,2,4,1,0,10
7660,791304,18,2,2,1,1,1,1,4,4,0,2,0,3,2,0,0,9
7661,790863,31,8,15,8,11,0,4,5,6,1,4,1,2,1,1,2,21
7661,780099,26,4,8,2,4,2,4,1,1,3,4,0,4,3,2,0,11
7661,785412,23,4,13,3,6,1,7,2,2,1,0,4,1,0,4,0,11
7661,775686,20,2,5,1,3,1,2,2,2,3,2,2,3,0,0,1,7
7661,776214,37,4,10,3,5,1,5,0,0,0,4,2,4,2,4,0,9
7661,785417,21,2,3,1,2,1,1,2,2,0,2,3,1,1,0,3,7
7661,785413,21,2,5,2,4,0,1,0,0,1,3,0,3,0,1,0,4
7661,785411,5,0,1,0,0,0,1,0,0,0,0,0,2,0,0,0,0
7661,776221,16,0,1,0,0,0,1,0,2,0,2,2,2,0,1,1,0
7662,781407,31,3,11,2,7,1,4,3,6,1,9,1,4,1,1,0,10
7662,791583,33,6,12,6,12,0,0,4,8,6,6,2,5,0,3,0,16
7662,797445,40,6,8,1,1,5,7,1,2,2,1,1,3,0,0,0,18
7662,780580,45,4,17,4,13,0,4,12,16,0,5,7,3,4,2,1,20
7662,776150,45,7,12,6,10,1,2,2,3,3,3,4,1,1,0,0,17
7662,797448,8,0,1,0,0,0,1,0,0,1,1,0,1,0,0,0,0
7662,786608,14,2,5,2,4,0,1,0,0,1,3,0,2,0,1,0,4
7662,786110,12,0,3,0,1,0,2,0,0,0,1,0,1,0,0,0,0
7662,785623,22,2,7,2,2,0,5,2,3,1,4,1,3,2,1,2,6
7663,799906,42,3,11,3,5,0,6,0,1,2,6,2,3,0,4,0,6
7663,775833,15,2,2,2,2,0,0,1,2,1,5,0,5,0,2,0,5
7663,785439,14,0,5,0,1,0,4,0,0,0,1,0,1,1,1,0,0
7663,781036,41,7,18,7,14,0,4,8,11,1,4,5,4,0,3,0,22
7663,774894,48,6,14,3,7,3,7,1,4,1,5,2,2,0,1,0,16
7663,796846,14,1,3,1,2,0,1,2,2,1,2,0,2,0,0,0,4
7663,796847,40,9,10,7,8,2,2,9,11,2,7,1,5,1,3,1,29
7663,775571,36,2,4,2,2,0,2,3,6,0,3,4,5,1,2,0,7
7664,780406,17,1,3,1,2,0,1,0,0,1,1,1,1,0,2,0,2
7664,775087,28,5,11,5,8,0,3,0,0,2,4,1,3,0,6,2,10
7664,785296,31,4,9,1,3,3,6,0,0,1,5,6,3,1,7,0,11
7664,780212,35,5,9,4,4,1,5,0,0,0,2,1,1,0,2,0,11
7664,767245,30,3,7,3,7,0,0,5,6,4,4,1,2,1,5,2,11
7664,780215,10,3,4,3,4,0,0,0,0,1,3,0,2,0,1,1,6
7664,790984,24,1,5,1,2,0,3,0,0,0,3,4,3,0,0,0,2
7664,785297,25,4,8,3,3,1,5,0,0,0,2,0,1,0,0,0,9
7665,780291,36,5,13,5,11,0,2,1,1,2,2,1,2,2,4,4,11
7665,785607,11,1,4,1,4,0,0,0,0,0,1,0,2,0,1,0,2
7665,796665,28,7,13,3,4,4,9,3,3,1,2,2,2,1,0,0,21
7665,785333,32,1,7,1,5,0,2,1,1,7,3,3,1,1,1,0,3
7665,775305,33,11,17,9,12,2,5,3,4,0,3,3,1,3,4,0,27
7665,796663,2,0,0,0,0,0,0,0,0,0,0,0,0,0,0,0,0
7665,791004,24,2,7,1,2,1,5,2,4,3,2,2,1,0,0,0,7
7665,791006,5,0,2,0,1,0,1,0,0,1,0,0,0,0,0,0,0
7665,796666,9,0,2,0,1,0,1,0,0,2,0,0,2,0,0,0,0
7665,796664,20,2,9,2,7,0,2,0,0,1,6,1,1,2,1,0,4
7666,791585,32,3,5,1,2,2,3,1,2,0,8,0,0,0,3,3,9
7666,791581,21,0,5,0,3,0,2,0,0,1,3,3,0,1,1,0,0
7666,786395,34,5,13,3,3,2,10,2,2,0,3,2,2,1,4,0,14
7666,786394,34,8,15,7,9,1,6,4,4,1,10,0,3,1,4,0,21
7666,780404,33,1,5,0,2,1,3,2,2,1,5,2,2,1,2,0,5
7666,780062,11,0,2,0,2,0,0,0,0,1,2,0,0,1,1,0,0
7666,785228,27,6,7,3,3,3,4,0,0,1,4,1,3,0,1,0,15
7666,780403,5,0,0,0,0,0,0,0,0,1,0,1,3,0,1,0,0
7666,797041,1,0,1,0,0,0,1,0,0,0,1,0,0,0,0,0,0
7666,791582,1,0,0,0,0,0,0,0,0,0,0,0,0,0,0,0,0
7666,797037,1,0,0,0,0,0,0,0,0,0,0,0,0,0,0,0,0
7667,781007,8,1,2,1,1,0,1,0,0,0,3,1,0,1,1,0,2
7667,781322,28,2,7,0,2,2,5,0,0,0,3,1,3,1,1,1,6
7667,785989,31,3,8,1,3,2,5,2,2,0,4,3,3,1,3,1,10
7667,786571,28,2,8,1,3,1,5,0,0,0,0,0,2,3,2,0,5
7667,781439,35,7,15,5,9,2,6,2,4,0,5,1,1,1,1,0,18
7667,781419,22,1,3,0,1,1,2,0,0,0,1,1,1,2,0,0,3
7667,797299,10,0,1,0,1,0,0,0,2,1,3,0,1,2,2,0,0
7667,780563,15,0,3,0,1,0,2,0,0,0,2,1,2,1,0,0,0
7667,781207,15,2,6,2,5,0,1,1,2,1,2,0,3,1,0,0,5
7667,784248,2,0,1,0,0,0,1,0,0,0,1,0,0,0,0,0,0
7667,797300,1,0,0,0,0,0,0,0,0,0,0,0,0,0,1,0,0
7667,791691,1,0,0,0,0,0,0,1,2,0,0,0,0,0,0,0,1
7667,791692,1,0,0,0,0,0,0,0,0,0,0,0,0,0,0,0,0
7667,791690,3,0,0,0,0,0,0,0,0,0,0,0,0,0,0,0,0
7668,786180,12,0,0,0,0,0,0,0,0,1,0,1,0,0,0,0,0
7668,792104,29,6,11,4,5,2,6,7,7,0,5,1,0,1,0,0,21
7668,797709,17,1,7,0,2,1,5,0,0,0,4,0,1,0,0,1,3
7668,797708,33,7,15,6,10,1,5,0,0,3,5,9,2,3,0,0,15
7668,775779,33,5,8,5,7,0,1,7,11,0,3,4,4,1,5,0,17
7668,786204,21,6,9,2,4,4,5,0,0,2,7,2,1,0,2,0,16
7668,786198,21,3,7,1,3,2,4,0,0,0,1,3,4,0,0,1,8
7668,797707,15,1,3,1,1,0,2,0,0,0,2,3,2,0,4,0,2
7668,785608,19,5,6,4,5,1,1,0,0,1,4,1,1,0,0,0,11
7669,791949,35,10,16,8,12,2,4,0,0,1,9,1,1,0,0,0,22
7669,776014,24,1,3,1,1,0,2,1,2,1,1,2,2,0,0,1,3
7669,785304,22,2,10,1,3,1,7,0,0,0,1,2,1,1,2,0,5
7669,780747,35,5,13,4,7,1,6,3,4,1,5,6,4,1,3,0,14
7669,776363,36,4,14,2,3,2,11,4,5,3,4,6,2,0,2,0,14
7669,797689,11,1,3,0,0,1,3,0,0,0,0,0,0,0,0,0,3
7669,797691,5,0,1,0,1,0,0,0,0,0,0,0,1,0,0,0,0
7669,797690,26,6,9,3,4,3,5,5,5,2,4,0,4,2,1,0,20
7669,791946,6,1,4,0,2,1,2,0,0,0,0,2,1,2,0,0,3
7670,780651,23,3,4,3,4,0,0,0,4,1,3,0,0,0,2,0,6
7670,791815,22,8,10,5,6,3,4,0,0,0,1,1,2,1,1,0,19
7670,791814,29,1,7,0,1,1,6,0,0,1,0,3,1,0,1,0,3
7670,786645,21,4,7,3,5,1,2,3,4,2,3,1,2,2,0,0,12
7670,780650,37,6,13,5,10,1,3,3,3,5,10,8,0,2,2,0,16
7670,791809,7,1,1,1,1,0,0,2,2,0,1,0,1,0,0,1,4
7670,797374,2,0,0,0,0,0,0,0,0,0,0,0,0,0,0,0,0
7670,791812,16,0,4,0,3,0,1,0,2,1,1,1,0,0,1,0,0
7670,781596,10,3,3,3,3,0,0,2,2,1,0,3,3,0,0,0,8
7670,797373,10,1,2,1,2,0,0,0,0,1,1,2,1,0,3,0,2
7670,797372,7,3,3,3,3,0,0,0,0,0,1,0,0,0,0,0,6
7670,786644,16,1,5,1,2,0,3,0,0,0,1,1,0,1,1,0,2
7671,780122,16,1,5,1,3,0,2,2,2,0,1,0,1,1,1,0,4
7671,797215,32,10,18,8,9,2,9,0,0,0,1,1,1,3,0,0,22
7671,791461,29,2,5,2,3,0,2,0,2,2,2,1,1,0,0,0,4
7671,791460,12,0,1,0,0,0,1,0,0,1,1,0,0,1,3,0,0
7671,786295,32,6,12,5,7,1,5,0,0,3,3,1,1,0,1,0,13
7671,797216,16,1,1,1,1,0,0,0,0,4,2,1,4,0,1,0,2
7671,786299,17,0,1,0,1,0,0,0,0,1,3,0,1,0,0,0,0
7671,797214,24,3,9,2,6,1,3,0,2,2,1,1,2,2,2,0,7
7671,780792,22,2,10,1,4,1,6,0,0,1,1,0,2,0,3,0,5
7676,790935,24,3,6,0,1,3,5,2,2,0,2,0,0,0,1,1,11
7676,792442,17,0,2,0,2,0,0,2,2,2,6,0,2,1,1,2,2
7676,780933,35,6,13,0,2,6,11,4,4,1,2,1,1,1,1,0,22
7676,775340,33,4,15,3,9,1,6,10,10,1,0,7,3,1,4,0,19
7676,774826,24,1,6,1,3,0,3,2,4,0,3,0,0,0,1,0,4
7676,796190,5,0,0,0,0,0,0,0,0,0,1,0,0,0,0,0,0
7676,790937,21,2,3,2,3,0,0,4,4,2,3,1,1,0,1,1,8
7676,785445,16,4,5,3,3,1,2,1,3,0,5,2,3,0,1,2,10
7676,790938,18,0,2,0,1,0,1,5,6,3,1,1,0,1,1,1,5
7676,796492,7,0,0,0,0,0,0,0,0,0,1,0,2,0,1,0,0
7677,791903,16,2,5,1,3,1,2,0,0,1,1,0,1,0,0,0,5
7677,797575,14,1,3,1,3,0,0,0,0,0,0,0,5,0,0,0,2
7677,791899,36,8,17,7,15,1,2,3,4,8,5,7,4,2,3,0,20
7677,786512,35,3,14,2,8,1,6,0,1,1,7,4,1,2,2,1,7
7677,786435,29,3,9,2,6,1,3,0,0,1,4,1,2,0,3,0,7
7677,797574,27,8,11,3,3,5,8,0,0,2,1,0,3,1,0,0,21
7677,797573,14,4,5,4,5,0,0,2,2,3,0,0,5,0,1,0,10
7677,786513,7,1,2,1,1,0,1,0,0,0,0,0,3,0,1,0,2
7677,797571,22,1,7,1,7,0,0,0,0,1,2,2,3,0,2,0,2
7678,796812,11,1,2,1,2,0,0,0,0,0,4,0,3,0,3,1,2
7678,780952,26,2,5,2,5,0,0,0,2,2,4,2,4,1,1,3,4
7678,796814,21,1,2,1,2,0,0,0,0,2,1,0,4,0,1,0,2
7678,786609,36,8,16,6,13,2,3,0,0,4,3,0,1,0,1,0,18
7678,796810,35,5,13,4,10,1,3,2,2,0,4,5,2,1,2,0,13
7678,791155,25,7,13,7,12,0,1,4,5,1,3,2,2,2,2,0,18
7678,780950,20,3,8,1,3,2,5,1,1,0,0,1,0,1,1,0,9
7678,791156,15,0,0,0,0,0,0,0,0,0,2,2,2,0,0,0,0
7678,780945,10,2,3,2,3,0,0,3,4,4,3,0,3,0,2,2,7
7678,791154,1,0,0,0,0,0,0,0,0,0,0,0,0,0,0,0,0
7679,781046,32,2,8,1,6,1,2,4,5,2,3,1,0,0,1,1,9
7679,780025,25,3,9,3,9,0,0,0,2,5,1,1,2,1,0,0,6
7679,796391,29,5,11,5,9,0,2,4,4,0,3,0,2,0,1,0,14
7679,785385,34,3,5,1,1,2,4,1,1,0,1,1,4,2,4,0,9
7679,785383,32,3,16,2,13,1,3,4,4,0,3,2,3,0,2,0,11
7679,790837,25,2,5,2,4,0,1,2,3,2,3,2,2,1,0,1,6
7679,786297,9,1,2,1,2,0,0,0,0,0,2,0,3,0,1,0,2
7679,786228,14,2,2,2,2,0,0,0,1,0,1,2,1,0,1,0,4
7680,796959,26,3,4,3,4,0,0,3,4,1,3,0,2,1,1,2,9
7680,781272,40,2,7,2,4,0,3,1,2,3,8,6,3,1,2,4,5
7680,796958,20,1,6,1,4,0,2,0,0,3,2,0,5,1,3,2,2
7680,791261,36,12,17,5,7,7,10,3,5,4,7,0,2,2,2,0,34
7680,781270,36,5,18,4,10,1,8,5,7,0,1,2,2,1,5,0,16
7680,791260,3,0,1,0,1,0,0,0,0,0,0,0,0,0,0,0,0
7680,785503,1,0,1,0,1,0,0,0,0,0,0,0,0,0,0,0,0
7680,791258,24,2,4,0,0,2,4,0,0,2,2,1,4,0,1,0,6
7680,785501,14,1,5,0,2,1,3,0,0,0,1,2,0,0,1,0,3
7681,797701,20,3,4,3,4,0,0,0,0,0,2,6,2,1,2,0,6
7681,792101,16,0,4,0,2,0,2,0,0,0,0,2,0,1,0,0,0
7681,780923,34,5,15,3,10,2,5,10,13,1,4,6,1,1,2,0,22
7681,775564,33,9,16,6,11,3,5,4,4,4,4,2,1,1,0,0,25
7681,776386,25,6,9,3,5,3,4,4,4,1,5,1,2,2,2,0,19
7681,797700,20,0,4,0,3,0,1,1,2,3,4,1,1,1,0,0,1
7681,780922,22,1,4,1,2,0,2,2,2,5,7,1,5,2,2,1,4
7681,792102,24,2,6,0,1,2,5,0,0,0,0,0,3,0,2,0,6
7681,786160,6,0,3,0,2,0,1,0,0,0,0,1,0,0,1,0,0
7682,785913,9,1,2,1,2,0,0,0,0,1,1,1,4,0,2,0,2
7682,786516,28,4,8,2,4,2,4,0,0,0,2,0,0,0,0,0,10
7682,798058,16,0,4,0,3,0,1,0,0,0,1,2,1,0,0,0,0
7682,781502,33,4,8,3,4,1,4,8,9,0,1,3,1,1,0,0,17
7682,780259,30,4,9,3,4,1,5,4,4,0,1,1,5,4,2,0,13
7682,792277,7,1,3,1,3,0,0,0,0,1,1,0,0,0,0,0,2
7682,785282,20,3,8,1,3,2,5,0,0,1,2,1,1,1,0,0,8
7682,781501,24,5,10,5,7,0,3,1,2,5,2,1,2,1,0,0,11
7682,781464,23,0,1,0,0,0,1,5,8,1,5,4,2,1,1,0,5
7682,792274,10,2,3,2,3,0,0,0,0,1,0,0,1,0,0,0,4
7683,785930,20,3,4,3,4,0,0,4,4,2,4,0,5,0,1,0,10
7683,780996,26,1,5,1,3,0,2,2,3,0,5,1,1,0,1,0,4
7683,780995,18,0,2,0,1,0,1,0,0,1,0,0,1,0,3,0,0
7683,796468,35,4,8,4,7,0,1,3,4,1,3,4,1,1,4,0,11
7683,791035,33,6,13,2,6,4,7,5,6,2,5,1,4,0,2,0,21
7683,775709,29,2,4,1,1,1,3,0,0,0,3,1,2,1,4,0,5
7683,796466,18,1,2,1,2,0,0,2,3,0,2,3,4,0,1,1,4
7683,796467,15,3,3,1,1,2,2,1,1,0,1,0,1,0,2,0,9
7683,785492,6,1,2,1,2,0,0,0,0,0,0,0,1,1,0,0,2
7684,780119,37,7,9,7,9,0,0,1,2,2,4,4,1,5,2,2,15
7684,796558,36,7,14,7,13,0,1,4,4,1,4,3,3,1,2,0,18
7684,796559,37,3,14,1,7,2,7,6,7,1,4,3,0,1,3,0,14
7684,776097,31,6,10,5,8,1,2,1,2,2,1,2,4,2,3,0,14
7684,785536,17,3,7,2,5,1,2,1,2,2,1,0,3,1,1,2,8
7684,785280,5,0,1,0,0,0,1,0,0,0,1,0,0,0,0,0,0
7684,796560,23,1,3,1,3,0,0,2,2,3,7,0,1,0,1,0,4
7684,780149,11,1,3,1,3,0,0,0,0,0,1,1,0,0,1,1,2
7684,775679,3,0,2,0,0,0,2,0,0,0,0,0,1,0,0,0,0
7685,790793,27,3,11,2,5,1,6,2,2,1,7,1,2,1,3,0,9
7685,780281,27,2,6,1,5,1,1,2,2,0,4,0,4,1,1,1,7
7685,790794,17,1,1,1,1,0,0,0,0,1,2,1,0,1,0,3,2
7685,785246,31,2,9,1,4,1,5,0,0,1,1,1,0,0,0,0,5
7685,780886,37,6,14,5,7,1,7,3,3,0,1,2,1,1,7,0,16
7685,796351,14,2,4,2,4,0,0,2,2,3,2,1,1,0,2,0,6
7685,790792,15,2,2,2,2,0,0,0,0,0,3,0,5,3,2,0,4
7685,785368,23,4,10,4,10,0,0,5,5,2,4,0,3,2,1,2,13
7685,790789,1,0,1,0,0,0,1,0,0,0,0,0,1,0,0,0,0
7685,796350,6,1,2,1,1,0,1,0,0,0,0,0,2,0,0,0,2
7685,796353,2,0,1,0,1,0,0,0,0,0,0,0,0,0,0,0,0
7686,775455,32,8,16,7,14,1,2,2,2,2,3,2,2,0,5,0,19
7686,792124,17,1,2,1,2,0,0,1,4,1,1,0,4,0,0,2,3
7686,792123,37,6,12,1,3,5,9,3,3,1,5,5,3,0,4,0,20
7686,786002,30,2,4,0,0,2,4,1,2,0,5,3,2,0,2,0,7
7686,781397,25,2,5,2,5,0,0,1,2,4,1,1,4,0,0,0,5
7686,797754,6,0,0,0,0,0,0,0,0,0,0,2,3,0,0,0,0
7686,792119,2,0,0,0,0,0,0,0,0,0,0,0,0,0,0,0,0
7686,786003,6,0,2,0,0,0,2,0,0,0,3,0,0,1,0,0,0
7686,786009,20,3,8,2,6,1,2,0,0,1,1,1,3,2,3,0,7
7686,797749,15,1,2,1,2,0,0,0,0,0,1,0,1,0,0,0,2
7686,797747,10,3,7,3,6,0,1,0,0,0,0,1,2,1,0,0,6
7687,781558,16,1,4,1,3,0,1,2,2,2,6,0,0,0,1,0,4
7687,780993,27,4,5,4,5,0,0,2,2,1,2,0,2,2,0,2,10
7687,775248,31,4,17,3,10,1,7,6,6,3,3,1,4,1,3,1,15
7687,797225,36,4,12,4,10,0,2,9,10,2,5,1,2,3,4,2,17
7687,791452,38,6,11,2,4,4,7,6,6,0,4,1,3,1,0,0,22
7687,797230,13,2,2,2,2,0,0,1,1,0,0,0,1,0,1,0,5
7687,797226,3,1,1,1,1,0,0,0,0,0,1,0,0,0,1,0,2
7687,797231,12,0,0,0,0,0,0,0,0,1,2,0,0,0,0,0,0
7687,791449,24,0,3,0,2,0,1,1,2,0,1,2,1,3,1,0,1
7688,797972,29,3,3,2,2,1,1,4,4,3,2,1,4,1,1,1,11
7688,797967,33,1,4,0,1,1,3,1,2,1,4,4,1,1,4,0,4
7688,797970,28,5,12,4,8,1,4,1,3,2,1,0,4,3,3,1,12
7688,781453,37,5,10,2,4,3,6,5,6,0,10,11,0,2,2,0,18
7688,774869,36,9,16,2,2,7,14,0,0,1,2,2,2,1,2,1,25
7688,792254,16,1,3,1,2,0,1,5,5,1,4,0,0,0,2,0,7
7688,786098,19,4,9,2,4,2,5,0,0,1,1,2,4,1,1,0,10
7688,797962,2,0,0,0,0,0,0,0,0,0,0,0,0,0,0,0,0
7689,786434,13,1,2,1,2,0,0,1,2,1,0,2,0,0,1,0,3
7689,780440,27,6,10,3,3,3,7,6,6,3,8,0,2,2,4,2,21
7689,791621,35,7,20,4,7,3,13,0,0,1,0,5,3,0,5,0,17
7689,786432,32,1,3,0,0,1,3,2,2,0,3,1,3,0,0,0,5
7689,786431,25,3,9,1,6,2,3,0,0,0,1,3,3,1,0,0,8
7689,791619,3,0,2,0,0,0,2,0,0,0,0,0,0,0,1,0,0
7689,791620,13,3,5,2,3,1,2,2,2,6,6,0,2,0,1,0,9
7689,781125,13,1,5,1,5,0,0,1,1,1,0,0,3,1,2,0,3
7689,775620,13,0,1,0,1,0,0,0,0,2,1,2,1,0,0,1,0
7689,781088,26,4,11,3,6,1,5,0,0,1,2,2,3,1,1,0,9
7690,785740,18,1,3,1,3,0,0,0,1,2,1,0,4,0,2,0,2
7690,785809,35,5,14,4,7,1,7,2,4,1,4,2,2,1,1,0,13
7690,780530,37,4,9,4,8,0,1,3,4,1,7,1,1,0,2,0,11
7690,797402,32,0,6,0,3,0,3,0,0,0,4,1,1,0,1,0,0
7690,785738,33,1,6,1,4,0,2,1,2,0,1,1,3,0,2,0,3
7690,797396,13,0,1,0,1,0,0,1,2,3,1,0,1,1,1,1,1
7690,785739,3,0,0,0,0,0,0,2,2,0,0,0,0,0,0,0,2
7690,786144,26,2,7,0,1,2,6,1,2,1,4,0,2,0,0,0,7
7690,791664,3,0,2,0,2,0,0,0,0,0,1,0,0,0,0,0,0
7690,797401,0,0,0,0,0,0,0,0,0,0,0,0,0,0,0,0,0
7691,792388,16,0,1,0,1,0,0,0,0,2,2,0,4,0,0,0,0
7691,797845,34,4,10,2,5,2,5,1,1,0,4,0,1,0,0,0,11
7691,797851,26,2,5,1,2,1,3,2,4,0,3,1,4,0,1,0,7
7691,792391,34,4,11,4,10,0,1,1,1,1,7,1,2,0,2,3,9
7691,792395,35,5,15,4,14,1,1,4,5,4,6,6,3,1,3,0,15
7691,781533,28,4,7,1,2,3,5,0,0,2,5,0,2,2,0,2,11
7691,792393,24,4,9,4,8,0,1,0,0,1,2,0,3,0,2,1,8
7691,792394,2,0,0,0,0,0,0,0,0,0,0,0,0,0,0,0,0
7691,786115,1,0,0,0,0,0,0,0,0,0,0,0,1,0,0,0,0
7692,786197,25,5,6,5,5,0,1,5,7,1,2,3,3,0,1,1,15
7692,780717,22,1,1,1,1,0,0,1,1,0,3,1,4,0,3,1,3
7692,776328,27,7,14,5,7,2,7,0,0,1,4,0,4,1,1,0,16
7692,791742,38,6,10,3,6,3,4,3,5,0,3,6,2,0,4,0,18
7692,776266,36,4,9,4,6,0,3,6,10,2,1,3,1,2,3,0,14
7692,791738,19,0,1,0,1,0,0,0,0,1,1,1,5,0,0,1,0
7692,791740,26,1,5,1,4,0,1,3,3,0,3,0,2,0,0,0,5
7692,791741,7,0,1,0,0,0,1,2,2,0,1,0,1,0,0,0,2
7693,791537,32,5,11,4,6,1,5,2,4,4,6,0,4,0,1,0,13
7693,775846,3,0,1,0,1,0,0,0,0,0,0,0,0,0,0,0,0
7693,780306,40,15,22,15,22,0,0,7,9,2,4,3,2,2,4,0,37
7693,797116,38,1,3,0,2,1,1,2,2,1,0,4,4,0,3,0,5
7693,780312,33,2,7,1,4,1,3,7,8,0,4,4,4,1,0,1,12
7693,791535,9,0,0,0,0,0,0,0,0,0,0,1,4,0,0,0,0
7693,786358,24,1,6,0,2,1,4,0,0,0,3,1,2,0,0,0,3
7693,775418,21,3,4,3,4,0,0,0,0,1,4,1,4,0,1,2,6
7694,791416,23,7,11,7,11,0,0,3,6,6,4,0,2,0,2,0,17
7694,781614,12,2,3,1,1,1,2,0,0,0,3,2,1,0,1,0,5
7694,797096,31,3,11,0,2,3,9,1,2,0,3,0,4,2,2,0,10
7694,785906,38,5,9,3,7,2,2,1,2,0,2,5,1,1,5,0,13
7694,780096,31,2,5,0,0,2,5,3,4,0,1,2,4,0,1,0,9
7694,797093,18,1,3,1,1,0,2,0,3,1,6,2,1,0,2,0,2
7694,785907,16,5,7,5,7,0,0,0,0,1,2,0,2,0,1,0,10
7694,780100,25,2,3,2,2,0,1,1,3,0,3,5,1,2,1,1,5
7694,797094,6,0,0,0,0,0,0,2,2,0,0,0,0,0,0,1,2
7695,786526,29,5,9,3,4,2,5,2,2,0,6,0,4,1,1,0,14
7695,786525,34,3,8,3,4,0,4,0,1,1,3,1,1,1,1,0,6
7695,786856,15,2,4,2,4,0,0,0,0,0,2,0,3,0,3,0,4
7695,786030,39,9,21,6,13,3,8,1,2,2,3,1,1,2,2,0,22
7695,781109,34,1,5,0,2,1,3,2,2,2,5,1,3,2,1,0,5
7695,791917,14,0,4,0,2,0,2,0,0,0,2,0,5,0,1,1,0
7695,791914,15,4,9,4,7,0,2,1,1,0,1,1,5,0,2,0,9
7695,797550,4,0,1,0,0,0,1,0,0,0,0,0,0,0,1,0,0
7695,786524,16,3,3,3,3,0,0,0,0,1,2,0,0,0,0,0,6
7710,785740,28,3,4,3,4,0,0,0,3,3,4,0,2,0,3,1,6
7710,785809,32,0,1,0,1,0,0,2,2,1,2,4,4,1,0,1,2
7710,780530,33,5,11,5,11,0,0,0,0,3,2,2,1,0,1,0,10
7710,797402,15,0,4,0,1,0,3,0,0,0,0,1,1,0,4,0,0
7710,785738,38,5,10,3,6,2,4,6,6,1,3,6,2,1,4,0,18
7710,797396,18,3,5,2,4,1,1,0,0,2,3,0,2,0,0,2,7
7710,786144,33,4,10,0,2,4,8,0,0,0,4,0,0,1,2,0,12
7710,791664,3,0,1,0,0,0,1,0,0,0,0,1,0,0,0,0,0
7711,792388,25,0,0,0,0,0,0,0,0,0,2,0,5,0,1,0,0
7711,797845,16,2,4,1,1,1,3,0,0,0,0,0,0,0,0,0,5
7711,797851,35,3,11,2,9,1,2,0,0,1,1,2,1,0,2,0,7
7711,792391,31,6,10,5,9,1,1,2,3,1,2,0,4,3,2,0,15
7711,792395,39,7,11,6,10,1,1,5,6,3,3,4,3,2,1,1,20
7711,781533,24,0,3,0,0,0,3,0,0,1,2,0,4,1,3,0,0
7711,792393,30,3,10,3,9,0,1,4,4,1,2,1,1,1,1,0,10
7712,781612,22,3,11,2,8,1,3,0,0,2,5,1,4,0,2,0,7
7712,786459,26,4,11,4,11,0,0,2,4,4,2,2,3,0,1,0,10
7712,781609,33,6,16,4,13,2,3,5,6,6,5,2,1,4,2,1,19
7712,797004,31,3,7,1,3,2,4,4,4,0,1,6,1,3,1,0,12
7712,791360,31,1,4,0,1,1,3,0,0,2,0,3,1,0,0,0,3
7712,797007,11,1,2,1,2,0,0,0,0,0,0,0,1,0,0,0,2
7712,797005,24,4,7,0,0,4,7,0,0,0,2,0,5,0,1,0,12
7712,797006,11,0,3,0,2,0,1,0,0,1,0,1,1,0,1,0,0
7712,797003,11,2,3,2,2,0,1,0,1,0,0,0,2,0,0,0,4
7713,780282,26,1,2,1,2,0,0,3,4,1,9,1,2,0,2,2,5
7713,780280,35,5,10,5,9,0,1,3,6,2,1,2,0,3,0,0,13
7713,780277,30,4,8,3,6,1,2,8,9,1,3,1,0,0,1,1,17
7713,791002,23,1,3,0,2,1,1,0,0,0,3,1,2,0,1,0,3
7713,785327,20,5,8,2,4,3,4,0,0,0,1,1,3,1,2,0,13
7713,785329,16,3,4,3,3,0,1,2,2,1,3,0,2,0,2,0,8
7713,791003,14,3,5,3,3,0,2,1,2,1,2,0,2,0,2,0,7
7713,785330,20,3,6,1,3,2,3,0,0,1,3,0,0,0,0,1,8
7713,785326,16,1,1,1,1,0,0,2,2,0,0,0,3,0,2,0,4
7714,791089,28,6,10,6,8,0,2,1,1,1,6,0,1,1,2,0,13
7714,791097,26,4,9,3,7,1,2,0,0,0,2,3,3,2,1,0,9
7714,791094,25,0,1,0,1,0,0,0,0,0,2,4,3,0,1,0,0
7714,791091,29,1,6,0,4,1,2,0,0,1,0,3,1,0,2,0,3
7714,785569,30,4,12,1,3,3,9,2,3,1,3,2,4,0,2,0,13
7714,785577,22,3,7,3,7,0,0,2,2,5,2,2,0,3,0,1,8
7714,796752,24,3,5,1,2,2,3,0,0,0,3,2,5,0,1,0,8
7714,791090,16,5,15,1,7,4,8,2,3,0,0,0,2,0,3,0,16
7715,797380,23,5,10,4,5,1,5,2,2,1,1,2,0,0,2,0,13
7715,789043,22,4,8,4,8,0,0,1,3,3,3,0,3,0,2,1,9
7715,791818,33,5,10,2,5,3,5,5,5,2,6,4,1,1,2,2,18
7715,786636,37,4,10,2,4,2,6,7,9,1,1,1,4,2,1,0,17
7715,780646,30,3,4,2,2,1,2,0,0,1,3,4,3,2,2,0,7
7715,797379,15,5,7,5,7,0,0,0,0,1,4,0,0,1,0,0,10
7715,797377,20,0,3,0,2,0,1,2,2,0,4,1,2,0,2,0,2
7715,775168,20,2,4,2,4,0,0,2,3,1,2,3,0,1,1,0,6
7716,785498,28,7,10,7,10,0,0,4,4,2,2,0,3,2,1,1,18
7716,780704,22,0,2,0,0,0,2,0,0,0,1,0,1,0,0,0,0
7716,796708,23,1,6,1,3,0,3,1,2,0,4,3,2,3,1,0,3
7716,781169,15,1,5,1,4,0,1,0,0,1,1,1,2,1,2,0,2
7716,780701,31,2,8,2,7,0,1,1,2,0,1,3,4,1,4,0,5
7716,796705,31,5,14,0,6,5,8,6,8,0,5,1,2,2,1,0,21
7716,791036,12,1,1,1,1,0,0,0,0,1,3,1,1,0,0,0,2
7716,776322,21,1,8,0,0,1,8,0,0,1,0,0,4,0,0,0,3
7716,796706,13,0,0,0,0,0,0,0,2,0,2,0,2,0,0,0,0
7716,780700,2,0,1,0,1,0,0,0,0,0,0,1,0,1,0,0,0
7716,791037,2,1,1,0,0,1,1,0,0,0,0,0,0,0,1,0,3
7717,797050,23,3,6,2,4,1,2,5,6,1,1,1,1,0,2,2,12
7717,780391,26,4,6,4,6,0,0,7,8,2,4,0,2,0,1,0,15
7717,790871,34,3,9,3,7,0,2,2,2,0,6,2,2,0,5,0,8
7717,780392,28,5,9,2,3,3,6,4,5,1,5,0,0,1,0,0,17
7717,776473,19,1,5,1,2,0,3,0,0,1,2,1,2,0,2,0,2
7717,780394,34,5,9,4,5,1,4,3,3,3,11,2,4,2,0,0,14
7717,791573,26,1,3,1,2,0,1,1,1,0,2,2,3,0,1,0,3
7717,785783,5,0,1,0,1,0,0,2,2,0,0,0,0,0,0,1,2
7717,791570,2,0,1,0,1,0,0,0,0,0,0,0,1,0,2,0,0
7717,791571,1,0,0,0,0,0,0,0,0,0,0,0,0,0,0,0,0
7717,791572,1,0,0,0,0,0,0,0,0,0,0,0,0,0,0,0,0
7717,797052,1,0,0,0,0,0,0,0,0,0,0,0,0,1,1,0,0
7718,796959,8,0,0,0,0,0,0,0,0,0,1,0,1,0,1,0,0
7718,781272,31,6,11,5,9,1,2,0,1,4,4,5,5,3,3,0,13
7718,796958,33,5,9,3,5,2,4,4,6,2,5,1,3,0,0,0,16
7718,791261,27,5,10,3,4,2,6,0,0,0,1,1,1,0,1,0,12
7718,781270,40,9,19,7,14,2,5,7,7,0,4,2,5,2,4,0,27
7718,791260,5,1,2,1,2,0,0,1,1,1,1,0,1,0,1,0,3
7718,785503,10,1,2,0,1,1,1,0,0,1,2,1,3,0,1,0,3
7718,785502,5,0,0,0,0,0,0,1,2,0,0,0,2,0,1,0,1
7718,791258,24,2,5,0,1,2,4,0,0,1,2,0,2,0,1,0,6
7718,785501,15,2,4,0,0,2,4,0,0,0,3,1,0,0,0,0,6
7718,799825,2,0,0,0,0,0,0,0,0,0,0,0,0,0,0,0,0
7719,797701,33,4,6,4,6,0,0,1,1,0,3,1,3,1,3,0,9
7719,792101,34,5,10,2,5,3,5,4,4,2,3,3,2,0,0,0,17
7719,780923,36,7,14,7,11,0,3,5,9,1,1,5,2,3,0,0,19
7719,775564,36,5,10,5,9,0,1,10,11,3,4,3,2,1,2,0,20
7719,776386,29,8,13,5,7,3,6,1,1,1,1,2,2,2,0,0,20
7719,797700,7,1,1,1,1,0,0,0,0,0,1,0,0,0,2,1,2
7719,780922,15,1,4,1,3,0,1,1,2,2,5,0,3,1,0,0,3
7719,786160,10,0,2,0,1,0,1,0,0,0,2,0,0,0,1,1,0
7719,792102,0,0,0,0,0,0,0,0,0,0,0,0,0,0,0,0,0
7720,791585,31,2,6,1,2,1,4,1,2,1,7,8,1,0,0,1,6
7720,791581,25,2,6,1,3,1,3,0,1,1,6,3,0,1,0,0,5
7720,786395,33,8,15,4,6,4,9,4,4,2,5,1,1,1,0,0,24
7720,786394,32,9,18,5,9,4,9,0,0,2,3,3,3,2,0,2,22
7720,780404,32,3,8,3,5,0,3,0,0,0,1,1,1,3,1,1,6
7720,785228,22,4,6,1,1,3,5,2,3,1,1,1,1,1,1,0,13
7720,780062,11,1,1,1,1,0,0,0,0,0,0,1,0,0,2,0,2
7720,780403,10,0,1,0,1,0,0,0,0,0,0,0,2,0,0,0,0
7720,797037,1,0,0,0,0,0,0,1,2,0,0,0,0,0,0,0,1
7720,797041,1,0,0,0,0,0,0,0,0,0,0,0,0,0,0,0,0
7720,791582,1,0,0,0,0,0,0,0,0,0,0,0,0,0,0,0,0
7720,799920,1,0,0,0,0,0,0,0,0,0,0,0,0,0,0,0,0
7721,781007,13,1,1,1,1,0,0,0,0,0,0,1,4,1,1,0,2
7721,781322,33,4,8,2,5,2,3,3,3,0,6,0,3,0,2,0,13
7721,785989,29,4,10,1,4,3,6,0,1,1,6,4,2,0,1,2,11
7721,786571,22,0,5,0,3,0,2,0,0,0,5,2,3,0,3,0,0
7721,781439,32,8,14,4,7,4,7,5,5,1,4,3,1,0,3,0,25
7721,797299,7,0,2,0,2,0,0,0,0,0,1,0,0,0,0,0,0
7721,781207,16,3,5,2,3,1,2,2,3,0,2,0,0,1,0,0,9
7721,781419,22,3,7,1,2,2,5,0,0,0,2,1,1,0,1,0,8
7721,780563,11,0,0,0,0,0,0,0,0,1,0,0,1,0,0,0,0
7721,791690,8,0,1,0,1,0,0,0,0,1,0,1,1,0,0,0,0
7721,784248,5,1,3,0,0,1,3,0,0,0,0,0,0,0,0,0,3
7721,791691,1,0,0,0,0,0,0,0,0,0,0,0,0,0,0,0,0
7721,797300,1,0,0,0,0,0,0,0,0,0,0,0,0,0,0,0,0
7722,791220,16,2,3,1,1,1,2,0,0,0,0,1,0,1,0,2,5
7722,791219,25,3,8,2,5,1,3,0,0,0,3,1,3,3,1,0,7
7722,776217,27,1,1,1,1,0,0,1,2,0,0,1,5,2,1,1,3
7722,790818,34,4,10,2,6,2,4,0,0,1,2,6,3,0,1,0,10
7722,780730,33,6,12,2,3,4,9,0,0,0,4,1,1,1,5,0,16
7722,786824,24,2,8,2,6,0,2,2,2,1,1,3,3,4,1,0,6
7722,791221,12,0,2,0,1,0,1,1,2,0,4,0,0,0,0,0,1
7722,796923,1,0,1,0,1,0,0,0,0,0,0,0,0,0,0,0,0
7722,786396,28,6,7,4,4,2,3,2,2,0,0,1,0,1,0,0,16
7723,791616,37,4,8,4,8,0,0,0,0,3,4,0,0,1,0,0,8
7723,780797,37,7,8,4,5,3,3,2,3,0,8,4,3,2,2,1,19
7723,796981,20,5,8,5,5,0,3,3,3,1,1,4,2,2,4,1,13
7723,785505,36,2,5,0,2,2,3,4,4,1,4,5,1,0,3,1,10
7723,775604,29,4,10,2,5,2,5,0,0,0,4,5,2,1,5,0,10
7723,796983,2,0,0,0,0,0,0,0,0,1,0,0,1,0,0,0,0
7723,796986,8,1,1,1,1,0,0,0,0,0,1,1,0,0,0,0,2
7723,791618,4,1,2,0,0,1,2,0,0,0,1,0,0,0,1,0,3
7723,780555,27,2,5,0,1,2,4,0,0,0,1,0,2,0,4,0,6
7724,796542,13,0,0,0,0,0,0,1,2,0,2,3,0,2,1,0,1
7724,781335,27,6,8,5,6,1,2,3,5,1,2,0,2,0,2,0,16
7724,776351,28,0,3,0,1,0,2,0,0,1,7,4,2,0,1,1,0
7724,785770,32,8,17,6,9,2,8,1,1,2,0,6,2,2,2,1,19
7724,781341,31,8,10,1,1,7,9,0,0,1,5,2,2,0,1,0,23
7724,791285,15,2,6,0,0,2,6,0,1,0,2,0,0,2,0,1,6
7724,785775,19,4,5,4,4,0,1,0,0,1,2,3,3,0,1,0,8
7724,796538,10,0,1,0,0,0,1,0,0,0,1,2,2,1,1,0,0
7724,791284,14,2,4,1,1,1,3,0,0,0,1,0,0,1,1,0,5
7724,785773,1,0,1,0,0,0,1,0,0,0,0,0,0,0,0,0,0
7724,785767,10,0,3,0,1,0,2,0,0,0,0,0,0,0,0,0,0
7725,786136,25,6,13,5,11,1,2,2,4,4,1,0,2,0,2,0,15
7725,797358,24,3,14,2,8,1,6,0,0,2,4,1,4,2,2,0,7
7725,797357,32,5,9,3,5,2,4,1,1,0,3,4,2,1,2,0,13
7725,797359,20,1,2,1,1,0,1,0,0,0,4,0,0,1,1,0,2
7725,776236,28,2,5,1,3,1,2,2,2,1,2,2,4,0,1,0,7
7725,797361,2,1,1,1,1,0,0,0,0,0,0,0,1,0,0,0,2
7725,791802,2,0,0,0,0,0,0,0,1,0,0,0,0,1,1,0,0
7725,797362,9,0,2,0,0,0,2,0,0,0,1,0,0,1,1,0,0
7725,786140,13,3,3,3,3,0,0,0,0,2,5,2,1,2,3,0,6
7725,791365,23,1,2,0,0,1,2,2,3,0,1,0,0,0,1,0,5
7725,775195,22,3,6,2,4,1,2,0,0,0,2,1,0,0,2,0,7
7726,786765,36,5,9,3,6,2,3,2,5,1,7,6,1,1,4,0,14
7726,792379,24,4,6,0,0,4,6,1,3,2,6,0,3,0,1,0,13
7726,792380,40,6,11,1,1,5,10,3,4,0,2,1,1,0,1,0,20
7726,781672,35,7,12,7,11,0,1,0,3,4,6,2,1,1,2,2,14
7726,781669,38,8,19,5,11,3,8,6,6,0,2,9,2,0,0,0,25
7726,797860,4,0,0,0,0,0,0,0,0,0,1,0,0,0,1,0,0
7726,797852,23,1,4,1,3,0,1,0,0,1,2,3,3,0,0,0,2
7727,785800,22,2,9,1,2,1,7,0,0,3,3,0,2,0,0,0,5
7727,785799,17,2,3,2,3,0,0,0,0,3,3,2,2,0,1,0,4
7727,791676,29,4,15,2,4,2,11,1,2,0,4,3,3,1,0,1,11
7727,780554,29,5,11,5,7,0,4,0,0,0,2,0,3,0,0,0,10
7727,780553,31,8,23,7,19,1,4,2,2,3,3,5,3,2,3,0,19
7727,797426,7,0,0,0,0,0,0,0,0,0,0,0,1,0,0,0,0
7727,791678,10,2,2,2,2,0,0,0,0,1,1,0,0,0,0,2,4
7727,791679,1,0,0,0,0,0,0,0,2,0,0,0,2,1,0,0,0
7727,785807,6,0,2,0,1,0,1,2,2,0,1,0,1,0,0,0,2
7727,780760,21,3,6,2,3,1,3,1,1,3,5,0,3,0,1,1,8
7727,797427,15,3,4,2,2,1,2,0,0,1,0,0,2,0,1,0,7
7727,791677,12,3,4,2,3,1,1,0,0,0,2,1,0,1,0,0,7
7728,791905,23,2,6,1,2,1,4,2,2,2,7,1,2,1,2,1,7
7728,781103,31,8,12,7,10,1,2,2,5,3,1,3,2,0,2,0,19
7728,797568,33,4,17,2,8,2,9,0,0,2,0,2,4,0,1,0,10
7728,797566,36,5,9,3,4,2,5,0,0,1,3,4,2,1,1,2,12
7728,781191,38,6,15,5,8,1,7,0,0,0,5,2,3,0,1,0,13
7728,797569,4,0,0,0,0,0,0,0,0,0,0,0,0,0,1,0,0
7728,791907,9,2,2,2,2,0,0,0,0,2,1,1,1,0,0,0,4
7728,781102,26,2,5,2,3,0,2,0,0,4,4,5,1,0,0,0,4
7729,785631,29,5,9,3,4,2,5,2,2,3,1,0,3,0,1,1,14
7729,786248,26,1,3,1,3,0,0,2,3,2,8,2,2,0,1,1,4
7729,785630,35,3,9,1,1,2,8,1,2,0,1,6,1,1,0,0,9
7729,785632,36,8,13,7,11,1,2,2,3,1,3,2,1,0,0,0,19
7729,780777,28,1,4,1,3,0,1,1,2,1,4,8,2,4,0,0,3
7729,791199,14,4,5,4,5,0,0,0,1,2,2,0,1,0,0,0,8
7729,791198,4,0,1,0,0,0,1,0,0,0,0,0,0,0,0,0,0
7729,791200,28,8,16,4,8,4,8,0,0,1,3,1,3,1,1,0,20
7730,797544,28,2,7,2,5,0,2,0,3,1,3,3,2,1,3,3,4
7730,797546,15,2,3,2,3,0,0,2,4,0,3,0,2,0,1,0,6
7730,797549,29,4,9,2,5,2,4,3,8,1,7,4,5,1,1,0,13
7730,791716,10,0,0,0,0,0,0,0,0,0,0,0,0,0,2,0,0
7730,780586,36,7,16,7,13,0,3,3,7,3,9,3,4,0,1,0,17
7730,780351,19,3,3,3,3,0,0,2,2,1,1,0,1,1,3,0,8
7730,797545,30,5,8,2,4,3,4,0,0,1,3,1,3,1,1,0,13
7730,797540,17,1,4,0,0,1,4,0,0,0,2,0,3,0,0,0,3
7730,791715,11,0,1,0,0,0,1,3,4,1,0,1,2,0,0,0,3
7730,790857,30,3,6,2,5,1,1,0,0,1,3,3,2,0,2,0,7
7731,797695,14,1,3,1,3,0,0,3,4,1,3,1,4,0,1,0,5
7731,797699,39,5,15,2,10,3,5,4,9,0,4,5,2,3,6,0,17
7731,797692,39,6,14,4,4,2,10,0,1,0,1,1,2,0,0,0,14
7731,791954,33,2,6,1,3,1,3,7,9,3,9,0,4,2,1,0,12
7731,780846,42,4,11,3,7,1,4,2,2,5,3,4,4,4,0,1,11
7731,797698,7,0,2,0,2,0,0,0,0,1,2,0,3,1,0,0,0
7731,780844,31,5,8,1,1,4,7,0,0,3,2,2,2,0,0,0,14
7731,797694,20,4,8,2,2,2,6,0,0,0,3,1,0,0,0,0,10
7732,775897,34,2,8,1,5,1,3,0,0,0,0,3,2,0,0,0,5
7732,780324,35,6,10,6,10,0,0,1,1,3,3,5,0,2,2,0,13
7732,791543,34,5,9,1,2,4,7,2,3,1,4,1,2,2,0,0,16
7732,786530,25,1,4,0,0,1,4,0,0,0,5,0,2,0,2,0,3
7732,780317,27,2,6,0,3,2,3,0,0,1,1,1,3,1,0,0,6
7732,784246,13,0,4,0,2,0,2,0,0,0,1,1,1,1,2,0,0
7732,791546,5,0,0,0,0,0,0,0,2,0,1,0,1,0,1,1,0
7732,791545,17,1,6,1,4,0,2,1,2,0,5,3,0,0,0,1,3
7732,786360,10,3,5,1,2,2,3,0,0,0,0,2,0,0,0,0,8
7733,792373,32,5,10,5,8,0,2,0,0,0,2,2,1,0,2,1,10
7733,781598,21,1,3,1,3,0,0,0,0,2,3,0,2,0,0,0,2
7733,792370,37,2,7,1,2,1,5,0,0,1,6,0,2,1,3,2,5
7733,797951,20,2,6,1,2,1,4,0,0,0,1,3,1,1,3,0,5
7733,775303,24,1,2,1,1,0,1,0,0,0,3,2,1,0,0,0,2
7733,790499,24,5,7,5,6,0,1,0,4,0,4,0,2,0,1,0,10
7733,797958,14,1,2,0,1,1,1,0,0,0,0,0,1,0,0,1,3
7733,776491,28,6,9,4,7,2,2,1,2,0,5,3,2,1,3,0,15
7734,780765,38,10,19,8,13,2,6,3,6,4,7,4,1,2,3,2,25
7734,781301,25,0,2,0,2,0,0,0,2,4,2,0,2,0,3,3,0
7734,786255,37,5,15,2,6,3,9,4,4,1,3,2,2,3,2,0,17
7734,780762,33,4,9,2,6,2,3,1,2,1,1,0,3,2,0,0,11
7734,780768,36,0,7,0,4,0,3,0,1,2,4,5,2,1,2,0,0
7734,791729,17,2,4,1,1,1,3,0,0,2,2,1,2,0,1,0,5
7734,797320,4,1,1,1,1,0,0,0,0,0,0,0,0,1,1,0,2
7734,780755,10,0,2,0,0,0,2,0,0,0,0,1,1,0,0,0,0
7735,791194,36,3,11,2,9,1,2,2,2,0,4,0,2,2,2,2,9
7735,780384,25,7,10,7,10,0,0,1,1,7,3,0,3,1,1,1,15
7735,780159,22,1,4,1,4,0,0,0,0,0,4,0,2,3,1,0,2
7735,796863,37,6,13,5,12,1,1,0,0,2,2,3,3,0,9,0,13
7735,775694,37,3,14,2,9,1,5,0,1,1,6,1,3,2,3,0,7
7735,800119,21,2,5,2,3,0,2,0,0,1,4,1,0,0,1,0,4
7735,791193,15,1,2,1,2,0,0,0,0,3,0,1,4,1,2,2,2
7735,796865,7,0,2,0,1,0,1,0,0,0,0,0,2,0,0,0,0
7736,780118,31,5,6,3,4,2,2,4,4,0,1,2,4,0,4,0,16
7736,791400,36,3,6,0,3,3,3,2,2,2,4,4,5,0,1,0,11
7736,785931,32,4,7,4,4,0,3,2,2,0,4,6,4,0,4,1,10
7736,791401,34,8,14,8,14,0,0,4,5,4,6,1,3,0,2,0,20
7736,780125,24,0,2,0,2,0,0,6,10,2,3,1,2,0,1,0,6
7736,786837,20,5,6,3,4,2,2,4,5,0,2,0,1,1,3,0,16
7736,797125,13,1,3,1,2,0,1,1,2,1,1,0,2,0,0,0,3
7736,797130,8,0,1,0,0,0,1,0,0,0,1,1,2,1,1,0,0
7736,797126,2,0,0,0,0,0,0,0,0,0,0,0,0,0,0,0,0
7737,791629,34,4,12,3,6,1,6,2,4,0,1,2,3,0,1,0,11
7737,796974,35,7,16,6,13,1,3,4,6,2,1,0,2,0,0,0,19
7737,781199,36,7,16,6,13,1,3,4,5,2,1,4,3,4,0,0,19
7737,776462,29,3,9,3,5,0,4,6,8,5,2,0,4,1,1,0,12
7737,785635,26,1,2,1,2,0,0,4,6,1,1,0,4,0,3,3,6
7737,791628,11,1,3,0,0,1,3,0,0,1,3,0,2,1,1,0,3
7737,775642,6,0,1,0,0,0,1,0,0,2,0,0,3,0,0,0,0
7737,791626,6,0,0,0,0,0,0,0,0,0,0,0,2,1,0,1,0
7737,786720,17,1,1,1,1,0,0,0,0,0,1,0,0,1,1,0,2
7738,797655,21,1,4,1,4,0,0,3,4,0,4,2,1,0,2,1,5
7738,792069,29,6,14,5,9,1,5,0,2,2,2,2,1,1,2,0,13
7738,785572,26,4,8,3,5,1,3,2,4,1,4,2,0,1,2,0,11
7738,797657,27,3,11,3,6,0,5,0,0,0,2,1,2,0,0,0,6
7738,792072,40,2,4,0,0,2,4,0,0,0,2,1,0,1,0,0,6
7738,797652,32,1,5,0,2,1,3,0,0,0,4,3,0,3,0,1,3
7738,784640,13,1,8,0,4,1,4,0,2,0,0,0,2,1,0,0,3
7738,786025,8,1,2,1,2,0,0,2,2,0,0,0,1,0,0,0,4
7738,774844,4,1,2,1,2,0,0,0,0,0,1,0,0,0,0,0,2
7739,780116,29,2,6,1,1,1,5,0,0,0,3,2,2,0,1,0,5
7739,790870,34,13,19,13,18,0,1,3,4,1,20,6,2,1,4,3,29
7739,796421,36,5,8,5,8,0,0,0,0,1,6,5,2,2,2,2,10
7739,790869,31,4,9,4,7,0,2,0,0,0,4,2,1,2,0,0,8
7739,790866,25,3,8,0,2,3,6,0,0,0,1,1,3,0,2,0,9
7739,780493,17,1,2,0,0,1,2,0,0,0,1,0,0,0,0,0,3
7739,796427,19,2,3,2,2,0,1,0,0,1,3,3,1,0,2,0,4
7739,796424,3,0,1,0,0,0,1,0,0,0,0,0,0,0,0,0,0
7739,796426,3,0,2,0,1,0,1,0,0,0,0,0,0,0,0,0,0
7739,796425,2,0,0,0,0,0,0,0,0,0,0,0,0,0,0,0,0
7739,783997,1,0,0,0,0,0,0,0,0,0,0,0,0,0,0,0,0
7752,780377,32,2,7,0,3,2,4,2,5,1,7,3,0,0,1,1,8
7752,791852,28,3,3,3,3,0,0,1,3,1,2,1,4,0,1,1,7
7752,797460,25,3,7,2,2,1,5,2,2,2,0,0,3,0,2,0,9
7752,786601,32,4,12,1,3,3,9,10,11,0,4,1,1,1,3,0,21
7752,786600,29,4,10,4,8,0,2,2,2,1,2,2,3,1,2,0,10
7752,791851,9,0,1,0,1,0,0,0,0,0,1,1,0,0,0,0,0
7752,791853,11,3,6,3,5,0,1,0,0,1,2,1,3,0,1,0,6
7752,797461,23,2,5,1,3,1,2,2,2,0,4,7,1,1,2,1,7
7752,786602,11,2,3,0,1,2,2,0,0,0,2,0,0,0,0,0,6
7753,797163,25,5,7,5,7,0,0,2,3,1,2,0,2,0,4,1,12
7753,797164,17,4,8,4,8,0,0,2,2,2,3,1,3,0,0,0,10
7753,786450,23,3,3,2,2,1,1,1,1,1,3,3,5,3,1,1,8
7753,776396,35,6,16,2,5,4,11,2,3,0,1,2,1,2,3,0,18
7753,776199,33,4,14,3,9,1,5,0,0,0,6,3,3,0,4,0,9
7753,797167,15,1,1,1,1,0,0,0,1,0,3,0,1,0,1,1,2
7753,791385,22,1,3,1,1,0,2,0,0,3,4,1,1,0,1,1,2
7753,797161,17,2,6,0,1,2,5,0,0,0,1,0,2,0,0,1,6
7753,797165,7,1,2,0,1,1,1,0,0,0,2,1,4,0,1,0,3
7753,791382,2,0,0,0,0,0,0,0,0,0,0,0,2,0,0,0,0
7753,791386,1,0,0,0,0,0,0,0,0,0,0,0,1,0,0,0,0
7753,797166,3,0,0,0,0,0,0,0,0,0,0,0,0,0,0,0,0
7754,791876,38,3,11,2,6,1,5,11,16,4,6,1,1,1,1,1,18
7754,791877,15,2,2,2,2,0,0,0,0,1,0,0,2,0,2,0,4
7754,797486,22,1,3,1,1,0,2,2,3,0,1,2,3,2,1,1,4
7754,786572,39,6,11,4,8,2,3,3,5,1,4,3,3,1,3,0,17
7754,780436,14,1,3,0,0,1,3,0,0,1,0,2,0,1,1,0,3
7754,781205,25,3,5,3,5,0,0,0,0,4,3,1,2,0,1,3,6
7754,785667,28,3,7,2,3,1,4,0,0,0,1,5,2,0,1,0,7
7754,786570,19,5,6,4,5,1,1,3,4,0,0,3,4,0,3,0,14
7755,785409,33,3,4,3,4,0,0,2,2,2,4,3,3,0,1,1,8
7755,785408,25,6,9,5,8,1,1,4,5,0,1,0,5,0,1,0,17
7755,785407,35,6,9,6,9,0,0,4,9,4,4,1,4,1,3,0,16
7755,796416,33,4,11,3,6,1,5,2,2,0,1,9,1,3,4,0,11
7755,790861,30,4,6,4,5,0,1,0,0,0,2,0,2,0,1,0,8
7755,796415,23,1,4,1,4,0,0,0,0,0,5,6,3,2,2,0,2
7755,780539,21,5,8,3,4,2,4,0,0,0,0,0,3,0,1,0,12
7756,791391,32,8,12,8,11,0,1,7,9,2,4,3,0,0,0,1,23
7756,797156,25,2,2,1,1,1,1,0,0,0,3,3,3,1,0,0,5
7756,791390,23,4,5,4,5,0,0,2,3,1,2,3,4,0,4,0,10
7756,775743,25,0,3,0,2,0,1,0,0,0,3,2,0,0,0,0,0
7756,780130,29,14,20,9,13,5,7,1,2,3,2,1,3,0,3,0,34
7756,797158,1,1,1,1,1,0,0,0,0,0,0,0,0,0,0,0,2
7756,791388,15,2,2,2,2,0,0,0,0,0,1,2,0,0,1,0,4
7756,776446,11,0,2,0,1,0,1,0,0,0,3,0,0,1,0,0,0
7756,780133,21,2,5,1,2,1,3,0,0,0,3,3,1,0,0,0,5
7756,780407,16,1,1,1,1,0,0,0,0,0,1,0,2,0,0,0,2
7756,797157,2,1,1,1,1,0,0,0,0,0,0,0,0,0,0,0,2
7756,791389,0,0,0,0,0,0,0,0,0,0,0,0,0,0,0,0,0
7757,781249,26,4,5,0,0,4,5,0,0,0,2,3,4,0,0,0,12
7757,775165,31,2,4,0,0,2,4,0,0,0,3,0,3,0,0,0,6
7757,785514,31,7,9,7,8,0,1,4,4,0,1,2,3,0,3,1,18
7757,785515,36,3,11,3,8,0,3,4,4,3,3,8,1,1,3,0,10
7757,781253,34,4,9,1,2,3,7,0,0,0,2,0,1,0,1,0,11
7757,796953,12,2,3,2,3,0,0,2,2,1,0,0,3,1,1,0,6
7757,796951,9,0,3,0,0,0,3,1,2,0,1,0,1,0,0,0,1
7757,791687,21,3,6,0,0,3,6,0,0,0,0,0,0,0,1,0,9
7757,791251,0,0,0,0,0,0,0,0,0,0,0,0,0,0,0,0,0
7757,776804,0,0,0,0,0,0,0,0,0,0,0,0,0,0,0,0,0
7758,785622,25,1,5,0,0,1,5,2,2,0,3,1,1,0,1,0,5
7758,781058,19,0,5,0,5,0,0,0,0,2,5,2,2,0,1,0,0
7758,780327,24,3,4,3,4,0,0,4,5,0,1,0,1,1,1,0,10
7758,797458,29,2,6,1,5,1,1,5,6,0,3,0,0,0,0,0,10
7758,797451,36,5,9,4,8,1,1,0,0,0,1,4,2,1,2,0,11
7758,797455,20,4,5,4,5,0,0,1,2,1,0,0,1,0,3,0,9
7758,797456,4,0,1,0,1,0,0,0,0,0,0,0,0,0,0,0,0
7758,791847,8,1,2,0,0,1,2,2,2,0,1,1,2,0,0,0,5
7758,791848,9,0,0,0,0,0,0,0,0,0,3,2,0,0,1,1,0
7758,786607,9,0,2,0,1,0,1,0,0,1,0,0,1,1,2,0,0
7758,797453,9,1,2,0,1,1,1,2,2,0,1,0,0,1,1,0,5
7758,791849,8,1,2,1,1,0,1,0,1,0,0,1,0,0,0,0,2
7759,791289,17,4,5,4,5,0,0,0,0,0,3,0,4,0,0,0,8
7759,796576,25,0,7,0,5,0,2,0,0,1,2,2,1,2,3,0,0
7759,796571,30,7,10,3,5,4,5,0,0,0,3,1,2,3,0,2,18
7759,796572,27,4,6,4,6,0,0,2,2,4,2,0,0,1,0,4,10
7759,781346,33,9,14,7,9,2,5,0,0,0,4,3,1,0,2,1,20
7759,785786,25,2,3,1,2,1,1,0,0,1,3,0,3,0,0,0,5
7759,796574,15,2,6,1,3,1,3,0,0,0,1,5,1,0,1,0,5
7759,791290,11,0,1,0,0,0,1,0,0,0,2,0,1,0,0,0,0
7759,791291,17,1,3,0,0,1,3,0,0,0,0,0,1,1,1,0,3
7760,792378,29,5,8,5,7,0,1,1,2,1,6,2,1,0,2,2,11
7760,786746,31,1,6,0,3,1,3,4,5,2,2,2,2,0,5,1,7
7760,780178,16,2,3,2,3,0,0,0,0,0,1,0,4,0,2,1,4
7760,792376,35,7,12,5,6,2,6,4,4,0,12,6,1,1,2,1,20
7760,797883,37,3,7,3,4,0,3,4,5,1,6,4,2,1,3,0,10
7760,797890,20,5,8,5,7,0,1,0,0,1,2,3,1,0,1,1,10
7760,797888,8,2,2,2,2,0,0,0,0,1,1,1,3,0,0,0,4
7760,775075,16,1,4,1,4,0,0,0,0,1,3,3,1,0,0,1,2
7760,786747,8,0,1,0,0,0,1,0,0,0,1,0,0,0,1,0,0
7761,791837,26,1,7,1,4,0,3,0,0,0,3,0,2,0,0,1,2
7761,780613,37,5,11,5,11,0,0,8,9,2,5,1,3,2,0,0,18
7761,775097,30,2,11,2,10,0,1,4,6,1,4,1,1,2,0,1,8
7761,780609,40,4,11,3,6,1,5,0,0,0,5,5,2,1,2,0,9
7761,776395,30,5,15,4,8,1,7,1,1,1,1,3,4,3,2,0,12
7761,786621,10,0,0,0,0,0,0,0,0,0,0,1,1,0,0,0,0
7761,786619,3,0,0,0,0,0,0,0,0,0,0,0,0,0,1,0,0
7761,797437,3,2,3,1,2,1,1,0,0,0,0,0,0,0,0,0,5
7761,786622,21,1,3,1,1,0,2,0,2,2,1,0,4,0,0,1,2
7762,792306,38,10,20,9,16,1,4,8,10,5,11,3,2,2,3,2,29
7762,776424,18,4,5,4,4,0,1,0,1,2,2,0,3,1,2,0,8
7762,792300,26,4,6,4,5,0,1,0,2,2,2,2,5,0,2,1,8
7762,792303,36,5,19,4,12,1,7,10,11,1,2,3,4,2,5,0,21
7762,781603,32,1,4,1,2,0,2,0,0,1,1,2,1,0,1,0,2
7762,786618,4,0,1,0,1,0,0,0,0,0,0,0,0,0,0,0,0
7762,797912,8,0,2,0,1,0,1,0,0,1,0,0,0,1,0,0,0
7762,797914,13,0,2,0,0,0,2,2,2,1,1,0,1,0,0,0,2
7762,780456,20,1,4,0,1,1,3,2,2,1,2,0,5,2,0,0,5
7762,790813,4,1,2,0,0,1,2,0,0,0,0,0,0,0,0,0,3
7762,796155,1,0,0,0,0,0,0,0,0,0,0,0,1,0,1,0,0
7763,797222,20,5,5,5,5,0,0,5,6,2,7,1,5,0,2,2,15
7763,781526,27,4,8,4,7,0,1,2,2,0,1,1,4,0,3,4,10
7763,797217,34,1,6,0,1,1,5,6,6,0,2,3,1,3,4,0,9
7763,797218,28,4,14,2,7,2,7,2,2,2,2,2,2,3,0,0,12
7763,775697,36,5,13,1,4,4,9,4,4,0,5,3,5,0,1,0,18
7763,791454,28,1,6,1,4,0,2,0,0,5,4,5,2,1,4,4,2
7763,791846,22,5,9,4,7,1,2,5,5,2,2,2,1,0,0,1,16
7763,797223,2,0,0,0,0,0,0,0,0,0,0,0,1,0,0,0,0
7763,791453,3,0,0,0,0,0,0,0,0,0,0,0,0,0,0,0,0
7764,790846,36,7,12,7,11,0,1,4,7,3,6,2,2,0,0,4,18
7764,796755,22,1,3,1,3,0,0,5,7,0,4,2,2,0,2,0,7
7764,791099,31,6,12,4,6,2,6,0,1,2,3,0,1,1,1,0,14
7764,785470,26,1,3,1,1,0,2,4,4,1,1,1,4,2,2,0,6
7764,780298,33,4,10,1,5,3,5,3,4,1,4,4,3,1,2,0,14
7764,780315,13,1,1,0,0,1,1,2,2,1,1,0,4,1,1,0,5
7764,780814,1,0,0,0,0,0,0,0,0,0,1,0,3,0,2,0,0
7764,785586,23,3,5,3,4,0,1,0,0,0,6,2,4,0,1,0,6
7764,796754,15,3,5,0,0,3,5,2,4,0,2,1,1,0,0,0,11
7765,780858,32,6,11,6,8,0,3,4,5,6,9,1,1,0,0,0,16
7765,792235,17,1,3,1,3,0,0,2,5,3,1,0,4,1,0,0,4
7765,797646,27,4,16,4,14,0,2,0,0,0,1,1,3,0,2,1,8
7765,780849,23,1,3,0,2,1,1,0,0,0,0,0,1,0,1,0,3
7765,780853,27,3,10,2,6,1,4,6,8,0,2,2,3,0,2,0,13
7765,780776,8,1,2,1,2,0,0,2,2,1,0,0,4,0,0,0,4
7765,785990,23,1,6,0,3,1,3,4,4,1,2,3,0,1,1,0,7
7765,785998,19,2,5,0,1,2,4,2,2,1,1,1,1,0,0,0,8
7765,786010,11,1,3,1,1,0,2,0,0,0,2,0,1,0,0,0,2
7765,792039,13,0,4,0,1,0,3,0,0,0,2,0,1,0,0,0,0
7766,786054,27,10,16,10,16,0,0,1,2,3,4,0,1,0,0,0,21
7766,791964,28,4,8,2,4,2,4,0,0,0,6,1,5,2,4,0,10
7766,786056,24,1,6,0,2,1,4,2,2,0,5,2,3,1,1,0,5
7766,781339,30,1,7,0,1,1,6,0,0,1,5,2,1,0,2,0,3
7766,781337,36,7,13,3,7,4,6,8,10,0,6,9,1,1,3,0,26
7766,797712,13,2,3,2,3,0,0,0,0,0,1,1,1,0,0,0,4
7766,799737,6,0,0,0,0,0,0,0,0,1,1,0,1,0,0,0,0
7766,797711,25,2,4,0,1,2,3,6,6,0,2,3,3,4,1,0,12
7766,797710,11,0,2,0,0,0,2,0,0,0,0,0,0,1,1,0,0
7766,797713,0,0,0,0,0,0,0,0,0,0,0,0,0,0,0,0,0
7767,792249,34,3,5,3,5,0,0,0,0,1,3,4,3,0,3,2,6
7767,781430,36,7,13,7,10,0,3,3,4,1,7,3,2,1,1,1,17
7767,792248,34,4,13,1,3,3,10,0,0,0,2,0,1,1,1,0,11
7767,781445,37,7,17,1,1,6,16,2,2,0,3,2,2,0,2,0,22
7767,768845,34,3,7,3,5,0,2,3,4,0,7,4,4,0,3,0,9
7767,781448,7,1,2,1,2,0,0,0,0,1,0,0,0,0,1,0,2
7767,792250,9,0,2,0,1,0,1,0,0,0,1,1,4,1,2,0,0
7767,797941,5,0,0,0,0,0,0,0,0,0,0,0,0,0,0,0,0
7767,792251,4,0,0,0,0,0,0,0,0,0,0,0,0,0,0,0,0
7768,786646,31,3,9,2,5,1,4,0,0,0,12,0,1,2,1,1,7
7768,780890,27,8,10,1,3,7,7,6,6,1,5,1,3,1,0,0,29
7768,786066,41,7,14,7,11,0,3,6,7,2,5,3,0,4,2,0,20
7768,780167,28,5,6,4,5,1,1,1,1,1,1,0,5,0,1,0,12
7768,775574,41,4,16,2,5,2,11,2,2,0,2,7,0,1,1,0,12
7768,775757,3,0,1,0,1,0,0,0,0,0,0,0,4,0,0,0,0
7768,791123,18,0,6,0,2,0,4,2,2,0,1,0,0,1,0,1,2
7768,785636,36,3,6,2,2,1,4,0,1,1,2,2,2,0,1,0,7
7769,792140,31,5,10,5,10,0,0,4,6,5,7,2,3,0,3,2,14
7769,786596,38,7,20,7,16,0,4,5,5,3,6,5,2,0,3,0,19
7769,792144,13,0,0,0,0,0,0,4,4,0,6,0,1,1,1,0,4
7769,785976,28,2,5,1,1,1,4,0,0,0,6,2,1,0,0,0,5
7769,781429,41,5,14,0,2,5,12,2,4,0,3,2,4,1,1,0,17
7769,797791,2,0,1,0,1,0,0,0,0,0,0,0,2,0,0,0,0
7769,792146,10,2,3,2,3,0,0,0,0,1,1,1,2,0,1,0,4
7769,797786,38,6,10,3,5,3,5,0,0,0,4,4,1,1,4,0,15
7769,781431,21,1,2,0,1,1,1,0,0,0,0,1,0,1,0,0,3
7769,797793,3,0,0,0,0,0,0,0,0,0,0,0,0,0,0,0,0
7770,790856,19,4,9,4,9,0,0,1,2,1,7,0,1,0,3,0,9
7770,780452,26,4,13,4,13,0,0,3,4,4,9,0,3,0,2,0,11
7770,796413,29,5,10,2,3,3,7,1,1,0,2,2,1,1,1,0,14
7770,796408,30,2,8,2,4,0,4,2,2,0,0,9,2,3,2,0,6
7770,796407,24,1,2,1,1,0,1,0,0,0,2,3,0,1,0,0,2
7770,796409,16,0,4,0,3,0,1,4,4,1,1,3,2,1,0,0,4
7770,796411,12,4,8,3,6,1,2,1,2,4,3,2,1,1,0,1,10
7770,796410,19,7,14,7,14,0,0,1,1,4,4,1,0,1,1,1,15
7770,780450,15,4,5,3,3,1,2,0,0,2,1,0,1,1,1,0,9
7770,798137,2,0,1,0,1,0,0,0,0,0,0,0,0,0,0,0,0
7770,796414,2,1,1,1,1,0,0,0,0,0,0,0,0,0,0,0,2
7770,775941,2,0,0,0,0,0,0,0,0,0,1,0,0,0,0,0,0
7770,780454,2,0,0,0,0,0,0,0,0,0,0,0,0,0,0,0,0
7770,781286,2,0,0,0,0,0,0,0,0,0,0,0,0,0,0,0,0
7771,780098,26,0,3,0,1,0,2,2,2,0,2,1,2,3,2,0,2
7771,797591,28,5,11,1,3,4,8,0,0,0,5,1,0,1,0,0,14
7771,781071,29,2,11,1,3,1,8,0,0,0,3,2,1,1,0,0,5
7771,791890,35,8,15,4,8,4,7,7,9,1,2,1,2,2,4,0,27
7771,780719,26,1,6,1,5,0,1,0,0,1,3,1,3,0,4,0,2
7771,797589,21,2,7,2,6,0,1,1,2,1,3,0,2,0,3,0,5
7771,797590,14,2,2,2,2,0,0,0,0,3,2,1,4,0,1,0,4
7771,791889,11,1,2,0,0,1,2,0,0,0,1,0,0,0,0,0,3
7771,797588,7,0,2,0,1,0,1,0,0,0,1,0,0,0,1,0,0
7771,791888,3,0,0,0,0,0,0,0,0,0,0,0,0,0,0,0,0
7772,790814,25,3,8,3,7,0,1,0,0,3,4,0,2,3,3,0,6
7772,796372,19,1,2,1,2,0,0,1,2,2,5,0,4,0,2,0,3
7772,780176,33,1,11,1,5,0,6,0,0,0,1,2,3,0,5,0,2
7772,796379,32,3,12,3,5,0,7,0,0,0,4,5,1,2,3,0,6
7772,790815,28,6,13,6,9,0,4,0,0,0,1,0,2,0,1,0,12
7772,796377,18,0,5,0,3,0,2,0,0,0,1,1,2,0,2,0,0
7772,786013,20,1,2,1,2,0,0,1,4,4,3,1,3,1,0,1,3
7772,796374,15,1,2,0,0,1,2,0,0,0,1,2,0,0,1,0,3
7772,796378,5,0,1,0,1,0,0,0,0,1,1,0,0,0,1,0,0
7772,796376,1,1,1,0,0,1,1,0,0,0,1,0,0,0,0,0,3
7772,790817,1,1,1,0,0,1,1,0,0,0,0,0,0,0,0,0,3
7772,796373,2,0,0,0,0,0,0,0,0,0,0,0,0,0,0,0,0
7772,796375,1,0,0,0,0,0,0,0,0,0,0,0,0,0,0,0,0
7773,790810,30,3,8,2,5,1,3,4,6,1,8,1,0,0,1,0,11
7773,785362,25,4,7,4,7,0,0,0,0,1,3,2,0,2,3,0,8
7773,785361,34,3,9,2,4,1,5,2,2,1,4,0,1,1,2,0,9
7773,790808,27,1,3,1,1,0,2,3,6,0,3,1,1,2,2,1,5
7773,779997,30,5,9,3,5,2,4,2,3,1,2,2,2,2,3,1,14
7773,774854,13,2,3,2,3,0,0,0,0,1,2,0,3,0,1,0,4
7773,796370,20,3,4,3,4,0,0,0,0,0,3,1,1,1,1,0,6
7773,790809,10,1,3,1,3,0,0,0,0,1,1,2,1,3,2,0,2
7773,790811,4,0,1,0,0,0,1,0,0,0,0,0,0,0,1,0,0
7773,779999,1,0,1,0,0,0,1,0,0,0,0,0,0,0,0,0,0
7773,796371,2,0,0,0,0,0,0,0,0,0,0,0,0,0,0,0,0
7773,796369,2,0,0,0,0,0,0,0,0,0,0,0,0,0,0,0,0
7773,796368,2,0,0,0,0,0,0,0,0,0,0,0,0,0,0,0,0
7774,796444,31,9,11,8,10,1,1,3,4,3,6,7,2,2,2,3,22
7774,790893,33,9,15,8,13,1,2,1,2,5,7,2,2,1,1,1,20
7774,786615,25,4,8,3,6,1,2,2,4,1,2,1,1,1,1,0,11
7774,786732,14,0,0,0,0,0,0,0,0,0,0,1,2,0,0,0,0
7774,775260,30,7,13,3,7,4,6,0,0,0,3,4,0,1,1,0,18
7774,775536,12,0,5,0,5,0,0,0,0,1,2,0,0,0,1,0,0
7774,790890,22,3,5,1,3,2,2,0,0,1,0,4,2,0,2,0,8
7774,790889,21,2,4,1,1,1,3,0,0,0,3,2,2,0,1,0,5
7774,780702,9,1,3,0,0,1,3,0,0,0,0,0,0,0,1,0,3
7774,796445,1,1,1,1,1,0,0,0,0,0,0,0,1,0,0,0,2
7774,799891,2,0,1,0,0,0,1,0,0,0,1,0,0,0,0,0,0
7774,796132,0,0,0,0,0,0,0,0,0,0,0,0,0,0,0,0,0
7774,792678,0,0,0,0,0,0,0,0,0,0,0,0,0,0,0,0,0
7775,790781,18,4,5,4,5,0,0,2,2,2,3,1,5,2,1,0,10
7775,780040,34,5,12,5,12,0,0,2,2,4,2,4,1,1,1,1,12
7775,790785,23,3,11,2,8,1,3,0,0,0,2,1,2,1,1,0,7
7775,781232,34,1,5,0,2,1,3,1,1,0,1,1,3,0,0,0,4
7775,780037,35,12,19,8,14,4,5,2,2,1,1,3,3,0,4,0,30
7775,796339,28,2,7,0,3,2,4,0,0,0,5,1,0,1,2,0,6
7775,790783,17,0,0,0,0,0,0,0,0,0,3,0,3,0,1,0,0
7775,790780,0,0,0,0,0,0,0,2,2,0,0,0,0,0,0,0,2
7775,792440,2,0,1,0,1,0,0,0,0,0,0,0,0,0,0,0,0
7775,796343,9,0,0,0,0,0,0,0,0,0,1,0,0,0,0,0,0
7775,780045,0,0,0,0,0,0,0,0,0,0,0,0,0,0,0,0,0
7776,790899,17,5,7,5,7,0,0,4,4,2,1,0,2,0,0,1,14
7776,785442,26,3,6,2,3,1,3,1,2,1,5,1,3,0,2,1,8
7776,799907,29,1,6,0,2,1,4,0,0,1,0,2,3,0,1,0,3
7776,785579,34,5,10,3,7,2,3,0,0,0,1,1,0,1,2,0,12
7776,781628,24,3,9,2,4,1,5,3,6,1,7,1,4,0,1,0,10
7776,790897,16,2,5,1,2,1,3,0,0,1,1,1,1,0,2,0,5
7776,790898,18,0,2,0,0,0,2,2,2,0,2,2,0,0,0,1,2
7776,775737,15,1,3,0,0,1,3,2,2,1,2,0,2,0,1,0,5
7776,775959,10,0,3,0,1,0,2,0,0,0,0,0,0,0,0,1,0
7776,796447,11,0,0,0,0,0,0,1,2,0,1,0,0,0,0,1,1
7777,790761,24,5,9,4,6,1,3,0,0,1,3,2,2,0,4,1,11
7777,790764,31,8,9,5,5,3,4,3,6,0,4,2,2,1,0,0,22
7777,796322,19,3,5,3,5,0,0,3,4,2,5,1,3,0,1,2,9
7777,796319,30,7,12,6,8,1,4,1,1,4,3,3,1,2,0,0,16
7777,796320,28,1,6,1,4,0,2,0,0,1,3,1,1,0,0,0,2
7777,796321,16,3,5,2,3,1,2,0,1,0,5,4,3,0,0,1,7
7777,779993,27,2,6,1,3,1,3,0,0,2,1,4,1,2,1,0,5
7777,785219,17,4,7,0,0,4,7,0,0,0,0,0,1,0,0,0,12
7777,796323,6,0,2,0,2,0,0,0,0,0,1,0,0,0,0,0,0
7777,775668,2,0,0,0,0,0,0,0,1,0,0,0,1,0,0,0,0
7778,781174,18,3,5,3,5,0,0,2,2,4,3,2,5,1,0,0,8
7778,781159,29,3,8,2,4,1,4,1,1,2,4,1,3,0,3,1,8
7778,791001,33,3,8,1,4,2,4,0,0,0,4,4,0,2,1,0,8
7778,781215,29,5,11,4,8,1,3,1,1,0,5,2,3,1,1,0,12
7778,775255,34,8,17,5,11,3,6,7,8,0,3,3,2,0,4,0,26
7778,796644,19,3,4,3,4,0,0,0,0,1,0,0,3,0,0,0,6
7778,785320,14,2,4,1,1,1,3,3,3,0,0,0,2,0,0,0,8
7778,779972,24,1,6,1,3,0,3,1,2,0,4,1,0,0,1,0,3
7779,781579,30,5,9,5,7,0,2,0,0,2,4,2,4,1,1,0,10
7779,786731,32,12,21,12,21,0,0,8,9,3,7,0,4,0,4,2,32
7779,798008,33,1,5,0,2,1,3,0,0,0,3,6,3,0,2,0,3
7779,781584,29,1,6,1,1,0,5,0,2,0,2,2,3,0,1,0,2
7779,780347,37,5,11,5,9,0,2,1,2,2,1,3,1,4,3,0,11
7779,775696,14,3,5,2,2,1,3,0,0,1,5,0,3,0,1,0,7
7779,776481,8,0,1,0,1,0,0,0,0,1,0,0,1,0,0,0,0
7779,792358,17,2,5,1,4,1,1,0,0,0,3,1,1,1,1,1,5
7779,798017,0,0,0,0,0,0,0,0,0,0,0,0,0,0,0,0,0
7780,775954,30,7,12,7,12,0,0,5,7,1,5,3,1,2,2,0,19
7780,796459,27,4,8,4,8,0,0,8,8,1,2,5,1,0,3,0,16
7780,781157,32,9,16,2,6,7,10,4,6,1,1,4,1,1,0,1,29
7780,781006,29,5,6,5,6,0,0,0,0,3,6,1,3,2,3,1,10
7780,796464,20,3,5,3,4,0,1,1,2,1,1,5,4,0,5,0,7
7780,790918,18,0,0,0,0,0,0,0,0,1,3,1,0,0,0,0,0
7780,796194,28,2,7,0,0,2,7,2,2,0,5,5,2,0,3,0,8
7780,790916,10,0,1,0,1,0,0,0,0,0,1,1,1,2,0,0,0
7780,785238,2,1,2,1,2,0,0,0,1,2,0,1,0,0,0,0,2
7780,790919,2,1,2,1,1,0,1,0,0,0,0,0,1,0,0,0,2
7780,780648,2,0,0,0,0,0,0,0,0,0,1,0,0,1,0,0,0
7781,785453,28,8,20,4,10,4,10,0,0,2,2,0,3,1,2,0,20
7781,790911,6,0,0,0,0,0,0,1,2,1,0,0,0,0,0,0,1
7781,790914,24,3,4,3,4,0,0,0,0,2,3,1,3,1,1,0,6
7781,774940,26,1,9,0,5,1,4,0,0,0,2,7,1,1,0,0,3
7781,785458,34,4,12,3,9,1,3,6,6,1,6,2,3,3,7,1,15
7781,790915,7,1,3,1,3,0,0,0,0,1,1,0,4,2,1,1,2
7781,785456,25,1,1,0,0,1,1,2,2,0,2,0,2,2,1,0,5
7781,785454,22,6,11,3,6,3,5,0,0,0,0,3,2,0,1,0,15
7781,790913,19,1,3,1,2,0,1,2,2,1,1,3,4,1,5,0,4
7781,800055,9,1,2,1,2,0,0,0,0,2,0,0,1,0,0,1,2
7794,785622,28,3,6,2,2,1,4,3,3,1,0,1,1,0,1,0,10
7794,781058,24,1,2,1,2,0,0,1,2,2,4,0,1,0,1,0,3
7794,780327,23,1,4,1,4,0,0,4,5,0,2,2,4,1,0,0,6
7794,797458,19,2,6,1,3,1,3,0,0,0,2,1,0,0,2,1,5
7794,797451,34,3,9,2,6,1,3,2,2,2,0,1,1,0,2,0,9
7794,797457,2,0,0,0,0,0,0,0,0,0,0,0,0,0,0,1,0
7794,797455,15,0,1,0,1,0,0,0,0,1,4,0,3,0,2,0,0
7794,797456,7,0,2,0,0,0,2,0,0,0,1,0,2,0,0,0,0
7794,797453,15,0,4,0,4,0,0,3,4,1,1,1,1,0,0,0,3
7794,791848,7,0,3,0,0,0,3,0,0,0,0,0,0,0,0,0,0
7794,791849,22,4,9,0,1,4,8,1,2,0,2,0,2,1,2,0,13
7794,786607,4,0,1,0,0,0,1,0,0,0,0,0,0,0,0,0,0
7795,791289,20,3,4,3,4,0,0,0,2,2,4,0,4,0,1,3,6
7795,796576,23,2,4,1,1,1,3,2,2,0,1,2,3,1,1,1,7
7795,796571,32,2,3,2,2,0,1,0,0,1,5,2,4,5,0,0,4
7795,796572,23,3,5,2,3,1,2,1,3,2,4,3,2,0,0,0,8
7795,781346,34,8,14,4,10,4,4,2,2,0,1,3,2,1,1,0,22
7795,785786,13,0,0,0,0,0,0,0,0,0,2,0,1,0,1,0,0
7795,791287,6,0,0,0,0,0,0,0,0,1,1,0,1,0,1,0,0
7795,796574,28,5,13,3,6,2,7,4,4,0,3,2,2,0,0,0,16
7795,791290,21,4,6,1,1,3,5,3,4,1,4,1,1,1,0,1,14
7796,791011,26,4,7,2,4,2,3,2,2,1,1,3,1,0,0,0,12
7796,785337,30,6,11,6,10,0,1,3,4,4,1,2,2,1,4,0,15
7796,796668,14,3,6,2,3,1,3,0,0,1,0,0,2,1,0,0,7
7796,791012,32,2,9,1,2,1,7,1,1,2,2,3,2,1,1,0,6
7796,781221,27,3,9,0,1,3,8,3,4,0,3,1,1,0,1,0,12
7796,796670,12,2,2,2,2,0,0,1,1,0,0,1,1,0,0,0,5
7796,796671,22,3,3,3,3,0,0,2,3,1,6,0,1,0,2,1,8
7796,791594,22,2,9,1,5,1,4,0,0,0,3,3,1,1,0,0,5
7796,791013,15,0,2,0,2,0,0,1,2,0,2,4,3,0,1,0,1
7797,797103,21,2,2,2,2,0,0,1,2,1,3,2,1,1,2,0,5
7797,797105,35,7,12,6,8,1,4,5,5,1,7,4,0,2,0,0,20
7797,797100,19,2,4,2,3,0,1,2,2,0,5,5,4,0,0,0,6
7797,791413,39,4,7,1,2,3,5,2,2,1,1,2,2,0,1,1,13
7797,785776,38,6,11,2,3,4,8,2,2,0,4,2,1,1,1,0,18
7797,791414,8,2,2,2,2,0,0,0,0,1,0,1,2,0,1,1,4
7797,785911,18,1,3,1,2,0,1,0,0,1,2,0,4,0,1,1,2
7797,797101,1,1,1,1,1,0,0,0,0,0,0,0,0,0,0,0,2
7797,781209,21,6,12,4,6,2,6,4,4,0,1,0,1,0,1,0,18
7798,786029,31,1,1,1,1,0,0,2,3,4,2,1,1,0,2,5,4
7798,781398,19,2,4,1,2,1,2,0,0,2,3,2,4,0,1,1,5
7798,792114,39,5,14,3,7,2,7,4,6,1,1,3,1,1,0,0,16
7798,786018,37,3,10,1,5,2,5,4,4,2,4,1,4,2,4,0,12
7798,775678,31,6,11,3,7,3,4,1,2,1,2,3,1,1,4,0,16
7798,797746,18,0,1,0,0,0,1,4,4,0,4,0,0,0,2,1,4
7798,786022,9,0,1,0,0,0,1,0,0,0,0,0,2,1,0,0,0
7798,797740,16,3,7,1,5,2,2,3,4,0,2,1,0,0,1,0,11
7799,776286,22,4,7,3,5,1,2,1,2,4,2,0,3,3,2,1,10
7799,775557,25,2,4,2,4,0,0,0,0,1,1,0,3,0,2,3,4
7799,791445,36,4,10,3,4,1,6,0,0,1,2,2,2,2,1,0,9
7799,785357,39,5,12,2,6,3,6,0,3,1,2,2,1,0,1,0,13
7799,775560,29,5,11,2,4,3,7,3,4,0,2,3,4,2,1,0,16
7799,781627,8,1,3,1,2,0,1,1,2,1,0,1,0,0,1,0,3
7799,785287,15,1,4,1,4,0,0,0,0,0,1,0,4,0,0,1,2
7799,797010,16,2,6,2,4,0,2,0,0,1,4,2,0,0,1,0,4
7799,791444,10,1,2,1,2,0,0,0,0,2,1,0,1,0,1,0,2
7800,781158,18,1,2,1,2,0,0,2,4,1,0,2,1,1,1,0,4
7800,781652,40,3,11,3,8,0,3,1,1,0,3,1,2,0,2,0,7
7800,786034,33,4,8,2,3,2,5,2,3,1,3,0,1,1,0,0,12
7800,786419,34,8,16,5,9,3,7,4,7,1,6,3,4,0,2,0,23
7800,781283,23,2,6,0,2,2,4,0,0,0,0,2,2,1,1,0,6
7800,781653,20,3,6,3,6,0,0,2,3,3,1,0,4,0,0,0,8
7800,791615,28,5,9,4,6,1,3,0,0,0,2,3,2,1,2,0,11
7800,785277,4,0,0,0,0,0,0,0,0,0,1,0,0,0,0,0,0
7801,792329,37,4,7,3,4,1,3,2,2,0,5,1,1,0,2,0,11
7801,786752,34,9,17,8,11,1,6,2,2,1,5,0,3,1,0,0,21
7801,781384,20,1,3,1,3,0,0,0,0,1,2,5,3,1,1,0,2
7801,781616,30,6,9,0,2,6,7,2,2,0,4,1,3,0,3,0,20
7801,776350,33,7,10,5,7,2,3,4,4,1,7,2,2,0,4,0,20
7801,781075,7,0,1,0,0,0,1,0,0,1,1,0,2,0,0,0,0
7801,781615,23,1,2,1,1,0,1,2,2,0,3,1,3,1,0,0,4
7801,786749,16,1,4,1,4,0,0,0,0,0,0,1,1,0,0,0,2
7802,782133,26,6,14,5,8,1,6,5,6,3,5,2,0,0,1,0,18
7802,785123,31,8,13,8,12,0,1,0,0,3,3,2,2,0,2,3,16
7802,790990,34,3,8,3,5,0,3,1,2,1,3,2,1,2,0,0,7
7802,789219,36,1,9,0,1,1,8,4,4,1,1,1,3,1,0,0,7
7802,785059,37,4,9,3,5,1,4,0,0,2,7,2,3,1,3,0,9
7802,785305,8,0,1,0,1,0,0,0,0,0,1,1,0,0,0,0,0
7802,796622,9,1,2,1,2,0,0,2,2,0,1,1,0,0,0,0,4
7802,796623,14,1,4,1,1,0,3,0,0,0,2,3,0,0,1,0,2
7802,785122,5,0,1,0,0,0,1,0,0,0,0,0,0,0,0,0,0
7803,791352,29,3,7,3,4,0,3,0,0,0,3,0,1,3,0,0,6
7803,780455,14,1,5,1,5,0,0,1,2,0,3,0,4,0,2,2,3
7803,797251,19,2,5,2,4,0,1,0,0,3,3,0,3,1,1,1,4
7803,797247,36,2,8,1,4,1,4,4,4,0,3,7,0,0,1,0,9
7803,776297,32,9,15,5,7,4,8,2,2,0,8,2,1,0,1,0,24
7803,797250,0,0,0,0,0,0,0,0,0,0,1,0,0,0,0,0,0
7803,791355,6,0,1,0,0,0,1,0,0,0,1,0,1,0,0,0,0
7803,791354,5,1,1,1,1,0,0,0,0,0,0,0,1,0,1,0,2
7803,785837,18,1,3,1,3,0,0,1,2,3,1,1,1,0,2,0,3
7803,786227,13,0,2,0,2,0,0,1,2,1,2,0,2,0,1,0,1
7803,797249,7,1,2,1,1,0,1,0,0,1,0,0,0,0,1,0,2
7803,797248,21,2,8,1,4,1,4,0,0,1,1,1,1,1,0,0,5
7804,791306,23,5,7,3,4,2,3,8,10,3,5,0,4,0,1,1,20
7804,780210,33,8,16,8,13,0,3,6,7,6,6,3,3,1,2,0,22
7804,796594,36,5,14,3,6,2,8,0,0,0,2,2,0,1,2,0,12
7804,792432,23,2,5,2,4,0,1,4,4,1,3,5,2,1,2,0,8
7804,775005,29,4,8,1,2,3,6,2,2,1,2,1,1,0,0,1,13
7804,796595,2,0,0,0,0,0,0,0,0,0,0,0,1,0,0,0,0
7804,796592,18,0,0,0,0,0,0,0,0,1,3,0,0,0,1,0,0
7804,790880,4,0,1,0,0,0,1,0,0,0,1,0,1,0,1,0,0
7804,792433,11,0,0,0,0,0,0,0,0,0,3,1,4,0,1,0,0
7804,786422,19,2,4,2,4,0,0,0,0,1,1,3,2,1,1,0,4
7804,792989,2,0,0,0,0,0,0,0,0,0,0,0,0,0,0,0,0
7805,791723,24,1,3,1,2,0,1,0,0,2,0,1,5,0,0,1,2
7805,797310,30,1,4,0,2,1,2,0,0,0,2,4,2,0,4,0,3
7805,791724,19,4,8,4,8,0,0,0,1,1,3,1,4,1,2,0,8
7805,797308,19,0,3,0,1,0,2,3,4,1,1,0,1,0,1,0,3
7805,781617,31,4,6,3,3,1,3,8,10,1,2,3,4,1,3,0,17
7805,797312,13,3,5,2,3,1,2,0,0,0,2,0,0,1,0,0,7
7805,780956,30,6,15,4,10,2,5,0,0,1,1,0,2,0,2,0,14
7805,786277,2,0,0,0,0,0,0,0,0,0,0,0,0,0,0,0,0
7805,800056,21,1,4,0,1,1,3,0,0,1,4,1,2,0,0,0,3
7805,780706,11,0,3,0,1,0,2,0,0,0,2,1,1,0,2,0,0
7806,796404,35,9,14,9,13,0,1,1,1,4,5,4,3,3,1,4,19
7806,790853,22,1,3,1,3,0,0,0,0,3,5,0,3,0,1,0,2
7806,790850,32,2,11,0,4,2,7,4,4,0,1,0,0,2,1,0,10
7806,781164,30,1,4,0,1,1,3,2,2,1,5,4,0,1,2,1,5
7806,781163,37,8,15,7,10,1,5,8,8,2,3,8,0,4,4,2,25
7806,796406,13,3,3,3,3,0,0,1,2,1,2,1,5,0,0,0,7
7806,785434,4,0,2,0,2,0,0,0,0,0,0,0,1,0,1,0,0
7806,796405,3,0,0,0,0,0,0,0,0,0,0,0,1,1,1,0,0
7806,790854,3,1,1,1,1,0,0,0,0,1,1,0,0,0,0,1,2
7806,790848,2,1,2,1,2,0,0,0,0,0,0,0,0,1,0,0,2
7806,790849,16,1,5,1,4,0,1,0,0,0,1,1,1,0,1,0,2
7806,781223,3,0,1,0,0,0,1,0,0,0,0,0,1,0,0,0,0
7806,790852,0,0,0,0,0,0,0,0,0,0,0,0,0,0,0,0,0
7807,786724,32,2,8,0,1,2,7,0,0,2,2,3,0,1,1,1,6
7807,786723,38,9,17,9,17,0,0,6,6,2,7,5,2,2,6,0,24
7807,792349,21,5,7,4,6,1,1,5,5,1,2,0,2,0,3,0,16
7807,798060,30,0,2,0,1,0,1,0,0,0,3,3,2,1,4,1,0
7807,792355,29,1,11,1,4,0,7,2,2,0,1,0,1,1,1,0,4
7807,786726,16,3,4,3,4,0,0,0,0,0,2,0,3,0,1,0,6
7807,798061,21,0,2,0,1,0,1,0,0,0,3,0,5,0,2,1,0
7807,792348,11,0,1,0,0,0,1,0,0,0,1,0,1,0,1,0,0
7807,798059,2,0,0,0,0,0,0,0,0,0,0,0,2,0,0,0,0
7807,781573,0,0,0,0,0,0,0,0,0,0,0,0,0,0,1,0,0
7807,792353,0,0,0,0,0,0,0,0,0,0,0,0,0,0,0,0,0
7808,797873,26,2,5,2,5,0,0,2,3,2,1,1,2,0,1,0,6
7808,797877,25,2,6,2,6,0,0,4,6,1,2,1,2,0,0,1,8
7808,797872,34,4,9,4,8,0,1,2,2,0,3,1,3,0,1,0,10
7808,791338,20,0,2,0,1,0,1,0,2,0,2,2,4,1,0,1,0
7808,791339,36,12,28,10,18,2,10,1,1,3,7,4,3,0,2,1,27
7808,791335,5,0,1,0,0,0,1,0,0,0,0,0,0,0,0,0,0
7808,791337,15,1,1,1,1,0,0,0,0,0,0,0,2,0,1,1,2
7808,785881,2,0,0,0,0,0,0,0,0,0,0,0,0,0,0,0,0
7808,781599,10,1,1,1,1,0,0,1,1,0,1,1,1,0,0,0,3
7808,797875,2,0,1,0,0,0,1,0,0,0,0,0,0,0,0,0,0
7808,797874,10,3,6,0,0,3,6,0,0,1,0,1,3,0,1,0,9
7808,781595,15,2,6,1,5,1,1,0,0,1,2,0,2,1,1,0,5
7809,785459,23,10,14,10,14,0,0,2,2,2,4,2,1,0,1,1,22
7809,789102,27,1,5,0,3,1,2,0,0,0,5,3,4,0,2,0,3
7809,789101,23,2,6,1,3,1,3,3,4,1,2,0,3,0,1,0,8
7809,781371,17,0,2,0,1,0,1,0,2,1,2,0,1,1,3,0,0
7809,781367,20,1,4,1,1,0,3,1,1,0,4,0,1,0,1,0,3
7809,797731,11,1,2,1,2,0,0,0,0,0,3,0,0,0,3,0,2
7809,792066,24,1,2,1,2,0,0,3,4,4,5,1,1,1,0,0,5
7809,792064,19,2,6,0,1,2,5,2,2,1,1,2,2,0,0,0,8
7809,792063,17,4,7,2,3,2,4,7,9,0,0,3,3,0,1,0,17
7809,792061,4,1,2,0,0,1,2,0,0,0,0,0,1,0,0,0,3
7809,788037,15,2,4,2,3,0,1,1,2,0,7,5,1,2,1,0,5
7810,797819,13,1,1,1,1,0,0,0,0,0,3,1,2,0,1,1,2
7810,792186,29,7,11,7,11,0,0,1,2,0,1,0,1,1,0,0,15
7810,781447,30,6,6,6,6,0,0,1,2,1,5,1,2,2,2,0,13
7810,792188,32,3,8,1,3,2,5,2,2,0,4,3,0,2,1,1,10
7810,792183,38,5,12,1,4,4,8,8,8,0,3,13,2,4,2,0,22
7810,797821,18,5,9,3,5,2,4,1,1,1,3,1,2,0,1,0,13
7810,780433,4,0,1,0,1,0,0,0,0,0,0,0,0,0,0,0,0
7810,781490,9,0,2,0,1,0,1,0,0,0,0,3,0,1,1,0,0
7810,792185,7,0,1,0,0,0,1,0,0,1,0,0,1,0,0,0,0
7810,786675,20,5,9,2,3,3,6,3,3,0,0,2,3,1,1,0,16
7811,797824,29,3,6,2,4,1,2,2,2,4,6,1,2,1,2,0,9
7811,775116,29,3,6,1,2,2,4,2,2,2,2,4,2,0,2,0,10
7811,797822,32,8,14,4,7,4,7,3,5,1,6,1,0,0,4,0,23
7811,792190,35,3,4,3,4,0,0,2,2,1,1,3,3,0,3,0,8
7811,786664,37,10,22,5,10,5,12,1,4,0,4,5,3,1,2,1,26
7811,797825,18,3,3,3,3,0,0,0,0,1,2,1,0,0,1,2,6
7811,792191,9,0,1,0,1,0,0,2,2,0,1,0,2,0,3,0,2
7811,791928,11,1,1,1,1,0,0,0,0,0,0,1,2,0,3,0,2
7812,790798,19,5,7,5,7,0,0,2,2,1,3,0,3,1,2,0,12
7812,780140,28,8,13,7,9,1,4,3,4,0,3,1,0,1,2,1,20
7812,796355,25,3,6,3,6,0,0,2,2,0,2,5,2,1,2,0,8
7812,785245,29,4,7,3,5,1,2,1,1,0,2,5,1,1,1,1,10
7812,790795,3,0,0,0,0,0,0,0,0,0,1,0,0,0,0,0,0
7812,790799,15,3,4,3,4,0,0,2,4,0,4,0,2,0,0,1,8
7812,775553,16,1,3,0,2,1,1,1,2,0,0,1,1,2,1,0,4
7812,796354,11,0,0,0,0,0,0,0,0,0,0,0,2,0,2,0,0
7812,796359,13,1,3,1,2,0,1,0,0,0,0,2,0,0,2,0,2
7812,790796,4,0,1,0,1,0,0,2,2,0,0,0,0,0,0,1,2
7812,799892,4,1,1,1,1,0,0,0,0,0,0,0,1,0,1,0,2
7812,780137,29,6,8,2,3,4,5,0,0,2,4,2,2,0,2,0,16
7812,788844,2,1,1,0,0,1,1,0,0,0,0,0,0,0,0,0,3
7812,794905,2,0,0,0,0,0,0,0,0,0,0,0,0,0,0,0,0
7813,792121,23,0,2,0,0,0,2,0,0,1,4,0,2,0,2,0,0
7813,786257,24,4,10,4,9,0,1,4,5,1,2,1,4,1,5,0,12
7813,786263,29,2,5,1,1,1,4,2,2,1,5,1,1,1,0,1,7
7813,785661,29,5,10,5,8,0,2,3,3,0,3,1,3,3,5,0,13
7813,775825,28,2,4,2,4,0,0,0,0,1,1,4,2,0,2,0,4
7813,792122,13,0,2,0,1,0,1,0,0,0,1,2,2,0,1,0,0
7813,797721,22,6,10,2,4,4,6,0,0,2,1,0,2,1,0,0,16
7813,786249,5,0,0,0,0,0,0,0,0,1,0,0,1,0,1,0,0
7813,797725,16,5,7,5,7,0,0,0,0,1,0,0,1,1,2,2,10
7813,797724,11,1,5,0,1,1,4,0,0,0,1,0,2,0,0,0,3
7814,797817,22,1,3,1,2,0,1,1,2,0,6,8,0,1,2,0,3
7814,783072,23,4,6,3,5,1,1,5,6,3,7,0,3,0,0,0,14
7814,781463,27,5,6,3,3,2,3,0,0,0,3,4,2,1,0,1,12
7814,791540,29,4,11,0,2,4,9,0,0,0,1,3,2,2,0,0,12
7814,776068,27,11,17,5,5,6,12,3,4,0,3,5,1,2,1,0,31
7814,792151,1,0,0,0,0,0,0,0,0,0,0,0,0,0,0,0,0
7814,785647,13,1,3,1,1,0,2,0,0,2,3,0,2,1,1,0,2
7814,785962,6,1,3,1,3,0,0,0,0,1,0,0,0,0,0,0,2
7814,797818,3,1,1,0,0,1,1,0,0,0,0,0,0,2,1,0,3
7814,793057,6,0,0,0,0,0,0,0,0,0,0,1,2,0,1,0,0
7814,792153,24,3,5,0,0,3,5,0,0,0,2,0,0,0,1,0,9
7814,781202,19,1,2,0,0,1,2,1,2,0,1,0,1,0,0,0,4
7815,791891,17,1,2,1,2,0,0,0,0,2,3,0,2,0,0,0,2
7815,786501,25,3,6,2,2,1,4,2,2,0,1,0,2,0,1,0,9
7815,781078,17,3,8,3,3,0,5,0,0,0,0,1,1,0,0,0,6
7815,786502,34,7,19,6,17,1,2,6,9,1,6,4,2,0,3,0,21
7815,781561,17,0,3,0,2,0,1,0,0,0,2,3,1,2,4,0,0
7815,797587,18,1,1,1,1,0,0,1,1,1,3,1,2,0,2,0,3
7815,797586,9,0,1,0,1,0,0,0,0,3,0,0,0,0,1,0,0
7815,791894,4,0,1,0,1,0,0,0,0,0,0,0,0,1,1,0,0
7815,791895,25,2,5,1,4,1,1,1,1,0,2,2,2,1,1,0,6
7815,791892,2,0,0,0,0,0,0,0,0,0,0,0,0,0,0,0,0
7815,797583,3,0,0,0,0,0,0,0,0,0,0,0,0,0,0,0,0
7815,781080,29,3,7,0,2,3,5,3,3,0,1,1,1,1,2,0,12
7816,791750,29,1,5,0,0,1,5,0,0,0,5,1,3,2,1,0,3
7816,786177,22,2,4,0,1,2,3,0,0,1,1,0,4,0,1,0,6
7816,780244,32,0,3,0,2,0,1,1,2,1,3,3,4,2,1,1,1
7816,786179,34,5,12,5,5,0,7,0,0,0,3,2,2,2,1,0,10
7816,780238,40,11,26,7,14,4,12,7,8,2,1,3,2,3,4,0,33
7816,791752,16,1,1,1,1,0,0,0,2,0,2,0,4,0,0,0,2
7816,790773,21,3,8,1,1,2,7,0,0,1,3,0,2,3,0,0,8
7816,781500,3,0,2,0,2,0,0,0,0,0,0,0,0,0,0,0,0
7816,785909,3,0,0,0,0,0,0,0,0,0,0,0,0,0,0,0,0
7817,791537,38,4,9,2,5,2,4,4,4,0,5,1,2,2,1,0,14
7817,786358,40,4,7,2,4,2,3,2,2,1,5,0,2,0,5,0,12
7817,775418,35,3,5,3,5,0,0,5,8,2,13,0,4,1,4,0,11
7817,780306,40,6,11,5,10,1,1,5,7,1,5,7,3,0,8,0,18
7817,797116,20,1,4,1,4,0,0,2,2,0,1,2,5,1,0,0,4
7817,791535,27,4,4,3,3,1,1,0,2,0,5,1,0,0,2,0,9
7818,791281,35,5,12,4,10,1,2,6,6,5,8,4,1,3,4,0,17
7818,792276,24,4,10,1,5,3,5,0,0,0,3,2,0,0,1,0,11
7818,791278,32,1,5,1,3,0,2,4,4,2,2,0,4,0,0,0,6
7818,786026,21,2,7,2,7,0,0,1,2,1,2,1,3,1,3,0,5
7818,785507,25,1,6,0,1,1,5,0,0,1,1,1,1,1,0,0,3
7818,796534,15,0,0,0,0,0,0,0,0,0,0,1,0,0,2,0,0
7818,785764,9,3,3,3,3,0,0,0,3,0,3,0,4,0,1,0,6
7818,796536,8,1,3,1,3,0,0,0,0,2,2,0,2,0,1,0,2
7818,796535,16,1,3,0,0,1,3,0,0,0,1,1,0,0,2,0,3
7818,785398,5,0,3,0,2,0,1,0,0,0,1,0,1,0,0,0,0
7818,775814,10,0,2,0,2,0,0,0,0,0,0,0,0,1,0,0,0
7819,786157,24,1,5,1,5,0,0,0,0,1,7,1,4,0,1,1,2
7819,780676,32,6,12,6,11,0,1,7,8,1,4,0,1,3,2,0,19
7819,791756,30,8,14,6,11,2,3,0,0,1,1,3,2,2,2,0,18
7819,780992,23,3,5,1,2,2,3,0,0,0,0,1,0,0,0,0,8
7819,780677,36,5,10,4,5,1,5,2,2,2,2,0,3,1,1,0,13
7819,791754,11,0,2,0,1,0,1,0,0,0,5,0,2,0,0,1,0
7819,775533,16,1,2,1,1,0,1,0,0,0,3,0,4,1,1,1,2
7819,797348,14,2,3,2,3,0,0,1,4,0,2,3,2,0,0,0,5
7819,780673,14,0,1,0,0,0,1,0,0,0,1,0,0,0,2,0,0
7820,797831,31,4,10,1,4,3,6,0,0,3,4,9,3,0,0,0,11
7820,785950,28,2,4,1,3,1,1,0,0,1,2,2,2,0,0,0,5
7820,797823,25,5,10,5,7,0,3,0,0,2,6,0,3,1,1,1,10
7820,797826,22,0,1,0,1,0,0,0,0,0,0,1,2,1,0,0,0
7820,792280,31,12,20,8,14,4,6,4,5,1,8,7,1,3,2,0,32
7820,792287,1,0,1,0,1,0,0,0,0,0,0,0,0,0,0,0,0
7820,792283,21,3,4,1,1,2,3,3,4,1,3,0,0,1,0,0,11
7820,792286,12,1,1,1,1,0,0,1,2,0,0,1,3,0,1,1,3
7820,797829,12,0,2,0,2,0,0,2,4,2,1,1,2,0,1,2,2
7820,799468,16,3,5,1,1,2,4,0,0,0,1,1,0,0,1,0,8
7820,797833,1,0,0,0,0,0,0,0,0,0,0,0,0,0,0,0,0
7821,785532,24,4,8,4,8,0,0,2,5,2,3,0,1,1,2,0,10
7821,780063,30,3,8,2,6,1,2,0,0,1,2,1,3,0,2,1,7
7821,796734,9,1,2,1,2,0,0,0,1,0,1,1,3,0,1,0,2
7821,791055,9,0,1,0,0,0,1,0,0,0,0,1,0,1,0,0,0
7821,775926,28,2,8,0,1,2,7,0,0,1,4,3,1,0,1,1,6
7821,796733,8,0,1,0,0,0,1,0,0,0,0,0,0,0,0,0,0
7821,791058,10,0,0,0,0,0,0,0,0,0,2,0,0,0,0,1,0
7821,791059,4,0,0,0,0,0,0,0,0,0,0,0,1,0,0,0,0
7821,791057,16,0,3,0,3,0,0,4,6,1,1,1,3,0,0,0,4
7821,791280,12,0,4,0,3,0,1,0,0,0,0,0,0,0,1,0,0
7821,791056,5,2,3,2,3,0,0,0,0,0,0,1,0,0,0,0,4
7821,785530,23,5,9,3,5,2,4,4,5,0,3,0,4,0,3,0,16
7821,775573,22,1,3,1,2,0,1,0,0,0,1,3,2,0,1,0,2
7822,790844,31,1,3,1,3,0,0,5,7,1,2,0,2,2,0,0,7
7822,775142,30,5,14,3,9,2,5,1,1,1,4,1,5,5,4,0,13
7822,790843,36,8,13,7,9,1,4,1,3,1,6,2,1,1,3,2,18
7822,786212,32,3,9,2,3,1,6,0,0,0,6,1,2,1,0,0,7
7822,785392,39,4,10,4,8,0,2,3,4,0,3,1,1,2,3,0,11
7822,781563,10,0,1,0,1,0,0,0,0,0,1,0,0,0,2,0,0
7822,799986,16,2,3,2,3,0,0,0,0,1,1,0,1,0,1,3,4
7822,796914,6,0,0,0,0,0,0,0,0,0,0,0,0,0,0,0,0
7823,775640,18,1,5,1,5,0,0,4,4,2,3,1,1,0,1,0,6
7823,780919,29,0,5,0,5,0,0,2,2,2,5,0,3,0,4,0,2
7823,785803,31,2,5,0,1,2,4,0,0,0,2,1,4,2,2,1,6
7823,780920,36,5,10,5,7,0,3,0,0,2,2,2,2,1,1,0,10
7823,780914,31,6,13,4,7,2,6,2,3,3,8,0,2,0,4,0,16
7823,775816,22,5,9,4,5,1,4,0,0,3,4,2,3,1,1,0,11
7823,791142,13,0,7,0,0,0,7,0,0,0,0,1,1,1,1,0,0
7823,796799,11,1,2,1,2,0,0,0,0,0,0,1,0,0,2,0,2
7823,791141,9,1,5,0,2,1,3,0,0,1,0,0,0,1,0,0,3
7834,797466,26,6,9,6,9,0,0,0,0,2,2,0,5,5,5,1,12
7834,791858,31,3,8,0,0,3,8,2,2,1,3,1,2,1,6,0,11
7834,797463,38,7,14,6,10,1,4,5,6,2,3,2,1,1,4,0,20
7834,791109,34,0,3,0,2,0,1,3,8,0,4,2,1,2,4,2,3
7834,785625,21,0,1,0,1,0,0,0,0,2,0,1,1,0,0,0,0
7834,797464,19,2,3,1,1,1,2,0,0,0,2,1,1,0,0,0,5
7834,797469,8,0,0,0,0,0,0,0,0,0,1,0,0,1,1,0,0
7834,797465,18,0,3,0,2,0,1,0,0,0,1,0,2,1,2,1,0
7834,791854,5,0,1,0,1,0,0,0,1,0,2,0,0,0,0,0,0
7835,785948,26,2,3,2,3,0,0,0,0,2,1,0,4,0,1,0,4
7835,785946,33,5,7,4,4,1,3,1,2,2,3,1,2,2,1,1,12
7835,797634,13,0,1,0,0,0,1,0,0,0,1,1,2,2,1,0,0
7835,785939,33,4,10,1,6,3,4,2,2,0,4,4,0,4,5,1,13
7835,785938,25,3,11,1,4,2,7,0,0,1,1,0,3,2,2,0,8
7835,792026,4,0,0,0,0,0,0,0,0,0,0,0,1,0,1,0,0
7835,792025,17,4,6,4,6,0,0,3,6,0,1,0,2,1,1,0,11
7835,792020,34,4,7,2,3,2,4,0,0,0,3,8,0,0,2,0,10
7835,792023,15,2,5,1,1,1,4,2,2,0,3,0,3,2,4,0,7
7836,780023,36,4,8,4,8,0,0,0,0,2,10,0,2,0,3,5,8
7836,792495,23,4,15,2,6,2,9,1,2,1,1,2,2,0,3,0,11
7836,792493,32,3,5,1,1,2,4,0,0,0,0,2,1,1,0,0,8
7836,792491,35,2,6,2,6,0,0,3,5,0,5,4,3,0,3,0,7
7836,781144,38,7,11,4,4,3,7,0,0,1,0,1,0,0,0,0,17
7836,798960,1,0,0,0,0,0,0,0,0,0,0,0,1,0,0,1,0
7836,798959,11,0,0,0,0,0,0,0,0,0,0,1,1,0,0,0,0
7836,798957,3,0,0,0,0,0,0,0,0,0,1,0,0,0,0,0,0
7836,786832,20,3,7,3,5,0,2,0,0,1,3,1,0,0,1,0,6
7836,793441,1,0,0,0,0,0,0,0,0,0,0,0,0,0,0,0,0
7837,791062,31,5,12,4,8,1,4,3,6,2,3,0,4,3,0,0,14
7837,791063,29,4,5,3,4,1,1,0,0,2,7,4,1,0,0,1,9
7837,796735,15,0,1,0,0,0,1,2,4,2,2,1,0,1,0,0,2
7837,791064,36,8,14,3,5,5,9,0,0,0,3,5,0,0,1,0,21
7837,780743,34,3,9,2,6,1,3,0,0,1,2,5,0,2,0,0,7
7837,796741,2,0,1,0,1,0,0,0,0,0,0,0,0,0,1,0,0
7837,791060,8,2,3,1,2,1,1,0,0,1,0,0,2,0,0,1,5
7837,785548,11,2,7,1,6,1,1,1,1,5,3,0,2,0,2,0,6
7837,796736,5,0,2,0,0,0,2,0,0,0,0,0,0,0,0,0,0
7837,796737,6,1,1,0,0,1,1,0,0,0,1,0,1,0,0,0,3
7837,780055,21,3,6,1,2,2,4,1,1,1,4,1,0,0,1,0,9
7837,796742,2,0,0,0,0,0,0,0,0,0,0,0,0,0,0,0,0
7838,796766,29,4,9,2,2,2,7,1,1,1,4,2,4,1,1,1,11
7838,785614,17,1,1,1,1,0,0,0,0,2,1,0,3,0,0,0,2
7838,796767,25,2,7,2,4,0,3,3,4,1,2,1,2,0,5,0,7
7838,796765,37,2,10,2,7,0,3,2,2,1,1,5,1,1,2,0,6
7838,780812,37,3,12,0,5,3,7,5,7,0,12,2,3,3,6,1,14
7838,791113,17,0,1,0,1,0,0,0,0,1,3,0,3,0,0,1,0
7838,785618,16,3,4,0,0,3,4,0,0,0,1,0,2,0,1,0,9
7838,780813,22,6,12,5,10,1,2,0,0,2,3,0,4,0,3,0,13
7839,797174,16,0,1,0,0,0,1,1,4,1,3,1,4,0,1,0,1
7839,791510,19,1,5,1,3,0,2,2,2,3,3,0,2,1,2,0,4
7839,786699,22,3,5,3,5,0,0,0,2,3,3,0,0,1,2,1,6
7839,785593,25,1,7,0,1,1,6,4,4,0,1,1,5,1,3,1,7
7839,775357,35,4,12,1,3,3,9,6,6,0,5,2,2,3,1,0,17
7839,791507,18,1,6,1,6,0,0,6,8,4,3,0,1,0,0,2,8
7839,798345,0,0,1,0,0,0,1,0,0,0,0,0,0,0,0,0,0
7839,797168,27,3,9,3,7,0,2,2,2,2,2,4,1,0,1,0,8
7839,791504,22,3,8,3,7,0,1,1,6,3,3,1,1,1,0,0,7
7839,791505,16,4,5,1,1,3,4,1,2,1,4,1,1,3,0,1,12
7840,790930,23,0,6,0,4,0,2,0,2,2,1,0,2,0,0,0,0
7840,780358,10,2,4,2,4,0,0,0,2,0,1,0,3,0,0,2,4
7840,775011,35,2,10,0,3,2,7,0,0,2,3,2,2,1,2,1,6
7840,780357,31,5,11,0,3,5,8,0,0,0,2,0,1,0,0,0,15
7840,775018,37,3,15,1,7,2,8,3,4,1,2,9,3,1,2,0,11
7840,776004,30,8,15,5,9,3,6,4,4,6,5,1,3,0,1,1,23
7840,796480,33,1,9,0,6,1,3,0,0,4,5,1,5,1,0,0,3
7840,796486,1,0,0,0,0,0,0,0,0,0,0,0,0,0,0,0,0
7841,780027,36,11,19,7,13,4,6,4,5,1,7,2,1,0,1,1,30
7841,786176,30,6,9,1,3,5,6,0,0,1,7,2,3,1,4,1,17
7841,786173,31,2,4,1,3,1,1,0,0,1,0,4,0,0,0,0,5
7841,780028,24,1,1,1,1,0,0,2,4,0,5,2,3,0,3,0,4
7841,774828,35,1,7,0,3,1,4,3,4,0,3,5,2,1,0,0,6
7841,797175,22,1,5,1,5,0,0,3,5,1,11,0,2,0,1,1,5
7841,780029,7,2,3,1,2,1,1,1,1,2,0,0,2,0,0,0,6
7841,791379,11,1,2,1,1,0,1,0,0,0,1,0,0,0,1,1,2
7841,791380,4,1,1,1,1,0,0,0,0,0,0,1,0,0,1,0,2
7842,781175,21,4,8,4,8,0,0,1,2,2,3,2,5,1,0,0,9
7842,786555,27,2,7,0,1,2,6,1,2,0,1,0,2,1,0,0,7
7842,786553,32,4,9,1,4,3,5,7,8,1,1,1,0,2,2,0,18
7842,780895,36,5,11,5,9,0,2,2,2,1,1,7,2,0,0,1,12
7842,781172,36,4,8,1,4,3,4,0,0,1,6,4,2,1,1,0,11
7842,781177,18,1,3,1,1,0,2,2,3,1,1,1,2,2,3,0,4
7842,792005,19,4,8,0,1,4,7,0,1,1,3,0,3,0,3,1,12
7842,785312,11,3,6,3,4,0,2,3,3,1,1,1,4,0,1,0,9
7843,790873,28,8,12,6,10,2,2,5,7,2,3,2,4,0,2,1,23
7843,785429,20,3,7,0,0,3,7,0,0,0,4,2,0,0,1,0,9
7843,780054,22,1,2,1,1,0,1,4,6,1,5,0,0,0,1,0,6
7843,781140,31,3,7,3,6,0,1,2,2,1,1,5,2,2,0,2,8
7843,786851,29,6,9,2,4,4,5,5,5,0,3,1,2,0,2,0,21
7843,781139,23,4,5,4,5,0,0,1,2,1,2,1,4,1,2,0,9
7843,776357,29,4,7,3,5,1,2,4,4,1,2,7,3,0,1,0,13
7843,796433,4,0,1,0,1,0,0,0,0,1,1,0,3,0,2,0,0
7843,799973,1,0,0,0,0,0,0,0,0,0,0,0,1,0,0,0,0
7843,776245,9,0,1,0,0,0,1,0,0,1,2,1,1,0,0,1,0
7843,796432,4,1,2,0,1,1,1,0,0,0,1,0,1,0,0,1,3
7844,786550,32,1,7,1,2,0,5,0,0,1,3,1,2,1,2,0,2
7844,776054,24,1,6,0,2,1,4,0,0,0,7,1,3,1,2,1,3
7844,792007,21,5,7,4,5,1,2,1,2,0,2,0,5,0,1,0,12
7844,792009,36,3,9,3,8,0,1,0,0,3,1,4,1,2,2,2,6
7844,792006,24,1,3,1,3,0,0,4,6,0,1,4,2,1,1,0,6
7844,792008,17,4,4,4,4,0,0,2,4,1,1,0,2,0,0,1,10
7844,776273,16,5,8,5,8,0,0,0,0,0,0,1,0,0,1,0,10
7844,786552,19,0,4,0,1,0,3,1,2,1,0,1,0,0,1,0,1
7844,792011,3,0,0,0,0,0,0,0,0,0,0,0,2,0,1,0,0
7844,791689,4,1,2,1,1,0,1,0,0,0,1,0,2,0,1,0,2
7844,797506,4,0,0,0,0,0,0,0,0,0,0,0,0,0,0,0,0
7845,796673,10,1,3,1,2,0,1,0,0,1,0,0,3,0,1,0,2
7845,796674,27,6,8,1,2,5,6,2,2,3,6,1,2,1,2,0,19
7845,779857,26,3,7,3,6,0,1,2,2,1,6,1,1,1,0,0,8
7845,779976,29,3,7,2,5,1,2,8,10,1,2,5,2,3,1,0,15
7845,774990,31,4,12,2,8,2,4,0,0,0,3,7,1,0,1,0,10
7845,791014,26,5,7,1,1,4,6,1,1,0,3,0,2,0,0,0,15
7845,781586,12,1,2,1,1,0,1,2,2,0,1,0,0,0,2,0,4
7845,785339,16,0,3,0,0,0,3,0,0,0,1,1,2,1,0,0,0
7845,785961,13,1,2,1,1,0,1,0,0,0,2,1,2,0,1,0,2
7845,785126,2,2,2,1,1,1,1,0,0,0,0,0,0,0,0,0,5
7845,787090,2,0,1,0,0,0,1,0,0,0,1,0,0,0,0,0,0
7845,780142,2,0,0,0,0,0,0,0,0,0,0,1,0,0,0,0,0
7845,796672,2,0,0,0,0,0,0,0,0,0,0,0,0,0,0,0,0
7845,791016,2,0,0,0,0,0,0,0,0,0,0,0,0,0,0,0,0
7846,791669,34,2,5,2,5,0,0,0,0,2,6,1,3,2,1,1,4
7846,785762,34,6,15,5,10,1,5,2,2,3,5,0,0,2,3,0,15
7846,797407,11,0,2,0,1,0,1,0,0,0,0,2,2,0,1,1,0
7846,791666,33,8,17,6,11,2,6,3,4,0,1,0,3,2,2,0,21
7846,780531,40,5,13,4,6,1,7,0,0,1,3,5,1,3,1,0,11
7846,797414,4,1,1,1,1,0,0,0,1,0,0,0,2,0,0,0,2
7846,780534,8,0,1,0,1,0,0,0,0,1,1,1,3,0,1,0,0
7846,797409,26,2,3,2,2,0,1,0,0,0,1,2,1,2,3,0,4
7846,785760,10,1,4,1,3,0,1,0,0,0,1,0,0,0,0,1,2
7847,791225,37,6,7,6,7,0,0,2,2,2,8,0,1,1,3,4,14
7847,775324,19,3,6,3,6,0,0,0,2,0,3,1,4,0,3,0,6
7847,791224,30,7,9,6,8,1,1,3,4,0,6,2,1,2,4,0,18
7847,785571,31,3,10,2,8,1,2,0,0,0,3,1,2,2,4,1,7
7847,781181,33,3,6,0,2,3,4,0,0,0,2,1,1,1,1,0,9
7847,796929,17,0,2,0,1,0,1,1,2,1,0,2,0,0,1,0,1
7847,791223,21,1,2,1,2,0,0,1,2,2,2,1,1,0,1,2,3
7847,791222,12,4,5,2,2,2,3,0,0,0,2,0,0,0,0,0,10
7848,780012,34,3,10,3,6,0,4,1,2,1,5,3,3,0,1,3,7
7848,796309,26,4,10,4,10,0,0,2,2,1,7,0,3,0,2,1,10
7848,790824,35,6,9,3,5,3,4,5,6,1,6,3,2,1,3,0,20
7848,780011,31,1,5,1,4,0,1,2,2,0,3,4,2,1,1,0,4
7848,775667,34,4,7,3,5,1,2,3,5,0,1,1,3,0,2,0,12
7848,774895,14,3,3,3,3,0,0,1,2,1,5,0,2,0,0,0,7
7848,781524,12,1,3,0,1,1,2,3,4,1,3,1,0,0,1,0,6
7848,785370,8,2,5,1,3,1,2,0,0,0,0,0,1,0,1,0,5
7848,796383,6,0,0,0,0,0,0,0,0,0,0,0,1,0,0,0,0
7849,780634,24,5,7,5,7,0,0,3,6,1,2,1,2,0,0,4,13
7849,791826,28,1,1,1,1,0,0,0,0,2,1,2,0,0,2,0,2
7849,786785,30,3,10,2,6,1,4,5,5,0,4,1,2,0,0,0,12
7849,786783,29,5,14,5,11,0,3,0,0,2,5,1,2,2,0,0,10
7849,780633,32,3,12,3,10,0,2,0,0,0,2,2,4,1,0,0,6
7849,776009,26,6,12,4,9,2,3,2,4,0,1,1,2,1,0,0,16
7849,786784,15,0,3,0,3,0,0,1,2,0,1,0,3,0,0,0,1
7849,797389,16,2,3,2,3,0,0,0,1,2,3,0,1,0,0,3,4
7850,780283,20,5,12,5,12,0,0,0,0,0,4,2,4,0,1,1,10
7850,790925,37,10,12,9,9,1,3,4,7,1,4,1,3,3,3,0,25
7850,791456,32,4,11,3,6,1,5,0,0,1,5,2,4,2,2,0,9
7850,785476,36,6,9,5,7,1,2,0,0,0,2,3,3,1,0,0,13
7850,785474,30,3,6,2,4,1,2,2,2,0,6,1,2,0,0,0,9
7850,800121,9,1,1,1,1,0,0,0,0,2,0,0,0,0,1,0,2
7850,790926,17,2,7,2,5,0,2,0,0,0,3,0,1,3,0,0,4
7850,785480,7,0,0,0,0,0,0,0,0,0,1,0,0,0,0,0,0
7850,796470,3,1,2,1,1,0,1,0,0,1,0,0,0,0,0,0,2
7850,785478,9,0,0,0,0,0,0,0,0,0,1,0,1,0,0,0,0
7851,796334,33,8,12,8,10,0,2,2,4,4,4,0,3,0,4,2,18
7851,790776,16,1,1,1,1,0,0,1,2,2,3,0,3,0,0,1,3
7851,796330,27,0,3,0,1,0,2,2,2,0,4,3,1,1,4,0,2
7851,796336,24,1,3,0,0,1,3,0,0,0,0,2,0,0,3,0,3
7851,785813,37,6,14,4,8,2,6,7,10,1,3,3,1,0,0,0,21
7851,785827,21,3,7,3,7,0,0,0,0,1,5,0,1,0,1,1,6
7851,796337,21,1,5,0,3,1,2,2,2,0,2,1,1,0,2,0,5
7851,779975,5,0,0,0,0,0,0,0,0,0,1,0,1,0,1,0,0
7851,796332,16,1,5,1,4,0,1,0,0,0,2,0,3,1,1,0,2
7852,797849,27,3,7,3,5,0,2,1,2,0,1,1,3,0,3,0,7
7852,781537,30,5,8,4,6,1,2,0,2,1,3,3,4,0,1,0,11
7852,779986,8,0,0,0,0,0,0,1,2,0,0,2,3,0,0,0,1
7852,786079,25,3,7,2,5,1,2,0,0,2,1,2,4,0,2,0,7
7852,792202,25,3,7,0,1,3,6,0,1,0,2,0,2,0,5,0,9
7852,797842,33,5,11,4,8,1,3,2,2,6,12,6,1,4,4,1,13
7852,797836,5,0,0,0,0,0,0,0,0,0,0,0,1,0,0,0,0
7852,797847,12,3,5,2,2,1,3,1,2,0,0,0,2,0,1,0,8
7852,797835,2,0,0,0,0,0,0,0,0,0,0,0,0,1,0,0,0
7852,797846,33,6,16,4,10,2,6,2,2,2,3,2,2,0,1,2,16
7853,791230,29,2,5,1,2,1,3,1,2,1,5,4,0,1,0,1,6
7853,785557,29,10,13,10,13,0,0,4,6,1,2,0,3,1,2,2,24
7853,791228,26,4,5,3,4,1,1,4,8,1,5,1,2,3,1,0,13
7853,796932,31,6,12,5,10,1,2,4,5,1,5,6,2,3,4,0,17
7853,785624,25,3,7,1,1,2,6,2,4,0,1,1,4,2,1,0,10
7853,796935,10,0,3,0,1,0,2,0,0,2,1,1,1,0,0,0,0
7853,796933,13,3,4,2,3,1,1,2,2,2,1,1,3,0,2,0,9
7853,791226,8,1,3,1,3,0,0,2,2,1,1,0,1,0,1,0,4
7853,791229,1,0,0,0,0,0,0,0,0,0,0,1,0,0,0,0,0
7853,791227,19,1,2,0,0,1,2,0,1,0,3,0,0,2,1,0,3
7853,781201,2,0,0,0,0,0,0,0,0,0,0,0,0,0,0,0,0
7853,781198,7,1,3,1,3,0,0,1,1,0,0,0,0,0,0,0,3
7854,775738,21,1,1,1,1,0,0,0,0,1,1,2,0,0,0,1,2
7854,786091,31,5,7,4,6,1,1,1,2,6,5,3,2,0,2,1,12
7854,786728,33,7,13,7,13,0,0,1,3,1,3,8,3,0,2,1,15
7854,785904,26,8,13,4,6,4,7,4,4,0,7,0,2,1,3,0,24
7854,780892,31,4,8,0,2,4,6,0,0,0,1,3,4,0,4,0,12
7854,786350,1,0,0,0,0,0,0,0,0,0,0,0,1,0,0,0,0
7854,797670,1,0,0,0,0,0,0,0,0,0,1,0,0,0,0,0,0
7854,797665,1,0,1,0,0,0,1,0,0,0,0,0,0,0,0,0,0
7854,792087,5,0,1,0,1,0,0,0,0,0,3,0,1,0,0,0,0
7854,785734,3,0,1,0,0,0,1,0,0,0,1,0,0,0,0,0,0
7854,786788,3,0,0,0,0,0,0,0,0,0,0,0,0,1,0,0,0
7854,786096,24,6,8,5,6,1,2,0,0,2,6,0,3,0,2,1,13
7854,781030,20,3,8,0,1,3,7,1,2,1,2,0,0,2,0,0,10
7855,786635,24,5,10,5,9,0,1,4,4,1,0,2,1,1,1,0,14
7855,791822,32,3,8,0,1,3,7,1,2,0,0,0,0,0,1,0,10
7855,781543,13,1,5,1,3,0,2,0,0,0,0,4,3,0,0,0,2
7855,780642,24,6,11,4,9,2,2,0,1,1,1,0,0,1,2,1,14
7855,776449,36,8,17,6,12,2,5,0,3,1,2,4,2,0,0,0,18
7855,798157,13,1,1,1,1,0,0,0,0,1,1,0,1,0,0,3,2
7855,797383,5,0,1,0,1,0,0,0,0,1,3,0,0,0,0,0,0
7855,791823,9,0,0,0,0,0,0,0,0,0,0,0,2,0,1,0,0
7855,791821,9,1,3,1,3,0,0,0,0,2,0,0,1,0,0,0,2
7855,785830,8,2,2,2,2,0,0,0,0,0,2,0,0,0,1,0,4
7855,797384,4,0,0,0,0,0,0,1,3,0,1,0,1,0,0,0,1
7855,786182,13,1,3,1,2,0,1,0,0,0,1,3,2,1,1,0,2
7855,786632,10,0,0,0,0,0,0,0,0,0,1,1,0,0,0,0,0
7856,786197,23,2,5,1,2,1,3,3,4,1,8,2,4,0,1,2,8
7856,780717,36,9,19,9,17,0,2,7,10,1,14,0,2,2,2,2,25
7856,776328,6,0,0,0,0,0,0,0,0,0,2,0,0,0,0,0,0
7856,791742,40,3,11,2,7,1,4,1,2,1,4,4,4,1,1,1,8
7856,776266,28,2,9,2,8,0,1,1,2,0,1,3,4,0,3,0,5
7856,791738,4,0,1,0,1,0,0,0,0,1,0,0,2,0,1,0,0
7856,797337,14,2,3,2,3,0,0,1,4,4,2,0,3,0,2,0,5
7856,797334,10,0,2,0,1,0,1,0,0,0,0,1,2,0,2,0,0
7856,791740,25,1,2,0,1,1,1,0,0,0,1,1,1,0,3,0,3
7856,791741,14,2,6,1,3,1,3,1,3,1,2,0,2,0,1,0,6
7857,785987,32,6,12,3,7,3,5,0,2,1,4,3,1,0,2,0,15
7857,776037,29,0,2,0,2,0,0,5,6,0,5,5,2,1,0,0,5
7857,780588,24,4,5,4,5,0,0,5,11,4,6,1,1,0,0,2,13
7857,786147,10,1,1,1,1,0,0,0,0,1,0,1,2,1,0,0,2
7857,780667,31,9,16,7,12,2,4,3,4,0,1,3,4,1,0,0,23
7857,792562,11,1,6,1,4,0,2,0,0,0,4,0,2,1,2,0,2
7857,782643,14,1,3,1,3,0,0,3,3,2,8,0,4,0,2,2,5
7857,781647,17,1,5,1,3,0,2,1,2,0,2,0,3,0,2,0,3
7857,791759,14,0,3,0,2,0,1,1,2,0,1,1,1,1,1,0,1
7857,775680,18,1,7,1,3,0,4,0,0,0,2,1,3,1,1,0,2
7858,781244,27,6,14,6,13,0,1,2,4,2,8,3,5,0,2,2,14
7858,791243,12,0,2,0,2,0,0,0,0,0,0,1,1,0,1,0,0
7858,791241,19,2,5,1,2,1,3,4,4,0,5,0,3,0,2,0,9
7858,785537,36,5,8,4,7,1,1,3,4,1,0,5,3,0,2,0,14
7858,781243,34,9,12,6,6,3,6,0,1,1,7,1,2,4,1,0,21
7858,791245,33,6,10,3,6,3,4,6,8,1,3,5,2,0,2,0,21
7858,791246,8,0,1,0,0,0,1,2,2,0,2,2,1,1,1,2,2
7858,785529,4,0,2,0,1,0,1,0,0,0,0,0,0,0,0,0,0
7858,781237,25,3,3,0,0,3,3,0,0,0,1,2,0,0,0,0,9
7858,776205,2,0,0,0,0,0,0,0,0,0,0,0,0,0,0,0,0
7859,797281,35,6,10,6,10,0,0,2,2,3,4,1,3,2,1,0,14
7859,791648,18,1,7,1,5,0,2,0,0,0,6,0,1,1,0,0,2
7859,785694,13,1,2,1,2,0,0,0,0,3,0,0,5,0,0,0,2
7859,791649,20,3,7,1,5,2,2,0,0,0,0,1,3,0,0,0,8
7859,797280,23,1,6,1,5,0,1,0,0,0,0,2,1,0,2,0,2
7859,791647,15,1,4,1,2,0,2,3,3,1,3,1,2,0,0,0,5
7859,797278,2,0,1,0,1,0,0,0,0,0,0,0,1,0,0,0,0
7859,797279,30,9,16,6,10,3,6,4,4,1,4,2,2,1,2,0,25
7859,786640,18,1,5,1,4,0,1,0,0,1,1,6,4,0,6,0,2
7859,785697,24,4,6,2,2,2,4,6,7,2,4,1,2,0,1,0,16
7859,785695,2,0,1,0,1,0,0,0,0,0,0,0,0,0,0,0,0
7860,790784,13,3,7,3,5,0,2,0,0,3,1,1,4,3,0,0,6
7860,786235,21,2,6,2,6,0,0,1,2,1,3,0,2,3,0,4,5
7860,797475,19,4,6,1,1,3,5,1,1,0,0,1,3,1,1,0,12
7860,786229,20,2,4,1,1,1,3,1,2,0,3,5,0,1,1,0,6
7860,775229,28,3,6,2,3,1,3,7,9,0,4,7,2,2,4,0,14
7860,786583,6,0,2,0,1,0,1,2,2,1,0,0,2,0,0,0,2
7860,776219,19,3,7,3,3,0,4,0,1,0,1,1,1,0,1,0,6
7860,797477,4,0,1,0,0,0,1,0,0,0,0,0,0,0,1,0,0
7860,797476,4,0,0,0,0,0,0,0,0,0,0,0,1,0,0,0,0
7860,791871,11,1,1,0,0,1,1,3,4,0,0,2,2,2,0,0,6
7860,786581,16,1,3,1,3,0,0,4,4,1,0,1,2,1,0,0,6
7860,786770,17,5,8,4,7,1,1,0,0,0,0,0,1,3,2,0,11
7860,786719,5,1,1,1,1,0,0,0,0,0,0,0,0,0,0,0,2
7860,781518,17,3,4,1,1,2,3,0,0,0,2,0,3,0,1,0,8
7861,780180,28,0,5,0,4,0,1,5,6,3,4,1,4,1,2,0,5
7861,781650,31,4,6,4,6,0,0,4,4,1,3,1,1,0,2,0,12
7861,797068,30,2,4,1,2,1,2,0,0,0,2,6,3,0,6,0,5
7861,791432,31,4,8,1,2,3,6,0,0,0,0,1,2,1,5,0,11
7861,791429,22,3,5,2,3,1,2,2,2,0,5,1,2,1,4,0,9
7861,797066,11,0,0,0,0,0,0,1,2,1,1,0,3,0,2,0,1
7861,791431,3,1,1,1,1,0,0,1,1,0,0,0,0,0,0,0,3
7861,797067,17,1,4,1,3,0,1,0,0,0,1,1,4,1,1,0,2
7861,797070,6,0,0,0,0,0,0,0,0,0,0,1,0,0,0,0,0
7861,777865,21,6,8,6,7,0,1,4,5,1,3,0,5,1,4,0,16
7862,786772,29,2,3,2,3,0,0,0,0,0,4,0,4,0,3,1,4
7862,781484,14,1,4,0,1,1,3,0,0,1,2,0,1,0,2,0,3
7862,786769,22,4,7,3,5,1,2,0,0,2,0,0,1,0,2,0,9
7862,786024,23,4,8,1,2,3,6,0,0,0,4,1,4,3,1,0,11
7862,780002,21,2,9,2,6,0,3,1,1,0,1,3,1,1,4,0,5
7862,791967,24,2,11,2,7,0,4,0,0,1,4,1,2,0,3,0,4
7862,790823,26,5,8,2,3,3,5,0,0,0,2,1,2,2,0,2,13
7862,797840,15,2,4,2,4,0,0,0,0,0,2,2,0,0,3,0,4
7862,791970,12,0,4,0,2,0,2,0,0,0,1,0,1,0,2,1,0
7862,786773,5,1,1,1,1,0,0,0,0,1,0,0,0,0,0,0,2
7862,785441,9,3,3,3,3,0,0,0,0,1,0,0,1,0,0,0,6
7863,792143,18,2,7,0,2,2,5,0,0,0,3,0,2,1,0,0,6
7863,786302,14,2,2,2,2,0,0,2,4,0,1,0,2,0,0,0,6
7863,786293,22,6,11,6,10,0,1,3,4,1,1,0,0,1,0,0,15
7863,780953,31,6,9,6,6,0,3,6,6,1,5,1,1,2,2,0,18
7863,797750,33,3,5,2,4,1,1,0,0,0,3,5,3,4,3,0,7
7863,797753,22,4,6,4,6,0,0,1,2,0,3,2,0,0,0,2,9
7863,786287,19,2,3,2,3,0,0,0,2,0,4,1,0,0,4,1,4
7863,780955,26,5,7,5,6,0,1,2,2,0,1,4,1,1,2,0,12
7863,797748,5,0,2,0,1,0,1,0,0,1,1,0,0,0,0,1,0
7863,792147,2,0,1,0,1,0,0,0,0,0,0,0,0,0,0,0,0
7863,786301,2,0,0,0,0,0,0,0,0,0,0,0,0,0,1,0,0
7863,792145,2,1,1,1,1,0,0,0,0,0,0,0,0,0,0,0,2
7863,797742,2,0,0,0,0,0,0,0,0,0,0,0,0,1,0,0,0
7863,797751,2,0,0,0,0,0,0,0,0,0,0,0,0,0,0,0,0
7872,781158,13,1,4,1,4,0,0,0,2,0,2,0,0,0,1,0,2
7872,781652,38,2,9,2,6,0,3,0,1,2,10,1,1,1,2,0,4
7872,786034,20,2,4,1,1,1,3,0,0,0,1,0,4,0,0,0,5
7872,786419,31,3,6,2,4,1,2,8,8,0,7,3,3,0,2,0,15
7872,781283,30,1,5,0,2,1,3,7,8,0,1,0,2,0,1,0,10
7872,781653,29,3,7,3,7,0,0,8,13,1,2,2,3,0,1,1,14
7872,791615,26,6,9,4,5,2,4,0,0,0,5,0,4,1,1,0,14
7872,785277,13,1,7,1,4,0,3,0,0,1,1,1,2,1,0,0,2
7873,792329,37,2,5,2,3,0,2,0,0,0,7,2,2,2,0,0,4
7873,786752,22,5,11,2,6,3,5,2,2,0,6,0,4,0,2,1,15
7873,781384,24,4,5,4,5,0,0,4,4,1,5,2,2,1,2,0,12
7873,781616,32,3,10,2,6,1,4,2,2,0,2,1,2,0,3,0,9
7873,776350,34,2,10,2,5,0,5,4,6,0,4,1,3,0,2,1,8
7873,792330,5,0,0,0,0,0,0,0,0,0,0,0,2,0,0,0,0
7873,781075,12,0,4,0,2,0,2,0,1,0,2,0,3,0,2,0,0
7873,781615,19,2,4,2,2,0,2,1,2,0,2,0,4,0,0,0,5
7873,792601,8,0,2,0,1,0,1,2,2,0,0,0,0,0,0,0,2
7873,786749,7,0,1,0,0,0,1,0,0,1,1,0,0,0,0,0,0
7874,791257,13,1,1,1,1,0,0,1,4,1,4,2,4,0,1,0,3
7874,791838,27,2,6,0,2,2,4,2,4,2,5,2,3,0,0,0,8
7874,786620,34,3,9,2,5,1,4,1,2,1,1,0,2,0,3,1,8
7874,781606,38,3,10,3,9,0,1,4,4,0,3,5,1,0,4,0,10
7874,781257,31,4,11,2,7,2,4,5,6,2,3,0,4,0,2,0,15
7874,796955,16,2,2,2,2,0,0,4,4,2,4,0,2,0,2,0,8
7874,791255,5,0,0,0,0,0,0,0,0,0,0,0,1,0,0,0,0
7874,780900,13,3,6,2,4,1,2,0,0,1,4,0,1,0,1,0,7
7874,781263,23,3,9,3,9,0,0,4,4,0,3,0,3,0,2,0,10
7875,791067,32,3,6,3,4,0,2,3,4,4,3,2,2,1,1,0,9
7875,780751,5,0,1,0,0,0,1,0,0,0,0,0,4,0,0,0,0
7875,796743,29,3,8,1,3,2,5,3,4,1,3,2,1,2,1,0,11
7875,791068,22,0,6,0,5,0,1,0,0,0,4,1,3,2,1,0,0
7875,785551,31,7,8,5,6,2,2,3,4,0,3,2,4,0,1,0,19
7875,785642,15,2,4,2,3,0,1,0,0,1,4,0,3,0,0,0,4
7875,780512,25,10,15,6,9,4,6,5,7,2,7,1,2,1,2,0,29
7875,780756,5,0,3,0,2,0,1,0,0,0,0,0,0,0,1,0,0
7875,796744,3,0,0,0,0,0,0,0,0,0,0,0,0,0,0,0,0
7875,791066,26,3,11,3,7,0,4,2,3,0,1,2,2,0,0,2,8
7875,791065,7,0,1,0,0,0,1,0,0,0,1,1,0,0,0,0,0
7876,780023,34,6,11,6,11,0,0,2,2,2,6,1,3,0,4,5,14
7876,792493,25,3,7,2,2,1,5,0,0,0,1,0,4,2,0,0,7
7876,792495,36,7,16,5,11,2,5,4,4,2,1,3,0,1,3,1,20
7876,792491,38,4,6,3,5,1,1,3,4,1,4,6,2,1,2,0,12
7876,781144,39,4,11,3,3,1,8,0,0,0,2,0,2,0,0,1,9
7876,786832,24,3,3,3,3,0,0,0,0,2,6,2,1,2,0,0,6
7876,798959,4,0,0,0,0,0,0,0,0,0,0,0,0,0,0,0,0
7877,791062,31,5,10,5,8,0,2,6,6,1,3,2,2,0,2,2,16
7877,791063,28,4,4,0,0,4,4,0,0,0,3,3,1,2,0,0,12
7877,796735,9,0,0,0,0,0,0,0,0,0,0,0,0,0,1,0,0
7877,791064,31,4,10,2,6,2,4,0,0,1,2,3,1,0,0,0,10
7877,780743,38,6,13,1,6,5,7,3,3,0,6,2,4,1,3,1,20
7877,791060,11,1,3,1,3,0,0,1,2,0,1,2,1,0,2,0,3
7877,785548,8,1,3,1,2,0,1,0,0,1,1,0,0,0,0,0,2
7877,785542,25,1,4,1,4,0,0,6,6,2,4,1,1,2,0,0,8
7877,780055,19,1,3,1,1,0,2,0,0,0,0,0,2,0,0,0,2
7878,786519,31,4,5,4,5,0,0,1,2,4,7,0,2,1,0,1,9
7878,791911,16,1,4,0,0,1,4,0,0,1,2,0,2,1,1,0,3
7878,797556,36,7,17,2,9,5,8,4,4,2,2,1,1,1,1,1,23
7878,791913,35,6,15,5,11,1,4,2,2,2,4,7,2,1,2,0,15
7878,786520,32,6,13,6,10,0,3,5,6,1,3,4,4,1,5,0,17
7878,797558,26,5,8,2,4,3,4,1,2,0,6,1,4,0,2,0,14
7878,797560,9,0,0,0,0,0,0,0,0,0,0,0,1,0,0,0,0
7878,797559,5,0,0,0,0,0,0,0,0,0,1,1,0,0,1,0,0
7878,797555,7,0,0,0,0,0,0,0,0,0,1,0,2,1,1,0,0
7878,781105,3,0,1,0,1,0,0,0,0,0,0,0,0,0,0,0,0
7879,786059,30,6,10,6,9,0,1,3,4,2,1,2,1,1,2,2,15
7879,776174,34,6,11,6,11,0,0,4,6,2,8,2,3,1,2,1,16
7879,791958,36,3,9,2,7,1,2,2,2,1,6,5,3,0,2,0,9
7879,791960,36,4,12,2,5,2,7,2,2,2,1,2,4,3,1,0,12
7879,785861,33,4,13,1,5,3,8,0,0,2,6,2,2,0,2,0,11
7879,797704,4,0,1,0,0,0,1,0,0,0,0,0,1,0,1,0,0
7879,781332,27,5,8,3,4,2,4,0,1,0,2,2,2,0,2,0,12
7880,786792,31,6,7,6,7,0,0,2,2,1,5,0,4,3,2,1,14
7880,792414,36,6,10,2,3,4,7,3,4,0,5,1,1,0,1,0,19
7880,789020,35,8,9,7,8,1,1,1,3,4,7,2,3,1,4,0,18
7880,786787,38,7,20,5,9,2,11,10,10,0,5,8,2,2,3,0,26
7880,774954,35,0,4,0,4,0,0,1,3,3,4,5,1,2,1,0,1
7880,786795,7,1,1,0,0,1,1,0,0,0,0,0,1,0,0,0,3
7880,792091,16,2,7,2,4,0,3,0,0,1,3,0,1,1,0,0,4
7880,781456,2,0,1,0,0,0,1,0,0,0,0,0,0,0,0,0,0
7881,785481,21,2,6,2,5,0,1,2,3,3,3,3,2,2,1,0,6
7881,780631,30,8,16,8,13,0,3,3,3,1,3,2,1,0,1,0,19
7881,797391,29,3,10,0,2,3,8,1,1,1,2,2,2,2,0,0,10
7881,786625,36,3,8,2,5,1,3,0,1,0,5,8,5,1,3,0,7
7881,780625,25,5,9,1,1,4,8,0,0,1,1,2,4,0,1,0,14
7881,797397,9,0,3,0,3,0,0,0,0,2,1,0,4,0,1,0,0
7881,797395,18,1,6,0,2,1,4,0,0,0,3,4,0,1,2,0,3
7881,797394,12,0,2,0,1,0,1,0,0,2,0,1,2,0,2,0,0
7881,786630,20,7,11,7,10,0,1,1,1,3,3,1,3,1,1,0,15
7882,780521,23,4,7,3,3,1,4,7,7,0,2,2,3,1,0,0,16
7882,775163,12,2,4,2,4,0,0,0,1,2,0,3,0,0,0,0,4
7882,791370,23,2,5,1,2,1,3,0,1,1,4,1,4,0,3,0,5
7882,786199,38,4,12,3,5,1,7,0,0,0,6,3,1,0,3,1,9
7882,780991,35,7,9,5,6,2,3,3,3,0,2,1,3,1,5,2,19
7882,780145,9,0,0,0,0,0,0,0,0,2,0,0,4,0,0,0,0
7882,781611,19,3,3,3,3,0,0,3,4,2,5,0,0,0,0,0,9
7882,797271,23,3,5,2,2,1,3,1,2,0,2,2,0,1,2,1,8
7882,743593,18,2,3,2,2,0,1,1,1,0,1,1,1,0,2,0,5
7883,785681,10,1,2,1,2,0,0,0,2,0,1,0,0,0,0,0,2
7883,796789,21,1,6,0,2,1,4,2,2,0,3,0,3,2,0,0,5
7883,791126,31,3,10,3,8,0,2,0,0,1,3,1,2,2,1,0,6
7883,791124,35,3,7,3,5,0,2,1,1,2,0,5,0,1,2,0,7
7883,780050,26,5,14,4,9,1,5,6,6,3,3,3,4,1,2,0,17
7883,784479,18,5,8,4,4,1,4,0,0,2,3,1,1,0,0,0,11
7883,796786,19,1,4,1,1,0,3,1,2,1,2,0,3,1,0,0,3
7883,775813,13,1,2,1,2,0,0,2,2,0,2,1,3,0,1,0,4
7883,796784,10,0,1,0,1,0,0,0,0,0,0,0,0,0,0,0,0
7883,796782,17,4,8,0,2,4,6,1,2,1,0,0,2,1,1,0,13
7884,774812,25,1,4,1,2,0,2,5,8,1,6,1,4,2,3,0,7
7884,791498,12,3,5,3,5,0,0,3,6,2,1,0,2,0,0,2,9
7884,791497,27,3,12,3,6,0,6,0,0,0,6,1,1,2,1,0,6
7884,781486,31,6,11,4,8,2,3,9,11,0,10,1,2,2,2,0,23
7884,780461,34,2,10,2,8,0,2,7,8,1,4,3,4,1,3,0,11
7884,791500,22,0,2,0,2,0,0,2,4,3,2,1,2,1,2,0,2
7884,790517,2,0,0,0,0,0,0,0,0,0,0,0,1,0,0,0,0
7884,797180,16,0,2,0,0,0,2,0,0,1,1,1,0,0,2,0,0
7884,791503,5,1,2,1,1,0,1,0,1,0,2,0,0,0,0,0,2
7884,780240,13,0,1,0,0,0,1,2,2,0,1,0,0,0,0,0,2
7884,776379,13,1,2,1,2,0,0,0,0,0,0,0,0,1,1,0,2
7885,791042,24,4,9,3,8,1,1,5,9,5,6,0,4,1,1,2,14
7885,774834,18,3,3,3,3,0,0,0,0,0,3,0,3,0,0,0,6
7885,791043,22,2,10,1,6,1,4,0,0,0,2,3,5,1,2,0,5
7885,776374,20,2,6,2,4,0,2,1,2,0,2,4,3,2,2,0,5
7885,775412,37,2,9,0,1,2,8,0,0,0,3,1,3,1,1,0,6
7885,796723,22,2,5,2,2,0,3,3,4,0,7,2,1,1,2,0,7
7885,796719,13,1,6,1,2,0,4,1,2,0,1,1,2,0,1,0,3
7885,785512,14,3,5,3,5,0,0,0,0,1,2,0,2,0,1,1,6
7885,796718,8,0,3,0,1,0,2,0,0,0,1,0,2,0,1,0,0
7885,796717,20,3,3,1,1,2,2,0,0,0,2,3,2,2,1,0,8
7885,796720,2,0,1,0,1,0,0,0,0,0,1,0,1,0,1,0,0
7886,792167,23,5,8,5,8,0,0,3,5,2,4,1,2,1,4,1,13
7886,797767,26,1,7,1,5,0,2,2,2,0,1,6,4,1,1,0,4
7886,791372,36,9,14,4,6,5,8,1,1,1,2,1,2,1,0,0,24
7886,792164,34,6,11,3,7,3,4,3,4,1,3,1,1,0,4,0,18
7886,780974,25,6,7,5,5,1,2,2,3,2,2,0,3,1,2,0,15
7886,797766,15,2,5,2,4,0,1,3,3,1,5,1,1,0,1,1,7
7886,797772,17,2,3,1,1,1,2,0,0,0,1,3,3,0,1,0,5
7886,792163,23,1,5,0,2,1,3,2,2,3,6,2,2,0,0,1,5
7886,797764,1,0,0,0,0,0,0,0,0,0,0,0,0,0,0,0,0
7887,786080,30,2,6,1,3,1,3,4,6,0,5,2,1,1,4,0,9
7887,786216,25,4,7,4,7,0,0,2,2,2,5,4,1,1,0,0,10
7887,791348,30,5,12,5,11,0,1,0,0,3,3,3,3,1,1,0,10
7887,786218,36,4,8,1,3,3,5,5,8,0,1,0,3,1,1,0,16
7887,780663,37,6,10,3,4,3,6,2,2,1,2,1,2,1,4,0,17
7887,797258,3,0,1,0,1,0,0,0,0,0,0,0,1,0,1,0,0
7887,791350,17,0,3,0,1,0,2,2,3,0,2,0,1,0,1,0,2
7887,781645,13,3,4,2,3,1,1,2,2,0,0,0,3,1,0,0,9
7887,780150,6,1,1,1,1,0,0,0,0,1,1,1,1,0,0,0,2
7887,780156,2,0,1,0,0,0,1,0,0,0,0,0,0,0,0,0,0
7887,797256,1,0,1,0,1,0,0,0,0,0,0,0,0,0,0,0,0
7888,796847,25,3,4,3,4,0,0,1,2,2,4,0,1,0,1,0,7
7888,775833,23,3,7,3,7,0,0,2,4,0,8,2,3,1,2,3,8
7888,781036,36,4,13,3,7,1,6,10,11,0,5,6,1,2,3,0,19
7888,775571,33,3,6,1,2,2,4,1,2,0,5,5,3,1,1,0,9
7888,774894,32,6,11,4,4,2,7,0,0,1,5,1,3,0,1,1,14
7888,799906,28,3,4,1,1,2,3,2,2,1,4,1,1,2,2,1,10
7888,796846,7,1,1,1,1,0,0,0,0,0,0,0,1,1,0,0,2
7888,796845,2,0,1,0,0,0,1,0,0,0,0,0,0,0,0,0,0
7888,785439,13,2,2,1,1,1,1,2,2,0,1,2,1,1,0,0,7
7888,783830,1,0,1,0,1,0,0,0,0,0,1,0,0,1,1,0,0
7889,780651,18,3,5,3,5,0,0,0,1,4,2,3,4,1,4,0,6
7889,791815,33,2,14,1,7,1,7,2,2,0,7,3,2,0,0,1,7
7889,791814,22,2,7,2,2,0,5,1,2,0,0,1,0,0,2,0,5
7889,786645,13,0,3,0,2,0,1,0,0,6,0,0,1,1,1,0,0
7889,780650,27,3,16,2,11,1,5,0,2,4,4,0,3,2,3,0,7
7889,791809,11,0,1,0,1,0,0,0,0,1,3,0,1,0,0,0,0
7889,791812,16,3,9,1,3,2,6,0,0,3,1,0,1,0,1,0,8
7889,781596,15,2,2,2,2,0,0,2,2,2,2,0,1,0,1,0,6
7889,797373,2,1,1,0,0,1,1,2,2,0,0,0,0,1,0,0,5
7889,791810,22,1,4,0,1,1,3,0,0,1,2,4,3,0,2,0,3
7889,797372,5,0,2,0,2,0,0,1,2,0,1,0,1,0,0,0,1
7889,786644,16,2,6,1,3,1,3,0,0,0,0,2,2,0,1,0,5
7890,797873,19,1,3,1,3,0,0,0,0,2,2,0,2,0,3,0,2
7890,797877,29,4,7,4,6,0,1,1,2,3,3,1,3,2,3,2,9
7890,797872,32,4,8,3,5,1,3,0,0,1,3,2,3,0,2,1,9
7890,791339,33,12,23,8,17,4,6,1,2,0,3,3,1,1,5,1,29
7890,781595,28,3,11,3,10,0,1,0,0,0,3,4,1,3,1,0,6
7890,791335,4,0,1,0,1,0,0,1,3,0,0,0,0,0,0,1,1
7890,791337,14,2,4,2,4,0,0,0,1,1,4,1,1,0,0,1,4
7890,785881,11,0,0,0,0,0,0,0,0,0,1,0,3,1,0,0,0
7890,781599,8,0,3,0,3,0,0,1,2,1,0,0,0,0,0,1,1
7890,791338,22,0,2,0,2,0,0,2,3,0,3,1,3,3,0,0,2
7891,785459,16,2,6,2,6,0,0,3,4,2,3,0,2,0,3,0,7
7891,789102,29,4,8,4,6,0,2,5,6,1,7,4,2,2,4,0,13
7891,789101,23,2,5,1,3,1,2,0,1,1,1,0,2,1,0,0,5
7891,781371,13,1,4,1,2,0,2,0,0,0,2,1,1,0,4,0,2
7891,781367,17,0,5,0,2,0,3,0,0,1,0,0,0,0,1,0,0
7891,797731,17,3,5,3,5,0,0,1,3,3,5,0,2,0,1,2,7
7891,792066,26,2,3,2,3,0,0,0,0,2,2,0,1,0,1,1,4
7891,792064,24,5,7,0,0,5,7,1,2,0,3,3,1,2,1,0,16
7891,792063,15,2,6,1,3,1,3,0,0,0,0,1,0,2,0,0,5
7891,792061,7,2,4,1,2,1,2,1,2,1,0,1,1,0,0,0,6
7891,788037,13,2,7,0,2,2,5,0,0,0,3,3,0,1,0,1,6
7892,785916,21,4,7,3,4,1,3,0,0,2,3,1,3,0,3,0,9
7892,780105,34,3,11,2,8,1,3,0,1,1,12,4,2,1,2,1,7
7892,785915,33,0,3,0,0,0,3,1,2,0,4,2,1,0,0,1,1
7892,785894,36,2,9,2,3,0,6,1,1,0,2,2,1,0,0,0,5
7892,781131,36,8,14,8,13,0,1,3,3,2,4,6,0,1,3,1,19
7892,791408,18,7,10,7,10,0,0,0,1,2,3,1,2,0,2,0,14
7892,785637,22,2,4,0,1,2,3,0,0,0,3,0,2,0,2,0,6
7893,791321,19,0,1,0,1,0,0,0,0,2,0,0,1,2,0,0,0
7893,791323,23,0,1,0,0,0,1,0,0,0,2,3,1,0,2,1,0
7893,791320,35,6,16,6,14,0,2,4,5,0,2,2,3,2,0,0,16
7893,785912,35,5,19,3,11,2,8,3,6,1,3,1,2,3,2,1,15
7893,781511,36,7,11,5,6,2,5,1,1,0,6,3,0,0,1,1,17
7893,796650,28,5,8,5,8,0,0,0,0,1,7,2,2,1,1,2,10
7893,796657,1,0,1,0,1,0,0,0,0,0,0,0,0,0,0,0,0
7893,796656,14,0,4,0,4,0,0,0,0,3,2,1,2,0,0,0,0
7893,796653,6,0,1,0,1,0,0,0,0,1,2,0,0,0,0,1,0
7893,796651,3,0,0,0,0,0,0,0,0,0,0,0,0,0,0,0,0
7894,785829,17,3,9,3,9,0,0,1,4,4,2,0,2,0,0,1,7
7894,775838,32,5,12,4,10,1,2,0,0,2,5,1,3,5,2,0,11
7894,796729,31,5,14,3,6,2,8,2,2,1,2,3,2,1,5,0,14
7894,796727,19,0,1,0,0,0,1,2,2,0,1,1,3,0,0,1,2
7894,791048,22,1,3,0,1,1,2,1,1,1,3,5,3,0,5,0,4
7894,791044,17,2,6,2,6,0,0,4,4,4,3,1,4,2,1,1,8
7894,780723,26,5,11,1,2,4,9,4,4,0,1,0,1,0,1,1,18
7894,786531,36,5,13,3,8,2,5,2,6,0,3,5,4,1,1,0,14
7895,781530,27,5,7,4,5,1,2,2,2,3,8,1,3,4,3,1,13
7895,776423,16,1,6,1,6,0,0,0,0,4,2,0,5,0,1,2,2
7895,798096,26,6,14,5,11,1,3,10,12,2,3,4,2,1,2,0,23
7895,792307,13,2,5,0,2,2,3,0,0,0,2,0,0,1,2,0,6
7895,792319,27,3,7,2,3,1,4,2,2,1,2,3,2,0,0,0,9
7895,792316,5,0,0,0,0,0,0,1,2,0,1,0,2,0,0,0,1
7895,792314,11,0,2,0,2,0,0,0,0,1,4,0,5,0,2,0,0
7895,786296,19,6,10,6,9,0,1,2,3,2,2,2,1,1,1,0,14
7895,792320,17,0,0,0,0,0,0,2,2,2,2,0,0,0,2,1,2
7895,798106,6,1,2,1,2,0,0,0,0,0,0,0,2,0,1,0,2
7895,798104,21,4,10,3,7,1,3,2,2,0,0,3,2,2,3,0,11
7895,792309,8,2,4,2,3,0,1,0,0,0,2,0,0,1,0,0,4
7895,792321,4,1,1,1,1,0,0,0,0,1,2,1,0,0,1,0,2
7896,792340,22,5,9,4,7,1,2,2,2,0,3,0,4,2,5,0,13
7896,792345,27,2,3,2,3,0,0,0,0,0,1,1,4,3,0,1,4
7896,792342,40,1,5,1,2,0,3,2,3,0,1,6,3,0,3,0,4
7896,792346,40,3,5,3,4,0,1,5,7,2,9,0,1,2,3,0,11
7896,781552,22,5,10,5,8,0,2,6,7,0,2,2,3,1,2,0,16
7896,798080,5,0,1,0,0,0,1,0,0,0,0,0,4,0,0,0,0
7896,792344,13,0,1,0,0,0,1,0,0,0,0,0,2,0,2,0,0
7896,781553,31,7,10,6,8,1,2,5,6,0,5,1,3,1,1,1,20
7897,796860,25,3,4,3,4,0,0,2,2,1,1,0,4,0,3,1,8
7897,791187,22,3,5,3,5,0,0,0,2,0,3,0,3,0,2,1,6
7897,796856,26,5,9,1,2,4,7,1,2,0,4,3,1,0,6,0,15
7897,785650,11,1,3,0,1,1,2,0,0,0,1,1,4,0,2,0,3
7897,785649,30,3,9,2,5,1,4,1,2,0,4,2,2,1,2,0,8
7897,791183,15,0,0,0,0,0,0,1,5,0,2,1,2,0,0,0,1
7897,791185,23,1,2,1,1,0,1,2,2,2,0,0,1,2,0,0,4
7897,796861,18,0,2,0,0,0,2,0,0,0,2,2,1,0,2,0,0
7897,791184,30,5,7,3,3,2,4,0,3,0,3,6,2,0,5,0,12
7898,792131,19,2,8,2,5,0,3,0,0,1,2,0,3,1,3,1,4
7898,786838,32,4,9,4,9,0,0,11,14,2,7,3,2,0,0,4,19
7898,797736,14,0,5,0,1,0,4,0,0,2,0,0,1,1,1,1,0
7898,792132,23,2,4,2,3,0,1,3,5,1,3,2,3,2,2,0,7
7898,792127,31,3,9,1,4,2,5,4,4,1,2,2,3,3,1,1,12
7898,799273,1,0,0,0,0,0,0,0,0,0,0,0,1,0,0,0,0
7898,792128,27,5,10,5,9,0,1,0,0,0,6,0,3,2,1,0,10
7898,797739,9,1,2,1,2,0,0,0,0,1,1,0,1,1,0,0,2
7898,792126,27,1,6,0,1,1,5,2,2,0,5,2,2,1,0,1,5
7898,791668,17,0,1,0,0,0,1,0,0,1,0,1,1,1,3,0,0
7899,791564,28,3,6,1,2,2,4,4,4,2,6,1,4,1,2,0,12
7899,775549,18,4,8,4,8,0,0,3,4,2,1,1,4,0,4,1,11
7899,797056,33,3,10,1,5,2,5,2,4,0,5,0,3,1,6,0,10
7899,791568,20,0,3,0,2,0,1,0,0,2,4,3,2,1,0,1,0
7899,797055,33,3,8,1,3,2,5,4,4,0,8,1,1,2,2,0,12
7899,797058,16,1,3,1,1,0,2,0,0,0,0,0,0,0,0,1,2
7899,791566,25,1,5,0,2,1,3,0,0,3,2,0,4,0,1,0,3
7899,797054,27,2,10,2,6,0,4,0,0,0,1,2,1,0,2,0,4
7900,797546,15,1,2,1,2,0,0,0,2,0,0,0,1,0,0,0,2
7900,797549,14,1,5,1,4,0,1,0,2,0,1,1,5,0,3,0,2
7900,797545,26,1,3,0,2,1,1,0,0,0,3,4,1,1,3,0,3
7900,791715,22,0,5,0,3,0,2,2,3,2,5,0,3,3,1,1,2
7900,780586,36,11,19,10,18,1,1,7,9,1,4,1,2,0,4,1,30
7900,797544,19,4,9,3,7,1,2,0,0,1,1,2,1,0,0,3,9
7900,780351,24,2,5,2,5,0,0,1,2,1,4,0,2,2,2,0,5
7900,797540,12,2,4,2,3,0,1,0,0,0,0,0,1,2,0,1,4
7900,791716,12,1,1,1,1,0,0,0,0,0,2,0,3,0,1,0,2
7900,790857,20,3,5,3,4,0,1,2,4,0,1,3,2,1,2,0,8
7901,797695,18,4,7,4,7,0,0,2,3,1,4,0,3,0,2,0,10
7901,797699,33,4,9,3,5,1,4,6,7,0,0,2,3,2,4,0,15
7901,797692,32,3,7,1,2,2,5,0,0,0,4,2,4,1,2,0,8
7901,791954,24,5,7,4,6,1,1,4,6,1,2,0,4,2,5,0,15
7901,780846,38,5,9,5,7,0,2,4,5,4,12,6,3,1,3,0,14
7901,797698,2,1,2,1,2,0,0,0,0,0,0,0,0,0,0,0,2
7901,780844,22,2,6,0,0,2,6,0,0,1,1,1,1,3,0,1,6
7901,797694,31,3,9,0,1,3,8,0,0,0,2,1,0,1,0,1,9
7902,776279,32,3,6,2,2,1,4,1,2,0,5,5,4,1,1,3,8
7902,781505,34,7,13,6,9,1,4,4,8,4,6,2,2,1,2,0,19
7902,780353,34,4,6,4,6,0,0,6,8,3,8,0,1,0,3,3,14
7902,791317,35,4,13,3,9,1,4,0,0,0,7,7,1,1,1,0,9
7902,777573,30,5,11,5,8,0,3,3,4,0,2,1,2,0,0,0,13
7902,786222,14,1,2,1,2,0,0,3,4,0,3,0,4,0,1,0,5
7902,796646,1,0,0,0,0,0,0,0,0,0,0,0,0,0,0,0,0
7902,796649,14,1,3,1,3,0,0,1,2,0,0,0,2,0,0,0,3
7902,790851,6,0,0,0,0,0,0,0,1,1,1,1,0,0,0,0,0
7903,774806,31,6,12,6,12,0,0,0,1,2,9,1,5,0,0,0,12
7903,775823,25,6,9,5,8,1,1,0,0,1,6,1,3,1,3,0,13
7903,791041,28,3,10,3,4,0,6,5,6,0,2,1,4,0,1,0,11
7903,791038,31,1,6,0,5,1,1,0,0,0,3,0,3,1,2,0,3
7903,789023,39,4,13,2,7,2,6,2,5,2,1,6,0,0,2,0,12
7903,796716,12,1,3,0,0,1,3,0,0,0,2,0,2,0,1,0,3
7903,796714,8,2,3,2,3,0,0,0,0,0,1,0,2,1,0,0,4
7903,775205,26,1,3,0,0,1,3,0,1,0,3,2,3,1,0,0,3
7904,785495,30,9,15,9,14,0,1,1,2,2,8,1,0,0,5,0,19
7904,785958,34,3,13,3,13,0,0,3,5,9,4,2,4,2,2,0,9
7904,785659,27,3,3,2,2,1,1,2,2,2,2,1,4,1,0,1,9
7904,785494,37,4,18,3,12,1,6,2,2,2,4,5,2,0,5,0,11
7904,780698,39,4,15,4,9,0,6,3,6,2,3,1,3,1,1,1,11
7904,785490,16,4,4,4,4,0,0,0,0,4,2,0,2,0,0,0,8
7904,791034,3,0,0,0,0,0,0,0,0,0,2,0,0,0,0,0,0
7904,780427,14,0,2,0,2,0,0,3,4,1,1,1,1,1,1,0,3
7905,797972,32,1,3,1,2,0,1,1,1,3,2,4,1,0,1,2,3
7905,797967,34,6,13,6,10,0,3,5,7,2,5,1,2,1,2,1,17
7905,797970,34,6,13,4,11,2,2,4,5,0,4,4,2,0,1,0,18
7905,781453,35,8,13,5,8,3,5,1,2,0,6,6,1,4,3,0,20
7905,774869,36,5,10,2,3,3,7,0,0,0,3,1,2,1,0,0,13
7905,792254,9,0,2,0,1,0,1,2,2,1,1,0,1,0,1,0,2
7905,797962,5,0,1,0,1,0,0,1,2,0,0,0,1,1,0,0,1
7905,786098,15,2,5,0,2,2,3,0,0,0,0,0,3,0,1,0,6
7906,781215,31,1,5,1,4,0,1,0,0,0,5,4,1,0,0,0,2
7906,791001,24,3,5,1,3,2,2,2,4,0,1,3,2,0,4,0,10
7906,775255,32,8,17,5,10,3,7,4,4,0,1,2,2,0,3,0,23
7906,781159,24,6,8,5,6,1,2,6,6,2,1,1,2,2,1,2,19
7906,781174,27,5,7,5,7,0,0,3,4,4,5,3,4,0,1,2,13
7906,796644,13,2,3,2,3,0,0,0,0,0,2,0,3,0,1,1,4
7906,785320,15,2,3,1,1,1,2,0,0,0,0,0,1,1,0,0,5
7906,785231,14,1,1,1,1,0,0,1,2,0,1,0,0,0,2,0,3
7906,779972,20,1,5,1,2,0,3,0,0,0,2,2,0,3,0,1,2
7907,798008,37,3,8,2,4,1,4,0,0,0,2,5,2,0,1,0,7
7907,781584,36,4,8,2,3,2,5,0,0,1,3,1,2,0,0,0,10
7907,780347,31,3,12,2,9,1,3,2,4,2,1,3,2,0,0,0,9
7907,781579,22,4,7,4,6,0,1,3,3,3,2,1,4,1,3,0,11
7907,786731,33,14,19,14,19,0,0,2,4,6,5,3,3,3,4,2,30
7907,775696,19,4,8,4,8,0,0,0,0,2,1,1,0,0,1,0,8
7907,776481,7,0,1,0,1,0,0,0,0,0,1,0,3,1,1,1,0
7907,798017,9,1,3,1,2,0,1,0,0,0,2,0,0,1,0,0,2
7907,792358,6,0,0,0,0,0,0,0,0,0,0,0,2,0,1,0,0
7914,781028,21,9,13,2,2,7,11,0,0,0,3,2,1,1,0,0,25
7914,781027,26,6,11,3,6,3,5,0,0,3,5,1,1,1,0,0,15
7914,781026,23,3,6,2,2,1,4,2,2,1,6,3,1,2,2,0,9
7914,790788,23,3,8,3,3,0,5,1,1,1,6,5,3,0,1,0,7
7914,796349,25,2,6,0,1,2,5,0,0,1,2,3,0,1,0,0,6
7914,796348,24,7,9,5,6,2,3,0,0,0,1,3,0,0,2,0,16
7914,796346,20,3,5,2,3,1,2,4,5,0,0,1,2,0,0,0,11
7914,790787,27,4,6,2,3,2,3,0,0,1,7,4,4,0,0,1,10
7914,790786,7,1,2,1,1,0,1,0,0,0,1,1,1,0,0,0,2
7914,797899,4,0,1,0,0,0,1,0,0,1,1,0,0,1,0,0,0
7916,780683,33,4,8,4,6,0,2,0,0,1,4,0,2,1,1,0,8
7916,780686,33,7,9,7,9,0,0,2,2,4,6,3,3,0,3,0,16
7916,786112,37,7,15,4,8,3,7,3,6,0,7,2,4,4,5,0,20
7916,797681,33,0,10,0,5,0,5,2,2,0,0,7,4,2,3,0,2
7916,780688,33,5,10,3,4,2,6,4,6,0,4,0,2,1,2,0,16
7916,791942,6,0,1,0,1,0,0,0,0,0,1,1,1,0,2,0,0
7916,797680,11,2,4,1,3,1,1,0,0,0,1,0,1,0,0,0,5
7916,780689,11,1,1,0,0,1,1,0,0,0,2,0,0,1,0,0,3
7916,797683,3,0,1,0,1,0,0,0,0,0,0,0,1,0,0,0,0
7917,775110,33,3,9,3,9,0,0,2,2,5,9,0,2,2,1,1,8
7917,797138,36,1,6,0,5,1,1,3,6,0,1,3,3,3,4,0,6
7917,785936,29,3,6,2,2,1,4,0,1,0,2,2,4,1,1,0,7
7917,791392,38,5,7,5,6,0,1,3,5,1,3,3,1,2,2,0,13
7917,775458,31,8,14,4,8,4,6,4,5,1,5,4,5,1,4,0,24
7917,785264,25,5,12,3,7,2,5,2,2,0,3,1,2,1,5,0,14
7917,786062,2,0,0,0,0,0,0,0,0,0,0,0,0,0,0,0,0
7917,797134,6,0,0,0,0,0,0,0,0,0,0,0,2,1,0,1,0
7918,791316,31,6,10,6,10,0,0,3,4,2,2,1,3,1,1,0,15
7918,780870,24,6,6,6,6,0,0,0,1,1,8,1,2,1,1,0,12
7918,781079,30,4,9,2,5,2,4,2,4,2,0,9,3,3,4,0,12
7918,781443,33,5,8,3,6,2,2,3,3,1,3,4,1,1,3,0,15
7918,775822,30,6,14,3,5,3,9,0,0,0,2,1,3,1,2,0,15
7918,796625,18,1,4,1,2,0,2,0,0,0,3,2,0,1,0,1,2
7918,796621,17,3,5,3,4,0,1,0,0,1,3,1,2,0,0,0,6
7918,791314,1,0,0,0,0,0,0,0,0,0,0,0,1,0,1,0,0
7918,785380,16,1,3,1,3,0,0,1,2,1,0,0,3,0,0,0,3
7919,792265,36,5,9,3,4,2,5,6,8,2,2,1,2,0,1,0,18
7919,792266,27,6,9,3,4,3,5,1,2,2,2,1,1,0,1,2,16
7919,786152,23,1,6,1,6,0,0,0,0,0,1,0,2,0,1,0,2
7919,792267,28,2,3,1,1,1,2,2,2,0,3,1,3,0,3,0,7
7919,798003,27,5,8,4,5,1,3,1,1,0,2,6,1,2,3,0,12
7919,798006,8,1,3,1,1,0,2,0,0,0,0,2,0,0,0,0,2
7919,792263,11,1,3,1,1,0,2,0,0,1,1,1,0,0,2,0,2
7919,797998,2,0,0,0,0,0,0,0,0,0,0,0,0,0,1,0,0
7919,798005,2,0,2,0,2,0,0,0,0,1,2,0,0,0,0,0,0
7919,798009,17,0,4,0,2,0,2,2,4,0,0,1,0,0,0,1,2
7919,798007,19,2,2,2,2,0,0,1,2,2,2,1,3,0,2,0,5
7920,780832,35,1,8,1,8,0,0,3,4,9,3,1,2,0,1,1,5
7920,790961,33,6,13,6,12,0,1,2,2,6,7,1,1,3,1,2,14
7920,786240,18,1,4,1,2,0,2,2,4,0,1,1,2,0,1,0,4
7920,785278,33,0,5,0,4,0,1,0,0,0,8,0,4,2,2,1,0
7920,780146,34,4,11,1,4,3,7,9,10,0,3,1,1,2,2,0,20
7920,796556,8,1,5,1,2,0,3,0,0,2,1,0,0,0,0,1,2
7920,796554,4,1,1,0,0,1,1,0,0,0,0,0,0,0,0,1,3
7920,796555,2,0,1,0,1,0,0,0,0,0,0,0,0,0,1,0,0
7920,775860,33,3,16,1,5,2,11,7,7,0,3,2,1,2,1,0,15
7921,787175,30,2,6,0,0,2,6,0,0,0,8,1,4,0,1,0,6
7921,782126,8,0,2,0,1,0,1,0,0,0,2,0,0,0,0,0,0
7921,790909,37,6,15,4,6,2,9,1,3,1,4,3,3,2,5,0,15
7921,781393,40,5,11,2,6,3,5,6,7,0,9,7,2,1,3,0,19
7921,775351,40,7,12,6,11,1,1,0,0,3,5,1,4,0,5,1,15
7921,796455,28,4,10,4,9,0,1,2,2,2,1,0,4,0,1,2,10
7921,790907,17,0,1,0,1,0,0,0,0,0,1,0,4,1,1,2,0
7922,786039,26,3,10,3,10,0,0,4,5,5,3,1,4,0,1,1,10
7922,792043,20,4,8,3,4,1,4,0,0,2,5,1,2,0,0,0,9
7922,786266,36,5,13,2,4,3,9,3,4,2,2,2,2,1,3,0,16
7922,792040,31,10,16,8,14,2,2,0,0,4,3,3,1,1,1,1,22
7922,775028,39,5,13,2,8,3,5,1,3,1,5,8,4,0,1,0,14
7922,797728,16,1,2,1,1,0,1,2,2,0,0,0,1,0,1,0,4
7922,797726,18,3,4,3,4,0,0,0,0,0,3,0,1,0,2,0,6
7922,797718,14,0,3,0,0,0,3,0,0,0,0,1,4,0,0,0,0
7923,797529,31,2,6,1,2,1,4,2,2,0,3,1,2,1,0,0,7
7923,797527,29,5,7,3,4,2,3,2,2,1,7,0,4,1,1,1,14
7923,791936,37,8,13,8,13,0,0,1,4,8,3,2,5,1,3,0,17
7923,797532,39,5,13,4,10,1,3,9,10,1,4,9,3,2,2,1,20
7923,785688,25,6,15,2,4,4,11,0,0,1,0,0,1,0,0,0,16
7923,791932,10,1,3,0,0,1,3,0,0,0,2,0,0,0,0,0,3
7923,785988,23,3,7,2,4,1,3,1,1,0,2,0,2,1,1,0,8
7923,791933,4,0,0,0,0,0,0,0,0,0,0,0,0,0,0,0,0
7923,791931,2,0,0,0,0,0,0,0,0,0,0,0,0,0,0,0,0
7924,796766,15,0,3,0,1,0,2,0,0,1,0,1,1,0,1,1,0
7924,785614,19,1,2,1,2,0,0,0,0,2,7,0,4,0,0,3,2
7924,796767,24,5,10,2,4,3,6,2,3,1,4,0,2,0,5,0,15
7924,796765,39,3,12,2,8,1,4,0,0,2,3,2,3,3,4,0,7
7924,780812,36,6,20,4,8,2,12,5,6,1,9,1,4,1,2,1,19
7924,791113,20,0,1,0,0,0,1,1,2,0,3,1,0,2,0,1,1
7924,785618,21,1,4,0,1,1,3,0,2,2,0,1,0,0,2,2,3
7924,780813,26,3,4,2,2,1,2,4,6,4,2,2,3,0,1,1,11
7925,797174,23,4,8,2,5,2,3,2,2,2,3,0,1,1,2,0,12
7925,791510,28,0,3,0,2,0,1,2,3,1,3,3,1,2,2,0,2
7925,786699,19,1,4,1,4,0,0,0,0,3,3,1,4,1,0,0,2
7925,785593,33,4,14,0,5,4,9,0,0,0,5,3,1,3,2,1,12
7925,775357,37,4,15,2,7,2,8,4,4,0,3,2,2,3,2,0,14
7925,791507,20,3,5,3,4,0,1,4,5,2,5,1,4,1,0,1,10
7925,791504,28,3,9,3,9,0,0,1,6,2,1,2,1,1,1,0,7
7925,791505,12,2,4,1,2,1,2,0,0,0,2,0,1,1,0,1,5
7926,796838,9,0,6,0,6,0,0,0,0,1,2,0,2,0,0,1,0
7926,796837,32,3,9,1,5,2,4,1,2,3,10,0,1,1,1,0,9
7926,796833,27,1,4,1,2,0,2,0,0,1,0,1,2,0,0,0,2
7926,785706,35,3,9,1,4,2,5,3,3,1,1,1,1,0,1,0,11
7926,785700,34,6,11,5,8,1,3,1,3,3,3,6,0,3,1,0,14
7926,791171,9,1,2,1,2,0,0,2,2,1,1,0,0,0,0,0,4
7926,796834,19,1,3,1,2,0,1,1,1,2,3,2,1,1,2,0,3
7926,780269,35,11,26,6,18,5,8,4,4,0,4,2,3,1,2,0,31
7927,791760,28,5,8,5,7,0,1,1,1,0,7,0,1,1,3,0,11
7927,780256,30,4,11,3,5,1,6,1,2,3,2,2,1,1,1,1,10
7927,796879,29,5,8,3,5,2,3,0,0,0,5,3,3,0,2,0,12
7927,796880,34,8,15,4,8,4,7,3,4,1,5,2,3,1,0,0,23
7927,791334,17,0,5,0,2,0,3,0,0,0,1,1,0,0,0,0,0
7927,785874,12,1,3,1,3,0,0,0,0,1,4,0,0,0,0,3,2
7927,796885,4,1,2,1,1,0,1,0,0,0,0,0,0,0,0,0,2
7927,796883,9,0,3,0,2,0,1,0,0,1,1,3,2,1,0,0,0
7927,791757,26,3,5,1,1,2,4,3,3,1,0,0,2,0,0,0,11
7927,781590,11,1,5,1,4,0,1,2,2,1,4,0,2,1,1,0,4
7928,780406,26,4,6,4,6,0,0,0,0,2,3,4,2,0,2,0,8
7928,775087,27,8,14,6,10,2,4,0,0,1,3,3,0,2,0,0,18
7928,785296,25,3,7,1,3,2,4,0,0,0,2,2,2,1,4,0,8
7928,780212,34,8,23,5,12,3,11,1,1,0,3,0,5,0,4,0,20
7928,767245,27,5,8,5,8,0,0,2,2,3,0,1,4,0,1,0,12
7928,780215,13,1,2,1,2,0,0,2,2,2,0,0,3,0,1,0,4
7928,790984,29,2,3,1,1,1,2,2,2,1,4,6,4,1,2,0,7
7928,785297,19,0,2,0,2,0,0,2,2,0,4,0,3,1,3,0,2
7929,790935,30,8,12,5,7,3,5,1,2,0,4,0,2,0,0,0,20
7929,792442,17,5,6,5,6,0,0,2,4,2,1,0,3,0,2,3,12
7929,780933,33,6,11,1,3,5,8,2,2,0,2,0,5,3,1,0,19
7929,775340,37,2,12,2,10,0,2,8,10,0,3,11,1,2,4,0,12
7929,774826,21,1,4,0,1,1,3,0,1,1,4,3,0,0,1,1,3
7929,796190,11,0,1,0,0,0,1,0,0,1,2,0,2,1,0,0,0
7929,790937,23,5,7,5,7,0,0,6,6,2,3,0,1,0,1,0,16
7929,785445,8,0,1,0,0,0,1,0,0,0,1,0,2,2,1,0,0
7929,790938,19,3,4,3,4,0,0,0,0,0,3,2,2,1,0,0,6
7929,796492,1,0,0,0,0,0,0,0,0,0,0,0,0,0,0,0,0
7930,791266,30,5,7,5,7,0,0,1,6,1,7,1,3,0,2,1,11
7930,785977,29,1,10,1,5,0,5,0,0,1,5,1,0,1,1,1,2
7930,791265,33,5,11,2,4,3,7,2,3,0,0,6,2,2,0,0,15
7930,791269,21,2,11,0,0,2,11,1,2,1,0,1,0,0,0,0,7
7930,785685,31,2,7,2,3,0,4,6,8,1,3,5,0,1,5,0,10
7930,796524,4,0,1,0,1,0,0,0,0,0,0,0,0,0,0,0,0
7930,796523,2,1,1,0,0,1,1,0,0,0,0,0,1,0,1,0,3
7930,796522,13,1,2,0,0,1,2,0,0,0,1,2,0,1,2,0,3
7930,796525,5,2,3,2,2,0,1,0,0,1,0,1,1,1,0,0,4
7930,791271,7,1,1,1,1,0,0,0,0,0,1,1,1,2,0,0,2
7930,781294,25,5,7,0,0,5,7,0,0,0,0,1,4,0,0,0,15
7931,797662,19,5,5,5,5,0,0,0,0,2,3,1,4,0,2,0,10
7931,786067,37,12,16,12,16,0,0,2,2,0,9,2,1,0,3,0,26
7931,797660,25,3,5,3,5,0,0,2,2,0,4,4,4,0,1,0,8
7931,785591,31,8,12,7,11,1,1,3,5,0,6,5,2,1,5,1,20
7931,780258,39,5,10,3,4,2,6,0,0,1,3,5,3,4,1,0,12
7931,792082,7,0,0,0,0,0,0,0,0,1,1,1,1,0,0,0,0
7931,791952,18,2,2,2,2,0,0,3,6,1,2,0,2,0,1,1,7
7931,797661,15,0,7,0,3,0,4,0,0,0,5,0,0,0,1,0,0
7931,792083,9,1,2,1,1,0,1,0,0,0,1,2,0,0,1,0,2
7932,797163,30,9,11,9,11,0,0,1,1,1,10,2,5,0,7,5,19
7932,797164,16,1,1,1,1,0,0,0,1,1,1,2,3,0,0,0,2
7932,786450,30,2,7,1,5,1,2,2,6,0,3,3,5,3,4,3,7
7932,776396,18,4,8,4,5,0,3,2,2,0,1,1,3,2,4,0,10
7932,776199,29,4,9,2,5,2,4,8,9,0,0,5,0,1,3,0,18
7932,797167,8,1,2,1,2,0,0,1,1,0,2,0,2,0,0,0,3
7932,791385,23,4,6,2,4,2,2,3,4,2,6,4,5,2,2,1,13
7932,797161,4,0,1,0,0,0,1,4,4,1,0,0,2,0,3,0,4
7932,797165,27,5,9,2,2,3,7,0,0,0,4,1,2,1,0,0,13
7932,791382,9,1,2,1,2,0,0,0,0,0,0,2,2,2,1,0,2
7932,791386,4,0,0,0,0,0,0,0,0,0,0,0,0,0,0,0,0
7932,800178,2,0,0,0,0,0,0,0,0,0,0,0,1,0,1,0,0
7933,780494,29,6,14,6,13,0,1,4,6,3,8,2,3,3,3,0,16
7933,797276,22,4,8,3,7,1,1,4,4,2,3,3,2,2,1,0,13
7933,780497,17,3,5,2,4,1,1,2,2,1,2,2,2,0,2,0,9
7933,780496,27,3,9,3,3,0,6,6,6,1,1,1,2,1,0,0,12
7933,780495,27,5,14,2,9,3,5,8,9,0,4,1,3,3,1,0,21
7933,797274,1,0,0,0,0,0,0,0,0,0,0,0,0,0,0,0,0
7933,791645,8,1,2,1,1,0,1,0,0,0,1,0,1,0,0,0,2
7933,785693,25,3,4,3,4,0,0,3,6,4,2,0,3,1,2,1,9
7933,791643,11,0,2,0,0,0,2,1,2,0,0,0,2,1,0,0,1
7933,785692,18,1,3,1,3,0,0,1,2,1,0,3,2,0,5,0,3
7933,785644,15,0,6,0,5,0,1,0,0,0,0,1,1,1,1,0,0
7934,792288,24,4,5,4,5,0,0,0,2,3,5,0,1,0,0,0,8
7934,785227,27,2,5,2,5,0,0,2,2,0,3,3,5,1,1,3,6
7934,786237,34,9,12,9,12,0,0,7,8,1,1,2,2,2,2,0,25
7934,780287,30,3,12,3,8,0,4,2,3,0,2,1,2,2,0,0,8
7934,776309,29,1,5,1,3,0,2,0,0,1,1,3,2,2,1,0,2
7934,798072,9,0,2,0,2,0,0,0,0,1,1,0,3,1,3,0,0
7934,792278,18,1,7,0,2,1,5,0,0,1,0,2,0,0,1,0,3
7934,786232,29,7,13,6,9,1,4,9,11,2,4,1,1,2,1,0,24
7935,786542,32,3,5,3,5,0,0,1,2,2,2,1,2,0,2,0,7
7935,786540,19,8,10,8,9,0,1,1,2,2,6,0,4,1,3,0,17
7935,792019,33,4,10,2,5,2,5,2,2,1,2,3,4,1,1,0,12
7935,792015,30,3,9,2,6,1,3,3,3,0,5,0,5,1,5,0,10
7935,775995,37,4,10,3,6,1,4,4,4,0,5,3,3,1,4,0,13
7935,785364,21,0,1,0,1,0,0,1,2,1,3,1,1,0,2,1,1
7935,792016,17,3,5,2,2,1,3,0,0,0,2,1,0,0,1,0,7
7935,791845,11,1,3,1,2,0,1,0,0,2,1,0,1,0,1,1,2
7936,780913,27,6,11,3,4,3,7,0,0,0,3,2,2,0,1,0,15
7936,798119,31,4,11,3,7,1,4,0,0,0,3,1,1,0,0,0,9
7936,798117,34,1,3,1,3,0,0,1,3,0,1,11,2,3,1,0,3
7936,780594,29,6,12,4,6,2,6,3,4,0,5,4,3,2,1,0,17
7936,775664,32,3,10,0,0,3,10,0,0,0,4,0,1,1,0,0,9
7936,798123,21,7,13,7,11,0,2,5,7,2,3,0,3,0,1,0,19
7936,798124,11,0,1,0,0,0,1,0,0,0,1,1,0,0,1,1,0
7936,798121,15,1,1,0,0,1,1,0,0,0,0,0,2,0,1,1,3
7937,776344,21,6,9,4,6,2,3,0,0,1,6,1,3,1,3,2,14
7937,775821,22,3,5,2,4,1,1,0,0,0,6,2,3,1,2,1,7
7937,792453,30,5,10,4,6,1,4,3,4,1,4,6,1,0,2,0,14
7937,785131,25,3,10,2,4,1,6,2,2,2,4,2,2,0,3,1,9
7937,781538,32,6,9,1,1,5,8,2,2,0,0,1,1,1,0,0,19
7937,798113,11,2,3,1,1,1,2,0,0,0,2,0,1,0,1,0,5
7937,785152,10,0,0,0,0,0,0,2,2,0,3,1,3,0,1,0,2
7937,798115,23,0,3,0,1,0,2,0,0,0,3,2,1,0,0,0,0
7937,792324,9,1,1,0,0,1,1,0,0,0,0,0,0,0,1,0,3
7937,776233,17,3,6,1,4,2,2,0,0,0,4,1,1,1,0,0,8
7938,780569,36,7,14,7,14,0,0,3,4,2,11,3,3,0,1,3,17
7938,797436,31,3,9,1,5,2,4,0,0,0,6,2,1,0,2,0,8
7938,791696,29,6,13,5,11,1,2,3,4,0,2,1,2,4,3,0,16
7938,781556,27,3,8,3,6,0,2,2,2,0,5,0,2,1,1,2,8
7938,780565,34,4,6,3,4,1,2,6,6,3,7,6,0,2,1,0,15
7938,797433,2,0,0,0,0,0,0,0,0,0,0,0,3,0,0,1,0
7938,797432,17,3,6,1,2,2,4,0,0,0,0,2,1,0,0,0,8
7938,791695,3,0,1,0,1,0,0,0,0,0,0,0,0,1,0,0,0
7938,785824,21,0,4,0,3,0,1,0,2,0,3,1,2,0,0,0,0
7939,786481,37,9,19,7,15,2,4,2,3,5,8,2,3,2,4,0,22
7939,797626,28,2,11,2,8,0,3,0,0,2,9,4,4,0,1,0,4
7939,797624,20,1,5,1,2,0,3,0,1,0,3,0,1,0,0,1,2
7939,786480,30,1,5,0,1,1,4,4,6,0,3,2,3,2,1,0,7
7939,781032,33,4,11,2,5,2,6,0,0,1,2,0,1,0,2,1,10
7939,797628,20,2,5,2,5,0,0,0,0,2,3,1,2,1,3,0,4
7939,791791,13,0,1,0,0,0,1,0,0,1,1,0,1,0,0,0,0
7939,785965,19,5,10,2,4,3,6,0,0,0,2,1,1,0,1,0,13
7940,781592,16,3,5,2,4,1,1,0,2,2,5,0,3,1,1,0,7
7940,780229,31,9,12,9,12,0,0,5,5,3,6,3,4,3,3,0,23
7940,795572,34,4,14,4,11,0,3,5,7,1,7,2,4,3,3,1,13
7940,791483,33,5,10,3,5,2,5,4,4,0,1,1,2,0,2,0,16
7940,797193,25,1,4,1,2,0,2,0,0,0,1,1,4,0,4,0,2
7940,791484,5,0,1,0,0,0,1,0,0,0,1,0,0,0,0,0,0
7940,791488,16,1,2,0,0,1,2,0,0,0,0,1,0,1,0,0,3
7940,797194,5,0,2,0,0,0,2,0,0,1,1,0,0,0,0,0,0
7940,791485,5,0,1,0,0,0,1,0,0,0,0,1,1,0,0,0,0
7940,786322,29,5,9,3,5,2,4,0,0,0,2,0,1,0,0,0,12
7940,780228,1,0,0,0,0,0,0,0,0,0,0,0,0,0,0,0,0
7941,797235,35,5,6,5,6,0,0,2,4,3,8,0,1,0,4,1,12
7941,797232,40,5,15,2,5,3,10,2,2,0,1,3,2,1,2,1,15
7941,797237,25,1,8,1,3,0,5,3,3,0,6,3,1,1,0,0,5
7941,797234,24,2,6,2,4,0,2,1,3,3,4,1,4,0,0,0,5
7941,797239,27,3,8,3,4,0,4,2,2,0,0,2,4,2,5,0,8
7941,797233,4,2,2,2,2,0,0,1,2,1,1,0,2,0,2,0,5
7941,791368,15,1,3,1,3,0,0,1,2,3,1,0,2,0,0,0,3
7941,791367,28,3,8,2,7,1,1,2,5,1,2,2,1,4,0,0,9
7941,797240,2,0,0,0,0,0,0,0,0,0,0,0,0,0,0,0,0
7942,781044,31,5,13,4,8,1,5,2,3,0,5,3,2,2,1,2,13
7942,791795,25,2,2,1,1,1,1,0,0,1,3,0,1,0,0,0,5
7942,786489,21,1,2,0,0,1,2,2,2,0,2,1,1,0,2,0,5
7942,786488,38,5,14,4,9,1,5,6,8,0,4,3,3,2,2,0,17
7942,781038,36,6,8,5,5,1,3,0,0,0,4,2,0,1,2,0,13
7942,797620,26,4,6,2,3,2,3,0,2,1,4,1,0,2,0,0,10
7942,786490,9,1,1,1,1,0,0,0,0,1,0,0,1,0,0,1,2
7942,797621,7,0,1,0,1,0,0,0,0,0,0,0,0,0,0,0,0
7942,797619,7,1,3,1,2,0,1,0,0,0,0,1,0,1,2,0,2
7943,792035,30,2,10,2,10,0,0,0,0,2,3,3,2,0,4,0,4
7943,780833,30,5,6,5,6,0,0,3,3,1,2,1,1,0,1,0,13
7943,792034,40,6,17,2,7,4,10,0,0,1,5,6,1,1,1,0,16
7943,791688,23,3,5,0,0,3,5,0,0,0,2,1,3,1,1,0,9
7943,780830,37,4,6,2,3,2,3,0,0,0,9,4,2,0,3,0,10
7943,797645,11,2,4,2,4,0,0,0,0,0,3,0,5,0,2,0,4
7943,785980,22,3,5,0,1,3,4,0,0,0,1,0,1,0,0,0,9
7943,785381,7,1,3,0,0,1,3,0,0,0,0,1,0,0,0,0,3
7944,781577,28,5,11,5,10,0,1,0,1,1,2,2,5,2,1,0,10
7944,775910,26,4,9,3,4,1,5,0,0,4,1,1,4,1,2,0,9
7944,786451,31,1,5,0,0,1,5,0,0,2,1,1,3,0,0,0,3
7944,780600,23,4,12,3,5,1,7,3,5,1,4,3,3,1,0,1,12
7944,781387,32,2,9,1,5,1,4,4,5,0,2,4,2,1,0,0,9
7944,791763,14,4,5,2,2,2,3,0,0,1,5,0,2,0,0,0,10
7944,786456,8,0,0,0,0,0,0,0,2,0,0,0,1,0,1,1,0
7944,780268,3,0,0,0,0,0,0,0,0,0,0,1,0,0,0,0,0
7944,797561,8,0,0,0,0,0,0,0,0,1,1,1,0,0,1,0,0
7944,780020,27,4,12,3,8,1,4,4,7,0,3,0,2,1,0,0,13
7945,781454,33,7,12,7,10,0,2,1,5,2,5,0,2,1,1,0,15
7945,786424,29,1,2,1,2,0,0,4,9,3,14,5,4,0,6,0,6
7945,792366,27,8,10,8,8,0,2,2,5,0,1,1,0,0,1,1,18
7945,791015,12,0,1,0,0,0,1,0,0,0,0,0,1,0,2,0,0
7945,785483,35,5,12,3,8,2,4,3,3,0,3,4,3,0,2,0,15
7945,797991,0,0,0,0,0,0,0,0,0,0,0,0,1,0,0,0,0
7945,785959,18,1,2,1,2,0,0,0,0,1,3,0,2,0,1,0,2
7945,797988,26,3,5,3,4,0,1,1,2,0,2,3,2,0,1,0,7
7945,797979,20,2,3,0,1,2,2,0,0,0,2,1,2,0,1,1,6
7946,796891,31,5,11,5,10,0,1,10,14,3,8,0,3,1,2,0,20
7946,796886,4,0,0,0,0,0,0,1,2,0,0,0,0,0,0,0,1
7946,796884,28,2,7,1,4,1,3,2,4,5,3,2,4,0,7,0,7
7946,796882,36,0,6,0,1,0,5,4,4,0,3,4,1,0,1,0,4
7946,796881,16,2,2,1,1,1,1,0,0,1,0,1,3,0,4,0,5
7946,796890,9,1,1,1,1,0,0,2,2,2,2,1,1,0,0,0,4
7946,796896,14,1,9,1,5,0,4,0,0,1,0,1,2,0,0,0,2
7946,796888,17,2,5,0,1,2,4,0,0,2,3,1,2,0,0,0,6
7946,796887,21,0,7,0,2,0,5,0,0,1,1,1,1,0,0,0,0
7946,790447,24,4,8,4,8,0,0,2,2,0,1,2,2,3,1,1,10
7947,791868,12,2,4,1,3,1,1,4,4,0,0,1,5,0,2,0,9
7947,797802,31,4,8,3,5,1,3,2,2,0,3,3,5,4,1,0,11
7947,797809,24,0,1,0,1,0,0,2,4,1,4,0,5,0,1,2,2
7947,797807,40,7,13,7,13,0,0,2,3,1,3,2,0,1,1,0,16
7947,786058,40,2,6,2,6,0,0,6,7,0,7,4,4,2,2,0,10
7947,797812,4,0,0,0,0,0,0,0,0,0,4,0,1,0,0,0,0
7947,795730,33,9,16,5,8,4,8,1,1,0,3,3,1,0,1,0,23
7947,797810,0,0,0,0,0,0,0,0,0,0,0,0,0,0,0,0,0
7947,797798,0,0,0,0,0,0,0,0,0,0,0,0,0,0,0,0,0
7947,797811,0,1,1,1,1,0,0,0,0,0,0,0,0,0,1,0,2
7947,781113,16,0,1,0,1,0,0,4,4,1,1,1,3,1,0,0,4
7948,791743,25,8,10,8,9,0,1,2,6,2,4,2,4,1,2,0,18
7948,797341,30,2,11,1,7,1,4,3,4,0,3,0,2,2,3,0,8
7948,791747,33,5,16,2,8,3,8,2,3,2,0,2,0,0,0,0,15
7948,791746,36,2,6,2,5,0,1,0,0,0,2,2,1,5,2,1,4
7948,786193,39,5,13,2,5,3,8,2,2,1,4,2,0,0,0,0,15
7948,797340,6,0,4,0,0,0,4,0,0,0,0,1,1,0,0,0,0
7948,797342,10,0,0,0,0,0,0,0,0,0,1,0,1,0,0,0,0
7948,786184,4,0,1,0,0,0,1,0,0,0,0,0,0,0,0,0,0
7948,797344,2,0,1,0,1,0,0,0,0,0,0,0,0,0,1,0,0
7948,780711,10,0,0,0,0,0,0,0,0,0,1,0,3,0,0,0,0
7948,797345,3,0,0,0,0,0,0,0,0,0,0,0,2,0,0,0,0
7948,797343,2,0,0,0,0,0,0,0,0,0,0,0,0,0,0,0,0
7949,796479,24,6,8,5,6,1,2,1,1,2,2,3,3,0,2,0,14
7949,781560,29,3,4,3,4,0,0,0,2,0,7,1,3,2,5,1,6
7949,796477,31,2,7,2,5,0,2,2,2,1,8,5,2,1,0,0,6
7949,791375,38,1,5,0,0,1,5,0,0,0,5,4,3,2,4,0,3
7949,785482,29,9,18,9,17,0,1,0,0,0,7,0,1,0,5,0,18
7949,780837,25,5,9,2,3,3,6,3,4,0,2,1,2,0,1,1,16
7949,796476,8,1,1,1,1,0,0,0,0,1,0,1,0,0,1,0,2
7949,786164,16,4,4,4,4,0,0,3,4,3,1,0,1,0,1,1,11
7950,786704,28,7,10,7,10,0,0,4,4,3,3,0,3,0,2,0,18
7950,785395,25,3,8,2,4,1,4,0,0,1,2,2,0,1,0,2,7
7950,775840,36,1,4,0,1,1,3,2,2,3,2,6,1,2,1,0,5
7950,775955,33,5,9,1,4,4,5,6,6,2,4,8,1,1,2,0,20
7950,775811,24,2,5,1,2,1,3,0,0,2,0,1,2,2,0,1,5
7950,786706,12,2,2,2,2,0,0,2,2,1,0,0,2,0,0,2,6
7950,775287,15,1,3,1,3,0,0,0,0,0,0,0,1,0,1,0,2
7950,790921,7,0,2,0,1,0,1,0,0,0,0,0,0,0,2,0,0
7950,786551,20,3,11,1,6,2,5,0,1,0,3,0,3,1,3,0,8
7951,791053,10,3,4,3,4,0,0,0,1,1,0,1,1,1,2,0,6
7951,780739,26,3,7,3,7,0,0,0,0,0,0,0,1,0,4,1,6
7951,785524,35,3,8,1,4,2,4,0,0,2,3,0,1,0,1,0,8
7951,781115,34,2,4,2,4,0,0,0,0,0,5,6,2,0,0,0,4
7951,775094,11,1,3,1,2,0,1,0,0,0,2,1,0,0,0,0,2
7951,796731,10,1,1,1,1,0,0,0,0,0,0,1,3,0,1,0,2
7951,796730,7,2,4,0,0,2,4,0,0,0,1,0,2,0,0,0,6
7951,791051,26,5,7,5,7,0,0,0,0,6,3,1,1,0,0,2,10
7951,790819,29,4,13,2,7,2,6,1,2,2,1,7,2,1,3,0,11
7951,786310,12,4,5,2,3,2,2,1,1,0,1,0,2,0,0,0,11
7980,790232,32,6,11,4,8,2,3,2,2,0,4,5,2,1,4,0,16
7980,780614,25,2,6,2,5,0,1,0,0,0,4,1,2,0,1,0,4
7980,780093,22,4,7,4,7,0,0,1,2,2,3,2,0,0,0,1,9
7980,789066,36,6,15,4,10,2,5,1,3,1,2,2,2,2,2,0,15
7980,776278,20,2,5,0,1,2,4,0,0,1,2,0,5,0,0,0,6
7980,780255,18,1,2,1,2,0,0,5,6,1,1,0,1,1,1,1,7
7980,792411,8,0,0,0,0,0,0,0,0,0,0,0,0,0,0,0,0
7980,786465,8,0,1,0,0,0,1,2,2,0,1,0,0,1,0,0,2
7980,786463,18,0,4,0,3,0,1,5,6,3,0,3,3,1,1,0,5
7980,785806,13,0,2,0,1,0,1,0,0,0,3,3,1,0,3,0,0
7981,786569,20,6,9,6,9,0,0,0,1,1,5,0,4,0,1,2,12
7981,791726,36,4,10,3,4,1,6,4,4,0,2,3,1,0,4,0,13
7981,786273,35,1,9,1,4,0,5,3,4,1,3,5,0,2,1,2,5
7981,780773,40,4,11,4,10,0,1,2,2,3,7,6,4,2,4,1,10
7981,775228,33,1,2,1,1,0,1,4,4,2,4,0,1,2,0,0,6
7981,797313,8,1,2,1,2,0,0,0,0,0,1,0,3,0,1,0,2
7981,791728,13,6,7,6,7,0,0,0,0,1,2,2,5,0,2,0,12
7981,797317,15,1,3,1,2,0,1,0,0,0,2,1,2,1,1,0,2
7982,790821,28,6,11,4,6,2,5,2,2,1,0,0,1,0,4,0,16
7982,775585,35,2,8,2,8,0,0,8,10,2,0,4,0,1,0,0,12
7982,790822,18,2,7,2,4,0,3,0,0,0,3,1,1,0,3,1,4
7982,780982,35,6,9,4,6,2,3,4,8,2,5,1,3,1,4,1,18
7982,774980,36,3,10,2,6,1,4,1,1,0,5,4,0,1,3,0,8
7982,785365,19,0,5,0,3,0,2,0,0,1,0,0,0,0,0,0,0
7982,780445,27,1,1,1,1,0,0,0,0,1,5,0,0,1,0,0,2
7982,792436,2,0,0,0,0,0,0,0,0,0,0,0,0,0,0,0,0
7983,785355,24,1,4,1,2,0,2,0,0,0,4,2,1,0,1,0,2
7983,781462,27,7,9,7,9,0,0,0,0,3,9,3,2,1,0,1,14
7983,780876,26,3,6,3,5,0,1,2,2,0,5,4,4,2,3,0,8
7983,785353,29,11,16,4,5,7,11,0,0,2,0,0,1,2,3,0,29
7983,781457,28,6,8,4,4,2,4,2,2,0,2,6,1,3,2,0,16
7983,791305,17,4,7,4,7,0,0,0,0,1,2,1,3,1,0,0,8
7983,781673,22,1,5,0,0,1,5,0,0,0,1,3,1,1,0,0,3
7983,790895,15,2,5,1,3,1,2,0,0,0,1,2,1,0,2,0,5
7983,792435,3,0,0,0,0,0,0,0,0,1,2,0,1,0,0,0,0
7983,790806,4,0,1,0,0,0,1,0,0,0,1,0,0,0,0,0,0
7983,796365,5,1,2,1,2,0,0,0,0,0,0,1,1,0,0,0,2
7984,791401,37,11,18,11,18,0,0,12,16,4,5,2,1,0,2,2,34
7984,780125,30,7,11,7,10,0,1,1,2,2,4,0,3,7,0,1,15
7984,791400,29,5,9,2,3,3,6,0,2,1,4,3,4,0,1,0,13
7984,785931,30,0,6,0,2,0,4,0,0,0,1,4,4,1,3,0,0
7984,780118,36,0,4,0,2,0,2,4,4,1,3,3,1,1,1,0,4
7984,786837,17,2,5,1,2,1,3,0,0,1,0,1,2,0,0,0,5
7984,797130,10,0,1,0,0,0,1,0,0,0,1,1,0,0,2,0,0
7984,797125,9,0,2,0,1,0,1,0,0,0,1,0,1,0,0,0,0
7984,797132,2,0,1,0,0,0,1,0,0,0,0,0,0,1,1,0,0
7985,790827,3,0,0,0,0,0,0,0,0,0,0,0,0,0,2,0,0
7985,790828,5,1,2,1,2,0,0,1,1,1,0,0,4,0,1,0,3
7985,785372,40,9,17,8,15,1,2,8,9,2,3,2,1,1,1,1,27
7985,796385,8,0,1,0,1,0,0,0,0,0,0,2,0,0,2,0,0
7985,774905,36,5,6,4,4,1,2,3,3,1,5,5,4,1,4,0,14
7985,786384,13,2,7,2,4,0,3,0,0,1,0,0,1,0,3,0,4
7985,796387,11,0,2,0,2,0,0,0,0,1,3,0,1,0,0,2,0
7985,790825,32,2,6,1,4,1,2,1,2,0,3,2,2,1,0,0,6
7985,785373,29,5,11,1,3,4,8,0,0,3,1,0,3,0,0,0,14
7985,785375,14,4,5,4,5,0,0,0,0,2,3,0,2,1,1,1,8
7985,785374,9,1,2,1,2,0,0,0,0,0,2,1,2,0,0,0,2
7986,797205,27,4,7,2,4,2,3,3,3,1,2,0,2,0,0,0,13
7986,786316,28,6,9,6,9,0,0,3,4,0,1,1,2,1,1,0,15
7986,797202,20,0,5,0,4,0,1,2,3,1,0,2,1,1,6,0,2
7986,791477,30,2,9,1,5,1,4,0,0,2,9,1,1,0,1,1,5
7986,780220,25,2,8,1,5,1,3,2,2,1,3,4,4,1,1,0,7
7986,797206,17,1,4,1,4,0,0,1,2,1,5,0,1,0,1,0,3
7986,791473,8,1,3,1,2,0,1,0,0,0,1,0,1,0,2,0,2
7986,797204,1,0,0,0,0,0,0,0,0,0,0,0,0,0,0,0,0
7986,791474,10,0,1,0,0,0,1,0,0,0,1,0,4,1,1,0,0
7986,791475,8,0,2,0,0,0,2,0,0,0,0,0,1,0,3,0,0
7986,791476,26,0,4,0,2,0,2,0,0,0,2,2,2,0,2,1,0
7987,791548,23,11,18,7,12,4,6,1,3,0,7,0,0,1,1,1,27
7987,791550,22,1,2,1,2,0,0,1,2,6,2,6,1,0,2,0,3
7987,786364,24,3,9,3,8,0,1,2,2,2,4,1,1,2,0,0,8
7987,780330,19,5,6,5,6,0,0,0,0,0,0,1,0,2,1,0,10
7987,780329,18,1,5,1,5,0,0,0,0,1,2,3,0,1,1,0,2
7987,797082,14,1,2,1,2,0,0,0,1,0,2,2,1,0,2,0,2
7987,789984,4,0,0,0,0,0,0,2,2,0,1,1,0,0,1,0,2
7987,780332,17,3,8,3,6,0,2,1,1,2,4,1,3,0,0,0,7
7987,791551,4,0,1,0,0,0,1,0,0,0,0,0,0,0,0,0,0
7987,797080,22,1,4,1,1,0,3,1,2,0,4,0,2,1,0,0,3
7987,786368,19,2,3,0,1,2,2,0,0,0,3,1,0,1,2,0,6
7987,786365,10,2,4,2,3,0,1,1,2,0,1,0,2,1,1,0,5
7987,781643,4,0,0,0,0,0,0,0,2,0,0,0,1,0,0,0,0
7988,775820,22,2,4,1,1,1,3,0,0,0,3,0,2,0,2,0,5
7988,775538,22,0,0,0,0,0,0,2,3,2,4,0,2,0,1,0,2
7988,791110,21,2,7,1,3,1,4,1,2,1,1,0,1,0,0,0,6
7988,785603,42,13,18,9,11,4,7,8,9,0,3,3,4,1,1,0,38
7988,776425,40,4,9,4,4,0,5,8,9,0,3,4,1,1,1,0,16
7988,796763,3,0,0,0,0,0,0,1,2,0,0,0,2,0,0,0,1
7988,791107,11,2,3,2,3,0,0,0,0,2,0,1,2,0,1,0,4
7988,791106,34,1,4,0,1,1,3,5,5,0,6,2,4,0,2,0,8
7988,796762,6,1,2,1,1,0,1,0,2,0,0,0,1,0,0,0,2
7988,786494,24,2,6,2,5,0,1,0,0,2,2,0,0,0,1,0,4
7990,785097,3,0,1,0,0,0,1,0,0,0,1,0,0,0,0,0,0
7990,780058,17,4,7,2,2,2,5,0,0,3,0,2,0,1,0,1,10
7990,776110,19,0,2,0,0,0,2,1,2,1,5,1,3,1,2,1,1
7990,780059,19,3,6,2,4,1,2,1,1,1,2,4,5,3,0,0,8
7990,780061,28,2,8,1,1,1,7,1,2,1,4,0,1,1,3,1,6
7990,790944,36,10,21,9,12,1,9,6,9,0,4,2,0,1,0,1,27
7990,790943,7,1,2,1,1,0,1,0,0,0,0,0,2,0,0,0,2
7990,796496,23,2,3,1,2,1,1,3,4,4,5,3,4,1,2,1,8
7990,796494,19,1,5,0,0,1,5,2,2,0,2,0,0,0,0,0,5
7990,786754,29,3,6,0,0,3,6,6,8,0,1,3,4,0,2,0,15
7990,796499,0,0,0,0,0,0,0,0,0,0,0,0,0,0,0,0,0
7990,788853,0,0,0,0,0,0,0,0,0,0,0,0,0,0,0,0,0
7991,792306,33,5,13,4,11,1,2,6,8,4,11,1,3,0,2,1,17
7991,796155,28,1,3,0,0,1,3,0,0,1,5,0,4,1,1,0,3
7991,792300,25,3,6,3,6,0,0,0,0,1,2,5,3,1,5,0,6
7991,792303,31,5,13,3,6,2,7,12,14,0,3,4,3,2,3,0,24
7991,781603,29,7,9,3,4,4,5,0,1,1,1,0,2,1,2,0,18
7991,797914,11,1,3,1,3,0,0,0,0,0,0,1,1,0,0,0,2
7991,797912,6,1,2,1,2,0,0,0,1,1,1,0,1,0,0,0,2
7991,790813,19,2,6,0,2,2,4,0,0,0,2,0,3,0,1,0,6
7991,780456,15,0,2,0,0,0,2,0,0,0,0,0,2,0,1,0,0
7991,781605,3,0,0,0,0,0,0,0,0,0,0,0,0,0,0,0,0
7992,792140,19,1,1,1,1,0,0,0,0,3,3,3,5,0,2,1,2
7992,786596,35,9,17,7,13,2,4,6,7,1,5,1,1,0,3,1,26
7992,797786,32,5,10,2,5,3,5,0,1,1,3,2,2,1,1,0,13
7992,785976,13,0,5,0,2,0,3,0,0,0,1,0,1,0,2,0,0
7992,781429,28,1,6,0,1,1,5,1,3,0,3,1,1,0,1,0,4
7992,797791,5,1,2,1,2,0,0,2,2,0,1,0,1,0,1,0,4
7992,792146,6,0,1,0,1,0,0,0,0,0,0,1,0,0,0,1,0
7992,797793,16,0,2,0,0,0,2,0,0,0,0,0,1,0,0,0,0
7992,792144,11,1,2,1,1,0,1,0,0,2,0,0,0,0,1,0,2
7992,797789,8,1,2,0,1,1,1,0,0,0,0,1,0,0,1,0,3
7992,785975,9,0,1,0,0,0,1,0,0,0,0,0,0,0,0,0,0
7992,781431,16,1,3,1,2,0,1,0,0,0,3,2,2,0,1,1,2
7992,797797,2,0,0,0,0,0,0,0,0,0,0,0,0,0,1,0,0
7993,786054,23,5,6,5,6,0,0,1,3,0,1,4,0,0,0,1,11
7993,791964,25,6,12,4,5,2,7,0,0,0,4,0,2,1,0,0,14
7993,786056,26,3,5,1,2,2,3,0,0,0,7,8,1,1,1,0,8
7993,781339,31,3,8,0,2,3,6,2,2,0,3,1,1,1,0,1,11
7993,781337,26,4,9,2,3,2,6,1,2,0,3,3,4,0,0,0,11
7993,797713,8,1,1,1,1,0,0,0,0,0,3,0,3,0,0,0,2
7993,797712,17,6,8,6,8,0,0,0,0,1,1,0,0,0,0,2,12
7993,799737,7,1,2,1,1,0,1,0,0,0,0,0,1,0,0,0,2
7993,797711,9,2,2,1,1,1,1,0,0,1,0,2,2,0,1,0,5
7993,797710,21,2,4,2,3,0,1,0,0,0,3,5,2,0,1,0,4
7993,791966,3,0,0,0,0,0,0,0,0,0,0,0,0,0,0,0,0
7993,797714,1,0,1,0,1,0,0,0,0,0,0,0,0,0,0,0,0
7993,791963,3,0,0,0,0,0,0,0,0,0,0,0,0,1,1,0,0
7994,792249,33,0,2,0,1,0,1,1,2,1,6,6,2,0,0,4,1
7994,781430,29,6,12,6,10,0,2,2,4,4,10,3,3,1,1,0,14
7994,792248,37,8,19,5,7,3,12,0,0,1,1,2,0,1,1,1,19
7994,781445,39,8,18,7,8,1,10,3,4,0,3,0,2,0,0,0,20
7994,768845,33,4,12,2,8,2,4,3,4,1,9,4,3,1,2,0,13
7994,781448,16,3,7,3,7,0,0,0,1,1,4,0,4,0,2,0,6
7994,797941,6,1,2,1,1,0,1,0,0,0,0,1,0,0,0,1,2
7994,786076,7,0,0,0,0,0,0,0,0,0,0,0,1,0,1,0,0
7994,792253,0,0,0,0,0,0,0,0,0,0,0,0,0,0,0,0,0
7995,786765,38,6,17,4,6,2,11,5,5,1,15,5,1,0,2,2,19
7995,792379,39,2,9,1,3,1,6,0,0,2,5,4,2,2,1,0,5
7995,792380,38,7,15,4,8,3,7,0,0,0,4,3,2,0,2,0,17
7995,781672,27,4,6,4,6,0,0,1,1,2,9,1,4,0,1,2,9
7995,781669,40,6,15,5,11,1,4,4,4,0,2,3,2,3,3,0,17
7995,797860,0,0,0,0,0,0,0,0,0,0,1,0,0,0,0,0,0
7995,797852,18,2,4,2,2,0,2,3,4,1,0,1,4,0,1,0,7
7996,792110,22,2,5,2,5,0,0,3,6,6,2,1,4,4,2,3,7
7996,792109,16,0,2,0,0,0,2,1,2,0,0,1,0,1,1,0,1
7996,797734,33,2,10,1,6,1,4,1,2,0,4,4,1,0,1,0,6
7996,797735,34,8,18,5,9,3,9,1,1,0,5,2,1,1,3,0,20
7996,781386,33,2,11,1,6,1,5,0,0,0,2,2,1,0,1,0,5
7996,786033,16,2,4,2,4,0,0,0,1,4,4,0,1,0,0,2,4
7996,797733,27,3,4,2,2,1,2,0,1,0,1,1,1,0,1,0,7
7996,792107,12,1,4,1,1,0,3,2,2,0,1,1,0,0,0,0,4
7996,789100,4,0,2,0,0,0,2,0,0,0,0,1,0,0,0,0,0
7996,797732,2,0,0,0,0,0,0,0,0,0,0,0,0,0,0,0,0
7996,789099,1,0,0,0,0,0,0,0,0,0,0,0,0,0,0,0,0
7997,785522,18,0,2,0,2,0,0,0,0,0,3,1,1,0,0,2,0
7997,781247,27,3,7,2,4,1,3,0,0,3,1,3,3,1,2,0,7
7997,796947,35,12,18,9,12,3,6,0,0,1,6,2,0,4,0,0,27
7997,791249,31,2,7,1,3,1,4,0,0,0,4,2,3,0,1,0,5
7997,775358,34,8,12,5,8,3,4,1,2,0,8,4,1,1,1,0,20
7997,796949,14,1,6,1,6,0,0,0,0,2,2,0,3,0,3,4,2
7997,785523,8,1,3,1,3,0,0,2,2,1,0,0,1,0,1,1,4
7997,796948,3,1,1,1,1,0,0,0,0,0,0,0,0,0,0,0,2
7997,796946,3,1,3,1,2,0,1,0,0,1,0,0,1,0,0,0,2
7997,796945,2,0,0,0,0,0,0,0,0,0,1,0,0,0,0,0,0
7997,791250,17,2,2,0,0,2,2,0,0,1,2,1,3,0,1,0,6
7997,796944,5,0,0,0,0,0,0,0,0,0,0,0,0,0,0,0,0
7997,791247,3,0,0,0,0,0,0,0,0,0,0,0,0,0,0,0,0
7998,797817,29,2,8,2,7,0,1,6,6,2,6,3,0,5,2,0,10
7998,783072,20,4,5,3,4,1,1,1,3,1,7,0,2,0,2,1,10
7998,781463,30,3,5,3,4,0,1,2,2,1,6,0,2,0,1,1,8
7998,791540,32,5,11,4,7,1,4,0,0,0,2,6,0,0,2,1,11
7998,776068,31,6,11,4,4,2,7,1,1,0,2,4,0,0,0,0,15
7998,785647,6,1,3,1,3,0,0,0,0,0,2,0,0,0,0,0,2
7998,785962,3,1,4,1,4,0,0,0,0,1,1,0,1,0,1,0,2
7998,793057,3,0,1,0,0,0,1,0,0,1,0,0,1,0,1,0,0
7998,792153,16,1,3,0,1,1,2,0,0,0,1,0,2,0,2,0,3
7998,787782,25,5,8,2,3,3,5,0,0,1,2,2,2,0,1,0,13
7998,781202,4,0,0,0,0,0,0,0,0,1,0,0,1,0,0,0,0
7998,797818,1,0,0,0,0,0,0,0,0,0,0,0,0,0,0,0,0
7999,797587,12,1,1,1,1,0,0,0,0,1,1,1,5,0,1,0,2
7999,786501,25,2,8,2,5,0,3,2,2,0,3,0,3,0,3,0,6
7999,781078,22,2,4,1,2,1,2,0,0,0,8,0,2,0,2,0,5
7999,786502,22,2,3,1,1,1,2,0,0,0,0,1,1,0,1,0,5
7999,781080,31,6,12,4,7,2,5,2,2,0,2,2,1,1,0,0,16
7999,797586,8,1,3,1,3,0,0,0,0,0,2,0,2,1,1,0,2
7999,791891,14,1,3,1,2,0,1,0,0,0,3,0,0,1,1,0,2
7999,791894,4,2,3,2,3,0,0,0,1,0,0,0,0,1,0,0,4
7999,797584,30,2,8,2,5,0,3,0,0,1,0,0,1,0,0,0,4
7999,791895,18,1,3,1,3,0,0,2,4,0,2,2,1,0,3,0,4
7999,791892,0,0,0,0,0,0,0,0,1,0,0,0,0,0,0,0,0
7999,797583,1,0,0,0,0,0,0,0,0,0,0,1,0,0,0,0,0
7999,781561,13,1,3,1,3,0,0,0,0,0,2,1,0,1,1,0,2
8000,790810,37,4,12,2,6,2,6,1,3,3,8,1,2,2,0,1,11
8000,785362,35,7,10,7,10,0,0,3,3,3,6,2,2,0,0,0,17
8000,790808,36,3,13,1,3,2,10,2,2,3,5,2,2,0,0,2,10
8000,785361,29,4,11,1,3,3,8,3,4,1,1,2,4,1,1,0,14
8000,779997,27,5,8,5,6,0,2,0,1,1,1,5,3,0,3,0,10
8000,774854,5,0,0,0,0,0,0,0,0,0,0,0,2,0,1,1,0
8000,796370,17,2,8,1,6,1,2,0,0,1,1,1,2,0,1,0,5
8000,790809,14,0,1,0,1,0,0,0,0,1,2,4,1,0,0,0,0
8001,780323,24,5,10,5,9,0,1,2,3,4,4,0,4,0,0,1,12
8001,797894,25,4,6,4,6,0,0,2,4,4,3,0,3,0,2,0,10
8001,792229,33,4,10,3,6,1,4,3,6,0,9,2,3,0,0,1,12
8001,785954,31,1,4,0,2,1,2,0,0,0,2,2,0,1,1,0,3
8001,785811,32,4,15,2,8,2,7,1,2,0,4,4,1,0,2,0,11
8001,792233,15,2,3,1,1,1,2,0,0,0,1,2,1,0,2,0,5
8001,792234,12,0,3,0,2,0,1,2,2,0,2,0,1,0,0,1,2
8001,792230,9,0,0,0,0,0,0,0,0,0,1,0,0,0,0,0,0
8001,786016,12,1,1,1,1,0,0,2,2,1,1,1,1,1,2,0,4
8001,797891,4,1,1,1,1,0,0,0,0,0,0,0,0,0,0,0,2
8001,781356,3,0,0,0,0,0,0,0,0,0,0,0,0,0,0,0,0
8002,792181,37,3,11,2,9,1,2,2,2,5,9,1,1,0,2,1,9
8002,780986,37,6,10,6,10,0,0,6,6,2,4,4,2,0,2,0,18
8002,785902,24,2,6,1,2,1,4,0,0,0,4,1,3,1,1,2,5
8002,792179,22,2,6,1,4,1,2,0,0,0,1,3,0,2,1,0,5
8002,786662,36,10,19,4,9,6,10,3,3,0,1,1,2,3,0,0,29
8002,797796,25,3,6,3,6,0,0,0,0,1,1,1,1,3,1,0,6
8002,786661,16,1,4,0,0,1,4,0,0,2,3,1,2,0,0,0,3
8002,792176,3,0,0,0,0,0,0,0,0,0,0,0,0,0,0,1,0
8003,785423,34,4,7,2,3,2,4,1,2,3,9,3,1,1,0,0,11
8003,775676,22,5,8,5,8,0,0,0,0,0,2,3,3,1,1,3,10
8003,786210,34,6,10,1,2,5,8,0,0,1,2,3,2,0,2,0,17
8003,785425,37,6,14,5,9,1,5,0,0,1,4,2,2,0,1,0,13
8003,785422,40,3,12,1,1,2,11,0,0,0,3,10,0,0,3,0,8
8003,786298,15,2,6,0,3,2,3,0,0,0,2,0,1,0,3,0,6
8003,774957,18,0,1,0,1,0,0,2,2,2,2,1,4,0,0,0,2
8004,781272,36,4,9,3,7,1,2,0,3,1,4,2,3,0,2,0,9
8004,796958,40,3,6,3,5,0,1,8,10,0,9,0,3,1,0,1,14
8004,791261,38,6,10,6,8,0,2,3,3,1,2,1,0,2,2,0,15
8004,785501,42,4,10,2,4,2,6,2,4,0,6,4,3,3,0,0,12
8004,781270,41,10,17,8,12,2,5,2,2,0,2,1,0,0,2,0,24
8004,796960,17,1,1,1,1,0,0,0,0,0,1,0,4,1,2,0,2
8004,796959,2,0,0,0,0,0,0,0,0,0,0,0,1,0,1,0,0
8004,791258,9,0,1,0,1,0,0,0,0,0,1,0,1,0,0,0,0
8005,785740,15,3,5,3,5,0,0,0,0,1,3,0,5,0,2,0,6
8005,785809,23,4,6,2,2,2,4,1,2,0,6,1,4,1,3,0,11
8005,780530,44,5,10,4,9,1,1,0,3,4,3,3,3,0,3,0,11
8005,797402,37,3,13,0,4,3,9,0,0,1,2,3,2,1,2,0,9
8005,785738,45,4,17,1,10,3,7,0,1,1,3,7,1,1,2,0,11
8005,797396,27,3,5,3,5,0,0,2,2,6,4,0,2,1,1,0,8
8005,786144,34,6,13,3,5,3,8,0,0,2,3,1,2,1,0,0,15
8006,797281,25,8,14,8,14,0,0,4,4,3,6,2,3,1,1,1,20
8006,791648,26,3,4,2,2,1,2,0,0,0,6,0,5,0,0,1,7
8006,785694,17,2,4,2,4,0,0,3,4,3,1,0,5,0,1,3,7
8006,797280,27,1,4,1,4,0,0,2,2,0,0,2,1,1,1,0,4
8006,797279,35,6,13,3,7,3,6,1,1,1,2,0,2,0,0,0,16
8006,791647,7,1,4,1,3,0,1,0,1,0,1,0,1,0,1,1,2
8006,797278,1,0,0,0,0,0,0,0,0,0,0,0,1,0,1,0,0
8006,791649,14,0,1,0,0,0,1,0,0,0,2,0,2,0,0,0,0
8006,786640,30,2,8,2,6,0,2,8,10,0,3,10,0,1,2,0,12
8006,785697,12,2,3,0,0,2,3,2,2,0,2,0,3,0,2,0,8
8006,785695,6,0,2,0,1,0,1,0,0,0,0,1,0,0,0,0,0
8007,781244,21,6,11,6,10,0,1,2,2,1,1,1,3,3,2,0,14
8007,791243,22,1,4,1,4,0,0,2,2,1,3,5,1,0,1,1,4
8007,791241,18,2,2,2,2,0,0,0,0,1,4,1,3,0,0,0,4
8007,785537,31,7,10,5,7,2,3,4,5,0,3,2,0,1,2,0,20
8007,781243,31,8,14,4,9,4,5,8,9,3,7,2,1,2,1,2,28
8007,796943,5,1,2,1,2,0,0,2,2,0,1,0,2,0,0,0,4
8007,796940,13,1,5,1,3,0,2,0,0,0,2,0,3,0,0,0,2
8007,791245,17,2,5,2,4,0,1,3,4,1,2,1,1,0,0,0,7
8007,791246,9,0,4,0,3,0,1,0,0,0,0,1,4,0,0,0,0
8007,785529,7,0,1,0,0,0,1,0,0,0,1,0,0,0,0,0,0
8007,781237,19,1,1,0,0,1,1,0,0,0,1,2,2,0,0,0,3
8007,776205,7,0,1,0,0,0,1,4,4,0,0,0,2,0,0,0,4
8008,796585,15,0,2,0,2,0,0,3,4,1,3,0,2,1,0,3,3
8008,780192,24,4,6,2,4,2,2,1,2,2,2,1,4,0,5,2,11
8008,798139,27,2,7,0,4,2,3,4,4,0,2,2,1,1,2,0,10
8008,786818,33,4,8,3,6,1,2,4,7,1,4,1,4,2,1,0,13
8008,780182,33,2,9,2,5,0,4,8,10,1,5,1,2,2,2,0,12
8008,780186,24,3,5,3,5,0,0,0,2,1,6,1,0,1,1,0,6
8008,798138,16,2,5,1,1,1,4,0,0,0,0,0,3,0,0,0,5
8008,786820,13,1,2,1,2,0,0,0,0,0,1,2,1,0,0,1,2
8008,780184,15,3,5,2,4,1,1,0,0,1,2,2,0,0,0,0,7
8009,786459,32,2,8,2,8,0,0,0,0,1,7,3,2,0,2,3,4
8009,781612,29,7,15,4,9,3,6,2,3,2,3,0,4,2,1,2,19
8009,797004,33,3,10,3,8,0,2,2,2,2,2,2,1,1,4,0,8
8009,791360,34,3,9,1,3,2,6,1,2,2,3,2,3,0,1,1,9
8009,781609,36,6,12,5,8,1,4,7,8,6,4,0,3,0,3,0,20
8009,797005,15,1,4,0,1,1,3,0,0,0,1,2,3,0,2,0,3
8009,797008,5,0,0,0,0,0,0,0,0,0,1,0,1,0,0,0,0
8009,797006,8,1,2,1,1,0,1,0,0,0,0,0,3,0,1,0,2
8009,797003,8,0,3,0,2,0,1,0,0,0,0,0,0,0,1,0,0
8010,796469,24,0,4,0,0,0,4,0,0,0,8,0,4,1,0,1,0
8010,779981,24,7,9,7,9,0,0,0,1,4,1,1,3,0,2,1,14
8010,785463,28,9,13,2,5,7,8,3,4,0,1,3,5,1,3,0,28
8010,779978,38,8,9,4,4,4,5,0,1,0,3,7,3,1,1,0,20
8010,776003,35,4,16,3,9,1,7,0,0,2,6,3,1,2,6,0,9
8010,790923,25,1,3,0,2,1,1,1,2,1,1,2,2,2,3,2,4
8010,785466,6,0,1,0,1,0,0,0,0,1,1,1,3,0,0,0,0
8010,779980,12,2,3,2,3,0,0,0,2,0,2,0,2,0,1,0,4
8010,779979,8,1,1,0,0,1,1,0,0,0,0,0,2,0,0,0,3
8011,791980,21,2,2,0,0,2,2,0,0,0,1,0,4,0,1,0,6
8011,785972,28,4,8,3,6,1,2,5,8,2,5,1,0,1,0,0,14
8011,785967,25,4,9,4,9,0,0,6,11,3,2,0,3,0,1,0,14
8011,791977,21,5,7,2,2,3,5,3,3,0,3,1,3,1,3,0,16
8011,791978,37,5,12,3,8,2,4,5,6,2,1,4,1,1,2,0,17
8011,791976,30,3,13,1,5,2,8,6,6,0,4,1,0,0,1,0,14
8011,780160,17,1,1,1,1,0,0,1,3,3,2,0,1,3,0,0,3
8011,797803,2,0,1,0,1,0,0,0,0,0,1,0,0,0,0,0,0
8011,785973,12,0,1,0,1,0,0,0,0,0,1,0,0,1,1,0,0
8011,797801,2,0,0,0,0,0,0,0,0,0,0,0,2,0,0,0,0
8011,797800,5,0,0,0,0,0,0,0,0,0,0,1,1,0,0,0,0
8012,790794,18,0,0,0,0,0,0,0,0,0,1,0,2,0,0,0,0
8012,780281,24,3,7,3,6,0,1,0,3,3,6,1,1,1,0,2,6
8012,790793,30,4,7,3,5,1,2,4,4,0,3,3,2,3,2,0,13
8012,785246,28,3,10,0,0,3,10,0,0,0,4,0,2,1,2,0,9
8012,780886,22,2,4,0,0,2,4,7,8,0,5,2,4,0,5,0,13
8012,796350,6,0,5,0,3,0,2,0,0,1,0,0,1,0,0,0,0
8012,785368,25,5,5,5,5,0,0,4,5,1,6,1,2,0,4,3,14
8012,790789,18,4,5,4,4,0,1,3,3,0,2,1,1,0,2,0,11
8012,790792,27,1,6,1,3,0,3,2,2,0,4,1,1,1,4,2,4
8012,790790,2,0,0,0,0,0,0,0,0,0,0,0,0,0,0,0,0
8013,791302,20,3,8,2,5,1,3,0,0,0,5,1,5,0,4,1,7
8013,781622,35,0,5,0,2,0,3,1,2,3,2,0,2,1,0,0,1
8013,791309,38,9,17,8,13,1,4,8,9,0,4,4,2,5,1,0,27
8013,785835,27,6,8,5,6,1,2,1,3,2,4,0,2,2,1,0,14
8013,776334,29,1,10,1,7,0,3,0,0,0,2,0,4,2,4,0,2
8013,791304,14,2,2,2,2,0,0,0,0,1,0,1,2,0,1,0,4
8013,796602,7,0,1,0,0,0,1,0,0,0,0,0,2,0,0,0,0
8013,796604,2,0,0,0,0,0,0,0,0,1,0,0,1,0,1,0,0
8013,796601,22,3,11,2,7,1,4,1,2,1,3,3,2,2,0,0,8
8013,775862,6,0,2,0,2,0,0,0,0,0,1,0,1,0,0,0,0
8014,791316,33,6,7,6,6,0,1,4,4,1,4,0,2,1,2,0,16
8014,780870,31,2,5,2,5,0,0,1,3,1,5,1,3,1,0,2,5
8014,781079,32,4,11,2,4,2,7,3,4,0,3,9,0,1,3,1,13
8014,781443,36,4,10,1,5,3,5,1,2,2,4,3,3,2,0,0,12
8014,775822,35,6,14,3,5,3,9,1,2,0,5,2,1,2,4,0,16
8014,796625,8,0,2,0,0,0,2,0,0,0,0,0,1,1,1,0,0
8014,796621,8,0,2,0,2,0,0,1,2,0,1,0,0,0,0,0,1
8014,791314,5,0,0,0,0,0,0,0,0,0,0,0,0,0,0,0,0
8014,785380,12,1,3,1,1,0,2,0,0,1,0,0,3,0,3,0,2
8015,792265,37,5,14,3,9,2,5,1,1,2,6,2,3,2,2,0,13
8015,792266,19,2,4,1,1,1,3,0,0,0,1,0,2,1,5,1,5
8015,786152,21,1,6,1,5,0,1,0,0,1,3,1,3,0,2,1,2
8015,798003,14,0,3,0,3,0,0,1,2,0,1,1,1,0,5,0,1
8015,798009,35,4,11,2,6,2,5,5,7,0,5,1,3,1,4,0,15
8015,798007,12,0,0,0,0,0,0,0,0,0,0,0,1,0,0,0,0
8015,798005,10,4,4,4,4,0,0,0,0,2,2,0,1,0,0,0,8
8015,792267,30,1,5,0,2,1,3,0,0,1,6,1,3,0,2,0,3
8015,792263,22,3,5,3,3,0,2,0,0,0,3,4,1,0,2,0,6
8016,791023,28,6,8,6,8,0,0,2,4,0,5,0,3,0,0,0,14
8016,796685,30,3,9,0,1,3,8,0,0,0,3,1,0,2,3,0,9
8016,791027,36,3,10,3,9,0,1,0,0,1,5,1,1,2,2,0,6
8016,791024,39,6,13,4,8,2,5,2,2,0,3,4,2,1,2,0,16
8016,777572,33,2,6,2,6,0,0,2,3,3,5,4,2,2,5,0,6
8016,791028,18,4,7,3,5,1,2,0,0,1,0,1,1,0,1,0,9
8016,796684,6,0,0,0,0,0,0,0,0,0,2,3,2,1,0,0,0
8016,781507,10,0,1,0,0,0,1,0,0,0,1,1,1,0,2,0,0
8017,792593,32,4,12,4,12,0,0,1,4,8,5,2,3,1,4,3,9
8017,792594,38,7,14,4,9,3,5,0,2,0,7,0,2,1,1,1,17
8017,792588,28,3,10,0,0,3,10,2,3,0,2,1,0,2,0,0,11
8017,792595,38,5,12,5,7,0,5,1,2,2,1,6,4,4,5,0,11
8017,792583,32,1,6,0,1,1,5,0,0,1,2,1,0,0,0,0,3
8017,792580,10,0,0,0,0,0,0,0,0,0,2,0,1,0,0,1,0
8017,796987,14,3,7,3,4,0,3,1,1,0,3,1,1,1,1,0,7
8017,792591,8,0,2,0,0,0,2,0,0,0,0,0,0,0,0,0,0
8018,781134,28,2,9,1,7,1,2,2,4,1,6,0,2,1,1,0,7
8018,774874,38,2,7,2,6,0,1,9,11,3,5,5,2,0,3,0,13
8018,796531,22,0,5,0,4,0,1,0,0,1,5,0,1,0,1,0,0
8018,786475,27,3,9,1,5,2,4,0,0,0,3,1,3,0,3,1,8
8018,785270,34,3,16,2,7,1,9,0,0,0,2,1,4,1,2,0,7
8018,780085,9,0,1,0,1,0,0,0,0,0,1,0,1,0,1,0,0
8018,786037,6,1,1,1,1,0,0,0,0,1,0,0,1,0,0,0,2
8018,780084,8,1,2,1,1,0,1,0,0,0,1,0,0,0,0,0,2
8018,775468,25,2,3,2,3,0,0,0,0,1,1,2,0,0,0,0,4
8018,776038,3,0,1,0,1,0,0,0,0,0,0,0,0,0,1,0,0
8019,786658,2,0,0,0,0,0,0,0,0,0,0,0,0,0,0,0,0
8019,797784,37,5,9,2,3,3,6,1,2,1,2,4,2,1,1,0,14
8019,792173,26,4,9,2,3,2,6,2,2,0,5,0,3,2,0,1,12
8019,789059,33,5,12,3,5,2,7,1,2,3,9,0,0,2,2,0,13
8019,780980,22,1,2,1,2,0,0,0,0,0,3,1,2,0,2,0,2
8019,797782,18,2,6,1,5,1,1,0,0,0,4,2,4,2,1,0,5
8019,797783,12,1,3,1,3,0,0,0,0,0,0,0,1,0,1,1,2
8019,785674,28,4,10,3,5,1,5,0,0,1,4,2,2,1,1,2,9
8019,792174,12,0,2,0,1,0,1,2,2,0,2,1,1,1,0,2,2
8019,780527,10,0,3,0,2,0,1,0,0,0,0,1,2,1,0,0,0
8020,791876,40,7,17,7,15,0,2,7,9,3,7,2,1,1,1,0,21
8020,791877,23,3,7,3,7,0,0,2,2,1,2,0,4,2,0,1,8
8020,785667,32,3,13,2,8,1,5,0,0,0,2,2,3,2,1,0,7
8020,786570,32,6,13,5,9,1,4,2,3,0,4,3,4,1,3,1,15
8020,780436,36,4,13,2,7,2,6,2,4,3,4,2,2,0,2,0,12
8020,781205,12,0,0,0,0,0,0,1,2,3,0,0,3,0,0,0,1
8020,797491,2,0,0,0,0,0,0,0,0,0,0,0,1,0,0,0,0
8020,797486,23,3,5,3,5,0,0,2,2,1,2,3,2,0,1,0,8
8021,780598,24,3,4,3,3,0,1,6,7,2,7,0,2,0,0,0,12
8021,781300,29,6,12,6,12,0,0,4,5,3,5,0,3,2,4,1,16
8021,781305,13,2,4,0,0,2,4,0,0,0,3,3,0,0,0,0,6
8021,790801,22,1,4,1,3,0,1,10,12,0,3,2,2,0,1,0,12
8021,781304,28,0,5,0,3,0,2,0,0,0,3,1,1,0,1,0,0
8021,796360,26,4,13,4,12,0,1,3,3,4,2,3,3,0,3,3,11
8021,790803,15,4,6,4,6,0,0,0,1,1,2,1,4,0,0,1,8
8021,781302,20,2,4,1,1,1,3,0,1,1,1,4,0,0,2,1,5
8021,796363,14,2,3,1,1,1,2,0,0,0,3,0,1,1,0,0,5
8021,796364,9,2,3,2,3,0,0,0,0,0,2,0,1,0,0,0,4
8022,792288,29,1,4,1,4,0,0,0,0,1,4,1,1,0,0,0,2
8022,785227,21,1,6,1,6,0,0,0,0,3,5,0,5,0,2,1,2
8022,786237,25,1,3,1,3,0,0,0,0,0,1,0,1,1,6,0,2
8022,780287,28,7,17,6,12,1,5,0,0,1,0,2,1,1,0,0,15
8022,776309,34,9,17,7,13,2,4,8,14,1,4,1,4,3,2,0,28
8022,798072,3,0,0,0,0,0,0,0,0,0,0,0,0,0,0,0,0
8022,798067,17,1,1,1,1,0,0,0,0,2,2,0,1,0,1,0,2
8022,792278,12,0,5,0,2,0,3,0,0,1,1,1,1,1,1,0,0
8022,786232,31,2,7,1,4,1,3,2,3,0,3,3,3,0,3,0,7
8023,786542,18,2,3,2,3,0,0,2,2,3,2,0,4,0,4,0,6
8023,786540,27,2,7,2,7,0,0,2,4,1,9,1,3,2,3,3,6
8023,792019,35,3,10,1,4,2,6,0,0,0,4,1,2,2,0,0,8
8023,792015,29,2,10,2,8,0,2,7,8,2,2,5,2,1,3,1,11
8023,775995,39,6,8,3,5,3,3,1,1,1,4,1,3,2,2,2,16
8023,785364,14,0,6,0,6,0,0,0,0,3,3,0,0,0,0,0,0
8023,792016,13,2,2,1,1,1,1,4,4,0,0,0,2,3,2,0,9
8023,791845,25,3,5,2,2,1,3,2,2,0,4,0,2,0,1,0,9
8024,797482,27,3,12,3,10,0,2,0,0,0,3,0,0,0,4,0,6
8024,797485,31,1,2,0,1,1,1,7,8,0,4,1,1,0,3,0,10
8024,797480,28,4,8,1,3,3,5,0,0,1,2,1,2,2,1,4,11
8024,791875,20,1,4,1,4,0,0,1,2,0,1,1,2,0,0,0,3
8024,781217,13,0,2,0,0,0,2,0,0,0,3,0,1,0,0,0,0
8024,797483,9,0,0,0,0,0,0,0,0,1,1,1,0,0,1,0,0
8024,797481,23,2,7,1,4,1,3,2,2,0,0,2,4,0,1,0,7
8024,797479,20,3,6,0,1,3,5,3,3,0,1,1,0,0,2,0,12
8024,797478,8,2,5,2,3,0,2,1,2,0,0,0,1,0,1,0,5
8024,791873,14,2,5,2,3,0,2,0,0,0,1,2,1,0,0,0,4
8024,786574,7,0,0,0,0,0,0,0,0,0,1,0,1,0,0,0,0
8024,786579,0,0,0,0,0,0,0,0,0,0,0,0,0,0,0,0,0
8025,786550,29,6,10,4,4,2,6,0,0,0,7,3,1,1,1,0,14
8025,776054,29,2,3,1,1,1,2,0,0,0,3,1,2,1,1,0,5
8025,792007,22,6,8,5,7,1,1,0,0,3,4,1,4,0,4,0,13
8025,792009,33,5,12,5,10,0,2,3,4,2,3,5,3,1,2,3,13
8025,792006,35,7,13,7,13,0,0,2,2,0,3,7,4,2,1,0,16
8025,792010,2,0,0,0,0,0,0,0,0,0,0,0,0,0,1,0,0
8025,792008,5,1,1,1,1,0,0,1,2,0,3,0,1,0,1,0,3
8025,797506,18,4,9,0,2,4,7,2,2,0,5,1,3,0,2,0,14
8025,786552,27,1,3,1,1,0,2,0,0,0,4,5,3,0,0,1,2
8026,792032,40,13,23,5,12,8,11,3,3,1,4,2,1,2,2,0,37
8026,761149,36,8,13,5,9,3,4,3,3,2,5,0,1,3,0,1,22
8026,780828,28,5,13,4,9,1,4,0,0,1,4,5,2,0,5,0,11
8026,792029,25,2,7,2,6,0,1,0,0,0,5,0,1,0,1,0,4
8026,792031,28,1,4,1,4,0,0,0,0,1,3,5,4,1,2,0,2
8026,797636,18,3,3,3,3,0,0,0,0,1,0,1,1,1,2,0,6
8026,792030,8,1,2,1,2,0,0,0,0,0,0,2,2,1,0,0,2
8026,785822,8,0,0,0,0,0,0,2,2,2,0,0,0,0,0,0,2
8026,797640,5,0,0,0,0,0,0,0,0,0,0,0,0,0,0,0,0
8026,797641,4,0,0,0,0,0,0,0,0,0,0,0,0,0,1,0,0
8027,792012,40,13,18,6,9,7,9,3,3,0,2,1,2,0,5,0,36
8027,786544,39,5,13,3,8,2,5,2,3,1,7,1,2,0,3,0,14
8027,786546,31,5,10,3,5,2,5,2,2,2,3,2,3,3,3,1,14
8027,786860,14,3,5,1,1,2,4,0,0,0,2,0,2,0,0,0,8
8027,797507,22,2,7,2,3,0,4,2,2,0,4,0,0,1,1,0,6
8027,792013,10,2,2,2,2,0,0,0,0,0,0,1,4,1,0,0,4
8027,786547,25,1,3,1,1,0,2,0,0,0,4,1,1,1,1,1,2
8027,797510,18,0,2,0,0,0,2,0,0,0,0,0,1,0,0,0,0
8027,797509,1,0,0,0,0,0,0,0,0,0,0,0,0,0,0,0,0
8028,785800,25,0,4,0,3,0,1,0,0,1,2,0,1,0,1,0,0
8028,785799,18,6,7,6,7,0,0,3,3,5,2,0,3,0,1,0,15
8028,791676,24,4,10,1,2,3,8,0,0,0,0,0,1,0,0,1,11
8028,780554,31,4,10,4,6,0,4,0,0,1,3,0,1,1,1,0,8
8028,780553,34,6,16,6,15,0,1,0,1,2,9,6,1,1,1,0,12
8028,797426,4,0,1,0,0,0,1,1,2,1,0,0,0,0,0,0,1
8028,791679,4,0,2,0,2,0,0,0,0,0,1,0,0,0,0,0,0
8028,785807,13,0,2,0,0,0,2,0,0,0,1,1,0,0,0,0,0
8028,780760,17,3,7,2,2,1,5,2,2,1,3,0,0,0,0,2,9
8028,797427,10,0,0,0,0,0,0,0,0,0,1,0,0,0,0,0,0
8028,791677,18,2,4,2,3,0,1,0,0,1,3,2,1,2,1,0,4
8028,791678,2,0,0,0,0,0,0,0,0,0,0,0,0,0,0,0,0
8029,786646,30,4,9,1,3,3,6,2,2,1,5,0,1,0,0,0,13
8029,780890,22,0,5,0,1,0,4,4,4,1,2,1,1,0,1,0,4
8029,786066,35,7,11,5,7,2,4,0,0,1,7,3,2,0,2,1,16
8029,780167,33,1,5,1,3,0,2,0,0,1,1,2,1,2,2,0,2
8029,775574,36,4,14,1,5,3,9,0,0,1,2,1,2,0,3,0,11
8029,775757,6,0,0,0,0,0,0,0,0,0,0,0,0,0,0,1,0
8029,791123,9,1,5,0,2,1,3,0,0,0,3,1,1,0,0,0,3
8029,785636,29,2,5,0,2,2,3,0,0,2,5,2,1,0,0,0,6
8030,792164,36,9,15,5,10,4,5,5,8,2,6,6,3,1,2,0,27
8030,791372,37,1,11,0,3,1,8,1,2,1,3,0,3,3,3,0,4
8030,797767,25,4,7,1,3,3,4,0,0,0,1,3,5,0,1,0,11
8030,780974,32,6,10,5,7,1,3,3,3,2,5,1,2,0,2,0,16
8030,792167,5,1,1,1,1,0,0,2,4,0,0,0,3,0,0,0,4
8030,797777,26,4,6,4,6,0,0,1,1,1,1,2,3,2,1,3,9
8030,792163,19,2,3,0,0,2,3,1,2,0,3,0,2,0,0,0,7
8030,797772,12,1,2,1,1,0,1,0,0,0,1,2,0,0,3,0,2
8030,797766,8,1,3,1,1,0,2,0,0,0,1,0,1,0,0,1,2
8031,786216,35,10,14,10,14,0,0,13,14,3,4,3,3,0,4,1,33
8031,780663,35,5,12,4,7,1,5,5,5,0,4,1,2,3,6,0,16
8031,786218,33,5,11,4,6,1,5,1,2,1,2,4,4,0,0,0,12
8031,786080,31,4,7,1,3,3,4,0,0,0,3,1,4,1,1,0,11
8031,791348,34,2,6,2,5,0,1,3,4,2,6,6,3,2,2,0,7
8031,791350,22,1,3,0,1,1,2,2,4,0,3,2,1,0,0,0,5
8031,781645,5,1,1,1,1,0,0,0,0,0,0,0,0,0,0,0,2
8031,797258,3,0,0,0,0,0,0,0,0,0,1,0,0,0,0,0,0
8031,780150,2,0,0,0,0,0,0,0,0,0,0,0,0,0,0,0,0
8032,797556,36,7,13,4,7,3,6,4,5,1,0,0,4,1,0,0,21
8032,791913,37,7,12,7,11,0,1,2,2,0,3,6,3,1,0,0,16
8032,786519,33,5,7,5,7,0,0,0,0,4,9,1,2,1,0,1,10
8032,786520,33,3,11,2,9,1,2,2,2,0,10,1,2,1,3,0,9
8032,791911,19,2,7,0,0,2,7,0,0,0,1,0,2,0,0,0,6
8032,797558,21,3,8,2,4,1,4,0,0,1,0,1,3,0,3,0,7
8032,797560,7,1,2,1,2,0,0,0,0,0,0,0,2,0,1,1,2
8032,797555,11,0,3,0,2,0,1,0,0,1,0,0,2,0,2,0,0
8032,797559,3,0,0,0,0,0,0,0,0,0,0,0,1,0,0,0,0
8033,786059,33,7,13,5,10,2,3,5,8,4,5,2,2,1,2,1,21
8033,791958,37,6,10,5,7,1,3,5,6,2,4,1,2,2,2,0,18
8033,776174,31,7,14,7,14,0,0,4,5,5,6,0,3,1,1,2,18
8033,785861,36,4,13,2,8,2,5,0,0,2,6,3,3,0,0,1,10
8033,791960,36,2,9,1,2,1,7,2,2,0,2,4,1,1,2,0,7
8033,781332,17,1,2,0,0,1,2,0,0,0,2,1,1,0,4,0,3
8033,797704,10,0,1,0,0,0,1,0,0,1,0,0,0,0,0,0,0
8034,782133,10,2,6,2,3,0,3,1,1,1,5,2,2,1,1,0,5
8034,785123,22,7,13,7,13,0,0,5,7,1,3,0,1,0,0,0,19
8034,790990,26,5,10,4,4,1,6,0,0,2,5,2,3,1,2,1,11
8034,789219,25,3,6,1,1,2,5,0,0,0,6,2,0,0,0,0,8
8034,785059,29,4,6,4,5,0,1,0,1,3,7,8,1,0,0,1,8
8034,796624,10,2,2,2,2,0,0,0,0,1,0,0,1,0,0,0,4
8034,790989,11,2,4,2,3,0,1,1,2,1,3,0,2,1,2,0,5
8034,785305,5,0,1,0,0,0,1,2,2,0,0,0,1,0,0,0,2
8034,796622,8,1,2,1,2,0,0,2,2,2,1,1,0,0,0,0,4
8034,796623,18,5,9,4,5,1,4,4,5,0,1,2,2,0,1,0,15
8034,790988,11,0,3,0,1,0,2,0,0,1,1,1,2,2,3,0,0
8034,785303,10,1,4,0,2,1,2,0,0,1,0,0,0,0,1,0,3
8034,785122,15,2,3,0,0,2,3,0,0,0,0,3,0,1,0,0,6
8035,797824,17,2,7,1,5,1,2,0,0,2,4,1,2,0,1,0,5
8035,775116,29,1,8,1,3,0,5,1,2,2,5,0,3,0,0,1,3
8035,797822,28,7,16,6,13,1,3,3,4,2,5,0,3,0,2,0,18
8035,792190,36,6,13,5,10,1,3,0,0,1,2,3,2,2,2,0,13
8035,791928,17,1,3,1,2,0,1,0,0,0,2,1,1,0,2,0,2
8035,797828,2,0,0,0,0,0,0,0,0,0,0,0,1,0,0,0,0
8035,792192,8,2,6,2,6,0,0,0,0,1,2,0,0,0,0,1,4
8035,797825,7,2,5,2,5,0,0,1,1,1,0,0,1,0,0,0,5
8035,792191,23,2,3,2,2,0,1,3,4,0,2,2,0,2,1,0,7
8035,786664,32,3,8,2,4,1,4,2,3,0,2,1,1,0,2,0,9
8035,781266,1,0,0,0,0,0,0,0,0,0,0,0,0,0,0,0,0
8036,791306,33,4,8,3,4,1,4,5,6,4,6,0,2,0,1,2,14
8036,780210,38,9,20,7,13,2,7,5,5,7,4,0,2,2,3,1,25
8036,796594,14,2,5,1,1,1,4,0,1,0,0,1,2,2,3,0,5
8036,792432,32,3,10,2,5,1,5,0,0,1,0,1,4,0,2,0,7
8036,775005,28,3,8,1,3,2,5,3,3,0,0,1,0,0,0,0,11
8036,796592,9,1,1,1,1,0,0,2,2,1,0,1,1,0,1,0,4
8036,792427,19,0,5,0,2,0,3,0,0,0,2,2,2,1,2,0,0
8036,792433,19,1,2,0,1,1,1,0,0,0,0,0,4,1,0,0,3
8036,786422,8,0,1,0,1,0,0,0,0,0,0,2,1,0,0,0,0
8037,791225,39,5,6,4,5,1,1,4,4,1,10,1,3,2,1,1,15
8037,775324,14,3,4,3,4,0,0,1,2,0,0,0,1,0,3,1,7
8037,791224,31,4,10,3,7,1,3,3,6,3,3,5,3,3,6,1,12
8037,785571,33,3,13,3,11,0,2,0,0,0,2,5,2,2,2,0,6
8037,781181,35,5,6,0,1,5,5,7,8,3,2,1,1,0,1,0,22
8037,796927,3,0,0,0,0,0,0,0,0,0,0,0,1,0,1,0,0
8037,796929,14,2,3,0,0,2,3,0,0,0,2,1,0,0,1,0,6
8037,791223,22,4,5,4,5,0,0,0,2,2,3,2,3,2,1,0,8
8037,791222,9,0,0,0,0,0,0,0,0,0,1,1,1,0,2,0,0
8038,786792,29,1,2,1,2,0,0,0,0,6,2,0,1,1,0,1,2
8038,792414,28,8,11,3,3,5,8,1,1,1,5,0,4,0,1,2,22
8038,789020,37,7,14,5,9,2,5,0,0,0,3,3,1,2,3,0,16
8038,786787,40,8,20,3,6,5,14,8,8,0,3,8,2,1,2,0,29
8038,774954,38,3,6,3,6,0,0,1,2,2,7,3,1,3,1,0,7
8038,786795,4,1,1,1,1,0,0,0,0,0,0,0,0,0,0,0,2
8038,792091,6,0,2,0,1,0,1,0,0,0,0,1,0,0,0,0,0
8038,781456,18,1,1,1,1,0,0,0,0,0,2,1,2,0,0,0,2
8039,785481,30,5,10,5,9,0,1,0,0,3,1,3,0,2,1,0,10
8039,780631,29,7,13,4,9,3,4,1,2,2,5,2,3,0,1,0,18
8039,797391,19,3,4,1,1,2,3,0,0,0,3,1,2,2,0,0,8
8039,786625,38,3,8,2,3,1,5,0,0,2,4,3,2,1,3,0,7
8039,780625,34,1,6,1,1,0,5,0,0,0,3,3,1,0,4,0,2
8039,797397,8,1,2,1,2,0,0,3,4,0,0,0,0,0,0,0,5
8039,797395,12,3,4,2,2,1,2,0,0,0,0,0,0,0,2,0,7
8039,797394,17,1,5,0,2,1,3,1,4,1,2,1,2,0,0,1,4
8039,786630,13,0,1,0,1,0,0,0,0,1,0,0,3,0,0,0,0
8040,780874,23,1,7,1,4,0,3,2,2,2,4,0,0,0,1,1,4
8040,781326,27,4,6,4,6,0,0,1,2,2,7,2,3,1,2,5,9
8040,797870,32,3,13,3,9,0,4,7,7,1,1,1,1,1,1,0,13
8040,792210,21,1,5,0,2,1,3,2,2,0,2,0,4,2,3,0,5
8040,781323,36,3,11,2,7,1,4,7,8,1,3,2,1,1,2,0,14
8040,797868,13,0,0,0,0,0,0,0,0,0,0,1,1,0,0,0,0
8040,785638,15,1,3,0,0,1,3,0,0,0,4,0,0,0,1,0,3
8040,792215,16,1,1,0,0,1,1,0,0,1,0,0,0,2,3,0,3
8040,792213,4,0,0,0,0,0,0,1,2,0,0,0,1,0,0,0,1
8040,785430,13,1,1,1,1,0,0,0,0,1,1,0,1,0,0,0,2
8041,796372,13,4,7,4,7,0,0,2,2,1,1,1,4,0,0,0,10
8041,790814,29,2,4,2,3,0,1,0,0,1,4,0,1,1,2,0,4
8041,796377,36,3,7,2,5,1,2,2,2,0,5,2,3,2,1,0,9
8041,796379,39,4,15,2,9,2,6,2,2,0,3,5,1,1,1,0,12
8041,780176,37,6,14,4,9,2,5,2,2,2,7,5,3,0,4,0,16
8041,786013,19,3,4,3,4,0,0,1,5,2,2,0,4,0,1,0,7
8041,790815,20,1,5,1,5,0,0,2,2,1,1,1,2,0,1,0,4
8041,796374,5,0,0,0,0,0,0,0,0,0,2,0,0,1,0,0,0
8041,796376,2,0,1,0,1,0,0,0,0,0,0,0,0,0,0,0,0
8042,786857,32,6,12,3,8,3,4,1,2,1,2,1,4,1,4,0,16
8042,781403,34,8,11,6,9,2,2,2,3,1,6,3,3,0,2,2,20
8042,792654,30,4,7,4,7,0,0,3,6,3,8,0,4,1,3,3,11
8042,797301,37,5,12,3,9,2,3,2,2,1,6,8,0,1,5,0,14
8042,781400,39,1,6,0,2,1,4,0,0,0,2,5,1,1,2,0,3
8042,792653,9,1,3,1,3,0,0,4,4,4,0,0,1,0,0,1,6
8042,780524,16,3,5,1,2,2,3,3,4,0,0,1,0,3,2,0,11
8042,797302,3,0,0,0,0,0,0,0,0,0,0,0,0,0,0,0,0
8043,780765,34,9,18,6,12,3,6,1,3,0,5,3,3,1,3,0,22
8043,781301,23,2,2,2,2,0,0,2,2,2,2,0,2,0,0,5,6
8043,786255,35,4,14,3,8,1,6,0,0,6,3,4,2,2,1,1,9
8043,780762,35,3,10,2,6,1,4,1,2,2,2,1,2,3,1,0,8
8043,780768,35,4,7,3,5,1,2,4,4,0,0,4,4,1,3,0,13
8043,791729,18,3,7,3,6,0,1,3,5,3,4,0,5,1,1,0,9
8043,797320,7,0,1,0,0,0,1,0,0,0,1,0,0,0,0,0,0
8043,780755,13,4,8,4,7,0,1,0,0,0,1,0,3,1,2,0,8
8044,790893,29,2,7,1,6,1,1,2,2,2,5,0,4,2,1,1,7
8044,796444,36,7,12,6,10,1,2,8,12,2,3,2,4,2,4,4,23
8044,786615,20,2,8,1,6,1,2,1,2,2,1,1,2,0,1,0,6
8044,786732,23,2,5,2,3,0,2,0,0,1,2,1,3,0,0,1,4
8044,775260,34,7,15,4,6,3,9,0,0,0,2,2,5,0,2,0,17
8044,775536,16,4,6,4,6,0,0,0,0,1,3,0,1,0,0,2,8
8044,790890,22,0,4,0,3,0,1,1,2,0,1,7,1,1,2,0,1
8044,780702,5,2,4,1,2,1,2,0,2,0,1,0,0,0,0,0,5
8044,790889,15,0,1,0,0,0,1,1,2,1,1,0,0,0,0,0,1
8045,796334,34,6,17,5,13,1,4,3,4,4,11,3,3,0,1,0,16
8045,790776,11,1,3,1,3,0,0,0,0,2,0,0,5,2,2,0,2
8045,796330,17,0,4,0,4,0,0,2,2,0,1,1,0,1,0,0,2
8045,796336,28,3,6,0,1,3,5,0,0,0,0,4,1,0,1,0,9
8045,785813,37,6,13,5,10,1,3,7,8,1,0,7,3,0,2,0,20
8045,785827,29,7,14,7,14,0,0,5,7,4,9,1,2,0,0,0,19
8045,779975,6,1,1,1,1,0,0,0,0,0,1,2,1,0,1,0,2
8045,796337,17,1,3,0,1,1,2,0,0,1,2,2,0,0,1,0,3
8045,796332,21,2,3,0,0,2,3,2,2,0,3,0,1,0,0,0,8
8046,781480,17,1,2,1,1,0,1,0,1,0,2,0,2,0,1,0,2
8046,774846,21,6,9,6,9,0,0,0,1,2,6,0,3,0,1,0,12
8046,797273,7,0,3,0,2,0,1,0,0,0,0,1,1,0,0,0,0
8046,786558,38,6,16,5,11,1,5,1,1,0,2,6,1,1,2,0,14
8046,766611,39,5,15,5,11,0,4,3,3,2,3,5,1,0,1,0,13
8046,786185,19,2,5,2,5,0,0,0,0,4,4,0,3,0,3,1,4
8046,797182,2,0,0,0,0,0,0,0,0,0,0,0,0,0,1,0,0
8046,791376,27,2,5,0,1,2,4,0,0,0,3,0,3,3,0,0,6
8046,797272,30,2,7,1,3,1,4,0,0,0,4,0,3,0,0,0,5
8047,779985,17,1,7,1,3,0,4,2,2,2,2,0,1,0,1,0,4
8047,790876,30,4,7,3,4,1,3,1,2,2,5,1,2,0,2,0,10
8047,785699,35,2,8,2,5,0,3,3,4,1,8,3,3,2,1,1,7
8047,781062,31,4,9,2,4,2,5,0,0,2,1,1,2,1,0,0,10
8047,774987,38,5,12,3,6,2,6,8,10,1,4,1,0,0,1,1,20
8047,790877,15,1,2,0,1,1,1,2,2,1,4,0,1,0,0,0,5
8047,790879,6,1,2,1,2,0,0,0,0,0,0,0,1,0,1,0,2
8047,785432,16,2,3,2,3,0,0,0,0,2,2,1,3,1,0,1,4
8047,790882,12,2,5,2,3,0,2,0,2,1,1,2,1,1,1,2,4
8048,797573,25,4,11,4,11,0,0,0,0,4,2,2,2,0,1,3,8
8048,791903,8,1,4,1,3,0,1,0,0,2,2,0,0,0,0,0,2
8048,791899,30,5,9,5,6,0,3,1,2,0,3,2,4,1,3,0,11
8048,786512,37,8,14,3,5,5,9,1,3,0,4,2,3,2,3,2,22
8048,786435,22,3,5,3,4,0,1,0,0,0,4,0,1,0,2,0,6
8048,797574,26,3,5,1,1,2,4,2,2,1,1,1,4,0,0,2,10
8048,797571,25,1,2,1,1,0,1,0,0,0,0,5,2,1,2,0,2
8048,786032,27,1,3,1,3,0,0,1,3,1,2,0,2,1,1,0,3
8049,780440,34,5,11,5,9,0,2,6,6,2,10,2,1,0,3,0,16
8049,775620,16,2,3,2,3,0,0,3,3,2,1,1,0,0,2,0,7
8049,791621,39,8,18,4,8,4,10,6,7,3,3,1,1,0,1,0,26
8049,786432,24,0,4,0,3,0,1,0,0,0,2,0,3,0,1,0,0
8049,786431,29,4,8,2,4,2,4,4,6,0,2,4,3,0,3,0,14
8049,791620,3,0,1,0,0,0,1,0,0,0,0,0,0,0,0,0,0
8049,786434,12,0,1,0,1,0,0,0,0,1,1,0,2,0,1,0,0
8049,781125,7,0,2,0,2,0,0,0,0,1,1,0,1,0,1,0,0
8049,781088,32,2,5,1,1,1,4,1,2,3,3,3,3,1,1,0,6
8049,775622,4,0,0,0,0,0,0,0,0,1,0,0,1,0,0,0,0
8050,775563,23,1,6,1,6,0,0,0,0,1,8,1,0,1,3,0,2
8050,781011,29,4,8,3,6,1,2,5,6,6,5,1,4,1,1,1,14
8050,797601,33,8,15,3,3,5,12,1,2,2,0,3,1,0,0,0,22
8050,781012,36,5,12,3,5,2,7,1,3,1,2,2,1,4,1,0,13
8050,775119,31,11,19,10,14,1,5,1,3,1,6,2,2,2,3,0,24
8050,797602,2,0,0,0,0,0,0,0,0,0,1,0,0,0,0,0,0
8050,775806,24,2,6,2,3,0,3,0,0,0,2,0,0,1,0,0,4
8050,797604,17,0,2,0,1,0,1,0,0,2,2,0,3,0,2,0,0
8050,786466,5,0,1,0,0,0,1,0,0,0,0,0,0,0,0,0,0
8051,780758,20,0,3,0,2,0,1,2,2,3,2,0,4,0,6,0,2
8051,775489,30,1,8,1,7,0,1,0,0,1,10,0,3,1,1,1,2
8051,785563,31,8,14,5,7,3,7,0,0,1,6,1,5,3,2,0,19
8051,791069,32,7,11,5,7,2,4,0,0,0,4,0,3,0,2,0,16
8051,780313,38,5,12,1,5,4,7,6,7,0,4,5,0,2,1,0,20
8051,791087,2,0,0,0,0,0,0,0,0,0,0,0,0,0,1,0,0
8051,791088,11,0,0,0,0,0,0,0,0,0,0,1,1,0,0,0,0
8051,785560,19,2,6,0,2,2,4,1,2,1,0,1,1,1,0,1,7
8051,785561,17,1,5,1,5,0,0,0,0,0,1,0,1,0,3,0,2
8052,774812,21,4,8,3,4,1,4,0,0,0,6,1,3,0,3,2,9
8052,791498,16,2,4,2,4,0,0,0,0,0,1,0,1,0,1,1,4
8052,791497,31,6,12,4,8,2,4,0,1,0,7,2,3,0,0,1,14
8052,781486,34,5,11,4,7,1,4,4,7,1,3,2,1,1,2,0,15
8052,780461,34,3,7,2,4,1,3,3,4,1,5,7,3,3,3,0,10
8052,791500,11,2,4,1,2,1,2,0,0,0,2,0,2,0,0,1,5
8052,797180,10,0,1,0,0,0,1,2,3,0,0,1,0,0,0,0,2
8052,791503,3,0,1,0,1,0,0,0,0,1,0,1,0,0,0,0,0
8052,780240,24,3,5,3,4,0,1,3,4,2,3,1,2,1,1,0,9
8052,776379,16,2,5,0,1,2,4,0,0,0,3,1,1,0,0,0,6
8053,791042,33,6,14,4,11,2,3,8,9,2,5,1,1,0,1,1,22
8053,774834,26,0,2,0,2,0,0,0,0,3,2,0,1,2,1,0,0
8053,791043,27,5,14,2,4,3,10,1,1,1,5,3,4,2,2,0,14
8053,776374,24,1,7,1,4,0,3,0,0,0,4,5,3,0,0,0,2
8053,775412,28,2,7,0,1,2,6,0,1,0,2,0,2,2,0,0,6
8053,796723,25,7,11,4,6,3,5,0,0,0,1,3,4,0,3,0,17
8053,796719,12,1,2,1,2,0,0,1,1,1,0,0,2,0,0,0,3
8053,785512,7,0,1,0,1,0,0,1,2,0,1,0,3,0,0,0,1
8053,796717,17,2,4,2,3,0,1,0,0,0,5,3,2,0,1,0,4
8053,796722,1,0,0,0,0,0,0,0,0,0,0,0,0,0,0,0,0
8054,775556,35,10,18,10,15,0,3,0,0,3,7,7,3,2,3,0,20
8054,780234,30,5,10,5,10,0,0,3,4,8,5,2,2,2,3,1,13
8054,786411,29,3,8,2,2,1,6,1,2,2,3,7,2,0,1,1,8
8054,780046,32,6,14,3,5,3,9,0,1,1,5,3,2,2,0,0,15
8054,781104,33,7,15,5,6,2,9,3,3,1,5,3,3,2,4,0,19
8054,781110,15,2,3,2,3,0,0,0,0,3,3,1,4,1,2,0,4
8054,797185,13,3,4,2,2,1,2,1,2,1,1,2,2,0,1,1,8
8054,786405,13,0,3,0,2,0,1,0,0,0,0,1,0,0,5,0,0
8055,791089,30,6,12,6,9,0,3,2,4,4,3,0,3,4,2,0,14
8055,791097,29,2,7,2,5,0,2,3,8,5,4,0,1,5,3,1,7
8055,791094,31,3,7,1,2,2,5,0,1,1,5,1,2,0,3,0,8
8055,791091,37,5,11,5,7,0,4,4,4,0,2,2,1,0,2,0,14
8055,791090,39,8,23,2,8,6,15,1,2,2,2,0,0,1,3,0,23
8055,791092,3,0,0,0,0,0,0,2,2,0,0,0,0,0,1,0,2
8055,796752,31,3,5,3,4,0,1,0,0,0,2,5,2,3,2,0,6
8056,797163,13,2,4,2,4,0,0,2,2,4,1,0,4,0,2,0,6
8056,797164,9,1,2,1,2,0,0,0,0,1,2,1,2,1,1,0,2
8056,786450,24,1,6,1,2,0,4,2,2,0,4,2,4,0,2,3,4
8056,776396,36,9,19,4,9,5,10,8,8,2,3,2,2,1,4,0,31
8056,776199,28,5,12,3,7,2,5,3,3,0,2,2,2,2,3,0,15
8056,800178,4,0,0,0,0,0,0,1,2,1,1,0,1,0,1,0,1
8056,797167,23,1,2,1,2,0,0,0,0,2,8,1,3,0,2,0,2
8056,791385,30,3,9,0,3,3,6,4,4,1,7,5,1,3,2,1,13
8056,797165,17,4,4,1,1,3,3,1,2,0,1,2,0,0,0,1,12
8056,793778,1,1,1,1,1,0,0,0,0,0,0,0,1,0,0,0,2
8056,791382,10,0,1,0,1,0,0,0,0,0,2,1,1,0,0,0,0
8056,797161,2,0,0,0,0,0,0,0,0,0,0,0,0,0,0,0,0
8056,791386,2,0,0,0,0,0,0,0,0,0,0,0,0,0,0,0,0
8056,797160,1,0,0,0,0,0,0,0,0,0,0,0,0,0,0,0,0
8057,780494,25,4,14,3,7,1,7,2,2,1,5,0,4,1,1,0,11
8057,797276,7,0,1,0,1,0,0,0,0,1,1,1,2,1,2,0,0
8057,780497,29,2,3,2,2,0,1,0,0,2,0,2,1,2,2,0,4
8057,780496,26,3,10,1,3,2,7,0,0,1,4,3,2,1,3,1,8
8057,780495,28,4,15,0,6,4,9,4,4,0,4,1,1,4,2,0,16
8057,797277,7,0,0,0,0,0,0,1,2,0,0,1,0,0,1,0,1
8057,797274,12,4,7,4,7,0,0,3,3,0,0,1,3,0,0,1,11
8057,785693,18,0,0,0,0,0,0,2,4,1,1,1,2,1,1,2,2
8057,797275,7,0,0,0,0,0,0,0,0,0,1,0,1,0,0,0,0
8057,791643,5,2,4,1,1,1,3,0,1,0,0,0,0,0,0,1,5
8057,789054,2,0,0,0,0,0,0,0,2,0,1,0,0,0,0,0,0
8057,785692,25,1,2,1,1,0,1,5,6,0,2,2,1,1,1,0,7
8057,785644,8,0,3,0,2,0,1,0,0,0,0,1,2,0,0,0,0
8057,799889,1,0,0,0,0,0,0,0,0,0,0,0,0,0,0,0,0
8058,786180,10,0,1,0,1,0,0,0,0,0,2,1,1,0,1,0,0
8058,792104,35,9,22,4,10,5,12,6,6,5,2,1,2,2,1,0,29
8058,797709,22,3,6,1,1,2,5,2,2,3,0,1,0,0,0,1,10
8058,797708,35,2,9,1,6,1,3,0,0,1,1,5,3,2,1,0,5
8058,775779,31,1,10,0,7,1,3,4,5,1,0,5,4,2,6,0,7
8058,786204,10,0,3,0,2,0,1,0,0,1,2,0,1,0,0,0,0
8058,797707,22,4,13,3,7,1,6,4,4,2,2,2,4,2,3,0,13
8058,786198,10,1,1,0,0,1,1,0,0,0,1,0,2,1,1,1,3
8058,785608,25,4,6,3,4,1,2,7,8,3,3,1,3,2,1,1,16
8059,791194,30,3,5,3,4,0,1,2,2,0,4,2,2,2,2,2,8
8059,780384,21,4,4,4,4,0,0,1,1,2,7,0,5,1,3,2,9
8059,780159,25,5,9,4,8,1,1,0,0,2,5,0,3,0,4,0,11
8059,796863,8,0,1,0,1,0,0,0,0,0,0,1,1,0,2,1,0
8059,775694,29,3,5,2,4,1,1,4,4,1,2,1,2,0,1,0,11
8059,774827,32,8,13,6,10,2,3,6,6,2,4,8,3,1,5,0,24
8059,800119,20,4,8,4,6,0,2,1,2,0,3,1,3,2,0,1,9
8059,791193,15,2,2,2,2,0,0,2,6,0,2,1,2,0,2,1,6
8059,791191,20,5,7,5,7,0,0,0,1,1,1,0,3,0,3,1,10
8060,781592,26,1,6,1,5,0,1,0,0,0,6,1,4,0,1,0,2
8060,780229,27,5,8,5,8,0,0,2,3,1,4,4,2,3,2,0,12
8060,795572,37,10,15,7,9,3,6,1,2,0,5,2,3,0,1,0,24
8060,791483,27,7,13,5,7,2,6,4,7,0,1,1,3,3,2,0,20
8060,797193,27,6,7,1,1,5,6,1,4,1,6,2,3,0,1,0,18
8060,797195,5,0,2,0,0,0,2,0,0,1,0,0,0,0,0,0,0
8060,791488,13,0,3,0,1,0,2,0,0,0,1,1,0,0,0,0,0
8060,797194,4,0,1,0,0,0,1,0,0,0,0,0,0,1,0,0,0
8060,786322,21,0,1,0,0,0,1,1,2,1,0,1,0,0,0,0,1
8060,791484,4,0,0,0,0,0,0,0,0,0,1,0,0,0,0,0,0
8060,791485,5,0,0,0,0,0,0,0,0,0,0,0,2,0,0,0,0
8060,791489,1,0,1,0,0,0,1,0,0,0,0,0,0,0,0,0,0
8060,791487,1,0,1,0,0,0,1,0,0,0,1,0,0,0,0,0,0
8060,786323,1,0,0,0,0,0,0,0,0,0,0,0,0,0,0,0,0
8060,797197,1,0,0,0,0,0,0,0,0,0,0,0,0,0,0,0,0
8061,797235,25,3,4,3,4,0,0,3,6,3,2,2,0,1,1,0,9
8061,797232,34,5,8,3,4,2,4,0,0,0,4,2,3,0,3,0,12
8061,797237,20,2,3,2,2,0,1,0,0,0,1,0,5,0,0,0,4
8061,797234,29,2,6,2,4,0,2,3,4,4,6,3,4,1,4,0,7
8061,797239,39,8,21,6,12,2,9,3,4,0,10,2,2,1,1,0,21
8061,797233,12,2,5,2,4,0,1,0,0,0,1,0,2,0,2,1,4
8061,786535,12,0,1,0,0,0,1,0,0,1,3,0,0,0,1,0,0
8061,791368,2,0,0,0,0,0,0,0,0,0,1,0,0,0,0,0,0
8061,791367,27,2,9,2,8,0,1,2,2,1,0,0,1,1,1,0,6
8062,796404,27,5,8,5,8,0,0,2,2,2,8,1,3,0,3,0,12
8062,790853,22,3,5,3,5,0,0,2,2,5,0,0,2,0,2,0,8
8062,790850,29,1,9,0,3,1,6,2,2,1,2,0,3,1,1,0,5
8062,781164,35,3,10,2,5,1,5,0,1,0,1,2,1,2,1,0,7
8062,781163,38,6,17,3,10,3,7,3,4,0,2,7,2,2,3,1,18
8062,785434,7,0,1,0,0,0,1,0,0,0,0,1,1,1,1,0,0
8062,790849,17,1,4,0,1,1,3,0,0,0,1,2,2,0,0,0,3
8062,796406,16,2,4,2,4,0,0,0,1,3,1,0,2,0,1,0,4
8062,796405,4,0,0,0,0,0,0,0,0,1,2,1,1,0,0,0,0
8062,790848,5,0,0,0,0,0,0,0,0,0,0,0,0,0,0,0,0
8063,775640,15,1,4,1,2,0,2,4,4,2,4,1,2,1,2,0,6
8063,780919,27,3,4,3,4,0,0,4,6,2,4,1,3,0,3,0,10
8063,785803,29,1,3,0,1,1,2,0,0,0,1,0,1,1,1,0,3
8063,780920,36,7,12,6,9,1,3,6,6,1,2,3,2,1,2,0,21
8063,780914,33,2,9,2,4,0,5,2,3,0,6,1,1,0,3,0,6
8063,791142,18,0,1,0,0,0,1,0,0,0,1,0,1,1,2,0,0
8063,775816,18,3,5,1,2,2,3,2,2,2,3,1,2,0,1,0,10
8063,796799,20,2,5,2,3,0,2,1,1,0,4,1,2,2,1,0,5
8063,791141,4,0,0,0,0,0,0,0,0,0,0,0,2,0,0,0,0
8064,785829,20,4,9,4,9,0,0,0,0,4,3,3,2,1,2,0,8
8064,775838,36,4,10,4,9,0,1,0,0,1,10,3,3,3,0,3,8
8064,796729,32,3,8,1,4,2,4,4,4,1,0,2,2,2,2,0,12
8064,791048,16,0,2,0,2,0,0,0,0,0,0,1,2,1,1,0,0
8064,786531,39,4,16,3,12,1,4,6,7,0,6,1,1,1,2,0,15
8064,791044,19,5,11,5,11,0,0,4,7,2,2,0,2,0,0,0,14
8064,780723,22,3,6,1,2,2,4,2,2,0,4,0,1,0,1,1,10
8064,796727,16,0,2,0,0,0,2,0,0,0,0,1,2,0,0,0,0
8065,781530,26,8,15,7,11,1,4,4,4,2,10,1,3,2,0,2,21
8065,776423,29,3,8,3,8,0,0,4,4,6,7,0,3,0,3,9,10
8065,798096,29,4,11,4,10,0,1,0,0,0,5,2,1,0,2,0,8
8065,792307,20,1,4,0,0,1,4,0,0,1,0,1,1,0,1,0,3
8065,792319,29,2,7,1,3,1,4,2,2,1,3,3,0,0,2,1,7
8065,792316,1,1,1,1,1,0,0,0,0,0,0,1,2,0,0,0,2
8065,792314,14,2,3,2,3,0,0,0,0,2,1,0,1,0,2,1,4
8065,786296,12,1,2,1,2,0,0,1,2,0,0,0,3,2,1,0,3
8065,792320,1,0,1,0,1,0,0,0,0,0,0,0,0,0,0,0,0
8065,798106,5,0,2,0,2,0,0,0,2,0,0,0,0,0,0,0,0
8065,798104,21,2,6,2,5,0,1,2,2,0,0,2,2,0,1,0,6
8065,792309,4,0,2,0,2,0,0,0,0,0,1,0,1,0,0,0,0
8065,792321,9,0,1,0,1,0,0,0,0,0,5,1,2,0,1,0,0
8066,780569,36,8,14,8,14,0,0,0,0,0,5,2,2,0,2,0,16
8066,797436,24,1,7,1,3,0,4,0,0,0,0,1,2,0,1,0,2
8066,791696,31,4,11,3,7,1,4,1,2,2,3,4,0,1,3,1,10
8066,781556,22,4,9,4,8,0,1,0,0,1,1,2,1,1,0,1,8
8066,780565,33,6,10,4,8,2,2,2,2,0,5,0,4,1,2,0,16
8066,797432,26,4,7,2,3,2,4,2,2,0,1,1,1,0,0,0,12
8066,785824,21,1,5,0,2,1,3,2,2,1,1,0,4,2,0,1,5
8066,791695,3,0,0,0,0,0,0,0,0,0,1,0,1,0,0,0,0
8066,797433,4,0,0,0,0,0,0,0,0,0,0,0,0,0,0,0,0
8067,786481,38,8,18,8,16,0,2,1,2,2,11,2,3,0,1,1,17
8067,797626,35,4,7,3,4,1,3,0,0,4,8,6,4,3,4,0,9
8067,797624,20,4,8,4,4,0,4,0,1,2,0,3,2,0,0,0,8
8067,786480,36,6,12,1,5,5,7,2,2,1,4,0,1,0,1,0,19
8067,781032,28,4,7,1,2,3,5,5,6,0,2,4,2,2,3,0,16
8067,785965,16,1,4,1,1,0,3,0,0,0,0,0,1,0,2,1,2
8067,797628,19,3,3,3,3,0,0,2,2,2,3,0,0,0,1,1,8
8067,791791,8,0,0,0,0,0,0,2,2,0,0,0,1,0,0,0,2
8068,790761,29,2,7,2,6,0,1,0,0,0,5,7,3,0,1,0,4
8068,790764,38,8,13,3,5,5,8,1,1,0,4,0,1,0,1,1,22
8068,796322,7,0,0,0,0,0,0,0,0,0,0,1,0,1,0,0,0
8068,796319,27,2,7,1,2,1,5,4,7,0,0,1,1,1,0,0,9
8068,796320,32,5,10,3,5,2,5,0,0,0,0,3,4,0,3,0,12
8068,779993,28,2,4,2,3,0,1,0,0,0,3,4,3,4,2,1,4
8068,796321,29,5,8,4,5,1,3,0,1,0,5,0,1,1,1,4,11
8068,785219,5,0,0,0,0,0,0,0,0,0,0,0,1,0,1,0,0
8068,796323,5,2,2,2,2,0,0,0,0,2,0,0,0,0,0,1,4
8069,775510,36,7,11,4,6,3,5,2,2,1,7,3,1,1,1,0,19
8069,774976,35,9,15,9,14,0,1,2,2,6,6,1,3,0,2,2,20
8069,797865,19,0,1,0,0,0,1,0,0,0,1,2,3,1,2,0,0
8069,786614,36,2,2,2,2,0,0,0,0,0,2,1,0,1,0,1,4
8069,786759,38,5,15,3,11,2,4,3,3,1,3,2,1,3,3,0,15
8069,792293,26,3,8,3,8,0,0,1,3,0,2,2,2,0,1,1,7
8069,792294,8,0,0,0,0,0,0,0,0,0,2,0,2,0,2,0,0
8069,786761,2,0,0,0,0,0,0,0,0,0,0,0,0,0,0,0,0
8070,791796,3,1,1,1,1,0,0,0,0,0,0,0,0,0,0,0,2
8070,781044,33,6,10,4,4,2,6,3,5,0,6,1,3,2,2,0,17
8070,786489,22,3,8,1,3,2,5,2,3,0,1,2,3,0,2,0,10
8070,786488,35,6,7,5,6,1,1,2,2,0,5,4,2,1,1,0,15
8070,781038,34,4,9,2,6,2,3,0,0,0,1,5,1,2,2,0,10
8070,797620,18,3,6,1,2,2,4,2,2,0,2,0,3,1,3,1,10
8070,786490,7,1,2,1,2,0,0,0,1,4,1,1,2,0,0,0,2
8070,797621,6,1,1,0,0,1,1,0,0,0,0,0,0,0,0,0,3
8070,797619,19,2,6,2,5,0,1,0,0,0,3,2,4,1,1,0,4
8070,791795,23,5,7,4,5,1,2,0,0,1,4,1,2,0,1,0,11
8071,792035,31,11,16,11,16,0,0,7,9,1,2,0,4,4,3,0,29
8071,780833,29,5,6,5,6,0,0,5,7,1,7,1,4,0,0,2,15
8071,792034,38,6,11,4,4,2,7,0,0,0,5,5,1,1,3,0,14
8071,791688,24,2,7,1,3,1,4,0,0,0,3,1,2,1,0,0,5
8071,780830,29,2,4,1,2,1,2,1,2,0,1,1,1,0,2,1,6
8071,797645,7,3,5,3,3,0,2,0,2,0,1,0,1,0,2,0,6
8071,785980,29,2,4,1,1,1,3,2,2,1,1,3,0,3,0,0,7
8071,785381,13,0,1,0,0,0,1,0,0,0,2,1,1,0,0,0,0
8072,776279,31,2,7,1,4,1,3,1,3,0,1,4,2,0,0,0,6
8072,781505,36,4,13,3,10,1,3,2,5,3,6,3,2,1,2,0,11
8072,780353,32,5,7,5,7,0,0,1,4,5,10,3,2,0,5,1,11
8072,791317,38,4,10,0,3,4,7,0,0,1,3,2,4,0,2,0,12
8072,777573,30,5,15,2,7,3,8,2,2,1,1,2,2,0,3,0,15
8072,786222,11,1,2,1,2,0,0,3,4,2,2,0,5,0,1,0,5
8072,785966,1,0,0,0,0,0,0,0,0,0,0,0,0,0,0,0,0
8072,796646,1,0,0,0,0,0,0,0,0,0,0,0,1,0,0,0,0
8072,796649,13,1,3,1,2,0,1,0,0,1,0,0,1,0,0,0,2
8072,790851,7,0,2,0,2,0,0,0,0,1,1,0,0,0,1,0,0
8073,774806,22,6,7,6,7,0,0,1,2,2,2,1,5,1,3,1,13
8073,775823,31,2,6,2,5,0,1,0,0,6,8,1,3,3,1,0,4
8073,791041,32,5,12,4,7,1,5,0,1,2,3,1,3,1,1,0,11
8073,791038,38,0,9,0,6,0,3,2,2,0,3,1,3,0,2,0,2
8073,789023,39,5,14,4,9,1,5,8,10,0,1,8,1,0,1,0,19
8073,796716,6,0,1,0,1,0,0,0,0,0,0,0,1,0,0,0,0
8073,796714,16,4,6,4,6,0,0,2,5,1,3,0,1,3,0,0,10
8073,775205,16,2,4,0,2,2,2,0,0,1,3,1,1,1,2,0,6
8074,790844,21,2,2,2,2,0,0,0,0,1,0,1,3,0,1,1,4
8074,775142,28,4,8,2,5,2,3,3,4,2,4,3,5,1,1,1,13
8074,790843,34,4,12,2,5,2,7,5,6,0,4,2,2,0,5,1,15
8074,786212,32,6,8,3,3,3,5,0,1,0,3,2,3,1,0,0,15
8074,785392,31,4,10,3,6,1,4,0,0,1,1,2,0,1,1,0,9
8074,799986,11,0,3,0,3,0,0,0,0,2,3,0,0,0,0,2,0
8074,780094,24,3,6,2,3,1,3,0,0,1,4,2,0,1,1,0,7
8074,796914,10,2,3,2,2,0,1,0,0,0,1,0,2,0,1,0,4
8074,781563,9,0,0,0,0,0,0,0,0,0,0,0,0,0,1,0,0
8075,786724,16,1,4,1,1,0,3,0,0,0,0,1,4,0,1,0,2
8075,786723,38,6,14,6,13,0,1,3,5,0,3,3,3,1,3,0,15
8075,792349,29,6,10,6,9,0,1,1,2,3,6,2,1,0,2,1,13
8075,798060,37,4,8,3,5,1,3,4,4,1,6,5,1,0,2,0,13
8075,792355,34,5,11,1,3,4,8,3,3,1,1,0,1,0,2,0,17
8075,786726,9,0,1,0,1,0,0,2,2,1,0,0,0,1,0,0,2
8075,798061,29,1,3,1,1,0,2,0,0,0,3,1,2,1,2,1,2
8075,792348,8,0,0,0,0,0,0,0,0,0,0,0,1,0,1,0,0
8076,780283,19,6,6,6,6,0,0,5,5,1,3,0,4,0,3,0,17
8076,790925,39,3,7,3,6,0,1,3,4,3,7,4,4,1,0,1,9
8076,791456,30,3,9,0,4,3,5,3,3,0,3,4,1,0,2,0,12
8076,785476,35,4,13,4,10,0,3,2,2,0,2,6,2,1,2,0,10
8076,785474,34,4,11,2,5,2,6,1,2,0,4,2,1,1,3,0,11
8076,790926,2,0,0,0,0,0,0,0,0,0,0,0,1,0,0,0,0
8076,785480,14,3,4,1,1,2,3,0,0,0,3,0,1,0,0,0,8
8076,796470,7,0,2,0,2,0,0,2,4,2,1,0,0,0,0,0,2
8076,800121,13,3,3,3,3,0,0,3,3,2,4,0,0,0,1,0,9
8076,785478,7,1,2,1,2,0,0,0,0,1,1,0,3,0,0,0,2
8077,790781,6,0,2,0,2,0,0,0,0,0,2,1,5,0,0,1,0
8077,780040,38,5,6,5,6,0,0,8,10,2,7,0,2,0,1,0,18
8077,790785,34,8,20,7,16,1,4,1,2,0,4,5,2,1,1,0,18
8077,781232,34,3,7,0,1,3,6,0,0,0,1,2,2,0,0,0,9
8077,780037,35,8,21,3,12,5,9,4,5,1,2,3,1,1,2,1,25
8077,796343,25,2,2,2,2,0,0,0,0,1,1,0,5,0,0,0,4
8077,796339,20,2,3,1,2,1,1,0,0,0,3,2,1,1,1,0,5
8077,790783,8,0,0,0,0,0,0,0,0,0,0,0,1,0,0,0,0
8106,790957,33,3,9,3,6,0,3,2,2,0,4,1,3,2,3,2,8
8106,785275,32,7,13,7,13,0,0,5,7,1,5,2,2,1,0,4,19
8106,790956,18,1,3,0,1,1,2,0,0,1,1,0,2,0,2,0,3
8106,796552,26,3,6,2,5,1,1,1,2,0,3,1,5,1,2,0,8
8106,780460,37,5,15,4,8,1,7,3,4,0,3,1,2,1,5,0,14
8106,796549,8,3,4,3,4,0,0,0,2,0,0,0,1,0,0,0,6
8106,796551,21,0,2,0,1,0,1,0,0,1,5,3,2,0,1,1,0
8106,796548,6,0,0,0,0,0,0,0,0,1,1,0,2,0,0,1,0
8106,796547,19,0,2,0,1,0,1,2,2,1,1,1,2,1,0,0,2
8106,785276,0,0,0,0,0,0,0,0,0,0,0,0,0,0,0,0,0
8107,792486,18,2,7,1,3,1,4,0,1,1,4,0,0,0,1,1,5
8107,785772,22,3,4,3,4,0,0,0,0,2,3,0,5,0,4,1,6
8107,785778,25,7,10,7,10,0,0,5,5,3,7,0,3,3,1,0,19
8107,785766,8,0,4,0,0,0,4,0,0,0,1,0,0,0,1,0,0
8107,780543,33,2,11,2,9,0,2,6,8,1,7,2,2,1,1,0,10
8107,792481,17,4,11,3,10,1,1,1,3,6,1,4,3,0,0,1,10
8107,792488,16,1,2,1,2,0,0,0,0,1,0,2,1,1,0,0,2
8107,780544,1,0,0,0,0,0,0,0,0,0,0,0,1,0,0,0,0
8107,797419,20,1,3,0,1,1,2,0,0,0,0,0,1,1,1,0,3
8107,792482,30,4,10,1,2,3,8,4,4,1,5,1,2,1,1,1,15
8107,792489,10,1,3,1,2,0,1,0,0,1,1,0,1,0,0,0,2
8108,791686,23,2,7,1,6,1,1,2,4,3,5,0,4,0,4,1,7
8108,798028,37,6,9,6,8,0,1,1,4,1,2,3,1,0,1,0,13
8108,790940,38,8,13,3,5,5,8,9,11,0,5,1,4,5,2,0,30
8108,786060,34,6,9,5,5,1,4,0,0,0,2,2,1,1,0,0,13
8108,780770,32,7,13,3,6,4,7,0,0,0,2,10,2,0,2,0,18
8108,798022,6,0,1,0,0,0,1,0,0,0,0,0,0,0,1,0,0
8108,792271,10,0,3,0,3,0,0,0,2,1,0,0,0,0,0,0,0
8108,792270,3,0,2,0,0,0,2,0,0,0,0,0,0,0,0,0,0
8108,792269,17,0,0,0,0,0,0,0,0,1,2,0,1,1,0,1,0
8109,790846,29,4,8,4,8,0,0,6,7,2,4,2,3,0,2,3,14
8109,796755,3,0,0,0,0,0,0,0,0,0,1,0,0,0,1,0,0
8109,791099,34,5,11,1,1,4,10,0,0,0,2,0,1,1,1,0,14
8109,785470,27,0,2,0,1,0,1,2,2,0,5,3,1,0,3,0,2
8109,780298,34,6,12,0,3,6,9,2,2,0,1,7,3,2,4,1,20
8109,780315,10,0,1,0,0,0,1,0,0,1,1,0,2,0,0,1,0
8109,796754,32,10,11,6,6,4,5,2,2,0,3,5,3,1,2,0,26
8109,780814,6,2,4,2,4,0,0,0,0,0,0,0,0,0,0,0,4
8109,785586,25,1,2,1,2,0,0,2,3,0,3,5,2,3,2,2,4
8110,797715,43,7,15,3,6,4,9,4,7,0,12,10,2,2,4,1,22
8110,780937,40,6,14,4,7,2,7,6,9,2,3,2,3,0,2,3,20
8110,791950,32,1,5,1,2,0,3,3,4,0,6,2,4,0,2,1,5
8110,792113,29,4,8,3,5,1,3,0,0,2,5,0,5,0,1,1,9
8110,775754,39,13,19,10,13,3,6,1,4,0,7,2,2,0,2,2,30
8110,797716,11,0,0,0,0,0,0,0,0,0,0,0,4,0,1,0,0
8110,797717,21,1,4,1,3,0,1,0,0,2,5,2,0,3,1,0,2
8110,792115,10,1,3,0,0,1,3,0,0,0,0,0,2,0,2,0,3
8110,800179,0,0,0,0,0,0,0,0,0,0,0,0,0,0,0,0,0
8111,780122,10,2,3,2,2,0,1,0,1,0,1,0,2,0,1,0,4
8111,797215,41,7,14,7,12,0,2,3,3,3,2,6,1,5,2,1,17
8111,791461,38,7,15,7,12,0,3,4,7,4,7,0,1,1,1,0,18
8111,791460,36,5,16,4,9,1,7,3,5,0,8,4,3,2,2,0,14
8111,786295,28,4,10,3,3,1,7,2,2,2,4,2,3,0,0,0,11
8111,786299,35,4,9,4,9,0,0,4,5,5,5,1,4,1,4,1,12
8111,797214,10,1,3,1,3,0,0,1,2,0,2,1,1,0,0,0,3
8111,780792,27,1,9,0,3,1,6,0,0,0,2,1,2,0,0,0,3
8112,791606,38,4,12,3,5,1,7,7,10,1,1,1,3,1,1,1,16
8112,786410,33,3,8,1,5,2,3,6,8,2,1,3,2,1,2,1,14
8112,775095,12,1,2,1,2,0,0,0,2,2,4,1,1,0,2,1,2
8112,791605,23,4,7,2,3,2,4,2,3,0,4,0,1,1,3,0,12
8112,786406,34,4,12,3,8,1,4,0,1,1,0,3,4,1,2,0,9
8112,797020,12,2,2,2,2,0,0,1,2,1,2,0,1,1,1,0,5
8112,792392,11,0,1,0,1,0,0,0,0,1,4,0,0,0,1,0,0
8112,797021,9,0,1,0,0,0,1,0,0,4,1,1,2,0,1,0,0
8112,791603,17,2,4,1,1,1,3,2,2,0,5,1,3,0,0,0,7
8112,791843,11,1,5,1,4,0,1,0,0,0,2,1,0,0,1,0,2
8113,791707,38,6,9,3,5,3,4,4,4,1,1,4,4,0,2,0,19
8113,785836,31,3,8,3,5,0,3,2,2,2,5,0,3,1,0,0,8
8113,785833,36,6,12,5,7,1,5,0,1,0,4,1,1,4,1,3,13
8113,791704,38,3,9,3,9,0,0,7,13,2,5,3,2,2,3,1,13
8113,785892,34,5,13,5,8,0,5,0,0,1,4,2,3,1,1,1,10
8113,775872,5,0,0,0,0,0,0,0,0,0,0,0,1,1,0,0,0
8113,785332,16,3,5,3,5,0,0,0,0,1,2,0,4,0,0,2,6
8113,797533,2,0,0,0,0,0,0,0,0,0,0,0,0,0,0,0,0
8114,791981,36,6,11,4,7,2,4,3,4,3,8,0,1,2,1,0,17
8114,780342,31,2,5,2,4,0,1,7,8,1,1,2,4,3,0,0,11
8114,791982,34,4,14,4,10,0,4,3,5,1,5,2,3,0,4,1,11
8114,780333,37,8,15,6,9,2,6,2,5,0,6,2,1,0,3,0,20
8114,781493,12,0,1,0,0,0,1,0,0,0,0,1,3,0,0,0,0
8114,786756,28,1,5,0,0,1,5,2,2,1,4,3,1,0,0,0,5
8114,786755,22,1,2,1,1,0,1,2,2,0,0,0,3,2,0,0,4
8115,796812,20,4,6,4,6,0,0,0,2,0,2,0,4,0,1,0,8
8115,780952,21,1,5,1,5,0,0,0,0,1,2,1,3,0,1,4,2
8115,791155,36,7,17,4,9,3,8,4,8,3,7,1,0,1,5,1,21
8115,786609,35,3,7,3,3,0,4,3,3,4,7,0,2,0,1,0,9
8115,796810,25,2,10,0,2,2,8,4,4,0,1,2,2,0,1,0,10
8115,796814,16,0,1,0,0,0,1,2,2,0,3,2,5,0,0,1,2
8115,791156,18,2,5,1,2,1,3,0,0,0,0,1,2,0,1,0,5
8115,791154,4,0,1,0,1,0,0,0,0,0,0,0,0,0,0,0,0
8115,780950,25,1,3,0,0,1,3,0,0,0,2,1,3,0,0,0,3
8116,775954,25,1,7,1,7,0,0,2,3,1,6,0,2,0,0,0,4
8116,781006,34,4,7,3,5,1,2,1,1,0,2,0,2,2,0,3,10
8116,796464,33,4,14,3,9,1,5,6,6,2,1,5,3,1,3,1,15
8116,796459,28,2,11,2,7,0,4,0,0,2,3,1,1,0,3,0,4
8116,781157,36,5,10,1,2,4,8,4,6,0,3,2,1,1,2,0,18
8116,790918,10,1,1,1,1,0,0,0,0,0,2,0,2,0,0,1,2
8116,796194,30,1,5,1,2,0,3,0,0,0,5,4,2,0,1,0,2
8116,790916,4,0,1,0,1,0,0,0,0,0,0,0,1,0,1,0,0
8117,797222,21,4,10,4,10,0,0,8,9,2,5,0,4,1,2,2,16
8117,781526,30,2,7,2,7,0,0,6,6,2,5,2,1,0,2,1,10
8117,797217,31,3,4,2,3,1,1,0,0,0,1,4,4,0,1,0,7
8117,797218,33,3,11,3,7,0,4,0,1,0,1,1,1,3,3,0,6
8117,775697,34,5,10,0,3,5,7,0,0,1,3,2,0,0,1,0,15
8117,791454,25,4,10,3,8,1,2,1,2,4,10,2,4,1,2,0,10
8117,791846,24,2,5,2,5,0,0,2,2,0,4,1,1,2,0,1,6
8117,791453,2,0,0,0,0,0,0,0,0,0,1,0,0,0,0,0,0
8118,791853,14,2,5,2,4,0,1,1,1,0,2,1,3,0,0,0,5
8118,780377,33,4,7,2,3,2,4,8,8,1,14,2,2,2,0,0,18
8118,797460,34,7,11,4,5,3,6,1,2,1,4,0,1,0,2,2,18
8118,786601,30,4,13,1,2,3,11,0,0,0,4,2,2,2,2,0,11
8118,786600,21,1,2,1,1,0,1,0,0,1,1,3,3,1,2,0,2
8118,791851,17,2,4,2,3,0,1,0,0,0,1,1,1,1,1,1,4
8118,791852,16,2,3,2,3,0,0,0,0,1,1,0,3,0,3,1,4
8118,797461,29,5,10,3,5,2,5,6,9,1,2,3,2,0,2,0,18
8118,786602,6,0,2,0,0,0,2,0,0,0,0,0,1,0,0,0,0
8119,786623,25,3,7,3,6,0,1,4,7,5,4,2,3,0,1,0,10
8119,797404,20,3,7,2,4,1,3,0,0,2,2,0,1,0,2,0,7
8119,791834,40,4,11,2,7,2,4,0,0,0,5,4,2,2,2,0,10
8119,791833,29,5,11,5,10,0,1,2,4,0,7,4,3,0,2,0,12
8119,785920,40,6,17,5,14,1,3,3,4,0,5,0,3,3,2,0,16
8119,786624,11,1,1,1,1,0,0,0,0,0,1,1,0,0,0,0,2
8119,785698,18,3,4,2,2,1,2,0,0,0,2,0,2,1,1,0,7
8119,784077,17,0,3,0,1,0,2,0,0,0,1,0,2,0,0,1,0
8120,781558,36,5,5,3,3,2,2,0,1,1,2,0,1,1,2,1,12
8120,780993,33,2,6,2,6,0,0,2,4,3,6,1,4,0,3,1,6
8120,775248,34,10,21,9,13,1,8,4,4,3,7,9,1,1,3,1,25
8120,797225,17,1,3,0,2,1,1,0,0,1,4,2,3,0,3,0,3
8120,791452,40,4,10,0,1,4,9,0,0,0,4,7,1,3,2,0,12
8120,797230,7,1,2,1,2,0,0,0,0,2,0,0,2,0,0,0,2
8120,797231,6,0,1,0,0,0,1,0,0,0,0,0,1,0,0,0,0
8120,791449,27,1,5,1,1,0,4,2,2,0,4,1,1,1,1,1,4
8121,776209,40,5,11,3,6,2,5,1,2,1,7,0,1,2,0,0,13
8121,791235,39,5,11,5,11,0,0,2,2,1,4,3,3,1,2,0,12
8121,791236,19,0,2,0,2,0,0,0,0,1,1,0,0,0,1,0,0
8121,791240,37,1,10,1,8,0,2,3,4,0,3,4,4,2,0,0,5
8121,791237,33,5,15,2,5,3,10,2,2,0,3,2,1,5,2,0,15
8121,788124,4,0,0,0,0,0,0,0,0,0,0,0,1,0,1,0,0
8121,781227,4,0,1,0,0,0,1,0,0,1,0,0,0,0,0,0,0
8121,796938,24,3,4,3,3,0,1,0,0,0,0,0,1,1,1,0,6
8122,775738,21,2,5,2,3,0,2,0,0,0,0,0,3,0,2,1,4
8122,786091,29,5,12,4,8,1,4,3,3,2,7,1,4,0,0,1,14
8122,786728,30,8,11,8,10,0,1,0,0,0,4,2,2,3,1,0,16
8122,785904,33,5,12,3,4,2,8,3,3,0,8,4,1,0,0,1,15
8122,780892,35,2,8,0,2,2,6,5,5,0,4,2,1,0,4,0,11
8122,792087,3,0,0,0,0,0,0,0,0,0,1,0,0,0,0,0,0
8122,785734,5,2,3,1,1,1,2,0,0,1,0,0,0,0,0,0,5
8122,786788,2,0,0,0,0,0,0,0,0,0,0,0,1,0,0,0,0
8122,786096,27,5,12,4,9,1,3,1,1,3,2,2,3,1,1,0,12
8122,781030,14,0,1,0,0,0,1,0,0,0,0,0,0,1,1,0,0
8122,797665,1,0,0,0,0,0,0,0,0,0,0,0,0,0,0,0,0
8122,797669,0,0,0,0,0,0,0,0,0,0,0,0,0,0,0,0,0
8122,797670,0,0,0,0,0,0,0,0,0,0,0,0,0,0,0,0,0
8123,798157,23,2,4,2,4,0,0,0,1,2,0,0,0,1,0,2,4
8123,786635,33,5,14,4,11,1,3,5,10,1,7,0,1,0,0,1,16
8123,791822,33,0,4,0,0,0,4,0,0,0,3,0,1,0,1,0,0
8123,780642,32,7,18,7,15,0,3,0,0,1,3,5,1,1,3,0,14
8123,776449,21,6,8,6,7,0,1,1,2,0,0,1,5,2,3,0,13
8123,797383,20,1,2,1,1,0,1,0,1,1,4,0,3,0,0,1,2
8123,791823,3,0,0,0,0,0,0,0,0,0,1,0,0,0,0,0,0
8123,785830,2,0,0,0,0,0,0,0,0,0,0,0,0,0,0,0,0
8123,797384,1,0,0,0,0,0,0,0,0,0,0,0,0,0,1,0,0
8123,786182,15,0,1,0,1,0,0,0,0,1,2,1,3,1,0,0,0
8123,786632,5,2,3,0,0,2,3,0,0,0,0,0,1,0,0,0,6
8123,781543,12,1,4,1,2,0,2,0,0,0,1,1,2,0,2,0,2
8124,791616,26,4,10,3,9,1,1,2,2,2,4,1,3,1,0,0,11
8124,780797,36,6,12,3,6,3,6,2,2,0,3,2,2,2,1,0,17
8124,796981,27,2,10,2,6,0,4,0,0,1,4,2,1,1,0,0,4
8124,785505,36,8,15,8,14,0,1,4,4,0,2,3,1,1,3,1,20
8124,775604,34,3,6,2,3,1,3,1,3,0,2,2,4,1,2,0,8
8124,796986,6,0,0,0,0,0,0,0,0,0,2,0,1,0,1,0,0
8124,791618,7,0,0,0,0,0,0,0,0,0,1,0,1,0,1,0,0
8124,780555,28,0,5,0,0,0,5,0,0,1,0,2,2,0,0,0,0
8125,796542,8,0,0,0,0,0,0,0,0,0,0,1,0,0,0,0,0
8125,781335,30,9,12,7,8,2,4,4,4,2,8,1,1,1,2,1,24
8125,776351,26,0,2,0,1,0,1,3,4,0,3,1,3,0,2,0,3
8125,785770,33,7,11,6,7,1,4,2,2,0,6,0,2,0,2,1,17
8125,781341,32,2,6,2,2,0,4,2,3,0,3,3,1,0,0,0,6
8125,791285,11,1,3,0,2,1,1,0,0,0,2,0,0,0,0,0,3
8125,785775,25,3,7,3,5,0,2,6,6,1,5,0,4,2,3,1,12
8125,796538,11,0,1,0,1,0,0,0,0,0,1,3,0,0,0,0,0
8125,791284,19,2,4,1,2,1,2,0,0,0,0,0,1,0,1,1,5
8125,785767,5,0,0,0,0,0,0,0,0,0,0,0,1,0,0,0,0
8126,790914,17,2,2,2,2,0,0,0,0,1,5,0,4,0,0,0,4
8126,785458,36,6,15,6,13,0,2,3,7,2,3,2,1,1,2,1,15
8126,785456,11,0,1,0,1,0,0,0,0,1,0,0,3,0,0,0,0
8126,785453,32,5,16,1,5,4,11,8,10,0,4,1,2,1,2,0,22
8126,774940,19,3,8,3,7,0,1,2,2,0,2,1,1,1,1,0,8
8126,780798,27,1,5,1,3,0,2,3,4,2,3,1,1,0,0,1,5
8126,790915,18,1,4,1,4,0,0,0,1,3,3,1,1,0,0,1,2
8126,790913,21,6,6,4,4,2,2,1,1,0,2,1,2,0,2,0,15
8126,785454,13,3,7,2,2,1,5,0,0,0,0,1,3,0,2,0,7
8126,800055,6,0,1,0,1,0,0,0,0,2,0,0,0,0,0,1,0
8127,790863,22,5,10,4,8,1,2,1,3,2,4,1,2,3,3,0,12
8127,775686,16,0,1,0,1,0,0,0,0,0,4,1,3,0,0,0,0
8127,785412,25,7,15,5,9,2,6,0,0,0,3,1,2,2,0,0,16
8127,776214,32,6,8,4,5,2,3,3,3,0,1,7,4,2,2,0,17
8127,780099,23,5,8,2,3,3,5,0,0,0,5,1,3,0,0,0,13
8127,780021,21,5,5,5,5,0,0,7,7,1,3,0,0,0,1,1,17
8127,785411,14,1,4,0,0,1,4,4,4,0,2,0,1,0,0,0,7
8127,776221,17,1,2,1,2,0,0,1,2,0,0,3,4,1,2,0,3
8127,785417,14,2,2,2,2,0,0,0,0,0,1,1,0,0,0,0,4
8127,785413,16,2,4,2,4,0,0,0,0,0,2,0,1,0,0,0,4
8128,790899,13,1,3,1,3,0,0,0,0,2,1,0,4,0,1,0,2
8128,785442,15,5,7,4,6,1,1,0,0,0,3,0,2,1,1,1,11
8128,799907,24,0,4,0,2,0,2,0,0,0,2,0,3,1,2,0,0
8128,785579,37,4,9,3,5,1,4,2,2,0,3,2,0,1,2,0,11
8128,781628,21,5,9,3,5,2,4,2,3,0,3,0,3,2,2,0,14
8128,796447,7,0,0,0,0,0,0,0,0,0,0,0,0,0,3,2,0
8128,790897,23,1,7,1,3,0,4,4,4,2,3,2,2,0,1,0,6
8128,790898,16,1,1,1,1,0,0,3,4,1,0,1,1,0,1,0,5
8128,775737,21,2,6,1,1,1,5,0,0,0,4,2,1,1,3,0,5
8128,775959,18,3,7,1,2,2,5,0,0,1,0,1,1,1,1,0,8
8128,785448,5,0,1,0,1,0,0,0,0,2,0,0,0,0,1,0,0
8129,785409,19,3,5,3,5,0,0,3,4,1,2,0,3,1,1,3,9
8129,785408,34,5,11,3,7,2,4,2,3,2,0,0,1,0,2,0,14
8129,785407,32,4,11,4,9,0,2,3,4,3,4,0,1,0,0,1,11
8129,796416,30,4,8,1,3,3,5,0,0,1,3,5,4,3,4,0,11
8129,790861,33,5,10,5,9,0,1,4,4,2,7,3,1,4,2,1,14
8129,796415,16,4,5,4,5,0,0,0,0,0,2,0,4,3,1,0,8
8129,780539,21,3,6,1,1,2,5,2,2,0,1,3,0,0,1,0,10
8129,790860,3,1,2,0,0,1,2,0,0,0,0,0,0,0,0,0,3
8129,796419,2,0,0,0,0,0,0,0,2,0,0,0,0,0,0,0,0
8129,796418,2,0,0,0,0,0,0,0,0,0,0,0,2,0,0,0,0
8129,790859,3,0,0,0,0,0,0,0,0,0,0,0,0,0,0,0,0
8129,796417,5,0,0,0,0,0,0,0,0,0,0,0,0,0,0,0,0
8130,791140,18,2,3,2,3,0,0,0,2,3,2,3,4,0,1,1,4
8130,791138,24,2,3,1,1,1,2,0,1,1,2,0,0,3,1,1,5
8130,786084,32,5,13,3,7,2,6,5,6,1,9,8,1,1,2,1,17
8130,780910,30,4,14,3,9,1,5,2,2,0,4,7,1,2,4,0,11
8130,780288,28,6,12,3,5,3,7,2,2,0,6,0,1,0,0,1,17
8130,796794,7,0,1,0,0,0,1,0,0,0,0,0,0,0,1,1,0
8130,796795,19,7,11,7,11,0,0,1,1,5,1,3,4,2,2,0,15
8130,780912,9,0,0,0,0,0,0,0,0,0,0,0,0,0,0,0,0
8130,780911,18,3,9,3,5,0,4,0,0,1,4,0,1,0,0,0,6
8130,781635,15,3,3,2,2,1,1,0,0,0,1,0,0,1,0,0,7
8131,780282,25,7,12,7,11,0,1,5,6,5,7,2,1,1,1,2,19
8131,780277,30,4,8,3,5,1,3,2,2,1,3,0,2,1,5,0,11
8131,791002,25,2,8,0,4,2,4,0,0,1,0,1,3,1,0,0,6
8131,785327,27,0,5,0,1,0,4,0,0,0,3,1,4,1,1,0,0
8131,780280,33,6,16,4,10,2,6,1,1,1,3,2,0,0,2,0,15
8131,785329,15,3,7,3,4,0,3,0,0,0,1,2,4,0,2,0,6
8131,791003,13,0,2,0,0,0,2,0,0,0,4,3,2,0,2,0,0
8131,785330,23,5,5,3,3,2,2,0,1,2,5,1,0,1,0,0,12
8131,785326,9,1,4,0,2,1,2,0,0,0,3,0,2,0,2,0,3
8132,792378,35,2,3,2,3,0,0,0,0,1,3,0,3,1,1,3,4
8132,786746,39,4,9,2,4,2,5,5,6,2,5,5,2,1,3,0,15
8132,780178,21,3,5,3,5,0,0,2,2,0,2,1,4,0,2,0,8
8132,792376,34,6,12,5,7,1,5,4,4,0,4,0,0,1,6,0,17
8132,797883,41,4,13,4,11,0,2,4,5,0,0,2,4,6,2,0,12
8132,797890,21,4,10,3,6,1,4,4,4,0,2,2,3,2,2,1,13
8132,797888,4,0,0,0,0,0,0,0,0,0,0,0,1,0,0,0,0
8132,775075,13,1,1,1,1,0,0,0,0,0,2,1,3,1,0,0,2
8132,786747,17,2,4,1,3,1,1,0,0,0,2,0,0,1,3,1,5
8132,797885,0,0,0,0,0,0,0,0,0,0,0,0,0,0,0,0,0
8133,776345,15,1,3,1,3,0,0,0,0,1,1,0,3,0,0,0,2
8133,796579,24,1,6,1,4,0,2,0,0,1,4,3,0,1,3,0,2
8133,785794,36,6,15,5,10,1,5,2,2,2,7,2,4,3,1,0,15
8133,785792,25,2,6,1,3,1,3,2,2,0,1,1,2,0,2,0,7
8133,781373,32,5,9,4,6,1,3,3,5,0,3,4,5,1,5,0,14
8133,791295,29,8,11,8,11,0,0,11,14,3,3,1,1,0,1,1,27
8133,796577,30,5,8,5,6,0,2,0,2,3,3,1,2,0,1,1,10
8133,791292,5,0,1,0,1,0,0,0,0,1,0,0,0,0,1,0,0
8133,791293,18,1,3,1,2,0,1,0,0,0,3,2,1,3,1,0,2
8133,796580,10,0,2,0,1,0,1,0,0,0,0,1,0,1,3,0,0
8133,781379,1,0,0,0,0,0,0,0,0,0,0,0,0,0,0,0,0
8134,781650,30,1,3,1,3,0,0,4,6,0,2,1,3,1,4,0,6
8134,797070,27,2,6,1,4,1,2,0,0,0,2,0,0,1,1,1,5
8134,797068,28,0,3,0,1,0,2,0,0,0,3,2,1,1,3,0,0
8134,791432,31,2,6,2,4,0,2,0,0,0,3,1,0,0,2,0,4
8134,791429,23,3,6,2,5,1,1,1,4,1,3,0,1,1,2,0,8
8134,797066,16,0,1,0,1,0,0,0,0,1,1,0,3,0,2,0,0
8134,791431,3,0,0,0,0,0,0,2,2,1,0,0,0,0,0,0,2
8134,797067,21,1,4,1,3,0,1,0,0,1,2,0,4,0,4,0,2
8134,777865,21,3,9,3,6,0,3,7,10,0,4,0,3,0,2,0,13
8135,790784,17,3,8,3,6,0,2,0,0,1,2,0,3,1,0,1,6
8135,786235,23,4,8,4,8,0,0,2,5,2,7,0,2,0,1,4,10
8135,797475,20,2,4,0,0,2,4,0,0,1,1,2,1,1,0,0,6
8135,786229,15,2,3,0,1,2,2,0,0,0,3,1,3,0,0,0,6
8135,775229,26,6,11,4,8,2,3,2,3,1,2,5,1,4,5,0,16
8135,786583,5,0,2,0,2,0,0,0,0,2,1,0,1,0,0,0,0
8135,776219,18,2,8,0,2,2,6,0,0,0,0,0,1,0,1,0,6
8135,797477,5,0,1,0,0,0,1,0,0,0,1,0,0,0,0,0,0
8135,797476,4,0,2,0,2,0,0,0,0,0,0,0,0,0,0,0,0
8135,791871,14,1,2,1,1,0,1,0,1,0,1,2,1,0,0,0,2
8135,786581,20,3,3,2,2,1,1,0,0,5,1,0,2,0,1,0,7
8135,786770,16,3,5,1,2,2,3,0,0,1,2,2,1,3,1,0,8
8135,786719,5,0,0,0,0,0,0,0,0,0,0,0,2,0,0,0,0
8135,781518,12,2,4,2,2,0,2,0,0,0,2,1,2,1,1,0,4
8136,775418,17,1,5,1,5,0,0,0,0,0,2,1,5,0,1,0,2
8136,791537,27,5,8,4,6,1,2,4,5,3,3,2,4,0,2,0,15
8136,786358,39,8,9,4,5,4,4,2,3,1,2,0,0,0,0,0,22
8136,797116,40,4,12,3,7,1,5,2,2,0,4,4,1,2,2,0,11
8136,780306,34,5,13,5,13,0,0,7,10,2,1,1,2,0,5,1,17
8136,775846,16,1,4,1,3,0,1,0,1,0,3,1,1,1,1,0,2
8136,791535,20,0,4,0,3,0,1,2,2,2,4,0,5,0,2,0,2
8136,791538,6,0,0,0,0,0,0,0,0,0,1,0,1,0,1,0,0
8136,797121,1,0,0,0,0,0,0,0,0,0,0,0,0,0,0,0,0
8137,796674,33,6,10,4,7,2,3,4,7,3,4,2,5,3,2,1,18
8137,796673,12,0,1,0,0,0,1,2,2,0,4,0,4,0,0,0,2
8137,779857,32,7,8,7,7,0,1,7,9,0,2,3,1,0,2,5,21
8137,774990,31,5,12,3,6,2,6,2,2,0,2,5,0,1,1,0,14
8137,779976,30,6,10,5,6,1,4,2,2,1,4,3,1,2,2,0,15
8137,791014,16,3,5,1,2,2,3,0,0,0,2,0,1,1,0,0,8
8137,785339,24,0,2,0,2,0,0,0,0,0,2,1,3,0,1,0,0
8137,781586,7,1,4,1,4,0,0,0,0,0,0,1,5,0,0,0,2
8137,785961,14,3,4,1,2,2,2,0,0,1,2,1,1,0,1,0,8
8137,785126,1,0,0,0,0,0,0,0,0,0,0,0,2,0,1,0,0
8138,776462,26,4,6,4,6,0,0,4,7,1,1,1,2,1,0,1,12
8138,785635,14,0,4,0,2,0,2,0,0,0,1,4,1,0,1,4,0
8138,791629,31,4,10,2,6,2,4,1,2,0,2,0,2,0,2,0,11
8138,796974,35,6,14,4,11,2,3,2,2,0,6,3,3,0,5,0,16
8138,781199,31,3,11,1,7,2,4,4,4,0,2,2,4,1,3,1,12
8138,796972,4,0,0,0,0,0,0,0,0,0,1,0,0,0,0,0,0
8138,775642,10,1,1,1,1,0,0,0,0,2,1,1,1,0,2,0,2
8138,786720,19,1,3,0,1,1,2,0,0,0,2,3,1,0,2,0,3
8138,791626,16,1,3,1,3,0,0,0,0,1,2,2,1,0,0,2,2
8138,791628,14,2,2,1,1,1,1,0,0,1,2,0,0,0,2,1,5
8139,791416,24,9,12,9,12,0,0,4,4,2,4,0,2,0,1,1,22
8139,797096,24,2,7,1,3,1,4,0,0,0,4,3,3,0,2,0,5
8139,785906,32,9,16,9,16,0,0,1,2,1,9,10,0,2,3,0,19
8139,781614,21,3,4,1,2,2,2,4,4,2,1,4,0,1,1,0,12
8139,780096,32,5,9,2,5,3,4,2,2,0,3,4,1,6,1,0,15
8139,785907,11,4,7,4,7,0,0,1,1,2,1,0,1,0,0,0,9
8139,797093,11,2,3,2,3,0,0,0,0,0,2,4,3,0,1,0,4
8139,780100,20,1,2,0,0,1,2,0,0,0,2,2,2,0,0,0,3
8139,797094,7,1,3,1,1,0,2,0,0,0,0,0,0,0,0,0,2
8139,791415,4,1,1,1,1,0,0,0,0,0,1,0,0,0,0,0,2
8139,791417,7,0,0,0,0,0,0,1,2,0,0,0,1,0,0,1,1
8139,797095,1,0,2,0,2,0,0,0,0,1,0,0,0,0,0,0,0
8139,767484,4,0,0,0,0,0,0,0,0,0,0,0,0,0,0,0,0
8139,797098,2,0,0,0,0,0,0,0,0,0,0,0,0,0,0,0,0
8140,797831,52,3,7,1,2,2,5,3,4,1,5,9,4,1,4,0,11
8140,785950,35,4,10,3,4,1,6,2,3,3,4,1,2,4,0,0,11
8140,797823,48,5,9,4,5,1,4,3,3,2,6,1,3,0,2,1,14
8140,797826,17,1,3,1,2,0,1,0,0,0,0,2,1,1,2,0,2
8140,792280,54,12,35,4,17,8,18,8,10,1,4,2,1,3,9,0,40
8140,792283,41,1,8,0,2,1,6,2,2,3,4,0,1,0,1,0,5
8140,797829,26,1,3,1,3,0,0,0,1,4,6,2,5,2,2,1,2
8140,799468,2,0,0,0,0,0,0,0,0,0,0,0,0,0,0,0,0
8141,792143,47,3,6,0,0,3,6,1,2,0,4,0,4,1,1,0,10
8141,786302,27,3,4,3,4,0,0,1,2,1,5,1,3,0,5,0,7
8141,786293,39,6,11,6,10,0,1,3,4,0,2,1,3,0,0,1,15
8141,780953,28,4,5,4,5,0,0,3,6,0,5,6,5,3,1,1,11
8141,797750,52,7,11,5,7,2,4,1,4,0,6,7,2,2,5,0,17
8141,780955,28,4,7,2,5,2,2,0,0,0,4,4,5,1,6,0,10
8141,797753,20,1,8,1,5,0,3,0,0,0,1,1,1,0,1,0,2
8141,786287,27,2,5,2,4,0,1,0,0,0,1,0,0,2,2,0,4
8141,797748,7,0,1,0,1,0,0,0,0,0,1,0,1,1,0,0,0
8142,797701,16,2,4,2,4,0,0,0,0,0,0,2,4,0,1,0,4
8142,780922,12,1,4,0,1,1,3,0,0,0,2,0,2,0,2,0,3
8142,792101,28,2,10,2,6,0,4,4,4,1,2,4,3,0,0,0,8
8142,775564,39,6,10,5,8,1,2,2,4,4,5,1,3,2,0,1,15
8142,797700,17,4,6,4,6,0,0,2,4,0,3,1,4,0,0,1,10
8142,792102,30,5,9,3,3,2,6,0,0,1,3,1,1,1,0,0,12
8142,776386,35,5,9,3,5,2,4,2,2,2,7,4,2,1,3,0,14
8142,780923,23,8,11,5,7,3,4,3,5,0,0,3,4,1,1,0,22
8143,797380,27,2,6,2,6,0,0,0,0,3,3,2,1,1,2,0,4
8143,789043,14,5,5,5,5,0,0,0,1,4,4,0,5,0,1,0,10
8143,791818,38,7,12,3,5,4,7,11,11,0,3,5,0,1,3,0,29
8143,786636,37,4,13,3,6,1,7,10,12,0,4,5,2,0,1,0,19
8143,780646,10,1,3,1,2,0,1,0,2,2,0,3,1,0,0,0,2
8143,797379,24,1,2,1,2,0,0,2,2,0,3,0,3,0,3,0,4
8143,797377,35,3,5,1,1,2,4,0,0,0,3,0,3,0,3,0,8
8143,775168,15,0,5,0,4,0,1,0,2,0,2,1,0,0,0,0,0
8143,797378,0,0,0,0,0,0,0,0,0,0,0,0,0,0,0,0,0
8144,780578,32,1,8,0,5,1,3,0,0,1,2,1,2,1,1,0,3
8144,797538,13,1,7,0,1,1,6,0,0,1,2,1,1,0,1,0,3
8144,785293,23,2,4,2,3,0,1,3,3,0,2,0,1,0,1,1,7
8144,785847,27,2,6,1,1,1,5,2,4,1,2,0,1,0,0,0,7
8144,780579,34,8,17,4,7,4,10,5,6,0,1,0,2,4,2,0,25
8144,791712,29,5,8,5,8,0,0,2,3,6,2,0,4,2,0,0,12
8144,791709,11,1,2,1,2,0,0,0,0,0,4,1,1,0,2,0,2
8144,797537,21,1,5,1,3,0,2,0,0,2,3,1,1,0,1,0,2
8144,797535,10,1,4,1,1,0,3,0,0,0,0,1,1,1,1,0,2
8145,796631,23,5,9,3,4,2,5,0,0,1,4,0,3,0,0,0,12
8145,790998,30,3,7,2,3,1,4,0,0,0,4,1,2,1,2,1,7
8145,790997,29,5,7,4,6,1,1,3,3,0,5,1,1,0,3,1,14
8145,790995,26,1,3,1,1,0,2,0,0,0,0,4,3,0,1,0,2
8145,785621,30,5,8,1,1,4,7,2,2,0,5,3,1,1,1,1,16
8145,766874,15,3,5,3,5,0,0,2,6,1,1,2,2,0,2,1,8
8145,790999,7,1,1,1,1,0,0,0,0,0,0,0,2,0,0,1,2
8145,790992,3,0,0,0,0,0,0,0,0,0,0,0,2,0,2,0,0
8145,796632,8,2,4,0,1,2,3,0,0,0,1,1,1,0,0,1,6
8145,786375,21,3,6,2,4,1,2,0,0,2,4,1,2,3,1,0,7
8145,781520,5,1,1,1,1,0,0,0,0,0,0,0,0,0,1,0,2
8145,785313,3,0,0,0,0,0,0,0,0,0,0,0,1,0,1,0,0
8146,791522,30,8,16,8,15,0,1,2,2,3,8,1,1,0,1,0,18
8146,786351,23,6,10,2,3,4,7,1,1,2,2,0,2,2,2,0,17
8146,786348,26,3,7,3,6,0,1,0,1,5,0,1,2,1,1,1,6
8146,797146,29,7,16,4,10,3,6,10,11,0,4,0,1,0,1,0,27
8146,797143,32,6,11,2,5,4,6,0,0,0,3,6,0,1,2,0,16
8146,785816,22,6,6,6,6,0,0,0,3,3,7,1,3,0,0,2,12
8146,797142,12,0,1,0,1,0,0,0,0,1,1,0,3,0,2,1,0
8146,797147,12,0,2,0,2,0,0,2,2,1,1,3,4,2,2,0,2
8146,797144,7,2,2,2,2,0,0,0,0,0,0,1,2,0,0,0,4
8146,797148,4,1,1,1,1,0,0,0,2,0,1,0,1,0,0,1,2
8146,786826,2,0,1,0,0,0,1,0,0,0,0,0,0,0,0,0,0
8146,797145,1,0,0,0,0,0,0,0,0,0,0,0,0,0,0,0,0
8147,796699,23,2,7,2,4,0,3,6,6,1,4,0,3,0,1,4,10
8147,790983,22,2,4,2,4,0,0,0,0,2,3,0,0,0,0,1,4
8147,790978,19,3,9,1,3,2,6,0,0,1,0,0,4,1,1,0,8
8147,790979,35,5,14,2,7,3,7,0,0,1,2,5,1,1,1,0,13
8147,796697,32,9,17,9,13,0,4,8,9,1,2,2,3,1,6,0,26
8147,796701,12,1,2,1,2,0,0,0,0,1,2,0,2,0,1,0,2
8147,788820,20,3,8,1,3,2,5,1,1,0,0,0,3,1,1,0,9
8147,790976,9,1,2,1,2,0,0,0,2,3,0,0,2,1,0,0,2
8147,796698,9,0,1,0,1,0,0,0,0,0,4,1,1,0,0,1,0
8147,790980,15,1,5,1,4,0,1,4,4,6,1,0,0,1,1,3,6
8147,790977,2,0,2,0,0,0,2,0,0,0,0,0,0,0,0,0,0
8147,789457,2,0,2,0,2,0,0,0,0,1,1,0,0,0,0,0,0
8148,780832,31,4,7,4,7,0,0,3,4,3,7,2,3,0,2,1,11
8148,790961,33,4,10,4,10,0,0,2,2,3,1,3,3,0,0,1,10
8148,786240,20,0,1,0,0,0,1,1,2,1,1,1,0,0,0,0,1
8148,785278,35,3,10,2,5,1,5,0,0,0,6,0,2,1,2,1,7
8148,780146,35,8,16,4,5,4,11,0,0,0,6,1,1,0,2,0,20
8148,796556,5,0,2,0,1,0,1,0,0,0,1,1,0,0,0,0,0
8148,796554,8,0,2,0,2,0,0,0,0,2,2,0,1,1,0,1,0
8148,796557,3,0,0,0,0,0,0,0,0,0,1,0,0,0,0,0,0
8148,796555,5,0,1,0,0,0,1,0,0,0,1,0,0,1,1,0,0
8148,775860,25,2,9,1,1,1,8,0,0,0,0,2,1,1,1,0,5
8149,796455,37,2,6,2,6,0,0,2,6,3,4,1,3,0,3,3,6
8149,787175,35,6,16,0,0,6,16,0,0,1,9,1,3,0,0,1,18
8149,790909,35,5,11,3,5,2,6,0,0,1,4,2,3,1,0,0,12
8149,781393,40,3,16,2,8,1,8,4,5,0,5,4,0,1,2,0,11
8149,775351,40,4,7,4,7,0,0,1,2,1,2,4,0,0,1,0,9
8149,790907,13,0,1,0,1,0,0,0,0,1,2,0,2,0,1,0,0
8150,781656,31,5,10,5,10,0,0,2,2,2,7,2,0,0,2,4,12
8150,796962,37,3,8,2,4,1,4,4,4,0,1,4,1,0,3,0,11
8150,781658,37,5,12,5,12,0,0,0,0,5,9,3,3,2,3,0,10
8150,780129,19,3,7,3,6,0,1,1,3,0,2,2,5,0,1,0,7
8150,798206,13,0,5,0,2,0,3,0,4,3,1,0,1,0,0,0,0
8150,791263,16,5,8,5,8,0,0,1,2,4,1,4,2,0,4,0,11
8150,796966,13,4,5,4,5,0,0,2,2,1,7,1,5,1,0,0,10
8150,796967,13,2,7,0,1,2,6,0,0,0,0,0,0,0,0,0,6
8150,791264,7,2,4,2,4,0,0,0,2,0,0,0,0,1,2,0,4
8150,796964,13,0,1,0,1,0,0,0,0,0,1,4,0,0,0,0,0
8150,790256,1,0,0,0,0,0,0,0,0,0,0,0,1,0,0,0,0
8151,787524,20,3,6,3,4,0,2,3,4,1,3,0,0,0,1,0,9
8151,780328,31,3,10,3,10,0,0,2,2,3,3,0,0,0,2,1,8
8151,781019,23,1,7,1,5,0,2,2,4,3,2,3,1,0,4,0,4
8151,787522,12,1,2,1,2,0,0,1,2,4,2,0,4,0,0,0,3
8151,775961,8,0,2,0,1,0,1,2,2,0,0,1,1,0,1,0,2
8151,783269,10,3,6,1,1,2,5,1,2,0,1,1,1,0,1,0,9
8151,791772,23,2,9,1,3,1,6,2,2,1,5,2,1,1,0,0,7
8151,780017,22,2,12,2,10,0,2,1,2,0,1,0,2,1,3,0,5
8151,775541,20,2,6,2,4,0,2,0,0,1,2,0,2,0,0,1,4
8151,791722,14,1,1,1,1,0,0,1,3,1,1,1,2,0,1,0,3
8151,797610,8,1,3,0,0,1,3,0,0,0,1,1,1,0,0,0,3
8151,791774,5,0,1,0,1,0,0,0,0,2,1,0,0,0,1,0,0
8151,797611,4,0,1,0,0,0,1,0,0,0,1,0,0,0,0,0,0
8152,780609,38,5,11,1,2,4,9,3,4,0,1,4,0,2,2,0,17
8152,776395,35,6,12,5,7,1,5,4,4,0,2,0,3,0,4,0,17
8152,791837,35,5,9,2,3,3,6,3,4,0,8,2,3,1,3,0,16
8152,780613,26,5,8,4,7,1,1,2,2,1,5,0,4,0,1,0,13
8152,775097,31,3,4,3,4,0,0,4,4,3,5,8,2,1,3,0,10
8152,786622,10,1,2,1,1,0,1,0,0,0,2,0,3,0,0,0,2
8152,786619,9,1,1,1,1,0,0,0,0,0,1,0,1,1,1,0,2
8152,797437,7,1,1,1,1,0,0,0,0,0,0,0,0,0,0,0,2
8152,786621,8,0,1,0,0,0,1,0,0,0,0,0,3,1,0,0,0
8152,797439,1,0,0,0,0,0,0,0,0,0,0,0,0,0,0,0,0
8153,774964,34,9,16,9,15,0,1,2,3,3,6,3,2,4,2,1,20
8153,796912,28,4,10,2,4,2,6,2,2,1,3,0,2,2,0,0,12
8153,775626,27,4,10,3,8,1,2,3,5,4,5,2,4,0,3,1,12
8153,774962,33,3,10,1,3,2,7,0,0,0,0,4,2,0,0,0,8
8153,796907,22,1,4,1,2,0,2,4,4,1,2,1,2,2,2,0,6
8153,796910,19,3,5,3,4,0,1,4,4,1,3,1,4,1,3,0,10
8153,796906,12,2,3,2,2,0,1,0,0,0,1,0,1,0,0,0,4
8153,791203,20,0,0,0,0,0,0,0,2,1,0,0,0,1,0,0,0
8153,796908,5,0,0,0,0,0,0,0,0,0,0,0,0,0,1,0,0
8154,797849,15,1,5,1,2,0,3,0,0,1,2,0,2,0,2,0,2
8154,781537,29,4,7,3,4,1,3,0,0,1,2,1,3,2,0,0,9
8154,779986,23,3,6,3,6,0,0,2,4,2,0,1,0,0,0,1,8
8154,786079,34,4,7,3,5,1,2,0,0,1,2,5,2,2,0,1,9
8154,792202,23,3,6,0,0,3,6,0,0,1,0,3,0,0,0,0,9
8154,797842,27,4,7,3,5,1,2,4,9,2,7,2,3,2,0,0,13
8154,797847,15,1,3,1,1,0,2,0,0,0,1,1,1,3,5,0,2
8154,797835,13,4,9,2,4,2,5,0,0,1,0,1,3,1,0,0,10
8154,797846,21,3,9,2,6,1,3,0,0,0,2,0,0,0,2,0,7
8155,797292,27,6,8,6,8,0,0,2,4,2,7,2,1,0,1,2,14
8155,780509,29,6,9,5,7,1,2,0,0,1,2,1,4,1,4,0,13
8155,797290,32,4,10,1,3,3,7,2,2,0,3,2,0,0,2,0,13
8155,797291,27,3,6,2,5,1,1,2,2,1,4,5,2,1,5,0,9
8155,786064,35,5,7,1,1,4,6,6,7,1,2,2,1,2,2,0,20
8155,791658,12,0,0,0,0,0,0,0,0,0,3,0,1,0,0,0,0
8155,785658,11,0,1,0,0,0,1,2,2,0,1,2,3,1,0,0,2
8155,791660,27,3,7,2,4,1,3,1,1,0,1,7,0,0,2,1,8
8156,792208,36,9,14,8,12,1,2,2,4,0,8,2,3,1,4,0,21
8156,797861,30,6,12,5,11,1,1,2,3,2,6,2,5,1,4,0,15
8156,781314,37,3,12,1,5,2,7,6,6,1,3,4,3,1,2,0,14
8156,797859,27,4,9,3,5,1,4,1,1,2,1,5,4,1,1,0,10
8156,786262,32,3,4,0,0,3,4,0,0,0,2,1,1,2,0,0,9
8156,792204,15,1,3,1,2,0,1,4,4,0,0,0,2,2,2,0,6
8156,776018,14,1,4,1,4,0,0,0,0,1,3,0,3,0,0,0,2
8156,781317,9,0,0,0,0,0,0,0,0,0,1,3,1,0,0,0,0
8157,786311,37,7,20,5,9,2,11,4,4,0,0,3,2,1,3,0,20
8157,780201,34,5,7,5,7,0,0,4,6,2,6,1,4,1,5,1,14
8157,791469,40,5,9,5,9,0,0,0,0,2,10,1,4,0,1,4,10
8157,791467,16,1,5,0,1,1,4,0,0,1,1,2,1,0,0,0,3
8157,775516,13,0,2,0,1,0,1,0,0,1,2,3,2,0,1,0,0
8157,797210,29,3,9,3,9,0,0,7,7,1,1,4,4,1,1,0,13
8157,798344,18,3,3,3,3,0,0,0,2,2,3,0,0,2,0,0,6
8157,791471,9,0,2,0,1,0,1,2,2,0,1,0,1,0,0,0,2
8157,791470,4,0,0,0,0,0,0,0,0,0,0,0,1,0,1,0,0
8158,780686,37,9,16,9,16,0,0,5,6,1,7,1,4,3,5,0,23
8158,780683,25,3,5,3,5,0,0,0,0,1,10,0,4,0,5,1,6
8158,797681,33,5,11,4,7,1,4,3,3,0,4,1,3,2,2,0,14
8158,786112,28,3,10,3,6,0,4,8,10,0,1,2,0,0,2,0,14
8158,780688,34,3,5,1,1,2,4,3,3,0,3,1,3,3,2,0,11
8158,797683,2,0,0,0,0,0,0,1,2,0,0,0,0,0,0,0,1
8158,797682,4,0,0,0,0,0,0,0,0,0,1,0,1,0,0,0,0
8158,797680,15,1,3,1,3,0,0,0,0,0,3,1,2,0,0,0,2
8158,791942,11,1,1,1,1,0,0,0,0,0,0,2,3,0,2,0,2
8158,780689,11,1,1,1,1,0,0,2,2,0,1,0,2,0,0,0,4
8159,775110,37,7,13,7,13,0,0,7,9,7,8,1,2,0,2,2,21
8159,791392,37,1,3,1,3,0,0,1,3,0,5,4,5,3,3,0,3
8159,785936,31,3,7,1,4,2,3,8,8,2,3,1,1,2,1,1,16
8159,780128,29,1,10,0,1,1,9,0,0,0,1,4,4,2,4,0,3
8159,775458,36,8,20,7,15,1,5,7,10,1,2,2,4,1,2,1,24
8159,797134,3,0,0,0,0,0,0,0,0,0,0,0,1,0,0,0,0
8159,797138,14,0,4,0,1,0,3,0,0,0,1,1,4,3,2,0,0
8159,785264,13,1,5,0,2,1,3,0,0,0,1,0,0,0,1,0,3
8160,792183,40,10,14,6,6,4,8,5,6,1,7,11,2,2,6,0,29
8160,792186,23,7,11,7,11,0,0,0,0,1,3,1,4,1,1,0,14
8160,781447,20,1,2,1,2,0,0,4,4,0,2,0,5,0,3,1,6
8160,792188,20,0,4,0,1,0,3,1,4,1,1,0,4,0,2,0,1
8160,797819,8,0,1,0,1,0,0,0,0,0,1,0,0,0,0,0,0
8160,780433,14,3,6,3,6,0,0,1,2,0,1,0,4,0,2,1,7
8160,781490,30,2,3,0,1,2,2,0,0,0,2,4,4,2,0,0,6
8160,792187,17,2,2,1,1,1,1,0,0,0,1,2,2,0,2,0,5
8160,797821,15,2,6,1,3,1,3,0,2,0,4,1,3,0,0,0,5
8160,786675,11,1,2,0,1,1,1,0,0,0,0,0,0,0,1,0,3
8160,796255,2,0,0,0,0,0,0,0,0,0,0,0,0,0,0,0,0
8161,776297,40,6,15,5,10,1,5,6,6,0,3,1,4,1,4,0,19
8161,797247,35,6,11,3,6,3,5,3,6,0,0,5,2,0,1,1,18
8161,797251,31,5,8,4,6,1,2,3,6,2,4,2,0,2,1,0,14
8161,780455,29,6,8,6,8,0,0,2,7,1,8,1,2,0,1,3,14
8161,791352,29,4,6,3,3,1,3,1,1,5,1,1,3,0,5,0,10
8161,785837,12,1,4,1,2,0,2,0,0,1,1,1,4,0,0,0,2
8161,797248,12,0,0,0,0,0,0,0,0,0,1,0,1,1,1,0,0
8161,791354,5,0,1,0,1,0,0,0,2,1,1,1,0,0,1,0,0
8161,797249,3,0,0,0,0,0,0,0,0,0,0,0,0,0,1,0,0
8161,797255,2,0,0,0,0,0,0,0,0,0,1,0,0,0,1,0,0
8161,797250,1,0,0,0,0,0,0,0,0,0,0,0,1,0,1,0,0
8161,791355,1,0,0,0,0,0,0,0,0,0,1,0,0,0,0,0,0
8162,786039,40,5,10,5,10,0,0,2,6,5,7,0,3,1,0,3,12
8162,792043,28,5,7,2,3,3,4,2,3,3,2,1,5,0,1,0,15
8162,786266,48,5,24,1,10,4,14,0,0,0,7,1,1,1,0,2,14
8162,792040,39,8,14,7,12,1,2,5,7,2,3,1,0,0,2,0,22
8162,775028,49,9,20,8,14,1,6,2,2,2,3,13,3,1,0,0,21
8162,797728,13,1,4,0,3,1,1,0,0,0,2,1,2,0,2,1,3
8162,797726,17,1,5,1,5,0,0,0,0,2,3,1,1,2,2,0,2
8162,797719,4,0,0,0,0,0,0,0,2,0,0,0,1,0,0,0,0
8162,797718,12,0,1,0,1,0,0,0,0,0,0,1,2,1,1,0,0
8163,797529,37,6,11,5,7,1,4,3,4,1,6,0,5,2,1,2,16
8163,797527,48,6,13,6,13,0,0,5,6,7,5,2,2,0,1,2,17
8163,791936,43,11,14,11,14,0,0,2,3,2,10,2,0,0,3,2,24
8163,797532,45,3,16,1,9,2,7,6,6,0,7,15,2,0,4,0,14
8163,785688,35,2,8,1,2,1,6,0,0,0,4,0,4,1,2,0,5
8163,791932,7,0,2,0,1,0,1,0,0,0,0,1,2,1,0,0,0
8163,791933,10,2,3,0,0,2,3,0,0,0,0,0,1,1,1,0,6
8163,785988,25,1,5,0,1,1,4,2,4,0,6,1,1,0,2,0,5
8164,780521,29,4,9,0,1,4,8,0,0,1,6,0,5,1,1,0,12
8164,775163,10,1,1,1,1,0,0,1,2,0,1,0,1,0,1,0,3
8164,791370,30,1,5,0,0,1,5,0,0,0,3,2,4,1,1,0,3
8164,786199,37,4,10,2,4,2,6,0,2,0,4,4,1,0,3,0,10
8164,780991,34,8,10,7,8,1,2,0,0,0,0,3,2,1,4,0,17
8164,780145,14,0,0,0,0,0,0,0,0,1,1,0,4,0,0,0,0
8164,781611,14,0,1,0,1,0,0,0,2,1,2,0,3,0,2,0,0
8164,797271,20,2,5,0,1,2,4,4,4,0,4,0,3,1,1,0,10
8164,743593,8,0,2,0,2,0,0,0,0,1,0,0,0,0,2,0,0
8164,791371,4,0,1,0,1,0,0,0,0,0,0,0,0,0,0,0,0
8165,785681,4,0,0,0,0,0,0,0,0,0,0,1,0,0,0,0,0
8165,796789,31,5,12,3,5,2,7,1,2,0,1,1,3,0,1,0,13
8165,791126,37,7,12,7,12,0,0,4,8,2,4,0,1,1,1,0,18
8165,791124,28,2,5,1,2,1,3,0,0,0,0,4,1,2,2,0,5
8165,780050,37,4,11,4,9,0,2,8,10,2,8,4,2,0,1,0,16
8165,784479,3,0,1,0,0,0,1,0,0,0,0,0,0,0,0,0,0
8165,796786,3,0,2,0,1,0,1,0,0,0,0,0,0,0,0,0,0
8165,775813,33,3,4,3,4,0,0,5,7,2,4,0,2,0,1,0,11
8165,796784,7,0,2,0,1,0,1,0,0,0,0,0,0,0,0,0,0
8165,796783,0,0,0,0,0,0,0,0,0,0,0,0,2,0,0,0,0
8165,796782,7,0,1,0,0,0,1,0,0,0,1,0,0,0,0,0,0
8165,792711,10,2,2,2,2,0,0,0,0,1,2,0,1,1,0,0,4
8166,791257,18,1,3,1,3,0,0,1,3,3,6,0,4,1,3,1,3
8166,791838,28,3,7,2,3,1,4,2,2,1,2,0,2,1,1,1,9
8166,786620,38,5,14,4,11,1,3,5,5,1,5,1,1,0,0,0,16
8166,781606,24,3,7,3,6,0,1,1,2,0,3,2,3,1,0,0,7
8166,781257,31,1,9,1,7,0,2,0,0,1,5,3,1,2,3,0,2
8166,796955,19,5,8,5,8,0,0,0,0,4,4,0,4,0,2,0,10
8166,791255,9,0,0,0,0,0,0,0,1,0,0,0,3,0,0,0,0
8166,780900,4,1,3,1,3,0,0,0,0,2,0,0,1,0,0,0,2
8166,781263,29,6,10,6,10,0,0,5,7,1,1,0,3,2,1,0,17
8167,791067,30,3,8,2,6,1,2,2,3,5,5,4,3,0,1,1,9
8167,780751,9,0,3,0,1,0,2,0,1,0,1,1,4,0,1,0,0
8167,796743,29,0,6,0,1,0,5,0,0,0,2,1,3,0,1,0,0
8167,791068,20,4,6,2,2,2,4,0,0,0,1,0,1,0,2,0,10
8167,785551,33,2,8,2,7,0,1,1,2,1,3,0,2,0,2,0,5
8167,785642,8,0,2,0,2,0,0,0,0,0,1,0,0,0,1,0,0
8167,780512,27,5,8,5,6,0,2,4,5,1,5,0,2,0,3,0,14
8167,780756,3,0,0,0,0,0,0,2,2,0,0,0,1,1,0,0,2
8167,796744,2,0,0,0,0,0,0,0,0,0,1,0,0,0,0,0,0
8167,791066,28,5,12,3,8,2,4,1,2,0,1,2,2,0,2,0,13
8167,791065,11,0,3,0,1,0,2,0,0,0,1,1,2,0,0,0,0
8168,781007,15,0,2,0,2,0,0,0,0,1,2,1,4,1,2,1,0
8168,781322,18,2,7,2,3,0,4,0,0,0,3,0,2,0,1,0,4
8168,785989,19,1,3,1,2,0,1,0,0,1,5,2,0,0,0,1,2
8168,786571,31,3,5,1,3,2,2,1,2,0,2,3,1,0,2,0,9
8168,781439,19,3,10,3,7,0,3,0,2,0,1,2,0,0,2,0,6
8168,781207,21,3,6,2,3,1,3,3,4,1,5,0,0,1,2,0,10
8168,780563,22,3,6,0,0,3,6,0,0,0,4,4,2,1,1,2,9
8168,781419,24,3,11,0,3,3,8,0,0,0,1,1,0,0,0,0,9
8168,791690,20,3,8,3,8,0,0,1,4,4,4,1,2,1,1,0,7
8168,797299,6,1,3,1,3,0,0,0,2,1,0,0,2,0,0,0,2
8168,797300,1,0,1,0,1,0,0,0,0,0,0,0,0,1,0,0,0
8168,784248,3,0,1,0,0,0,1,0,0,0,0,0,0,0,0,0,0
8168,791691,1,0,0,0,0,0,0,0,0,0,0,0,0,0,0,0,0
8169,790839,21,1,3,1,3,0,0,1,2,3,4,1,4,0,1,0,3
8169,785388,21,4,8,4,8,0,0,1,4,2,1,0,0,0,2,2,9
8169,790840,24,4,10,2,2,2,8,0,0,1,6,3,1,1,2,0,10
8169,796395,31,6,12,4,5,2,7,1,1,2,5,3,2,3,4,2,15
8169,785386,27,3,8,3,6,0,2,0,0,0,2,4,2,2,1,0,6
8169,796393,19,4,6,4,6,0,0,0,0,1,4,2,1,0,0,0,8
8169,780370,16,3,4,2,2,1,2,0,1,1,5,0,2,1,2,0,7
8169,790841,14,1,5,0,0,1,5,0,0,0,2,2,3,0,0,0,3
8169,780373,24,4,8,0,0,4,8,2,2,0,4,1,0,1,0,0,14
8169,796396,3,0,0,0,0,0,0,0,0,0,1,0,0,0,1,0,0
8170,790856,18,7,8,7,8,0,0,0,0,2,7,1,3,1,0,0,14
8170,780452,26,5,7,5,7,0,0,2,7,1,3,2,2,1,0,1,12
8170,796413,24,7,10,2,3,5,7,0,0,1,1,4,1,1,3,1,19
8170,796408,27,4,8,3,4,1,4,0,0,0,2,3,1,2,4,1,9
8170,796407,22,0,3,0,1,0,2,0,0,0,7,4,1,1,1,0,0
8170,796411,12,4,6,4,6,0,0,2,4,2,2,3,2,2,1,2,10
8170,796410,17,10,14,10,14,0,0,1,5,8,3,1,1,1,1,2,21
8170,790858,11,2,3,2,3,0,0,2,2,0,0,3,1,1,0,0,6
8170,796409,18,2,5,0,1,2,4,0,0,0,0,3,1,0,1,0,6
8170,780450,14,0,1,0,0,0,1,0,0,1,2,5,0,1,0,1,0
8170,781286,3,0,0,0,0,0,0,0,0,0,1,0,0,0,0,0,0
8170,796414,2,1,1,1,1,0,0,0,0,0,0,0,0,0,0,0,2
8170,775941,3,0,2,0,2,0,0,0,0,0,1,0,0,0,0,0,0
8170,798137,3,0,1,0,1,0,0,0,0,1,0,0,0,0,0,0,0
8171,791534,20,2,6,2,5,0,1,0,0,6,2,0,3,0,2,0,4
8171,797127,20,1,2,1,1,0,1,2,2,1,0,0,2,0,0,0,4
8171,791533,30,4,14,3,10,1,4,0,0,6,4,2,1,0,4,0,9
8171,791528,33,3,13,3,10,0,3,0,1,0,3,4,2,2,4,0,6
8171,775045,26,6,15,6,13,0,2,1,1,0,1,0,2,4,2,0,13
8171,797124,15,2,3,2,3,0,0,2,4,1,2,0,1,0,0,0,6
8171,791531,19,2,4,2,2,0,2,2,2,0,2,0,3,1,1,0,6
8171,797129,8,0,2,0,2,0,0,2,2,1,0,0,2,0,1,1,2
8171,780301,17,2,6,2,4,0,2,0,0,0,3,1,2,1,1,0,4
8171,774880,12,0,2,0,1,0,1,0,0,0,0,1,0,1,1,1,0
8172,786197,20,3,4,3,4,0,0,0,0,2,4,0,5,0,2,0,6
8172,780717,29,8,16,6,12,2,4,8,9,2,7,3,4,1,0,0,26
8172,791742,31,4,10,2,5,2,5,7,8,0,3,1,4,2,2,2,17
8172,791741,29,3,6,1,2,2,4,2,4,0,2,1,5,0,3,0,10
8172,776266,37,5,8,5,6,0,2,6,8,1,1,5,1,0,2,0,16
8172,774859,2,0,1,0,1,0,0,0,0,0,0,0,1,0,0,0,0
8172,776328,11,0,2,0,2,0,0,0,0,0,2,0,1,0,0,1,0
8172,791738,18,2,2,2,2,0,0,4,6,2,2,0,3,1,2,0,8
8172,797334,3,0,1,0,1,0,0,0,1,0,0,0,0,0,1,0,0
8172,791740,18,1,5,0,0,1,5,0,0,0,1,6,1,0,1,0,3
8172,797337,2,0,0,0,0,0,0,0,0,0,0,0,0,0,0,0,0
8173,791997,39,6,13,3,5,3,8,3,4,2,7,2,4,0,1,0,18
8173,786566,26,4,7,4,5,0,2,3,4,1,3,1,4,1,2,0,11
8173,786568,16,2,3,2,3,0,0,1,4,0,4,0,4,0,2,2,5
8173,791993,37,3,9,2,6,1,3,2,4,0,1,4,3,1,1,0,9
8173,781188,40,9,14,7,9,2,5,6,8,1,2,6,5,0,3,1,26
8173,797493,4,0,1,0,1,0,0,0,0,0,3,0,2,0,0,0,0
8173,786562,15,3,3,2,2,1,1,2,2,1,0,1,2,1,2,0,9
8173,781189,23,0,5,0,3,0,2,4,4,3,2,3,4,1,1,0,4
8174,786132,16,1,2,1,2,0,0,1,2,2,1,0,1,0,1,3,3
8174,775074,26,3,4,3,4,0,0,0,0,2,1,1,3,0,2,1,6
8174,786448,18,2,4,1,1,1,3,2,2,1,0,2,4,1,2,0,7
8174,780731,34,4,11,4,9,0,2,0,0,0,4,2,0,0,2,0,8
8174,780462,38,1,15,1,9,0,6,2,2,1,2,2,2,1,3,0,4
8174,786447,30,4,8,3,6,1,2,4,4,4,2,3,4,1,3,1,13
8174,791631,16,3,6,2,3,1,3,0,0,0,0,0,2,0,0,0,7
8174,796971,11,2,3,1,2,1,1,0,1,1,2,0,0,1,1,0,5
8174,791632,4,0,0,0,0,0,0,0,0,0,1,0,0,0,0,0,0
8174,776365,7,1,2,0,0,1,2,0,0,0,1,0,1,0,0,0,3
8175,796401,31,1,2,1,1,0,1,0,0,0,3,3,4,1,2,0,2
8175,785999,30,4,6,4,6,0,0,4,6,2,4,2,1,1,2,0,12
8175,775654,30,4,9,4,9,0,0,1,1,4,3,0,3,0,0,2,9
8175,791639,32,6,13,4,10,2,3,3,3,0,3,0,0,2,2,0,17
8175,785389,34,6,12,6,8,0,4,4,4,0,3,6,1,2,3,0,16
8175,785255,10,2,3,2,3,0,0,0,0,0,0,1,3,0,4,0,4
8175,796398,4,0,0,0,0,0,0,0,0,1,2,0,0,0,0,0,0
8175,796399,21,2,3,2,3,0,0,2,3,0,2,2,3,2,1,0,6
8175,775171,2,0,0,0,0,0,0,0,1,0,0,1,0,0,0,0,0
8175,791640,6,0,1,0,0,0,1,0,0,0,0,0,0,0,0,0,0
8176,781516,14,2,6,2,6,0,0,4,4,3,4,0,1,0,0,2,8
8176,797331,34,6,12,4,6,2,6,2,3,3,3,6,2,1,2,0,16
8176,791737,33,3,6,2,4,1,2,1,2,0,10,7,1,2,4,0,8
8176,783524,33,6,8,2,3,4,5,2,4,0,2,7,1,0,3,0,18
8176,780561,22,5,8,0,1,5,7,0,0,2,4,0,3,0,7,0,15
8176,791734,15,1,2,1,2,0,0,0,0,1,2,2,1,0,1,0,2
8176,791736,2,1,2,0,1,1,1,0,0,0,0,0,0,0,1,0,3
8176,797332,7,2,4,2,4,0,0,0,0,1,1,0,1,1,1,0,4
8176,797333,20,3,6,2,2,1,4,0,0,0,3,1,4,0,1,1,7
8176,795372,2,0,0,0,0,0,0,0,0,0,1,0,0,0,1,0,0
8176,786223,18,6,6,6,6,0,0,1,1,1,3,3,1,2,2,0,13
8177,791230,22,7,10,2,3,5,7,0,0,0,2,1,0,1,0,3,19
8177,785557,22,2,9,1,8,1,1,0,0,2,0,0,5,0,3,0,5
8177,791228,32,6,10,3,6,3,4,3,4,2,0,1,1,0,2,1,18
8177,796932,23,3,11,3,9,0,2,0,0,0,1,2,1,0,3,0,6
8177,785624,19,0,3,0,0,0,3,2,2,1,3,4,0,2,1,0,2
8177,796935,14,0,7,0,2,0,5,0,0,0,0,0,2,0,0,1,0
8177,796933,22,3,6,3,5,0,1,4,9,5,2,1,2,2,0,0,10
8177,791226,7,0,1,0,1,0,0,0,0,1,0,0,1,0,1,0,0
8177,791229,1,0,0,0,0,0,0,0,0,0,0,0,0,0,0,0,0
8177,791227,22,3,9,1,4,2,5,2,2,0,3,3,2,1,2,1,10
8177,781201,16,1,3,1,3,0,0,0,0,0,0,0,1,1,1,1,2
8178,796837,39,5,14,2,9,3,5,3,4,2,5,0,1,1,0,0,16
8178,796833,29,1,5,0,1,1,4,0,0,0,1,0,0,2,0,0,3
8178,785706,22,1,8,0,3,1,5,0,0,1,3,1,1,0,1,0,3
8178,785700,43,8,12,6,6,2,6,0,1,3,13,10,1,5,3,1,18
8178,780269,35,11,24,8,16,3,8,3,5,0,1,2,0,1,4,0,28
8178,796838,14,2,3,2,3,0,0,0,0,1,2,0,4,0,1,1,4
8178,791171,8,0,0,0,0,0,0,0,0,1,0,0,2,0,1,0,0
8178,796834,35,4,6,1,2,3,4,5,6,4,4,1,1,1,1,0,16
8179,791760,31,2,8,2,8,0,0,1,2,3,4,1,2,0,2,0,5
8179,780256,31,7,12,3,5,4,7,4,6,3,6,1,1,2,4,1,22
8179,796879,37,5,11,4,6,1,5,4,4,1,2,6,3,1,2,0,15
8179,796880,37,4,10,1,3,3,7,0,0,1,6,1,2,0,2,0,11
8179,791757,42,5,13,1,6,4,7,1,2,1,3,3,2,1,1,0,15
8179,785874,12,3,5,3,5,0,0,0,0,2,1,0,1,0,0,0,6
8179,796885,11,0,3,0,2,0,1,1,2,1,1,1,1,0,2,0,1
8179,796883,8,1,2,0,0,1,2,0,0,0,0,2,1,0,0,0,3
8179,781590,16,1,5,1,5,0,0,0,0,0,2,0,2,0,1,0,2
8180,792388,11,1,2,1,2,0,0,0,0,0,1,0,5,0,0,0,2
8180,797845,20,0,0,0,0,0,0,0,0,0,0,0,2,0,1,0,0
8180,797851,34,4,11,1,7,3,4,2,2,1,3,1,0,0,1,0,13
8180,792391,33,5,7,5,7,0,0,4,5,5,7,2,3,3,1,1,14
8180,792395,29,6,12,3,7,3,5,0,0,3,7,0,3,1,5,1,15
8180,781533,29,1,9,0,0,1,9,0,0,0,0,1,4,0,1,2,3
8180,792393,31,7,11,6,10,1,1,5,5,1,6,5,1,1,2,0,20
8180,792394,13,0,3,0,1,0,2,0,0,0,4,0,2,0,2,0,0
8181,785884,28,2,5,2,5,0,0,5,6,3,1,1,3,0,0,0,9
8181,786131,26,4,10,3,7,1,3,1,2,1,4,1,1,2,4,1,10
8181,780904,22,0,5,0,5,0,0,0,3,4,3,1,1,2,0,2,0
8181,797685,35,2,9,2,6,0,3,6,6,0,2,1,2,0,2,0,10
8181,786128,35,3,14,3,9,0,5,3,3,1,4,3,1,1,2,0,9
8181,797684,2,1,1,1,1,0,0,0,0,1,1,0,0,0,0,0,2
8181,792100,15,3,5,3,5,0,0,0,0,2,6,0,2,1,0,0,6
8181,797686,15,0,1,0,0,0,1,4,6,0,0,1,2,0,0,0,4
8181,792099,2,0,0,0,0,0,0,2,2,1,0,0,0,0,0,0,2
8181,792096,8,0,3,0,0,0,3,0,0,0,1,0,0,0,0,0,0
8181,786145,11,0,3,0,1,0,2,0,0,0,0,0,2,0,1,0,0
8181,786141,1,0,0,0,0,0,0,0,0,0,0,0,0,0,0,0,0
8182,791281,31,7,9,6,7,1,2,1,2,2,2,2,3,1,5,0,16
8182,792276,31,1,5,0,2,1,3,0,0,0,0,4,3,2,2,0,3
8182,791278,19,0,0,0,0,0,0,0,1,1,0,2,3,0,1,0,0
8182,786026,36,7,19,6,13,1,6,2,5,4,3,0,0,1,2,0,17
8182,785507,19,0,4,0,0,0,4,2,2,0,4,1,2,0,0,0,2
8182,796534,18,2,3,1,1,1,2,0,0,0,0,0,1,0,0,0,5
8182,785764,12,2,4,2,3,0,1,0,1,1,1,0,1,0,1,0,4
8182,796536,12,0,0,0,0,0,0,3,4,2,0,0,2,0,0,1,3
8182,796535,10,0,2,0,1,0,1,0,1,0,1,0,2,0,3,0,0
8182,785398,12,3,5,2,4,1,1,0,0,1,1,0,2,0,1,0,7
8183,786157,17,1,1,1,1,0,0,1,2,0,1,0,4,0,0,0,3
8183,780676,35,5,9,5,8,0,1,3,3,0,5,0,2,3,1,0,13
8183,791756,26,2,8,2,6,0,2,4,5,0,3,2,3,1,2,0,8
8183,780992,25,5,7,2,4,3,3,0,0,0,0,1,2,1,3,0,13
8183,780677,25,5,5,1,1,4,4,0,1,1,7,1,1,2,0,0,14
8183,791754,12,3,4,3,3,0,1,1,2,1,1,0,0,0,0,1,7
8183,786150,7,1,1,1,1,0,0,2,2,0,0,0,2,0,0,0,4
8183,775533,20,1,2,1,2,0,0,2,2,0,1,1,2,0,2,2,4
8183,797348,18,1,3,1,3,0,0,4,7,0,1,2,3,2,1,0,6
8183,780673,15,1,1,0,0,1,1,0,0,0,1,0,1,0,1,0,3
8184,792131,21,1,6,1,4,0,2,0,0,2,4,2,4,3,3,0,2
8184,786838,34,5,7,5,7,0,0,5,11,2,3,1,3,2,3,1,15
8184,797736,16,0,2,0,1,0,1,2,2,1,0,0,2,0,2,0,2
8184,792132,33,1,5,1,4,0,1,0,0,0,3,2,3,2,3,0,2
8184,792127,33,4,12,4,7,0,5,4,5,1,6,3,3,0,1,0,12
8184,792128,24,1,3,1,1,0,2,2,2,2,7,0,4,0,3,1,4
8184,797739,3,0,1,0,1,0,0,0,0,0,0,0,0,1,1,0,0
8184,792126,28,4,10,1,3,3,7,2,2,0,5,0,4,0,3,0,13
8184,791668,7,0,1,0,1,0,0,0,0,0,0,0,1,0,0,0,0
8184,799908,1,0,0,0,0,0,0,0,0,0,0,0,0,0,0,0,0
8185,791564,29,3,8,2,3,1,5,0,1,1,4,0,4,0,3,0,7
8185,775549,22,6,10,6,10,0,0,3,5,1,5,0,5,0,3,1,15
8185,797056,29,1,5,1,3,0,2,4,5,0,8,3,2,0,1,0,6
8185,791568,14,0,1,0,1,0,0,0,0,0,2,0,2,0,0,1,0
8185,797055,32,3,10,2,7,1,3,1,2,1,2,1,0,1,5,0,8
8185,797058,18,1,2,0,0,1,2,7,8,1,1,0,2,1,0,0,10
8185,791566,11,0,0,0,0,0,0,0,4,2,1,0,3,1,2,0,0
8185,797054,21,2,6,1,3,1,3,0,0,0,0,3,1,3,2,0,5
8185,786381,24,0,2,0,0,0,2,0,0,0,1,1,3,3,1,2,0
8186,792340,23,6,12,6,12,0,0,1,1,1,4,0,5,0,3,1,13
8186,792342,40,6,11,2,4,4,7,7,8,1,2,0,1,0,0,0,23
8186,792346,26,5,8,4,6,1,2,3,5,2,5,1,3,1,0,0,14
8186,781553,18,0,2,0,1,0,1,1,2,2,5,3,5,1,1,0,1
8186,781552,36,5,14,3,9,2,5,4,5,1,1,8,2,3,2,1,16
8186,792345,31,2,4,2,4,0,0,3,4,2,5,1,3,0,3,0,7
8186,798080,17,2,3,0,0,2,3,0,0,0,1,1,2,0,0,1,6
8186,792344,9,0,0,0,0,0,0,0,0,1,0,0,4,0,0,0,0
8187,796860,34,8,11,8,10,0,1,3,6,2,0,1,2,1,2,1,19
8187,791187,14,2,8,2,8,0,0,2,3,4,1,2,3,0,1,0,6
8187,796856,28,1,2,0,0,1,2,3,6,0,5,1,3,0,2,0,6
8187,785650,20,0,1,0,0,0,1,0,0,0,1,2,0,0,2,0,0
8187,785649,38,7,15,6,8,1,7,3,3,0,5,3,4,1,2,0,18
8187,791183,2,0,0,0,0,0,0,0,0,0,0,0,2,1,0,0,0
8187,791185,24,1,4,0,2,1,2,2,4,1,4,1,1,0,1,1,5
8187,775208,4,2,2,2,2,0,0,0,1,0,0,0,1,0,1,0,4
8187,791184,23,3,4,3,3,0,1,3,4,1,0,3,2,0,0,0,9
8187,796861,13,1,2,1,1,0,1,0,0,0,2,0,1,0,0,0,2
8188,780913,35,5,9,1,2,4,7,2,2,0,1,1,3,0,0,0,16
8188,798119,20,1,6,1,5,0,1,0,1,0,1,0,0,0,1,0,2
8188,798117,40,2,3,2,2,0,1,1,2,0,3,5,3,3,4,0,5
8188,780594,42,8,15,2,4,6,11,3,3,0,2,5,3,0,3,0,25
8188,775664,40,3,8,0,2,3,6,2,2,1,2,1,0,1,0,1,11
8188,798123,14,6,8,4,5,2,3,2,2,0,3,1,5,0,3,1,16
8188,798124,13,2,4,2,4,0,0,0,0,0,2,3,0,0,0,0,4
8188,798121,21,1,4,1,3,0,1,2,2,0,5,1,2,0,0,0,4
8189,776344,32,9,13,9,12,0,1,1,5,2,3,2,2,0,3,0,19
8189,775821,21,3,8,2,6,1,2,0,0,2,3,0,3,0,1,0,7
8189,792453,40,8,11,8,11,0,0,3,4,0,3,6,2,1,2,0,19
8189,785131,24,4,9,3,5,1,4,0,0,3,5,2,3,0,2,0,9
8189,781538,38,1,6,1,2,0,4,0,0,0,4,2,1,3,1,1,2
8189,798113,17,4,5,4,5,0,0,1,3,1,4,1,2,1,1,1,9
8189,785152,11,0,0,0,0,0,0,0,0,0,3,1,0,0,1,0,0
8189,798115,21,3,9,0,2,3,7,0,0,1,2,0,1,0,0,0,9
8189,792324,5,1,1,1,1,0,0,1,1,0,0,0,0,0,0,0,3
8189,776233,16,2,3,1,1,1,2,0,0,0,1,1,4,0,1,0,5
8190,790798,22,7,8,7,7,0,1,7,7,4,4,1,1,0,1,1,21
8190,780140,27,6,13,6,9,0,4,4,5,3,5,3,2,3,1,1,16
8190,796355,28,7,14,7,11,0,3,3,5,1,6,1,1,0,4,0,17
8190,785245,21,5,8,4,6,1,2,1,1,0,0,2,2,3,0,0,12
8190,780137,27,2,5,2,5,0,0,2,2,1,5,1,1,1,2,0,6
8190,790799,13,3,5,3,5,0,0,1,1,0,0,1,1,2,1,1,7
8190,775553,19,2,4,2,3,0,1,2,3,0,6,0,2,3,2,0,6
8190,796354,12,2,3,1,1,1,2,1,1,1,3,1,0,1,1,0,6
8190,796359,8,3,4,1,2,2,2,0,0,0,0,0,1,1,0,0,8
8190,799892,7,2,5,2,3,0,2,0,0,2,2,0,2,0,0,0,4
8190,790796,4,0,0,0,0,0,0,0,0,1,0,0,2,0,1,0,0
8190,790800,3,1,1,0,0,1,1,0,0,0,0,0,1,0,0,0,3
8190,794905,3,0,1,0,0,0,1,0,0,0,0,0,1,0,0,0,0
8190,790795,3,0,1,0,1,0,0,0,0,0,0,0,0,0,1,0,0
8190,788844,3,0,0,0,0,0,0,0,0,0,0,0,0,0,0,0,0
8191,785987,21,0,6,0,2,0,4,0,3,1,1,3,1,1,1,0,0
8191,776037,27,6,9,5,7,1,2,0,1,0,1,1,1,0,0,0,13
8191,780588,15,3,5,3,5,0,0,1,2,1,3,0,3,1,2,1,7
8191,786147,16,0,1,0,0,0,1,0,0,0,2,0,4,0,0,0,0
8191,780667,23,4,11,2,7,2,4,0,0,0,2,1,2,1,2,0,10
8191,782643,18,4,6,4,6,0,0,0,0,3,4,1,1,1,5,1,8
8191,775680,22,1,9,0,4,1,5,0,3,0,3,0,3,1,2,0,3
8191,781647,17,3,8,3,5,0,3,4,4,0,2,1,0,2,0,1,10
8191,791759,20,5,7,5,7,0,0,0,0,0,0,3,2,0,3,0,10
8191,792562,16,2,2,1,1,1,1,3,4,1,2,1,2,0,2,0,8
8191,797354,2,0,0,0,0,0,0,0,0,0,0,0,0,0,0,0,0
8191,791758,3,0,0,0,0,0,0,0,0,0,0,0,0,0,0,0,0
8192,785916,10,0,2,0,1,0,1,2,2,0,0,1,4,0,1,0,2
8192,780106,21,3,4,3,4,0,0,0,0,3,6,0,2,0,1,0,6
8192,780105,34,2,9,1,7,1,2,1,2,1,3,2,2,1,1,1,6
8192,785915,29,3,9,0,0,3,9,0,0,0,2,1,2,0,0,0,9
8192,781131,33,4,15,4,14,0,1,3,5,0,6,5,1,0,2,0,11
8192,791408,18,5,7,5,7,0,0,0,0,3,0,1,3,0,1,0,10
8192,785637,32,4,7,1,2,3,5,1,1,0,3,6,3,0,0,0,12
8192,785894,23,1,5,0,0,1,5,0,0,1,1,0,1,0,0,0,3
8193,796650,33,8,13,8,12,0,1,3,5,4,6,1,1,0,0,1,19
8193,791321,27,3,5,3,5,0,0,0,0,0,0,1,0,0,1,4,6
8193,791323,28,1,3,1,1,0,2,0,0,0,5,3,3,1,0,3,2
8193,791320,39,9,20,9,18,0,2,2,2,1,6,1,2,0,1,0,20
8193,781511,29,6,12,4,7,2,5,4,4,2,3,2,3,1,1,0,18
8193,796653,13,0,1,0,0,0,1,0,0,2,1,0,1,0,0,0,0
8193,785912,21,0,5,0,3,0,2,1,2,0,1,3,0,1,0,0,1
8193,796656,10,1,2,1,2,0,0,1,2,1,0,1,1,0,0,0,3
8194,791669,15,2,4,2,4,0,0,0,0,1,3,2,0,0,2,1,4
8194,785762,21,3,5,3,5,0,0,2,2,1,1,2,3,2,0,1,8
8194,797407,13,0,1,0,1,0,0,0,0,0,2,1,5,0,2,0,0
8194,791666,27,3,8,1,3,2,5,3,4,1,2,3,1,2,0,0,11
8194,780531,28,9,12,2,3,7,9,4,4,0,1,1,0,1,1,1,29
8194,797414,13,0,0,0,0,0,0,0,1,2,1,0,1,0,0,1,0
8194,797411,6,0,0,0,0,0,0,0,0,0,1,0,1,0,1,0,0
8194,780534,21,4,4,4,4,0,0,4,4,2,5,0,1,2,3,1,12
8194,797409,22,6,8,4,4,2,4,0,0,0,2,4,1,1,3,0,14
8194,791671,1,1,2,0,0,1,2,0,0,0,0,0,0,0,0,0,3
8194,797415,10,0,2,0,0,0,2,1,2,0,0,1,3,0,0,0,1
8194,785760,14,2,4,1,1,1,3,0,1,0,1,2,4,1,1,0,5
8194,780535,9,1,3,1,2,0,1,0,0,0,1,1,0,0,0,0,2
8195,791723,20,1,4,1,4,0,0,5,6,1,1,1,3,0,2,0,7
8195,797310,24,3,7,1,2,2,5,2,3,0,4,2,0,2,2,0,10
8195,791724,33,4,8,4,5,0,3,2,5,2,3,1,2,1,5,0,10
8195,797308,22,2,6,0,1,2,5,2,2,0,1,0,2,0,1,0,8
8195,781617,32,2,11,0,6,2,5,3,4,1,4,0,2,0,2,0,9
8195,797312,21,3,5,3,4,0,1,0,0,1,0,0,3,0,2,0,6
8195,786277,7,0,2,0,2,0,0,0,0,2,1,0,1,0,1,0,0
8195,800056,14,1,2,1,1,0,1,0,0,0,2,1,1,2,2,0,2
8195,780706,27,3,4,3,3,0,1,4,4,0,0,2,1,0,0,0,10
8196,781577,29,1,6,1,5,0,1,8,8,1,5,2,1,0,4,0,10
8196,775910,27,3,4,1,2,2,2,0,0,1,2,1,1,0,2,1,8
8196,786451,29,2,8,1,2,1,6,2,2,0,5,1,0,2,0,0,7
8196,780600,36,6,13,4,8,2,5,6,7,2,3,1,2,1,1,0,20
8196,781387,33,5,10,2,5,3,5,3,4,0,2,1,3,2,0,0,16
8196,791763,12,1,4,1,2,0,2,1,2,2,1,0,3,0,0,0,3
8196,790888,3,0,1,0,0,0,1,1,2,1,1,0,0,0,1,0,1
8196,786456,12,0,2,0,2,0,0,0,0,0,2,1,1,0,0,0,0
8196,797561,7,0,0,0,0,0,0,0,0,0,3,1,3,0,1,0,0
8196,780020,12,1,4,1,3,0,1,0,0,1,1,0,1,0,0,1,2
8197,781454,35,4,8,4,7,0,1,1,4,1,2,1,4,0,2,1,9
8197,786424,33,1,7,1,7,0,0,0,0,3,12,3,4,0,2,1,2
8197,792366,33,7,17,7,16,0,1,2,5,2,2,3,3,2,2,1,16
8197,791015,12,2,3,1,1,1,2,0,0,1,2,2,0,0,4,0,5
8197,785483,34,2,11,1,3,1,8,2,2,0,3,1,2,0,0,0,7
8197,785959,12,3,3,3,3,0,0,0,0,3,3,0,2,0,0,0,6
8197,797988,27,3,5,2,3,1,2,2,2,0,2,4,4,2,3,1,9
8197,797979,11,1,1,0,0,1,1,0,0,0,0,1,2,0,1,0,3
8197,775335,3,1,2,0,0,1,2,0,0,0,0,0,0,0,0,0,3
8198,796891,29,3,6,3,5,0,1,2,2,1,8,2,5,1,3,1,8
8198,796884,24,3,6,2,3,1,3,2,3,0,3,1,4,1,2,0,9
8198,796896,35,6,11,0,0,6,11,4,5,1,6,3,4,1,1,1,22
8198,796882,33,1,6,1,1,0,5,4,5,0,3,3,1,1,3,0,6
8198,790447,30,2,5,2,5,0,0,1,2,2,3,1,2,0,2,0,5
8198,796890,11,0,4,0,4,0,0,0,0,1,1,1,2,0,2,0,0
8198,796888,5,0,0,0,0,0,0,0,0,0,0,1,0,0,0,0,0
8198,796887,16,5,9,1,2,4,7,0,0,1,1,0,0,0,0,0,14
8198,796881,17,0,1,0,0,0,1,0,0,1,1,4,2,0,2,0,0
8199,791868,33,1,6,1,5,0,1,0,2,0,3,0,1,1,4,2,2
8199,797802,26,1,6,1,5,0,1,0,0,2,4,1,3,3,1,0,2
8199,797809,38,3,9,2,7,1,2,6,8,2,11,0,3,1,1,2,13
8199,797807,33,4,10,3,6,1,4,0,0,0,0,2,1,1,1,0,9
8199,786058,40,3,10,3,7,0,3,2,2,1,1,1,2,1,3,1,8
8199,795730,9,3,6,3,4,0,2,0,0,0,2,0,1,1,0,0,6
8199,797810,2,0,1,0,1,0,0,0,0,1,0,0,1,0,0,0,0
8199,781113,19,3,3,3,3,0,0,2,3,1,0,0,2,0,1,0,8
8200,786772,15,1,3,1,3,0,0,1,2,0,4,0,4,0,2,0,3
8200,781484,23,1,3,0,0,1,3,1,3,0,5,0,4,0,3,4,4
8200,786769,35,5,11,3,7,2,4,3,4,2,7,0,3,1,3,2,15
8200,780002,30,6,11,5,8,1,3,4,4,0,6,3,3,0,1,0,17
8200,776046,2,1,2,0,0,1,2,0,0,1,0,0,0,0,0,0,3
8200,786024,38,2,7,1,3,1,4,0,0,1,3,1,3,0,2,0,5
8200,791967,26,3,7,2,2,1,5,3,3,0,2,4,0,0,0,0,10
8200,790823,21,2,4,1,2,1,2,0,0,0,1,0,2,0,2,1,5
8200,785441,8,0,1,0,1,0,0,0,0,0,3,1,3,1,1,0,0
8200,786773,2,0,0,0,0,0,0,0,0,0,1,0,0,0,0,0,0
8201,791058,11,1,3,1,3,0,0,1,2,3,2,0,1,0,2,0,3
8201,791057,9,0,0,0,0,0,0,2,4,0,1,0,1,0,1,0,2
8201,796734,19,1,3,0,2,1,1,0,0,2,0,0,1,0,1,0,3
8201,785530,33,3,16,3,12,0,4,7,11,0,5,0,3,0,1,1,13
8201,775573,22,1,5,0,2,1,3,0,0,0,1,1,1,1,2,0,3
8201,785532,24,3,7,3,7,0,0,6,9,7,5,0,2,1,1,0,12
8201,780063,36,4,15,4,12,0,3,0,1,0,7,1,4,0,0,2,8
8201,791280,18,2,6,2,4,0,2,0,0,0,0,2,1,0,0,0,4
8201,775926,28,1,5,0,1,1,4,0,0,2,3,0,1,0,2,0,3
8201,791059,0,0,0,0,0,0,0,0,0,0,0,0,0,0,0,0,0
8202,786704,21,3,3,3,3,0,0,3,4,1,1,2,2,1,1,0,9
8202,785395,23,9,11,5,6,4,5,5,6,0,1,1,1,1,1,1,27
8202,775840,29,2,4,0,0,2,4,0,1,0,6,8,3,2,3,0,6
8202,775955,28,0,2,0,1,0,1,2,2,0,5,7,1,3,2,0,2
8202,775811,23,1,2,1,2,0,0,0,0,0,2,2,0,1,0,0,2
8202,792327,6,0,2,0,2,0,0,0,0,1,2,0,2,0,2,0,0
8202,786706,13,0,1,0,1,0,0,3,4,1,0,0,3,0,1,1,3
8202,786703,7,1,3,0,0,1,3,0,0,0,0,0,0,0,0,0,3
8202,775287,10,0,3,0,0,0,3,0,0,0,0,0,0,0,0,0,0
8202,790921,14,2,3,1,1,1,2,0,0,0,1,0,5,0,1,0,5
8202,786551,25,2,6,0,2,2,4,0,0,0,3,0,1,0,1,0,6
8202,798110,1,0,0,0,0,0,0,0,0,0,0,0,0,0,0,0,0
8203,791051,19,4,5,4,5,0,0,0,0,2,8,1,3,0,3,0,8
8203,780739,22,0,4,0,4,0,0,2,2,0,0,1,1,0,2,0,2
8203,790819,19,4,10,3,5,1,5,0,0,0,1,1,0,1,4,0,9
8203,785524,22,1,3,0,2,1,1,1,2,1,1,0,2,1,0,1,4
8203,781115,30,1,3,1,3,0,0,0,1,1,0,2,1,0,1,0,2
8203,796731,14,2,4,2,4,0,0,0,0,1,1,0,1,1,0,0,4
8203,796730,9,0,3,0,0,0,3,2,2,0,0,0,0,0,0,1,2
8203,785784,5,0,0,0,0,0,0,0,0,0,1,0,0,1,0,0,0
8203,791052,15,0,1,0,1,0,0,1,4,1,0,0,1,0,0,1,1
8203,786310,21,2,4,1,2,1,2,3,4,0,1,0,2,0,0,0,8
8203,775094,24,2,6,2,4,0,2,0,0,1,3,3,2,0,3,1,4
8218,792084,20,0,1,0,1,0,0,1,2,2,5,2,3,1,0,0,1
8218,791296,38,9,15,5,6,4,9,4,4,1,2,1,1,0,4,0,26
8218,786397,36,5,8,4,6,1,2,0,0,2,8,4,3,3,0,0,11
8218,796590,24,0,5,0,4,0,1,0,0,0,3,3,4,2,1,0,0
8218,791519,38,9,14,6,10,3,4,7,10,0,2,3,1,1,4,0,28
8218,796593,20,3,5,3,5,0,0,2,3,1,3,3,0,0,0,0,8
8218,796591,21,1,5,1,2,0,3,0,0,0,2,1,2,0,0,0,2
8218,780529,3,0,0,0,0,0,0,2,2,0,1,1,1,0,0,0,2
8219,781407,22,2,3,2,3,0,0,2,3,2,3,1,3,0,3,0,6
8219,797445,38,6,12,3,6,3,6,1,1,2,2,1,2,2,3,0,16
8219,791583,30,6,15,6,15,0,0,2,5,3,5,1,4,0,0,2,14
8219,780580,33,4,7,3,5,1,2,5,7,2,7,10,4,1,1,0,14
8219,776150,32,4,14,3,8,1,6,1,1,1,0,1,1,1,1,0,10
8219,786608,7,1,1,1,1,0,0,0,0,0,0,0,1,1,0,0,2
8219,786110,4,0,2,0,1,0,1,0,0,0,1,0,0,0,0,1,0
8219,785623,20,3,4,3,3,0,1,0,0,2,1,1,1,0,1,0,6
8219,786659,11,1,2,1,2,0,0,0,0,0,1,0,0,0,1,0,2
8219,797448,3,0,0,0,0,0,0,0,0,0,0,0,0,0,0,0,0
8220,791140,27,5,11,5,11,0,0,0,0,1,3,1,3,1,1,2,10
8220,791138,26,1,2,1,2,0,0,0,1,0,4,1,2,1,0,0,2
8220,786084,29,3,4,3,3,0,1,0,0,1,3,4,0,1,4,0,6
8220,780910,27,4,11,2,8,2,3,5,5,1,5,7,2,1,5,0,15
8220,780288,25,4,7,4,5,0,2,3,4,1,3,2,1,1,1,0,11
8220,796794,10,4,4,4,4,0,0,0,0,1,1,2,0,0,1,0,8
8220,796795,13,5,5,5,5,0,0,0,0,0,0,2,4,0,0,1,10
8220,780912,4,0,0,0,0,0,0,0,2,0,0,0,0,0,0,0,0
8220,780911,23,3,7,1,3,2,4,0,0,2,4,2,1,0,2,0,8
8220,781635,16,3,3,1,1,2,2,0,0,0,4,2,0,0,0,0,8
8221,780282,28,5,7,5,6,0,1,4,4,3,3,2,1,1,1,0,14
8221,780277,22,2,10,1,5,1,5,0,0,3,4,1,1,1,2,1,5
8221,791002,24,1,3,0,0,1,3,0,0,0,0,1,0,1,1,0,3
8221,785327,24,2,7,2,3,0,4,2,2,0,1,0,1,2,1,0,6
8221,780280,21,4,9,4,7,0,2,0,1,1,2,1,1,2,3,0,8
8221,785329,14,4,8,3,4,1,4,0,0,1,2,2,3,0,1,1,9
8221,796662,16,2,3,2,3,0,0,2,2,1,1,0,2,1,0,0,6
8221,791003,17,3,10,2,5,1,5,1,3,1,1,0,0,0,1,0,8
8221,785330,23,2,4,2,2,0,2,0,0,0,1,1,3,0,0,0,4
8221,785326,11,0,0,0,0,0,0,0,0,0,2,1,1,0,0,0,0
8222,780377,26,5,12,1,1,4,11,2,2,2,6,2,1,2,0,0,16
8222,791852,8,3,5,3,5,0,0,1,4,1,1,0,2,0,0,0,7
8222,797460,30,5,10,4,6,1,4,0,1,1,5,5,1,0,2,1,11
8222,786601,9,1,3,0,0,1,3,0,0,1,0,0,3,0,0,0,3
8222,786600,27,2,8,2,8,0,0,1,2,0,7,8,3,6,2,0,5
8222,791851,32,6,8,4,5,2,3,3,3,1,6,4,5,0,1,1,17
8222,791853,12,1,1,1,1,0,0,0,0,0,1,0,2,0,0,0,2
8222,797461,28,9,11,4,5,5,6,2,2,0,6,3,2,0,3,0,25
8222,797459,6,0,0,0,0,0,0,0,0,1,0,0,0,0,1,0,0
8222,796247,1,0,0,0,0,0,0,0,0,0,0,0,0,0,0,0,0
8222,786604,2,0,0,0,0,0,0,0,0,1,0,0,0,0,0,0,0
8222,786602,12,0,5,0,1,0,4,0,0,0,1,0,1,0,0,0,0
8222,786599,7,3,7,2,4,1,3,0,0,0,0,0,1,0,0,0,7
8223,786623,8,2,3,2,3,0,0,2,3,1,1,0,4,0,0,0,6
8223,797404,18,2,6,1,4,1,2,0,0,1,4,1,2,1,2,0,5
8223,791834,27,0,9,0,5,0,4,1,2,0,1,1,0,0,1,0,1
8223,791833,21,4,7,3,5,1,2,3,5,1,2,0,1,0,2,1,12
8223,785920,27,2,9,2,6,0,3,2,3,0,3,3,1,0,2,0,6
8223,797413,7,2,3,2,2,0,1,0,0,0,0,0,0,0,0,0,4
8223,797410,2,0,1,0,1,0,0,0,0,0,0,0,0,0,0,0,0
8223,786624,15,3,5,3,5,0,0,5,6,5,4,0,2,0,1,0,11
8223,797406,3,0,0,0,0,0,0,0,0,0,1,1,0,0,0,0,0
8223,797403,9,1,1,1,1,0,0,1,2,1,0,0,1,0,0,0,3
8223,785698,29,3,8,0,2,3,6,2,2,1,5,5,1,2,1,0,11
8223,785271,8,0,1,0,0,0,1,0,0,0,0,0,0,0,1,0,0
8223,784077,26,3,10,0,4,3,6,0,0,0,6,2,1,1,1,0,9
8224,790873,29,7,15,4,10,3,5,6,7,4,6,3,3,0,2,0,23
8224,785429,15,0,2,0,0,0,2,0,0,0,1,0,0,0,0,0,0
8224,780054,35,2,5,1,4,1,1,1,1,0,3,0,3,2,2,0,6
8224,781140,33,2,5,2,5,0,0,1,1,1,3,2,4,0,0,0,5
8224,786851,32,12,18,7,8,5,10,1,1,0,1,3,1,0,1,0,30
8224,776357,32,6,9,5,7,1,2,2,2,0,3,3,4,0,3,0,15
8224,796433,11,1,3,1,3,0,0,0,0,0,1,0,2,0,0,1,2
8224,776245,7,1,2,1,1,0,1,1,1,0,1,0,0,0,0,0,3
8224,799973,3,1,1,0,0,1,1,0,0,0,0,0,0,1,0,0,3
8224,796432,3,0,0,0,0,0,0,0,0,0,0,0,0,0,0,0,0
8225,780012,36,4,9,2,3,2,6,2,4,1,3,4,2,0,1,0,12
8225,796309,29,8,14,8,14,0,0,6,6,5,4,2,2,1,1,2,22
8225,790824,28,2,4,1,1,1,3,4,6,1,5,4,2,0,3,0,9
8225,780011,35,5,9,2,5,3,4,4,4,0,2,1,2,0,1,0,17
8225,775667,29,3,9,1,4,2,5,3,4,0,3,7,2,0,1,0,11
8225,781524,23,6,8,3,4,3,4,0,0,2,1,0,0,0,0,0,15
8225,774895,11,2,2,2,2,0,0,0,0,0,0,1,3,0,0,0,4
8225,785370,9,1,3,1,2,0,1,0,0,0,1,0,0,0,0,0,2
8226,796466,26,3,4,1,1,2,3,0,0,1,3,0,3,0,3,2,8
8226,785930,25,2,4,2,4,0,0,6,8,1,2,0,3,0,3,1,10
8226,780996,14,0,1,0,0,0,1,0,0,0,2,1,0,0,1,0,0
8226,796468,37,2,6,2,6,0,0,5,6,1,4,4,3,1,2,0,9
8226,791035,38,9,22,5,12,4,10,10,12,2,8,5,4,0,5,0,32
8226,780995,23,4,8,2,5,2,3,0,0,3,1,2,5,0,1,0,10
8226,785461,2,0,0,0,0,0,0,0,0,0,0,0,1,0,1,0,0
8226,775709,28,2,4,0,0,2,4,1,2,0,1,2,4,0,1,0,7
8226,796467,7,0,1,0,0,0,1,0,0,0,0,0,0,0,0,0,0
8227,785996,24,2,11,2,9,0,2,4,4,3,1,1,3,0,0,0,8
8227,780858,31,4,8,2,5,2,3,2,2,2,5,1,3,1,1,1,12
8227,797646,22,4,11,3,5,1,6,0,0,0,1,3,3,1,1,0,9
8227,780849,27,1,5,0,1,1,4,0,0,4,2,2,2,1,1,0,3
8227,780853,26,4,9,3,6,1,3,5,9,0,3,4,4,2,1,0,14
8227,792235,16,3,6,3,6,0,0,1,2,1,1,0,2,0,1,0,7
8227,792039,17,2,4,1,3,1,1,2,6,1,2,0,2,2,0,0,7
8227,785990,24,5,10,3,8,2,2,6,6,1,2,3,2,0,2,0,18
8227,786010,11,2,3,1,1,1,2,0,0,2,1,0,0,0,0,0,5
8227,780776,2,0,0,0,0,0,0,0,0,0,1,0,1,0,0,0,0
8228,781270,39,4,12,1,6,3,6,2,2,0,0,3,2,0,3,0,13
8228,781272,32,5,14,3,8,2,6,0,0,1,3,2,4,1,1,1,12
8228,791261,24,3,13,2,9,1,4,2,2,1,6,1,0,0,1,0,9
8228,785501,30,2,9,1,4,1,5,2,2,0,4,1,3,3,2,0,7
8228,796958,26,1,6,1,5,0,1,4,4,3,5,0,5,1,2,0,6
8228,791258,19,2,4,1,2,1,2,0,0,0,1,0,2,1,0,0,5
8228,796960,20,2,3,2,3,0,0,0,1,5,0,0,5,0,0,0,4
8228,791260,4,1,1,1,1,0,0,1,1,0,0,0,1,0,1,0,3
8228,799825,1,1,1,1,1,0,0,0,0,0,0,0,0,0,0,0,2
8228,785502,4,0,0,0,0,0,0,0,0,0,0,0,0,0,0,0,0
8228,785503,1,0,0,0,0,0,0,0,0,0,0,1,0,0,0,0,0
8229,780530,37,8,10,8,10,0,0,0,1,0,3,1,1,1,2,3,16
8229,785809,35,7,11,7,11,0,0,8,9,5,8,3,2,2,2,1,22
8229,785738,40,3,11,2,7,1,4,7,10,0,11,4,3,0,4,0,14
8229,797402,27,4,8,1,2,3,6,0,0,0,3,2,4,0,1,0,11
8229,785740,19,2,2,2,2,0,0,1,4,4,0,0,4,0,1,1,5
8229,786144,30,1,5,0,0,1,5,1,2,0,2,4,2,1,2,0,4
8229,791664,9,1,3,1,2,0,1,0,0,0,2,1,1,1,1,0,2
8229,785739,3,0,0,0,0,0,0,0,0,0,0,0,0,0,0,0,0
8229,780526,0,0,0,0,0,0,0,0,0,0,0,0,0,0,0,0,0
8229,797401,0,0,0,0,0,0,0,0,0,0,0,0,0,0,0,0,0
8230,780579,40,7,16,6,10,1,6,5,5,0,4,2,0,5,2,0,20
8230,797537,29,5,11,5,10,0,1,3,5,1,2,1,1,0,2,0,13
8230,785293,34,1,6,1,4,0,2,3,5,2,3,3,5,1,1,0,5
8230,780578,19,1,5,1,4,0,1,0,0,1,2,1,3,0,1,0,2
8230,785843,30,0,4,0,1,0,3,1,2,5,4,1,2,0,1,0,1
8230,785847,25,3,9,2,4,1,5,1,2,1,0,0,2,1,2,0,8
8230,797535,13,2,5,1,2,1,3,0,0,0,2,0,1,0,2,0,5
8230,791712,10,1,2,1,2,0,0,2,2,1,0,0,1,0,0,1,4
8231,790998,34,6,7,5,5,1,2,3,4,2,5,0,3,1,2,1,16
8231,790997,33,6,12,4,4,2,8,2,2,1,4,2,3,1,2,1,16
8231,785621,23,3,8,2,4,1,4,4,4,0,1,6,4,0,2,0,11
8231,790995,33,3,6,1,3,2,3,0,0,0,6,1,4,1,2,0,8
8231,796631,23,2,6,1,2,1,4,2,2,2,3,1,1,0,1,0,7
8231,766874,24,6,8,6,8,0,0,0,0,0,4,1,1,1,2,0,12
8231,786375,20,1,4,1,3,0,1,0,0,1,4,1,1,2,1,1,2
8231,790999,6,0,0,0,0,0,0,0,0,0,1,1,1,0,1,0,0
8231,796632,3,0,0,0,0,0,0,0,0,0,0,0,0,0,2,0,0
8231,781520,1,0,0,0,0,0,0,0,0,0,1,0,0,0,1,0,0
8232,780634,24,2,4,2,4,0,0,0,0,2,6,2,2,0,3,0,4
8232,791826,29,3,5,2,2,1,3,0,1,0,2,2,5,0,3,0,7
8232,786785,26,1,6,1,2,0,4,4,4,2,2,0,2,0,1,0,6
8232,786783,30,0,5,0,3,0,2,0,0,1,3,3,3,2,1,1,0
8232,780633,34,5,10,3,6,2,4,0,0,1,7,2,3,2,1,0,12
8232,797389,13,1,1,1,1,0,0,0,0,1,1,0,2,0,1,1,2
8232,776009,26,6,13,4,8,2,5,5,6,0,1,1,1,1,2,0,19
8232,786784,18,3,11,3,7,0,4,3,3,0,1,0,4,1,2,0,9
8232,797388,0,0,0,0,0,0,0,0,0,0,0,0,0,0,0,0,0
8233,791585,33,3,7,2,4,1,3,4,6,2,5,2,1,1,0,1,11
8233,791581,20,2,3,1,1,1,2,7,9,0,4,4,3,0,2,0,12
8233,786395,39,5,12,2,4,3,8,1,2,0,3,2,2,2,4,0,14
8233,786394,33,5,10,4,7,1,3,2,2,2,8,1,2,2,0,0,13
8233,780404,28,5,8,5,7,0,1,2,5,1,0,3,2,3,2,0,12
8233,785228,24,1,5,1,2,0,3,0,0,0,0,0,3,1,3,0,2
8233,780062,15,1,2,1,2,0,0,0,0,0,4,0,0,0,0,0,2
8233,780403,8,0,0,0,0,0,0,2,4,1,0,0,1,0,0,0,2
8234,792593,22,2,5,2,5,0,0,2,2,2,7,1,5,0,4,0,6
8234,792594,31,5,13,4,6,1,7,1,1,1,6,3,4,0,2,1,12
8234,792588,36,1,3,0,0,1,3,1,4,0,1,0,3,0,0,1,4
8234,792595,36,4,9,2,6,2,3,2,4,1,3,5,2,3,2,0,12
8234,792583,31,5,13,2,3,3,10,2,2,1,0,0,2,2,1,0,15
8234,796989,1,0,0,0,0,0,0,0,0,0,0,0,0,0,0,0,0
8234,792580,15,3,4,3,4,0,0,2,4,3,1,0,4,1,0,0,8
8234,796988,2,0,0,0,0,0,0,0,0,0,0,0,0,0,0,0,0
8234,796987,14,1,4,1,4,0,0,1,4,0,0,2,2,1,0,0,3
8234,792591,11,0,1,0,0,0,1,0,0,0,0,1,0,0,2,0,0
8234,792586,1,0,1,0,0,0,1,0,0,0,0,0,0,0,0,0,0
8235,791023,29,8,11,8,11,0,0,4,6,4,6,2,2,1,0,0,20
8235,796685,27,3,8,2,4,1,4,3,3,0,2,2,4,2,1,0,10
8235,791027,24,2,3,2,3,0,0,0,0,2,2,2,4,1,2,0,4
8235,791024,39,4,11,4,9,0,2,6,6,1,3,3,2,0,5,0,14
8235,777572,34,6,13,4,11,2,2,2,3,3,4,4,5,0,3,0,16
8235,791028,25,2,5,1,3,1,2,0,0,0,5,0,2,0,0,0,5
8235,796683,1,0,0,0,0,0,0,0,0,0,0,0,0,0,0,0,0
8235,781507,21,2,3,0,1,2,2,1,4,1,7,3,2,0,2,0,7
8236,785631,30,3,5,1,2,2,3,1,3,0,4,0,0,2,2,0,9
8236,786248,9,4,6,4,6,0,0,0,0,0,1,0,2,0,1,0,8
8236,785630,23,5,6,2,2,3,4,0,0,0,2,3,2,0,0,0,13
8236,785632,27,3,3,3,3,0,0,2,2,1,5,3,0,0,1,0,8
8236,780777,20,1,3,0,2,1,1,0,0,1,2,3,0,1,2,0,3
8236,791199,19,3,3,3,3,0,0,0,0,1,3,1,3,0,1,1,6
8236,791197,12,3,3,3,3,0,0,0,0,1,1,0,2,0,0,0,6
8236,796898,6,0,3,0,2,0,1,0,0,0,0,1,0,1,1,1,0
8236,791198,16,0,4,0,0,0,4,0,0,0,1,0,0,0,0,0,0
8236,791196,6,0,2,0,1,0,1,0,0,0,0,0,0,0,0,0,0
8236,791200,26,12,14,7,7,5,7,3,5,0,0,5,2,2,0,0,32
8236,781129,6,0,0,0,0,0,0,0,0,0,0,0,0,0,0,0,0
8237,781249,23,5,7,4,4,1,3,2,2,1,0,1,2,0,1,0,13
8237,775165,26,0,4,0,0,0,4,0,0,0,2,2,0,0,0,0,0
8237,785514,26,3,9,3,8,0,1,2,4,3,5,0,1,0,1,0,8
8237,785515,29,9,14,8,10,1,4,0,0,1,1,2,2,4,3,0,19
8237,781253,24,2,6,1,2,1,4,0,0,0,1,0,0,0,0,0,5
8237,796953,18,6,11,6,10,0,1,1,1,2,1,0,1,1,0,0,13
8237,796951,11,1,1,1,1,0,0,0,0,0,1,0,0,0,0,0,2
8237,796952,6,0,0,0,0,0,0,0,0,1,1,0,0,0,0,0,0
8237,791251,15,0,0,0,0,0,0,0,0,0,0,0,0,0,1,0,0
8237,791687,18,4,6,2,2,2,4,1,1,0,2,1,0,0,1,0,11
8237,776804,4,0,0,0,0,0,0,0,0,0,1,0,0,1,1,0,0
8238,797344,26,4,10,4,10,0,0,1,4,1,2,1,2,0,1,0,9
8238,797341,28,5,8,4,4,1,4,3,4,0,3,0,4,2,2,1,14
8238,791747,31,3,11,1,3,2,8,2,3,2,6,4,2,0,2,1,10
8238,791746,36,6,9,5,7,1,2,0,0,1,4,5,3,1,4,0,13
8238,786193,34,2,7,0,1,2,6,0,0,0,2,5,0,0,0,0,6
8238,797343,14,1,3,1,2,0,1,1,2,1,2,0,0,0,0,1,3
8238,797340,15,2,4,0,1,2,3,0,0,0,1,0,1,0,0,0,6
8238,786184,10,1,3,0,1,1,2,0,0,0,1,1,1,0,0,0,3
8238,780711,6,0,1,0,1,0,0,0,0,0,0,0,1,0,1,0,0
8239,796479,34,1,5,1,5,0,0,0,0,5,6,4,1,2,3,0,2
8239,781560,29,6,9,6,9,0,0,1,3,5,8,0,4,1,2,1,13
8239,796477,27,3,7,3,6,0,1,2,3,1,3,4,2,3,3,0,8
8239,791375,36,4,9,3,4,1,5,0,1,1,2,7,2,0,2,0,9
8239,785482,32,7,25,6,18,1,7,2,5,7,5,3,2,1,2,1,17
8239,786164,17,2,6,1,4,1,2,0,0,2,2,1,1,0,0,0,5
8239,780837,25,4,15,0,3,4,12,1,2,3,1,1,1,1,1,0,13
8240,791511,19,3,5,3,5,0,0,2,4,0,0,0,4,2,1,0,8
8240,778442,31,3,10,1,6,2,4,2,2,4,7,4,3,1,1,0,10
8240,797150,31,6,11,6,9,0,2,2,2,3,3,3,0,0,3,0,14
8240,780946,37,4,9,2,4,2,5,0,0,0,1,5,2,1,2,0,10
8240,786637,31,5,8,3,4,2,4,2,3,0,5,2,1,4,3,0,14
8240,797151,21,4,6,4,6,0,0,0,1,1,0,1,4,2,0,0,8
8240,791515,9,1,1,0,0,1,1,0,0,0,0,1,1,1,0,0,3
8240,791516,5,0,0,0,0,0,0,0,0,1,0,0,0,1,0,0,0
8240,791513,16,5,8,4,5,1,3,0,0,0,4,2,1,0,3,0,11
8241,791493,38,3,7,3,7,0,0,5,7,4,10,1,0,0,1,1,11
8241,789036,37,8,13,8,13,0,0,8,8,3,3,4,2,0,4,0,24
8241,791492,33,6,11,3,4,3,7,4,4,2,3,0,1,1,2,0,19
8241,778888,36,3,9,2,4,1,5,0,0,0,3,1,3,3,6,0,7
8241,776494,40,0,4,0,1,0,3,0,0,0,1,3,3,2,2,0,0
8241,780504,5,1,2,1,2,0,0,0,0,0,0,0,1,0,1,0,2
8241,791495,5,1,4,0,1,1,3,0,0,1,0,0,1,0,1,0,3
8241,791494,6,0,1,0,0,0,1,0,0,0,0,0,2,1,0,0,0
8242,784640,32,7,9,5,6,2,3,0,0,2,4,2,1,0,0,0,16
8242,797655,29,5,12,5,12,0,0,1,2,3,6,4,1,1,1,1,11
8242,797657,27,1,5,1,2,0,3,0,0,0,0,3,0,0,0,0,2
8242,792072,38,2,5,0,0,2,5,3,3,0,3,3,0,0,2,0,9
8242,792069,31,3,10,1,3,2,7,3,5,0,2,2,2,1,2,0,11
8242,797652,22,1,1,1,1,0,0,1,2,0,3,2,1,1,0,0,3
8242,785572,21,5,7,2,2,3,5,0,0,0,2,1,2,0,1,0,13
8243,792373,38,4,9,3,7,1,2,0,0,4,1,2,0,1,0,0,9
8243,781598,15,1,2,1,1,0,1,0,0,0,0,0,1,0,2,0,2
8243,792370,38,6,12,5,8,1,4,2,3,1,5,4,2,2,0,1,15
8243,797951,21,3,7,1,2,2,5,0,0,0,4,1,1,0,0,0,8
8243,775303,31,3,6,0,3,3,3,0,0,1,3,2,2,1,1,0,9
8243,797958,22,7,10,6,7,1,3,0,0,2,1,1,0,0,1,0,15
8243,790499,8,0,4,0,1,0,3,0,0,1,1,1,3,0,0,0,0
8243,776491,27,4,11,4,11,0,0,0,0,2,4,3,1,0,1,0,8
8243,781597,0,0,0,0,0,0,0,0,0,0,0,0,2,0,0,0,0
8244,790957,35,1,6,1,2,0,4,2,2,2,6,2,1,2,3,1,4
8244,785275,31,3,5,3,5,0,0,2,4,0,4,5,1,1,4,0,8
8244,790956,20,2,5,0,2,2,3,0,0,1,0,1,1,1,2,0,6
8244,796552,31,1,6,0,2,1,4,1,2,0,0,0,2,0,1,0,4
8244,780460,39,10,19,3,8,7,11,3,4,1,1,2,2,3,4,0,30
8244,796549,9,1,3,1,3,0,0,0,0,0,4,0,4,1,0,0,2
8244,796551,21,1,4,1,3,0,1,1,1,0,1,3,4,0,1,0,3
8244,796548,4,0,0,0,0,0,0,0,0,0,1,0,1,0,0,1,0
8244,796547,10,1,1,0,0,1,1,0,0,0,1,2,0,0,1,0,3
8245,792486,27,1,2,0,1,1,1,3,6,0,7,2,1,1,2,0,6
8245,785772,26,4,5,4,5,0,0,0,2,1,6,0,2,3,0,0,8
8245,792482,16,2,3,2,3,0,0,0,0,1,3,0,2,0,2,0,4
8245,785778,36,7,10,7,10,0,0,7,8,2,2,2,1,5,2,1,21
8245,780543,37,8,17,7,13,1,4,0,0,0,1,3,1,2,2,0,17
8245,792481,14,2,6,2,6,0,0,0,0,2,1,0,4,0,3,1,4
8245,792488,13,2,4,1,1,1,3,0,0,0,0,0,1,1,0,0,5
8245,797419,23,2,5,2,4,0,1,0,0,1,1,3,2,1,1,0,4
8245,792489,8,0,1,0,0,0,1,0,0,0,1,0,0,0,1,0,0
8246,791949,27,5,9,5,6,0,3,7,11,2,8,0,4,0,0,2,17
8246,776014,29,4,7,4,5,0,2,2,2,2,1,2,4,1,2,0,10
8246,797690,35,5,8,4,6,1,2,2,3,3,8,4,1,4,3,0,13
8246,780747,34,1,6,1,5,0,1,0,0,1,3,6,2,1,3,1,2
8246,776363,37,2,10,2,4,0,6,0,0,0,2,0,1,1,1,0,4
8246,785304,8,0,3,0,1,0,2,0,0,0,0,0,1,0,0,0,0
8246,797691,13,3,6,3,6,0,0,2,3,0,0,3,1,1,0,0,8
8246,797689,6,0,0,0,0,0,0,0,0,1,1,1,1,1,1,0,0
8246,791946,7,2,4,1,1,1,3,0,0,0,2,0,0,0,1,0,5
8246,791947,4,2,2,2,2,0,0,0,1,1,1,0,0,0,0,0,4
8247,785498,30,4,10,4,9,0,1,2,2,5,7,1,3,0,4,0,10
8247,780704,29,2,6,1,2,1,4,0,0,1,1,1,2,0,1,0,5
8247,796705,39,3,15,1,7,2,8,6,6,2,4,6,4,1,3,0,14
8247,796708,31,3,16,3,8,0,8,0,0,1,3,1,3,1,2,1,6
8247,776322,33,5,10,3,4,2,6,0,0,1,3,1,2,2,2,0,12
8247,796706,28,1,4,0,0,1,4,1,2,3,6,1,4,2,1,0,4
8247,791036,10,0,0,0,0,0,0,0,2,2,1,0,0,0,0,0,0
8248,781319,14,7,10,7,9,0,1,5,6,4,1,0,2,3,5,1,19
8248,781408,18,5,6,4,4,1,2,7,8,1,2,3,0,1,1,1,18
8248,786691,24,3,12,1,3,2,9,5,5,0,6,4,0,4,4,0,13
8248,786693,27,6,14,3,6,3,8,0,0,0,5,2,0,5,2,1,15
8248,781329,20,2,3,2,3,0,0,0,0,1,3,3,4,4,3,0,4
8248,797876,11,2,5,2,5,0,0,1,2,4,5,1,1,2,1,1,5
8248,786656,11,3,4,3,4,0,0,1,4,1,0,0,3,0,2,1,7
8248,792046,21,8,11,4,5,4,6,2,2,2,1,2,1,1,0,0,22
8248,792447,6,2,3,1,2,1,1,0,0,0,2,0,1,2,1,0,5
8248,792221,18,1,4,1,3,0,1,1,2,2,3,0,1,1,2,0,3
8248,781455,22,0,5,0,3,0,2,2,3,0,0,10,1,4,2,0,2
8248,776059,8,0,0,0,0,0,0,3,4,0,3,2,0,0,2,0,3
8264,790232,40,6,13,4,9,2,4,1,2,0,2,4,2,1,2,3,15
8264,780614,15,2,2,1,1,1,1,0,0,1,3,1,2,0,0,0,5
8264,780093,12,2,6,2,6,0,0,0,0,1,1,0,1,0,2,0,4
8264,789066,38,1,5,0,2,1,3,0,0,0,3,6,0,2,2,0,3
8264,776278,24,3,6,0,3,3,3,2,2,1,1,2,2,0,0,0,11
8264,780255,28,6,8,6,8,0,0,2,3,3,3,1,4,2,0,0,14
8264,792411,9,2,3,1,1,1,2,0,0,0,0,0,1,0,0,0,5
8264,786463,25,3,9,2,5,1,4,0,2,1,2,1,2,1,1,0,7
8264,785806,9,1,3,1,1,0,2,0,0,0,0,1,0,0,0,0,2
8265,786569,30,6,8,6,8,0,0,1,4,3,5,1,4,0,4,1,13
8265,797317,34,3,9,2,6,1,3,0,0,1,2,1,1,0,2,0,7
8265,791726,34,2,6,1,2,1,4,2,3,0,2,0,3,0,1,0,7
8265,786273,37,5,12,2,7,3,5,0,0,2,5,4,2,0,4,3,13
8265,780773,39,7,10,7,8,0,2,4,6,3,6,8,2,0,3,2,18
8265,797313,16,2,7,0,3,2,4,0,0,2,1,0,0,0,0,0,6
8265,791728,10,2,2,2,2,0,0,0,0,1,1,0,1,1,1,1,4
8266,785287,14,2,3,2,3,0,0,2,2,2,1,1,4,0,0,1,6
8266,776286,22,3,6,2,4,1,2,2,2,2,2,1,3,0,1,0,9
8266,791445,23,4,9,2,4,2,5,0,0,0,1,0,3,1,0,0,10
8266,785357,26,6,14,3,6,3,8,5,5,0,8,3,2,1,2,1,20
8266,775560,25,4,7,4,6,0,1,3,3,2,3,1,0,2,2,2,11
8266,797010,25,4,10,4,8,0,2,4,4,1,5,3,2,1,1,0,12
8266,775557,11,0,0,0,0,0,0,0,0,0,1,0,3,0,0,2,0
8266,781627,20,4,9,3,8,1,1,1,2,2,7,1,2,0,0,1,10
8266,791444,10,0,0,0,0,0,0,2,3,2,4,0,0,0,1,0,2
8266,785895,8,1,3,0,0,1,3,0,0,0,0,1,1,0,0,0,3
8266,797012,11,2,3,2,3,0,0,0,0,0,1,1,1,1,0,0,4
8266,797009,2,1,1,0,0,1,1,0,0,0,0,0,0,0,0,0,3
8266,797011,3,0,1,0,1,0,0,0,0,0,0,1,1,0,0,1,0
8267,781107,14,1,2,1,2,0,0,0,2,1,2,3,3,0,1,0,2
8267,791972,29,4,13,2,5,2,8,1,1,0,2,1,1,0,1,0,11
8267,796777,22,1,2,0,1,1,1,3,4,1,1,2,5,0,1,0,6
8267,785366,31,2,9,2,7,0,2,4,4,1,3,2,2,0,1,0,8
8267,780863,28,1,10,1,7,0,3,4,8,0,3,0,2,1,2,0,6
8267,796778,22,3,6,2,4,1,2,3,6,0,5,1,4,1,1,3,10
8267,780867,11,1,2,1,1,0,1,0,0,1,0,0,2,0,3,0,2
8267,791974,27,0,3,0,1,0,2,0,0,0,0,0,1,1,2,0,0
8267,796780,14,2,3,1,1,1,2,2,3,0,4,0,1,0,1,0,7
8267,791973,2,0,0,0,0,0,0,0,0,0,0,0,0,0,0,0,0
8268,791131,16,2,4,2,3,0,1,0,0,1,1,0,2,0,3,2,4
8268,796791,18,1,7,0,4,1,3,0,0,0,2,2,1,1,0,0,3
8268,791132,28,4,10,2,4,2,6,0,0,3,2,0,2,0,2,0,10
8268,786090,38,5,11,4,6,1,5,9,10,1,10,4,1,3,2,0,20
8268,786088,34,4,7,4,5,0,2,4,4,2,8,2,2,0,6,1,12
8268,791133,6,0,1,0,1,0,0,0,0,1,1,0,0,0,0,0,0
8268,791134,4,0,0,0,0,0,0,0,0,0,2,0,1,0,0,0,0
8268,785541,8,0,1,0,0,0,1,0,0,2,1,0,3,0,0,0,0
8268,791135,22,2,5,2,5,0,0,6,10,2,4,1,2,1,2,2,10
8268,796790,23,2,10,1,3,1,7,1,2,1,4,2,1,4,2,0,6
8268,786092,3,0,1,0,1,0,0,0,0,0,0,0,0,0,0,0,0
8269,785664,15,2,3,2,3,0,0,0,0,2,3,0,3,0,1,1,4
8269,785841,34,3,8,0,2,3,6,3,4,0,3,1,4,3,3,0,12
8269,796609,31,4,12,2,8,2,4,0,0,1,2,3,2,2,4,0,10
8269,796611,19,1,4,1,1,0,3,0,0,1,3,0,1,0,0,0,2
8269,792869,31,3,9,2,3,1,6,4,4,0,3,2,2,0,3,0,11
8269,796613,24,4,16,1,5,3,11,0,2,1,2,3,1,1,1,0,11
8269,792232,19,2,4,1,2,1,2,0,0,1,4,0,2,1,0,1,5
8269,791312,7,0,0,0,0,0,0,0,0,0,1,0,1,1,1,1,0
8269,766623,20,0,4,0,2,0,2,0,0,1,3,2,3,1,0,0,0
8270,781659,30,2,4,2,2,0,2,3,7,4,7,0,0,0,1,1,7
8270,781005,27,8,13,8,9,0,4,3,4,2,9,0,0,0,1,2,19
8270,792684,18,3,5,2,3,1,2,3,5,0,2,0,3,1,1,0,10
8270,782162,27,3,10,2,6,1,4,7,8,3,4,1,3,1,2,2,14
8270,781665,32,6,11,2,3,4,8,0,0,0,2,5,1,3,1,0,16
8270,796855,2,1,2,1,2,0,0,0,0,0,0,0,0,0,0,0,2
8270,790494,10,1,4,1,2,0,2,0,0,1,1,1,0,0,2,0,2
8270,788866,7,0,2,0,2,0,0,0,0,1,1,0,3,0,2,0,0
8270,781411,2,0,0,0,0,0,0,0,0,0,1,0,0,0,0,1,0
8270,796853,8,0,3,0,3,0,0,0,0,2,1,1,0,1,0,0,0
8270,792683,16,1,4,1,2,0,2,0,0,0,3,1,2,1,2,0,2
8270,780610,21,1,7,0,2,1,5,0,0,2,1,3,2,0,0,0,3
8272,797701,11,1,1,1,1,0,0,0,0,0,2,1,3,0,1,1,2
8272,792101,29,4,8,4,6,0,2,3,5,2,1,2,5,1,0,0,11
8272,780923,35,8,20,5,14,3,6,3,4,0,3,3,1,0,2,0,22
8272,776386,33,2,7,2,4,0,3,5,6,3,6,1,0,1,2,0,9
8272,775564,33,5,14,4,11,1,3,4,4,1,5,4,4,2,1,1,15
8272,786160,14,4,6,2,3,2,3,2,2,0,1,0,2,0,0,0,12
8272,780922,21,0,1,0,0,0,1,4,6,2,3,1,3,0,1,4,4
8272,792102,9,0,1,0,0,0,1,0,0,0,0,0,0,0,0,0,0
8272,797700,15,3,5,2,4,1,1,0,0,2,2,1,3,2,0,0,7
8273,797380,28,3,7,2,4,1,3,4,5,0,5,1,5,1,0,0,11
8273,789043,28,6,10,6,10,0,0,1,4,4,7,0,4,0,0,3,13
8273,786636,35,7,13,3,7,4,6,3,4,0,1,6,1,0,0,0,21
8273,780646,32,5,10,4,7,1,3,3,4,1,3,3,2,0,3,0,14
8273,791818,34,5,13,3,7,2,6,6,6,1,3,3,4,1,4,1,18
8273,797377,13,1,1,0,0,1,1,0,0,0,1,2,1,0,1,0,3
8273,797378,7,1,1,1,1,0,0,0,0,0,0,0,0,0,1,0,2
8273,775168,11,0,3,0,2,0,1,0,0,0,3,0,3,1,0,0,0
8273,797379,12,2,3,2,3,0,0,2,2,1,3,0,0,0,0,0,6
8274,786475,34,5,8,3,5,2,3,6,10,2,7,4,2,2,3,0,18
8274,774874,37,3,7,3,6,0,1,4,4,0,3,2,4,0,3,0,10
8274,796531,32,5,9,5,7,0,2,0,0,0,1,2,2,0,2,0,10
8274,781134,22,3,6,1,4,2,2,2,2,3,4,0,5,1,2,1,10
8274,785270,21,3,10,0,1,3,9,1,2,0,3,0,4,0,2,1,10
8274,786037,16,2,4,2,3,0,1,1,1,1,1,0,0,1,0,0,5
8274,775468,21,2,6,2,5,0,1,0,0,0,3,2,1,0,1,0,4
8274,780084,12,0,2,0,0,0,2,0,0,0,1,1,3,0,0,0,0
8274,780085,5,0,0,0,0,0,0,0,0,1,0,0,0,0,0,0,0
8275,797784,34,5,11,3,7,2,4,3,4,1,3,3,3,1,3,0,15
8275,792173,29,2,8,2,3,0,5,1,3,2,3,1,4,1,1,2,5
8275,780980,14,0,2,0,1,0,1,2,2,0,1,0,0,3,1,0,2
8275,786658,3,1,2,1,2,0,0,0,0,1,0,0,0,0,0,0,2
8275,792175,3,0,1,0,1,0,0,0,0,0,0,0,1,0,2,0,0
8275,789059,33,5,12,5,9,0,3,1,2,6,6,0,3,0,2,0,11
8275,792174,24,2,3,1,1,1,2,2,2,1,3,1,0,1,0,0,7
8275,780049,20,2,7,2,6,0,1,1,2,2,2,1,2,0,3,0,5
8275,797783,15,1,5,1,5,0,0,2,4,0,2,0,2,1,0,0,4
8275,797785,4,1,1,1,1,0,0,0,0,0,1,0,0,0,0,0,2
8275,797782,2,0,2,0,2,0,0,0,0,1,0,0,0,0,0,0,0
8275,785674,19,2,5,2,2,0,3,2,3,0,2,0,4,0,1,0,6
8276,781609,32,10,18,7,12,3,6,0,1,0,12,2,1,6,5,1,23
8276,781612,31,5,11,1,2,4,9,0,0,1,3,2,4,2,3,0,14
8276,791360,35,3,7,1,1,2,6,0,0,1,3,1,0,2,1,1,8
8276,797004,33,3,7,3,5,0,2,0,0,0,1,6,3,0,3,0,6
8276,797005,31,2,7,2,3,0,4,0,0,1,4,2,4,3,1,1,4
8276,797003,13,3,4,3,4,0,0,1,1,0,1,0,2,0,0,0,7
8276,797006,13,2,4,1,2,1,2,0,0,0,1,1,0,3,1,0,5
8276,797007,8,0,2,0,1,0,1,0,0,0,1,1,1,1,0,0,0
8276,791358,2,0,0,0,0,0,0,0,0,0,0,0,0,0,0,0,0
8276,797008,1,0,0,0,0,0,0,0,0,0,0,0,0,0,0,0,0
8276,785887,1,0,0,0,0,0,0,0,0,0,1,0,0,0,0,0,0
8277,780182,32,4,13,2,6,2,7,4,4,0,7,1,2,3,1,0,14
8277,786818,31,4,9,4,7,0,2,1,1,0,3,3,3,2,4,0,9
8277,780192,28,4,7,3,4,1,3,0,2,0,3,3,1,1,4,0,9
8277,798139,24,3,5,3,4,0,1,1,1,0,1,1,2,0,4,0,7
8277,796585,11,1,5,1,5,0,0,0,2,4,3,0,0,0,1,1,2
8277,780186,21,1,2,1,2,0,0,2,4,0,5,0,0,0,2,0,4
8277,796587,6,2,2,2,2,0,0,0,0,0,0,0,0,0,0,0,4
8277,798138,13,0,4,0,1,0,3,2,2,0,1,0,1,1,2,0,2
8277,786820,16,0,2,0,0,0,2,0,0,0,3,0,0,0,1,0,0
8277,780184,11,0,0,0,0,0,0,0,0,0,0,1,0,1,2,0,0
8277,780188,3,0,1,0,0,0,1,0,0,0,1,0,0,0,0,0,0
8277,796584,3,0,0,0,0,0,0,0,0,0,0,0,0,0,1,0,0
8277,796583,1,0,0,0,0,0,0,0,0,0,0,0,0,0,0,0,0
8278,797673,40,7,12,2,5,5,7,0,0,1,10,2,0,0,1,0,19
8278,786117,40,6,13,3,8,3,5,3,3,2,2,6,3,0,3,0,18
8278,786118,31,3,6,0,1,3,5,0,0,0,4,2,2,0,0,0,9
8278,780437,39,3,10,3,9,0,1,2,2,2,4,0,3,0,1,0,8
8278,786123,29,4,5,4,5,0,0,0,0,3,4,3,2,1,3,0,8
8278,797675,11,2,3,2,3,0,0,1,2,0,3,0,1,0,0,0,5
8278,792093,10,0,4,0,1,0,3,2,2,1,0,2,1,1,0,0,2
8279,781028,32,7,12,4,4,3,8,1,3,0,3,5,1,0,0,0,18
8279,790788,31,6,10,0,1,6,9,0,0,0,5,1,1,2,0,0,18
8279,785243,27,3,9,1,3,2,6,0,0,2,2,3,2,0,1,0,8
8279,796347,21,0,3,0,1,0,2,0,0,2,2,2,1,0,0,0,0
8279,781026,18,0,5,0,1,0,4,0,0,0,1,1,3,1,1,0,0
8279,796349,24,2,6,0,0,2,6,2,2,0,2,1,1,0,1,0,8
8279,785242,19,2,4,2,3,0,1,0,1,1,1,3,2,1,1,0,4
8279,796348,14,1,2,1,2,0,0,0,0,0,3,0,0,0,2,0,2
8279,781027,14,0,2,0,1,0,1,0,0,0,0,0,1,0,0,0,0
8280,781656,22,1,6,1,5,0,1,2,3,2,3,1,5,1,1,4,4
8280,781658,36,6,12,5,11,1,1,2,2,5,4,1,1,3,4,0,15
8280,791263,21,8,11,7,10,1,1,1,2,2,3,2,3,0,4,0,18
8280,796962,35,5,13,3,6,2,7,4,4,0,3,7,3,1,7,0,16
8280,780129,31,2,8,1,6,1,2,2,2,0,1,1,5,0,2,1,7
8280,798206,11,1,3,1,2,0,1,0,0,1,0,0,1,0,0,3,2
8280,790256,1,0,0,0,0,0,0,0,0,0,0,1,2,0,0,0,0
8280,796967,11,0,2,0,0,0,2,1,3,0,1,0,1,1,1,0,1
8280,796966,18,0,1,0,1,0,0,0,2,0,4,1,5,2,2,0,0
8280,796964,8,0,0,0,0,0,0,0,0,0,1,0,0,0,1,0,0
8280,791264,6,0,2,0,2,0,0,0,0,0,0,0,1,1,0,0,0
8281,787522,23,3,8,3,8,0,0,0,0,4,4,0,5,1,1,3,6
8281,787524,32,2,5,1,4,1,1,7,11,3,3,0,4,2,3,1,12
8281,781019,22,5,10,4,7,1,3,2,5,0,5,4,3,9,4,0,13
8281,780328,30,5,12,5,12,0,0,4,4,4,2,1,1,2,0,0,14
8281,775961,27,3,8,1,4,2,4,2,3,3,0,3,0,2,3,0,10
8281,775541,20,4,8,4,7,0,1,0,0,1,3,0,1,1,0,0,8
8281,783269,7,0,3,0,3,0,0,2,2,2,1,0,0,0,0,0,2
8281,791772,14,0,2,0,0,0,2,0,0,1,1,0,0,1,4,0,0
8281,791722,10,1,1,1,1,0,0,3,6,1,0,0,1,0,0,0,5
8281,780017,15,0,4,0,3,0,1,0,0,1,1,1,5,0,3,0,0
8282,792388,9,1,2,1,2,0,0,0,0,0,1,0,3,0,1,0,2
8282,797845,19,0,3,0,1,0,2,0,0,0,0,0,1,0,0,0,0
8282,797851,39,6,9,6,7,0,2,3,4,1,2,3,2,1,0,0,15
8282,792391,40,13,19,12,18,1,1,4,4,4,3,1,3,2,4,0,31
8282,792395,20,3,7,2,5,1,2,0,0,1,1,1,4,0,2,0,7
8282,781533,31,0,2,0,2,0,0,2,2,2,1,3,4,0,0,1,2
8282,792393,33,3,9,3,6,0,3,4,4,0,2,4,2,2,3,0,10
8282,792394,9,1,3,0,0,1,3,0,0,0,0,0,1,0,0,0,3
8283,785884,6,1,1,0,0,1,1,0,0,0,0,0,0,0,1,0,3
8283,786131,39,2,11,2,8,0,3,3,4,2,2,2,2,1,1,0,7
8283,780904,14,3,4,3,4,0,0,0,0,0,2,0,1,1,1,0,6
8283,797685,40,3,7,2,3,1,4,6,8,1,0,3,3,1,3,0,13
8283,786128,40,7,12,5,9,2,3,4,4,2,9,6,3,0,2,0,20
8283,792100,26,4,5,4,5,0,0,4,5,3,4,0,4,0,1,0,12
8283,797686,35,3,5,2,3,1,2,0,0,0,0,2,2,1,4,0,7
8284,775556,33,10,24,8,12,2,12,4,7,2,9,6,1,4,2,2,26
8284,780234,24,0,4,0,3,0,1,2,2,2,7,0,4,1,0,3,2
8284,786411,27,2,3,1,2,1,1,1,1,0,0,3,3,1,2,0,6
8284,780046,31,3,12,2,7,1,5,0,2,2,5,4,0,1,1,0,7
8284,781104,36,6,14,1,2,5,12,7,8,0,2,4,2,1,1,0,24
8284,781110,23,2,4,1,3,1,1,1,2,7,5,1,2,1,3,0,6
8284,797185,13,1,5,0,2,1,3,2,2,1,0,0,2,0,0,1,5
8284,786405,13,2,3,2,2,0,1,1,2,0,1,1,1,1,2,0,5
8285,791089,26,4,11,4,9,0,2,3,3,2,7,0,3,0,0,0,11
8285,791097,26,5,10,5,9,0,1,0,1,1,4,2,3,0,0,0,10
8285,791094,27,2,7,1,4,1,3,2,3,1,4,3,5,1,4,0,7
8285,791091,37,7,12,6,8,1,4,5,6,0,3,3,0,0,2,0,20
8285,791090,34,6,12,3,4,3,8,2,3,2,6,1,2,1,4,0,17
8285,791092,2,1,1,1,1,0,0,0,0,0,1,0,1,0,0,0,2
8285,796752,28,2,4,1,3,1,1,0,0,0,2,7,5,1,1,0,5
8285,791093,20,3,9,3,9,0,0,1,1,1,3,0,3,0,2,0,7
8286,780027,33,8,16,8,15,0,1,7,11,3,8,2,1,0,3,1,23
8286,786176,33,4,11,3,6,1,5,2,4,2,9,4,4,2,6,0,11
8286,786173,28,7,10,3,3,4,7,0,0,0,0,2,1,1,0,0,18
8286,780028,30,1,4,0,1,1,3,1,1,1,3,2,2,0,1,0,4
8286,774828,33,2,7,0,1,2,6,0,0,0,3,6,1,1,1,0,6
8286,797175,16,2,3,1,2,1,1,1,2,0,4,1,2,1,1,2,6
8286,780029,7,1,4,1,3,0,1,0,0,1,2,1,2,0,1,0,2
8286,791380,6,0,2,0,2,0,0,0,2,2,2,0,1,0,2,0,0
8286,791379,14,1,1,0,0,1,1,1,2,0,1,1,1,0,0,0,4
8286,797178,0,0,0,0,0,0,0,0,0,0,0,0,0,0,0,0,0
8287,781175,21,1,3,1,3,0,0,6,6,2,4,0,4,0,0,0,8
8287,786555,28,3,7,0,0,3,7,1,3,0,3,2,1,1,0,1,10
8287,786553,31,3,15,1,6,2,9,3,4,1,2,2,1,1,0,1,11
8287,780895,27,4,10,3,7,1,3,2,2,1,6,0,3,1,3,0,11
8287,781172,32,3,7,1,3,2,4,0,0,0,3,2,2,1,2,0,8
8287,781177,14,3,6,1,2,2,4,0,0,2,2,0,3,3,2,0,8
8287,785312,26,3,11,3,7,0,4,0,0,0,3,6,0,3,2,0,6
8287,792005,14,1,2,0,0,1,2,0,0,0,3,0,2,0,1,0,3
8287,797503,7,1,1,1,1,0,0,1,2,1,1,1,4,0,0,0,3
8288,799000,32,3,5,3,5,0,0,2,5,3,6,3,4,2,1,0,8
8288,785471,25,4,5,4,5,0,0,4,5,1,4,0,0,1,4,4,12
8288,780263,29,5,10,3,8,2,2,7,11,2,4,2,3,2,3,2,19
8288,786697,33,0,3,0,1,0,2,0,0,0,1,2,3,0,2,0,0
8288,775628,36,5,13,4,9,1,4,9,10,1,5,3,5,4,7,3,20
8288,792399,12,1,3,1,3,0,0,0,0,1,2,1,1,0,2,0,2
8288,775198,28,6,9,4,6,2,3,0,1,0,1,1,0,1,0,0,14
8288,780571,5,0,2,0,1,0,1,0,0,0,0,2,0,0,2,0,0
8289,781081,34,4,7,4,6,0,1,1,4,0,4,0,2,2,1,2,9
8289,791864,31,7,11,4,6,3,5,0,0,2,3,1,2,1,3,0,17
8289,791863,15,3,4,3,3,0,1,0,0,0,4,0,5,1,1,0,6
8289,797472,23,3,5,1,1,2,4,2,4,1,2,1,1,2,1,0,10
8289,780965,40,5,18,2,10,3,8,0,0,1,4,6,2,3,9,0,13
8289,797470,20,3,6,0,0,3,6,1,4,1,0,6,5,2,0,1,10
8289,786592,26,5,10,5,9,0,1,0,2,2,1,3,5,3,0,0,10
8289,797473,10,1,3,1,3,0,0,0,0,0,0,0,1,0,0,2,2
8289,786791,1,0,1,0,0,0,1,0,0,0,0,0,0,0,0,0,0
8289,776447,0,0,0,0,0,0,0,0,0,0,1,0,0,0,0,0,0
8290,791548,38,8,21,6,13,2,8,6,8,6,12,1,3,2,7,4,24
8290,791550,23,4,6,4,6,0,0,1,5,0,5,2,5,0,0,0,9
8290,786364,30,4,9,4,7,0,2,2,3,0,0,0,4,1,2,0,10
8290,780330,28,4,5,4,5,0,0,0,2,1,2,3,2,3,1,0,8
8290,780329,31,3,8,3,7,0,1,2,2,0,2,2,0,4,3,0,8
8290,797082,16,1,5,1,5,0,0,1,4,2,1,3,4,0,2,0,3
8290,780332,3,0,1,0,0,0,1,0,0,0,0,1,0,0,2,0,0
8290,797080,8,0,1,0,0,0,1,0,0,0,0,0,1,0,0,0,0
8290,786368,23,4,5,2,2,2,3,0,1,1,4,3,3,2,1,0,10
8291,797205,23,3,4,2,2,1,2,3,3,1,2,1,5,4,2,0,10
8291,786316,10,1,3,1,3,0,0,0,0,1,1,0,3,0,0,1,2
8291,791477,32,5,9,5,8,0,1,5,10,2,7,1,3,3,0,0,15
8291,791476,37,4,10,1,1,3,9,8,8,0,4,1,3,1,4,0,19
8291,780220,37,3,10,3,7,0,3,3,6,1,8,6,3,3,6,2,9
8291,797206,29,7,11,7,11,0,0,1,4,4,6,2,2,2,3,0,15
8291,791473,9,0,4,0,3,0,1,0,0,0,0,0,2,1,0,0,0
8291,797202,14,1,2,1,2,0,0,0,0,0,0,0,3,1,2,0,2
8291,791474,2,0,0,0,0,0,0,0,0,0,0,0,0,0,1,0,0
8291,791475,7,1,3,0,0,1,3,1,2,0,0,0,1,0,0,0,4
8292,786526,28,1,4,1,4,0,0,1,2,0,4,3,2,1,1,1,3
8292,786525,19,1,3,1,2,0,1,2,2,0,1,0,4,1,3,1,4
8292,786856,18,2,3,2,3,0,0,1,1,1,4,2,2,0,1,0,5
8292,791914,32,8,15,6,10,2,5,1,3,0,2,4,1,0,3,0,19
8292,786030,32,2,7,1,4,1,3,0,0,0,1,2,2,1,3,1,5
8292,791917,26,3,6,2,2,1,4,0,0,1,2,0,0,0,2,0,7
8292,781109,17,2,5,1,2,1,3,0,0,1,5,2,1,1,0,0,5
8292,797550,18,1,6,0,2,1,4,0,0,0,2,0,0,0,1,0,3
8292,786524,9,0,1,0,1,0,0,0,0,0,1,0,0,0,0,1,0
8292,797551,1,0,0,0,0,0,0,0,0,0,0,0,0,0,0,0,0
8292,791920,0,0,0,0,0,0,0,0,0,0,0,0,0,0,0,0,0
8293,790930,24,4,8,3,5,1,3,1,2,2,1,0,2,0,0,1,10
8293,780358,17,1,6,1,5,0,1,0,0,1,0,0,2,0,0,1,2
8293,775011,28,0,7,0,3,0,4,0,0,0,6,4,1,1,2,0,0
8293,780357,33,3,11,1,4,2,7,4,4,0,6,3,2,3,1,0,12
8293,775018,34,5,6,2,2,3,4,0,0,0,5,5,0,1,3,0,13
8293,776004,22,7,8,4,5,3,3,2,2,3,5,3,2,2,1,1,19
8293,796480,32,3,8,3,7,0,1,6,7,0,2,2,0,3,1,0,12
8293,796483,5,0,2,0,0,0,2,0,0,0,1,0,0,0,0,0,0
8293,780355,1,0,0,0,0,0,0,0,0,0,0,0,1,0,0,0,0
8293,796486,1,0,1,0,0,0,1,0,0,0,0,0,0,0,0,0,0
8293,796485,1,0,0,0,0,0,0,0,0,0,0,0,0,0,0,0,0
8293,785496,1,0,0,0,0,0,0,0,0,0,0,0,0,0,0,0,0
8293,785491,1,0,0,0,0,0,0,0,0,0,0,0,0,0,0,0,0
8300,791482,26,3,4,3,4,0,0,0,0,1,6,2,1,0,0,1,6
8300,786319,18,2,4,2,4,0,0,4,6,0,6,0,2,1,0,0,8
8300,786318,30,11,19,4,7,7,12,0,0,1,0,1,1,0,0,0,29
8300,784268,27,3,9,3,8,0,1,0,0,0,3,6,1,0,2,0,6
8300,780223,31,3,5,0,1,3,4,4,4,0,2,3,3,0,1,0,13
8300,797198,2,0,1,0,1,0,0,0,0,0,0,0,0,0,0,0,0
8300,791481,13,1,1,1,1,0,0,0,0,0,4,0,3,0,2,0,2
8300,780225,25,2,6,0,1,2,5,0,0,0,0,1,0,0,1,0,6
8300,797200,4,0,1,0,0,0,1,0,0,0,1,0,0,0,0,0,0
8300,797199,16,1,4,1,3,0,1,0,0,0,2,0,1,0,0,1,2
8300,797201,3,0,0,0,0,0,0,0,0,0,0,0,0,0,0,0,0
8300,796079,1,0,0,0,0,0,0,0,0,0,0,0,0,0,0,0,0
8300,791480,1,0,0,0,0,0,0,0,0,0,0,0,0,0,0,0,0
8300,791479,1,0,0,0,0,0,0,0,0,0,0,0,0,0,0,0,0
8300,786317,1,0,0,0,0,0,0,0,0,0,0,0,0,0,0,0,0
8300,786320,1,1,1,1,1,0,0,0,0,0,0,0,0,0,0,0,2
8301,791787,22,4,11,3,7,1,4,0,2,2,7,0,3,0,4,0,9
8301,789048,25,3,6,3,6,0,0,3,4,3,3,0,1,1,1,0,9
8301,789046,22,2,4,0,0,2,4,0,0,0,3,0,1,1,0,1,6
8301,791786,25,5,10,3,5,2,5,0,0,0,2,0,1,0,3,0,12
8301,789041,26,0,4,0,1,0,3,0,0,0,1,3,1,0,1,0,0
8301,799762,3,0,0,0,0,0,0,0,0,0,0,0,0,0,0,0,0
8301,791785,9,1,2,0,0,1,2,0,0,0,0,0,0,0,0,0,3
8301,785540,8,0,4,0,4,0,0,0,0,0,1,0,2,0,0,1,0
8301,797632,1,0,0,0,0,0,0,0,0,0,0,0,0,0,0,0,0
8301,797633,1,0,0,0,0,0,0,0,0,0,0,0,0,0,0,0,0
8301,797631,13,1,4,1,3,0,1,0,0,0,2,2,0,0,0,0,2
8301,797630,21,1,3,1,2,0,1,3,4,1,2,2,0,0,0,1,5
8301,797629,9,2,3,2,3,0,0,0,0,1,3,0,1,0,2,0,4
8301,789044,15,2,5,2,3,0,2,0,0,1,2,0,1,1,0,1,4
8302,792140,29,3,6,3,6,0,0,1,1,1,4,2,4,0,5,0,7
8302,786596,35,4,11,3,6,1,5,6,7,0,1,4,0,1,4,0,15
8302,797786,34,4,11,2,5,2,6,0,2,0,1,1,2,1,4,0,10
8302,785976,30,3,7,0,3,3,4,2,2,0,6,1,1,0,1,0,11
8302,781429,19,0,1,0,0,0,1,0,0,0,0,1,2,0,1,0,0
8302,797791,11,1,3,1,3,0,0,0,0,2,1,0,0,1,1,0,2
8302,797793,3,0,0,0,0,0,0,0,0,0,0,1,0,0,0,0,0
8302,792144,27,2,5,2,2,0,3,0,0,1,4,1,1,0,0,0,4
8302,797789,1,1,1,1,1,0,0,0,0,0,0,0,0,0,0,0,2
8302,781431,11,2,5,1,3,1,2,0,0,0,0,0,1,0,0,0,5
8303,785800,19,2,3,0,0,2,3,0,0,0,5,1,1,1,0,0,6
8303,785799,12,3,6,3,6,0,0,0,0,2,3,1,4,1,1,2,6
8303,791676,23,4,6,1,2,3,4,0,0,1,0,3,4,0,1,0,11
8303,780554,24,6,8,5,6,1,2,2,2,0,4,0,0,1,0,1,15
8303,780553,25,7,15,7,15,0,0,1,1,2,3,5,1,4,6,0,15
8303,797426,11,0,3,0,2,0,1,0,0,0,2,1,1,0,0,0,0
8303,791678,10,1,1,1,1,0,0,0,0,1,2,0,0,0,0,0,2
8303,791679,5,0,0,0,0,0,0,0,0,0,0,1,1,0,1,0,0
8303,785807,15,1,3,0,0,1,3,0,0,0,4,0,0,1,0,0,3
8303,780760,19,4,7,3,3,1,4,0,0,2,0,1,2,1,0,0,9
8303,797427,20,4,10,2,2,2,8,0,1,0,2,1,1,0,1,0,10
8303,790964,1,0,0,0,0,0,0,0,0,0,0,0,0,0,0,0,0
8303,791677,16,0,3,0,3,0,0,0,0,1,0,1,1,1,1,0,0
8304,789177,28,3,9,3,9,0,0,0,2,2,10,0,4,0,0,3,6
8304,780227,24,1,9,1,7,0,2,0,4,4,6,1,4,1,1,2,2
8304,791336,19,1,4,1,2,0,2,0,0,2,2,2,0,2,2,0,2
8304,791340,26,2,7,2,7,0,0,4,8,1,2,5,3,0,4,0,8
8304,776089,30,4,7,1,2,3,5,1,2,2,1,4,3,4,2,0,12
8304,797260,1,0,1,0,1,0,0,0,0,0,1,0,0,0,0,0,0
8304,775758,22,0,1,0,1,0,0,2,4,1,6,2,1,0,0,1,2
8304,789178,16,1,2,0,0,1,2,2,2,0,0,1,3,1,0,0,5
8304,780181,34,9,18,3,8,6,10,2,4,1,0,1,2,3,5,1,26
8305,796637,18,1,3,1,3,0,0,0,2,0,1,0,1,1,2,0,2
8305,792632,34,3,4,3,4,0,0,1,2,2,7,0,1,1,2,1,7
8305,792629,18,2,4,2,4,0,0,0,0,0,1,1,3,0,1,0,4
8305,792626,33,3,9,3,8,0,1,0,2,1,6,5,3,1,1,0,6
8305,780250,31,4,11,4,7,0,4,7,8,1,8,0,2,1,2,0,15
8305,796634,10,1,1,1,1,0,0,2,3,0,4,0,5,1,1,0,4
8305,796638,13,1,4,0,0,1,4,0,0,0,0,1,1,0,4,0,3
8305,792627,6,0,3,0,3,0,0,0,0,1,0,0,0,1,0,0,0
8305,792631,9,0,1,0,1,0,0,0,0,0,2,0,1,0,3,0,0
8305,781491,28,5,11,2,5,3,6,5,6,0,1,1,4,0,1,0,18
8306,797463,44,8,28,6,18,2,10,13,14,3,10,3,3,1,1,1,31
8306,791109,41,5,10,5,10,0,0,5,7,6,4,3,4,0,1,1,15
8306,791858,38,4,7,2,3,2,4,3,4,1,3,1,4,1,2,0,13
8306,797466,34,4,11,4,10,0,1,3,8,3,5,0,2,1,2,1,11
8306,789074,3,0,0,0,0,0,0,2,2,0,0,0,0,0,0,0,2
8306,797464,25,1,3,1,1,0,2,0,0,0,5,1,5,1,2,1,2
8306,797469,6,1,3,1,1,0,2,0,0,1,0,0,1,0,2,0,2
8306,797465,10,0,2,0,1,0,1,1,2,0,0,0,1,0,0,0,1
8306,785625,22,0,3,0,1,0,2,0,0,0,1,0,4,0,2,1,0
8306,791854,2,0,0,0,0,0,0,0,0,0,0,0,0,0,0,0,0
8307,780812,44,8,22,3,9,5,13,14,19,1,10,0,4,1,2,0,35
8307,796767,43,9,20,7,13,2,7,2,4,3,7,1,3,0,4,0,22
8307,785614,31,5,5,5,5,0,0,3,4,2,5,0,4,0,1,0,13
8307,796765,31,1,5,1,4,0,1,4,4,2,2,2,2,2,3,0,6
8307,796766,29,1,7,1,3,0,4,0,0,1,3,2,4,0,0,0,2
8307,785618,25,0,5,0,0,0,5,0,0,0,2,1,5,0,1,0,0
8307,791113,22,0,2,0,2,0,0,0,0,2,2,0,4,0,1,1,0
8307,800004,0,0,0,0,0,0,0,0,0,0,0,0,0,0,0,0,0
8308,797310,38,5,10,4,7,1,3,0,0,0,4,3,1,2,4,0,11
8308,797308,37,4,12,3,6,1,6,0,0,0,1,1,1,1,0,1,9
8308,780706,39,2,8,1,4,1,4,2,2,0,8,3,3,0,2,0,7
8308,791723,23,2,5,2,5,0,0,0,0,2,2,0,5,0,0,2,4
8308,781617,24,1,7,1,4,0,3,0,0,1,5,0,5,0,2,0,2
8308,791724,22,5,11,3,6,2,5,0,0,2,2,0,4,0,1,0,12
8308,797312,14,1,4,1,2,0,2,1,2,2,2,0,3,0,1,0,3
8308,800056,3,0,1,0,0,0,1,0,0,0,0,0,0,0,0,0,0
8309,797292,30,8,12,8,12,0,0,7,14,5,8,0,1,0,1,3,23
8309,786064,36,5,9,4,5,1,4,3,4,3,9,2,2,1,3,0,14
8309,797290,34,3,10,2,6,1,4,1,2,0,1,1,2,1,5,1,8
8309,797291,30,2,7,1,5,1,2,2,2,0,4,1,3,1,2,1,7
8309,780509,30,0,2,0,0,0,2,2,2,0,2,2,2,0,2,2,2
8309,785658,10,0,0,0,0,0,0,1,2,0,1,0,1,0,1,0,1
8309,791658,9,0,0,0,0,0,0,1,2,1,1,0,0,0,0,0,1
8309,791660,21,0,4,0,2,0,2,0,0,0,1,2,1,0,0,1,0
8310,791200,40,11,18,6,10,5,8,9,10,0,5,1,3,1,4,2,36
8310,785632,40,6,9,6,9,0,0,0,0,3,7,2,1,0,1,1,12
8310,785630,40,4,9,1,1,3,8,0,0,0,5,2,0,0,3,0,11
8310,786248,8,2,4,2,4,0,0,0,1,0,0,2,3,0,1,0,4
8310,785631,37,1,5,1,3,0,2,0,0,2,6,3,1,0,2,4,2
8310,791199,29,1,2,1,2,0,0,4,6,3,3,0,4,0,1,1,6
8310,781129,0,0,0,0,0,0,0,3,3,0,0,0,0,0,0,0,3
8310,791198,6,0,0,0,0,0,0,0,0,0,0,0,0,0,0,0,0
8311,785515,37,6,16,5,11,1,5,4,4,1,1,3,5,2,5,0,17
8311,781249,34,6,9,2,3,4,6,0,0,0,4,0,1,1,0,0,16
8311,785514,37,5,13,4,11,1,2,3,4,2,3,2,2,3,1,1,14
8311,775165,32,1,4,0,0,1,4,0,0,1,6,2,3,0,0,0,3
8311,781253,35,0,1,0,0,0,1,0,0,0,2,0,0,0,0,0,0
8311,791687,24,5,10,3,5,2,5,1,2,0,0,0,3,2,0,0,13
8311,796953,1,0,0,0,0,0,0,0,0,0,0,0,0,0,0,0,0
8312,790761,29,3,9,2,5,1,4,0,0,1,3,4,1,0,1,1,7
8312,796322,25,9,11,9,11,0,0,0,0,5,6,0,2,0,1,2,18
8312,796319,33,8,17,4,6,4,11,1,1,1,1,7,0,0,3,2,21
8312,790764,35,5,11,3,6,2,5,3,5,2,3,5,1,2,2,3,15
8312,796320,34,5,7,1,2,4,5,0,0,0,5,7,3,1,3,0,14
8312,779993,27,2,3,0,0,2,3,0,1,0,2,4,2,2,1,0,6
8312,796321,7,1,2,1,2,0,0,0,0,1,0,0,1,0,1,0,2
8312,785219,3,0,1,0,0,0,1,0,0,0,1,0,0,0,0,0,0
8312,796323,7,1,3,1,3,0,0,0,0,2,3,0,2,0,1,1,2
8313,785902,32,5,12,4,7,1,5,0,0,2,6,1,3,3,3,2,11
8313,792181,25,3,11,2,9,1,2,0,2,6,2,1,1,1,2,1,7
8313,792179,18,0,4,0,2,0,2,0,0,0,1,0,1,1,1,0,0
8313,780986,33,5,8,5,8,0,0,3,4,2,1,1,2,0,0,1,13
8313,786662,35,8,15,3,6,5,9,0,0,1,3,4,2,2,4,0,21
8313,786661,17,1,6,1,2,0,4,2,2,2,2,0,0,1,0,1,4
8313,797796,29,6,11,5,10,1,1,2,4,2,3,3,0,1,1,0,15
8313,792176,7,0,1,0,1,0,0,0,0,0,0,0,0,1,0,0,0
8313,797794,4,0,1,0,0,0,1,0,0,0,0,0,1,0,0,0,0
8314,775358,35,6,12,3,5,3,7,2,2,1,3,4,3,2,1,0,17
8314,796947,31,6,12,6,9,0,3,1,2,0,6,2,2,4,1,0,13
8314,785522,23,4,7,4,5,0,2,2,2,4,1,1,2,2,1,0,10
8314,781247,24,4,6,3,3,1,3,0,0,1,2,1,4,1,2,0,9
8314,791249,34,3,8,1,2,2,6,0,0,0,2,2,2,0,3,0,8
8314,791250,23,3,7,1,2,2,5,0,0,0,6,2,2,1,2,0,8
8314,796949,12,2,4,2,4,0,0,2,2,2,2,0,1,1,2,2,6
8314,796946,1,0,0,0,0,0,0,2,2,0,0,0,1,0,0,0,2
8314,785523,13,0,1,0,1,0,0,0,1,1,0,0,2,0,1,0,0
8314,791247,2,0,0,0,0,0,0,0,0,0,0,0,0,0,0,0,0
8314,796945,1,0,0,0,0,0,0,0,0,0,0,0,0,0,0,0,0
8314,796948,1,0,1,0,0,0,1,0,0,0,0,0,0,0,0,0,0
8315,781386,35,6,12,5,8,1,4,2,2,0,4,0,0,0,0,0,15
8315,797734,28,5,8,4,5,1,3,2,2,0,3,1,3,0,8,0,13
8315,797735,32,3,10,2,3,1,7,4,4,0,5,2,4,1,3,0,11
8315,792109,15,1,1,1,1,0,0,0,1,0,1,0,1,2,3,0,2
8315,792110,19,0,1,0,0,0,1,0,0,1,2,0,5,0,1,1,0
8315,786031,25,2,5,1,2,1,3,7,9,0,3,1,1,1,2,0,12
8315,789100,1,0,0,0,0,0,0,1,2,0,1,0,0,0,0,0,1
8315,797733,20,0,5,0,2,0,3,0,0,0,0,0,1,3,2,0,0
8315,786033,20,0,0,0,0,0,0,0,0,0,2,0,0,0,1,1,0
8315,792107,4,0,0,0,0,0,0,0,0,0,0,0,0,0,0,0,0
8315,797732,1,0,0,0,0,0,0,0,0,0,0,0,0,0,0,0,0
8316,796568,29,3,5,3,5,0,0,2,2,3,6,1,3,0,1,0,8
8316,796566,35,7,15,7,15,0,0,2,4,7,7,0,2,1,3,1,16
8316,790969,36,4,10,4,8,0,2,1,1,0,7,2,1,1,1,0,9
8316,780166,34,4,11,4,8,0,3,5,5,0,2,1,3,2,4,0,13
8316,775107,29,2,8,2,4,0,4,0,0,0,0,2,1,1,2,0,4
8316,790971,11,0,2,0,2,0,0,0,0,2,1,0,1,2,1,0,0
8316,790968,15,1,4,1,1,0,3,0,0,0,0,1,1,2,0,0,2
8316,790967,7,0,1,0,0,0,1,0,0,0,0,0,0,0,0,0,0
8316,796569,4,0,1,0,1,0,0,0,0,0,0,0,1,0,0,0,0
8317,792227,34,4,11,2,7,2,4,3,3,1,5,0,0,0,2,2,13
8317,781352,16,3,7,3,7,0,0,0,0,0,1,0,3,0,1,0,6
8317,792223,37,5,10,5,7,0,3,2,2,1,4,0,2,3,1,0,12
8317,785935,39,6,14,3,10,3,4,2,2,0,4,4,2,1,3,0,17
8317,781340,25,2,3,2,2,0,1,2,2,0,3,1,3,0,1,0,6
8317,797881,18,1,4,1,4,0,0,1,1,2,3,0,2,2,3,0,3
8317,797889,6,0,1,0,1,0,0,0,0,0,0,0,1,0,1,0,0
8317,781351,6,0,0,0,0,0,0,0,0,0,0,0,0,0,1,0,0
8317,797882,2,0,0,0,0,0,0,0,0,0,1,0,0,0,1,0,0
8317,792228,7,0,1,0,1,0,0,0,0,1,2,1,2,0,0,0,0
8317,786453,10,0,0,0,0,0,0,0,0,0,3,2,3,0,0,0,0
8318,791923,26,4,9,4,9,0,0,0,0,0,4,3,3,0,3,1,8
8318,781122,18,2,3,2,3,0,0,2,2,1,3,1,3,0,1,1,6
8318,791925,29,6,11,3,6,3,5,2,3,4,6,3,2,2,2,0,17
8318,786527,20,1,5,0,2,1,3,0,2,0,1,1,2,2,0,0,3
8318,781112,15,3,3,3,3,0,0,2,3,0,0,2,1,0,1,0,8
8318,797541,13,3,7,3,7,0,0,2,4,6,1,0,4,0,0,1,8
8318,791927,11,2,4,0,2,2,2,0,1,0,3,0,1,3,2,0,6
8318,786529,14,0,0,0,0,0,0,0,0,0,2,0,1,0,2,0,0
8318,797542,22,8,11,1,2,7,9,2,4,0,3,3,1,1,1,0,25
8318,791926,11,0,3,0,0,0,3,3,6,0,1,1,0,0,0,0,3
8318,791922,2,0,1,0,0,0,1,0,0,0,0,0,0,0,1,0,0
8318,786858,19,1,4,1,2,0,2,0,0,1,1,3,0,1,0,0,2
8319,791440,23,4,5,4,5,0,0,2,4,1,3,1,4,0,0,0,10
8319,797019,23,4,6,4,5,0,1,6,6,0,1,2,4,0,1,0,14
8319,797016,25,5,9,1,1,4,8,0,0,1,3,2,1,0,1,0,14
8319,781378,36,6,15,6,11,0,4,1,1,2,8,2,1,2,2,2,13
8319,775267,15,1,5,0,1,1,4,0,0,0,1,1,1,0,3,0,3
8319,797013,18,2,8,1,4,1,4,2,2,1,5,0,1,0,0,0,7
8319,791441,17,2,5,2,3,0,2,3,4,1,1,0,1,2,2,0,7
8319,774959,20,2,3,1,2,1,1,0,0,0,4,4,1,0,2,0,5
8319,791443,1,0,0,0,0,0,0,0,0,0,0,0,1,0,1,0,0
8319,775739,2,0,1,0,1,0,0,0,0,0,1,0,0,0,0,0,0
8319,797015,13,1,4,1,2,0,2,0,0,1,0,0,1,0,1,0,2
8319,781629,7,2,3,2,3,0,0,1,2,2,0,0,0,0,0,0,5
8320,797562,7,2,3,2,3,0,0,0,0,1,1,0,1,0,1,1,4
8320,786460,19,2,7,2,7,0,0,0,0,1,2,0,3,0,1,0,4
8320,780604,30,6,8,6,7,0,1,5,5,0,5,3,4,1,1,0,17
8320,780603,19,0,2,0,1,0,1,2,2,1,3,1,2,1,1,0,2
8320,780602,30,5,10,4,8,1,2,2,3,0,9,4,1,0,1,1,13
8320,786071,9,3,4,3,4,0,0,0,2,1,1,1,0,1,0,1,6
8320,797565,2,0,0,0,0,0,0,0,0,0,0,1,1,0,1,1,0
8320,791768,15,3,4,3,4,0,0,3,4,0,1,2,5,1,2,0,9
8320,797563,2,0,0,0,0,0,0,0,0,0,0,1,0,0,0,0,0
8320,797564,2,1,1,1,1,0,0,0,0,0,0,0,0,0,0,0,2
8320,791766,27,4,6,4,5,0,1,0,0,1,0,2,2,2,1,0,8
8320,791767,11,1,1,1,1,0,0,0,0,0,4,1,1,0,1,0,2
8320,786230,23,7,13,3,6,4,7,0,0,0,2,5,1,0,2,0,18
8320,780605,2,1,1,0,0,1,1,0,0,0,1,0,1,0,0,0,3
8320,800196,2,0,0,0,0,0,0,0,0,0,1,0,0,0,0,0,0
8321,780758,24,2,3,2,3,0,0,0,0,1,3,0,5,1,2,0,4
8321,775489,29,6,16,6,15,0,1,2,2,7,6,1,0,1,2,2,14
8321,785563,33,2,11,2,8,0,3,1,2,2,4,3,2,0,0,1,5
8321,785561,27,4,12,4,12,0,0,4,7,5,1,1,2,2,2,1,12
8321,780313,37,5,16,4,9,1,7,5,9,1,3,4,1,1,3,0,16
8321,791087,5,0,0,0,0,0,0,0,0,1,0,0,2,0,1,0,0
8321,796750,2,0,1,0,0,0,1,0,0,0,0,0,1,0,0,0,0
8321,796748,2,0,0,0,0,0,0,0,0,0,0,0,0,0,0,0,0
8321,791088,25,4,10,1,5,3,5,1,2,4,0,0,0,0,2,0,12
8321,785560,16,0,4,0,0,0,4,0,0,0,1,1,3,0,0,1,0
8322,792067,32,5,10,3,6,2,4,3,5,2,5,1,2,0,1,1,15
8322,775523,13,4,9,4,7,0,2,0,0,1,0,1,4,1,1,0,8
8322,797649,34,3,10,3,6,0,4,7,7,1,7,3,3,2,3,0,13
8322,792058,22,4,7,4,7,0,0,2,2,2,2,1,2,1,2,0,10
8322,789028,15,4,7,4,6,0,1,0,0,1,1,5,5,1,3,0,8
8322,786836,8,1,3,1,2,0,1,0,0,0,3,0,1,0,0,0,2
8322,792062,29,3,6,3,5,0,1,2,2,1,11,0,1,1,2,1,8
8322,789053,26,1,3,1,2,0,1,0,0,0,0,6,0,0,2,0,2
8322,789029,21,4,9,3,5,1,4,0,0,1,0,0,2,0,2,0,9
8323,796516,27,3,9,3,9,0,0,4,6,3,4,2,5,1,4,2,10
8323,792318,26,6,8,6,8,0,0,2,5,1,4,1,4,0,3,0,14
8323,786717,29,4,9,3,6,1,3,0,0,0,7,1,3,4,1,0,9
8323,780753,32,1,7,1,3,0,4,2,2,0,0,4,1,2,5,0,4
8323,775329,22,2,6,0,0,2,6,4,5,0,1,2,4,0,1,0,10
8323,796519,20,0,2,0,1,0,1,0,0,1,2,1,4,0,0,0,0
8323,796520,29,6,12,2,5,4,7,1,3,0,3,1,0,0,0,0,17
8323,796518,9,0,1,0,0,0,1,2,4,1,4,0,0,0,2,0,2
8323,792315,6,0,1,0,0,0,1,0,0,0,0,0,1,1,0,0,0
8324,790884,32,6,10,6,10,0,0,6,10,4,3,1,0,1,1,1,18
8324,791635,25,0,8,0,5,0,3,2,2,0,3,1,1,0,3,0,2
8324,796438,16,1,3,1,1,0,2,0,2,1,1,1,3,2,1,0,2
8324,790883,38,5,12,5,10,0,2,6,6,0,2,1,1,0,2,1,16
8324,796436,38,8,13,7,9,1,4,3,4,0,5,2,4,1,6,0,20
8324,796439,19,2,4,2,4,0,0,3,4,0,4,0,1,0,1,0,7
8324,796442,3,1,1,1,1,0,0,0,0,0,1,0,0,0,1,0,2
8324,785436,33,1,1,1,1,0,0,0,2,1,5,3,2,2,1,1,2
8324,790885,14,1,1,0,0,1,1,2,2,0,4,0,1,0,2,1,5
8324,781262,7,0,0,0,0,0,0,0,0,0,0,0,0,0,0,0,0
8325,780323,33,4,6,4,6,0,0,0,0,4,5,1,4,0,3,3,8
8325,797894,15,2,7,2,7,0,0,0,0,1,0,1,4,1,0,1,4
8325,792229,37,5,10,4,9,1,1,1,2,2,5,1,4,4,5,0,12
8325,785954,37,2,5,1,4,1,1,0,0,0,5,3,2,3,0,0,5
8325,785811,39,7,16,6,11,1,5,2,2,0,2,1,4,0,1,0,17
8325,792234,8,0,1,0,0,0,1,0,0,0,2,0,0,0,0,0,0
8325,792233,38,6,16,5,11,1,5,5,8,3,0,1,3,1,2,0,18
8325,792230,11,1,3,1,2,0,1,0,0,0,2,3,3,0,1,0,2
8325,781356,7,1,2,0,1,1,1,0,0,0,0,0,0,1,0,0,3
8326,792473,15,1,2,1,2,0,0,1,2,0,1,2,1,0,1,0,3
8326,792478,32,0,6,0,2,0,4,1,2,0,0,1,2,3,1,0,1
8326,792474,31,1,3,1,1,0,2,0,0,0,2,4,3,2,2,1,2
8326,785249,40,9,19,6,11,3,8,5,8,1,1,3,2,2,0,0,26
8326,780035,38,7,17,7,11,0,6,2,2,2,6,1,3,1,3,0,16
8326,785251,24,4,4,1,1,3,3,4,5,3,3,0,3,2,2,0,15
8326,780043,9,0,1,0,1,0,0,0,0,0,0,1,2,1,1,1,0
8326,799281,5,1,1,1,1,0,0,0,0,0,0,1,0,0,1,0,2
8326,780036,6,0,1,0,0,0,1,0,0,0,0,1,0,1,0,0,0
8327,797546,23,6,7,6,7,0,0,1,3,1,6,0,1,1,3,2,13
8327,797549,33,2,5,2,5,0,0,1,2,2,4,13,1,2,1,0,5
8327,797545,19,0,1,0,1,0,0,0,0,0,3,1,1,0,1,0,0
8327,791715,23,4,7,3,4,1,3,0,0,0,3,0,2,1,0,0,9
8327,780351,18,1,2,1,1,0,1,0,1,1,3,0,2,1,2,0,2
8327,797540,5,0,0,0,0,0,0,0,0,1,0,0,1,0,0,0,0
8327,791716,2,0,0,0,0,0,0,0,0,0,1,0,0,0,0,0,0
8327,790857,30,2,4,2,2,0,2,4,4,0,1,4,1,1,0,0,8
8327,780586,31,8,18,7,15,1,3,5,6,4,3,2,2,0,5,0,22
8327,797544,16,7,7,7,7,0,0,0,0,0,2,2,1,1,4,0,14
8334,781516,11,2,4,2,4,0,0,0,0,0,1,0,1,0,1,1,4
8334,797331,33,3,7,2,3,1,4,1,1,0,2,1,3,0,2,0,8
8334,791737,34,1,5,1,3,0,2,4,4,0,3,4,3,0,5,0,6
8334,783524,32,4,10,2,4,2,6,5,5,0,2,7,2,4,4,0,15
8334,780561,32,5,11,2,2,3,9,0,0,1,6,0,2,1,2,0,13
8334,791734,12,4,8,4,8,0,0,1,2,2,5,1,0,1,0,1,9
8334,791736,1,0,0,0,0,0,0,0,0,0,0,1,0,1,0,0,0
8334,775913,2,0,2,0,2,0,0,1,2,0,0,0,0,0,1,0,1
8334,797332,4,0,1,0,1,0,0,1,2,0,0,0,1,0,0,0,1
8334,797333,22,1,4,1,4,0,0,2,2,1,0,1,2,1,1,0,4
8334,795372,1,0,0,0,0,0,0,0,0,0,0,0,0,0,0,0,0
8334,786223,16,1,3,1,2,0,1,2,2,1,3,0,1,0,0,0,4
8335,791230,29,2,5,0,2,2,3,0,2,0,4,3,2,4,1,0,6
8335,785557,24,6,10,4,7,2,3,1,2,2,3,2,1,1,1,3,15
8335,791228,25,5,10,2,5,3,5,1,2,3,2,4,2,1,4,0,14
8335,796932,32,7,18,3,10,4,8,5,8,0,5,4,2,1,4,0,23
8335,785624,21,5,8,3,5,2,3,0,0,0,2,0,3,2,0,0,12
8335,796935,10,0,1,0,1,0,0,0,0,0,4,1,1,0,1,0,0
8335,796933,21,4,4,3,3,1,1,1,1,1,5,2,2,1,2,0,10
8335,791226,9,1,1,1,1,0,0,2,2,0,1,0,3,0,0,2,4
8335,791229,3,0,1,0,1,0,0,0,0,0,1,0,0,0,1,0,0
8335,791227,23,0,2,0,2,0,0,0,0,0,3,3,2,0,2,0,0
8335,781201,3,1,1,1,1,0,0,1,2,0,1,0,0,0,0,0,3
8336,791511,7,0,0,0,0,0,0,0,0,0,0,0,2,1,2,1,0
8336,778442,28,4,11,2,6,2,5,1,2,0,5,1,2,1,3,1,11
8336,780946,36,3,8,1,5,2,3,2,3,0,6,7,1,3,1,0,10
8336,786637,24,2,6,1,2,1,4,0,0,1,3,4,2,0,2,0,5
8336,791513,28,6,13,3,8,3,5,0,0,1,1,0,2,2,2,1,15
8336,797151,29,2,3,2,3,0,0,0,0,0,1,1,4,0,1,0,4
8336,791515,16,1,4,0,1,1,3,2,2,1,2,1,1,0,1,0,5
8336,797150,28,6,11,5,8,1,3,5,5,1,3,2,2,1,0,0,18
8336,791516,4,0,0,0,0,0,0,0,0,0,1,0,1,0,0,0,0
8337,791493,36,4,12,4,12,0,0,1,4,7,3,2,5,2,1,0,9
8337,789036,31,4,12,4,11,0,1,0,0,3,4,2,4,0,6,2,8
8337,791492,36,6,13,4,7,2,6,6,6,0,3,0,1,0,1,0,20
8337,778888,33,3,6,2,3,1,3,1,2,1,6,2,1,2,3,0,8
8337,776494,35,3,9,2,3,1,6,2,2,1,9,4,2,1,2,2,9
8337,780504,12,2,2,2,2,0,0,0,0,0,1,0,0,0,1,0,4
8337,797191,4,0,1,0,0,0,1,0,0,0,0,0,0,0,0,0,0
8337,791494,13,2,4,2,3,0,1,2,3,0,1,1,0,1,1,0,6
8338,781666,36,7,14,2,7,5,7,7,8,0,2,0,1,0,1,0,26
8338,792334,36,8,18,8,17,0,1,2,3,4,3,1,3,0,0,1,18
8338,792338,37,2,7,2,7,0,0,4,7,1,7,5,2,1,4,2,8
8338,786575,19,2,2,2,2,0,0,4,6,2,5,1,3,0,0,1,8
8338,799842,25,0,5,0,3,0,2,2,2,0,2,2,2,2,5,1,2
8338,798097,21,3,4,3,4,0,0,3,4,3,5,0,1,1,1,1,9
8338,798095,18,1,3,0,0,1,3,2,2,0,1,1,1,0,0,0,5
8338,791636,5,0,2,0,0,0,2,0,0,0,0,0,0,0,0,0,0
8338,798100,3,0,1,0,0,0,1,0,0,0,0,2,0,0,0,0,0
8339,797898,33,7,20,5,15,2,5,3,4,0,1,4,2,3,1,0,19
8339,789058,28,5,11,2,5,3,6,1,3,1,6,0,2,0,1,1,14
8339,787239,32,4,5,4,5,0,0,3,5,6,4,0,3,0,1,2,11
8339,781374,28,3,9,3,8,0,1,2,2,1,5,1,3,3,0,0,8
8339,792236,26,3,8,3,7,0,1,0,0,0,2,2,2,0,1,0,6
8339,792237,18,5,8,2,4,3,4,3,3,0,0,1,0,0,0,0,16
8339,785286,12,0,4,0,0,0,4,0,0,0,3,0,0,0,0,0,0
8339,785818,10,0,2,0,1,0,1,0,0,0,0,0,4,0,1,0,0
8339,792238,8,0,0,0,0,0,0,0,0,3,0,1,2,1,1,0,0
8339,792240,3,0,1,0,0,0,1,0,0,0,0,1,0,0,0,0,0
8339,797895,2,0,0,0,0,0,0,0,0,1,0,0,1,0,0,0,0
8339,785986,0,0,0,0,0,0,0,0,0,0,0,0,0,0,0,0,0
8340,792020,29,5,10,3,7,2,3,2,2,0,1,2,5,1,8,0,14
8340,785938,29,6,13,6,10,0,3,1,2,0,1,2,1,2,2,0,13
8340,785939,34,3,10,3,7,0,3,6,6,2,3,3,1,0,0,0,12
8340,785948,22,2,3,2,3,0,0,2,6,4,3,0,5,0,0,0,6
8340,785946,28,1,6,1,4,0,2,1,3,4,8,1,2,1,0,1,3
8340,792025,16,2,2,2,2,0,0,1,2,0,2,0,3,0,2,0,5
8340,792023,16,1,5,0,1,1,4,0,1,0,4,1,2,0,1,1,3
8340,792026,14,1,2,1,2,0,0,0,3,0,0,0,3,1,0,1,2
8340,797634,12,0,1,0,0,0,1,0,0,0,0,0,0,1,0,0,0
8341,796571,38,8,10,8,9,0,1,2,2,4,2,1,3,3,1,0,18
8341,791289,30,4,8,4,8,0,0,0,2,6,3,1,4,0,2,1,8
8341,796576,24,3,10,1,3,2,7,0,0,0,3,1,4,1,4,0,8
8341,781346,16,2,6,0,4,2,2,2,2,0,1,0,4,1,2,0,8
8341,796572,31,1,4,1,3,0,1,5,8,0,5,0,4,2,0,0,7
8341,796574,33,6,13,5,10,1,3,5,6,2,5,3,1,0,2,1,18
8341,791287,8,1,1,1,1,0,0,0,0,1,2,0,0,0,0,0,2
8341,791290,18,0,5,0,2,0,3,0,2,0,3,0,1,1,1,1,0
8341,785786,2,0,0,0,0,0,0,0,0,0,0,0,0,0,0,0,0
8342,785661,39,7,16,4,10,3,6,2,2,0,7,5,2,1,2,0,19
8342,786263,37,5,10,4,6,1,4,3,3,3,4,1,2,1,2,0,14
8342,786257,24,4,6,4,6,0,0,3,4,1,3,1,5,1,2,0,11
8342,775825,33,2,10,2,5,0,5,3,4,2,2,4,2,1,2,0,7
8342,797721,17,1,5,0,1,1,4,2,2,0,2,0,0,0,0,1,5
8342,792121,27,3,8,1,2,2,6,0,0,2,4,1,3,1,0,0,8
8342,786249,7,1,2,1,1,0,1,0,0,0,0,1,1,0,1,0,2
8342,797725,16,0,3,0,3,0,0,0,0,5,2,1,2,0,0,0,0
8343,791993,30,9,12,8,11,1,1,3,3,2,3,1,4,0,2,0,22
8343,786566,40,6,14,4,9,2,5,2,2,1,4,1,1,0,0,0,16
8343,781188,38,5,10,5,9,0,1,4,5,0,4,5,3,0,5,0,14
8343,791997,33,4,9,3,4,1,5,0,2,2,3,1,3,0,1,0,9
8343,786568,18,0,1,0,1,0,0,0,0,0,6,0,2,2,0,0,0
8343,781189,22,0,4,0,4,0,0,0,0,0,0,0,2,0,2,0,0
8343,786562,15,0,5,0,2,0,3,0,0,1,1,2,0,1,1,0,0
8343,786563,4,0,0,0,0,0,0,0,0,0,0,0,0,0,0,0,0
8344,791616,22,7,9,7,8,0,1,0,0,2,3,2,1,0,2,0,14
8344,780797,24,6,12,1,1,5,11,0,0,0,10,0,1,0,2,1,17
8344,796986,12,0,0,0,0,0,0,0,0,0,1,1,0,1,1,0,0
8344,785505,13,3,5,3,5,0,0,2,2,1,5,1,2,2,1,0,8
8344,775604,21,4,7,1,1,3,6,0,0,0,2,2,0,2,1,0,11
8344,796983,10,4,6,4,6,0,0,2,3,2,1,0,3,0,0,0,10
8344,796981,18,2,3,1,2,1,1,3,4,0,1,1,0,1,1,0,8
8344,791618,16,1,4,1,2,0,2,0,0,1,2,2,3,0,0,0,2
8344,780555,18,2,3,1,1,1,2,0,0,0,4,4,3,0,1,1,5
8344,786429,7,1,2,1,2,0,0,0,0,1,1,0,0,0,0,0,2
8344,786430,7,2,3,2,3,0,0,0,0,2,3,0,0,0,0,0,4
8344,796984,10,1,4,1,3,0,1,0,0,0,0,0,0,1,1,0,2
8344,791617,10,1,4,1,3,0,1,0,0,1,1,1,1,0,0,0,2
8344,780432,9,1,2,0,0,1,2,0,0,0,0,0,1,2,0,0,3
8344,796985,3,0,2,0,1,0,1,0,0,0,1,1,0,0,0,0,0
8345,792249,22,2,3,2,2,0,1,0,0,1,3,2,1,0,1,1,4
8345,781430,23,2,6,2,5,0,1,1,2,0,3,0,0,2,3,0,5
8345,797941,19,0,4,0,3,0,1,0,0,1,1,0,0,2,1,0,0
8345,781445,29,3,13,2,4,1,9,3,3,1,1,1,1,2,1,0,10
8345,768845,24,3,8,3,6,0,2,0,0,1,3,0,2,0,2,0,6
8345,781448,17,2,4,2,4,0,0,1,1,2,5,0,1,0,1,0,5
8345,792250,22,4,11,2,3,2,8,0,1,0,0,1,1,0,0,0,10
8345,792251,9,1,2,0,0,1,2,0,2,0,0,0,0,0,0,0,3
8345,786076,18,2,6,2,5,0,1,5,7,1,0,1,0,0,1,0,9
8345,797957,9,0,0,0,0,0,0,0,0,1,2,0,1,0,0,0,0
8345,797944,3,0,2,0,1,0,1,0,0,0,2,0,0,0,0,1,0
8345,786072,1,0,1,0,1,0,0,0,0,0,0,0,0,0,0,0,0
8345,792253,4,0,0,0,0,0,0,0,0,0,0,0,0,0,0,0,0
8346,784640,15,0,6,0,4,0,2,0,0,1,2,2,0,0,1,0,0
8346,797655,28,5,6,5,6,0,0,1,3,3,5,1,1,0,2,0,11
8346,792069,40,7,11,6,9,1,2,6,8,0,3,4,1,0,5,0,21
8346,797657,35,5,9,3,4,2,5,0,0,0,1,1,3,1,0,0,12
8346,792072,31,0,0,0,0,0,0,3,4,0,2,1,3,2,0,0,3
8346,797652,24,4,5,3,4,1,1,1,3,0,6,1,3,3,3,0,10
8346,785572,23,4,9,4,5,0,4,2,3,0,3,5,1,2,1,0,10
8346,786025,4,0,1,0,1,0,0,0,0,0,1,0,0,0,0,0,0
8346,774844,0,0,0,0,0,0,0,0,0,0,0,0,0,0,0,0,0
8347,792370,36,2,7,2,4,0,3,0,0,1,4,2,5,1,3,0,4
8347,781598,14,2,4,2,3,0,1,1,2,1,1,1,1,0,1,0,5
8347,792373,30,5,10,4,8,1,2,4,4,1,3,1,2,0,0,0,15
8347,775303,35,2,6,1,1,1,5,0,0,0,4,5,3,1,4,1,5
8347,797951,22,3,9,0,1,3,8,0,0,0,1,0,1,0,0,0,9
8347,797958,23,3,5,1,1,2,4,1,2,2,1,1,0,0,1,0,9
8347,790499,12,4,6,4,5,0,1,0,0,0,0,0,5,2,0,0,8
8347,776491,20,2,7,2,6,0,1,0,0,0,5,1,1,1,2,1,4
8347,781597,5,0,1,0,0,0,1,0,0,1,1,0,1,0,0,0,0
8347,792368,3,2,3,1,1,1,2,0,0,1,0,0,1,0,1,0,5
8348,776309,22,6,10,6,10,0,0,1,2,1,4,4,1,3,1,0,13
8348,786232,13,4,9,3,6,1,3,3,4,1,1,0,0,2,1,0,12
8348,786237,17,3,7,3,7,0,0,4,6,2,4,1,0,1,1,0,10
8348,785227,16,3,5,3,5,0,0,1,3,3,3,1,2,0,0,3,7
8348,792288,18,3,5,3,4,0,1,0,0,4,8,1,2,0,0,0,6
8348,798084,26,10,14,8,12,2,2,1,1,1,3,2,2,2,0,0,23
8348,798067,19,6,7,6,7,0,0,0,0,2,3,0,1,2,0,2,12
8348,780287,21,5,10,5,6,0,4,0,0,0,3,2,2,3,0,0,10
8348,792278,17,4,11,3,5,1,6,0,0,0,2,2,0,0,1,0,9
8348,798077,11,1,3,0,1,1,2,2,2,0,0,0,1,0,0,0,5
8348,798072,7,2,2,2,2,0,0,1,2,3,3,0,0,0,1,1,5
8348,792282,4,1,1,1,1,0,0,2,2,0,2,1,0,0,0,0,4
8348,798068,9,0,5,0,5,0,0,1,2,1,0,1,1,1,0,0,1
8350,797861,33,8,13,8,13,0,0,3,4,3,8,2,1,1,2,0,19
8350,797859,29,3,4,2,3,1,1,3,4,0,1,3,3,0,3,1,10
8350,792208,36,4,7,2,4,2,3,10,10,0,8,3,0,0,2,0,20
8350,786262,24,2,5,0,1,2,4,0,0,0,1,2,2,1,1,0,6
8350,781314,36,3,10,3,7,0,3,3,3,0,3,2,4,1,3,0,9
8350,776018,11,0,0,0,0,0,0,0,0,0,1,0,2,0,1,1,0
8350,797856,5,0,0,0,0,0,0,0,0,0,1,2,0,0,1,0,0
8350,792204,22,3,9,1,3,2,6,0,0,0,1,3,2,1,2,0,8
8350,781317,4,1,1,0,0,1,1,0,0,0,0,0,0,0,0,0,3
8351,791512,16,1,4,1,4,0,0,3,5,0,2,1,4,1,1,1,5
8351,786338,40,5,12,2,5,3,7,0,1,1,8,1,2,2,3,0,13
8351,797647,27,2,4,1,2,1,2,0,0,1,0,3,2,3,2,0,5
8351,792050,30,7,10,5,5,2,5,0,0,1,2,6,1,2,1,0,16
8351,785347,32,4,11,3,7,1,4,2,3,0,3,4,4,1,1,0,11
8351,792047,23,8,13,5,8,3,5,0,0,4,2,1,2,0,2,1,19
8351,792045,0,0,0,0,0,0,0,0,0,0,0,0,0,0,1,0,0
8351,797648,5,0,0,0,0,0,0,0,0,0,0,0,0,0,0,0,0
8351,792051,5,1,1,1,1,0,0,0,0,0,1,0,0,0,1,0,2
8351,780862,5,1,1,0,0,1,1,0,0,0,0,0,1,0,0,0,3
8351,792052,17,1,4,0,2,1,2,1,2,0,2,0,2,1,0,0,4
8352,780201,33,2,10,2,10,0,0,4,8,6,10,0,3,1,2,0,8
8352,791469,29,3,8,3,8,0,0,2,4,3,5,0,2,0,1,3,8
8352,797210,38,5,13,4,10,1,3,4,5,0,2,5,2,3,4,0,15
8352,786311,40,7,16,3,7,4,9,1,1,1,1,1,4,0,2,0,19
8352,775516,35,6,12,6,10,0,2,5,5,4,3,4,4,1,1,0,17
8352,798344,9,0,1,0,1,0,0,2,2,2,0,0,3,1,1,1,2
8352,791467,16,1,8,1,3,0,5,0,0,1,3,0,1,1,0,0,2
8352,791471,0,0,0,0,0,0,0,0,0,0,0,0,0,0,0,0,0
8353,797367,30,3,5,3,5,0,0,1,4,1,3,2,0,2,1,1,7
8353,797369,31,7,10,4,5,3,5,0,0,0,2,2,3,1,4,1,17
8353,797366,10,0,3,0,2,0,1,0,0,1,1,1,3,1,2,0,0
8353,791807,37,3,7,1,2,2,5,8,9,0,5,1,2,0,0,0,16
8353,786130,38,7,15,5,8,2,7,2,3,0,8,0,4,1,3,0,18
8353,797364,12,1,3,1,3,0,0,2,2,1,3,0,4,0,0,1,4
8353,797365,15,1,4,0,0,1,4,0,0,0,3,0,1,0,0,0,3
8353,797363,27,1,7,1,3,0,4,10,10,0,2,5,3,0,2,0,12
8354,797579,27,4,6,0,0,4,6,1,2,0,9,0,4,0,2,0,13
8354,786509,21,7,7,7,7,0,0,0,1,3,7,2,3,1,3,0,14
8354,786507,24,2,6,0,3,2,3,0,0,0,2,3,1,0,1,0,6
8354,785796,26,3,11,3,7,0,4,3,4,0,6,3,3,0,4,0,9
8354,797576,27,6,7,3,3,3,4,0,0,0,1,4,0,0,1,0,15
8354,797582,1,0,0,0,0,0,0,0,0,0,1,0,0,0,0,0,0
8354,797581,4,0,0,0,0,0,0,0,2,0,0,0,0,0,0,0,0
8354,797578,10,2,3,2,2,0,1,1,1,0,2,0,1,1,1,0,5
8354,791896,18,5,10,0,1,5,9,0,0,0,3,0,0,0,0,0,15
8354,781325,24,3,6,3,3,0,3,0,0,0,3,3,2,0,0,0,6
8354,791897,18,1,3,1,3,0,0,4,4,0,7,3,1,0,2,0,6
8356,790951,21,2,2,2,2,0,0,0,0,1,5,1,2,1,0,0,4
8356,786309,30,4,7,1,2,3,5,2,2,4,2,3,2,1,0,0,13
8356,780087,31,8,14,8,12,0,2,5,5,2,7,2,4,1,2,0,21
8356,776076,30,1,6,1,6,0,0,0,0,0,3,1,0,0,2,0,2
8356,776136,32,2,8,1,3,1,5,5,6,0,1,7,3,0,2,0,10
8356,796543,14,0,2,0,2,0,0,0,2,0,1,0,2,0,0,0,0
8356,775037,7,0,0,0,0,0,0,0,0,0,3,0,0,0,1,0,0
8356,796545,6,0,2,0,2,0,0,0,0,0,1,1,1,1,1,0,0
8356,790952,3,1,2,1,1,0,1,0,0,0,0,0,0,0,0,0,2
8356,786089,26,5,12,3,4,2,8,1,2,0,4,1,2,1,1,0,13
8357,791988,29,10,12,10,12,0,0,5,8,4,5,0,3,1,5,1,25
8357,796506,9,0,1,0,1,0,0,1,2,2,2,0,0,0,0,1,1
8357,796507,33,1,9,0,4,1,5,0,0,0,2,2,4,1,1,0,3
8357,796503,30,4,10,3,7,1,3,0,1,0,4,0,3,2,2,0,9
8357,791989,38,2,12,2,7,0,5,1,6,0,5,1,1,1,2,0,5
8357,780077,4,1,1,1,1,0,0,0,0,1,0,0,0,0,1,0,2
8357,792443,14,0,0,0,0,0,0,2,2,0,1,1,0,0,1,0,2
8357,796508,23,1,3,0,0,1,3,0,0,0,4,0,1,0,0,0,3
8357,785258,20,1,1,1,1,0,0,0,0,0,2,0,3,1,1,0,2
8358,775536,12,1,1,1,1,0,0,0,0,1,0,0,2,0,2,0,2
8358,796444,34,5,7,5,7,0,0,1,3,2,3,2,3,0,1,0,11
8358,790890,34,2,9,1,7,1,2,1,2,4,3,8,1,2,1,0,6
8358,786732,22,3,6,3,4,0,2,1,2,3,2,1,2,0,4,1,7
8358,775260,37,8,14,2,3,6,11,2,2,0,4,2,0,0,4,0,24
8358,790889,25,2,5,1,3,1,2,2,2,1,1,0,1,0,0,0,7
8358,786615,36,6,12,4,8,2,4,1,2,2,9,4,2,2,3,0,15
8358,796445,0,0,0,0,0,0,0,0,0,0,0,0,0,0,0,0,0
8359,790844,15,1,3,0,1,1,2,0,2,0,0,1,0,1,1,0,3
8359,775142,23,3,10,3,8,0,2,3,3,2,1,1,3,0,1,1,9
8359,790843,35,5,8,4,5,1,3,0,0,1,4,4,1,2,2,0,11
8359,786212,33,5,11,1,5,4,6,0,0,1,4,0,3,2,1,0,14
8359,785392,32,2,8,2,8,0,0,1,2,2,1,1,2,4,0,0,5
8359,780094,26,6,13,5,11,1,2,1,2,3,6,0,4,0,2,1,14
8359,799986,16,1,1,1,1,0,0,0,0,0,0,0,2,1,0,2,2
8359,781563,5,0,1,0,0,0,1,0,0,0,0,0,0,0,2,0,0
8359,796914,15,0,2,0,1,0,1,0,0,0,0,3,1,1,1,0,0
8366,791482,25,5,10,3,3,2,7,1,1,1,5,0,3,1,0,0,13
8366,786319,15,0,0,0,0,0,0,2,2,0,3,3,1,0,1,0,2
8366,786318,31,7,13,1,2,6,11,4,4,1,3,2,0,0,2,1,24
8366,784268,27,0,5,0,3,0,2,2,2,0,3,2,1,0,2,0,2
8366,780223,23,1,5,0,2,1,3,3,4,1,3,3,1,1,0,1,6
8366,791481,20,1,3,1,3,0,0,0,0,3,3,0,1,0,0,2,2
8366,780225,20,3,5,0,0,3,5,2,2,0,3,0,2,0,0,0,11
8366,797199,24,3,5,1,3,2,2,0,0,0,0,3,1,1,2,1,8
8366,786317,1,0,0,0,0,0,0,0,0,0,1,0,0,0,0,0,0
8366,797200,9,1,2,0,0,1,2,0,0,0,2,1,0,0,0,0,3
8366,786320,1,1,1,0,0,1,1,0,0,0,0,0,0,0,0,0,3
8366,797198,1,0,0,0,0,0,0,0,0,0,1,0,0,0,0,0,0
8366,791480,1,0,0,0,0,0,0,0,0,0,0,0,0,0,0,0,0
8366,796079,1,0,0,0,0,0,0,0,0,0,0,0,0,0,0,0,0
8366,797201,1,0,0,0,0,0,0,0,0,0,0,0,0,0,0,0,0
8367,791787,27,4,8,4,7,0,1,3,4,1,5,0,2,0,0,0,11
8367,789048,27,3,7,3,7,0,0,2,2,2,4,0,0,1,2,2,8
8367,789046,21,2,7,1,3,1,4,0,0,1,1,1,3,2,1,0,5
8367,791786,34,2,6,2,4,0,2,0,0,0,3,0,1,0,1,0,4
8367,789041,25,6,12,3,6,3,6,2,3,1,2,1,1,1,1,0,17
8367,791785,5,0,0,0,0,0,0,0,0,0,0,1,2,0,0,0,0
8367,785540,11,1,4,1,4,0,0,0,0,2,2,0,2,1,1,0,2
8367,797630,21,0,7,0,3,0,4,0,0,0,2,1,2,0,1,0,0
8367,797629,11,2,4,2,3,0,1,0,1,0,1,0,1,0,0,0,4
8367,789044,10,1,1,0,0,1,1,0,0,1,1,0,1,0,0,0,3
8367,797633,1,0,1,0,0,0,1,0,0,0,0,0,0,0,0,0,0
8367,797632,1,0,0,0,0,0,0,0,0,0,0,0,0,0,0,0,0
8367,799762,1,0,0,0,0,0,0,0,0,0,0,0,0,0,0,0,0
8367,797631,5,0,0,0,0,0,0,0,0,0,0,0,0,0,0,0,0
8368,785987,26,1,3,0,1,1,2,3,3,0,3,2,3,0,1,0,6
8368,776037,34,5,11,5,11,0,0,1,2,1,0,2,1,1,3,0,11
8368,780588,16,1,6,1,6,0,0,2,2,3,2,1,0,0,1,0,4
8368,786147,27,3,5,2,3,1,2,0,0,0,0,3,4,0,0,0,7
8368,780667,28,4,11,2,5,2,6,2,2,0,4,2,2,1,2,0,12
8368,792562,4,0,1,0,0,0,1,0,0,0,0,0,0,0,1,0,0
8368,782643,24,5,9,5,9,0,0,1,2,5,6,1,3,0,1,5,11
8368,781647,15,3,7,1,4,2,3,0,0,0,2,0,3,0,3,0,8
8368,791759,14,3,5,3,4,0,1,0,0,1,0,2,1,0,0,0,6
8368,775680,12,1,4,1,1,0,3,0,0,0,1,0,0,0,1,0,2
8369,786550,31,4,6,4,5,0,1,4,4,0,7,1,3,1,2,0,12
8369,776054,28,4,7,4,5,0,2,5,8,1,7,2,2,1,0,2,13
8369,792007,32,6,14,6,13,0,1,3,5,1,4,1,1,2,0,0,15
8369,792009,34,2,7,2,7,0,0,2,2,2,2,1,1,1,2,1,6
8369,792006,37,9,12,9,11,0,1,3,6,0,3,5,4,2,2,0,21
8369,792008,13,2,3,2,3,0,0,0,0,2,0,0,2,0,1,0,4
8369,797506,15,2,7,0,2,2,5,0,0,0,0,1,2,0,0,0,6
8369,786552,10,0,0,0,0,0,0,0,0,0,0,0,0,0,0,0,0
8370,791316,34,10,15,10,15,0,0,2,2,4,4,2,2,1,1,2,22
8370,780870,25,4,14,4,14,0,0,0,0,5,3,1,3,1,0,1,8
8370,781079,32,1,8,0,3,1,5,0,0,0,5,6,1,2,1,0,3
8370,781443,31,8,11,2,3,6,8,2,3,0,0,4,2,2,2,0,24
8370,775822,34,5,11,3,4,2,7,4,4,1,4,6,1,0,1,0,16
8370,796625,13,0,2,0,1,0,1,2,2,0,1,0,2,1,0,0,2
8370,796621,13,3,5,1,2,2,3,0,0,1,1,2,1,1,1,1,8
8370,791314,7,0,0,0,0,0,0,0,0,0,1,0,2,0,0,0,0
8370,785380,11,1,4,1,3,0,1,0,0,0,2,0,2,0,0,0,2
8371,780832,33,3,4,3,4,0,0,6,6,2,5,2,1,0,3,1,12
8371,796557,9,0,0,0,0,0,0,0,0,0,1,0,0,0,1,0,0
8371,786240,25,1,1,1,1,0,0,1,2,0,3,2,3,0,1,1,3
8371,785278,32,4,12,1,4,3,8,2,3,0,3,0,3,0,1,1,13
8371,780146,29,5,17,4,12,1,5,2,2,1,2,4,1,1,3,0,13
8371,796556,9,0,1,0,0,0,1,0,0,0,0,0,0,0,0,0,0
8371,796554,25,2,4,2,2,0,2,0,0,3,3,0,2,1,1,2,4
8371,796555,8,1,2,1,1,0,1,0,2,0,3,0,1,1,0,0,2
8371,775860,30,9,14,5,7,4,7,2,2,3,3,2,3,3,3,0,24
8372,791837,25,2,8,2,6,0,2,0,0,2,3,0,3,0,1,0,4
8372,780613,33,8,14,8,13,0,1,2,2,1,6,3,4,0,4,1,18
8372,775097,24,7,8,7,8,0,0,2,6,1,4,5,1,1,0,1,16
8372,780609,39,1,8,0,2,1,6,6,8,1,8,6,1,4,1,0,9
8372,776395,37,7,15,2,6,5,9,1,2,0,5,1,2,1,0,0,20
8372,786621,14,1,2,1,1,0,1,3,4,0,0,1,2,0,0,1,5
8372,786619,5,0,0,0,0,0,0,0,0,0,0,0,0,1,0,0,0
8372,797437,4,0,1,0,1,0,0,0,0,0,0,0,1,0,0,0,0
8372,786622,19,2,3,1,2,1,1,2,2,0,1,1,1,0,0,0,7
8373,797028,23,2,5,2,3,0,2,3,4,1,4,0,3,0,4,0,7
8373,775047,11,0,0,0,0,0,0,0,0,0,1,0,3,0,1,1,0
8373,797025,29,4,8,2,4,2,4,0,0,1,3,4,3,0,0,2,10
8373,791600,31,5,9,2,2,3,7,1,2,0,5,0,0,0,0,1,14
8373,780410,37,3,13,3,7,0,6,1,3,1,3,2,1,2,1,0,7
8373,797026,18,5,7,4,4,1,3,4,4,0,2,1,1,0,0,1,15
8373,791598,22,4,8,4,6,0,2,1,1,0,4,2,4,0,2,2,9
8373,797027,9,0,0,0,0,0,0,0,0,0,2,0,3,0,2,1,0
8373,792116,20,1,5,0,2,1,3,0,1,2,1,2,1,0,1,0,3
8374,791302,34,9,12,9,10,0,2,4,7,3,7,0,1,2,3,3,22
8374,781622,29,3,6,0,1,3,5,0,0,2,1,0,3,1,1,0,9
8374,791309,37,6,15,5,9,1,6,1,2,3,8,13,3,1,2,0,14
8374,785835,27,7,10,5,5,2,5,2,3,2,5,0,2,1,2,0,18
8374,776334,30,1,10,0,4,1,6,2,2,1,4,1,1,0,1,0,5
8374,796601,22,5,9,3,4,2,5,9,14,0,0,4,4,0,1,0,21
8374,775862,15,1,5,1,5,0,0,0,0,1,3,0,1,1,0,0,2
8374,791304,3,0,2,0,0,0,2,0,0,0,0,1,1,0,0,0,0
8374,796602,3,0,0,0,0,0,0,0,0,0,0,0,1,0,0,0,0
8375,791522,33,6,13,6,9,0,4,1,2,1,9,3,3,1,4,1,13
8375,786351,28,2,7,2,2,0,5,0,0,3,3,1,5,1,0,0,4
8375,786348,19,1,3,0,1,1,2,0,0,0,1,0,2,0,1,0,3
8375,797146,34,7,19,5,12,2,7,5,8,0,5,0,1,1,0,0,21
8375,797143,38,5,11,2,4,3,7,6,6,0,0,3,1,1,2,0,19
8375,785816,15,1,3,1,3,0,0,1,5,4,4,0,4,0,0,0,3
8375,797147,18,0,4,0,2,0,2,2,4,1,3,1,2,1,3,0,2
8375,797142,6,1,1,1,1,0,0,0,0,1,0,1,2,1,0,0,2
8375,797144,9,4,6,2,3,2,3,1,2,1,1,2,2,1,0,0,11
8376,781081,27,4,6,4,6,0,0,2,2,4,2,2,5,0,3,3,10
8376,791864,37,11,14,10,11,1,3,3,4,5,9,2,1,0,1,1,26
8376,791863,17,4,5,4,5,0,0,1,4,0,0,0,2,2,1,0,9
8376,797472,29,4,12,1,1,3,11,2,2,0,0,2,3,1,1,0,13
8376,780965,39,2,6,1,2,1,4,2,3,1,2,11,0,6,5,2,7
8376,797473,12,1,1,1,1,0,0,0,0,0,1,0,3,1,0,0,2
8376,786791,3,0,0,0,0,0,0,0,0,1,0,0,1,0,0,0,0
8376,797470,24,2,7,1,3,1,4,0,0,0,5,4,2,0,5,0,5
8376,786592,12,0,4,0,2,0,2,0,0,1,0,2,3,0,1,0,0
8377,792418,28,4,7,4,7,0,0,2,3,3,6,0,1,1,2,1,10
8377,782654,20,1,2,1,2,0,0,0,0,1,1,0,3,1,3,0,2
8377,796693,24,3,4,2,2,1,2,1,1,0,2,3,0,1,4,0,8
8377,796691,17,3,7,0,2,3,5,0,0,0,0,1,0,1,3,0,9
8377,789484,32,3,12,3,10,0,2,2,4,3,4,2,3,1,3,2,8
8377,796692,11,0,2,0,1,0,1,0,0,0,0,0,0,3,0,0,0
8377,792424,17,0,1,0,1,0,0,1,2,2,2,1,3,1,2,0,1
8377,792419,7,0,0,0,0,0,0,0,2,1,0,1,1,0,0,0,0
8377,800100,3,1,1,1,1,0,0,0,0,0,0,1,0,0,0,0,2
8377,792421,29,5,11,4,5,1,6,0,0,0,1,4,2,1,1,0,11
8377,792422,12,2,5,2,5,0,0,1,2,0,0,0,1,0,0,0,5
8378,791534,26,5,11,3,9,2,2,0,0,4,9,1,3,1,1,0,12
8378,797127,36,4,11,2,5,2,6,1,1,2,2,3,3,0,2,1,11
8378,791533,27,6,10,6,9,0,1,0,0,3,5,1,3,0,1,0,12
8378,780301,26,2,6,1,3,1,3,1,2,3,7,2,0,0,1,0,6
8378,775045,40,7,14,5,10,2,4,2,3,0,4,4,2,1,3,0,18
8378,791531,27,3,7,3,4,0,3,4,5,2,3,1,1,0,2,0,10
8378,774880,8,0,1,0,0,0,1,0,0,0,1,0,0,0,0,0,0
8378,797124,10,0,4,0,3,0,1,0,0,0,0,1,0,0,0,0,0
8379,785423,25,0,8,0,2,0,6,2,2,0,4,0,1,2,1,0,2
8379,775676,30,9,15,9,14,0,1,0,0,3,3,0,1,1,0,1,18
8379,786210,30,2,7,1,4,1,3,0,0,0,3,1,3,2,3,0,5
8379,785425,30,1,6,0,2,1,4,6,8,1,3,0,1,0,1,0,9
8379,785422,38,5,11,1,3,4,8,0,1,1,3,6,3,2,1,0,14
8379,786298,29,4,9,3,4,1,5,0,0,0,8,2,3,0,2,0,9
8379,774957,18,0,1,0,0,0,1,0,0,0,1,0,0,0,0,0,0
8380,790828,7,3,6,3,6,0,0,0,0,2,0,0,5,0,0,0,6
8380,785373,32,2,4,1,2,1,2,0,0,0,4,1,1,0,0,1,5
8380,785372,39,9,19,9,18,0,1,2,4,1,5,5,0,2,2,2,20
8380,790825,31,5,11,5,10,0,1,5,7,0,1,5,2,1,1,0,15
8380,774905,36,6,11,5,10,1,1,0,1,3,13,1,1,2,1,1,13
8380,796387,9,0,0,0,0,0,0,0,0,0,0,0,3,0,0,0,0
8380,785374,6,0,0,0,0,0,0,0,0,1,0,1,5,0,2,1,0
8380,786384,14,3,3,1,1,2,2,5,6,0,2,2,3,1,2,1,13
8380,785375,12,3,3,3,3,0,0,1,2,1,1,0,4,0,0,3,7
8380,796385,9,1,2,1,1,0,1,0,0,0,0,2,0,1,0,0,2
8380,790827,5,0,0,0,0,0,0,0,0,0,0,1,0,0,0,0,0
8381,791416,24,5,11,5,11,0,0,3,11,3,3,0,3,0,1,0,13
8381,781614,23,1,3,1,2,0,1,2,2,3,3,2,2,0,0,0,4
8381,797096,16,0,3,0,2,0,1,2,2,0,0,1,0,0,0,0,2
8381,785906,37,6,18,5,12,1,6,4,8,3,6,5,1,2,4,2,17
8381,780096,33,7,13,3,5,4,8,4,5,2,1,2,4,0,2,0,22
8381,797093,19,5,7,5,6,0,1,2,4,2,2,2,3,1,3,0,12
8381,780100,23,0,0,0,0,0,0,0,0,2,5,2,2,1,0,0,0
8381,785907,18,0,3,0,3,0,0,0,0,1,3,0,2,0,1,0,0
8381,797094,7,0,2,0,2,0,0,2,2,0,1,0,2,0,0,0,2
8382,776209,39,10,21,9,16,1,5,2,3,1,6,2,2,0,1,1,23
8382,791235,16,0,1,0,1,0,0,0,0,0,1,0,0,0,0,0,0
8382,791236,19,1,2,1,2,0,0,0,0,0,2,0,0,0,2,0,2
8382,791240,34,1,3,1,3,0,0,1,2,0,2,3,3,1,3,0,3
8382,791237,30,3,8,2,4,1,4,5,8,0,4,6,4,5,1,0,12
8382,788124,4,0,0,0,0,0,0,0,0,0,1,0,0,0,0,0,0
8382,781227,6,0,0,0,0,0,0,0,0,0,1,0,0,0,0,0,0
8382,796938,26,4,8,1,4,3,4,4,4,1,0,0,4,0,6,0,15
8382,791238,26,7,12,7,12,0,0,0,0,1,6,2,3,1,1,1,14
8383,780291,36,5,12,3,7,2,5,1,2,6,3,0,1,0,2,1,13
8383,785607,10,0,1,0,1,0,0,0,0,0,1,0,1,0,0,0,0
8383,796665,36,10,16,2,2,8,14,1,3,0,2,2,3,1,1,0,29
8383,785333,35,2,6,1,2,1,4,8,12,1,9,7,2,2,1,0,13
8383,775305,37,4,13,2,9,2,4,3,4,0,6,4,1,5,2,1,13
8383,796663,7,0,1,0,1,0,0,0,0,0,1,1,0,0,1,0,0
8383,791004,18,4,6,2,3,2,3,0,0,1,5,2,1,2,1,0,10
8383,791006,2,0,0,0,0,0,0,0,0,0,0,0,0,0,0,0,0
8383,796666,10,1,2,1,2,0,0,0,0,0,1,0,2,0,1,0,2
8383,796664,9,1,2,1,1,0,1,0,0,0,0,1,2,0,2,0,2
8384,791981,29,5,13,4,9,1,4,1,2,0,6,0,4,1,1,0,12
8384,780342,25,5,10,3,8,2,2,2,3,5,4,4,1,1,1,1,14
8384,791982,30,3,7,2,3,1,4,1,1,0,3,2,1,0,3,0,8
8384,780333,24,5,8,3,5,2,3,2,4,0,3,5,4,1,2,0,14
8384,781493,28,6,8,2,2,4,6,1,2,0,2,2,3,0,1,0,17
8384,786755,24,2,3,2,2,0,1,2,4,0,5,3,4,2,2,0,6
8384,791985,2,0,0,0,0,0,0,0,0,0,0,0,0,0,1,0,0
8384,791986,11,1,2,1,1,0,1,1,2,0,3,2,0,1,1,0,3
8384,786756,18,2,7,1,3,1,4,2,2,1,4,0,1,1,1,0,7
8384,791984,7,0,1,0,0,0,1,0,0,1,1,1,2,2,0,0,0
8384,800198,2,0,1,0,1,0,0,0,0,0,0,1,0,1,0,0,0
8385,786180,5,0,0,0,0,0,0,0,0,0,0,0,0,0,1,0,0
8385,792104,31,5,18,5,12,0,6,6,6,1,6,0,1,1,2,0,16
8385,797709,20,3,9,2,4,1,5,2,3,0,0,1,4,2,1,2,9
8385,797708,27,2,7,2,3,0,4,0,0,0,2,2,2,2,1,0,4
8385,775779,31,2,7,2,6,0,1,0,0,1,5,4,3,2,1,0,4
8385,786198,21,2,4,1,2,1,2,0,0,1,2,0,1,0,2,1,5
8385,786204,23,2,5,2,3,0,2,0,0,0,4,0,2,1,1,0,4
8385,797707,23,1,3,1,2,0,1,4,8,1,2,4,2,0,4,0,6
8385,785608,13,4,5,3,3,1,2,1,2,2,1,0,4,0,1,0,10
8385,776327,3,0,0,0,0,0,0,0,2,0,1,0,0,0,1,0,0
8385,792106,3,0,0,0,0,0,0,0,0,0,0,0,0,0,1,0,0
8386,780263,3,0,1,0,1,0,0,0,0,0,0,0,0,0,0,0,0
8386,799000,20,8,14,8,14,0,0,3,4,3,6,2,3,1,1,1,19
8386,786697,26,3,8,3,6,0,2,0,0,0,3,3,0,3,0,1,6
8386,775628,17,4,12,4,8,0,4,2,3,0,10,2,0,2,3,2,10
8386,785471,29,5,10,5,10,0,0,1,2,4,2,1,3,1,0,3,11
8386,792399,24,3,6,3,4,0,2,0,0,0,6,1,1,3,0,0,6
8386,780571,25,1,6,1,2,0,4,4,4,0,2,2,2,1,0,0,6
8386,775198,24,5,9,3,4,2,5,3,4,2,4,1,3,1,2,0,15
8386,786695,10,2,7,1,2,1,5,0,0,0,2,1,4,1,0,0,5
8386,798999,5,0,3,0,1,0,2,0,0,1,0,0,0,1,0,0,0
8386,792397,17,2,9,2,8,0,1,0,0,2,1,0,0,1,1,0,4
8387,799130,28,0,7,0,0,0,7,0,0,0,4,0,1,0,4,1,0
8387,792634,36,0,11,0,5,0,6,0,0,1,2,2,2,2,1,0,0
8387,799129,32,3,11,1,5,2,6,2,2,1,10,2,3,0,7,0,10
8387,800091,32,6,14,6,13,0,1,5,7,1,6,1,2,0,4,1,17
8387,800005,21,0,4,0,4,0,0,0,0,1,7,0,2,0,1,2,0
8387,799134,19,2,5,1,2,1,3,2,2,1,4,0,2,1,5,0,7
8387,799133,12,1,4,1,4,0,0,3,4,2,3,0,2,0,4,0,5
8387,799128,7,3,5,3,5,0,0,0,1,1,2,0,0,0,3,0,6
8387,799136,5,0,0,0,0,0,0,0,0,0,0,0,0,0,0,0,0
8387,799135,8,0,1,0,1,0,0,0,0,0,1,0,2,0,0,0,0
8388,790863,22,4,7,3,5,1,2,3,6,3,4,2,2,0,2,0,12
8388,780021,29,5,9,5,9,0,0,0,1,5,5,0,2,3,3,4,10
8388,785412,26,1,9,1,5,0,4,0,0,1,2,2,2,1,1,0,2
8388,780099,36,4,8,1,2,3,6,0,0,1,2,3,2,0,0,0,11
8388,776214,36,3,12,1,4,2,8,1,2,1,1,6,3,2,3,0,9
8388,775686,21,2,3,2,3,0,0,2,2,2,2,0,1,1,0,1,6
8388,776221,10,0,2,0,2,0,0,0,0,0,0,1,0,0,3,0,0
8388,785417,8,0,1,0,1,0,0,0,0,0,1,0,0,0,0,1,0
8388,785411,7,1,5,0,2,1,3,0,0,0,0,0,0,0,1,0,3
8388,785413,5,0,1,0,1,0,0,0,0,0,1,0,1,0,0,0,0
8389,786447,32,3,7,3,6,0,1,1,2,1,4,1,1,0,1,0,7
8389,775074,32,4,6,4,6,0,0,2,3,2,7,0,2,1,5,1,10
8389,786448,28,3,5,2,4,1,1,3,4,1,2,3,3,3,0,0,10
8389,780731,33,1,7,1,5,0,2,8,8,1,3,3,0,0,3,0,10
8389,780462,38,6,17,4,12,2,5,0,0,0,3,0,2,1,2,0,14
8389,791632,6,1,3,1,3,0,0,0,0,0,0,0,2,0,0,0,2
8389,786132,10,2,2,2,2,0,0,0,0,5,1,0,3,0,2,0,4
8389,796971,16,1,6,1,5,0,1,1,2,1,3,1,0,0,0,0,3
8389,791631,5,0,2,0,1,0,1,0,0,0,0,0,0,0,0,0,0
8390,786857,25,1,8,0,6,1,2,2,3,1,3,0,5,2,2,1,5
8390,781403,38,3,12,3,7,0,5,4,4,1,2,3,3,1,3,1,10
8390,792654,33,5,6,5,6,0,0,8,12,3,7,1,2,0,5,1,18
8390,797301,37,4,11,3,5,1,6,1,2,1,2,3,2,3,2,0,10
8390,781400,33,4,10,3,5,1,5,0,0,0,0,1,0,1,2,0,9
8390,792653,7,1,3,1,3,0,0,0,0,0,2,0,0,1,0,0,2
8390,780524,16,0,2,0,2,0,0,0,0,0,3,1,0,2,0,0,0
8390,797302,8,1,1,0,0,1,1,0,0,0,0,0,0,0,1,0,3
8390,797303,3,0,0,0,0,0,0,0,0,0,0,0,1,0,0,0,0
8391,796812,21,4,7,4,7,0,0,0,1,3,4,2,3,0,1,2,8
8391,780952,22,3,6,3,6,0,0,1,2,6,1,0,5,1,1,2,7
8391,791155,34,8,17,7,14,1,3,3,3,1,9,1,1,0,3,0,20
8391,786609,27,3,7,3,6,0,1,2,3,2,3,2,2,0,2,1,8
8391,796810,34,8,16,8,14,0,2,1,2,1,4,7,1,6,0,0,17
8391,780945,10,1,3,1,3,0,0,0,0,2,2,0,3,0,1,0,2
8391,796814,13,0,1,0,1,0,0,0,0,1,2,0,3,1,3,0,0
8391,791156,10,1,1,1,1,0,0,1,2,1,1,0,1,0,2,0,3
8391,780950,26,2,8,1,3,1,5,0,0,0,1,0,1,0,1,0,5
8391,785752,3,0,0,0,0,0,0,0,0,0,1,0,0,0,0,0,0
8398,792197,37,6,10,3,6,3,4,2,3,0,6,1,0,1,0,0,17
8398,797522,12,2,2,2,2,0,0,0,0,1,0,0,5,0,1,0,4
8398,781132,35,7,14,5,10,2,4,1,1,2,7,4,0,2,1,1,17
8398,797518,33,5,15,5,13,0,2,2,3,1,6,9,1,1,2,0,12
8398,791940,31,3,11,2,8,1,3,3,3,1,3,1,0,1,1,0,10
8398,797521,16,3,5,2,2,1,3,1,2,1,2,0,5,0,2,0,8
8398,797520,9,3,3,0,0,3,3,0,0,0,2,0,2,0,0,0,9
8398,786539,6,0,0,0,0,0,0,1,2,0,2,1,2,0,1,0,1
8398,791939,2,0,0,0,0,0,0,0,0,0,0,0,1,0,0,0,0
8398,789070,2,0,0,0,0,0,0,0,0,0,0,0,1,0,0,0,0
8398,791938,17,1,1,1,1,0,0,10,12,1,0,1,3,0,0,1,12
8399,790935,18,1,8,1,3,0,5,0,0,0,2,0,3,0,1,0,2
8399,792442,21,2,2,2,2,0,0,1,4,3,1,0,2,1,2,3,5
8399,780933,27,3,9,0,3,3,6,0,0,0,3,1,3,1,0,1,9
8399,775340,34,8,17,7,12,1,5,5,5,2,5,4,2,1,1,0,22
8399,774826,25,1,4,1,2,0,2,1,1,0,1,0,1,0,1,0,3
8399,796190,19,3,7,0,0,3,7,0,0,3,1,2,3,0,0,0,9
8399,790937,16,2,3,2,3,0,0,1,2,1,3,0,1,0,2,1,5
8399,785445,16,2,7,1,2,1,5,0,0,0,5,0,3,0,0,0,5
8399,790938,15,2,5,2,4,0,1,0,0,1,3,4,1,0,3,0,4
8399,796492,3,0,2,0,2,0,0,0,0,1,0,1,1,0,0,0,0
8399,796493,3,0,0,0,0,0,0,2,2,0,0,0,0,0,0,0,2
8399,796491,3,2,3,2,2,0,1,3,5,1,1,0,3,0,1,0,7
8400,797573,21,3,6,3,6,0,0,2,2,3,1,0,5,0,1,2,8
8400,791903,18,3,7,2,5,1,2,1,1,0,1,0,1,0,1,0,8
8400,791899,36,11,20,11,19,0,1,4,9,2,4,3,2,1,1,1,26
8400,786512,31,5,11,2,6,3,5,0,0,0,3,4,3,3,2,1,13
8400,786435,9,0,1,0,1,0,0,0,0,0,0,0,1,0,1,0,0
8400,797574,30,0,6,0,3,0,3,0,0,0,4,0,2,0,0,1,0
8400,797575,9,2,3,2,3,0,0,0,0,1,0,0,1,0,0,0,4
8400,800197,3,0,0,0,0,0,0,0,0,0,0,0,0,0,0,0,0
8400,797571,30,3,10,2,7,1,3,3,4,1,2,7,2,3,2,1,10
8400,786032,13,2,7,2,7,0,0,1,2,0,0,1,0,3,1,0,5
8401,785495,28,9,13,9,13,0,0,0,0,1,7,1,1,0,2,0,18
8401,785958,28,8,11,8,11,0,0,5,5,5,7,2,1,0,2,1,21
8401,785659,19,5,5,4,4,1,1,5,6,1,1,1,3,0,1,2,16
8401,785494,28,3,9,3,6,0,3,3,4,1,2,4,1,0,1,0,9
8401,780698,27,6,11,5,9,1,2,0,1,1,6,1,1,0,2,0,13
8401,796704,3,2,2,1,1,1,1,0,0,0,0,0,0,0,0,0,5
8401,785490,14,1,4,1,2,0,2,0,0,0,2,0,3,1,1,1,2
8401,791034,14,3,4,3,4,0,0,2,2,3,4,0,0,0,2,0,8
8401,775377,9,0,1,0,1,0,0,0,0,3,1,0,0,1,0,1,0
8401,791033,8,2,6,2,4,0,2,0,0,2,0,1,0,0,1,0,4
8401,785486,6,0,2,0,2,0,0,0,0,0,1,1,2,1,1,0,0
8401,780427,16,3,7,3,6,0,1,0,0,0,2,4,3,1,2,0,6
8402,796761,22,0,1,0,1,0,0,0,0,0,2,0,2,0,0,1,0
8402,780109,32,4,10,2,4,2,6,4,4,0,5,0,2,2,6,3,14
8402,796758,35,6,14,5,11,1,3,3,4,0,6,1,0,0,1,0,16
8402,785597,21,0,2,0,0,0,2,1,4,0,0,1,2,0,1,0,1
8402,780794,35,2,9,0,2,2,7,2,2,0,1,0,0,2,0,0,8
8402,798158,8,0,0,0,0,0,0,0,0,1,2,1,0,0,0,0,0
8402,791103,6,0,1,0,0,0,1,2,2,0,0,0,1,0,1,0,2
8402,796760,11,0,3,0,2,0,1,0,0,0,5,1,0,1,3,0,0
8402,796757,30,5,12,5,8,0,4,3,6,1,3,1,2,0,2,0,13
8403,780440,18,5,8,3,6,2,2,0,0,1,5,1,1,0,1,0,12
8403,775620,4,0,0,0,0,0,0,0,0,1,1,0,2,1,0,0,0
8403,791621,26,9,14,2,2,7,12,0,0,0,3,2,1,0,2,0,25
8403,786432,16,2,5,0,2,2,3,0,0,0,0,1,2,1,0,0,6
8403,786431,23,4,7,2,2,2,5,0,0,0,2,1,1,1,2,0,10
8403,796975,6,1,1,1,1,0,0,0,0,0,2,0,1,0,0,0,2
8403,791619,11,1,3,1,2,0,1,0,0,0,2,0,1,0,0,0,2
8403,791620,20,5,7,2,2,3,5,0,0,0,2,2,2,0,1,0,13
8403,786434,12,3,7,3,7,0,0,0,0,2,3,0,0,0,0,2,6
8403,781125,15,3,3,3,3,0,0,1,2,2,2,1,3,0,1,0,7
8403,780442,2,0,2,0,2,0,0,0,0,2,1,0,0,0,1,0,0
8403,796976,5,3,4,3,4,0,0,0,1,2,0,0,4,0,0,1,6
8403,796977,6,0,1,0,1,0,0,0,0,1,1,0,0,0,1,0,0
8403,786433,2,0,2,0,0,0,2,0,0,0,0,0,1,0,0,0,0
8403,781088,23,2,6,0,2,2,4,1,2,1,7,6,3,0,3,0,7
8403,775622,11,0,3,0,2,0,1,0,0,0,1,2,0,1,0,0,0
8404,792378,24,4,4,4,4,0,0,0,0,0,2,3,4,0,1,3,8
8404,797890,29,2,12,1,7,1,5,4,5,1,3,3,1,1,1,1,9
8404,786746,31,5,10,1,3,4,7,2,3,0,9,0,3,1,1,0,16
8404,780178,23,4,7,4,7,0,0,1,3,0,1,1,2,1,1,2,9
8404,797883,40,5,11,4,8,1,3,4,4,0,3,7,1,3,2,0,15
8404,797888,18,0,4,0,2,0,2,1,2,2,2,0,2,0,0,1,1
8404,775075,10,0,0,0,0,0,0,0,0,1,0,0,2,0,0,0,0
8404,785744,6,1,2,1,2,0,0,0,0,0,0,0,0,0,0,0,2
8404,797885,19,3,5,2,2,1,3,0,0,0,1,2,2,0,0,0,7
8405,780651,28,9,15,9,15,0,0,3,4,5,3,1,5,0,3,2,21
8405,791815,39,6,15,3,8,3,7,1,1,2,5,1,2,0,3,1,16
8405,791810,32,0,1,0,0,0,1,1,2,0,6,3,1,0,4,0,1
8405,791814,23,2,6,0,0,2,6,0,0,0,3,0,0,0,1,0,6
8405,780650,36,6,12,5,10,1,2,3,5,2,10,3,4,1,1,0,16
8405,791809,4,0,0,0,0,0,0,0,0,0,0,0,0,0,0,0,0
8405,791812,1,0,1,0,0,0,1,0,0,0,0,0,0,0,1,0,0
8405,781596,9,0,1,0,1,0,0,1,2,0,1,0,5,0,2,1,1
8405,786645,13,1,4,1,3,0,1,0,2,1,0,1,1,0,0,0,2
8405,786644,15,0,2,0,0,0,2,2,2,2,0,2,2,1,0,1,2
8406,796699,31,3,5,3,4,0,1,4,7,2,6,2,1,1,5,1,10
8406,790983,29,5,12,4,5,1,7,0,0,1,2,2,1,0,3,3,11
8406,790978,34,5,13,2,5,3,8,1,3,2,0,1,3,1,1,1,14
8406,790979,35,0,6,0,3,0,3,6,6,0,9,4,4,2,7,0,6
8406,788820,31,3,11,0,1,3,10,1,2,1,3,3,3,0,3,0,10
8406,796701,10,1,1,1,1,0,0,0,2,1,1,0,1,1,2,0,2
8406,796698,17,0,1,0,0,0,1,2,2,1,1,0,2,1,0,1,2
8406,790976,7,1,1,1,1,0,0,0,0,0,1,0,1,0,0,0,2
8406,790977,2,0,1,0,0,0,1,0,0,0,1,0,0,0,0,0,0
8406,790980,3,0,0,0,0,0,0,0,0,0,0,1,0,0,0,0,0
8406,789457,1,0,0,0,0,0,0,0,0,0,0,0,0,0,0,0,0
8407,785368,21,2,6,2,6,0,0,3,4,4,4,1,0,1,2,0,7
8407,780281,24,3,9,3,9,0,0,1,2,3,3,1,1,0,4,0,7
8407,790793,32,8,14,6,7,2,7,1,1,1,12,3,3,2,2,0,19
8407,785246,27,3,7,1,2,2,5,0,0,0,0,1,2,0,1,0,8
8407,780886,22,2,7,1,6,1,1,6,7,1,3,2,3,1,1,0,11
8407,790792,29,7,12,5,6,2,6,0,1,0,0,0,4,5,2,1,16
8407,790794,19,2,3,2,3,0,0,0,0,1,3,2,2,1,0,2,4
8407,790789,10,0,3,0,2,0,1,0,0,0,1,1,4,1,1,0,0
8407,796351,15,1,2,1,2,0,0,0,1,1,0,1,1,0,0,0,2
8407,796350,1,0,0,0,0,0,0,0,0,0,0,0,0,0,0,0,0
8408,781342,34,5,15,5,13,0,2,2,4,7,7,5,2,1,2,0,12
8408,781593,25,4,6,3,4,1,2,0,0,2,3,1,3,0,4,1,9
8408,790901,34,3,12,1,5,2,7,4,5,0,1,0,2,0,4,0,12
8408,785452,36,4,6,4,6,0,0,3,3,0,3,2,1,0,0,1,11
8408,781620,27,1,1,1,1,0,0,0,0,0,1,2,0,0,0,1,2
8408,790902,25,1,2,0,1,1,1,1,2,0,1,2,3,0,3,0,4
8408,796450,7,0,1,0,1,0,0,0,0,1,0,0,3,0,0,0,0
8408,774835,4,0,0,0,0,0,0,0,0,0,2,0,1,0,0,0,0
8408,796449,8,1,3,0,1,1,2,0,0,0,0,0,0,0,2,0,3
8409,785355,34,2,6,1,3,1,3,1,1,1,4,1,0,1,1,1,6
8409,781462,37,9,11,8,10,1,1,7,11,3,7,3,3,0,1,1,26
8409,780876,26,3,5,3,3,0,2,0,0,0,0,3,4,2,1,0,6
8409,785353,36,5,14,4,8,1,6,1,2,0,2,4,2,1,2,1,12
8409,781457,39,5,10,2,5,3,5,0,0,1,2,3,1,5,1,0,13
8409,790895,8,1,3,0,1,1,2,0,0,0,0,0,0,0,0,0,3
8409,781673,14,1,1,0,0,1,1,0,0,0,0,0,1,0,0,0,3
8409,792435,1,0,0,0,0,0,0,0,0,0,0,0,1,0,0,0,0
8409,796365,1,0,0,0,0,0,0,0,0,0,1,0,0,0,0,0,0
8409,790806,1,0,0,0,0,0,0,0,0,0,0,0,0,0,0,0,0
8409,791305,3,0,0,0,0,0,0,0,0,0,0,0,0,0,0,0,0
8410,780874,11,2,4,1,2,1,2,0,0,0,1,0,1,0,1,0,5
8410,781326,29,4,6,4,6,0,0,3,5,2,8,1,3,0,1,1,11
8410,797870,36,3,9,2,5,1,4,0,0,0,2,5,2,3,2,0,7
8410,792210,27,3,5,0,0,3,5,0,0,0,2,2,3,0,3,0,9
8410,781323,38,5,11,3,4,2,7,5,8,0,4,9,1,0,4,0,17
8410,785430,11,2,3,2,3,0,0,0,0,1,2,0,3,1,0,0,4
8410,797868,20,2,7,2,4,0,3,0,0,0,2,1,2,0,0,0,4
8410,792215,17,3,4,2,2,1,2,1,2,0,0,0,5,2,2,1,8
8410,785638,10,0,0,0,0,0,0,1,2,0,1,1,2,0,0,0,1
8410,797869,1,0,0,0,0,0,0,0,0,0,1,0,1,0,0,0,0
8411,791980,25,4,4,3,3,1,1,0,0,1,4,2,0,0,0,0,9
8411,785972,25,1,4,1,4,0,0,2,2,1,1,2,1,0,1,0,4
8411,785967,28,6,12,6,12,0,0,6,14,3,11,2,2,1,2,1,18
8411,791977,29,3,6,2,2,1,4,0,0,0,1,1,1,1,1,0,7
8411,791978,37,4,12,4,8,0,4,3,6,2,0,5,1,3,3,0,11
8411,780160,12,0,0,0,0,0,0,0,2,2,2,3,4,2,0,0,0
8411,791976,23,6,15,3,5,3,10,8,9,1,1,3,3,1,1,0,23
8411,785973,18,1,4,1,2,0,2,0,0,0,2,1,0,1,1,0,2
8411,797800,3,0,0,0,0,0,0,0,0,1,0,0,2,0,0,0,0
8412,791062,34,7,14,6,11,1,3,4,4,1,5,2,2,3,2,1,19
8412,791063,25,3,5,2,4,1,1,2,2,1,3,5,1,0,0,2,9
8412,785542,31,2,3,2,2,0,1,0,0,0,4,1,1,0,1,0,4
8412,780743,31,3,8,2,5,1,3,0,0,0,4,2,2,1,3,0,7
8412,780055,20,3,4,2,2,1,2,0,0,1,3,0,3,0,0,0,7
8412,796741,2,0,0,0,0,0,0,0,0,0,0,0,0,0,0,0,0
8412,791060,11,1,3,1,3,0,0,0,0,1,1,1,2,1,1,0,2
8412,785548,11,0,2,0,1,0,1,0,2,1,1,1,1,0,0,0,0
8412,796735,9,2,3,0,1,2,2,0,0,0,1,0,1,0,0,0,6
8412,796736,3,0,0,0,0,0,0,0,0,0,0,1,0,0,1,0,0
8412,796737,2,0,0,0,0,0,0,0,0,0,0,0,0,0,1,0,0
8412,791064,21,5,7,3,3,2,4,2,4,2,2,4,0,0,0,0,14
8413,797873,14,1,2,1,2,0,0,0,0,1,0,0,3,1,0,1,2
8413,797877,26,4,7,4,7,0,0,1,2,4,3,1,1,0,1,1,9
8413,797872,27,0,6,0,6,0,0,0,0,2,1,1,1,0,2,1,0
8413,791338,24,3,4,3,4,0,0,2,2,1,2,1,1,2,0,0,8
8413,791339,31,4,12,2,8,2,4,3,4,0,6,2,1,3,3,1,13
8413,791337,15,1,4,1,4,0,0,0,0,1,2,0,2,0,0,0,2
8413,785881,11,0,1,0,1,0,0,2,2,1,1,0,2,0,2,0,2
8413,781599,11,0,2,0,2,0,0,0,0,0,1,0,0,0,1,0,0
8413,797875,21,6,13,6,7,0,6,0,2,0,0,1,3,1,0,0,12
8413,797874,8,0,2,0,0,0,2,0,0,1,0,0,0,0,0,0,0
8413,781595,12,0,2,0,1,0,1,0,0,0,1,1,1,0,1,0,0
8414,781007,27,4,4,4,4,0,0,1,1,2,3,1,3,0,0,0,9
8414,781322,25,1,3,0,0,1,3,0,1,0,2,0,3,0,2,1,3
8414,785989,13,0,2,0,1,0,1,0,0,0,1,2,0,0,3,0,0
8414,786571,30,5,12,3,6,2,6,5,8,0,4,3,4,2,4,1,17
8414,781439,38,16,24,10,15,6,9,3,3,0,8,6,2,1,4,0,41
8414,797299,9,1,1,1,1,0,0,0,0,0,2,1,3,1,1,0,2
8414,781419,23,1,4,0,2,1,2,0,0,0,2,2,1,0,3,0,3
8414,781207,7,0,2,0,1,0,1,0,0,0,0,1,0,1,1,0,0
8414,780563,25,2,4,0,1,2,3,2,2,0,3,0,3,2,0,0,8
8414,791690,3,0,0,0,0,0,0,0,0,0,1,0,0,0,0,1,0
8415,781175,28,2,5,2,5,0,0,6,8,8,6,1,4,3,2,0,10
8415,786555,32,6,13,2,4,4,9,0,0,0,2,5,2,2,0,0,16
8415,786553,32,8,18,2,6,6,12,7,8,0,1,1,3,2,0,0,29
8415,780895,27,5,9,5,8,0,1,1,1,1,5,2,3,1,3,0,11
8415,781172,35,4,9,1,1,3,8,2,2,1,4,5,0,4,4,0,13
8415,792005,15,1,6,1,2,0,4,0,0,0,1,1,2,0,1,0,2
8415,785312,19,0,5,0,4,0,1,0,0,0,3,4,2,1,4,0,0
8415,781177,9,1,2,0,0,1,2,0,0,1,2,0,0,1,0,0,3
8415,797503,3,1,3,1,3,0,0,0,0,2,1,0,1,0,0,1,2
8415,797501,0,0,0,0,0,0,0,0,0,0,0,0,0,0,0,0,0
8416,785298,18,3,5,3,5,0,0,1,2,1,2,0,3,0,2,1,7
8416,775224,32,1,2,1,2,0,0,1,3,8,7,0,2,2,2,3,3
8416,778046,31,5,10,2,5,3,5,5,8,0,3,2,4,3,3,0,18
8416,782121,37,4,12,3,8,1,4,0,0,2,2,4,2,2,0,0,9
8416,775793,29,5,13,5,9,0,4,4,4,0,5,3,0,1,2,0,14
8416,786594,28,7,15,3,5,4,10,4,4,1,1,0,0,1,0,0,22
8416,785302,15,1,2,1,2,0,0,0,0,1,2,1,0,0,2,0,2
8416,796598,10,1,3,1,1,0,2,0,0,0,0,0,0,0,1,0,2
8417,774846,27,2,4,2,4,0,0,0,0,4,2,1,2,2,5,0,4
8417,791376,36,2,5,1,2,1,3,0,0,0,4,2,3,3,1,0,5
8417,786558,37,8,15,6,12,2,3,3,3,0,8,6,2,0,6,0,21
8417,797272,31,8,12,3,4,5,8,1,2,0,1,1,4,1,1,0,22
8417,766611,36,6,18,5,14,1,4,0,0,1,3,2,2,0,0,0,13
8417,786185,13,1,1,1,1,0,0,0,0,1,4,0,4,0,2,2,2
8417,781480,16,2,5,1,2,1,3,0,0,1,3,3,4,0,2,2,5
8417,797273,4,0,0,0,0,0,0,0,0,0,1,0,0,0,0,0,0
8417,791377,0,0,0,0,0,0,0,0,0,0,0,0,1,0,0,0,0
8418,796372,32,6,7,6,7,0,0,1,3,4,4,1,2,0,4,0,13
8418,796377,34,2,8,2,5,0,3,2,2,2,2,1,3,2,1,1,6
8418,796379,38,2,12,1,5,1,7,4,4,0,4,9,2,0,3,0,9
8418,790815,37,3,10,2,7,1,3,4,4,1,9,0,3,1,0,0,11
8418,780176,38,7,13,2,4,5,9,0,0,1,6,1,1,2,3,0,19
8418,796374,14,0,5,0,0,0,5,0,0,0,1,0,2,0,2,0,0
8418,786013,7,2,2,2,2,0,0,0,0,1,0,0,3,0,1,0,4
8419,779985,16,1,7,1,2,0,5,0,0,1,0,1,1,0,0,0,2
8419,790876,37,6,13,6,9,0,4,1,2,0,1,3,2,1,1,0,13
8419,785699,30,2,5,2,4,0,1,1,2,1,1,0,2,0,2,0,5
8419,781062,35,2,11,0,5,2,6,1,2,2,9,1,1,4,2,0,7
8419,774987,32,9,18,7,14,2,4,5,6,2,4,1,2,0,4,0,25
8419,785432,19,2,2,2,2,0,0,0,0,2,2,0,1,0,1,3,4
8419,790877,21,0,0,0,0,0,0,1,2,0,2,1,5,0,1,2,1
8419,790882,6,0,0,0,0,0,0,0,0,0,1,0,2,1,1,0,0
8419,790879,4,0,0,0,0,0,0,0,0,1,0,1,0,0,0,0,0
8420,796469,20,4,8,2,3,2,5,3,4,0,4,0,0,0,1,1,13
8420,779981,24,3,5,3,5,0,0,0,1,2,6,1,4,1,2,0,6
8420,785463,44,3,12,2,7,1,5,8,8,0,1,3,0,1,4,0,15
8420,779978,38,3,10,3,5,0,5,5,8,2,7,5,3,1,3,0,11
8420,776003,42,3,14,2,7,1,7,6,6,0,10,1,1,2,3,0,13
8420,779980,7,2,3,2,3,0,0,0,0,0,0,0,3,0,0,0,4
8420,790923,21,4,5,4,4,0,1,2,4,5,3,1,3,1,2,0,10
8420,785466,22,0,3,0,1,0,2,0,0,1,3,1,4,1,0,0,0
8420,790924,4,1,1,0,0,1,1,0,0,0,1,0,0,0,1,0,3
8420,779979,3,0,0,0,0,0,0,0,0,0,0,0,0,0,0,0,0
8421,790810,41,4,12,3,7,1,5,7,11,4,9,3,2,1,2,1,16
8421,785362,24,5,9,5,9,0,0,2,4,2,2,2,5,1,2,0,12
8421,790808,39,4,7,2,3,2,4,0,0,1,4,3,2,2,1,2,10
8421,785361,43,5,15,0,4,5,11,2,3,0,2,1,3,1,2,0,17
8421,779997,38,2,12,2,10,0,2,0,0,0,4,3,4,1,1,2,4
8421,774854,5,1,1,1,1,0,0,0,0,1,1,0,1,0,1,1,2
8421,796370,20,5,6,5,5,0,1,1,3,0,1,2,1,0,2,0,11
8421,790809,15,0,3,0,2,0,1,0,0,0,1,0,2,1,1,0,0
8421,796371,0,0,0,0,0,0,0,0,0,0,0,0,0,0,0,0,0
8421,790811,0,0,0,0,0,0,0,0,0,0,0,0,0,0,0,0,0
8422,796343,24,3,6,3,6,0,0,2,2,5,3,0,3,0,0,3,8
8422,780040,28,9,11,9,11,0,0,4,6,2,10,0,4,2,0,1,22
8422,790785,30,7,14,6,12,1,2,1,1,0,6,7,3,2,3,1,16
8422,781232,26,2,5,0,0,2,5,2,2,0,2,1,3,1,1,0,8
8422,780037,31,8,15,5,6,3,9,7,13,0,4,6,1,1,2,0,26
8422,796339,23,2,9,0,2,2,7,0,0,0,2,1,2,4,1,0,6
8422,790783,19,1,2,1,2,0,0,0,0,2,2,2,2,0,0,0,2
8422,785236,3,1,2,0,1,1,1,0,0,0,1,0,0,0,1,0,3
8422,780045,3,0,1,0,0,0,1,0,0,0,0,0,1,0,0,0,0
8422,792440,5,0,0,0,0,0,0,0,0,0,0,0,0,0,0,0,0
8422,790780,8,2,4,1,3,1,1,1,1,0,0,2,0,2,0,0,6
8423,786772,13,1,2,1,2,0,0,0,0,1,3,1,0,0,1,0,2
8423,781484,17,2,7,2,3,0,4,1,3,2,3,1,2,0,0,0,5
8423,791967,31,7,16,6,10,1,6,1,2,4,2,0,1,1,2,0,16
8423,786769,24,4,8,1,5,3,3,1,2,0,2,0,2,1,3,0,12
8423,786024,19,1,7,0,1,1,6,0,0,0,5,3,2,0,1,0,3
8423,780002,20,4,8,3,6,1,2,0,0,0,2,2,5,1,3,0,9
8423,790823,18,0,2,0,0,0,2,4,5,0,0,1,1,0,1,0,4
8423,791970,22,3,8,2,3,1,5,0,1,1,1,2,1,0,2,0,7
8423,797840,16,1,5,1,4,0,1,2,5,0,1,1,2,0,3,0,4
8423,785441,9,0,1,0,1,0,0,0,2,0,5,1,0,0,0,0,0
8423,786773,11,1,1,1,1,0,0,0,0,1,1,1,0,0,0,0,2
8426,792067,21,1,1,0,0,1,1,1,2,2,2,4,1,0,0,0,4
8426,775523,16,1,4,1,3,0,1,4,6,0,3,0,0,1,1,0,6
8426,797649,36,7,15,5,9,2,6,4,6,1,2,1,1,4,3,1,20
8426,792058,23,1,5,1,5,0,0,0,0,1,4,2,3,2,0,0,2
8426,789028,32,8,11,8,10,0,1,3,4,2,2,8,3,1,2,1,19
8426,786836,20,0,2,0,2,0,0,3,4,1,5,0,1,0,1,0,3
8426,792062,23,2,2,2,2,0,0,3,4,2,8,0,2,1,0,0,7
8426,789053,18,3,7,0,1,3,6,0,0,0,0,1,0,1,2,0,9
8426,789029,11,1,7,0,2,1,5,0,0,1,0,2,0,0,1,0,3
8427,791988,35,8,12,8,12,0,0,3,4,3,2,3,4,2,5,1,19
8427,792443,20,2,6,2,5,0,1,0,0,0,5,0,1,0,0,0,4
8427,796507,27,1,8,0,6,1,2,2,2,1,5,0,4,1,4,0,5
8427,796503,34,6,13,3,8,3,5,2,3,1,1,3,3,1,0,0,17
8427,791989,35,2,9,2,8,0,1,0,0,1,3,1,3,0,3,0,4
8427,780077,5,1,1,1,1,0,0,0,0,0,1,0,0,0,0,0,2
8427,796506,10,0,0,0,0,0,0,0,0,0,5,0,3,0,0,1,0
8427,796508,25,2,7,0,1,2,6,0,0,1,0,1,0,1,1,0,6
8427,785258,9,0,2,0,1,0,1,0,0,1,0,0,1,1,1,0,0
8428,781026,26,6,9,2,4,4,5,0,0,1,6,3,0,0,3,1,16
8428,785243,25,5,10,5,6,0,4,2,5,3,3,1,3,0,0,0,12
8428,790788,29,3,8,1,1,2,7,1,1,0,0,0,2,0,1,0,9
8428,781028,34,1,7,1,2,0,5,0,0,0,4,0,1,0,2,0,2
8428,796347,11,0,4,0,3,0,1,0,0,0,3,2,0,0,0,0,0
8428,796348,18,2,3,2,2,0,1,0,0,0,1,1,1,0,2,0,4
8428,785242,17,2,2,2,2,0,0,0,0,2,2,1,0,0,0,1,4
8428,781027,15,1,2,0,0,1,2,0,0,0,0,2,1,2,0,0,3
8428,796349,13,1,3,0,1,1,2,0,0,0,1,1,1,0,2,0,3
8428,790787,12,0,1,0,0,0,1,0,0,0,0,2,0,2,1,1,0
8429,797673,40,6,12,2,6,4,6,0,0,0,5,0,2,0,0,0,16
8429,786118,40,5,10,0,1,5,9,0,0,1,6,1,2,1,3,0,15
8429,780437,35,6,16,5,13,1,3,1,2,4,3,1,3,0,1,1,14
8429,786117,40,3,13,2,10,1,3,0,0,0,3,5,0,2,2,0,7
8429,786123,39,1,2,1,2,0,0,2,2,2,6,3,1,0,1,2,4
8429,792093,4,0,0,0,0,0,0,0,0,0,0,0,1,0,0,0,0
8429,797672,1,0,0,0,0,0,0,0,0,0,0,0,0,0,0,0,0
8429,797675,1,0,0,0,0,0,0,0,0,0,0,0,1,0,1,0,0
8430,780087,37,6,14,6,12,0,2,11,14,4,5,1,3,1,0,0,23
8430,786309,15,7,11,2,4,5,7,1,2,2,1,0,3,1,0,0,20
8430,776136,32,4,11,3,7,1,4,2,2,0,5,4,2,1,4,0,11
8430,776076,34,1,8,1,7,0,1,1,2,0,5,3,0,3,1,0,3
8430,790951,15,0,1,0,1,0,0,0,0,3,3,0,2,0,1,0,0
8430,786089,19,2,8,1,4,1,4,0,0,1,1,1,2,0,0,0,5
8430,796543,20,1,3,1,3,0,0,1,2,2,1,0,3,1,0,0,3
8430,790952,8,1,5,0,2,1,3,0,0,0,0,0,2,0,1,0,3
8430,796540,12,0,1,0,1,0,0,0,0,1,0,0,3,0,0,1,0
8430,796545,6,0,1,0,1,0,0,0,0,0,0,1,0,0,0,0,0
8430,775037,2,0,2,0,2,0,0,0,0,1,0,0,0,0,0,0,0
8431,786717,34,5,11,4,7,1,4,3,4,2,5,1,2,0,2,1,14
8431,796520,32,4,12,2,6,2,6,3,3,1,3,1,1,0,0,0,13
8431,796519,34,3,6,3,5,0,1,2,3,1,2,4,5,0,0,0,8
8431,796516,9,0,1,0,1,0,0,1,2,0,1,0,2,0,0,1,1
8431,780753,20,0,1,0,0,0,1,0,0,0,1,1,1,0,2,0,0
8431,796518,23,3,6,2,3,1,3,2,2,2,5,0,1,0,2,0,9
8431,792318,30,2,4,2,4,0,0,3,7,2,6,0,3,2,4,0,7
8431,775329,17,2,7,0,0,2,7,1,4,0,4,0,2,1,3,0,7
8431,792315,1,0,0,0,0,0,0,0,0,0,0,0,2,0,0,0,0
8432,791777,34,6,13,6,12,0,1,4,4,1,1,5,0,6,3,0,16
8432,781025,19,4,6,2,3,2,3,0,2,0,7,0,3,0,2,0,10
8432,780488,25,3,5,1,1,2,4,0,1,0,1,2,3,0,2,0,8
8432,776285,25,3,6,3,6,0,0,2,3,4,2,1,3,0,3,0,8
8432,775503,22,2,9,1,4,1,5,2,2,1,1,0,2,2,1,0,7
8432,791829,19,6,12,3,6,3,6,2,2,0,0,1,2,1,1,0,17
8432,786476,15,4,4,4,4,0,0,2,2,0,4,0,2,1,1,2,10
8432,786474,23,2,5,2,3,0,2,0,0,1,5,4,1,0,0,0,4
8432,791783,9,1,2,0,1,1,1,0,0,0,2,1,2,0,1,1,3
8432,797612,2,1,1,1,1,0,0,1,2,0,0,0,0,1,1,0,3
8432,791776,7,0,1,0,0,0,1,0,0,1,0,0,2,0,1,0,0
8433,782162,28,3,7,2,5,1,2,4,4,1,0,1,3,0,4,2,11
8433,781005,27,4,9,3,6,1,3,2,2,1,1,2,0,0,1,0,11
8433,792684,27,4,12,3,5,1,7,1,5,2,6,0,1,1,4,0,10
8433,781659,21,3,6,2,3,1,3,1,2,0,1,0,2,1,4,1,8
8433,781665,34,0,1,0,0,0,1,0,0,0,3,5,3,2,4,0,0
8433,780610,23,2,8,0,3,2,5,0,2,0,0,2,2,1,2,0,6
8433,781411,6,1,1,1,1,0,0,1,2,2,2,0,2,0,2,1,3
8433,788866,10,0,1,0,1,0,0,2,2,0,0,0,2,0,1,0,2
8433,790494,9,1,1,1,1,0,0,0,0,0,1,0,2,0,4,1,2
8433,796855,8,1,2,1,2,0,0,0,0,1,3,0,1,0,0,1,2
8433,792683,7,0,0,0,0,0,0,0,0,1,0,0,1,0,1,0,0
8434,780937,39,10,18,5,7,5,11,11,11,1,5,1,3,0,2,0,36
8434,775754,39,9,19,4,8,5,11,2,2,0,7,4,3,2,3,0,25
8434,792113,34,6,9,2,2,4,7,2,4,2,0,1,3,2,0,0,18
8434,797715,38,6,9,2,3,4,6,0,0,3,3,5,2,1,3,0,16
8434,792115,34,0,7,0,2,0,5,2,2,2,6,5,2,1,1,0,2
8434,797717,13,0,2,0,0,0,2,0,0,0,0,1,2,0,0,0,0
8434,797716,1,0,0,0,0,0,0,0,0,0,0,0,1,0,0,0,0
8434,800179,1,0,0,0,0,0,0,0,0,0,0,0,0,0,0,0,0
8434,800209,1,0,0,0,0,0,0,0,0,0,0,0,0,0,0,0,0
8435,781036,38,6,17,4,10,2,7,3,4,0,6,4,0,1,3,0,17
8435,774894,28,6,12,6,9,0,3,4,5,2,3,4,3,1,1,1,16
8435,796847,23,5,8,4,5,1,3,2,2,1,0,1,1,1,0,0,13
8435,799906,24,4,6,2,4,2,2,1,2,4,5,0,3,0,0,0,11
8435,775571,35,3,7,2,4,1,3,0,0,0,1,2,4,1,2,0,7
8435,796846,29,6,7,3,3,3,4,0,0,0,6,0,3,1,4,0,15
8435,796845,6,1,2,0,0,1,2,0,0,0,1,0,0,0,0,0,3
8435,785439,16,1,2,1,1,0,1,0,0,0,1,1,1,0,2,0,2
8435,789925,1,0,0,0,0,0,0,0,0,0,0,0,0,0,0,0,0
8436,799281,18,7,9,5,6,2,3,2,2,1,4,1,3,1,2,0,18
8436,792474,33,1,5,1,1,0,4,0,0,0,6,3,5,1,4,0,2
8436,780035,27,3,8,2,7,1,1,1,2,0,4,1,0,1,0,0,8
8436,785249,34,4,11,4,11,0,0,8,11,0,4,1,0,2,1,0,16
8436,780036,27,4,8,4,6,0,2,0,0,0,2,3,3,1,2,2,8
8436,785251,10,0,2,0,2,0,0,0,0,0,0,1,0,1,0,1,0
8436,792473,30,2,6,1,5,1,1,3,4,1,2,3,4,2,1,1,8
8436,792478,13,1,2,1,1,0,1,0,1,0,2,1,1,1,1,0,2
8436,780043,8,0,1,0,0,0,1,0,0,2,0,0,0,0,1,1,0
8437,797545,18,0,2,0,0,0,2,0,0,0,2,0,2,0,1,0,0
8437,797546,17,3,4,3,4,0,0,1,4,2,1,1,2,0,1,0,7
8437,797549,26,2,6,2,6,0,0,3,5,1,3,2,3,0,5,2,7
8437,791715,19,2,8,0,1,2,7,0,0,1,5,2,3,2,1,0,6
8437,780351,21,1,3,1,3,0,0,2,4,1,3,0,3,0,4,0,4
8437,780586,32,8,14,5,7,3,7,1,2,1,4,3,4,0,2,0,20
8437,790857,25,3,7,3,5,0,2,1,1,0,2,1,2,0,4,0,7
8437,797540,8,0,2,0,1,0,1,0,0,1,0,0,0,1,0,0,0
8437,797544,23,0,2,0,2,0,0,2,2,1,6,1,1,0,1,1,2
8437,791716,11,1,2,1,1,0,1,0,0,1,0,0,0,1,2,0,2
8438,780282,29,4,8,4,8,0,0,1,2,3,5,3,1,0,2,1,9
8438,780277,30,4,7,2,4,2,3,4,6,0,8,0,3,2,2,1,14
8438,791002,24,3,5,0,1,3,4,0,0,0,1,1,3,0,0,0,9
8438,785327,30,2,4,1,2,1,2,3,3,0,2,2,4,0,0,1,8
8438,780280,33,10,17,10,15,0,2,2,3,4,3,1,4,1,5,0,22
8438,785329,11,1,5,1,4,0,1,0,1,1,0,2,1,0,0,1,2
8438,796662,3,0,1,0,0,0,1,0,0,0,0,1,0,0,0,0,0
8438,791003,9,0,1,0,0,0,1,0,0,1,0,0,0,0,2,0,0
8438,785330,19,3,5,3,3,0,2,1,3,1,2,0,2,0,1,0,7
8438,785326,12,1,1,1,1,0,0,2,2,0,0,1,2,0,0,0,4
8439,781612,23,6,9,4,5,2,4,2,2,0,1,1,4,1,0,3,16
8439,797005,34,7,9,4,5,3,4,4,4,0,6,1,4,1,3,0,21
8439,797004,30,6,12,4,9,2,3,0,0,0,1,1,2,0,2,0,14
8439,791360,32,0,4,0,1,0,3,1,3,0,3,2,4,1,0,0,1
8439,781609,38,11,14,8,9,3,5,5,8,0,5,1,1,2,0,1,30
8439,797007,17,0,0,0,0,0,0,0,0,0,1,2,2,0,1,0,0
8439,797008,5,0,1,0,1,0,0,0,0,0,2,0,0,0,0,0,0
8439,797006,8,1,4,1,3,0,1,0,0,0,0,2,3,0,0,0,2
8439,797003,13,1,1,1,1,0,0,0,0,0,0,2,1,0,0,0,2
8440,796407,26,1,4,1,3,0,1,1,1,1,2,0,1,2,3,0,3
8440,796408,30,0,6,0,4,0,2,1,2,0,0,7,2,1,3,0,1
8440,790856,13,1,4,1,4,0,0,1,2,2,3,2,3,0,0,0,3
8440,780452,30,8,10,8,10,0,0,2,4,2,3,0,4,2,2,0,18
8440,796413,25,2,9,0,2,2,7,2,2,0,1,0,2,1,2,0,8
8440,796410,24,3,6,3,6,0,0,3,5,4,7,1,4,1,2,2,9
8440,796409,18,4,10,2,6,2,4,1,2,0,2,1,3,1,4,0,11
8440,780450,15,1,4,0,0,1,4,2,2,0,1,0,0,1,1,0,5
8440,796411,9,5,6,5,6,0,0,0,0,3,1,0,0,1,1,0,10
8440,790858,10,0,1,0,1,0,0,2,2,0,1,2,1,0,1,0,2
8441,780391,29,5,7,5,7,0,0,1,2,3,2,0,4,0,0,1,11
8441,780392,31,4,9,1,4,3,5,4,4,1,2,1,0,4,2,1,15
8441,790871,32,5,13,4,8,1,5,6,9,1,3,5,1,0,5,0,17
8441,780394,26,1,4,0,0,1,4,0,0,0,5,0,4,1,1,1,3
8441,797050,37,9,13,8,9,1,4,5,5,2,9,2,3,0,1,0,24
8441,776473,23,2,4,1,1,1,3,0,0,0,2,6,4,1,4,0,5
8441,785783,14,2,4,1,2,1,2,0,0,0,0,1,0,0,1,0,5
8441,791573,8,1,2,0,1,1,1,0,0,0,1,0,1,0,2,0,3
8442,785996,26,0,3,0,3,0,0,2,2,2,3,0,1,0,3,4,2
8442,780858,11,0,1,0,0,0,1,0,0,1,1,2,0,0,0,0,0
8442,797646,24,3,11,2,8,1,3,2,6,1,3,3,1,1,2,0,9
8442,780849,31,6,10,2,2,4,8,0,0,3,3,1,1,3,2,0,16
8442,780853,30,4,12,3,8,1,4,4,5,1,1,2,3,1,5,0,13
8442,786010,15,1,3,0,2,1,1,0,0,0,2,0,1,0,1,0,3
8442,785990,22,0,7,0,5,0,2,1,2,1,1,0,1,0,1,0,1
8442,792235,14,1,3,1,3,0,0,0,0,0,0,1,3,0,0,0,2
8442,792039,15,0,1,0,0,0,1,0,0,0,0,1,2,0,0,0,0
8442,780776,12,0,1,0,1,0,0,1,2,2,4,0,1,0,1,0,1
8443,796466,30,2,4,0,1,2,3,0,0,2,2,1,3,1,0,3,6
8443,785930,22,2,3,2,3,0,0,1,1,0,5,0,3,0,0,0,5
8443,780996,26,3,7,1,4,2,3,3,4,1,0,2,1,2,1,0,11
8443,796468,34,3,11,1,7,2,4,3,4,0,3,3,2,2,2,0,11
8443,791035,35,9,15,6,8,3,7,1,3,1,5,4,3,1,4,0,22
8443,796467,1,0,0,0,0,0,0,0,0,0,0,0,1,0,2,0,0
8443,780995,24,4,7,2,4,2,3,0,0,1,5,2,3,1,0,0,10
8443,775709,28,0,4,0,1,0,3,0,0,0,3,3,1,1,0,0,0
8444,781335,34,9,16,7,8,2,8,1,2,1,8,2,0,1,2,5,21
8444,776351,31,4,9,4,4,0,5,1,3,1,3,1,2,3,0,1,9
8444,791284,14,1,3,0,0,1,3,0,0,0,1,0,1,0,1,0,3
8444,785770,33,7,11,7,9,0,2,0,0,0,6,1,2,1,2,1,14
8444,781341,33,5,6,3,3,2,3,2,2,0,1,5,2,0,1,0,14
8444,796542,3,0,0,0,0,0,0,0,0,0,1,0,0,0,0,0,0
8444,791285,15,3,5,0,1,3,4,0,0,0,4,0,0,0,2,1,9
8444,785775,26,0,4,0,2,0,2,0,2,2,6,7,4,1,2,1,0
8444,796538,4,0,0,0,0,0,0,0,0,0,0,0,1,0,0,0,0
8444,791283,2,0,0,0,0,0,0,0,0,0,0,0,0,0,1,0,0
8444,785767,5,1,1,1,1,0,0,0,0,0,0,0,1,0,0,0,2
8445,792249,35,7,9,7,8,0,1,0,0,0,2,4,3,3,1,0,14
8445,781430,32,7,15,7,14,0,1,4,5,1,6,3,2,1,2,0,18
8445,797941,28,1,7,0,4,1,3,0,1,1,1,0,0,2,0,0,3
8445,781445,39,6,20,4,11,2,9,2,2,1,4,2,0,1,0,0,16
8445,768845,36,2,7,2,5,0,2,0,0,0,3,4,2,0,2,0,4
8445,781448,21,2,3,2,3,0,0,1,2,2,5,1,2,0,1,0,5
8445,792250,9,1,2,0,1,1,1,0,0,0,0,0,1,1,1,0,3
8446,785800,22,2,8,0,2,2,6,0,0,0,1,0,1,0,2,0,6
8446,785799,19,2,5,2,5,0,0,0,0,6,10,1,4,1,1,0,4
8446,791676,28,5,13,1,2,4,11,1,1,2,2,1,2,2,2,1,15
8446,780554,29,4,9,3,7,1,2,1,2,0,3,0,2,0,1,0,10
8446,780553,31,11,27,11,26,0,1,6,10,3,3,6,3,5,1,0,28
8446,797426,6,0,0,0,0,0,0,0,0,0,1,0,0,0,0,0,0
8446,791678,2,0,0,0,0,0,0,0,0,1,0,0,0,0,0,0,0
8446,791679,5,0,0,0,0,0,0,0,0,0,0,0,1,0,1,0,0
8446,785807,16,1,4,1,2,0,2,2,2,3,2,0,1,1,0,0,4
8446,780760,16,1,4,1,2,0,2,0,0,2,4,1,2,0,1,2,2
8446,797427,12,2,4,0,0,2,4,0,0,0,0,0,2,1,1,0,6
8446,791677,14,2,3,1,2,1,1,0,0,0,5,3,2,0,0,0,5
8447,792140,28,2,10,2,10,0,0,2,2,1,7,1,0,0,1,0,6
8447,786596,36,4,10,3,6,1,4,2,2,0,9,2,3,1,2,0,11
8447,797786,27,1,2,0,0,1,2,2,2,0,3,1,3,1,2,0,5
8447,785976,23,5,5,0,0,5,5,0,0,0,1,1,4,1,2,0,15
8447,781429,34,3,7,0,0,3,7,6,6,0,2,2,3,1,0,0,15
8447,797791,7,0,1,0,1,0,0,0,0,1,1,0,0,0,0,0,0
8447,792146,2,0,1,0,1,0,0,0,0,0,0,0,0,0,0,0,0
8447,792144,7,0,1,0,0,0,1,0,0,0,1,0,1,0,0,1,0
8447,781431,6,0,0,0,0,0,0,1,2,0,2,0,0,0,1,0,1
8447,776092,30,10,18,6,11,4,7,4,6,0,4,4,1,0,5,0,28
8448,791923,19,1,1,1,1,0,0,1,2,0,3,0,5,2,2,0,3
8448,781122,16,0,1,0,1,0,0,0,0,1,2,0,3,0,1,0,0
8448,791925,18,1,7,0,3,1,4,3,4,0,2,1,1,0,1,0,6
8448,786527,18,2,5,0,0,2,5,2,4,0,0,0,1,0,0,0,8
8448,781112,14,1,3,1,3,0,0,0,0,0,0,1,1,0,2,1,2
8448,791922,1,0,0,0,0,0,0,0,0,0,0,0,0,0,0,0,0
8448,786529,10,0,0,0,0,0,0,2,2,1,1,0,2,0,1,0,2
8448,797541,29,1,2,1,2,0,0,0,0,3,8,0,1,1,1,2,2
8448,797543,2,1,2,1,1,0,1,0,0,0,0,0,0,0,0,0,2
8448,797542,20,2,8,1,4,1,4,7,8,0,3,2,2,0,5,0,12
8448,791927,27,5,10,3,5,2,5,4,7,1,6,1,2,0,3,0,16
8448,786858,23,1,6,1,3,0,3,2,2,0,0,2,1,0,2,0,4
8448,800210,3,0,0,0,0,0,0,0,0,0,0,0,0,0,0,0,0
8449,792158,13,2,3,2,3,0,0,2,2,1,2,2,3,1,0,0,6
8449,780138,27,8,13,8,13,0,0,5,10,5,4,1,2,3,0,0,21
8449,792154,27,2,10,1,6,1,4,0,2,1,5,3,3,0,1,0,5
8449,792152,24,4,10,3,7,1,3,0,0,0,2,2,2,0,0,0,9
8449,780581,24,7,9,5,5,2,4,0,1,0,2,4,2,0,1,0,16
8449,797755,27,2,4,2,3,0,1,0,0,3,2,1,3,1,1,1,4
8449,792157,14,2,2,2,2,0,0,1,4,3,1,0,4,1,0,0,5
8449,792159,7,0,1,0,0,0,1,0,0,0,0,1,0,0,0,0,0
8449,786014,21,6,9,5,6,1,3,1,2,0,2,3,2,2,0,0,14
8449,797759,2,1,1,0,0,1,1,0,0,0,0,0,0,0,0,0,3
8449,797756,14,0,3,0,2,0,1,0,2,0,1,3,1,3,4,0,0
8450,797861,32,4,7,4,7,0,0,0,0,3,5,0,3,1,2,1,8
8450,797859,19,0,5,0,4,0,1,0,0,1,1,2,1,2,0,2,0
8450,792208,34,5,13,1,7,4,6,10,13,1,6,1,1,2,6,3,24
8450,786262,33,3,8,2,2,1,6,0,0,1,1,1,2,2,3,1,7
8450,781314,24,1,7,0,3,1,4,0,0,0,4,1,4,1,2,0,3
8450,776018,15,2,4,2,4,0,0,1,5,1,2,2,3,0,2,0,5
8450,797856,1,0,0,0,0,0,0,0,0,1,0,0,0,0,0,0,0
8450,792204,21,2,7,1,2,1,5,4,6,2,2,2,0,5,2,0,9
8450,786682,5,1,3,1,1,0,2,0,0,1,1,1,1,0,0,0,2
8450,781317,16,1,6,0,3,1,3,0,0,0,2,3,2,1,1,0,3
8451,797562,6,0,0,0,0,0,0,0,0,0,0,1,3,0,0,0,0
8451,791766,19,3,4,2,3,1,1,0,0,0,2,2,4,0,0,0,7
8451,786230,32,4,13,1,5,3,8,0,1,0,5,3,2,5,4,0,11
8451,780604,33,3,9,3,9,0,0,10,11,0,6,2,1,2,6,0,16
8451,780602,35,6,9,6,9,0,0,1,2,1,8,3,4,0,4,0,13
8451,786071,8,0,1,0,1,0,0,2,2,1,4,1,2,2,0,0,2
8451,791768,19,3,6,3,6,0,0,0,0,1,2,2,0,2,4,0,6
8451,786460,12,1,6,1,6,0,0,0,0,1,1,1,0,1,0,1,2
8451,791767,9,2,3,1,1,1,2,0,0,1,2,0,2,0,2,1,5
8451,780605,3,0,0,0,0,0,0,0,0,0,0,0,1,0,1,0,0
8451,780603,24,3,5,2,2,1,3,0,0,2,2,2,1,0,2,0,7
8452,775806,23,7,11,0,2,7,9,2,2,0,4,1,2,0,3,0,23
8452,781011,29,2,5,2,5,0,0,2,2,2,3,2,3,1,0,2,6
8452,797601,39,3,10,0,1,3,9,0,0,0,6,4,3,0,2,0,9
8452,781012,34,5,13,3,6,2,7,7,10,0,3,5,0,7,1,0,19
8452,775119,33,4,9,3,6,1,3,8,8,0,6,3,1,0,4,1,17
8452,797602,1,1,1,1,1,0,0,0,0,0,0,0,0,0,0,1,2
8452,775188,9,0,0,0,0,0,0,0,0,0,1,0,4,1,3,0,0
8452,797604,20,1,4,1,2,0,2,2,2,3,2,0,2,1,1,0,4
8452,786466,12,1,4,0,1,1,3,0,0,1,0,0,0,0,0,0,3
8453,791440,22,5,7,5,7,0,0,0,0,0,3,0,5,0,3,1,10
8453,797019,26,3,8,3,7,0,1,5,6,0,3,5,1,0,6,0,11
8453,797016,28,2,9,0,2,2,7,0,0,1,5,2,1,1,0,0,6
8453,781378,30,4,8,4,5,0,3,4,4,1,4,2,3,1,2,1,12
8453,775267,24,3,9,1,2,2,7,0,0,0,0,1,4,0,0,0,8
8453,781629,13,2,4,2,4,0,0,1,3,2,2,0,3,1,0,0,5
8453,775739,15,4,6,4,6,0,0,0,0,2,0,0,1,0,1,2,8
8453,797013,12,0,2,0,1,0,1,2,2,0,1,0,1,1,1,0,2
8453,791441,14,2,5,2,4,0,1,0,0,0,1,0,0,0,0,0,4
8453,774959,16,1,3,1,1,0,2,0,0,0,3,2,1,1,2,0,2
8454,796390,18,2,5,2,5,0,0,2,4,3,3,1,3,0,4,2,6
8454,785451,21,1,4,1,1,0,3,4,5,0,5,3,1,0,2,2,6
8454,790832,28,3,9,0,2,3,7,4,4,1,4,2,3,1,3,0,13
8454,790834,18,2,3,1,1,1,2,0,0,0,2,2,0,0,3,0,5
8454,790831,13,2,3,2,3,0,0,2,4,1,2,0,3,2,0,0,6
8454,785377,29,2,6,2,5,0,1,2,4,1,5,0,2,2,4,0,6
8454,790833,17,3,7,3,7,0,0,0,3,1,3,0,5,1,1,1,6
8454,790830,20,1,2,1,1,0,1,0,1,0,2,1,0,0,5,1,2
8454,785379,8,2,2,1,1,1,1,0,0,0,2,1,0,0,0,0,5
8454,796389,2,0,1,0,0,0,1,0,0,0,0,0,0,0,0,0,0
8454,785518,26,3,12,3,11,0,1,0,0,4,7,5,3,2,4,0,6
8455,791686,18,1,3,1,2,0,1,0,1,0,4,0,2,0,3,0,2
8455,798028,22,0,3,0,2,0,1,3,7,0,1,0,2,1,2,0,3
8455,790940,37,4,14,2,9,2,5,2,2,2,8,0,3,2,1,1,12
8455,786060,31,2,12,2,7,0,5,2,4,0,5,0,3,0,3,0,6
8455,780770,39,7,16,7,13,0,3,4,6,0,0,3,2,6,3,0,18
8455,792271,19,1,4,1,4,0,0,1,1,0,3,0,2,2,1,0,3
8455,792269,20,0,2,0,1,0,1,2,2,1,0,0,4,2,1,2,2
8455,798022,4,0,3,0,1,0,2,0,0,0,0,0,0,1,0,0,0
8455,792270,7,0,1,0,0,0,1,0,0,0,1,0,2,0,0,1,0
8455,792305,2,0,0,0,0,0,0,0,0,0,0,0,0,0,1,1,0
8455,800211,1,0,0,0,0,0,0,0,0,0,0,0,0,0,0,0,0
8456,790821,32,4,10,2,6,2,4,2,2,2,5,1,1,0,0,0,12
8456,775585,32,1,4,1,3,0,1,0,1,3,3,1,3,1,3,0,2
8456,790822,33,9,16,5,11,4,5,7,8,0,4,1,2,2,1,1,29
8456,780982,36,5,17,4,9,1,8,0,0,2,2,1,0,1,0,1,11
8456,774980,36,3,12,3,10,0,2,6,6,3,1,4,0,1,4,0,12
8456,780445,18,0,5,0,5,0,0,0,0,3,2,0,2,0,0,0,0
8456,785365,11,2,6,1,3,1,3,0,2,0,1,1,0,1,0,0,5
8456,792436,2,0,0,0,0,0,0,0,0,1,0,0,0,0,0,0,0
8457,780598,9,1,2,1,1,0,1,0,0,1,3,0,0,0,0,0,2
8457,781300,26,6,11,6,10,0,1,0,0,4,9,6,1,0,4,2,12
8457,790801,15,0,2,0,2,0,0,0,0,0,0,0,0,1,0,0,0
8457,781305,23,2,6,1,1,1,5,0,0,1,1,0,2,1,1,1,5
8457,781302,24,4,9,2,3,2,6,2,2,0,3,0,1,0,2,0,12
8457,796363,24,7,9,5,5,2,4,0,0,0,3,3,0,2,0,0,16
8457,790802,15,3,7,0,1,3,6,0,0,0,0,0,2,0,0,0,9
8457,796360,24,4,6,4,6,0,0,0,0,2,2,8,0,0,2,0,8
8457,790803,23,5,10,5,10,0,0,3,4,4,4,2,3,1,1,2,13
8457,796362,11,4,5,4,5,0,0,0,1,1,3,0,3,0,1,3,8
8457,781303,2,0,1,0,0,0,1,0,0,0,0,0,1,0,0,0,0
8457,776372,2,0,0,0,0,0,0,0,0,0,0,2,0,0,0,0,0
8457,776366,2,1,1,0,0,1,1,0,0,0,1,0,0,0,0,0,3
8458,786618,9,1,1,1,1,0,0,0,0,0,2,0,2,0,2,0,2
8458,796155,25,1,3,0,0,1,3,0,0,0,4,0,4,0,0,0,3
8458,792300,34,4,15,3,10,1,5,1,3,3,2,4,2,1,5,0,10
8458,790813,16,4,5,1,1,3,4,0,0,0,2,0,1,0,0,0,11
8458,781603,32,5,12,2,4,3,8,0,1,1,3,3,4,1,4,0,13
8458,797912,29,1,7,0,1,1,6,0,0,1,1,0,1,0,3,0,3
8458,797914,28,4,8,0,2,4,6,2,2,0,1,2,4,1,2,0,14
8458,780456,8,0,2,0,1,0,1,0,0,0,3,0,0,0,0,0,0
8458,781605,13,1,1,1,1,0,0,0,0,1,2,0,1,0,1,0,2
8458,797907,1,0,0,0,0,0,0,0,0,0,0,0,2,0,1,0,0
8458,781607,5,0,0,0,0,0,0,0,0,0,0,0,0,0,0,0,0
8459,775954,16,2,2,2,2,0,0,0,1,0,3,0,3,0,1,1,4
8459,781006,30,4,8,4,5,0,3,2,2,3,7,1,1,0,2,1,10
8459,796464,28,1,6,1,5,0,1,4,6,1,2,3,4,1,6,2,6
8459,796459,31,5,8,5,6,0,2,10,10,0,3,2,1,3,3,1,20
8459,781157,33,7,14,2,6,5,8,2,2,0,3,3,1,0,1,0,21
8459,790917,28,1,6,1,5,0,1,0,1,2,3,1,2,3,2,0,2
8459,796194,27,1,4,0,0,1,4,0,0,0,5,1,1,1,1,0,3
8459,790919,3,0,1,0,1,0,0,0,0,0,0,0,0,0,0,0,0
8459,790918,4,2,2,2,2,0,0,0,0,1,1,0,0,1,0,0,4
8460,785913,24,2,5,2,5,0,0,2,2,1,1,1,3,0,0,0,6
8460,786516,20,4,5,2,2,2,3,0,0,0,1,0,2,0,0,1,10
8460,785282,25,1,5,1,2,0,3,2,2,0,2,2,3,0,2,1,4
8460,781502,35,5,10,3,7,2,3,10,13,0,6,4,2,2,2,1,22
8460,780259,37,5,15,3,9,2,6,2,3,2,10,2,2,4,6,1,14
8460,781501,28,2,3,2,3,0,0,3,4,0,1,2,4,0,3,1,7
8460,781464,23,2,5,0,1,2,4,0,0,0,6,0,1,0,1,0,6
8460,792277,7,0,1,0,1,0,0,0,0,0,0,0,0,0,0,0,0
8460,792274,1,0,0,0,0,0,0,0,0,0,0,0,0,0,0,0,0
8461,781107,24,2,3,2,3,0,0,1,5,1,2,0,4,1,1,1,5
8461,791974,33,3,7,3,3,0,4,0,0,2,3,2,2,0,0,1,6
8461,791972,28,5,8,1,2,4,6,0,0,1,6,0,4,2,3,0,14
8461,785366,35,2,10,2,6,0,4,1,3,0,8,5,1,1,1,0,5
8461,780863,36,9,24,7,18,2,6,4,7,2,2,6,2,1,3,2,24
8461,796778,8,1,4,1,3,0,1,0,0,2,0,0,3,1,1,0,2
8461,780867,8,0,2,0,2,0,0,0,0,2,1,0,0,2,0,1,0
8461,796780,20,3,5,0,1,3,4,0,0,0,1,0,2,1,2,0,9
8461,796777,8,1,1,0,0,1,1,2,2,0,1,0,2,0,1,0,5
8462,781046,38,7,14,4,9,3,5,3,3,1,8,0,3,0,0,2,20
8462,780025,34,7,10,7,10,0,0,1,2,1,6,0,2,0,2,1,15
8462,796391,15,0,2,0,1,0,1,0,0,0,1,3,2,0,1,0,0
8462,785385,38,5,9,2,4,3,5,3,4,0,2,2,2,1,2,0,16
8462,785383,39,5,11,2,6,3,5,5,6,1,8,9,4,1,3,0,18
8462,785382,2,0,1,0,0,0,1,0,0,0,0,0,0,0,0,0,0
8462,786297,6,1,1,1,1,0,0,0,0,1,1,0,0,1,1,0,2
8462,786228,22,3,5,1,1,2,4,2,2,0,3,3,2,0,2,0,10
8462,790837,2,1,1,1,1,0,0,0,0,0,0,0,0,0,0,0,2
8462,792180,4,0,0,0,0,0,0,0,0,0,0,0,1,0,0,0,0
8463,791949,37,10,17,9,12,1,5,3,4,3,9,1,0,2,1,0,24
8463,776014,33,1,4,1,3,0,1,0,1,0,2,2,1,1,0,0,2
8463,797690,35,1,5,1,3,0,2,2,2,0,1,3,3,1,3,0,4
8463,797691,31,5,6,4,5,1,1,0,0,1,4,2,3,0,0,0,11
8463,780747,34,8,21,8,17,0,4,6,8,0,2,3,3,1,2,0,22
8463,785304,16,1,4,0,1,1,3,0,0,0,2,1,4,1,0,0,3
8463,784336,7,0,1,0,1,0,0,0,0,0,1,1,2,0,0,1,0
8463,797689,3,1,2,1,1,0,1,0,0,0,1,0,0,0,0,0,2
8463,791946,4,0,1,0,1,0,0,0,0,0,0,0,0,1,1,0,0
8464,780406,17,3,4,0,1,3,3,0,0,0,2,0,4,0,1,0,9
8464,775087,28,3,7,2,5,1,2,5,6,1,5,1,3,0,4,0,12
8464,785296,30,8,11,3,3,5,8,5,6,1,2,6,1,2,2,1,26
8464,780212,38,6,11,4,6,2,5,2,2,0,5,4,4,2,1,0,16
8464,767245,21,8,13,8,13,0,0,0,1,5,2,1,3,0,4,0,16
8464,780214,4,0,2,0,1,0,1,0,0,0,1,0,1,0,0,0,0
8464,790985,1,0,0,0,0,0,0,0,2,0,0,0,0,0,0,0,0
8464,780215,8,1,1,1,1,0,0,0,0,0,1,0,3,0,2,0,2
8464,796597,1,0,0,0,0,0,0,0,0,0,0,0,0,0,0,0,0
8464,796596,1,0,0,0,0,0,0,0,0,0,1,0,0,0,0,0,0
8464,790984,27,2,5,0,0,2,5,0,0,0,1,3,1,1,1,0,6
8464,791168,1,0,1,0,1,0,0,0,0,0,0,0,1,0,0,0,0
8464,785297,23,0,2,0,0,0,2,3,3,1,2,0,1,0,0,0,3
8465,781558,26,3,5,2,2,1,3,2,2,0,2,3,3,1,4,0,9
8465,780993,26,4,8,4,7,0,1,0,0,3,2,1,4,1,0,1,8
8465,775248,28,2,12,0,5,2,7,0,0,1,1,0,2,0,4,1,6
8465,797225,34,9,14,9,12,0,2,5,8,2,5,0,4,3,4,1,23
8465,791452,31,4,8,3,4,1,4,2,2,0,5,3,4,2,3,0,11
8465,797230,11,0,2,0,2,0,0,3,6,2,2,0,0,0,0,0,3
8465,791446,6,1,2,0,0,1,2,0,0,0,1,0,0,0,0,0,3
8465,797226,8,1,2,1,2,0,0,0,2,3,1,0,0,0,0,0,2
8465,797231,12,0,4,0,0,0,4,2,2,0,1,0,3,0,0,0,2
8465,797229,1,0,0,0,0,0,0,0,0,0,0,0,0,0,0,0,0
8465,791449,17,1,3,1,2,0,1,2,2,0,0,2,1,0,0,0,4
8466,790899,25,1,3,1,3,0,0,1,1,0,2,0,2,0,2,0,3
8466,785442,24,5,12,3,7,2,5,1,1,2,1,0,2,0,2,0,13
8466,799907,27,0,4,0,2,0,2,0,0,0,4,2,1,0,1,0,0
8466,785579,33,3,9,1,3,2,6,8,8,0,2,1,2,1,1,0,16
8466,781628,21,1,7,1,4,0,3,0,0,0,4,1,1,0,0,0,2
8466,790898,9,0,1,0,1,0,0,0,0,0,2,1,0,0,1,0,0
8466,790897,24,2,6,1,1,1,5,0,0,0,1,0,4,1,1,0,5
8466,796447,8,0,0,0,0,0,0,0,0,0,1,0,2,0,1,0,0
8466,775737,19,0,3,0,0,0,3,0,0,0,1,1,1,0,0,0,0
8466,785448,3,0,0,0,0,0,0,0,0,0,0,0,0,1,1,0,0
8466,775959,7,0,2,0,2,0,0,0,0,1,1,0,0,0,0,0,0
8467,785224,22,3,7,3,3,0,4,3,5,2,8,1,2,1,0,0,9
8467,780879,34,6,9,5,7,1,2,0,0,1,9,2,1,1,5,0,13
8467,790769,10,0,3,0,1,0,2,0,0,0,2,1,0,0,2,0,0
8467,785743,30,4,8,3,4,1,4,2,2,1,2,6,1,1,1,0,11
8467,780875,32,1,8,1,4,0,4,2,2,1,3,2,0,0,1,1,4
8467,785226,8,0,1,0,1,0,0,0,0,0,0,0,2,1,1,0,0
8467,796325,4,0,0,0,0,0,0,0,0,0,2,0,1,0,0,0,0
8467,790768,16,0,2,0,2,0,0,0,0,1,3,1,0,0,0,0,0
8467,790767,24,6,7,1,1,5,6,0,0,0,0,0,3,0,0,0,17
8467,775785,15,0,1,0,0,0,1,4,4,0,1,0,1,0,0,1,4
8467,796324,5,0,0,0,0,0,0,2,2,1,1,0,1,0,1,0,2
8468,774985,23,4,10,4,8,0,2,3,3,0,0,1,4,0,2,0,11
8468,789025,25,3,6,2,4,1,2,2,2,1,1,0,3,0,2,0,9
8468,782157,35,2,6,1,4,1,2,1,2,1,8,7,2,1,4,0,6
8468,781149,30,0,2,0,1,0,1,1,2,3,3,2,3,0,1,0,1
8468,775276,12,0,2,0,0,0,2,0,0,0,0,1,0,0,0,0,0
8468,792670,30,5,13,2,5,3,8,6,7,2,5,0,2,1,3,2,19
8468,780193,14,3,6,1,2,2,4,1,2,0,1,0,3,1,0,0,9
8468,786163,17,1,4,1,2,0,2,2,4,1,2,1,3,0,1,0,4
8468,780852,7,2,2,2,2,0,0,0,0,1,0,0,1,0,0,0,4
8468,792669,5,0,0,0,0,0,0,0,0,1,0,0,0,0,1,0,0
8468,798152,1,0,0,0,0,0,0,0,0,0,0,0,0,0,0,0,0
8468,792666,1,0,0,0,0,0,0,0,0,0,0,0,1,0,0,1,0
8469,787524,32,4,11,3,7,1,4,6,6,4,3,2,2,2,1,1,15
8469,775961,27,3,7,1,2,2,5,7,7,1,2,0,2,1,0,0,15
8469,787522,34,5,5,5,5,0,0,2,2,6,8,1,2,1,0,0,12
8469,781019,37,5,13,4,9,1,4,0,3,0,3,9,0,3,1,0,11
8469,780328,20,3,6,3,6,0,0,1,1,2,3,1,0,1,1,0,7
8469,791772,14,2,7,0,2,2,5,1,2,1,1,1,2,0,0,0,7
8469,780017,14,0,4,0,4,0,0,7,8,1,3,1,5,1,1,0,7
8469,783269,10,2,6,2,2,0,4,1,2,0,0,0,0,0,0,0,5
8469,775541,6,0,2,0,2,0,0,0,0,0,1,0,3,0,0,0,0
8469,791722,6,0,0,0,0,0,0,0,0,0,0,0,1,0,0,0,0
8470,781058,29,5,8,5,8,0,0,2,4,2,4,1,1,0,0,0,12
8470,785622,29,3,10,1,5,2,5,4,6,3,1,0,0,2,1,0,12
8470,780327,18,3,5,3,5,0,0,2,2,3,3,0,4,0,1,0,8
8470,797451,33,2,4,2,3,0,1,3,6,0,1,8,1,1,3,0,7
8470,797458,27,0,0,0,0,0,0,0,0,0,2,3,2,1,5,0,0
8470,797455,22,7,7,7,7,0,0,0,0,3,6,0,0,1,1,1,14
8470,797456,14,5,9,2,2,3,7,0,0,0,5,2,1,1,0,0,13
8470,791849,12,2,4,1,1,1,3,1,2,0,0,1,3,2,1,0,6
8470,791848,7,0,0,0,0,0,0,1,2,1,2,0,0,0,0,0,1
8470,797453,5,0,2,0,1,0,1,1,2,1,0,1,1,0,0,0,1
8470,786607,3,0,2,0,0,0,2,0,0,0,0,1,0,0,0,0,0
8470,791850,1,0,0,0,0,0,0,0,0,0,1,0,0,0,0,0,0
8472,796579,35,4,10,1,3,3,7,5,6,1,4,4,1,3,1,0,16
8472,781373,34,6,15,3,7,3,8,0,0,0,5,3,0,1,2,1,15
8472,785794,37,5,15,5,14,0,1,4,5,10,5,2,1,0,1,0,14
8472,785792,18,1,5,0,3,1,2,0,0,1,0,0,0,0,0,0,3
8472,776345,15,0,5,0,4,0,1,0,0,1,0,0,3,0,3,2,0
8472,791295,25,5,13,5,12,0,1,1,3,6,4,0,2,1,0,3,11
8472,796580,19,1,3,1,2,0,1,2,2,1,2,1,2,2,0,0,4
8472,796577,8,0,4,0,2,0,2,0,0,1,0,0,2,0,0,1,0
8472,791293,6,0,2,0,1,0,1,0,0,0,0,0,1,0,1,0,0
8472,791292,3,0,0,0,0,0,0,0,0,0,1,0,1,0,0,0,0
8473,791519,40,4,12,3,9,1,3,6,7,0,3,4,2,1,5,0,15
8473,786397,40,5,10,5,8,0,2,2,3,0,14,0,2,1,4,2,12
8473,791296,40,5,11,4,9,1,2,0,0,1,5,0,1,0,2,1,11
8473,792084,19,1,2,1,2,0,0,2,4,0,2,2,4,0,0,1,4
8473,796590,14,0,0,0,0,0,0,0,0,0,2,1,2,0,0,0,0
8473,796591,26,4,6,2,2,2,4,1,2,1,3,1,2,2,1,0,11
8473,796593,11,2,4,2,4,0,0,0,2,0,0,0,0,0,0,0,4
8473,791299,10,0,1,0,0,0,1,1,2,0,0,0,2,0,1,1,1
8473,780529,0,0,0,0,0,0,0,0,0,1,1,0,0,0,0,0,0
8474,785593,30,5,10,2,2,3,8,2,3,0,1,1,0,0,1,0,15
8474,775357,37,3,10,0,1,3,9,4,4,0,3,4,2,0,2,0,13
8474,797174,24,3,6,2,4,1,2,0,0,1,0,0,0,0,1,0,7
8474,791510,25,1,3,1,2,0,1,0,0,0,3,0,0,1,1,0,2
8474,791509,2,0,1,0,0,0,1,0,0,0,0,0,0,0,1,0,0
8474,791504,29,4,14,4,13,0,1,2,4,5,4,1,2,1,1,0,10
8474,786699,18,3,4,3,4,0,0,4,5,0,4,1,3,1,2,0,10
8474,791507,20,2,4,2,4,0,0,3,4,0,3,0,4,1,0,0,7
8474,791505,15,2,3,2,3,0,0,0,0,1,2,0,1,0,1,0,4
8475,792495,35,7,15,4,8,3,7,3,5,3,5,4,5,2,6,0,20
8475,792493,38,3,5,1,1,2,4,2,2,1,2,0,1,1,0,1,10
8475,792491,36,4,10,4,8,0,2,1,1,0,0,5,1,1,2,0,9
8475,781144,33,3,7,0,0,3,7,0,0,0,4,0,1,0,1,0,9
8475,780023,15,3,5,3,5,0,0,2,2,1,5,1,4,0,2,3,8
8475,786832,24,5,8,4,5,1,3,0,0,2,3,0,2,0,1,1,11
8475,788128,15,3,4,2,2,1,2,0,0,0,1,0,3,0,1,0,7
8475,798959,4,0,0,0,0,0,0,0,0,0,0,0,1,0,0,0,0
8476,775510,37,7,16,2,5,5,11,2,2,0,2,0,3,0,0,0,21
8476,774976,33,6,12,5,6,1,6,6,6,4,7,0,3,3,1,5,19
8476,797865,30,1,5,1,3,0,2,0,0,0,2,3,2,1,2,0,2
8476,786614,19,1,5,1,1,0,4,0,0,0,1,2,5,0,2,0,2
8476,786759,39,2,7,1,6,1,1,6,6,0,3,7,4,0,3,0,11
8476,792294,16,2,3,2,3,0,0,0,0,3,0,1,1,0,0,0,4
8476,786761,15,1,3,1,3,0,0,0,0,0,1,0,1,0,0,1,2
8476,792293,11,0,3,0,2,0,1,0,0,0,1,0,0,1,0,0,0
8477,785409,28,3,6,3,6,0,0,2,2,0,3,3,2,0,2,1,8
8477,785408,38,2,7,1,4,1,3,3,4,2,6,3,3,0,0,0,8
8477,785407,31,5,10,5,9,0,1,4,5,0,6,1,1,1,2,1,14
8477,796416,30,3,5,0,1,3,4,7,8,0,3,0,1,2,0,0,16
8477,790861,29,2,5,2,4,0,1,1,2,0,3,3,0,1,3,1,5
8477,796415,24,4,9,4,8,0,1,4,5,1,3,1,3,0,2,1,12
8477,780539,20,1,2,0,0,1,2,2,2,0,1,1,2,2,0,0,5
8478,785498,17,2,5,2,4,0,1,1,1,0,0,0,4,1,3,0,5
8478,776469,35,4,10,4,8,0,2,3,4,3,10,3,2,0,2,0,11
8478,796705,39,6,12,6,9,0,3,2,2,2,4,5,1,2,3,0,14
8478,796708,39,2,5,2,5,0,0,4,4,0,2,3,1,2,3,0,8
8478,776322,35,5,9,2,3,3,6,3,3,0,6,0,0,1,1,0,16
8478,780704,19,1,3,0,0,1,3,0,0,0,3,0,0,0,0,0,3
8478,796706,16,1,2,1,1,0,1,2,2,0,1,0,1,0,2,1,4
8479,780765,35,4,13,1,4,3,9,0,2,0,3,1,3,0,6,0,11
8479,781301,15,1,1,1,1,0,0,0,0,0,1,0,0,0,0,1,2
8479,786255,36,6,14,5,8,1,6,1,2,2,2,0,2,0,1,0,14
8479,780762,32,3,9,3,5,0,4,0,2,1,3,1,1,0,1,0,6
8479,780768,36,3,11,1,5,2,6,1,1,1,4,6,3,1,3,1,9
8479,791729,27,3,4,3,3,0,1,0,0,2,4,1,3,0,0,1,6
8479,780755,16,2,5,2,4,0,1,0,0,2,1,0,2,1,1,0,4
8479,797320,3,0,1,0,1,0,0,0,0,0,0,0,0,0,0,0,0
8480,791548,29,4,9,3,6,1,3,4,4,2,8,2,1,2,3,3,13
8480,780332,13,1,6,1,4,0,2,0,0,1,0,0,2,1,0,1,2
8480,781643,5,0,1,0,1,0,0,0,0,0,0,0,1,0,0,0,0
8480,780330,26,3,6,3,5,0,1,2,2,2,3,0,4,2,0,0,8
8480,780329,33,8,14,7,11,1,3,3,4,0,1,3,1,0,1,0,20
8480,797082,13,3,7,2,5,1,2,0,3,3,2,0,3,1,0,0,7
8480,791550,22,2,4,2,4,0,0,1,7,3,2,1,2,0,2,0,5
8480,791551,2,0,0,0,0,0,0,0,0,0,0,0,0,0,0,0,0
8480,797080,5,0,2,0,2,0,0,0,0,1,0,0,0,0,0,0,0
8480,786368,17,0,2,0,0,0,2,0,0,0,0,2,1,0,2,1,0
8480,786364,35,2,9,2,7,0,2,1,2,1,8,2,2,1,0,0,5
8481,790957,25,1,5,0,3,1,2,1,2,1,5,2,1,2,3,0,4
8481,785275,27,2,6,2,6,0,0,0,0,3,6,1,3,0,4,4,4
8481,790956,17,2,5,0,1,2,4,0,0,1,2,0,1,0,1,0,6
8481,785089,24,1,8,1,4,0,4,0,0,1,2,1,3,2,2,1,2
8481,780460,36,6,14,3,5,3,9,3,4,1,5,1,2,0,3,0,18
8481,796550,21,0,5,0,1,0,4,3,4,2,3,0,2,0,0,1,3
8481,796549,10,0,1,0,1,0,0,0,0,0,1,0,3,0,0,0,0
8481,796551,13,1,2,1,2,0,0,0,0,2,3,0,0,0,3,1,2
8481,796548,1,0,0,0,0,0,0,0,0,0,0,0,0,0,0,0,0
8481,796547,7,1,1,1,1,0,0,0,0,0,0,0,1,0,0,0,2
8481,796552,17,1,6,1,3,0,3,2,2,0,0,1,3,0,1,0,4
8481,785276,2,0,0,0,0,0,0,4,4,0,1,0,0,0,0,0,4
8482,780122,26,3,5,3,5,0,0,3,4,2,5,2,3,0,0,4,9
8482,797215,26,5,7,2,2,3,5,4,5,0,0,6,1,2,4,0,17
8482,791461,33,5,9,4,6,1,3,3,4,5,9,2,3,3,3,0,14
8482,780792,30,5,11,1,6,4,5,8,8,0,2,3,2,2,1,0,22
8482,775598,16,1,1,0,0,1,1,0,2,0,1,1,0,3,1,0,3
8482,797216,6,0,0,0,0,0,0,0,0,0,1,1,0,0,1,0,0
8482,786299,10,0,0,0,0,0,0,0,0,0,2,0,3,0,1,0,0
8482,791460,27,5,8,3,3,2,5,2,2,1,0,1,0,0,6,0,14
8482,789034,1,0,1,0,0,0,1,0,0,0,0,0,0,0,0,0,0
8482,786295,25,2,7,2,4,0,3,2,2,0,3,2,3,2,4,0,6
8483,796912,20,2,7,2,4,0,3,2,4,0,3,0,5,1,2,0,6
8483,775626,34,9,17,9,15,0,2,5,5,3,1,3,4,3,4,1,23
8483,774964,16,1,3,1,3,0,0,0,0,2,2,2,2,0,1,1,2
8483,796907,25,3,3,1,1,2,2,3,6,0,2,1,0,2,2,0,11
8483,774962,28,1,7,0,5,1,2,0,0,0,1,2,1,1,2,0,3
8483,796910,22,5,10,5,10,0,0,1,2,0,2,1,4,1,2,0,11
8483,785609,3,0,0,0,0,0,0,0,0,0,0,0,0,0,0,0,0
8483,796908,6,0,2,0,0,0,2,0,0,0,0,0,2,0,1,0,0
8483,796906,18,2,7,1,4,1,3,0,0,2,1,0,1,0,2,1,5
8483,775566,4,0,0,0,0,0,0,0,0,0,0,0,0,1,0,0,0
8483,791203,24,1,5,1,3,0,2,2,2,3,1,4,1,3,1,1,4
8484,791616,20,4,7,4,7,0,0,3,3,1,0,0,1,1,1,0,11
8484,780797,40,3,9,1,3,2,6,0,0,1,6,6,3,0,1,0,8
8484,796986,1,0,1,0,1,0,0,0,0,0,0,0,1,0,0,0,0
8484,785505,21,3,6,3,6,0,0,5,6,1,0,3,3,0,6,1,11
8484,775604,44,5,15,1,6,4,9,0,0,0,8,7,1,1,2,0,14
8484,786429,5,0,0,0,0,0,0,0,0,0,0,1,1,0,0,0,0
8484,796984,5,1,1,1,1,0,0,0,0,0,0,1,0,0,0,0,2
8484,796981,16,2,4,1,2,1,2,0,0,0,1,0,0,0,1,0,5
8484,791618,35,12,12,10,10,2,2,2,3,1,1,1,0,3,1,0,28
8484,780555,38,1,3,1,1,0,2,0,0,0,4,3,0,1,2,0,2
8485,786646,29,2,9,2,4,0,5,0,0,1,3,2,3,1,0,0,4
8485,780890,25,2,4,1,2,1,2,0,0,0,3,1,1,1,1,0,5
8485,786066,33,7,13,2,6,5,7,3,6,4,5,2,4,2,3,0,22
8485,780167,40,3,9,2,6,1,3,5,6,2,2,0,0,2,5,0,12
8485,775574,43,10,18,6,10,4,8,0,0,1,2,6,3,2,2,0,24
8485,791119,6,0,0,0,0,0,0,0,0,1,2,0,0,0,1,0,0
8485,791123,13,0,3,0,0,0,3,0,0,0,3,0,2,1,0,0,0
8485,785636,36,4,6,3,4,1,2,1,1,0,2,2,0,0,0,0,10
8486,796401,26,3,9,2,6,1,3,0,0,0,3,2,3,0,2,2,7
8486,785999,26,4,7,4,7,0,0,1,2,1,12,2,3,0,3,0,9
8486,775654,23,3,5,3,5,0,0,5,6,3,5,0,0,1,2,3,11
8486,796399,32,2,5,0,1,2,4,0,0,0,3,3,2,2,2,0,6
8486,785389,32,3,5,2,3,1,2,8,9,0,4,5,2,1,4,0,15
8486,791640,12,2,4,2,4,0,0,0,0,2,3,1,1,0,2,1,4
8486,785255,14,2,3,2,3,0,0,0,0,1,4,2,2,2,1,0,4
8486,775171,5,0,2,0,1,0,1,0,0,0,0,0,0,0,0,0,0
8486,796400,1,2,2,2,2,0,0,0,0,1,0,0,0,0,0,0,4
8486,791639,21,3,8,3,6,0,2,3,4,0,1,1,2,1,1,0,9
8486,796403,1,0,1,0,1,0,0,0,0,0,0,0,0,1,0,0,0
8486,796398,7,0,0,0,0,0,0,0,1,2,1,0,0,0,4,0,0
8487,790914,24,1,4,1,4,0,0,1,2,4,2,0,3,1,1,2,3
8487,785456,17,2,4,1,2,1,2,0,0,0,0,0,1,0,0,0,5
8487,780798,35,1,7,0,2,1,5,0,0,1,7,1,2,2,2,2,3
8487,785454,26,2,7,1,3,1,4,2,2,0,0,4,2,1,4,0,7
8487,785453,34,4,12,3,6,1,6,1,1,1,1,2,0,1,2,1,10
8487,790915,6,0,1,0,1,0,0,0,0,0,1,0,1,0,0,0,0
8487,785458,25,6,15,6,13,0,2,2,2,0,2,1,3,2,2,0,14
8487,800055,5,1,2,1,2,0,0,0,2,0,1,0,0,0,0,0,2
8487,790912,8,0,2,0,1,0,1,0,0,0,0,0,0,0,0,0,0
8487,785455,20,1,8,1,7,0,1,2,2,0,1,1,2,0,0,0,4
8488,775738,8,0,0,0,0,0,0,0,0,1,1,1,2,0,0,0,0
8488,786091,38,8,11,7,9,1,2,4,5,4,5,1,2,0,2,2,21
8488,786728,38,7,12,7,12,0,0,2,2,1,1,2,1,1,1,1,16
8488,785904,34,3,13,2,5,1,8,2,2,0,4,4,0,0,2,0,9
8488,780892,38,6,10,3,3,3,7,6,6,1,5,4,2,4,1,0,21
8488,785734,3,0,1,0,0,0,1,0,0,0,0,0,0,0,0,0,0
8488,786788,17,3,5,2,3,1,2,6,6,1,1,0,1,1,0,0,13
8488,786096,17,2,4,1,1,1,3,0,0,0,3,1,2,0,3,0,5
8488,781030,7,0,4,0,1,0,3,0,0,0,1,1,0,0,0,0,0
8489,797587,18,3,5,3,5,0,0,0,3,0,5,0,2,0,2,1,6
8489,786501,38,3,9,1,2,2,7,0,0,0,0,0,1,0,1,0,8
8489,781078,30,6,14,0,3,6,11,0,0,0,3,0,4,0,0,0,18
8489,786502,40,10,22,6,13,4,9,1,3,2,5,9,1,2,5,0,25
8489,781080,30,3,6,1,2,2,4,0,0,0,3,3,4,0,2,0,8
8489,791891,2,1,1,1,1,0,0,0,0,1,0,0,4,0,0,0,2
8489,797584,9,0,0,0,0,0,0,0,0,1,0,0,0,0,1,0,0
8489,791895,33,5,6,5,6,0,0,3,4,4,5,3,2,2,0,0,13
8490,785347,25,8,11,5,6,3,5,6,7,0,1,0,4,1,1,0,25
8490,786338,38,6,16,4,8,2,8,1,1,1,2,1,2,0,4,0,15
8490,775601,36,4,6,3,4,1,2,5,6,0,3,4,3,0,3,0,14
8490,792050,27,4,7,3,4,1,3,3,4,1,2,0,2,1,3,0,12
8490,791512,16,1,3,1,3,0,0,3,5,2,3,0,3,2,1,1,5
8490,792047,26,6,10,3,6,3,4,2,2,1,7,1,5,2,0,1,17
8490,797647,23,1,6,0,2,1,4,0,0,1,3,3,4,1,2,0,3
8490,792052,6,0,0,0,0,0,0,0,0,0,0,0,0,0,0,0,0
8490,792051,3,0,0,0,0,0,0,0,0,0,0,0,0,0,0,0,0
8491,780471,35,10,15,10,15,0,0,2,2,6,5,1,3,0,3,0,22
8491,796996,35,7,11,7,11,0,0,5,5,3,5,1,4,0,2,0,19
8491,791608,33,3,9,0,0,3,9,5,5,0,1,1,3,2,1,0,14
8491,776011,22,1,6,1,4,0,2,8,8,1,4,5,4,0,5,0,10
8491,791613,16,1,3,0,2,1,1,1,2,0,1,0,2,1,1,0,4
8491,792071,31,4,11,1,2,3,9,3,4,0,4,1,3,0,0,0,14
8491,780417,9,3,3,2,2,1,1,0,0,0,1,0,2,0,1,0,7
8491,791610,10,2,2,1,1,1,1,0,0,0,1,0,2,0,0,0,5
8491,796994,9,0,1,0,1,0,0,0,0,0,0,2,1,0,2,0,0
8492,780635,6,0,0,0,0,0,0,0,0,0,1,0,1,0,0,0,0
8492,780634,27,5,8,5,8,0,0,0,0,2,8,1,3,0,4,7,10
8492,786785,30,8,12,4,5,4,7,0,1,0,8,1,2,2,1,0,20
8492,780633,36,7,13,1,2,6,11,0,0,1,4,10,2,2,2,1,20
8492,776009,33,4,10,4,7,0,3,2,2,0,2,7,3,1,4,0,10
8492,797389,11,2,4,2,4,0,0,0,1,0,3,0,2,0,0,1,4
8492,791826,21,2,4,1,1,1,3,0,0,1,0,2,0,2,2,0,5
8492,786784,10,2,6,2,4,0,2,1,2,0,2,0,0,1,0,0,5
8492,786783,20,0,2,0,1,0,1,0,0,2,3,1,3,1,0,1,0
8492,780637,2,0,1,0,1,0,0,0,0,0,0,0,0,0,0,0,0
8492,778644,2,0,1,0,0,0,1,0,0,0,0,0,0,0,0,0,0
8492,791825,1,0,0,0,0,0,0,0,0,0,0,0,0,0,0,0,0
8492,800144,1,0,0,0,0,0,0,0,0,0,0,0,0,0,0,0,0
8493,791401,32,7,16,7,16,0,0,7,11,7,4,1,1,3,1,0,21
8493,780125,21,1,3,1,3,0,0,0,0,1,8,1,0,0,1,0,2
8493,791400,17,0,3,0,2,0,1,0,0,0,1,2,0,0,1,0,0
8493,785931,22,0,7,0,5,0,2,0,0,0,2,1,1,1,3,0,0
8493,780118,32,7,12,2,5,5,7,1,1,0,2,4,4,1,2,0,20
8493,786837,20,2,7,2,4,0,3,1,2,0,4,1,0,1,0,0,5
8493,797125,26,1,4,1,3,0,1,2,4,1,1,3,2,1,2,0,4
8493,797130,13,0,3,0,3,0,0,0,0,0,1,1,1,0,3,0,0
8493,797132,7,1,2,0,0,1,2,0,0,0,0,1,1,0,0,0,3
8493,797126,9,3,4,1,2,2,2,0,0,0,1,0,0,0,0,0,8
8493,791399,1,0,0,0,0,0,0,0,0,0,1,0,0,0,0,0,0
8494,797111,30,1,6,1,5,0,1,0,0,1,3,2,2,1,2,0,2
8494,797110,18,2,6,0,0,2,6,0,0,0,2,0,0,0,1,0,6
8494,791407,28,6,11,3,7,3,4,0,0,0,1,0,3,1,1,0,15
8494,785928,36,1,6,0,3,1,3,3,4,3,2,2,0,1,1,0,6
8494,785923,34,3,8,2,7,1,1,2,2,0,2,5,1,2,3,0,9
8494,797115,3,0,0,0,0,0,0,0,0,0,0,0,0,0,0,0,0
8494,797109,2,0,0,0,0,0,0,0,0,0,0,0,1,0,0,0,0
8494,791403,27,3,8,3,7,0,1,0,0,1,3,0,2,0,1,0,6
8494,797114,8,0,1,0,0,0,1,1,2,0,0,0,2,0,1,0,1
8494,791404,14,0,1,0,1,0,0,0,0,0,0,1,1,1,1,0,0
8495,780201,39,4,11,4,11,0,0,0,0,1,5,2,0,1,1,0,8
8495,791469,40,3,6,3,6,0,0,0,0,3,7,0,1,1,1,4,6
8495,797210,37,8,11,8,10,0,1,2,2,0,2,2,1,0,4,0,18
8495,786311,16,2,5,1,3,1,2,0,0,0,1,3,3,1,3,0,5
8495,775516,38,4,9,3,7,1,2,3,3,3,2,4,1,2,3,0,12
8495,798344,2,1,1,1,1,0,0,0,0,0,0,0,0,0,0,0,2
8495,791471,3,1,1,1,1,0,0,0,0,0,0,0,2,1,0,0,2
8495,791467,25,4,5,0,0,4,5,2,2,0,4,3,3,1,1,0,14
8496,786805,33,9,12,7,9,2,3,4,5,2,4,0,1,1,3,0,24
8496,774936,21,4,7,4,6,0,1,1,2,0,4,2,2,0,2,1,9
8496,790932,30,5,11,3,8,2,3,2,2,0,2,4,0,0,1,1,14
8496,781345,29,3,6,2,4,1,2,1,1,1,4,5,4,1,1,0,8
8496,786803,28,1,6,1,4,0,2,2,2,1,1,4,0,0,1,0,4
8496,790934,19,4,7,2,5,2,2,2,4,3,2,3,2,2,2,1,12
8496,786804,7,0,2,0,1,0,1,2,2,1,1,0,0,0,1,0,2
8496,790933,25,3,4,0,0,3,4,4,4,0,2,0,3,0,2,0,13
8496,780033,8,0,2,0,1,0,1,0,0,0,0,3,0,2,1,0,0
8497,797367,31,5,7,5,7,0,0,1,2,0,3,2,3,2,2,2,11
8497,797369,27,1,1,1,1,0,0,0,0,0,1,1,4,0,2,0,2
8497,797366,21,1,2,1,2,0,0,0,0,2,2,4,2,3,0,0,2
8497,791807,37,4,10,4,5,0,5,2,2,1,4,2,3,1,1,1,10
8497,786130,33,13,24,9,13,4,11,3,4,1,4,0,2,2,2,1,33
8497,797368,8,1,1,1,1,0,0,0,0,1,1,0,1,0,1,0,2
8497,797364,6,1,2,1,2,0,0,0,0,0,2,1,2,1,0,0,2
8497,797365,10,1,3,0,1,1,2,0,0,1,0,0,0,0,0,0,3
8497,797363,27,2,10,2,8,0,2,3,3,0,2,4,3,0,4,0,7
8497,797371,0,0,0,0,0,0,0,0,0,0,0,0,0,0,0,0,0
8498,785536,10,1,3,1,2,0,1,0,0,0,1,0,1,0,1,1,2
8498,780119,39,5,9,5,9,0,0,1,4,5,7,2,2,1,3,1,11
8498,796558,19,2,3,2,2,0,1,1,1,1,2,1,4,0,1,0,5
8498,796559,39,3,12,1,7,2,5,16,19,1,4,4,2,1,1,3,24
8498,776097,37,5,7,5,6,0,1,2,5,0,4,4,5,0,3,4,12
8498,796560,22,4,8,4,6,0,2,5,7,1,7,0,2,0,0,0,13
8498,785280,10,0,2,0,2,0,0,0,0,0,0,0,1,0,1,0,0
8498,780149,16,4,9,2,5,2,4,2,5,0,2,3,1,2,2,0,12
8498,785285,8,1,1,1,1,0,0,0,2,1,1,1,0,0,0,2,2
8499,776110,22,5,14,1,5,4,9,0,0,3,3,1,3,0,3,0,14
8499,780059,24,2,6,2,6,0,0,0,1,0,4,4,5,1,5,1,4
8499,796494,18,3,6,2,3,1,3,0,0,1,2,1,2,0,2,0,7
8499,790944,21,2,6,1,3,1,3,0,0,0,1,0,5,1,1,0,5
8499,780061,35,4,8,2,5,2,3,2,2,0,2,2,5,2,2,0,12
8499,780058,6,0,5,0,0,0,5,0,0,1,1,0,1,0,0,0,0
8499,796496,23,1,5,1,3,0,2,0,0,2,3,2,3,0,1,0,2
8499,790941,17,4,8,4,6,0,2,1,2,4,5,0,4,0,0,2,9
8499,790943,1,0,0,0,0,0,0,0,0,0,0,0,2,0,0,0,0
8499,796495,1,0,0,0,0,0,0,0,0,0,0,0,0,0,0,0,0
8499,786754,32,5,11,2,5,3,6,0,3,0,3,4,2,0,2,0,13
8500,785714,20,5,7,5,7,0,0,3,3,3,3,2,3,0,1,1,13
8500,775894,27,3,4,2,2,1,2,2,2,2,2,2,0,1,2,0,9
8500,785711,27,5,10,2,4,3,6,0,0,0,4,4,1,1,1,0,13
8500,780985,23,1,5,0,0,1,5,0,0,0,1,0,0,0,1,0,3
8500,775266,24,4,10,1,2,3,8,2,4,1,3,1,2,2,4,1,13
8500,796829,14,3,3,3,3,0,0,3,4,1,6,0,1,0,1,2,9
8500,779994,13,4,6,2,2,2,4,0,1,0,1,0,2,0,0,0,10
8500,785378,15,0,4,0,1,0,3,0,0,0,3,2,1,1,1,0,0
8500,791167,18,1,1,1,1,0,0,2,4,0,1,3,1,2,0,0,4
8500,780988,4,1,2,0,1,1,1,0,2,1,1,0,0,0,0,0,3
8500,785710,4,0,1,0,0,0,1,0,0,0,0,0,0,1,0,0,0
8500,791169,2,0,0,0,0,0,0,0,0,0,1,0,0,1,0,0,0
8500,796828,3,0,1,0,0,0,1,0,0,0,0,1,0,1,1,0,0
8500,796827,3,0,1,0,1,0,0,0,0,0,0,0,0,0,0,0,0
8500,796826,3,0,0,0,0,0,0,0,0,0,0,0,0,0,0,0,0
8501,791194,23,3,8,1,4,2,4,1,2,1,1,0,3,1,2,0,9
8501,780384,33,3,5,3,5,0,0,0,0,4,3,1,3,2,3,0,6
8501,780159,24,2,6,2,5,0,1,0,0,2,5,1,2,0,2,0,4
8501,775694,22,3,9,2,6,1,3,0,0,0,2,1,2,0,1,0,7
8501,774827,29,4,10,3,5,1,5,0,0,0,3,3,1,3,4,0,9
8501,800119,11,1,7,1,4,0,3,1,1,1,0,1,1,1,0,0,3
8501,791191,16,2,5,1,3,1,2,0,0,1,4,0,5,1,2,2,5
8501,796863,16,0,2,0,2,0,0,0,0,0,0,2,0,0,1,0,0
8501,796865,12,3,5,2,2,1,3,0,0,0,1,0,0,0,0,0,7
8501,799890,14,1,5,0,2,1,3,0,0,0,2,0,3,0,0,0,3
8502,785482,38,11,24,9,18,2,6,3,4,0,6,0,2,1,4,0,27
8502,781560,36,7,9,7,9,0,0,2,3,3,5,2,3,1,0,1,16
8502,796477,21,2,4,1,2,1,2,0,1,0,3,3,0,0,2,0,5
8502,791375,35,1,6,1,4,0,2,1,2,0,3,3,4,2,0,1,3
8502,796479,25,1,1,1,1,0,0,0,0,0,2,1,4,0,1,0,2
8502,780837,27,3,11,3,7,0,4,3,3,1,3,0,0,0,0,0,9
8502,786164,11,1,3,1,2,0,1,0,0,3,1,0,5,0,0,1,2
8502,796476,4,0,0,0,0,0,0,0,0,0,0,0,1,0,0,0,0
8502,796473,3,0,0,0,0,0,0,0,0,1,0,0,0,0,0,0,0
8503,792276,40,4,9,1,4,3,5,8,9,0,3,7,3,0,2,0,19
8503,786026,31,8,13,6,9,2,4,0,0,2,5,1,4,1,0,0,18
8503,791281,40,3,11,2,7,1,4,5,8,2,4,0,2,1,2,1,12
8503,791278,36,4,13,1,4,3,9,1,2,4,4,3,2,2,0,0,12
8503,785507,16,0,4,0,1,0,3,0,0,0,2,1,1,0,1,0,0
8503,796534,14,1,2,0,1,1,1,1,2,0,0,0,1,0,0,0,4
8503,785398,18,0,2,0,1,0,1,2,2,0,3,0,2,0,0,1,2
8503,796536,5,0,1,0,1,0,0,0,0,0,0,0,1,0,1,0,0
8503,796535,0,0,0,0,0,0,0,0,0,0,0,0,0,0,0,0,0
8506,785495,34,8,14,7,9,1,5,0,0,0,4,3,1,2,3,0,17
8506,785958,27,5,11,5,11,0,0,1,2,4,5,1,3,1,2,1,11
8506,785659,34,6,6,5,5,1,1,7,11,4,6,1,1,2,1,2,20
8506,785494,36,5,13,5,9,0,4,4,5,0,4,11,1,1,2,0,14
8506,780698,33,6,13,5,8,1,5,2,2,1,3,2,3,2,0,0,15
8506,785490,12,1,5,0,1,1,4,2,2,2,1,0,1,1,1,0,5
8506,791034,13,1,3,0,0,1,3,0,0,0,1,1,1,0,1,0,3
8506,780427,11,0,2,0,2,0,0,0,0,0,2,1,2,0,2,0,0
8507,796761,28,3,4,3,4,0,0,0,0,1,4,1,3,1,2,4,6
8507,780109,31,6,11,4,6,2,5,1,1,2,3,2,1,2,1,1,15
8507,796758,32,4,10,3,8,1,2,0,0,0,2,1,1,0,4,0,9
8507,796757,36,10,22,9,16,1,6,3,4,0,1,3,4,0,2,0,24
8507,780794,37,4,6,1,1,3,5,1,2,0,7,4,3,1,1,0,12
8507,791103,4,0,0,0,0,0,0,0,0,1,1,0,2,1,2,0,0
8507,785597,31,2,5,2,3,0,2,3,4,0,3,6,3,2,1,0,7
8507,796760,1,0,0,0,0,0,0,0,0,0,0,0,0,0,0,0,0
8508,791723,32,6,8,6,8,0,0,4,6,3,7,1,4,1,1,4,16
8508,781617,37,3,9,3,6,0,3,10,12,0,9,0,2,1,7,0,16
8508,797308,35,3,9,2,4,1,5,3,5,0,3,2,1,1,2,0,10
8508,797310,34,1,1,1,1,0,0,1,2,0,1,4,0,0,4,0,3
8508,791724,40,6,9,4,5,2,4,3,4,0,4,6,2,0,2,0,17
8508,797312,4,0,0,0,0,0,0,0,0,1,0,0,4,0,1,0,0
8508,780706,18,2,7,2,7,0,0,0,2,0,6,0,0,2,1,0,4
8509,797849,36,8,12,7,9,1,3,3,5,0,3,4,5,4,0,0,20
8509,781537,29,3,8,3,4,0,4,0,3,0,2,1,5,1,6,0,6
8509,779986,16,1,5,1,5,0,0,0,0,0,0,1,1,0,0,0,2
8509,792202,36,3,9,2,4,1,5,1,1,0,6,2,1,1,0,0,8
8509,786079,18,1,6,0,3,1,3,0,0,0,4,3,2,0,1,0,3
8509,797846,21,2,6,2,5,0,1,1,2,2,4,0,3,1,2,0,5
8509,797835,16,1,2,0,0,1,2,0,0,0,0,0,0,1,1,0,3
8509,792201,2,0,1,0,1,0,0,0,0,0,0,0,0,0,0,0,0
8509,797848,6,0,0,0,0,0,0,0,0,0,0,0,2,1,2,0,0
8509,797847,12,3,6,3,5,0,1,0,1,0,0,1,4,2,0,0,6
8509,797836,8,0,1,0,0,0,1,0,0,0,0,0,0,0,2,0,0
8510,797380,15,2,5,1,4,1,1,0,0,2,1,1,4,0,2,0,5
8510,789043,24,3,4,3,4,0,0,0,1,5,1,2,1,1,3,1,6
8510,786636,37,4,12,2,3,2,9,1,2,1,1,5,2,0,2,0,11
8510,780646,23,1,2,0,0,1,2,0,0,0,3,2,4,1,2,0,3
8510,791818,36,7,14,3,3,4,11,4,4,0,2,2,1,1,5,0,22
8510,797377,29,3,6,0,1,3,5,2,2,1,1,3,2,0,0,0,11
8510,775168,11,3,4,3,4,0,0,0,0,1,2,1,2,0,1,0,6
8510,797379,13,1,4,1,3,0,1,1,4,0,3,1,0,0,1,0,3
8510,797382,12,1,3,1,3,0,0,0,0,0,0,1,4,2,0,0,2
8511,796959,25,2,5,2,5,0,0,0,0,0,6,1,1,0,0,2,4
8511,781272,35,6,9,5,7,1,2,0,0,3,3,4,4,0,3,2,13
8511,791261,21,5,7,3,4,2,3,1,1,0,3,0,2,1,2,0,13
8511,781270,36,6,15,3,4,3,11,4,4,0,0,0,0,1,3,0,19
8511,785501,32,2,7,2,3,0,4,2,2,0,1,5,1,3,1,0,6
8511,796958,16,1,2,1,2,0,0,3,3,1,2,2,1,0,2,0,5
8511,791258,10,1,1,0,0,1,1,2,2,0,1,0,0,0,0,0,5
8511,791260,6,1,1,1,1,0,0,0,0,0,0,0,4,0,0,0,2
8511,796960,19,5,6,5,6,0,0,5,5,0,1,1,1,1,0,1,15
8511,799825,0,0,0,0,0,0,0,0,0,0,0,0,0,0,0,0,0
8512,791089,29,5,11,4,7,1,4,1,3,2,7,1,1,0,2,0,12
8512,791097,21,5,7,5,7,0,0,1,2,1,2,0,2,1,0,0,11
8512,796753,29,0,14,0,8,0,6,4,4,2,1,0,1,2,1,0,4
8512,796752,32,4,11,2,5,2,6,2,2,2,0,4,1,1,3,0,12
8512,791091,34,3,6,1,3,2,3,3,4,1,2,4,1,0,2,0,11
8512,785577,30,4,6,4,6,0,0,2,2,2,4,3,0,0,1,2,10
8512,785569,25,1,7,1,2,0,5,1,2,0,2,3,1,0,1,0,3
8513,792388,24,3,6,3,6,0,0,0,0,4,5,0,3,1,1,0,6
8513,797845,21,2,10,1,5,1,5,2,2,1,1,1,4,0,2,0,7
8513,797851,35,5,9,4,8,1,1,0,0,1,5,4,2,0,0,0,11
8513,792391,26,7,9,7,9,0,0,2,2,3,7,3,3,1,0,0,16
8513,792395,31,8,13,6,9,2,4,2,2,3,7,7,3,4,4,0,20
8513,781533,23,4,9,3,6,1,3,0,0,1,2,1,1,0,1,1,9
8513,792393,25,4,9,3,7,1,2,0,0,0,4,5,2,1,2,1,9
8513,792394,9,1,3,0,0,1,3,0,0,0,1,0,0,0,0,0,3
8513,786115,6,1,1,1,1,0,0,0,0,1,0,0,0,0,2,0,2
8514,785903,5,0,0,0,0,0,0,0,0,0,2,0,0,0,0,0,0
8514,791416,25,8,10,8,10,0,0,8,10,2,5,0,2,0,2,1,24
8514,797096,28,8,15,6,7,2,8,0,2,1,3,0,5,0,0,0,18
8514,780100,25,3,7,2,3,1,4,1,2,2,5,2,2,4,0,1,8
8514,780096,36,1,9,0,2,1,7,4,4,0,2,2,2,2,4,0,7
8514,797098,1,0,0,0,0,0,0,0,0,0,0,0,1,0,0,0,0
8514,781614,23,4,7,4,5,0,2,6,7,4,3,1,2,1,1,0,14
8514,797093,31,4,8,4,7,0,1,2,2,2,10,8,2,1,5,0,10
8514,785907,11,1,4,1,4,0,0,0,0,1,1,0,2,0,2,0,2
8514,797094,6,0,1,0,0,0,1,0,0,0,0,0,1,0,0,0,0
8514,791417,5,0,0,0,0,0,0,1,2,0,0,0,0,0,0,0,1
8514,767484,2,1,1,1,1,0,0,0,0,0,0,0,0,0,0,0,2
8514,797097,1,0,0,0,0,0,0,0,0,0,0,0,0,0,0,0,0
8514,791415,1,0,0,0,0,0,0,0,0,0,0,0,0,0,0,0,0
8515,781007,18,3,5,3,5,0,0,1,1,1,4,1,4,0,2,0,7
8515,781322,26,0,3,0,2,0,1,0,0,0,2,0,2,0,1,1,0
8515,785989,24,2,6,2,3,0,3,2,2,0,4,1,4,0,3,1,6
8515,786571,26,6,16,5,12,1,4,3,4,0,4,1,4,2,2,0,16
8515,781439,20,3,7,3,6,0,1,1,2,1,3,1,2,0,3,0,7
8515,781207,19,4,8,3,3,1,5,3,4,0,1,0,2,0,1,0,12
8515,797300,2,0,0,0,0,0,0,0,0,0,0,0,0,0,0,0,0
8515,781419,21,5,9,3,4,2,5,0,0,0,1,1,0,0,1,0,12
8515,797299,11,3,5,3,5,0,0,1,3,1,1,0,4,1,0,0,7
8515,780563,25,0,1,0,0,0,1,0,0,0,1,2,1,1,0,0,0
8515,791690,3,0,0,0,0,0,0,0,0,0,0,0,2,0,1,0,0
8515,784248,3,1,1,0,0,1,1,0,0,0,0,1,0,0,0,0,3
8515,791691,2,0,0,0,0,0,0,0,0,0,1,0,0,0,0,0,0
8515,791692,0,0,0,0,0,0,0,0,0,0,0,0,0,0,0,0,0
8516,797685,45,5,13,5,12,0,1,4,4,0,3,4,3,1,6,0,14
8516,780904,22,4,6,4,6,0,0,2,4,2,4,0,2,0,2,0,10
8516,786131,32,2,7,1,3,1,4,3,4,1,5,1,3,0,1,0,8
8516,786145,35,1,7,1,3,0,4,2,4,0,4,0,2,0,1,0,4
8516,780906,3,0,1,0,1,0,0,0,0,0,0,0,0,1,0,0,0
8516,785884,25,4,7,2,2,2,5,2,2,2,6,0,2,1,0,0,12
8516,792100,23,5,6,5,5,0,1,1,4,0,4,0,1,1,1,1,11
8516,797686,40,2,10,2,7,0,3,2,4,0,1,4,4,1,3,0,6
8517,785738,45,5,18,3,11,2,7,4,5,0,6,9,3,2,5,0,16
8517,797402,41,5,10,2,3,3,7,0,0,0,3,0,4,0,3,0,13
8517,785740,35,4,8,4,8,0,0,2,4,4,8,1,3,0,2,0,10
8517,780530,34,4,7,4,7,0,0,2,4,3,1,0,5,2,1,1,10
8517,785809,30,3,8,3,6,0,2,1,2,2,3,0,3,3,0,1,7
8517,786144,36,5,10,1,4,4,6,2,3,1,6,2,2,0,2,0,16
8517,791664,3,0,0,0,0,0,0,0,0,0,0,0,0,1,0,0,0
8517,785739,1,0,0,0,0,0,0,0,0,0,1,0,1,0,0,0,0
8518,790781,28,4,5,4,5,0,0,0,0,1,1,1,3,0,1,2,8
8518,780040,37,8,13,8,13,0,0,5,9,5,15,2,2,1,3,0,21
8518,790785,36,3,14,2,13,1,1,6,6,0,5,7,2,1,2,0,13
8518,781232,38,2,5,1,2,1,3,2,2,0,2,3,4,3,3,0,7
8518,780037,39,12,21,8,11,4,10,3,4,0,4,3,3,0,1,0,31
8518,796343,12,0,0,0,0,0,0,0,0,0,1,1,1,0,1,1,0
8518,790780,4,0,2,0,1,0,1,0,0,1,0,0,0,0,0,0,0
8518,790783,3,0,0,0,0,0,0,0,0,0,1,0,1,0,0,0,0
8518,785236,3,0,0,0,0,0,0,0,0,0,0,0,0,0,0,0,0
8519,786772,24,3,4,3,4,0,0,1,4,4,7,1,3,1,0,1,7
8519,781484,22,1,2,0,0,1,2,3,4,0,1,1,2,2,2,1,6
8519,791967,25,2,9,2,8,0,1,1,2,2,0,0,3,0,2,0,5
8519,786769,35,5,14,3,8,2,6,2,2,2,4,2,2,0,3,1,14
8519,780002,36,7,15,5,8,2,7,0,2,0,2,7,3,2,5,0,16
8519,786024,33,5,15,2,7,3,8,0,0,1,7,4,4,0,0,0,13
8519,790823,25,4,4,1,1,3,3,0,0,1,4,0,3,0,2,0,11
8520,786792,34,4,5,4,5,0,0,2,2,5,8,1,4,0,0,2,10
8520,792414,28,2,4,2,3,0,1,2,2,0,3,2,4,2,2,1,6
8520,789020,36,5,9,3,4,2,5,2,2,2,5,0,1,1,4,1,14
8520,786787,38,16,26,6,10,10,16,4,4,0,2,5,1,2,3,0,46
8520,774954,28,1,3,1,3,0,0,0,0,1,3,6,1,0,2,0,2
8520,786795,10,1,2,1,2,0,0,0,0,2,0,2,2,0,0,0,2
8520,792091,12,0,3,0,2,0,1,0,0,0,0,0,1,0,1,1,0
8520,781456,14,1,2,0,1,1,1,0,2,0,1,0,0,0,0,0,3
8521,785481,33,9,16,8,14,1,2,3,4,1,4,1,1,3,0,2,22
8521,780631,19,3,8,3,7,0,1,2,4,3,2,0,0,0,2,0,8
8521,797391,24,6,10,3,3,3,7,0,0,0,2,1,1,0,2,0,15
8521,786625,30,1,6,1,4,0,2,0,0,1,0,4,4,1,0,0,2
8521,780625,35,6,10,2,4,4,6,1,1,0,2,9,3,0,3,0,17
8521,797397,8,0,0,0,0,0,0,0,0,0,1,0,1,1,0,0,0
8521,797395,25,2,5,2,5,0,0,1,2,1,0,1,2,1,1,0,5
8521,797394,5,0,0,0,0,0,0,0,0,0,0,0,0,0,0,0,0
8521,786630,21,1,2,1,2,0,0,2,2,0,2,0,4,0,0,0,4
8522,781081,21,5,11,5,11,0,0,0,0,7,2,2,5,1,1,0,10
8522,797470,29,3,11,1,3,2,8,1,3,0,4,5,1,2,0,0,9
8522,791864,31,8,18,6,11,2,7,2,2,2,10,1,3,2,1,0,20
8522,791863,19,3,6,3,4,0,2,2,2,2,2,1,0,3,2,0,8
8522,780965,32,4,12,1,5,3,7,2,5,1,1,6,3,6,4,0,13
8522,797473,18,0,1,0,1,0,0,0,0,0,1,0,0,0,0,0,0
8522,786791,18,5,5,4,4,1,1,0,0,1,3,2,2,1,0,1,11
8522,786592,27,5,9,4,7,1,2,0,2,2,1,8,1,3,3,0,11
8522,776447,4,0,2,0,1,0,1,0,0,0,1,0,0,0,0,0,0
8522,791865,1,0,0,0,0,0,0,0,0,0,0,0,0,0,0,0,0
8523,800005,29,2,3,2,3,0,0,2,4,2,7,0,2,0,1,2,6
8523,800091,35,3,8,3,7,0,1,0,6,1,6,1,1,1,5,1,6
8523,799129,35,6,11,2,3,4,8,0,0,0,3,2,2,2,5,1,16
8523,799130,25,3,7,1,3,2,4,1,2,0,1,2,0,0,3,0,9
8523,792634,34,4,9,1,3,3,6,4,7,3,5,5,3,0,7,0,15
8523,799128,6,0,0,0,0,0,0,0,0,0,0,0,1,0,0,0,0
8523,799133,18,2,4,0,1,2,3,2,3,1,5,2,1,0,2,0,8
8523,799134,17,0,3,0,0,0,3,2,4,0,2,3,1,3,3,0,2
8523,799135,1,0,0,0,0,0,0,0,0,0,0,0,0,0,0,0,0
8524,786724,25,4,10,2,6,2,4,0,0,2,1,2,0,0,1,0,10
8524,786723,29,4,13,4,11,0,2,0,0,0,2,2,2,2,2,0,8
8524,792349,33,8,14,7,11,1,3,0,0,0,6,1,2,0,0,4,17
8524,798060,27,3,4,0,0,3,4,0,0,0,5,3,3,1,2,0,9
8524,792355,28,3,9,2,5,1,4,0,0,0,1,3,1,0,1,0,7
8524,792352,17,0,1,0,0,0,1,0,0,0,1,7,1,1,0,0,0
8524,798061,28,4,6,2,4,2,2,0,0,0,2,1,1,1,2,2,10
8524,792348,7,0,1,0,0,0,1,0,0,0,2,0,0,0,0,0,0
8524,786726,6,0,0,0,0,0,0,0,0,0,0,0,0,0,0,0,0
8524,798059,0,0,0,0,0,0,0,0,0,0,0,0,0,0,0,0,0
8524,781573,0,0,0,0,0,0,0,0,0,0,0,0,0,0,0,0,0
8525,780283,28,7,9,7,8,0,1,1,2,0,5,0,1,1,3,1,15
8525,790925,30,5,10,4,8,1,2,0,0,0,3,2,2,0,1,2,11
8525,791456,33,7,13,3,7,4,6,0,0,0,8,2,1,2,1,1,18
8525,785476,32,3,6,3,5,0,1,1,1,0,0,5,2,0,2,0,7
8525,785474,35,7,10,3,4,4,6,1,1,0,4,3,1,0,2,0,19
8525,796470,14,0,1,0,1,0,0,0,0,0,2,0,0,0,0,1,0
8525,785480,15,1,1,0,0,1,1,0,0,0,1,0,0,1,1,0,3
8525,790926,3,1,2,0,0,1,2,0,0,0,1,0,0,0,0,0,3
8525,800121,10,0,3,0,3,0,0,0,0,2,2,1,0,1,0,0,0
8525,796471,0,0,1,0,1,0,0,0,0,0,0,0,0,0,0,0,0
8526,796650,44,7,10,7,9,0,1,4,6,2,5,0,1,2,1,0,18
8526,791321,33,2,4,2,4,0,0,4,4,2,3,1,4,0,0,0,8
8526,791323,39,0,3,0,2,0,1,2,2,0,6,5,5,1,3,2,2
8526,791320,48,8,17,8,15,0,2,2,3,0,6,2,1,0,3,0,18
8526,781511,47,10,23,7,14,3,9,4,6,0,4,2,1,3,2,1,27
8526,796657,5,0,1,0,1,0,0,1,2,0,0,0,0,0,0,0,1
8526,796656,24,3,3,3,3,0,0,1,2,0,4,0,1,0,0,1,7
8526,796653,2,0,1,0,1,0,0,0,0,0,0,0,1,0,0,0,0
8526,796654,8,1,2,0,1,1,1,0,0,0,0,0,1,0,0,0,3
8527,780521,40,3,4,2,2,1,2,1,1,1,5,1,2,0,1,0,8
8527,775163,17,1,1,1,1,0,0,0,0,0,0,0,3,1,2,1,2
8527,791370,29,4,5,0,1,4,4,0,0,0,4,2,5,2,1,0,12
8527,786199,48,7,21,7,16,0,5,4,5,0,7,5,1,1,1,0,18
8527,780991,41,7,22,5,16,2,6,5,7,2,2,4,2,1,2,0,21
8527,780145,13,0,1,0,1,0,0,0,0,1,2,0,2,0,0,0,0
8527,781611,21,3,3,3,3,0,0,0,1,2,4,0,4,0,2,0,6
8527,797271,31,5,9,3,6,2,3,1,2,0,4,0,4,3,2,1,13
8527,743593,10,4,4,3,3,1,1,0,0,0,1,0,1,0,1,0,9
8528,786635,34,3,12,3,8,0,4,4,9,0,4,2,4,0,4,0,10
8528,791822,37,4,12,0,1,4,11,0,0,0,2,0,2,0,0,0,12
8528,781543,20,0,3,0,3,0,0,3,4,2,1,2,1,0,0,0,3
8528,780642,36,8,12,8,12,0,0,3,3,0,6,4,2,0,2,0,19
8528,776449,22,5,7,5,7,0,0,0,0,0,1,2,4,1,2,0,10
8528,798157,11,0,1,0,1,0,0,2,2,1,3,1,1,0,0,2,2
8528,797383,13,2,3,1,1,1,2,2,2,1,3,0,1,0,0,0,7
8528,786182,24,3,6,2,3,1,3,3,4,1,2,0,1,1,1,0,10
8528,786632,3,0,0,0,0,0,0,0,0,0,0,0,0,0,0,0,0
8529,783072,13,3,5,2,3,1,2,0,0,0,0,0,1,0,0,0,7
8529,781463,26,5,6,5,5,0,1,2,2,0,5,1,4,0,0,0,12
8529,791540,35,8,12,8,10,0,2,3,3,0,4,3,1,1,3,0,19
8529,787782,25,3,8,3,5,0,3,1,2,1,1,2,4,2,2,1,7
8529,776068,27,8,14,8,12,0,2,0,0,0,1,1,3,0,1,0,16
8529,797817,32,4,6,4,5,0,1,3,3,1,11,3,1,0,0,0,11
8529,774879,19,2,6,2,6,0,0,0,0,0,3,2,1,0,2,0,4
8529,792153,23,2,2,0,0,2,2,0,0,0,1,0,2,1,0,0,6
8530,791352,24,7,10,6,6,1,4,0,1,3,4,3,0,0,0,0,15
8530,780455,24,7,9,7,9,0,0,1,3,2,5,0,2,0,2,1,15
8530,797251,22,0,3,0,2,0,1,2,2,1,1,4,2,1,2,0,2
8530,797247,36,2,5,0,2,2,3,1,2,0,2,7,2,0,1,0,7
8530,776297,35,9,15,2,6,7,9,5,5,0,5,3,0,1,3,0,30
8530,791354,15,2,4,2,4,0,0,1,2,1,4,1,2,0,0,1,5
8530,785837,13,0,2,0,1,0,1,0,0,0,0,1,4,0,0,0,0
8530,797248,21,5,8,2,3,3,5,0,0,0,2,1,1,0,0,0,13
8530,791355,3,0,1,0,0,0,1,0,0,0,1,1,1,0,0,0,0
8530,797249,7,0,0,0,0,0,0,0,0,0,1,1,0,0,1,0,0
8531,797414,30,1,4,1,4,0,0,3,6,5,2,0,3,0,0,0,5
8531,785762,24,3,9,1,4,2,5,0,0,0,4,0,4,1,0,0,8
8531,797407,26,5,12,3,8,2,4,3,4,2,2,5,3,1,1,0,15
8531,791666,30,4,10,3,4,1,6,3,4,0,1,1,2,2,1,0,12
8531,780531,35,7,14,1,3,6,11,2,2,0,6,4,4,1,1,0,22
8531,780534,13,1,1,1,1,0,0,0,0,0,0,1,1,0,0,0,2
8531,797409,14,0,3,0,1,0,2,0,0,0,1,3,0,0,0,0,0
8531,797415,11,1,3,0,1,1,2,2,2,0,1,0,0,0,1,0,5
8531,785760,17,2,4,1,2,1,2,0,0,1,0,0,0,1,1,0,5
8532,792399,21,1,3,1,3,0,0,2,2,0,2,1,1,0,1,0,4
8532,799000,34,8,13,8,13,0,0,2,4,5,5,0,4,0,2,0,18
8532,775198,34,6,8,4,5,2,3,3,4,2,3,2,1,0,1,0,17
8532,786697,16,0,3,0,2,0,1,0,0,0,1,2,2,0,2,0,0
8532,775628,35,9,15,6,10,3,5,2,3,0,4,5,3,3,6,2,23
8532,785471,18,3,3,3,3,0,0,2,5,1,1,0,0,1,1,0,8
8532,780263,25,1,4,0,0,1,4,0,0,1,4,2,4,0,4,0,3
8532,786695,1,0,0,0,0,0,0,0,0,0,0,0,0,0,0,0,0
8532,780571,16,2,4,0,0,2,4,0,0,0,0,0,2,0,1,0,6
8533,792418,18,2,4,0,1,2,3,0,0,0,0,1,5,1,1,1,6
8533,782654,27,2,6,2,6,0,0,4,5,1,0,4,3,0,6,0,8
8533,796693,28,2,7,1,4,1,3,4,4,1,2,3,2,0,3,0,9
8533,796691,18,1,1,1,1,0,0,0,0,0,2,1,2,1,1,0,2
8533,789484,36,4,11,3,7,1,4,3,4,0,4,0,3,2,4,0,12
8533,796695,1,0,0,0,0,0,0,0,0,0,0,0,0,0,0,0,0
8533,796692,0,0,1,0,0,0,1,0,0,0,0,0,0,0,1,0,0
8533,792424,13,0,1,0,1,0,0,0,2,0,1,0,2,0,0,0,0
8533,792419,4,0,0,0,0,0,0,0,0,0,0,0,1,0,0,0,0
8533,800100,2,0,0,0,0,0,0,0,0,0,0,0,1,0,0,0,0
8533,792421,23,5,6,2,2,3,4,0,0,0,2,0,0,2,3,0,13
8533,792422,28,7,7,7,7,0,0,1,1,1,5,0,0,1,2,0,15
8533,792423,2,0,0,0,0,0,0,0,0,0,0,0,0,0,0,0,0
8534,796673,26,4,8,2,4,2,4,1,3,2,4,0,3,0,2,0,11
8534,796674,31,5,8,3,4,2,4,1,3,1,8,2,3,0,1,0,13
8534,779857,22,3,7,3,6,0,1,0,0,1,7,4,2,0,0,2,6
8534,779976,35,10,13,3,6,7,7,2,2,0,3,5,0,1,2,0,29
8534,774990,24,3,5,3,4,0,1,4,4,0,2,5,5,0,1,0,10
8534,785126,1,0,0,0,0,0,0,0,0,0,0,0,0,0,0,0,0
8534,781586,14,1,4,1,4,0,0,0,0,0,0,3,3,0,1,1,2
8534,785961,22,2,2,2,2,0,0,0,0,1,2,2,2,1,4,0,4
8534,791014,6,0,0,0,0,0,0,0,0,0,0,0,0,0,0,0,0
8534,785339,19,2,4,2,2,0,2,0,0,0,2,2,1,0,1,0,4
8535,791750,36,0,5,0,0,0,5,2,2,2,1,3,2,1,2,0,2
8535,786177,29,3,7,2,4,1,3,2,2,1,3,0,1,0,0,1,9
8535,791752,17,0,2,0,2,0,0,0,0,1,2,1,2,0,1,0,0
8535,786179,22,3,11,0,3,3,8,3,5,0,0,0,4,2,1,0,12
8535,780238,40,6,16,4,9,2,7,2,2,2,2,4,4,2,1,0,16
8535,791749,8,1,1,0,0,1,1,0,0,1,0,0,1,0,2,0,3
8535,780244,20,2,5,2,2,0,3,2,4,1,2,3,1,0,0,0,6
8535,785909,1,0,0,0,0,0,0,0,0,0,0,0,1,0,0,0,0
8535,790773,27,8,13,3,4,5,9,4,6,1,4,2,1,0,0,0,25
8536,797824,21,2,4,2,2,0,2,0,0,1,4,1,3,0,1,0,4
8536,797822,34,4,11,3,6,1,5,0,0,1,6,1,4,4,4,0,9
8536,792190,35,8,12,7,10,1,2,4,5,1,1,6,0,1,5,0,21
8536,791928,12,0,1,0,0,0,1,0,0,1,0,0,0,0,0,0,0
8536,786664,38,11,17,5,9,6,8,3,4,0,3,6,1,3,5,2,31
8536,775116,24,2,4,0,1,2,3,0,0,0,2,2,0,0,2,0,6
8536,797825,13,1,1,1,1,0,0,0,0,0,2,1,3,1,1,0,2
8536,792191,23,3,5,2,4,1,1,1,3,3,3,4,4,1,1,0,8
8537,796592,17,1,3,1,3,0,0,0,0,2,1,3,1,0,2,0,2
8537,780210,36,7,14,7,12,0,2,3,3,3,3,2,2,1,6,3,17
8537,796594,13,1,4,1,2,0,2,0,0,1,1,0,2,0,1,0,2
8537,792432,27,1,4,1,2,0,2,1,1,2,0,6,1,0,1,0,3
8537,775005,20,4,10,4,7,0,3,2,2,0,1,1,1,0,0,0,10
8537,791306,27,11,14,8,10,3,4,0,1,3,9,1,0,1,3,0,25
8537,792427,27,4,10,3,7,1,3,3,3,1,3,5,3,3,2,0,12
8537,792433,20,1,5,0,1,1,4,0,0,0,0,0,1,2,0,0,3
8537,786422,13,1,1,1,1,0,0,0,2,0,0,0,4,0,2,0,2
8538,786157,25,2,3,2,3,0,0,1,2,1,6,0,3,0,0,2,5
8538,780676,35,8,17,8,12,0,5,8,8,0,9,0,4,1,4,0,24
8538,791756,33,7,14,5,12,2,2,2,2,1,3,2,1,2,5,0,18
8538,780992,26,4,4,2,2,2,2,0,0,0,2,3,0,3,0,0,10
8538,780677,33,1,6,0,4,1,2,3,4,2,3,0,2,2,3,0,6
8538,791754,14,1,1,1,1,0,0,0,1,2,1,1,0,2,1,0,2
8538,786150,4,0,1,0,1,0,0,0,0,0,0,0,1,0,0,0,0
8538,775533,19,3,6,2,3,1,3,0,0,3,0,0,3,0,1,0,7
8538,797348,15,1,5,1,3,0,2,2,2,0,3,1,0,0,2,0,4
8538,780673,21,0,3,0,0,0,3,2,2,1,4,1,1,0,0,0,2
8539,781174,31,2,3,2,3,0,0,0,2,4,5,2,2,1,1,0,4
8539,781159,29,1,10,1,6,0,4,3,5,2,2,4,4,1,3,1,5
8539,791001,24,4,6,3,4,1,2,0,0,0,1,4,5,1,2,0,9
8539,781215,25,0,4,0,1,0,3,0,0,0,5,0,2,1,4,0,0
8539,775255,41,10,21,4,5,6,16,3,3,0,2,2,2,0,4,0,29
8539,796644,5,0,0,0,0,0,0,0,0,0,0,0,0,0,0,0,0
8539,785320,11,0,4,0,1,0,3,0,0,1,2,1,3,0,0,0,0
8539,785231,34,4,10,2,4,2,6,0,0,0,2,1,1,0,1,0,10
8539,779972,25,3,8,0,2,3,6,0,0,1,1,2,2,0,1,0,9
8540,776462,30,5,9,5,8,0,1,0,0,2,2,1,5,2,0,0,10
8540,775642,32,4,9,4,8,0,1,1,2,3,5,2,3,2,3,0,9
8540,791629,26,2,8,2,4,0,4,0,0,0,3,1,1,3,4,0,4
8540,796974,39,6,12,5,7,1,5,0,0,0,2,3,2,2,0,0,13
8540,781199,38,5,17,2,6,3,11,8,8,0,3,7,4,1,3,0,21
8540,791626,10,1,1,1,1,0,0,0,0,2,3,0,3,0,3,0,2
8540,786720,10,0,1,0,0,0,1,0,0,0,0,0,4,1,1,0,0
8540,791628,15,0,5,0,1,0,4,0,0,1,3,0,2,1,0,0,0
8541,791917,27,2,5,1,3,1,2,1,2,1,2,0,1,1,2,0,6
8541,786526,28,1,3,1,3,0,0,2,2,1,6,4,3,0,2,0,4
8541,786525,34,5,10,3,8,2,2,3,4,1,4,0,0,2,1,0,15
8541,791914,32,5,13,2,6,3,7,12,12,1,1,1,1,0,2,0,25
8541,786030,32,2,8,2,4,0,4,0,1,1,4,1,2,3,7,0,4
8541,786856,18,2,2,2,2,0,0,1,3,3,5,1,4,0,1,1,5
8541,797550,11,2,4,1,1,1,3,1,1,0,0,1,1,1,2,0,6
8541,781109,16,0,0,0,0,0,0,2,2,0,2,0,1,1,0,0,2
8541,786524,2,0,0,0,0,0,0,0,0,0,0,0,0,0,0,0,0
8542,785532,29,5,7,5,7,0,0,5,6,1,4,0,3,1,0,1,15
8542,780063,30,2,7,1,2,1,5,2,2,1,1,3,4,1,1,0,7
8542,785530,35,7,11,7,10,0,1,6,6,0,3,2,1,0,3,0,20
8542,775573,21,2,5,1,1,1,4,0,0,0,0,3,3,0,0,0,5
8542,775926,12,0,2,0,0,0,2,0,0,0,1,0,0,0,2,1,0
8542,796734,21,0,5,0,2,0,3,0,0,2,4,0,1,0,1,1,0
8542,791280,12,1,3,1,2,0,1,3,3,1,2,1,1,0,0,0,5
8542,791055,23,0,3,0,2,0,1,1,2,1,1,1,4,0,2,0,1
8542,791058,11,1,1,1,1,0,0,0,0,0,2,0,0,0,1,1,2
8542,791057,5,1,2,1,2,0,0,0,0,0,0,0,0,0,0,0,2
8542,791059,1,0,0,0,0,0,0,0,0,0,0,0,0,0,0,0,0
8543,796404,32,3,6,3,6,0,0,1,2,2,9,1,2,0,2,1,7
8543,790853,24,6,8,6,8,0,0,3,4,2,1,1,2,0,1,1,15
8543,790850,32,2,8,2,3,0,5,6,6,0,2,1,1,0,0,0,10
8543,781164,30,1,3,1,2,0,1,2,2,0,1,2,4,0,1,1,4
8543,781163,36,5,9,5,7,0,2,2,2,0,2,3,3,2,4,0,12
8543,796406,8,2,3,2,2,0,1,1,1,0,0,0,0,1,0,1,5
8543,785434,5,0,0,0,0,0,0,0,0,0,0,0,1,0,0,0,0
8543,790849,20,2,6,2,5,0,1,0,0,0,2,0,0,1,1,0,4
8543,790854,9,1,2,1,2,0,0,0,0,0,1,1,3,0,1,0,2
8543,781223,4,0,0,0,0,0,0,0,0,0,0,0,0,0,0,0,0
8544,797721,26,0,6,0,1,0,5,0,0,1,2,0,3,1,1,2,0
8544,786257,34,6,12,6,11,0,1,3,4,2,6,1,3,0,2,1,15
8544,786263,24,3,7,3,6,0,1,2,2,1,8,0,4,2,1,3,8
8544,785661,40,5,15,2,9,3,6,4,7,1,1,4,4,0,2,1,17
8544,775825,39,3,9,3,6,0,3,1,2,0,6,4,2,2,6,0,7
8544,792121,28,1,2,0,0,1,2,2,2,1,6,0,1,1,0,0,5
8544,797725,6,3,3,3,3,0,0,0,0,0,1,0,0,0,0,0,6
8544,792356,1,0,0,0,0,0,0,0,0,0,0,0,0,0,0,0,0
8544,797724,1,0,0,0,0,0,0,0,0,0,0,0,0,0,0,0,0
8544,786249,1,0,0,0,0,0,0,0,0,0,0,0,0,0,0,0,0
8545,786550,25,0,5,0,4,0,1,0,0,0,3,0,1,1,1,0,0
8545,776054,29,3,12,3,9,0,3,0,1,2,10,0,4,2,2,2,6
8545,792007,36,4,13,3,10,1,3,2,2,3,2,0,2,0,1,1,11
8545,792009,32,5,10,5,9,0,1,2,2,0,0,0,2,4,1,0,12
8545,792006,37,4,11,4,11,0,0,1,2,0,5,3,1,2,6,0,9
8545,792008,8,0,0,0,0,0,0,1,1,1,0,0,3,0,0,0,1
8545,797506,10,0,2,0,2,0,0,0,0,0,0,0,0,1,1,0,0
8545,786552,23,3,5,2,4,1,1,0,1,0,2,1,2,0,2,0,7
8546,775455,28,7,11,7,8,0,3,4,5,2,1,2,4,1,2,0,18
8546,792124,26,4,5,4,5,0,0,2,6,3,7,0,2,0,2,1,10
8546,792123,30,7,15,1,5,6,10,0,0,1,6,1,4,1,0,0,20
8546,786005,28,3,6,2,3,1,3,0,0,0,1,1,2,1,1,0,7
8546,781397,26,1,4,1,2,0,2,0,0,0,3,3,0,1,2,0,2
8546,797754,8,1,1,1,1,0,0,0,0,0,1,1,1,0,0,0,2
8546,786003,13,1,3,0,2,1,1,0,0,0,1,2,0,0,1,0,3
8546,786009,3,0,0,0,0,0,0,0,0,0,1,0,0,0,1,0,0
8546,792120,22,2,6,2,6,0,0,0,1,0,2,3,2,0,2,0,4
8546,786002,16,0,4,0,0,0,4,0,0,0,2,1,2,1,0,0,0
8547,780440,33,7,14,4,7,3,7,3,4,5,4,1,1,1,0,0,20
8547,775620,12,1,2,1,2,0,0,0,1,5,5,0,4,0,0,0,2
8547,791621,24,0,8,0,4,0,4,0,0,1,2,0,2,0,4,0,0
8547,786432,29,3,8,2,5,1,3,2,2,0,4,3,0,0,0,0,9
8547,786431,37,6,17,3,10,3,7,5,6,3,4,2,2,1,4,1,20
8547,791620,7,0,0,0,0,0,0,0,0,0,2,0,1,0,0,0,0
8547,786434,18,5,7,5,7,0,0,0,0,0,2,0,2,0,0,0,10
8547,781125,10,1,2,1,2,0,0,0,0,0,0,0,1,0,0,0,2
8547,781088,24,3,6,1,2,2,4,0,0,0,2,1,3,1,2,0,8
8547,775622,6,1,2,0,1,1,1,0,0,0,0,0,1,0,0,0,3
8548,792197,27,7,14,4,6,3,8,0,2,2,1,2,1,0,0,0,17
8548,797522,9,0,3,0,3,0,0,0,0,1,0,0,1,1,0,0,0
8548,781132,33,5,6,2,2,3,4,0,0,2,5,8,1,2,3,0,13
8548,791940,24,5,10,3,5,2,5,2,3,2,2,2,1,0,1,1,14
8548,786534,32,3,8,3,7,0,1,2,3,1,8,12,2,3,4,1,8
8548,797521,4,0,0,0,0,0,0,0,0,0,0,0,1,0,0,0,0
8548,786539,5,0,1,0,0,0,1,0,0,0,0,0,0,0,0,0,0
8548,797517,20,7,7,7,7,0,0,2,2,0,6,0,1,1,0,0,16
8548,797520,5,2,3,1,1,1,2,0,0,1,0,1,1,0,1,0,5
8548,797518,23,3,6,2,3,1,3,0,0,0,2,4,1,0,2,0,7
8548,791938,18,2,3,0,0,2,3,0,0,0,2,1,1,1,1,0,6
8549,776209,39,7,12,5,8,2,4,2,2,1,5,3,0,3,3,0,18
8549,791235,20,3,10,3,10,0,0,2,2,2,1,0,2,0,2,0,8
8549,791236,18,1,3,0,2,1,1,1,2,1,1,1,0,0,1,0,4
8549,791240,33,2,4,2,4,0,0,0,0,0,5,5,1,1,2,0,4
8549,791237,24,2,6,1,1,1,5,1,2,0,0,2,0,3,1,0,6
8549,788124,3,0,0,0,0,0,0,0,0,0,0,0,1,0,0,0,0
8549,781227,12,1,3,0,0,1,3,0,0,1,1,0,1,0,1,0,3
8549,796938,26,5,11,2,4,3,7,4,5,0,2,0,2,0,1,0,17
8549,791238,22,3,6,3,5,0,1,1,1,0,0,1,2,1,1,0,7
8549,796939,3,0,0,0,0,0,0,0,0,0,0,0,0,0,0,0,0
8550,792594,33,5,11,3,5,2,6,2,3,1,5,1,0,1,3,2,14
8550,792595,36,5,10,5,9,0,1,2,2,2,1,2,3,2,5,0,12
8550,792583,33,4,7,1,1,3,6,0,0,0,0,0,2,0,2,0,11
8550,792593,22,2,10,2,10,0,0,6,9,1,3,2,5,0,0,3,10
8550,792588,27,2,6,0,0,2,6,0,0,0,4,1,1,2,1,2,6
8550,792580,19,3,7,3,7,0,0,4,5,2,2,3,1,1,0,2,10
8550,792591,18,2,4,1,1,1,3,0,0,0,2,2,1,1,0,0,5
8550,792586,11,1,1,0,0,1,1,0,0,0,0,1,2,0,1,0,3
8550,792592,1,0,0,0,0,0,0,0,0,0,0,0,0,0,0,0,0
8551,776386,37,9,21,8,17,1,4,0,0,3,5,3,3,3,4,0,19
8551,780923,30,6,7,3,3,3,4,3,3,0,5,5,2,1,5,0,18
8551,775564,40,7,11,7,10,0,1,3,4,0,8,2,1,0,1,1,17
8551,792101,34,5,10,1,3,4,7,0,2,0,2,2,1,0,0,0,14
8551,797701,12,0,1,0,1,0,0,1,2,0,2,5,2,1,0,1,1
8551,780922,20,3,5,3,5,0,0,6,6,2,6,1,2,2,1,1,12
8551,792102,10,1,3,0,0,1,3,0,0,0,0,0,1,0,1,0,3
8551,797700,11,0,3,0,3,0,0,0,0,1,1,2,3,1,0,0,0
8551,786160,6,0,1,0,1,0,0,0,0,1,0,0,0,0,1,0,0
8552,777572,32,8,10,6,7,2,3,4,4,1,7,3,5,2,1,0,22
8552,791024,38,5,15,4,10,1,5,9,15,1,6,2,1,0,9,0,20
8552,791023,21,6,8,6,8,0,0,2,4,3,5,1,5,0,0,2,14
8552,791027,27,4,5,2,2,2,3,2,2,2,8,0,4,0,3,0,12
8552,796685,28,2,6,1,3,1,3,2,4,0,4,2,2,0,2,0,7
8552,791028,20,2,8,0,2,2,6,0,0,1,0,0,4,0,0,2,6
8552,781507,29,2,4,2,3,0,1,0,0,2,2,6,1,0,1,0,4
8552,796683,5,1,2,1,2,0,0,0,0,1,0,0,1,0,2,0,2
8553,781104,36,8,22,5,9,3,13,3,4,1,0,4,4,0,1,1,22
8553,780234,31,6,11,6,10,0,1,7,11,8,5,0,4,1,0,0,19
8553,775556,35,6,16,1,6,5,10,0,0,1,5,1,0,1,2,1,17
8553,786411,29,3,9,2,3,1,6,3,4,0,1,2,3,0,1,0,10
8553,780046,15,1,3,0,0,1,3,0,0,0,3,3,5,0,0,0,3
8553,797185,32,3,8,3,5,0,3,2,2,4,1,1,2,3,2,0,8
8553,781110,14,0,0,0,0,0,0,1,2,0,3,0,2,0,1,0,1
8553,786405,8,0,4,0,2,0,2,0,0,0,1,1,2,0,2,0,0
8554,780509,29,5,7,4,6,1,1,4,7,1,5,1,2,0,0,4,15
8554,797290,31,4,8,2,6,2,2,4,6,0,3,2,1,0,5,1,14
8554,786064,33,3,8,2,5,1,3,2,2,0,3,2,3,1,3,0,9
8554,797292,25,4,11,4,11,0,0,1,1,5,8,1,3,0,1,1,9
8554,797291,23,3,4,3,3,0,1,0,1,0,2,3,4,0,0,1,6
8554,791660,30,4,7,2,4,2,3,2,3,0,1,3,2,1,1,1,12
8554,791658,13,1,2,1,2,0,0,2,3,2,3,0,0,0,1,3,4
8554,791661,2,1,1,0,0,1,1,0,0,0,0,0,0,0,0,0,3
8554,785658,11,1,4,1,3,0,1,0,0,0,2,0,0,1,0,1,2
8554,791663,2,0,0,0,0,0,0,0,0,0,1,0,0,0,0,0,0
8554,797295,1,0,0,0,0,0,0,0,0,0,0,0,0,0,0,0,0
8555,792183,36,9,24,6,19,3,5,9,9,1,2,1,1,1,5,0,30
8555,792186,26,5,10,5,10,0,0,1,2,5,5,1,2,1,0,0,11
8555,792187,22,2,7,1,3,1,4,0,0,0,1,0,3,0,1,0,5
8555,781447,30,2,7,2,7,0,0,0,0,3,5,0,0,1,1,1,4
8555,792188,24,1,10,0,5,1,5,1,2,1,1,0,2,1,0,0,4
8555,781490,21,1,2,0,1,1,1,0,0,1,1,1,2,1,0,0,3
8555,796255,2,1,2,0,0,1,2,0,0,0,1,0,0,0,0,0,3
8555,780433,9,0,0,0,0,0,0,0,0,1,3,0,1,0,0,0,0
8555,792185,7,0,4,0,4,0,0,0,0,1,2,0,0,0,0,0,0
8555,797821,7,0,2,0,1,0,1,0,0,0,0,0,5,1,0,0,0
8555,797819,6,0,0,0,0,0,0,0,0,1,0,0,1,0,0,0,0
8555,786675,5,0,1,0,0,0,1,0,0,0,0,0,3,0,1,1,0
8555,797820,5,0,0,0,0,0,0,0,0,0,1,1,0,0,0,0,0
8556,790798,25,7,9,7,8,0,1,4,5,1,5,1,3,0,0,0,18
8556,780140,39,10,17,7,9,3,8,2,2,1,6,0,1,2,2,1,25
8556,796355,34,4,10,4,9,0,1,5,7,3,8,8,4,2,4,0,13
8556,785245,36,1,5,0,2,1,3,1,2,0,0,7,3,1,3,0,4
8556,780137,35,4,13,1,4,3,9,0,0,3,6,3,1,2,3,0,11
8556,790799,11,2,2,2,2,0,0,0,0,0,0,0,3,0,1,0,4
8556,775553,13,3,5,3,4,0,1,4,5,0,1,2,1,0,3,0,10
8556,790796,3,1,1,1,1,0,0,0,0,1,1,0,0,0,0,0,2
8556,799892,4,1,2,1,1,0,1,0,0,0,1,0,1,0,0,0,2
8557,786197,28,8,15,6,11,2,4,1,2,1,5,1,4,1,2,1,19
8557,780717,38,6,17,6,13,0,4,2,4,3,8,4,4,1,4,0,14
8557,791742,31,4,10,4,8,0,2,3,4,0,2,3,3,4,0,2,11
8557,791741,37,7,10,3,4,4,6,0,0,0,4,0,0,1,1,0,18
8557,776266,35,4,8,4,8,0,0,1,2,1,2,3,4,0,4,0,9
8557,791740,18,2,5,2,3,0,2,0,0,0,1,1,2,1,0,0,4
8557,791738,6,0,1,0,1,0,0,0,0,1,0,0,1,0,1,0,0
8557,774859,1,0,0,0,0,0,0,0,0,0,1,0,0,0,0,0,0
8557,797337,6,0,1,0,1,0,0,0,0,0,0,0,0,0,0,1,0
8558,780012,36,5,8,1,3,4,5,2,2,1,5,1,2,1,2,0,16
8558,796309,23,6,13,6,13,0,0,2,2,3,5,1,3,0,0,2,14
8558,790824,34,9,12,7,9,2,3,1,2,0,2,4,1,1,1,0,21
8558,780011,33,3,11,2,7,1,4,0,0,2,6,3,0,1,0,0,7
8558,775667,32,3,9,3,8,0,1,0,0,2,2,4,1,1,2,0,6
8558,774895,8,3,5,3,5,0,0,0,0,2,1,0,3,0,0,0,6
8558,785370,8,1,5,1,4,0,1,0,0,2,1,0,1,0,1,0,2
8558,781524,16,3,4,2,3,1,1,0,0,0,3,0,2,1,0,0,7
8558,796383,6,0,3,0,1,0,2,0,0,0,1,0,0,0,0,0,0
8558,796382,1,0,0,0,0,0,0,0,0,0,1,0,0,0,0,0,0
8558,780941,1,0,0,0,0,0,0,0,0,0,0,0,0,0,0,0,0
8558,796384,1,0,0,0,0,0,0,0,0,0,0,0,0,0,0,0,0
8558,785600,1,0,0,0,0,0,0,0,0,0,0,0,0,0,0,0,0
8559,780027,33,6,19,5,17,1,2,3,3,3,1,1,1,3,2,1,16
8559,786176,29,4,9,3,4,1,5,2,2,0,5,0,0,1,1,0,11
8559,786173,31,4,5,3,4,1,1,0,0,1,0,2,1,0,0,1,9
8559,780028,17,0,2,0,1,0,1,0,0,0,8,1,1,0,0,0,0
8559,774828,33,4,10,2,4,2,6,3,4,0,2,0,2,0,2,0,13
8559,780029,1,0,1,0,0,0,1,0,0,0,0,0,0,0,0,0,0
8559,797175,21,3,6,2,4,1,2,0,0,0,6,0,3,0,0,1,7
8559,791379,14,0,4,0,3,0,1,0,0,1,3,0,0,0,1,0,0
8559,791380,7,0,1,0,1,0,0,1,2,0,0,0,3,0,1,0,1
8559,797179,7,0,1,0,1,0,0,0,0,0,0,0,1,0,2,0,0
8559,797178,5,0,1,0,1,0,0,0,0,1,0,0,0,0,0,0,0
8559,797176,2,0,0,0,0,0,0,0,0,0,0,0,0,0,0,0,0
8560,798962,27,5,9,5,9,0,0,3,5,6,4,0,2,0,0,3,13
8560,791718,31,4,10,1,3,3,7,1,4,0,2,2,3,2,0,0,12
8560,798963,19,4,9,4,8,0,1,0,3,1,1,2,1,0,0,0,8
8560,791717,26,0,10,0,4,0,6,4,6,1,2,0,3,2,3,0,4
8560,787996,10,1,2,1,2,0,0,0,0,1,1,0,1,0,0,0,2
8560,781446,28,2,11,1,5,1,6,6,8,2,0,2,0,1,4,0,11
8560,798964,16,3,3,3,3,0,0,3,3,2,3,0,0,0,0,0,9
8560,798965,20,1,3,0,1,1,2,2,2,0,5,1,3,2,3,2,5
8560,798968,21,1,5,0,1,1,4,0,0,2,1,1,4,1,3,1,3
8560,798966,2,0,1,0,1,0,0,0,0,0,0,0,2,1,0,0,0
8561,786798,39,10,18,10,18,0,0,7,8,3,6,4,0,1,1,0,27
8561,781656,29,7,14,7,14,0,0,3,4,5,5,2,3,1,1,3,17
8561,796962,38,4,7,3,5,1,2,0,0,0,4,4,3,3,2,0,9
8561,781658,30,4,10,4,10,0,0,0,0,5,10,1,5,0,1,0,8
8561,780129,24,2,5,1,3,1,2,0,0,0,1,1,5,1,7,0,5
8561,791263,8,1,4,1,4,0,0,1,1,1,0,1,0,0,3,0,3
8561,798206,11,1,4,1,2,0,2,0,0,0,1,0,2,0,1,1,2
8561,796964,10,1,1,1,1,0,0,0,0,0,1,2,0,0,0,0,2
8561,790256,2,0,0,0,0,0,0,2,3,0,1,0,0,0,0,0,2
8561,796967,6,0,2,0,0,0,2,0,0,0,0,0,0,1,1,0,0
8561,796966,3,0,0,0,0,0,0,0,0,1,0,0,2,0,2,0,0
8562,785287,15,2,3,2,3,0,0,2,2,2,0,0,3,1,0,1,6
8562,776286,34,1,5,1,4,0,1,0,0,5,3,5,0,1,1,0,2
8562,791445,24,4,12,2,5,2,7,2,2,0,2,3,2,1,1,1,12
8562,785357,35,11,21,3,5,8,16,3,3,1,5,1,1,2,3,0,33
8562,775560,33,3,6,2,4,1,2,2,2,2,2,4,2,5,3,0,9
8562,797010,20,5,8,3,5,2,3,0,0,0,3,0,1,1,1,1,12
8562,775557,16,1,2,1,2,0,0,0,0,1,0,1,0,1,0,2,2
8562,781627,12,2,4,2,4,0,0,1,2,0,1,0,3,0,0,2,5
8562,797012,7,0,1,0,0,0,1,0,0,0,1,1,1,1,0,0,0
8562,785895,2,0,1,0,0,0,1,0,0,0,1,0,0,0,0,0,0
8562,791444,2,0,0,0,0,0,0,0,0,0,0,0,0,0,0,1,0
8563,776100,31,3,6,3,4,0,2,1,1,0,2,0,0,0,2,0,7
8563,785991,35,3,7,2,4,1,3,2,2,1,6,0,3,1,3,2,9
8563,797762,22,1,3,1,3,0,0,1,2,0,4,4,3,1,5,0,3
8563,781406,35,5,12,5,10,0,2,7,7,0,1,2,0,2,3,0,17
8563,781401,31,2,8,2,5,0,3,2,2,2,3,0,1,1,0,0,6
8563,792133,14,2,3,0,0,2,3,0,0,0,2,1,1,0,3,0,6
8563,797758,5,0,2,0,1,0,1,0,0,0,0,0,1,0,0,0,0
8563,775317,18,4,6,3,3,1,3,0,0,0,3,1,2,0,1,0,9
8563,792129,2,0,0,0,0,0,0,0,0,0,0,0,1,0,0,0,0
8563,797760,5,0,1,0,1,0,0,0,0,0,0,0,0,0,0,0,0
8563,792130,2,0,0,0,0,0,0,0,0,0,0,0,0,0,0,0,0
8564,791230,31,2,9,2,4,0,5,0,0,0,5,4,1,1,0,0,4
8564,785557,24,7,11,7,11,0,0,0,1,2,7,2,4,0,3,3,14
8564,791228,30,7,11,6,7,1,4,0,1,0,3,3,1,2,4,0,15
8564,796932,37,8,19,6,13,2,6,4,5,0,4,3,1,1,1,0,22
8564,785624,26,3,6,0,1,3,5,0,0,1,4,2,5,1,1,0,9
8564,796935,2,0,0,0,0,0,0,0,0,0,0,0,0,0,0,0,0
8564,796933,18,4,6,4,5,0,1,0,0,1,2,1,2,1,0,0,8
8564,791226,12,1,2,1,2,0,0,0,0,1,2,0,1,0,0,2,2
8564,791227,20,2,3,1,1,1,2,2,2,0,2,2,1,1,1,0,7
8565,785305,9,2,6,2,6,0,0,0,1,2,1,0,1,0,0,0,4
8565,782133,26,4,14,3,10,1,4,0,1,4,3,1,0,1,3,0,9
8565,790990,31,4,12,2,6,2,6,4,4,0,8,1,5,1,2,0,14
8565,789219,34,3,10,2,5,1,5,0,0,2,3,3,2,2,1,0,7
8565,785059,25,2,6,2,5,0,1,2,2,1,6,5,4,0,3,0,6
8565,796624,8,1,2,1,2,0,0,0,0,1,0,0,0,0,1,0,2
8565,790989,1,0,0,0,0,0,0,0,0,0,0,0,0,0,0,0,0
8565,796622,16,4,9,4,9,0,0,0,0,3,1,0,1,1,1,2,8
8565,796623,21,3,8,3,6,0,2,0,0,0,5,1,0,0,5,0,6
8565,790988,3,0,0,0,0,0,0,0,0,0,1,0,0,0,0,0,0
8565,785303,4,0,1,0,0,0,1,0,0,0,0,0,0,0,0,0,0
8565,785122,22,4,6,2,2,2,4,1,1,1,1,4,0,0,0,0,11
8566,780686,29,7,11,7,10,0,1,1,3,2,1,6,3,1,2,0,15
8566,780683,37,7,13,5,6,2,7,0,0,2,8,0,1,1,1,0,16
8566,797681,33,4,8,2,4,2,4,0,0,0,4,3,1,0,0,0,10
8566,786112,31,5,11,5,10,0,1,2,2,0,2,1,2,2,2,0,12
8566,780688,31,3,10,2,4,1,6,3,3,1,3,2,1,2,2,0,10
8566,797680,9,1,2,1,2,0,0,0,0,0,1,0,0,0,0,0,2
8566,791942,16,2,4,0,2,2,2,0,0,0,1,0,2,1,1,0,6
8566,780689,14,1,3,0,1,1,2,0,0,0,2,0,0,0,1,0,3
8567,785916,20,3,6,2,3,1,3,0,0,2,2,0,2,0,2,0,7
8567,780105,34,5,12,5,11,0,1,0,0,0,4,2,1,0,0,1,10
8567,785637,37,4,8,1,2,3,6,0,0,0,2,1,2,0,4,0,11
8567,785915,28,1,3,0,0,1,3,0,0,0,2,0,2,1,0,0,3
8567,781131,31,6,16,6,13,0,3,1,1,2,5,4,2,2,7,1,13
8567,791408,16,1,1,1,1,0,0,0,0,1,2,2,1,1,2,0,2
8567,780106,1,0,0,0,0,0,0,0,0,0,0,0,1,0,0,0,0
8567,785894,33,4,7,2,3,2,4,2,2,1,6,0,1,0,3,0,12
8568,786039,30,4,6,4,6,0,0,5,8,7,3,1,2,0,0,1,13
8568,792043,24,2,3,2,2,0,1,2,3,1,4,1,3,0,0,0,6
8568,786266,36,6,18,3,11,3,7,5,5,0,3,0,0,3,4,0,20
8568,792040,26,6,9,6,8,0,1,1,2,0,4,2,4,0,1,0,13
8568,775028,30,6,10,3,4,3,6,7,9,1,4,5,3,1,4,0,22
8568,797728,14,0,1,0,0,0,1,0,0,1,3,1,1,0,1,0,0
8568,797726,12,2,7,2,4,0,3,0,0,0,4,0,1,1,2,0,4
8568,797727,0,0,0,0,0,0,0,0,0,0,0,0,0,0,0,0,0
8568,797723,0,0,0,0,0,0,0,0,0,0,0,0,0,0,0,0,0
8568,797719,2,0,0,0,0,0,0,0,0,0,1,0,0,0,0,0,0
8568,797718,26,1,3,1,2,0,1,4,6,0,2,2,1,2,0,0,6
8568,792042,0,0,0,0,0,0,0,0,0,0,0,0,0,0,0,0,0
8569,775110,38,9,14,9,14,0,0,2,6,4,13,2,2,0,2,2,20
8569,791392,17,2,3,1,1,1,2,0,0,0,1,1,3,2,1,0,5
8569,785936,16,0,1,0,0,0,1,0,0,2,0,1,4,0,1,0,0
8569,780128,33,6,17,3,8,3,9,8,9,0,5,2,2,1,4,0,23
8569,775458,34,4,14,3,8,1,6,3,4,0,2,3,3,1,8,0,12
8569,797134,2,0,0,0,0,0,0,0,0,0,0,0,2,0,0,0,0
8569,797138,23,1,4,1,3,0,1,2,2,2,1,2,4,1,0,0,4
8569,797135,24,3,4,1,1,2,3,0,0,0,2,2,3,0,0,0,8
8569,785264,13,0,0,0,0,0,0,0,0,0,1,0,5,0,0,0,0
8570,797579,16,1,4,1,2,0,2,1,1,1,1,0,4,0,0,0,3
8570,786509,36,4,10,4,10,0,0,3,6,3,12,1,2,4,3,0,11
8570,786508,31,6,10,5,9,1,1,0,2,5,2,0,3,1,6,0,13
8570,785796,36,7,11,6,9,1,2,4,5,0,3,2,2,1,1,0,19
8570,797576,38,4,9,2,5,2,4,0,0,0,4,4,2,1,5,0,10
8570,791897,4,0,0,0,0,0,0,0,0,0,3,0,3,0,1,1,0
8570,797577,3,0,0,0,0,0,0,1,2,1,0,0,0,0,0,0,1
8570,797582,2,0,0,0,0,0,0,0,0,0,0,0,0,0,0,0,0
8570,791896,7,0,3,0,1,0,2,0,0,0,0,0,2,0,0,0,0
8570,781325,27,3,6,2,4,1,2,2,3,0,2,1,2,1,1,0,9
8571,790784,34,2,3,1,1,1,2,4,5,2,4,2,4,2,5,0,9
8571,786235,15,2,6,2,6,0,0,0,0,1,3,0,5,0,0,2,4
8571,797475,27,3,10,2,7,1,3,1,3,1,2,1,3,1,2,0,8
8571,786229,31,4,4,0,0,4,4,5,5,3,2,0,1,1,2,0,17
8571,775229,32,4,18,4,13,0,5,2,5,2,2,1,2,0,2,0,10
8571,776219,25,1,5,1,3,0,2,4,5,1,4,1,0,0,1,1,6
8571,786581,9,2,5,2,5,0,0,0,0,1,0,0,1,1,0,0,4
8571,786770,17,1,7,1,6,0,1,2,4,1,2,0,1,2,2,0,4
8571,781518,6,0,0,0,0,0,0,2,2,0,2,0,3,0,0,0,2
8571,791871,4,0,0,0,0,0,0,0,0,0,0,0,1,0,0,0,0
8572,791225,24,9,12,9,12,0,0,2,3,5,2,0,4,0,2,0,20
8572,775324,27,5,10,5,10,0,0,5,8,2,3,0,3,0,2,0,15
8572,791224,34,6,12,6,11,0,1,5,6,2,4,8,5,2,7,2,17
8572,785571,34,3,8,2,5,1,3,2,3,0,3,5,5,0,2,0,9
8572,781181,37,8,13,3,3,5,10,1,2,1,3,1,3,0,1,1,22
8572,796929,22,1,3,1,1,0,2,0,1,0,1,4,4,1,0,0,2
8572,796927,9,1,2,1,1,0,1,1,2,1,1,0,0,0,0,0,3
8572,791222,13,0,1,0,1,0,0,0,0,2,2,1,2,1,0,0,0
8573,781516,8,1,3,1,3,0,0,0,0,0,0,0,1,1,0,0,2
8573,797331,38,10,16,3,7,7,9,0,0,3,0,2,2,2,1,0,27
8573,791737,21,2,3,1,1,1,2,9,12,1,1,1,2,0,4,0,14
8573,783524,35,2,10,2,5,0,5,3,4,0,4,9,1,1,2,0,7
8573,780561,15,4,8,1,2,3,6,0,0,1,1,1,2,0,0,2,11
8573,791734,16,5,9,5,8,0,1,0,1,2,2,1,1,0,1,0,10
8573,797333,18,0,0,0,0,0,0,0,0,2,2,1,1,0,2,0,0
8573,795372,10,2,2,1,1,1,1,0,0,1,1,1,2,1,0,0,5
8573,786223,24,0,2,0,1,0,1,8,10,2,7,5,4,0,3,0,8
8573,797332,15,5,10,5,10,0,0,0,0,2,2,0,3,0,1,1,10
8574,780919,20,1,4,1,3,0,1,0,0,1,5,1,4,1,2,0,2
8574,775640,18,1,4,1,4,0,0,2,3,0,2,0,0,1,2,2,4
8574,785803,31,4,6,2,3,2,3,0,0,0,1,1,2,0,0,0,10
8574,780920,34,4,14,4,13,0,1,7,7,1,3,14,3,3,3,1,15
8574,780914,32,4,7,2,4,2,3,2,2,2,2,1,1,2,0,0,12
8574,791142,12,2,2,1,1,1,1,2,2,0,1,0,1,0,0,0,7
8574,775816,28,9,12,3,3,6,9,0,0,3,8,2,2,0,1,0,24
8574,796797,8,2,4,1,2,1,2,1,1,0,2,0,4,0,0,0,6
8574,791141,6,0,2,0,1,0,1,0,0,0,0,0,0,0,1,0,0
8574,796799,11,0,2,0,1,0,1,0,0,0,1,1,0,0,0,0,0
8575,796444,34,6,13,6,12,0,1,1,2,1,4,0,2,0,4,1,13
8575,790893,19,1,4,1,3,0,1,0,0,3,2,0,3,0,3,1,2
8575,790890,24,3,6,3,4,0,2,1,3,0,3,2,5,2,1,0,7
8575,786732,24,3,7,1,4,2,3,1,2,1,4,2,1,1,0,0,9
8575,775260,32,3,9,1,6,2,3,5,8,1,1,1,0,1,1,0,13
8575,786615,24,1,7,1,6,0,1,2,2,1,4,2,0,0,0,1,4
8575,775536,14,4,6,4,6,0,0,1,1,1,1,0,2,0,0,0,9
8575,790889,17,0,4,0,1,0,3,0,0,1,1,0,2,0,2,0,0
8575,780702,8,2,4,1,2,1,2,0,0,0,0,0,0,0,0,0,5
8575,799891,3,0,0,0,0,0,0,0,0,1,0,0,0,0,1,0,0
8575,796445,1,0,0,0,0,0,0,0,0,0,0,0,0,0,0,0,0
8576,785509,23,2,8,0,0,2,8,2,2,0,2,0,2,0,1,2,8
8576,791424,27,4,8,4,7,0,1,0,0,3,4,0,1,3,1,2,8
8576,797085,33,3,9,2,3,1,6,0,2,2,4,2,4,1,1,0,7
8576,791421,38,2,10,1,4,1,6,3,6,0,4,5,2,0,5,0,8
8576,785899,34,3,8,3,5,0,3,4,4,0,5,1,3,0,0,0,10
8576,791425,19,2,7,2,7,0,0,5,8,1,3,1,3,0,0,1,9
8576,797090,11,3,4,3,4,0,0,2,2,1,1,0,2,0,1,0,8
8576,797088,15,0,0,0,0,0,0,0,0,0,0,0,3,0,1,0,0
8577,797281,38,7,13,5,10,2,3,3,4,2,11,1,4,0,4,0,19
8577,791648,15,2,3,1,1,1,2,0,0,0,2,1,5,0,1,0,5
8577,785694,31,2,4,2,4,0,0,5,6,1,2,2,5,1,3,2,9
8577,797280,24,5,9,4,7,1,2,3,4,1,0,1,4,0,0,0,14
8577,797279,21,0,4,0,2,0,2,0,0,0,1,0,3,0,1,0,0
8577,797278,1,0,1,0,0,0,1,0,0,0,0,0,1,0,0,0,0
8577,791649,28,2,7,0,3,2,4,1,2,0,5,0,1,3,1,1,7
8577,786640,34,3,6,2,3,1,3,3,4,0,5,6,2,0,3,0,10
8577,785697,8,0,0,0,0,0,0,0,2,0,1,0,1,0,0,0,0
8578,791997,24,2,5,1,2,1,3,0,0,0,2,2,1,0,0,0,5
8578,786566,36,2,7,2,5,0,2,10,10,3,3,0,3,1,3,2,14
8578,786568,21,4,7,4,7,0,0,3,3,3,5,0,2,0,2,0,11
8578,791993,35,3,5,1,3,2,2,2,4,1,2,2,3,1,2,0,10
8578,781188,40,7,12,3,5,4,7,7,7,1,1,8,1,1,4,0,25
8578,797493,9,1,1,1,1,0,0,0,2,0,2,0,2,0,0,0,2
8578,786562,10,0,1,0,0,0,1,0,0,0,1,1,2,0,0,0,0
8578,781189,25,3,6,3,4,0,2,1,2,0,3,1,5,2,4,1,7
8579,791537,25,5,8,4,6,1,2,6,7,5,3,2,4,2,1,0,17
8579,786358,37,4,10,4,6,0,4,1,2,5,2,1,3,3,0,1,9
8579,775418,21,6,9,6,9,0,0,3,4,2,4,0,3,0,1,0,15
8579,780306,40,5,8,4,6,1,2,1,3,0,4,3,3,1,2,1,12
8579,797116,37,4,9,2,4,2,5,6,9,1,0,2,2,2,3,0,16
8579,791535,10,0,1,0,0,0,1,0,0,0,1,2,0,0,0,0,0
8579,780312,30,3,11,1,4,2,7,4,4,0,1,3,4,2,0,0,12
8580,790828,16,2,2,2,2,0,0,0,0,0,0,0,4,0,2,0,4
8580,785373,32,4,6,3,4,1,2,2,2,1,4,1,2,0,0,0,11
8580,785372,33,7,11,6,8,1,3,3,5,0,4,4,3,2,4,3,18
8580,790825,23,1,10,0,6,1,4,2,2,1,0,1,0,0,1,0,5
8580,774905,29,2,7,2,5,0,2,4,6,0,4,5,3,0,2,1,8
8580,796385,21,1,4,1,3,0,1,4,4,0,3,6,0,1,1,0,6
8580,796387,0,0,0,0,0,0,0,0,0,0,0,0,2,0,1,0,0
8580,785374,5,0,0,0,0,0,0,0,0,3,0,0,2,0,0,0,0
8580,785375,16,4,5,4,5,0,0,0,0,1,4,1,1,1,0,1,8
8580,786384,18,3,5,2,2,1,3,1,2,0,3,0,3,0,2,0,8
8580,790827,7,0,0,0,0,0,0,3,4,0,2,1,1,0,2,0,3
8581,790873,28,4,13,4,12,0,1,10,12,2,6,2,3,1,0,0,18
8581,785429,20,0,1,0,1,0,0,0,0,0,0,2,2,2,0,1,0
8581,780054,34,3,7,2,5,1,2,3,4,2,1,1,3,2,3,1,10
8581,786851,30,7,16,6,9,1,7,2,2,0,2,2,3,1,1,0,17
8581,781139,32,0,0,0,0,0,0,0,0,0,5,2,4,1,1,0,0
8581,796433,12,4,4,4,4,0,0,0,3,2,2,0,0,0,2,0,8
8581,776357,28,4,8,2,5,2,3,2,2,1,2,5,2,1,1,0,12
8581,796432,7,0,0,0,0,0,0,0,0,0,1,0,0,0,0,0,0
8581,776245,7,1,3,1,2,0,1,0,0,0,0,0,1,1,1,0,2
8581,799973,2,0,0,0,0,0,0,0,0,0,0,0,1,0,0,0,0
8581,796102,0,0,0,0,0,0,0,0,0,0,0,0,0,0,0,0,0
8582,792143,29,4,5,1,1,3,4,0,0,0,5,1,2,1,2,3,11
8582,786302,18,3,3,3,3,0,0,1,2,1,2,1,4,0,0,0,7
8582,786293,29,7,14,6,12,1,2,0,0,3,2,1,1,0,2,0,15
8582,797750,26,2,5,2,5,0,0,0,0,0,1,5,0,3,3,0,4
8582,780955,33,4,6,1,1,3,5,2,2,0,5,3,4,0,1,0,13
8582,797753,24,5,13,4,8,1,5,1,2,0,2,0,3,0,0,0,12
8582,792147,15,1,3,1,3,0,0,0,0,1,1,1,0,0,0,0,2
8582,786287,19,2,7,2,6,0,1,0,0,3,4,1,1,0,1,1,4
8582,797748,7,0,1,0,1,0,0,0,0,0,0,1,0,0,1,0,0
8583,780094,31,3,11,1,6,2,5,2,2,2,4,0,0,0,1,0,10
8583,775142,35,5,11,4,6,1,5,1,2,4,6,4,2,1,3,2,12
8583,790843,34,9,16,6,8,3,8,3,5,1,2,1,1,2,0,2,24
8583,786212,34,5,11,2,4,3,7,0,0,1,4,3,2,1,0,0,13
8583,785392,33,1,7,0,1,1,6,0,0,1,2,2,3,1,2,0,3
8583,790844,18,3,5,3,4,0,1,3,4,0,2,1,1,0,0,0,9
8583,781563,4,0,1,0,1,0,0,0,0,0,1,1,0,0,0,0,0
8583,799986,5,0,0,0,0,0,0,0,0,0,0,0,0,0,0,1,0
8583,796914,6,0,0,0,0,0,0,0,0,0,0,0,0,0,1,0,0
8584,796334,27,3,7,3,6,0,1,3,5,2,7,0,1,0,2,1,9
8584,790776,16,2,4,2,4,0,0,0,0,3,1,0,3,0,0,1,4
8584,796330,38,5,7,3,3,2,4,2,4,1,3,2,2,1,1,0,14
8584,785813,36,6,14,4,10,2,4,5,6,1,5,4,3,4,4,0,19
8584,796337,35,2,6,2,6,0,0,3,4,1,4,8,1,1,1,4,7
8584,785827,19,4,6,4,6,0,0,0,0,1,3,1,3,2,2,0,8
8584,796332,19,4,6,4,5,0,1,0,0,2,2,0,3,0,2,0,8
8584,779975,6,0,1,0,1,0,0,0,0,0,2,0,0,0,0,0,0
8584,779973,1,0,1,0,0,0,1,0,0,0,0,0,0,0,0,0,0
8584,796333,1,0,0,0,0,0,0,0,0,0,0,0,0,0,0,0,0
8584,796335,1,0,0,0,0,0,0,0,0,0,0,0,0,0,0,0,0
8584,796338,1,0,0,0,0,0,0,0,0,0,0,0,0,0,0,0,0
8585,797831,33,1,7,0,1,1,6,0,0,0,1,2,0,2,2,0,3
8585,785950,28,2,9,1,4,1,5,0,0,4,10,0,2,0,1,0,5
8585,797823,18,4,7,4,6,0,1,0,1,4,3,0,3,0,0,0,8
8585,797826,21,3,5,0,2,3,3,3,3,0,1,1,3,0,1,0,12
8585,792280,30,2,15,1,7,1,8,3,4,2,1,2,3,3,3,0,8
8585,797829,28,5,11,5,11,0,0,0,0,3,0,0,3,0,1,0,10
8585,792283,14,1,2,1,1,0,1,0,1,0,0,1,1,1,0,0,2
8585,780505,19,1,5,0,2,1,3,0,2,0,0,1,0,0,3,1,3
8585,792284,1,0,1,0,0,0,1,0,0,0,0,0,0,0,0,0,0
8585,792286,6,1,1,1,1,0,0,0,0,1,0,0,0,0,0,0,2
8585,799468,2,0,0,0,0,0,0,0,0,0,0,1,0,0,0,0,0
8586,792167,29,6,8,6,8,0,0,2,3,1,5,0,3,2,4,1,14
8586,797767,15,0,2,0,1,0,1,0,0,0,3,3,5,1,0,0,0
8586,791372,36,6,14,1,3,5,11,0,0,0,1,2,0,0,2,0,17
8586,792164,35,2,8,2,5,0,3,1,2,0,6,5,0,2,0,0,5
8586,797777,4,0,0,0,0,0,0,0,0,0,0,0,0,0,0,0,0
8586,797766,13,1,5,1,5,0,0,0,2,2,2,2,1,0,2,0,2
8586,797772,17,0,2,0,1,0,1,0,0,0,1,7,1,0,0,1,0
8586,780974,38,14,18,14,18,0,0,6,6,3,2,2,1,2,2,0,34
8586,792163,13,1,5,1,4,0,1,0,1,1,1,0,2,0,1,1,2
8587,797616,25,4,9,3,5,1,4,2,4,0,2,0,3,1,2,1,11
8587,786493,35,5,10,3,5,2,5,2,2,1,3,4,1,2,3,0,14
8587,791881,36,0,3,0,1,0,2,0,0,0,3,9,0,2,1,0,0
8587,797613,17,1,7,1,2,0,5,0,0,0,0,0,0,0,0,0,2
8587,786420,36,7,10,3,4,4,6,2,2,1,6,3,2,3,5,1,20
8587,797618,15,3,4,3,4,0,0,0,0,1,2,0,5,0,2,3,6
8587,797617,13,6,9,3,4,3,5,0,0,1,3,0,1,0,1,0,15
8587,797614,23,4,5,1,1,3,4,0,1,0,4,1,1,1,0,0,11
8588,786838,27,9,16,9,16,0,0,4,8,1,5,0,2,1,4,4,22
8588,792131,31,1,4,1,4,0,0,4,5,4,8,2,3,3,3,0,6
8588,797736,16,1,2,1,1,0,1,0,0,0,3,0,1,0,0,0,2
8588,792132,25,4,10,3,6,1,4,5,7,0,4,3,3,3,2,0,14
8588,792127,25,2,9,2,6,0,3,1,1,0,0,3,1,1,1,0,5
8588,799273,2,0,2,0,2,0,0,0,0,1,0,0,0,0,0,0,0
8588,792128,16,2,4,2,4,0,0,3,4,2,3,0,3,0,2,0,7
8588,799908,4,0,0,0,0,0,0,0,0,0,0,0,0,1,0,0,0
8588,797739,14,3,4,3,4,0,0,1,1,1,1,0,1,1,2,0,7
8588,792126,25,0,3,0,1,0,2,0,0,2,1,1,0,1,0,0,0
8588,791668,15,1,4,1,4,0,0,1,1,0,1,1,2,2,0,0,3
8589,786623,12,3,5,3,5,0,0,1,1,3,2,1,4,0,1,0,7
8589,797404,13,1,5,1,1,0,4,0,0,0,3,0,1,0,2,1,2
8589,791834,30,1,7,0,4,1,3,0,0,0,0,0,2,1,3,0,3
8589,791833,30,2,5,1,3,1,2,4,4,1,4,2,1,2,2,0,9
8589,785920,37,4,10,2,5,2,5,3,3,0,4,6,3,1,6,0,13
8589,797413,6,0,1,0,1,0,0,0,0,0,3,0,2,0,0,0,0
8589,786624,10,3,3,3,3,0,0,0,0,2,2,0,3,1,2,0,6
8589,797405,20,4,8,4,8,0,0,1,3,0,4,1,2,1,3,0,9
8589,785698,19,1,4,0,1,1,3,0,0,1,4,1,2,0,1,2,3
8589,784077,21,0,4,0,2,0,2,0,0,0,0,1,2,0,0,1,0
8589,797406,1,0,0,0,0,0,0,0,0,0,0,0,0,0,0,0,0
8589,797403,1,0,0,0,0,0,0,0,0,0,0,0,0,0,0,0,0
8590,791089,35,8,14,6,9,2,5,2,2,3,5,1,5,2,2,0,20
8590,791097,21,4,4,4,4,0,0,1,2,2,1,4,1,3,2,0,9
8590,796753,25,3,8,0,3,3,5,0,0,0,5,2,3,2,3,0,9
8590,796752,30,1,7,0,5,1,2,3,4,0,5,5,2,0,2,0,6
8590,791091,35,5,10,4,7,1,3,8,8,0,2,2,1,0,1,0,19
8590,785577,25,2,4,2,3,0,1,0,0,2,3,1,0,0,2,3,4
8590,785569,29,3,8,0,3,3,5,7,10,0,2,1,3,1,3,0,16
8591,792388,20,2,3,2,3,0,0,0,0,1,2,0,1,0,0,0,4
8591,797845,22,1,7,1,4,0,3,1,1,1,1,1,2,2,0,0,3
8591,797851,38,4,13,4,7,0,6,3,4,1,2,5,3,1,2,0,11
8591,792391,35,6,12,6,11,0,1,1,2,4,5,0,2,1,1,0,13
8591,792395,40,12,20,11,15,1,5,4,5,2,7,1,1,4,3,1,29
8591,781533,15,1,4,0,1,1,3,1,2,1,1,0,5,1,1,0,4
8591,792393,25,5,9,5,8,0,1,0,0,0,2,3,5,2,5,1,10
8591,786115,5,1,1,0,0,1,1,0,0,0,0,0,1,0,0,0,3
8592,792593,30,5,11,5,11,0,0,2,3,4,5,2,3,3,1,2,12
8592,792594,36,10,14,10,12,0,2,9,11,0,7,2,3,4,3,4,29
8592,792588,37,0,6,0,2,0,4,2,2,0,7,1,3,0,2,0,2
8592,792595,28,5,8,5,7,0,1,4,4,0,2,2,4,1,7,0,14
8592,792583,34,4,6,2,2,2,4,2,3,2,0,1,3,3,2,0,12
8592,792580,11,0,1,0,1,0,0,1,2,1,0,1,1,0,0,2,1
8592,796987,16,1,5,1,5,0,0,3,6,0,2,1,1,1,2,0,5
8592,792591,7,0,1,0,0,0,1,0,0,0,1,0,1,0,1,0,0
8592,792586,1,0,0,0,0,0,0,0,0,0,0,0,0,0,0,0,0
8593,797701,28,3,6,3,6,0,0,1,2,2,3,2,4,0,4,1,7
8593,792101,34,6,13,5,10,1,3,1,2,0,2,1,3,2,3,0,14
8593,780923,37,3,14,3,10,0,4,6,7,1,2,2,1,3,1,0,12
8593,775564,36,7,11,6,10,1,1,3,4,4,5,1,2,4,2,0,18
8593,776386,26,3,8,3,5,0,3,2,2,0,4,1,3,2,4,1,8
8593,797700,13,1,2,1,2,0,0,2,3,0,4,0,4,0,0,0,4
8593,780922,12,1,8,1,5,0,3,0,0,3,2,0,5,1,1,0,2
8593,792102,6,1,2,1,1,0,1,0,0,1,0,0,2,1,0,0,2
8593,786156,0,0,0,0,0,0,0,0,0,0,0,0,0,0,0,0,0
8593,786160,8,0,3,0,2,0,1,0,0,1,1,0,3,0,1,0,0
8594,792227,32,5,7,4,5,1,2,6,7,1,6,1,3,0,0,1,17
8594,781352,24,4,7,4,7,0,0,2,2,1,5,1,1,1,2,0,10
8594,792223,35,2,7,1,3,1,4,2,2,0,4,1,2,0,4,0,7
8594,785935,37,5,10,4,5,1,5,0,0,0,4,2,1,2,2,1,11
8594,781340,34,3,6,3,6,0,0,1,2,0,5,2,3,1,1,0,7
8594,797881,13,3,7,3,7,0,0,0,0,1,1,0,3,1,3,0,6
8594,797889,3,0,0,0,0,0,0,0,2,1,0,0,0,0,0,0,0
8594,781351,8,0,0,0,0,0,0,0,0,0,0,0,1,0,0,0,0
8594,797882,7,0,1,0,0,0,1,0,0,0,0,0,0,0,0,0,0
8594,792228,1,0,1,0,1,0,0,0,0,0,0,0,0,0,0,0,0
8594,786453,6,0,0,0,0,0,0,0,0,0,0,1,0,0,0,0,0
8595,791511,9,1,1,1,1,0,0,1,2,0,0,0,1,0,1,0,3
8595,778442,22,0,6,0,4,0,2,0,2,0,7,0,2,0,0,0,0
8595,797150,36,6,12,6,10,0,2,1,3,1,2,3,2,4,1,0,13
8595,780946,40,1,2,1,2,0,0,2,2,0,2,3,2,1,6,0,4
8595,786637,17,3,7,3,4,0,3,0,0,0,2,0,3,0,1,0,6
8595,797151,11,0,0,0,0,0,0,2,2,0,2,0,1,0,0,1,2
8595,791515,20,1,4,1,3,0,1,1,2,0,2,1,3,1,1,2,3
8595,791516,18,3,5,1,2,2,3,0,0,1,1,1,1,0,1,1,8
8595,791513,27,3,8,1,4,2,4,2,2,0,0,1,0,3,1,0,10
8596,785664,25,2,4,2,3,0,1,3,10,6,6,0,2,1,1,3,7
8596,785841,34,4,7,4,5,0,2,4,8,1,2,4,1,0,5,1,12
8596,796609,27,4,7,2,4,2,3,1,2,1,4,1,3,1,3,0,11
8596,796611,33,2,7,1,3,1,4,2,4,3,3,0,1,0,1,3,7
8596,792869,33,1,8,0,2,1,6,2,2,2,2,1,1,1,1,0,5
8596,796613,28,3,7,3,5,0,2,0,0,3,6,0,1,0,0,0,6
8596,792232,10,1,4,1,2,0,2,0,0,0,2,1,2,0,0,3,2
8596,791312,6,2,3,2,3,0,0,0,0,0,1,0,1,0,2,0,4
8596,781504,32,7,15,6,12,1,3,5,6,2,2,2,1,1,3,0,20
8596,766623,22,2,3,2,3,0,0,0,0,1,1,0,3,1,2,1,4
8597,780832,9,1,3,1,3,0,0,0,0,0,1,0,2,0,0,0,2
8597,790961,41,5,6,5,6,0,0,7,9,3,3,0,2,0,1,0,17
8597,786240,20,0,0,0,0,0,0,0,0,0,0,1,1,0,0,0,0
8597,785278,45,9,20,4,9,5,11,1,3,1,7,1,3,3,4,0,24
8597,780146,45,9,19,5,11,4,8,2,2,1,3,3,3,3,3,0,24
8597,796556,8,1,3,1,3,0,0,0,1,1,0,0,0,0,0,0,2
8597,796554,15,0,0,0,0,0,0,0,0,0,1,0,2,0,1,2,0
8597,796557,0,0,3,0,3,0,0,0,0,2,0,0,1,0,0,0,0
8597,796555,2,0,0,0,0,0,0,0,2,0,0,0,1,0,0,0,0
8597,796553,24,1,3,1,3,0,0,0,0,0,5,1,4,2,0,3,2
8597,775860,41,5,15,4,7,1,8,2,3,0,2,6,3,1,1,0,13
8598,786123,25,4,6,4,6,0,0,0,0,2,6,0,2,1,1,1,8
8598,780437,23,5,7,4,6,1,1,0,0,1,1,2,3,2,0,0,11
8598,797673,36,7,13,5,7,2,6,2,3,1,4,3,0,0,2,0,18
8598,786118,31,5,8,1,2,4,6,0,0,1,6,4,1,2,2,0,14
8598,786117,33,5,12,3,6,2,6,0,0,0,2,10,0,2,0,0,12
8598,797675,15,0,0,0,0,0,0,0,0,1,6,0,3,1,2,1,0
8598,797672,9,1,2,1,1,0,1,0,0,0,0,1,1,0,0,0,2
8598,792093,21,6,10,1,2,5,8,1,2,0,1,2,0,1,0,1,18
8598,786119,7,2,2,1,1,1,1,0,0,1,0,0,1,1,0,0,5
8599,792084,19,1,2,1,2,0,0,0,2,1,2,2,0,2,1,0,2
8599,791296,27,4,9,4,7,0,2,2,2,1,2,1,1,0,1,0,10
8599,786397,25,3,10,3,8,0,2,0,0,0,3,0,0,1,2,0,6
8599,796590,27,1,5,1,3,0,2,1,2,0,0,0,0,0,2,1,3
8599,791519,26,2,7,2,4,0,3,2,2,0,1,2,0,1,1,0,6
8599,791297,7,0,1,0,1,0,0,0,0,1,0,0,0,0,0,0,0
8599,791299,13,0,3,0,3,0,0,2,2,1,2,1,0,0,1,0,2
8599,796593,14,1,2,1,2,0,0,2,5,0,2,0,1,0,0,0,4
8599,796591,28,2,5,0,1,2,4,0,0,0,4,0,2,0,3,0,6
8599,780529,14,1,2,1,2,0,0,0,0,0,1,1,2,1,2,0,2
8600,790935,19,0,5,0,4,0,1,2,3,1,3,1,0,0,1,0,2
8600,792442,24,4,5,4,5,0,0,0,0,6,3,0,3,2,1,3,8
8600,790938,20,1,1,1,1,0,0,2,4,2,1,1,0,0,2,0,4
8600,780933,25,2,11,0,2,2,9,0,0,0,0,0,2,1,0,1,6
8600,775340,33,7,20,2,8,5,12,10,12,2,2,4,5,1,3,0,29
8600,796491,2,1,2,1,1,0,1,2,2,1,0,0,0,0,0,0,4
8600,796190,11,0,0,0,0,0,0,0,0,0,3,0,3,0,0,0,0
8600,790937,16,1,2,1,2,0,0,4,6,0,3,0,1,0,0,3,6
8600,785445,20,2,5,2,3,0,2,0,0,1,3,0,2,0,2,1,4
8600,796492,6,1,4,1,3,0,1,2,4,1,0,0,0,0,0,0,4
8600,774826,24,2,6,2,5,0,1,0,0,0,6,1,3,0,2,0,4
8601,780291,19,3,7,3,5,0,2,1,2,1,5,0,5,0,2,0,7
8601,785607,17,4,6,4,5,0,1,1,1,2,1,1,3,1,0,0,9
8601,796665,37,6,12,3,6,3,6,0,0,0,2,5,1,1,2,0,15
8601,785333,26,5,8,4,5,1,3,2,4,2,2,1,4,1,0,0,13
8601,775305,34,7,16,6,11,1,5,4,4,0,6,1,2,1,4,0,19
8601,796663,4,0,1,0,1,0,0,0,0,1,0,0,1,0,0,0,0
8601,791004,22,2,8,0,3,2,5,2,2,2,4,1,2,1,1,0,8
8601,791006,15,1,2,1,1,0,1,2,2,1,2,2,0,1,0,0,4
8601,796666,6,0,2,0,2,0,0,0,0,1,0,0,3,0,1,0,0
8601,796664,20,3,5,3,5,0,0,2,4,1,1,2,3,0,0,0,8
8602,797380,9,1,1,0,0,1,1,0,0,0,2,1,3,0,1,0,3
8602,789043,27,4,9,4,9,0,0,0,2,3,7,0,2,0,2,0,8
8602,791818,38,4,15,3,8,1,7,3,3,3,2,1,1,0,0,0,12
8602,786636,38,3,12,2,4,1,8,9,10,0,3,5,2,2,2,0,16
8602,780646,30,3,4,2,2,1,2,3,3,0,2,3,3,0,1,0,10
8602,797379,11,0,1,0,1,0,0,1,2,1,4,0,2,0,0,0,1
8602,797377,28,5,7,2,2,3,5,0,0,1,3,1,1,2,4,1,13
8602,775168,17,3,9,2,7,1,2,0,0,0,1,0,0,0,0,0,7
8602,791817,2,0,0,0,0,0,0,0,0,0,0,0,0,0,0,0,0
8602,797378,0,0,0,0,0,0,0,0,0,0,0,0,0,0,0,0,0
8603,796959,21,3,5,2,4,1,1,0,0,1,2,0,3,1,0,1,7
8603,781272,29,4,11,4,8,0,3,1,1,3,7,1,4,0,6,3,9
8603,791261,40,8,14,5,7,3,7,1,2,2,6,2,2,0,1,0,20
8603,785501,27,3,10,2,4,1,6,5,6,0,4,0,3,4,3,1,12
8603,781270,36,2,11,1,6,1,5,5,5,0,0,1,1,2,1,0,10
8603,796960,19,1,4,1,4,0,0,2,3,5,1,0,4,1,1,0,4
8603,791260,7,1,3,1,3,0,0,0,0,2,0,1,2,0,1,0,2
8603,796958,13,0,0,0,0,0,0,0,0,0,3,1,0,0,1,0,0
8603,791258,7,0,1,0,0,0,1,0,0,0,0,0,0,0,0,0,0
8603,785502,1,0,0,0,0,0,0,0,0,0,0,0,0,0,0,0,0
8604,781175,19,4,6,4,6,0,0,1,1,0,3,2,2,1,1,0,9
8604,786555,22,3,5,0,0,3,5,0,0,0,0,0,4,0,0,1,9
8604,786553,27,5,12,5,7,0,5,1,4,0,2,2,1,1,1,1,11
8604,780895,27,2,6,2,4,0,2,0,0,0,1,0,1,0,2,1,4
8604,781172,30,4,9,3,6,1,3,0,0,0,6,6,2,4,3,0,9
8604,781177,11,1,3,0,0,1,3,0,0,1,0,0,1,0,3,0,3
8604,785312,14,1,5,1,3,0,2,0,1,1,0,0,1,0,0,0,2
8604,792005,18,0,5,0,1,0,4,0,0,0,3,0,0,0,0,0,0
8604,797503,8,0,3,0,3,0,0,0,1,2,1,0,1,0,0,1,0
8604,797501,8,1,2,1,1,0,1,0,0,0,0,0,0,0,0,0,2
8604,797500,4,1,3,0,0,1,3,0,0,0,0,0,1,0,1,0,3
8604,786557,3,0,1,0,1,0,0,0,1,0,1,0,0,0,1,0,0
8604,792004,4,0,1,0,1,0,0,0,0,2,0,1,0,0,0,0,0
8604,797502,4,0,1,0,0,0,1,0,0,0,1,0,1,0,0,0,0
8604,781173,1,0,0,0,0,0,0,0,0,0,0,0,0,0,0,0,0
8605,790839,23,2,4,2,3,0,1,0,0,1,4,1,2,0,2,0,4
8605,785388,26,4,8,4,8,0,0,3,6,0,5,4,3,1,2,0,11
8605,796395,32,5,12,3,6,2,6,2,2,0,5,1,1,3,2,4,14
8605,785386,20,4,6,2,4,2,2,0,0,0,0,0,3,1,0,1,10
8605,780373,30,5,9,3,3,2,6,4,5,0,2,3,2,2,1,0,16
8605,790841,18,1,3,1,2,0,1,0,0,1,2,0,0,0,0,0,2
8605,780370,15,2,3,1,2,1,1,0,0,1,6,3,0,0,0,0,5
8605,796393,12,3,4,3,4,0,0,0,0,2,3,0,3,0,3,1,6
8605,790840,10,0,1,0,0,0,1,2,2,0,1,0,4,0,3,0,2
8605,796396,6,0,0,0,0,0,0,0,0,0,2,1,0,0,0,0,0
8605,790838,2,1,1,1,1,0,0,0,0,0,0,0,0,0,0,0,2
8605,796394,2,0,0,0,0,0,0,0,0,0,1,0,0,1,0,0,0
8605,796397,2,0,0,0,0,0,0,1,2,0,1,0,0,0,0,0,1
8605,788752,2,0,1,0,0,0,1,0,0,0,0,0,0,0,0,0,0
8606,792373,34,4,12,4,10,0,2,3,3,1,5,0,3,1,0,0,11
8606,781598,19,1,3,1,1,0,2,0,0,0,2,1,2,0,1,0,2
8606,792370,38,4,9,3,4,1,5,2,4,2,5,4,2,0,4,2,11
8606,797951,25,3,8,2,4,1,4,1,2,0,2,3,1,2,0,0,8
8606,775303,24,0,5,0,2,0,3,0,0,0,7,1,1,0,1,1,0
8606,797958,21,2,5,1,3,1,2,2,4,1,3,0,3,0,1,0,7
8606,792368,2,0,1,0,0,0,1,0,0,0,0,0,0,0,0,0,0
8606,790499,1,0,0,0,0,0,0,0,0,0,0,0,0,0,1,0,0
8606,786739,12,0,5,0,4,0,1,0,0,1,1,0,1,0,0,0,0
8606,776491,24,2,7,2,5,0,2,0,0,0,6,2,1,1,1,1,4
8607,791391,32,4,8,4,8,0,0,0,0,1,5,2,3,0,0,0,8
8607,797156,24,1,7,1,3,0,4,2,2,0,6,2,2,1,0,0,4
8607,791390,35,9,15,8,12,1,3,3,4,5,9,2,3,1,0,1,22
8607,775743,32,4,10,3,6,1,4,1,1,0,2,0,1,0,0,0,10
8607,780133,33,3,11,2,7,1,4,0,1,0,4,1,2,1,1,0,7
8607,797158,5,0,1,0,1,0,0,0,0,0,0,0,0,0,0,0,0
8607,791388,8,1,2,1,2,0,0,0,0,0,1,1,0,0,3,0,2
8607,776446,14,0,4,0,0,0,4,1,2,0,2,0,0,1,0,0,1
8607,780407,16,2,4,2,3,0,1,0,0,0,2,0,0,0,1,0,4
8607,797157,1,0,0,0,0,0,0,0,0,0,0,0,0,0,0,0,0
8608,797587,23,2,7,2,7,0,0,1,2,1,1,2,2,1,0,2,5
8608,786501,21,3,6,0,0,3,6,0,0,0,2,0,1,0,1,0,9
8608,781078,30,7,11,3,5,4,6,1,3,1,3,0,2,2,0,0,19
8608,786502,29,2,9,2,6,0,3,3,4,0,6,2,1,1,1,0,7
8608,781080,29,4,10,2,4,2,6,1,2,0,0,4,2,1,1,0,11
8608,797586,22,0,0,0,0,0,0,2,4,0,0,0,2,2,1,0,2
8608,791891,5,1,1,1,1,0,0,1,1,0,1,0,3,0,0,0,3
8608,797584,13,1,3,1,2,0,1,1,2,0,0,2,2,1,5,0,3
8608,791895,17,0,2,0,2,0,0,1,3,3,1,3,1,0,2,0,1
8608,781561,8,0,1,0,1,0,0,2,2,0,0,0,1,0,3,0,2
8608,797583,1,0,0,0,0,0,0,0,0,0,0,0,0,0,0,0,0
8608,791892,1,0,0,0,0,0,0,0,0,0,0,0,0,0,0,0,0
8608,791894,1,0,0,0,0,0,0,0,0,0,0,0,0,0,0,0,0
8609,775738,16,0,2,0,1,0,1,2,2,2,2,1,1,0,0,1,2
8609,786091,31,7,10,5,7,2,3,2,2,3,4,1,2,2,2,0,18
8609,786728,31,5,8,4,5,1,3,4,5,0,3,6,2,0,3,1,15
8609,785904,23,7,12,5,6,2,6,1,2,1,2,1,3,1,4,0,17
8609,780892,14,8,12,5,5,3,7,1,1,0,3,1,2,1,1,0,20
8609,786350,4,0,0,0,0,0,0,4,4,2,1,0,2,0,0,0,4
8609,797669,2,0,0,0,0,0,0,0,0,0,0,0,1,1,1,0,0
8609,797670,2,1,2,1,2,0,0,0,0,1,0,0,0,0,0,0,2
8609,797665,2,0,1,0,0,0,1,0,0,0,0,0,0,0,0,0,0
8609,797666,14,0,0,0,0,0,0,0,0,0,1,3,1,1,1,0,0
8609,792087,6,2,3,1,2,1,1,2,2,0,1,0,0,2,0,0,7
8609,785734,14,0,3,0,0,0,3,1,2,0,0,0,1,0,0,0,1
8609,786788,10,0,0,0,0,0,0,0,2,0,3,1,1,0,0,0,0
8609,786096,17,0,1,0,1,0,0,0,0,0,2,2,2,2,1,0,0
8609,781030,14,2,3,0,0,2,3,0,0,0,2,0,2,0,0,0,6
8610,791011,30,6,13,4,6,2,7,0,0,2,5,3,2,0,3,0,14
8610,796671,17,3,5,3,5,0,0,0,0,2,3,0,2,0,1,1,6
8610,785337,35,7,13,6,10,1,3,2,3,1,5,1,1,0,1,1,17
8610,791012,31,4,8,2,2,2,6,0,0,0,4,2,3,0,1,0,10
8610,781221,31,4,9,3,5,1,4,1,4,0,1,1,2,0,0,0,10
8610,796670,10,0,0,0,0,0,0,0,0,2,0,1,0,0,0,0,0
8610,796668,20,1,6,0,1,1,5,2,2,1,0,0,3,1,1,0,5
8610,791594,18,4,6,3,5,1,1,0,0,0,3,2,1,1,0,0,9
8610,791013,8,0,1,0,1,0,0,0,0,0,2,0,1,0,2,0,0
8611,785631,35,4,8,2,3,2,5,3,4,3,9,4,2,1,1,0,13
8611,786248,35,10,13,10,13,0,0,1,2,1,6,0,3,2,0,2,21
8611,791200,40,5,12,1,5,4,7,2,2,0,1,4,2,1,4,0,16
8611,785630,40,5,10,1,3,4,7,2,3,0,3,5,0,0,0,0,16
8611,785632,39,4,9,3,8,1,1,2,6,1,5,4,2,0,1,0,11
8611,791199,5,0,1,0,1,0,0,0,2,1,1,1,0,0,0,0,0
8611,791198,6,1,2,0,0,1,2,0,0,0,0,0,0,0,0,0,3
8612,786542,20,2,4,2,3,0,1,2,6,0,1,1,1,0,2,0,6
8612,786540,24,6,11,6,10,0,1,2,3,3,10,1,0,3,1,1,14
8612,792019,31,3,7,3,4,0,3,2,3,0,1,3,1,0,0,0,8
8612,792015,37,5,11,5,10,0,1,4,5,2,3,4,0,3,3,2,14
8612,775995,32,1,4,0,3,1,1,0,0,0,4,2,1,1,2,0,3
8612,785364,16,3,5,3,5,0,0,1,2,2,2,1,1,0,0,0,7
8612,792016,25,4,7,2,3,2,4,0,0,0,3,1,2,3,1,0,10
8612,791845,15,2,6,1,3,1,3,0,0,1,2,0,0,0,0,0,5
8613,796979,31,6,11,3,5,3,6,2,2,1,6,0,2,0,0,1,17
8613,776200,17,1,4,1,4,0,0,0,0,0,1,1,2,2,2,0,2
8613,786437,24,2,2,0,0,2,2,0,0,0,8,1,1,1,2,0,6
8613,780925,29,2,6,1,4,1,2,1,2,0,2,4,3,0,6,0,6
8613,781034,34,5,12,5,8,0,4,0,0,2,2,6,1,2,2,0,10
8613,796980,8,2,2,2,2,0,0,0,0,0,2,0,2,0,0,1,4
8613,791625,9,0,1,0,0,0,1,0,0,0,0,0,0,0,1,0,0
8613,791622,15,2,4,2,4,0,0,0,1,1,3,0,1,0,1,0,4
8613,791624,13,2,4,0,1,2,3,0,0,0,3,1,1,0,1,0,6
8613,791637,6,1,2,0,1,1,1,0,0,0,0,0,0,0,0,1,3
8613,780446,14,1,5,0,3,1,2,0,0,0,0,1,2,0,0,0,3
8614,781650,19,2,4,2,4,0,0,4,4,2,3,1,4,1,3,0,8
8614,797070,23,4,5,3,3,1,2,0,0,1,0,2,1,0,0,1,9
8614,797068,26,1,8,0,4,1,4,4,4,0,0,2,1,0,2,0,7
8614,791432,23,2,6,2,4,0,2,2,2,0,1,1,3,0,0,0,6
8614,791429,33,4,5,1,1,3,4,0,0,0,5,5,3,1,3,0,11
8614,791431,4,0,0,0,0,0,0,0,0,1,0,0,1,0,0,0,0
8614,797067,15,1,3,1,2,0,1,2,2,1,2,0,1,0,0,2,4
8614,777865,26,7,14,3,6,4,8,4,5,1,1,2,2,2,2,0,22
8614,776079,14,1,4,1,2,0,2,0,0,0,2,1,0,0,0,0,2
8614,797066,17,2,4,2,4,0,0,1,1,2,3,0,3,2,1,0,5
8615,791652,24,8,8,8,8,0,0,8,9,0,3,0,3,2,1,0,24
8615,786495,19,2,2,2,2,0,0,0,0,0,1,0,3,0,1,0,4
8615,797285,14,0,4,0,1,0,3,0,0,0,0,1,0,1,0,0,0
8615,791650,30,5,8,5,7,0,1,2,4,0,5,1,3,0,2,0,12
8615,776384,36,7,17,7,14,0,3,0,0,0,3,7,5,0,4,0,14
8615,791653,9,0,0,0,0,0,0,0,0,1,2,0,1,0,0,0,0
8615,791654,3,0,0,0,0,0,0,0,0,0,0,0,0,0,0,0,0
8615,775705,13,1,1,1,1,0,0,0,1,2,0,0,3,0,0,0,2
8615,797289,13,3,3,3,3,0,0,2,2,0,3,0,0,1,0,0,8
8615,797286,20,1,6,1,3,0,3,2,2,0,1,0,0,2,3,0,4
8615,797283,19,0,2,0,0,0,2,1,1,1,2,0,1,0,1,0,1
8616,791493,31,3,11,3,11,0,0,4,6,10,9,2,2,1,2,1,10
8616,789036,35,5,15,5,15,0,0,4,9,2,2,3,3,0,3,1,14
8616,791492,38,3,9,1,4,2,5,3,6,1,2,1,4,2,4,0,11
8616,778888,35,2,7,2,4,0,3,2,3,1,4,1,1,0,0,0,6
8616,776494,37,4,9,2,5,2,4,8,10,0,4,0,3,1,3,0,18
8616,780504,10,1,3,1,3,0,0,0,0,0,1,1,0,0,2,0,2
8616,797192,2,0,1,0,1,0,0,0,0,1,2,0,0,0,0,0,0
8616,791495,7,0,0,0,0,0,0,0,0,1,1,0,1,1,1,0,0
8616,791494,5,0,0,0,0,0,0,0,0,0,2,1,1,0,2,0,0
8617,792334,30,1,6,1,6,0,0,1,2,2,7,4,2,0,0,1,3
8617,786575,21,6,8,6,8,0,0,1,4,5,2,1,5,0,0,1,13
8617,799842,33,5,12,5,9,0,3,2,3,0,2,2,3,0,2,0,12
8617,792338,36,3,7,3,7,0,0,5,7,1,3,3,2,1,4,1,11
8617,781666,33,3,13,0,4,3,9,0,0,1,2,1,3,2,1,0,9
8617,798097,13,2,2,2,2,0,0,0,0,0,4,1,5,0,1,0,4
8617,786708,14,2,7,1,5,1,2,1,2,0,2,0,2,1,1,0,6
8617,798095,7,1,3,1,1,0,2,0,0,0,1,0,2,2,1,0,2
8617,791636,13,2,5,0,2,2,3,0,0,0,2,2,1,0,3,0,6
8618,797802,32,6,11,5,8,1,3,1,2,1,4,0,2,0,4,0,14
8618,797807,26,5,9,4,5,1,4,1,2,1,0,2,1,1,1,0,12
8618,797809,38,2,7,2,5,0,2,3,4,2,4,0,2,0,4,1,7
8618,786058,35,0,4,0,3,0,1,2,4,0,3,1,2,3,1,0,2
8618,791868,14,1,3,1,2,0,1,0,0,0,0,1,2,1,2,0,2
8618,792264,17,2,4,2,3,0,1,1,1,2,0,1,1,1,2,0,5
8618,797810,9,2,4,1,2,1,2,0,0,0,0,2,1,0,0,0,5
8618,795730,15,1,5,1,2,0,3,0,0,0,1,1,1,0,0,0,2
8618,797811,3,1,2,1,2,0,0,0,0,0,0,0,0,1,0,0,2
8618,797812,4,0,0,0,0,0,0,0,0,0,1,1,0,0,1,0,0
8618,797798,3,0,0,0,0,0,0,0,2,0,0,0,0,0,0,0,0
8618,781113,2,0,0,0,0,0,0,0,0,0,0,1,0,1,0,0,0
8618,797806,2,0,0,0,0,0,0,0,0,0,0,0,0,0,0,0,0
8618,797808,0,0,0,0,0,0,0,0,0,0,0,0,0,0,0,0,0
8619,775910,27,7,8,4,5,3,3,1,2,0,4,1,0,1,3,0,18
8619,781577,22,3,6,3,5,0,1,1,1,1,6,2,3,0,0,1,7
8619,786451,27,2,8,1,3,1,5,0,0,0,4,3,0,1,2,0,5
8619,780600,25,2,6,1,3,1,3,0,0,2,0,3,2,0,5,0,5
8619,781387,7,1,1,0,0,1,1,0,0,0,1,1,2,0,1,0,3
8619,780020,22,5,8,2,5,3,3,1,1,0,3,5,0,1,3,0,14
8619,790888,15,4,5,2,2,2,3,2,3,2,1,0,1,1,1,0,12
8619,797561,25,3,4,2,3,1,1,2,2,1,3,4,3,0,1,0,9
8619,793065,6,1,2,0,1,1,1,0,0,0,0,0,0,0,0,0,3
8619,786456,22,1,1,1,1,0,0,0,0,1,3,0,1,1,0,1,2
8619,786457,2,0,1,0,0,0,1,0,0,0,0,0,1,0,0,0,0
8620,792034,36,4,9,4,6,0,3,5,8,0,11,2,1,0,1,0,13
8620,780833,32,6,7,6,7,0,0,1,3,0,3,3,2,2,2,1,13
8620,792035,20,3,5,3,5,0,0,3,4,0,1,2,4,2,3,0,9
8620,780830,30,3,5,3,4,0,1,2,3,0,5,3,1,0,1,0,8
8620,791688,33,1,1,0,0,1,1,1,2,0,1,1,3,1,4,0,4
8620,797645,25,6,9,6,8,0,1,5,7,1,4,2,1,1,4,0,17
8620,785980,19,1,2,0,0,1,2,0,0,1,2,0,1,2,1,0,3
8620,785381,3,0,0,0,0,0,0,0,0,0,1,0,1,0,0,0,0
8620,797644,1,0,0,0,0,0,0,0,0,0,0,0,0,0,0,0,0
8620,785982,1,0,0,0,0,0,0,0,0,0,0,0,0,0,0,0,0
8621,781552,37,6,11,3,6,3,5,2,3,1,1,1,3,1,4,0,17
8621,792340,30,4,13,4,10,0,3,4,4,0,3,1,4,0,6,0,12
8621,792346,28,2,3,1,2,1,1,0,0,0,1,2,5,1,0,0,5
8621,781553,25,2,8,2,4,0,4,0,0,0,4,1,3,4,1,1,4
8621,792342,28,0,6,0,1,0,5,1,2,0,0,2,1,1,0,1,1
8621,792345,25,2,5,1,3,1,2,1,2,1,1,0,3,1,0,0,6
8621,798080,11,1,4,0,0,1,4,0,0,0,4,1,0,1,1,0,3
8621,792344,2,0,0,0,0,0,0,1,2,0,0,0,0,0,0,0,1
8621,792341,11,0,0,0,0,0,0,0,0,0,0,0,2,0,0,0,0
8621,798088,1,0,1,0,0,0,1,0,0,0,0,0,0,0,0,0,0
8621,798086,1,0,0,0,0,0,0,0,0,0,0,0,0,0,0,0,0
8621,798085,1,0,0,0,0,0,0,0,0,1,0,0,0,0,1,1,0
8622,781579,30,7,13,4,8,3,5,2,3,3,7,3,3,3,4,1,19
8622,775696,26,3,7,0,3,3,4,1,2,1,1,2,1,1,5,0,10
8622,786731,36,3,9,3,9,0,0,10,14,5,12,2,1,1,2,3,16
8622,781584,30,3,10,0,1,3,9,1,2,0,3,0,0,1,0,0,10
8622,780347,36,2,4,2,4,0,0,0,0,0,0,8,2,1,2,1,4
8622,776481,4,0,1,0,1,0,0,0,0,0,1,0,0,0,0,0,0
8622,798017,18,3,4,3,4,0,0,1,2,2,2,2,1,0,2,0,7
8622,798008,15,2,4,0,1,2,3,3,4,0,0,2,1,0,1,0,9
8622,792358,5,0,0,0,0,0,0,0,0,0,0,1,0,0,0,0,0
8623,797523,31,3,4,0,0,3,4,1,2,0,5,3,2,1,2,0,10
8623,785402,21,0,5,0,5,0,0,4,4,1,2,1,5,3,0,0,4
8623,797524,22,2,3,1,2,1,1,0,0,1,4,2,3,2,1,0,5
8623,792118,36,4,13,1,6,3,7,0,0,0,2,6,0,1,6,0,11
8623,782593,35,9,18,4,7,5,11,0,0,0,3,3,4,3,2,0,23
8623,785828,24,5,12,4,9,1,3,4,5,2,2,0,5,0,1,1,15
8623,791702,11,1,2,1,2,0,0,0,0,1,0,1,2,1,0,0,2
8623,797525,3,0,1,0,1,0,0,0,0,1,0,0,1,0,0,0,0
8623,791700,17,0,0,0,0,0,0,2,3,0,2,2,0,0,0,0,2
8623,797526,0,0,0,0,0,0,0,0,0,0,0,0,0,0,0,0,0
8624,797103,28,7,10,7,10,0,0,4,6,2,6,1,2,2,3,0,18
8624,797105,29,1,6,1,4,0,2,0,0,0,2,0,1,1,2,0,2
8624,797100,25,0,1,0,1,0,0,0,0,2,5,4,2,1,4,0,0
8624,791413,27,2,8,1,2,1,6,5,6,0,1,3,3,0,2,1,10
8624,785776,26,2,5,1,1,1,4,1,2,0,1,1,2,2,1,0,6
8624,791414,13,3,4,3,3,0,1,0,0,0,0,0,2,0,1,0,6
8624,785911,12,0,0,0,0,0,0,0,0,2,1,1,1,0,0,0,0
8624,791411,24,3,9,1,2,2,7,0,0,0,7,1,2,2,3,0,8
8624,781209,16,2,7,1,2,1,5,1,2,0,1,1,1,1,1,0,6
8625,781103,22,4,7,4,7,0,0,3,4,3,5,1,4,0,1,0,11
8625,797568,33,4,10,3,3,1,7,3,4,1,2,5,1,1,2,0,12
8625,797566,35,3,6,1,1,2,5,1,1,1,6,0,2,1,4,0,9
8625,781191,31,5,13,3,7,2,6,3,4,0,4,1,4,3,1,0,15
8625,781102,24,2,6,2,6,0,0,2,2,1,3,3,3,4,3,0,6
8625,797569,11,2,2,2,2,0,0,1,1,1,0,0,0,2,2,0,5
8625,791905,30,3,9,3,4,0,5,6,6,0,5,1,0,0,2,0,12
8625,791904,14,0,2,0,1,0,1,0,0,0,1,2,0,0,0,1,0
8625,797570,0,0,0,0,0,0,0,0,0,0,0,0,0,0,0,0,0
8625,781364,0,0,0,0,0,0,0,0,0,0,0,0,0,0,0,0,0
8626,791051,30,5,8,5,8,0,0,0,0,0,6,0,1,2,0,1,10
8626,780739,23,6,10,6,8,0,2,1,1,0,4,0,2,0,1,2,13
8626,790819,30,7,13,2,4,5,9,0,0,2,1,7,0,2,0,0,19
8626,785524,12,1,5,0,1,1,4,0,0,1,1,0,3,0,2,0,3
8626,781115,29,0,2,0,2,0,0,2,2,1,2,7,1,1,3,0,2
8626,796731,22,3,5,3,4,0,1,0,0,4,2,2,1,1,0,0,6
8626,796730,1,0,1,0,0,0,1,0,0,0,1,0,0,0,0,0,0
8626,785784,3,1,3,1,2,0,1,0,0,0,0,0,0,0,0,0,2
8626,791052,4,0,1,0,1,0,0,0,0,0,0,0,2,0,0,0,0
8626,786310,10,0,1,0,0,0,1,0,0,0,0,1,0,1,1,0,0
8626,775094,17,7,10,5,6,2,4,0,0,2,3,5,1,0,0,0,16
8626,775456,19,6,7,5,5,1,2,0,0,0,4,4,0,2,1,3,13
8627,796838,24,1,3,1,3,0,0,1,2,2,4,2,2,1,3,0,3
8627,796837,31,3,10,2,6,1,4,1,2,1,5,2,1,0,0,0,8
8627,796833,21,1,6,1,3,0,3,2,2,1,0,0,0,1,1,0,4
8627,785700,32,2,8,2,6,0,2,0,0,1,0,5,2,3,6,0,4
8627,780269,34,12,20,10,17,2,3,1,1,1,2,1,0,0,1,0,27
8627,791171,15,1,2,1,2,0,0,1,1,2,2,0,0,0,1,0,3
8627,796834,28,2,6,0,1,2,5,0,0,1,2,4,0,0,0,2,6
8627,785706,14,1,4,0,0,1,4,0,0,0,2,1,0,0,0,0,3
8627,796832,1,0,0,0,0,0,0,0,0,0,0,0,0,0,0,0,0
8628,796479,23,2,2,0,0,2,2,1,2,0,3,2,2,0,3,0,7
8628,781560,33,4,5,4,5,0,0,0,0,3,3,4,3,1,2,3,8
8628,791375,35,6,12,2,5,4,7,2,2,0,1,1,3,3,2,0,18
8628,785482,35,6,18,5,13,1,5,0,1,1,6,1,1,1,0,0,13
8628,780837,34,3,10,3,6,0,4,2,2,0,3,5,3,0,0,0,8
8628,796473,5,1,1,1,1,0,0,0,0,2,2,0,1,0,0,0,2
8628,786164,23,4,6,3,3,1,3,1,1,2,0,1,2,0,0,0,10
8628,796477,10,1,3,1,3,0,0,0,0,0,0,0,0,0,1,0,2
8628,796476,2,0,0,0,0,0,0,0,0,0,0,0,0,0,0,0,0
8629,791281,36,6,14,6,12,0,2,3,3,1,4,5,0,1,3,0,15
8629,792276,35,2,3,0,1,2,2,4,4,0,3,4,1,1,4,0,10
8629,791278,32,2,6,1,1,1,5,1,1,1,3,0,2,3,1,0,6
8629,786026,27,4,10,2,7,2,3,2,3,0,1,0,3,0,2,0,12
8629,785507,36,5,8,0,1,5,7,2,2,0,3,3,2,0,0,0,17
8629,796534,6,0,1,0,1,0,0,0,0,0,1,0,0,0,0,0,0
8629,796536,8,0,0,0,0,0,0,0,2,1,2,0,1,0,1,0,0
8629,796535,5,1,1,1,1,0,0,0,0,0,0,0,1,1,0,0,2
8629,785398,15,1,3,1,1,0,2,3,4,1,3,0,2,0,0,0,5
8630,781107,12,1,4,1,4,0,0,0,0,1,1,0,4,0,2,1,2
8630,791972,38,10,16,6,9,4,7,3,3,2,3,5,2,2,2,0,27
8630,796777,32,3,7,2,4,1,3,0,0,0,3,2,1,1,2,0,7
8630,791974,33,4,8,2,5,2,3,6,7,0,3,7,3,2,2,0,16
8630,780863,23,3,8,3,5,0,3,2,2,0,1,4,4,2,2,0,8
8630,796778,28,8,8,7,7,1,1,3,4,3,10,2,2,1,0,3,20
8630,780867,4,0,2,0,2,0,0,0,0,3,1,0,0,0,0,0,0
8630,796780,25,4,11,2,2,2,9,1,1,0,6,3,3,1,2,0,11
8630,791973,2,0,1,0,1,0,0,0,0,0,0,0,0,0,0,0,0
8630,792708,1,0,0,0,0,0,0,0,0,0,0,0,0,0,0,0,0
8630,780873,2,0,0,0,0,0,0,0,0,0,0,0,0,0,0,0,0
8631,791686,21,1,6,1,4,0,2,1,2,1,2,1,3,0,2,0,3
8631,798028,34,5,7,5,6,0,1,3,4,0,4,1,2,4,3,0,13
8631,790940,35,9,15,2,5,7,10,12,15,0,3,0,2,1,3,1,37
8631,786060,32,2,5,2,4,0,1,1,2,0,1,3,0,1,0,0,5
8631,780770,26,0,3,0,1,0,2,1,2,0,2,2,4,0,3,0,1
8631,792271,12,3,6,3,6,0,0,2,2,1,1,0,4,1,0,0,8
8631,792269,22,0,1,0,1,0,0,0,0,0,3,1,1,1,1,1,0
8631,798022,9,0,2,0,0,0,2,0,0,1,1,0,1,0,1,1,0
8631,792270,6,0,1,0,1,0,0,2,2,0,1,0,0,0,1,0,2
8631,798020,1,0,2,0,0,0,2,0,0,0,0,0,0,0,0,0,0
8631,792273,1,1,1,1,1,0,0,0,0,0,1,0,0,0,0,0,2
8631,792305,1,0,0,0,0,0,0,0,0,0,0,0,0,0,0,1,0
8632,791366,0,0,1,0,1,0,0,0,0,0,0,0,0,0,0,0,0
8632,780170,20,5,6,4,5,1,1,0,0,0,2,3,0,0,0,0,11
8632,797244,23,0,5,0,3,0,2,1,2,0,2,1,4,2,2,0,1
8632,797243,28,3,8,3,8,0,0,2,5,3,2,1,1,1,4,1,8
8632,785742,35,9,15,7,9,2,6,5,6,0,2,6,3,0,1,0,25
8632,797241,26,3,5,3,5,0,0,3,4,0,2,1,2,1,2,1,9
8632,791361,22,1,2,1,2,0,0,0,1,1,5,1,2,0,0,0,2
8632,791363,20,1,3,0,1,1,2,3,4,1,1,2,2,1,0,0,6
8632,786340,26,6,10,2,4,4,6,0,0,0,1,2,1,3,1,1,16
8633,791201,22,7,11,7,10,0,1,2,2,2,6,1,3,0,3,2,16
8633,775767,29,4,7,4,7,0,0,5,5,3,6,3,1,0,1,0,13
8633,796902,20,1,10,1,6,0,4,0,0,1,1,2,3,2,3,0,2
8633,785628,33,5,11,2,4,3,7,5,5,0,2,7,4,0,4,0,18
8633,785627,18,1,2,0,0,1,2,0,0,0,2,0,2,0,2,1,3
8633,796904,2,0,0,0,0,0,0,0,0,0,1,0,2,0,0,0,0
8633,791202,24,5,5,0,0,5,5,0,0,0,0,1,2,0,0,1,15
8633,781135,10,0,1,0,0,0,1,0,0,2,0,0,0,0,0,1,0
8633,796903,6,1,3,0,0,1,3,0,1,0,0,0,0,0,0,0,3
8633,796901,18,2,5,1,1,1,4,2,2,1,0,0,1,2,0,0,7
8633,785629,18,2,2,1,1,1,1,2,2,1,2,1,0,0,2,0,7
8634,791023,32,6,13,6,13,0,0,0,0,4,10,0,2,0,2,2,12
8634,796685,31,2,14,1,5,1,9,5,6,1,3,2,1,0,1,0,10
8634,791027,32,3,8,0,3,3,5,1,2,2,1,1,1,2,1,0,10
8634,791024,36,3,8,1,3,2,5,6,8,0,1,3,3,1,4,0,14
8634,777572,37,4,11,3,8,1,3,4,4,1,9,0,2,3,4,0,13
8634,791028,15,0,2,0,0,0,2,0,0,0,1,1,3,0,0,0,0
8634,781507,17,2,3,2,3,0,0,0,0,2,2,1,0,0,1,0,4
8635,775556,35,5,8,5,7,0,1,1,2,1,9,3,1,1,0,1,11
8635,780234,36,7,10,7,8,0,2,2,2,2,6,1,1,2,0,1,16
8635,786411,28,4,11,2,4,2,7,0,0,0,4,1,5,1,3,0,10
8635,780046,24,2,10,1,4,1,6,1,2,0,4,3,4,2,3,0,6
8635,781104,33,3,8,2,3,1,5,0,0,0,0,2,5,1,4,0,7
8635,781110,10,1,1,1,1,0,0,0,0,0,2,1,0,0,0,0,2
8635,797185,28,2,6,2,4,0,2,4,4,0,4,1,2,2,0,1,8
8635,786405,6,0,2,0,1,0,1,0,0,0,0,1,1,0,1,0,0
8636,786569,27,5,6,5,6,0,0,3,4,1,5,1,4,0,0,1,13
8636,797317,14,1,3,1,2,0,1,0,2,1,1,0,3,0,3,1,2
8636,791726,40,4,8,2,4,2,4,6,8,0,3,3,0,0,5,0,16
8636,786273,39,5,9,3,4,2,5,0,0,0,4,5,2,1,2,2,12
8636,780773,39,6,11,6,9,0,2,2,7,0,6,3,2,1,2,0,14
8636,797315,3,0,0,0,0,0,0,0,0,0,0,0,1,0,0,0,0
8636,797313,25,2,4,1,3,1,1,3,4,2,2,1,1,0,0,0,8
8636,791728,13,3,7,3,7,0,0,3,4,4,4,0,4,1,1,2,9
8637,786404,29,4,8,4,7,0,1,2,3,2,7,1,4,2,3,0,10
8637,780378,35,6,13,6,13,0,0,3,4,3,4,0,3,0,1,2,15
8637,786378,37,3,9,1,4,2,5,2,3,0,2,3,4,1,1,0,10
8637,786374,23,1,6,1,5,0,1,0,1,0,0,0,4,0,1,0,2
8637,786253,37,11,16,9,13,2,3,3,4,0,3,6,4,0,2,0,27
8637,797062,5,1,2,1,2,0,0,1,1,1,0,0,2,0,0,0,3
8637,797065,18,0,2,0,0,0,2,0,0,0,1,1,0,0,0,0,0
8637,797061,10,1,3,1,1,0,2,0,0,0,0,0,2,1,2,0,2
8637,791562,1,0,0,0,0,0,0,0,0,0,0,0,0,0,0,0,0
8637,780381,4,0,1,0,1,0,0,0,0,1,0,1,0,1,0,0,0
8637,780121,1,0,0,0,0,0,0,0,0,0,0,0,1,0,0,0,0
8638,791042,20,3,7,3,6,0,1,1,2,1,7,1,4,0,2,6,7
8638,774834,21,1,5,1,4,0,1,0,0,2,2,0,1,1,2,3,2
8638,791043,34,8,16,6,10,2,6,1,1,1,6,2,0,1,2,0,19
8638,776374,22,2,6,2,4,0,2,2,2,0,3,2,3,2,0,0,6
8638,775412,20,0,2,0,0,0,2,0,0,0,3,2,1,1,1,0,0
8638,796723,18,2,3,1,1,1,2,4,4,0,0,3,3,2,3,0,9
8638,796719,8,0,2,0,2,0,0,0,0,1,0,0,2,0,3,0,0
8638,785512,20,4,6,4,6,0,0,1,2,3,1,1,3,0,1,3,9
8638,796718,9,1,2,1,1,0,1,2,2,0,0,0,0,0,0,1,4
8638,796717,18,0,2,0,2,0,0,3,4,1,2,1,3,0,3,0,3
8638,796720,10,1,3,1,2,0,1,0,0,0,0,0,0,0,0,0,2
8639,792299,24,1,11,1,8,0,3,2,2,1,4,2,3,2,3,2,4
8639,786181,21,3,8,3,8,0,0,1,2,2,4,1,3,0,1,2,7
8639,792304,36,4,11,2,5,2,6,2,2,1,4,2,1,0,1,0,12
8639,792301,23,3,7,3,6,0,1,6,6,1,3,3,4,0,4,0,12
8639,786275,32,3,3,0,0,3,3,5,6,1,2,0,3,1,1,0,14
8639,798089,12,2,3,2,3,0,0,0,0,1,0,1,2,1,1,0,4
8639,792295,12,0,0,0,0,0,0,0,0,0,1,0,0,0,0,0,0
8639,786286,13,1,4,1,3,0,1,1,2,1,1,0,1,0,0,0,3
8639,786278,27,4,7,2,4,2,3,3,3,0,1,1,2,2,1,0,13
8640,796860,32,6,13,6,13,0,0,3,3,4,3,3,2,1,3,0,15
8640,791187,21,4,9,4,9,0,0,0,3,2,2,0,5,0,2,0,8
8640,796856,26,4,11,0,2,4,9,1,2,1,4,0,2,1,0,0,13
8640,791184,14,0,1,0,1,0,0,0,0,0,3,0,2,0,1,0,0
8640,785649,35,7,19,4,12,3,7,1,1,0,4,5,3,2,1,0,18
8640,791183,13,2,4,2,4,0,0,1,2,1,1,0,3,0,1,0,5
8640,791185,15,1,2,1,1,0,1,0,2,1,2,0,0,0,0,0,2
8640,775208,4,2,2,2,2,0,0,0,0,0,0,0,0,1,0,0,4
8640,796861,10,2,5,1,3,1,2,0,0,0,0,0,1,0,0,0,5
8640,796857,1,0,0,0,0,0,0,0,0,0,0,0,0,0,0,0,0
8640,785650,29,2,5,0,2,2,3,0,0,0,1,5,0,3,1,0,6
8641,780569,28,6,8,6,8,0,0,0,0,2,7,2,5,0,7,2,12
8641,791695,22,0,0,0,0,0,0,0,2,0,5,1,3,0,1,1,0
8641,791696,36,8,15,7,11,1,4,3,3,0,3,2,3,2,3,0,20
8641,781556,9,2,3,2,3,0,0,0,0,0,2,0,0,0,0,1,4
8641,780565,34,10,16,4,8,6,8,6,6,1,7,1,1,0,1,0,32
8641,797433,10,0,0,0,0,0,0,0,0,0,2,0,3,0,0,2,0
8641,797432,17,1,7,0,3,1,4,1,2,1,1,2,4,0,1,0,4
8641,797436,24,2,8,2,6,0,2,2,2,1,3,2,2,1,2,0,6
8641,785824,20,0,1,0,0,0,1,2,2,1,2,0,0,0,0,0,2
8642,797235,23,3,3,3,3,0,0,1,3,1,4,1,2,0,3,1,7
8642,797232,38,5,14,2,6,3,8,0,0,0,1,1,2,2,3,0,13
8642,791367,33,8,13,8,13,0,0,4,5,0,3,4,3,1,2,0,20
8642,797234,31,3,8,3,5,0,3,0,0,2,11,1,1,1,1,0,6
8642,797239,29,7,15,5,8,2,7,2,3,0,4,4,2,1,1,0,18
8642,797236,1,0,0,0,0,0,0,0,0,0,0,0,0,0,0,0,0
8642,797238,1,0,0,0,0,0,0,0,0,0,0,0,0,0,0,0,0
8642,786535,21,4,5,2,3,2,2,0,0,1,3,0,1,0,0,0,10
8642,797240,1,0,0,0,0,0,0,0,0,0,0,0,0,0,0,0,0
8642,797237,17,1,5,1,4,0,1,1,1,0,2,1,1,1,1,1,3
8642,785446,4,1,1,0,0,1,1,0,0,0,0,0,0,1,0,0,3
8642,791369,1,0,0,0,0,0,0,0,0,0,0,0,0,0,0,0,0
8643,785294,22,1,4,1,4,0,0,2,4,3,4,1,4,0,1,0,4
8643,791085,12,1,6,1,4,0,2,0,0,0,0,0,1,0,1,1,2
8643,791080,33,5,10,5,9,0,1,2,2,0,4,1,2,1,2,1,12
8643,786446,13,0,2,0,1,0,1,1,2,0,2,5,1,1,4,0,1
8643,785675,35,5,15,1,5,4,10,0,0,0,7,5,2,1,2,0,14
8643,796511,23,1,5,1,3,0,2,0,0,1,3,0,1,0,0,0,2
8643,791083,16,3,6,2,4,1,2,0,0,1,3,1,1,0,0,2,7
8643,791081,3,0,0,0,0,0,0,0,0,1,0,0,0,0,1,0,0
8643,796512,29,5,10,4,4,1,6,1,1,1,4,0,3,1,2,1,12
8643,796515,14,3,8,0,1,3,7,0,0,1,1,0,2,0,2,0,9
8644,792265,33,5,17,3,7,2,10,2,3,4,2,1,1,0,1,0,14
8644,786152,23,3,9,3,9,0,0,0,0,1,2,1,3,0,2,0,6
8644,798003,27,3,7,2,4,1,3,1,3,1,3,3,3,3,5,0,8
8644,798009,23,3,9,3,6,0,3,0,0,2,5,2,1,2,0,0,6
8644,792263,21,2,5,1,1,1,4,0,0,1,3,2,2,2,4,0,5
8644,798007,19,1,5,1,3,0,2,0,0,0,1,0,2,1,1,0,2
8644,798005,6,0,1,0,1,0,0,0,0,1,1,0,1,0,1,0,0
8644,797998,16,2,5,1,1,1,4,0,1,0,1,1,0,1,1,0,5
8644,798006,6,0,0,0,0,0,0,1,2,0,0,0,0,0,0,0,1
8644,792267,26,5,8,3,3,2,5,0,1,1,5,3,2,1,0,0,12
8645,791135,32,7,10,6,9,1,1,8,10,5,7,0,2,0,1,3,23
8645,796791,28,2,6,2,3,0,3,0,0,0,3,3,2,1,2,1,4
8645,791132,29,5,13,2,4,3,9,0,0,2,2,1,3,1,1,0,13
8645,786090,33,5,10,5,8,0,2,2,2,1,9,2,2,1,3,0,12
8645,786088,28,3,7,3,6,0,1,2,3,2,7,4,3,4,4,1,8
8645,791133,6,0,2,0,2,0,0,0,0,0,0,0,0,0,1,0,0
8645,791134,5,0,0,0,0,0,0,0,0,1,0,0,0,0,1,0,0
8645,791131,10,0,2,0,1,0,1,0,0,0,3,0,1,0,0,0,0
8645,796790,29,4,12,1,5,3,7,4,4,0,1,1,0,2,0,0,15
8646,791809,11,2,4,2,4,0,0,0,0,1,2,0,0,0,2,0,4
8646,780651,26,6,13,6,13,0,0,3,8,3,6,3,1,0,2,3,15
8646,791815,31,5,10,3,7,2,3,3,4,1,6,2,4,0,1,1,15
8646,791810,32,1,2,1,1,0,1,0,1,1,3,9,1,2,4,0,2
8646,780650,36,5,9,4,6,1,3,2,4,0,6,3,1,1,2,0,13
8646,791812,14,2,6,0,3,2,3,0,0,2,1,1,1,0,1,0,6
8646,781596,16,4,4,4,4,0,0,0,0,2,2,0,3,1,1,1,8
8646,791814,10,0,0,0,0,0,0,0,0,0,0,1,0,0,0,0,0
8646,786645,21,3,6,2,5,1,1,2,2,2,2,0,1,0,0,0,9
8646,786644,3,0,0,0,0,0,0,0,0,0,1,0,0,0,0,0,0
8647,791837,34,2,9,2,5,0,4,3,4,2,5,3,1,1,0,0,7
8647,780613,33,3,9,3,9,0,0,4,8,0,4,1,2,2,3,0,10
8647,775097,30,4,6,4,6,0,0,2,3,0,1,5,2,1,2,0,10
8647,780609,40,3,7,1,2,2,5,0,0,0,1,4,1,3,1,0,8
8647,776395,39,9,17,3,8,6,9,0,0,0,3,2,3,3,1,0,24
8647,786621,7,1,1,0,0,1,1,2,2,0,0,1,4,0,0,0,5
8647,786619,3,0,1,0,1,0,0,0,0,0,1,0,0,0,0,0,0
8647,786622,13,1,2,0,1,1,1,0,0,0,1,1,2,0,1,1,3
8647,797437,1,0,0,0,0,0,0,0,0,0,0,0,0,0,0,0,0
8648,781249,39,6,10,4,5,2,5,2,2,1,5,4,2,0,2,0,16
8648,775165,23,1,2,0,1,1,1,0,0,0,3,0,3,1,1,0,3
8648,785514,37,8,16,5,11,3,5,7,11,2,2,3,5,4,2,2,26
8648,785515,30,9,16,6,10,3,6,0,0,0,2,7,2,2,3,0,21
8648,781253,34,1,2,1,1,0,1,2,3,3,0,1,2,0,0,0,4
8648,796953,6,0,2,0,2,0,0,0,0,0,0,0,0,1,0,0,0
8648,791251,0,0,0,0,0,0,0,0,0,0,0,0,0,0,0,0,0
8648,791687,31,4,9,3,6,1,3,2,3,0,0,0,2,1,3,0,11
8649,790870,36,15,19,15,19,0,0,3,5,4,2,0,2,1,5,0,33
8649,790869,30,9,15,6,10,3,5,5,9,1,2,3,4,1,5,0,26
8649,780116,24,2,2,1,1,1,1,2,2,0,7,0,5,0,2,0,7
8649,796421,38,4,6,4,6,0,0,0,0,0,6,6,2,2,2,1,8
8649,790866,38,1,4,0,1,1,3,0,0,0,2,2,3,1,1,0,3
8649,780493,21,3,3,0,0,3,3,2,2,0,3,0,1,0,2,0,11
8649,796427,11,0,0,0,0,0,0,2,2,1,1,1,0,0,0,0,2
8649,783997,2,0,0,0,0,0,0,0,0,0,0,0,0,0,0,0,0
8650,787239,23,3,4,3,4,0,0,0,0,1,3,0,3,0,1,2,6
8650,789058,33,2,4,1,2,1,2,0,0,1,3,1,2,2,2,5,5
8650,797898,31,7,19,5,12,2,7,4,6,0,2,7,2,4,1,0,20
8650,792236,22,0,4,0,2,0,2,0,0,0,1,1,0,1,1,0,0
8650,781374,28,7,16,6,13,1,3,7,9,0,3,4,1,2,0,0,22
8650,792238,8,1,1,1,1,0,0,0,0,1,2,0,1,0,0,0,2
8650,785818,11,1,2,0,0,1,2,0,0,1,0,0,1,0,0,0,3
8650,785286,14,0,1,0,0,0,1,4,4,2,1,1,0,0,0,0,4
8650,776337,6,0,1,0,1,0,0,0,0,1,0,0,2,0,0,0,0
8650,792240,3,0,0,0,0,0,0,0,0,0,0,0,1,0,0,0,0
8650,792237,21,4,10,2,4,2,6,1,1,0,2,0,2,2,0,0,11
8651,796568,31,3,7,3,7,0,0,0,0,3,4,3,3,2,1,0,6
8651,796566,30,7,13,7,13,0,0,1,3,2,12,0,3,0,1,2,15
8651,790969,28,2,6,2,6,0,0,4,6,1,3,4,2,0,4,0,8
8651,780166,29,8,8,5,5,3,3,1,1,1,5,7,2,1,4,0,20
8651,775107,27,3,10,2,7,1,3,0,0,1,1,3,3,0,1,1,7
8651,790971,9,2,3,2,3,0,0,0,0,0,3,0,1,0,0,0,4
8651,796569,14,3,3,3,3,0,0,0,0,1,0,2,4,0,1,1,6
8651,796563,2,0,1,0,0,0,1,0,0,0,0,0,0,0,0,0,0
8651,790968,19,2,5,1,2,1,3,0,0,0,1,3,2,0,2,0,5
8651,790967,11,0,2,0,0,0,2,0,0,0,0,0,1,0,1,0,0
8652,781530,24,14,17,14,16,0,1,1,1,0,10,1,1,4,1,0,29
8652,776423,17,6,8,6,8,0,0,0,0,1,4,0,2,2,1,2,12
8652,798096,23,3,6,3,4,0,2,0,0,0,1,3,0,1,1,0,6
8652,792307,17,2,3,2,3,0,0,0,0,0,3,0,1,1,1,0,4
8652,792319,21,0,3,0,1,0,2,0,0,1,2,2,3,0,1,0,0
8652,798109,3,1,1,1,1,0,0,1,1,1,2,0,1,0,0,0,3
8652,792316,3,2,2,2,2,0,0,1,2,0,1,0,0,0,1,0,5
8652,792314,16,5,6,5,6,0,0,0,1,2,1,1,1,1,1,1,10
8652,786296,14,0,0,0,0,0,0,1,2,1,2,3,1,0,1,0,1
8652,792320,7,1,3,1,3,0,0,0,0,1,0,0,0,0,0,0,2
8652,798106,5,0,1,0,1,0,0,1,2,1,0,0,2,0,0,0,1
8652,798104,23,1,6,1,4,0,2,0,0,0,0,4,0,0,0,0,2
8652,798102,4,0,2,0,1,0,1,0,0,0,0,0,0,0,0,0,0
8652,792309,14,2,4,1,3,1,1,0,0,0,2,3,1,0,0,0,5
8652,792321,9,0,0,0,0,0,0,0,0,0,1,0,0,2,0,0,0
8653,780913,18,3,14,0,3,3,11,2,2,2,3,1,3,1,1,0,11
8653,798119,25,2,6,2,5,0,1,1,1,0,1,0,0,0,1,0,5
8653,798117,21,0,2,0,0,0,2,0,0,1,3,2,0,0,1,0,0
8653,780594,33,3,7,1,2,2,5,0,0,0,2,2,1,0,3,0,8
8653,775664,23,1,3,1,2,0,1,0,0,1,1,2,1,2,1,0,2
8653,798127,7,2,3,0,0,2,3,0,0,0,1,0,3,0,0,0,6
8653,798123,20,4,12,4,11,0,1,2,3,5,1,1,1,1,3,0,10
8653,798118,5,2,2,0,0,2,2,0,0,0,0,0,0,0,0,0,6
8653,769332,8,1,5,1,1,0,4,0,0,0,2,0,0,0,1,0,2
8653,786398,4,0,1,0,1,0,0,0,0,0,0,0,2,0,0,0,0
8653,798126,5,0,0,0,0,0,0,1,2,0,1,3,0,0,0,0,1
8653,798124,16,2,2,2,2,0,0,0,0,0,2,1,1,0,2,0,4
8653,798121,11,0,2,0,1,0,1,0,0,0,1,0,1,0,0,0,0
8653,798120,4,0,1,0,0,0,1,0,0,0,0,1,0,1,0,0,0
8654,797047,17,1,1,1,1,0,0,0,2,1,0,0,1,0,0,1,2
8654,775515,15,1,6,0,0,1,6,2,2,0,2,0,3,0,1,1,5
8654,791579,34,6,10,4,6,2,4,1,1,0,2,4,3,1,0,0,15
8654,786387,39,5,11,5,11,0,0,2,2,1,0,0,1,1,3,0,12
8654,780399,31,2,8,0,4,2,4,0,1,1,2,5,1,1,4,0,6
8654,786846,27,4,10,2,4,2,6,4,5,0,10,2,3,0,4,1,14
8654,780400,14,1,2,1,2,0,0,0,0,1,0,1,1,1,0,0,2
8654,791575,4,0,1,0,1,0,0,0,0,0,0,0,1,0,0,0,0
8654,797046,19,3,7,0,1,3,6,0,0,0,0,0,2,3,1,0,9
8655,791883,32,6,7,6,7,0,0,3,6,2,5,1,2,4,2,2,15
8655,781066,26,7,10,7,10,0,0,0,0,2,1,1,2,0,7,0,14
8655,797594,20,2,4,2,3,0,1,0,1,0,6,1,1,1,1,0,4
8655,791884,34,3,14,1,9,2,5,2,2,0,2,3,2,0,2,0,10
8655,780695,28,8,11,5,6,3,5,2,3,0,7,1,3,1,0,0,21
8655,797600,3,0,0,0,0,0,0,0,0,0,0,1,1,0,1,0,0
8655,797598,8,2,2,2,2,0,0,2,2,0,2,0,1,0,1,2,6
8655,797596,23,1,3,1,2,0,1,1,2,1,2,2,2,2,2,0,3
8655,786496,26,0,0,0,0,0,0,4,4,0,5,2,1,3,2,0,4
8655,791885,0,0,0,0,0,0,0,0,0,0,0,0,0,0,0,0,0
8656,792246,32,6,14,6,14,0,0,1,2,3,3,0,1,0,2,3,13
8656,797925,23,1,6,0,3,1,3,0,0,0,2,2,2,0,1,0,3
8656,791701,17,1,3,1,3,0,0,1,2,2,3,2,1,1,2,0,3
8656,781420,34,8,15,5,6,3,9,2,4,2,11,2,3,0,5,1,21
8656,781405,31,5,13,4,7,1,6,1,3,0,3,2,5,1,5,0,12
8656,780615,7,0,0,0,0,0,0,0,0,0,1,0,2,0,1,0,0
8656,781624,32,2,7,1,4,1,3,0,0,1,9,0,2,1,2,2,5
8656,792245,24,0,2,0,0,0,2,0,0,0,2,1,4,0,1,0,0
8657,792288,26,3,5,3,5,0,0,0,2,4,4,1,3,1,1,0,6
8657,785227,24,2,5,2,5,0,0,0,0,2,4,2,5,0,3,2,4
8657,786237,31,3,9,3,9,0,0,1,1,0,7,0,1,2,0,0,7
8657,786232,25,4,10,4,9,0,1,4,6,0,1,3,2,4,1,0,12
8657,776309,32,8,14,8,13,0,1,3,8,0,4,1,1,2,1,0,19
8657,798072,3,0,0,0,0,0,0,0,0,0,0,0,0,0,0,0,0
8657,798067,14,0,1,0,1,0,0,0,0,0,3,0,1,0,1,1,0
8657,798084,7,0,1,0,0,0,1,0,0,0,1,0,1,0,0,0,0
8657,792278,11,1,3,0,1,1,2,2,2,0,0,0,0,0,3,0,5
8657,780287,27,4,13,3,10,1,3,2,3,0,5,1,1,1,2,0,11
8658,791524,28,5,5,3,3,2,2,4,4,1,5,1,0,1,1,3,16
8658,797139,24,8,11,8,11,0,0,0,1,3,7,1,0,2,0,1,16
8658,775394,22,2,8,2,5,0,3,0,0,1,7,3,0,0,2,0,4
8658,791526,22,4,5,2,2,2,3,2,2,0,4,4,3,1,3,0,12
8658,780272,25,2,8,0,2,2,6,1,2,0,3,8,0,2,3,0,7
8658,786354,6,0,1,0,1,0,0,0,0,0,0,0,2,0,0,0,0
8658,797141,4,2,3,2,2,0,1,0,0,1,0,0,0,0,0,0,4
8658,791523,17,2,7,0,2,2,5,2,2,1,4,4,2,1,1,0,8
8658,791525,4,1,1,0,0,1,1,0,0,0,0,1,0,0,0,0,3
8658,797137,4,0,2,0,2,0,0,0,0,1,0,0,0,0,0,1,0
8658,780273,20,2,4,0,2,2,2,0,0,0,3,0,1,1,0,0,6
8658,775592,24,9,16,3,8,6,8,1,2,2,6,1,2,2,0,0,25
8659,791839,6,1,2,1,2,0,0,0,0,1,0,0,0,0,0,0,2
8659,797444,25,5,8,2,4,3,4,4,7,3,3,0,1,1,0,0,17
8659,792381,28,5,15,3,7,2,8,0,0,0,2,1,2,1,0,0,12
8659,791842,27,6,17,3,6,3,11,1,3,1,5,0,1,0,3,0,16
8659,786616,27,1,7,1,5,0,2,0,0,1,2,5,2,1,3,0,2
8659,791840,8,0,1,0,1,0,0,0,0,1,0,0,0,0,0,0,0
8659,797443,12,1,2,1,2,0,0,1,2,0,3,0,1,0,1,1,3
8659,785322,22,1,4,0,0,1,4,0,0,0,2,1,2,0,1,1,3
8659,791841,4,0,3,0,1,0,2,0,0,1,0,0,0,0,1,0,0
8659,776341,16,0,2,0,1,0,1,0,0,0,4,1,1,0,0,1,0
8659,786736,25,1,4,1,1,0,3,0,0,0,3,3,0,1,3,0,2
8660,786424,26,6,15,6,15,0,0,10,13,4,9,1,4,0,5,2,22
8660,792366,29,5,8,5,8,0,0,4,8,1,2,0,4,0,3,0,14
8660,785483,32,2,8,1,3,1,5,4,4,1,8,2,3,1,3,0,9
8660,781454,27,3,9,2,8,1,1,1,2,7,7,1,4,0,5,0,8
8660,791015,15,2,4,2,2,0,2,1,1,0,0,3,2,1,1,0,5
8660,797979,25,3,6,2,3,1,3,2,2,0,0,1,0,0,1,0,9
8660,797988,25,2,5,2,4,0,1,1,2,0,2,8,2,1,2,0,5
8660,785959,13,1,1,1,1,0,0,1,4,1,3,1,2,0,1,1,3
8660,775335,7,1,1,0,0,1,1,0,0,0,1,1,0,1,0,0,3
8660,797991,1,0,0,0,0,0,0,0,0,0,0,0,0,0,0,0,0
8661,786691,35,6,19,5,14,1,5,2,4,5,9,3,3,0,1,0,15
8661,786693,35,4,10,2,7,2,3,2,2,1,3,0,3,0,0,0,12
8661,781329,35,2,11,2,7,0,4,2,7,2,4,8,5,7,4,0,6
8661,786656,9,2,4,2,4,0,0,2,2,1,1,0,5,0,2,0,6
8661,781408,12,2,3,2,2,0,1,0,0,1,1,0,3,1,1,0,4
8661,792219,18,7,9,7,9,0,0,5,6,6,6,0,3,1,0,1,19
8661,792046,28,3,16,3,9,0,7,2,2,0,1,1,2,0,0,0,8
8661,797876,12,2,4,2,4,0,0,0,0,1,0,0,4,2,1,0,4
8661,792221,8,0,0,0,0,0,0,0,0,1,0,0,2,1,1,0,0
8661,781455,8,0,1,0,0,0,1,0,0,0,0,1,0,1,1,0,0
8662,780258,33,5,11,1,3,4,8,3,4,0,1,2,2,0,3,0,17
8662,786067,37,3,7,3,7,0,0,5,7,0,8,3,2,0,2,1,11
8662,797660,30,3,6,1,2,2,4,3,6,1,5,2,1,1,2,0,11
8662,797662,21,4,6,4,6,0,0,3,5,3,3,1,4,1,1,0,11
8662,785591,32,2,9,2,7,0,2,1,3,0,5,2,2,0,2,0,5
8662,797661,20,2,6,1,4,1,2,0,0,0,4,0,1,2,3,0,5
8662,791952,19,0,1,0,1,0,0,0,0,0,3,1,3,0,2,0,0
8662,792082,8,0,2,0,1,0,1,0,0,1,3,0,0,0,2,1,0
8663,785665,29,4,8,1,1,3,7,3,4,2,3,0,1,0,1,0,14
8663,775651,25,5,10,5,9,0,1,0,1,0,6,3,2,2,1,0,10
8663,791627,31,2,7,0,2,2,5,1,2,0,4,5,2,2,1,0,7
8663,791070,24,2,6,1,2,1,4,1,2,0,1,0,4,4,0,0,6
8663,776178,21,1,5,1,3,0,2,1,4,1,3,1,3,1,2,0,3
8663,776253,20,4,7,0,1,4,6,0,1,0,5,0,2,1,2,0,12
8663,796502,12,4,6,3,3,1,3,1,2,1,2,0,2,0,1,0,10
8663,796501,18,2,4,0,1,2,3,1,2,2,1,3,1,0,1,0,7
8663,791071,11,0,0,0,0,0,0,0,2,0,0,0,2,0,1,1,0
8663,796504,5,0,1,0,0,0,1,0,0,0,0,1,1,0,0,0,0
8663,785660,2,0,0,0,0,0,0,0,0,0,0,0,1,0,0,0,0
8663,796505,2,0,0,0,0,0,0,0,0,0,0,0,0,0,0,0,0
8664,775897,16,1,3,1,1,0,2,0,0,1,1,1,0,0,2,0,2
8664,780324,26,5,7,5,7,0,0,1,1,1,5,2,0,1,3,4,11
8664,791543,33,3,9,1,4,2,5,0,0,1,2,1,2,2,2,0,8
8664,786530,31,3,5,0,0,3,5,4,4,0,2,2,1,3,0,1,13
8664,780317,31,1,7,1,2,0,5,0,1,0,3,1,0,1,1,0,2
8664,791545,23,5,10,5,8,0,2,6,6,3,2,2,0,1,1,1,16
8664,786360,12,0,3,0,0,0,3,0,0,1,2,0,0,2,1,0,0
8664,784246,15,1,4,1,2,0,2,2,2,1,2,1,4,2,2,1,4
8664,791546,8,0,3,0,0,0,3,0,0,0,4,0,1,0,0,0,0
8664,797092,5,2,2,2,2,0,0,0,0,0,0,1,1,0,1,0,4
8665,784640,24,3,6,3,5,0,1,0,0,1,0,1,2,0,0,2,6
8665,797655,33,2,10,2,10,0,0,0,2,0,5,5,1,1,1,0,4
8665,797657,35,6,6,1,1,5,5,0,0,3,5,2,1,1,1,0,17
8665,792072,34,3,6,0,1,3,5,0,0,0,3,1,2,0,1,0,9
8665,792069,33,5,13,1,5,4,8,0,0,0,3,2,3,1,8,0,14
8665,797652,27,1,5,1,4,0,1,0,0,0,6,1,2,1,3,0,2
8665,785572,12,0,2,0,2,0,0,0,0,0,0,0,1,1,1,0,0
8665,786025,2,0,0,0,0,0,0,0,0,0,1,0,0,0,0,0,0
8666,796455,26,2,4,2,4,0,0,2,3,5,5,0,5,0,0,1,6
8666,787175,26,6,14,0,2,6,12,1,1,0,1,2,4,1,1,0,19
8666,790909,40,4,12,1,2,3,10,1,3,1,5,4,1,2,2,0,12
8666,781393,40,10,23,4,8,6,15,6,7,1,4,4,2,3,3,0,32
8666,775351,40,3,11,3,11,0,0,4,4,4,2,5,3,1,3,0,10
8666,790907,3,0,0,0,0,0,0,0,0,0,0,0,0,0,0,2,0
8666,782126,25,1,4,1,4,0,0,0,0,3,3,0,2,0,1,0,2
8667,791316,26,7,12,7,12,0,0,0,0,2,5,1,4,0,1,4,14
8667,780870,30,2,5,2,5,0,0,6,6,3,8,0,2,0,1,2,10
8667,781079,26,1,7,1,4,0,3,0,0,1,4,5,1,1,3,0,2
8667,781443,36,4,9,3,6,1,3,5,6,0,3,7,2,2,2,0,14
8667,775822,34,2,8,0,2,2,6,2,2,0,5,4,3,1,0,0,8
8667,796625,5,0,1,0,1,0,0,0,0,0,0,0,0,0,1,1,0
8667,796621,27,8,12,2,3,6,9,6,7,1,3,1,1,1,3,0,28
8667,791314,8,2,2,1,1,1,1,0,0,0,0,1,1,1,3,0,5
8667,785380,4,1,3,0,1,1,2,0,0,0,0,1,0,0,0,0,3
8667,796626,4,0,0,0,0,0,0,0,0,0,0,0,0,0,0,0,0
8668,797325,33,3,5,3,5,0,0,1,4,5,5,1,5,0,1,1,7
8668,797329,29,5,12,2,2,3,10,1,1,2,1,0,4,0,0,0,14
8668,797327,30,2,6,1,4,1,2,5,8,2,0,1,3,2,1,2,10
8668,797323,38,3,13,2,9,1,4,10,11,0,5,7,1,1,3,0,17
8668,786236,39,6,16,5,10,1,6,0,0,1,3,1,3,1,4,2,13
8668,781002,6,0,0,0,0,0,0,0,0,0,1,0,0,0,0,0,0
8668,776478,1,0,1,0,0,0,1,0,0,0,0,0,0,0,0,0,0
8668,797322,4,1,1,1,1,0,0,0,0,0,1,0,2,0,0,0,2
8668,786233,20,0,2,0,0,0,2,0,1,1,3,0,1,1,0,0,0
8668,797324,0,0,0,0,0,0,0,0,0,0,0,0,0,0,0,0,0
8669,776279,6,0,3,0,1,0,2,0,0,0,1,0,0,0,1,0,0
8669,781505,32,8,13,5,6,3,7,5,7,1,1,3,4,0,2,1,24
8669,780353,28,6,6,6,6,0,0,3,5,4,8,0,4,0,1,1,15
8669,791317,33,2,14,1,10,1,4,0,0,0,3,5,4,1,5,0,5
8669,777573,19,1,7,1,4,0,3,0,0,0,3,1,2,0,0,0,2
8669,786222,15,2,3,2,3,0,0,1,2,1,2,0,2,0,2,0,5
8669,785966,1,0,0,0,0,0,0,0,0,0,0,0,0,0,1,0,0
8669,796646,30,2,2,0,0,2,2,0,0,1,2,2,1,0,3,0,6
8669,796647,12,0,2,0,0,0,2,0,0,0,2,2,1,1,1,0,0
8669,796649,17,0,3,0,1,0,2,0,0,1,4,0,1,0,0,0,0
8669,790851,7,0,2,0,1,0,1,0,0,0,1,0,3,0,2,0,0
8670,776344,36,7,14,6,13,1,1,2,3,0,4,3,1,2,0,1,17
8670,775821,26,6,9,6,7,0,2,2,2,2,1,0,0,1,1,0,14
8670,792453,29,4,10,4,8,0,2,5,6,0,4,3,2,0,0,0,13
8670,785131,23,2,4,1,1,1,3,0,0,0,2,1,4,0,1,1,5
8670,781538,33,1,3,0,1,1,2,0,0,1,2,2,1,1,1,0,3
8670,798113,13,3,5,3,4,0,1,1,1,2,2,0,2,1,0,2,7
8670,785152,4,0,1,0,1,0,0,0,0,0,0,0,1,0,1,0,0
8670,798115,16,0,3,0,2,0,1,0,0,0,1,1,2,0,1,0,0
8670,776233,20,4,6,3,4,1,2,0,0,1,2,0,3,0,0,0,9
8671,786704,29,9,12,9,12,0,0,3,5,2,6,0,3,1,2,0,21
8671,785395,31,4,10,1,3,3,7,0,0,2,4,2,1,0,2,2,11
8671,775840,32,4,8,3,4,1,4,4,4,0,4,2,3,0,1,0,13
8671,775955,39,6,14,6,13,0,1,3,4,1,2,7,0,0,2,0,15
8671,775811,18,1,1,1,1,0,0,0,1,1,1,2,2,0,1,0,2
8671,786706,11,1,1,1,1,0,0,0,0,1,0,0,2,0,1,0,2
8671,786703,8,0,1,0,0,0,1,0,0,0,0,0,0,0,0,0,0
8671,775287,10,0,1,0,0,0,1,0,0,0,0,1,2,0,0,0,0
8671,786702,22,3,5,2,2,1,3,1,2,0,4,0,2,1,0,0,8
8672,791760,23,2,4,2,4,0,0,5,7,0,2,0,0,1,0,1,9
8672,780256,14,1,3,1,2,0,1,1,2,1,3,1,4,0,1,0,3
8672,796879,19,2,4,1,2,1,2,1,1,1,4,2,0,0,1,0,6
8672,796880,28,1,4,1,1,0,3,0,0,2,1,0,2,0,4,1,2
8672,791334,27,5,10,3,5,2,5,4,7,1,1,1,1,0,2,0,16
8672,785874,20,3,4,3,4,0,0,4,5,0,5,1,4,1,3,1,10
8672,796885,3,0,0,0,0,0,0,0,0,0,0,2,0,1,2,0,0
8672,796883,21,6,9,5,7,1,2,0,0,1,0,3,1,2,1,0,13
8672,791757,21,3,6,2,2,1,4,0,0,0,1,1,0,2,0,0,7
8672,781590,24,5,8,3,5,2,3,0,1,3,4,0,5,0,1,0,12
8673,774812,15,4,5,4,5,0,0,1,2,3,1,0,4,1,3,2,9
8673,797180,33,5,8,3,4,2,4,0,0,0,2,1,2,0,2,1,12
8673,791497,36,9,16,5,7,4,9,1,1,1,8,1,3,4,3,0,23
8673,781486,37,2,7,2,6,0,1,7,8,0,1,2,3,1,4,0,11
8673,780461,28,8,12,7,9,1,3,0,1,1,1,4,3,2,1,0,17
8673,791500,14,0,1,0,1,0,0,0,0,0,0,0,4,0,0,0,0
8673,791498,8,0,1,0,1,0,0,0,0,0,1,0,1,0,0,0,0
8673,791503,5,0,0,0,0,0,0,0,0,0,1,0,0,0,0,0,0
8673,791502,4,0,0,0,0,0,0,0,0,0,0,1,0,0,1,0,0
8673,780240,20,0,1,0,0,0,1,4,8,0,4,1,1,0,1,0,4
8684,796699,30,4,8,2,3,2,5,0,0,2,3,0,0,0,2,3,10
8684,790983,27,2,5,1,2,1,3,8,10,0,2,0,1,1,2,0,13
8684,790978,33,5,17,3,7,2,10,3,6,1,5,0,2,2,0,1,15
8684,790979,36,7,14,5,9,2,5,7,11,2,5,3,2,1,2,0,23
8684,788820,31,3,5,1,2,2,3,6,8,0,3,3,4,2,1,0,14
8684,796701,12,1,1,1,1,0,0,0,0,2,0,1,3,1,2,0,2
8684,790976,8,0,4,0,4,0,0,0,0,5,2,1,2,0,1,0,0
8684,796698,17,0,1,0,1,0,0,0,0,1,1,1,1,1,1,0,0
8684,790980,2,0,0,0,0,0,0,0,2,1,0,0,0,0,0,0,0
8684,789457,2,0,0,0,0,0,0,0,0,0,1,0,1,0,0,0,0
8684,790977,2,0,0,0,0,0,0,0,0,0,0,0,0,0,0,0,0
8685,775954,19,2,4,2,4,0,0,0,0,1,3,0,2,0,4,1,4
8685,796464,37,9,17,8,14,1,3,4,4,3,0,1,4,1,0,0,23
8685,796459,31,6,14,3,10,3,4,5,6,3,2,6,2,2,3,1,20
8685,781157,28,3,8,0,0,3,8,0,0,0,1,2,5,0,0,0,9
8685,781006,32,4,8,2,4,2,4,0,0,2,6,1,2,0,2,1,10
8685,796194,26,2,6,0,1,2,5,0,0,0,1,2,3,1,0,0,6
8685,790918,4,0,0,0,0,0,0,0,0,1,0,0,1,0,0,1,0
8685,790917,19,0,5,0,1,0,4,0,0,1,4,2,1,2,2,1,0
8685,790916,3,0,0,0,0,0,0,0,0,0,2,0,2,0,1,0,0
8685,780648,1,0,1,0,1,0,0,0,0,0,0,0,1,0,0,0,0
8686,796617,10,2,2,2,2,0,0,0,0,0,1,0,1,0,0,0,4
8686,775131,32,3,4,2,3,1,1,2,4,0,3,5,5,1,2,1,9
8686,796616,30,5,13,4,6,1,7,5,6,0,3,1,4,2,2,1,16
8686,796612,36,7,10,7,10,0,0,3,6,1,1,4,2,0,1,0,17
8686,785562,34,6,13,5,9,1,4,7,8,2,2,1,0,4,1,1,20
8686,792429,5,0,1,0,1,0,0,0,0,0,0,0,0,0,0,0,0
8686,796614,3,1,1,1,1,0,0,0,0,0,1,0,0,0,0,0,2
8686,796607,22,4,5,4,5,0,0,0,0,1,2,0,1,0,3,0,8
8686,796606,28,1,3,1,3,0,0,0,0,0,1,1,3,1,1,0,2
8687,791482,35,4,6,2,3,2,3,0,0,0,7,9,2,0,4,0,10
8687,786319,12,2,2,2,2,0,0,0,0,2,0,1,1,0,0,0,4
8687,786318,37,12,18,4,7,8,11,2,3,0,3,0,2,0,3,0,34
8687,784268,33,7,12,4,9,3,3,2,2,0,0,2,2,1,2,0,19
8687,780223,30,4,6,2,2,2,4,2,2,0,4,4,4,0,1,0,12
8687,791481,22,5,7,5,7,0,0,1,2,3,5,0,2,1,1,2,11
8687,780225,20,1,4,1,1,0,3,0,0,0,0,6,2,0,0,0,2
8687,797200,2,0,1,0,0,0,1,0,0,0,0,0,0,0,1,0,0
8687,797199,9,0,0,0,0,0,0,2,2,0,0,1,2,0,1,0,2
8688,791194,17,0,3,0,3,0,0,0,0,0,3,0,1,0,4,1,0
8688,780384,26,1,4,1,4,0,0,2,2,4,1,0,2,0,1,0,4
8688,780159,20,2,5,2,5,0,0,0,0,0,4,2,1,0,1,1,4
8688,796863,23,2,5,1,3,1,2,0,0,0,1,3,0,2,1,0,5
8688,774827,37,9,19,5,12,4,7,0,1,0,2,4,1,1,2,0,22
8688,775694,27,2,8,1,5,1,3,6,6,0,1,2,4,2,1,0,11
8688,800119,18,4,5,4,4,0,1,0,0,0,2,0,3,0,2,0,8
8688,791193,14,1,3,1,3,0,0,1,1,1,3,1,1,0,0,0,3
8688,796865,18,1,5,0,0,1,5,0,0,1,1,0,4,1,1,0,3
8689,786857,33,5,9,3,4,2,5,7,8,6,4,3,2,2,1,1,19
8689,781403,30,3,8,0,3,3,5,5,5,0,6,1,2,1,2,2,14
8689,792654,24,3,9,3,9,0,0,1,1,2,5,0,4,0,3,2,7
8689,797301,38,5,13,5,11,0,2,4,5,0,1,5,1,1,4,1,14
8689,780524,34,2,7,0,2,2,5,0,0,1,3,3,0,2,4,0,6
8689,792653,14,0,1,0,1,0,0,2,2,1,1,0,4,0,1,2,2
8689,797303,11,0,1,0,1,0,0,0,0,0,2,0,1,0,1,1,0
8689,797302,11,2,2,2,2,0,0,0,0,0,1,0,1,0,1,0,4
8689,797306,2,0,0,0,0,0,0,0,0,1,1,0,0,0,1,0,0
8689,797304,3,1,1,1,1,0,0,0,0,0,0,0,0,0,0,0,2
8690,791606,40,5,12,4,8,1,4,0,0,0,3,0,4,2,0,0,11
8690,786410,29,1,4,0,2,1,2,3,4,2,2,0,3,1,2,0,6
8690,775095,11,3,5,3,5,0,0,1,4,1,3,0,2,1,0,0,7
8690,786406,22,0,2,0,0,0,2,0,0,2,1,3,4,1,1,0,0
8690,780414,35,8,17,8,15,0,2,7,11,1,0,3,3,1,3,0,23
8690,797020,6,0,1,0,1,0,0,0,0,0,2,0,0,0,1,0,0
8690,792392,9,0,1,0,1,0,0,0,0,0,1,1,3,0,1,0,0
8690,797021,18,1,3,1,3,0,0,0,1,0,1,1,0,1,2,0,2
8690,791605,24,6,11,3,4,3,7,0,0,1,1,0,1,2,3,0,15
8690,791603,6,0,0,0,0,0,0,0,0,0,1,1,2,0,2,0,0
8691,792171,34,3,9,3,7,0,2,2,2,6,7,1,2,0,1,6,8
8691,780049,13,0,0,0,0,0,0,1,4,1,0,0,4,0,2,0,1
8691,797784,38,7,14,1,7,6,7,2,2,1,1,1,4,3,3,0,22
8691,789059,36,5,8,4,5,1,3,1,3,1,5,1,2,0,4,0,12
8691,780980,18,0,1,0,0,0,1,0,0,0,2,2,2,1,2,0,0
8691,797783,4,1,1,1,1,0,0,0,0,0,2,0,0,0,0,0,2
8691,785674,28,4,11,3,6,1,5,6,6,2,4,0,4,1,7,0,15
8691,792174,15,0,2,0,0,0,2,2,2,0,0,0,3,0,0,0,2
8691,792173,14,0,3,0,1,0,2,0,0,0,0,0,0,0,0,0,0
8692,792140,25,7,8,7,8,0,0,0,0,2,8,2,2,0,3,1,14
8692,786596,31,6,14,3,8,3,6,1,2,0,4,7,1,3,2,1,16
8692,781431,10,2,4,2,2,0,2,0,0,0,1,0,0,0,0,0,4
8692,781429,35,5,8,1,2,4,6,0,0,0,1,0,1,1,1,0,14
8692,776092,23,5,7,4,6,1,1,1,1,0,5,9,3,2,5,0,12
8692,797791,4,1,1,1,1,0,0,0,0,0,1,0,1,0,0,0,2
8692,792146,2,0,0,0,0,0,0,0,0,0,1,0,0,0,0,0,0
8692,797793,2,1,2,0,0,1,2,0,0,0,0,0,0,0,0,0,3
8692,797797,4,0,0,0,0,0,0,0,0,0,0,1,0,0,0,0,0
8692,797786,22,1,3,0,0,1,3,0,0,1,2,3,2,0,1,0,3
8692,792144,15,2,3,2,2,0,1,0,0,0,1,1,1,0,1,1,4
8692,797789,2,0,1,0,1,0,0,0,0,0,0,0,0,0,1,0,0
8692,785976,23,5,7,2,2,3,5,0,0,0,0,0,2,0,0,1,13
8692,785975,2,0,0,0,0,0,0,0,0,0,0,0,0,0,0,0,0
8693,791616,22,5,6,5,6,0,0,1,1,0,4,1,0,0,2,2,11
8693,780797,13,1,5,1,4,0,1,2,2,0,2,0,3,0,1,1,4
8693,785505,24,6,11,5,8,1,3,3,3,0,3,3,1,3,4,0,16
8693,780555,27,1,3,1,3,0,0,0,0,0,1,1,1,2,2,0,2
8693,775604,30,1,6,0,1,1,5,0,0,0,4,1,2,1,2,0,3
8693,796985,4,0,0,0,0,0,0,0,0,0,0,0,1,1,1,0,0
8693,786429,10,0,0,0,0,0,0,2,2,1,1,0,0,1,0,0,2
8693,796983,6,4,6,4,6,0,0,0,0,0,1,0,0,0,1,0,8
8693,786430,7,2,2,2,2,0,0,0,0,0,1,1,0,0,1,0,4
8693,796986,12,1,4,1,2,0,2,0,0,0,2,0,0,1,0,0,2
8693,796981,17,0,4,0,3,0,1,0,0,1,0,1,0,0,0,0,0
8693,791617,10,1,1,0,0,1,1,0,0,0,0,3,1,0,0,0,3
8693,791618,14,1,5,1,4,0,1,1,1,1,0,1,1,2,1,0,3
8693,780432,4,1,3,0,1,1,2,0,0,0,1,0,0,0,0,0,3
8694,776209,35,6,11,4,8,2,3,1,3,3,7,3,3,4,1,1,15
8694,796938,27,4,7,1,1,3,6,3,3,1,2,4,3,0,1,0,14
8694,791240,29,2,4,2,4,0,0,2,2,2,2,2,1,2,2,0,6
8694,791237,28,8,11,4,5,4,6,0,0,1,4,2,0,0,0,0,20
8694,791238,32,7,12,5,10,2,2,6,6,0,3,4,2,3,1,1,22
8694,788124,5,0,0,0,0,0,0,0,0,0,1,0,1,0,0,2,0
8694,781227,11,2,5,1,3,1,2,2,2,2,1,0,1,0,1,0,7
8694,796939,4,1,2,1,2,0,0,1,2,0,1,0,1,0,2,0,3
8694,791235,7,0,2,0,2,0,0,0,0,0,2,0,0,0,0,0,0
8694,791236,22,1,7,1,5,0,2,2,2,2,2,0,2,0,1,0,4
8695,797573,15,1,4,1,4,0,0,2,2,1,2,0,1,0,1,0,4
8695,791903,13,0,3,0,2,0,1,0,0,1,2,0,3,0,1,0,0
8695,791899,37,7,16,7,15,0,1,6,7,2,1,3,3,2,2,0,20
8695,786512,37,7,14,3,5,4,9,0,0,0,3,3,5,2,2,1,18
8695,786435,21,1,4,1,3,0,1,1,2,0,3,0,1,0,2,0,3
8695,797574,29,4,6,2,2,2,4,0,0,2,1,0,1,0,2,1,10
8695,791900,18,1,8,1,7,0,1,0,1,1,3,0,2,0,0,0,2
8695,800197,1,0,0,0,0,0,0,0,0,0,0,0,1,0,0,0,0
8695,797571,29,0,2,0,0,0,2,0,0,1,2,5,1,1,5,0,0
8696,786509,34,4,8,4,8,0,0,2,6,4,9,1,2,0,3,0,10
8696,786508,20,3,9,2,4,1,5,0,0,0,4,1,5,1,2,0,7
8696,791897,16,0,2,0,2,0,0,0,0,2,0,1,3,0,1,0,0
8696,785796,36,7,20,2,12,5,8,4,5,0,4,1,2,0,1,0,23
8696,797576,35,4,12,1,4,3,8,3,3,0,2,5,4,0,2,0,14
8696,797579,21,1,2,1,1,0,1,0,0,1,3,1,1,0,2,0,2
8696,797577,6,0,0,0,0,0,0,0,0,0,1,0,1,0,0,0,0
8696,791896,1,0,1,0,0,0,1,0,0,0,0,0,0,0,0,0,0
8696,786507,8,0,1,0,1,0,0,0,0,0,1,0,1,0,1,0,0
8696,781325,23,3,8,0,1,3,7,0,0,1,1,1,3,0,0,0,9
8697,790784,30,5,9,3,5,2,4,2,2,0,6,0,1,0,0,1,14
8697,786235,22,3,5,3,5,0,0,1,3,0,1,0,1,1,0,1,7
8697,797475,27,2,3,2,2,0,1,3,6,1,5,0,3,1,2,0,7
8697,786229,22,1,5,1,3,0,2,2,2,0,1,0,1,1,0,0,4
8697,775229,34,6,9,6,9,0,0,7,13,0,2,6,3,2,2,0,19
8697,776219,17,3,7,3,4,0,3,1,2,0,2,0,3,0,2,0,7
8697,786581,18,3,5,3,4,0,1,1,2,1,3,0,0,1,0,0,7
8697,786770,20,2,7,1,5,1,2,0,0,0,4,1,1,0,1,0,5
8697,781518,10,1,1,0,0,1,1,0,0,0,1,0,0,0,0,0,3
8698,785536,6,0,0,0,0,0,0,0,0,0,1,0,0,0,0,1,0
8698,780119,38,8,12,7,10,1,2,2,2,3,7,1,2,1,2,1,19
8698,796558,38,7,12,7,10,0,2,1,2,0,5,6,3,1,0,0,15
8698,796559,36,3,14,2,9,1,5,11,14,3,5,5,1,0,1,0,18
8698,776097,12,0,2,0,1,0,1,2,2,0,6,2,4,0,1,0,2
8698,796560,30,3,5,2,3,1,2,1,2,0,6,2,3,2,1,4,8
8698,785280,6,1,2,0,0,1,2,0,0,0,0,0,0,1,1,0,3
8698,780149,32,5,15,3,9,2,6,6,9,2,4,1,2,2,2,0,18
8698,775679,2,0,0,0,0,0,0,0,0,0,0,0,0,0,0,0,0
8699,791522,38,6,15,4,13,2,2,2,3,1,6,2,3,0,2,1,16
8699,786351,18,0,8,0,0,0,8,0,0,0,2,2,4,0,0,0,0
8699,786348,24,2,9,0,2,2,7,0,0,1,2,1,1,0,1,0,6
8699,797146,39,11,19,10,14,1,5,2,4,1,6,1,1,0,1,1,25
8699,797143,37,6,14,3,11,3,3,0,1,1,4,4,3,0,2,0,15
8699,797142,12,3,3,2,2,1,1,1,2,1,1,0,3,0,1,1,8
8699,785816,22,1,3,1,3,0,0,1,2,4,6,3,4,2,0,1,3
8699,797147,7,1,4,1,2,0,2,0,0,0,0,0,3,0,0,0,2
8699,797144,3,0,1,0,1,0,0,0,0,1,0,0,0,0,1,0,0
8700,782638,2,0,1,0,0,0,1,0,0,0,1,0,0,0,0,0,0
8700,780271,33,4,8,4,5,0,3,1,3,2,6,1,3,2,0,0,9
8700,790772,38,6,11,5,9,1,2,6,9,0,1,2,2,0,1,0,19
8700,796328,36,5,12,5,12,0,0,9,11,2,4,2,2,1,2,0,19
8700,782637,2,1,1,0,0,1,1,0,0,0,0,0,0,1,0,0,3
8700,780022,26,6,11,2,5,4,6,0,0,0,2,6,4,2,0,0,16
8700,780218,18,2,3,2,3,0,0,1,1,3,4,1,3,0,0,0,5
8700,790774,22,1,3,0,1,1,2,2,2,0,1,0,0,1,0,0,5
8700,767736,21,6,9,4,5,2,4,4,6,0,4,1,3,1,1,0,18
8700,792438,2,0,0,0,0,0,0,0,0,0,0,0,0,0,0,0,0
8701,785423,29,4,8,4,6,0,2,2,2,3,6,0,4,1,2,0,10
8701,775676,22,5,6,5,6,0,0,2,2,0,4,2,2,0,1,2,12
8701,786298,24,3,8,3,4,0,4,1,1,1,3,4,4,0,3,0,7
8701,785422,39,12,19,9,12,3,7,1,3,2,3,7,4,0,1,0,28
8701,774957,20,1,3,0,1,1,2,0,0,0,3,1,4,1,2,0,3
8701,786210,32,7,9,5,6,2,3,1,2,0,1,2,2,0,1,0,17
8701,785425,34,6,12,5,7,1,5,0,0,1,5,1,4,0,1,1,13
8702,785509,22,1,8,1,2,0,6,3,4,1,0,0,1,0,3,1,5
8702,791424,19,3,9,2,7,1,2,3,6,1,2,1,4,0,1,0,10
8702,797085,37,5,10,2,5,3,5,5,6,0,6,5,2,2,1,0,18
8702,791421,33,2,4,2,4,0,0,0,2,0,1,0,3,1,1,0,4
8702,785899,28,0,2,0,2,0,0,0,2,1,0,0,4,3,2,0,0
8702,797079,3,0,0,0,0,0,0,1,2,0,1,0,1,0,2,0,1
8702,791425,23,2,7,2,7,0,0,2,4,1,8,1,3,0,5,2,6
8702,797086,1,0,0,0,0,0,0,0,0,0,0,0,0,0,0,0,0
8702,797090,13,2,3,2,3,0,0,1,1,0,2,0,1,0,1,0,5
8702,797088,21,3,5,0,0,3,5,0,0,1,2,0,1,0,0,0,9
8703,797281,18,0,3,0,2,0,1,0,0,0,3,0,3,0,3,0,0
8703,791648,26,2,6,2,3,0,3,1,2,1,6,0,4,3,2,0,5
8703,785694,25,5,6,5,6,0,0,5,6,4,2,0,5,1,1,0,15
8703,797280,29,1,7,1,7,0,0,4,6,0,4,4,3,0,4,0,6
8703,797279,37,5,11,2,7,3,4,5,5,0,3,0,4,0,2,1,18
8703,797278,3,0,0,0,0,0,0,0,0,1,1,0,1,1,2,0,0
8703,791649,24,2,6,1,2,1,4,3,4,0,3,1,3,0,0,0,8
8703,786640,24,2,6,1,2,1,4,0,0,0,0,3,0,0,2,0,5
8703,785697,14,0,0,0,0,0,0,2,2,0,3,0,0,0,2,0,2
8704,792417,33,5,10,5,9,0,1,1,2,4,3,2,4,0,1,0,11
8704,786861,38,5,12,4,7,1,5,0,0,3,1,5,4,0,2,0,11
8704,786867,35,2,11,1,4,1,7,0,0,2,6,3,1,0,0,0,5
8704,780387,35,10,15,7,11,3,4,6,7,2,13,2,0,1,1,1,29
8704,767033,29,3,7,0,1,3,6,0,0,0,1,5,3,1,4,0,9
8704,796869,1,0,0,0,0,0,0,0,0,0,0,0,0,0,0,0,0
8704,785801,1,0,0,0,0,0,0,0,0,0,1,0,0,0,0,0,0
8704,796867,3,0,2,0,1,0,1,0,0,0,0,0,1,0,0,0,0
8704,796868,1,0,0,0,0,0,0,0,0,0,0,0,0,0,0,0,0
8704,792416,18,3,4,2,3,1,1,0,0,0,1,1,2,0,3,0,7
8704,786866,5,1,1,0,0,1,1,2,2,0,1,0,0,0,0,0,5
8704,786865,1,0,0,0,0,0,0,0,0,0,0,0,1,0,0,0,0
8705,790998,26,3,5,3,3,0,2,0,0,1,5,1,4,0,1,0,6
8705,766874,23,4,4,4,4,0,0,1,3,2,3,2,2,1,1,1,9
8705,790997,37,4,10,3,7,1,3,6,6,2,1,2,1,0,2,1,15
8705,790996,26,1,6,0,3,1,3,0,0,0,4,1,1,0,1,0,3
8705,785621,37,5,18,2,4,3,14,1,1,1,1,1,2,3,3,0,14
8705,796631,17,1,7,1,2,0,5,0,1,3,3,1,2,0,0,0,2
8705,790995,30,5,14,4,8,1,6,0,0,3,4,2,4,0,1,0,11
8705,786375,4,0,3,0,1,0,2,0,0,0,0,0,1,0,0,0,0
8706,780338,29,2,4,2,4,0,0,1,2,3,6,1,4,1,3,0,5
8706,791030,37,3,8,3,6,0,2,4,6,1,3,6,3,0,3,1,10
8706,785477,36,3,14,3,8,0,6,1,1,0,5,1,1,1,2,0,7
8706,785475,27,4,6,1,1,3,5,2,2,0,1,0,4,0,2,1,13
8706,780344,4,0,0,0,0,0,0,0,0,0,0,0,0,1,0,0,0
8706,791032,11,2,4,1,1,1,3,2,2,1,1,0,3,1,1,0,7
8706,796688,6,0,0,0,0,0,0,0,0,0,1,1,1,0,0,0,0
8706,796687,30,7,13,5,10,2,3,5,8,0,3,1,3,1,2,0,21
8706,786655,20,2,5,0,1,2,4,2,2,0,4,1,2,0,0,1,8
8707,790957,30,1,3,0,1,1,2,3,4,3,9,2,1,3,2,0,6
8707,785275,22,3,4,3,4,0,0,0,0,1,0,3,2,1,3,1,6
8707,790956,17,4,6,3,4,1,2,1,2,0,1,1,2,0,2,0,10
8707,785089,31,5,8,3,4,2,4,5,5,0,3,0,3,0,1,0,17
8707,780460,37,4,18,1,8,3,10,8,9,0,2,8,2,0,2,0,19
8707,796550,19,2,6,0,1,2,5,0,2,0,5,1,4,1,1,1,6
8707,796549,4,1,3,1,3,0,0,0,0,1,1,0,2,1,0,0,2
8707,796551,20,5,6,4,5,1,1,1,2,3,1,0,1,1,0,2,12
8707,796547,4,0,0,0,0,0,0,0,0,0,0,0,0,0,0,0,0
8707,796552,16,0,1,0,1,0,0,0,0,0,2,2,1,0,1,0,0
8708,796334,28,5,11,5,10,0,1,6,7,6,9,3,2,0,2,2,16
8708,779975,4,0,0,0,0,0,0,0,0,0,1,0,0,0,0,0,0
8708,796330,34,3,7,1,2,2,5,2,2,4,9,2,3,0,1,0,10
8708,785813,38,7,17,2,9,5,8,7,8,0,3,7,2,2,2,0,26
8708,796337,24,1,11,1,5,0,6,0,0,0,1,1,1,1,1,0,2
8708,796336,23,1,5,0,1,1,4,0,0,0,1,0,2,0,2,0,3
8708,796332,24,1,5,1,2,0,3,3,4,1,2,0,3,2,0,0,5
8708,785827,8,0,1,0,1,0,0,2,2,0,2,0,2,0,0,0,2
8708,790776,17,5,6,5,5,0,1,1,1,1,0,1,2,1,1,1,11
8709,786772,17,0,0,0,0,0,0,0,0,0,1,0,5,0,0,1,0
8709,781484,30,6,8,1,1,5,7,1,3,0,1,1,5,1,2,1,18
8709,786769,34,3,9,3,6,0,3,5,6,1,6,2,2,0,4,1,11
8709,786024,36,5,11,4,5,1,6,1,2,0,8,4,3,1,0,0,12
8709,780002,35,4,9,4,7,0,2,9,9,0,2,2,3,1,4,0,17
8709,791967,29,6,13,6,9,0,4,1,2,1,5,2,1,0,2,0,13
8709,786773,10,1,1,1,1,0,0,1,2,0,1,0,3,1,0,0,3
8709,790823,9,0,0,0,0,0,0,0,0,0,1,0,0,0,1,0,0
8710,780023,29,5,6,5,6,0,0,1,1,0,6,1,4,0,2,6,11
8710,792493,28,1,3,0,1,1,2,0,0,0,1,1,2,0,0,0,3
8710,792495,36,5,8,3,4,2,4,7,9,0,6,3,4,3,5,0,19
8710,792491,40,5,8,5,7,0,1,7,9,2,1,5,3,0,4,1,17
8710,781144,32,2,6,0,2,2,4,0,0,0,3,0,0,0,2,0,6
8710,798959,4,0,1,0,0,0,1,0,0,0,3,0,0,0,0,0,0
8710,788128,4,0,1,0,0,0,1,0,0,0,1,1,0,0,0,0,0
8710,786832,27,4,7,2,3,2,4,1,2,0,2,1,3,2,1,0,11
8711,797466,24,4,6,4,6,0,0,3,3,4,0,0,3,2,2,0,11
8711,791858,40,7,8,4,4,3,4,5,6,3,1,1,2,1,1,0,22
8711,797463,39,4,16,2,7,2,9,3,5,0,5,3,3,2,4,2,13
8711,791109,32,7,14,6,12,1,2,2,3,0,8,1,4,0,0,0,17
8711,785625,25,0,9,0,5,0,4,0,0,2,3,1,2,1,0,0,0
8711,797464,16,0,3,0,2,0,1,0,0,0,0,0,2,3,2,0,0
8711,797469,3,0,0,0,0,0,0,0,0,0,0,0,1,0,0,0,0
8711,797465,6,0,0,0,0,0,0,0,0,0,0,0,0,0,0,0,0
8711,791854,15,1,3,1,2,0,1,0,0,1,2,1,0,0,0,0,2
8712,796812,15,2,6,2,6,0,0,0,0,1,6,0,4,0,0,0,4
8712,780952,16,2,3,2,3,0,0,0,0,1,1,1,4,1,1,1,4
8712,791155,31,9,15,9,11,0,4,6,6,1,1,1,2,2,2,0,24
8712,786609,23,3,7,3,5,0,2,0,0,3,5,0,5,0,1,1,6
8712,796810,34,9,14,6,8,3,6,0,1,1,2,3,1,0,2,0,21
8712,780945,12,0,1,0,1,0,0,0,0,0,0,0,2,0,0,0,0
8712,791156,17,2,6,2,4,0,2,0,0,0,0,4,1,1,0,0,4
8712,780950,21,3,7,0,1,3,6,0,0,0,2,1,0,0,0,1,9
8712,796814,28,3,5,3,4,0,1,2,2,1,7,2,3,1,1,0,8
8712,791154,3,0,0,0,0,0,0,0,0,0,1,0,1,0,0,0,0
8713,797050,31,5,10,4,8,1,2,7,9,3,5,0,1,0,2,1,18
8713,780394,30,2,6,1,4,1,2,0,1,2,5,0,2,0,1,0,5
8713,780391,25,3,5,3,5,0,0,0,0,0,1,0,1,0,2,0,6
8713,790871,21,0,9,0,4,0,5,2,4,3,1,3,1,1,3,0,2
8713,780392,25,2,4,0,1,2,3,0,0,0,1,1,3,0,1,0,6
8713,797048,21,5,9,5,8,0,1,4,5,1,1,0,3,1,2,1,14
8713,776473,25,1,3,1,3,0,0,0,0,1,3,3,4,1,3,0,2
8713,785783,10,1,5,1,3,0,2,0,0,0,1,0,0,0,0,0,2
8713,791573,12,3,5,3,4,0,1,1,2,0,0,1,0,0,0,0,7
8714,790877,13,0,3,0,2,0,1,0,0,3,0,0,0,0,2,0,0
8714,779985,23,3,6,2,4,1,2,1,2,1,4,0,4,0,1,1,8
8714,790876,40,9,13,6,7,3,6,2,2,0,4,2,3,0,1,0,23
8714,781062,36,4,8,1,2,3,6,3,3,0,4,1,2,0,0,0,14
8714,774987,45,7,18,6,16,1,2,7,9,0,6,8,3,2,5,1,22
8714,785432,17,5,6,5,6,0,0,0,0,2,2,1,1,0,1,0,10
8714,785699,32,4,8,2,4,2,4,0,1,0,1,4,3,5,3,1,10
8714,790882,15,1,4,1,2,0,2,1,1,1,0,1,2,1,1,0,3
8714,790879,4,0,1,0,1,0,0,0,2,0,0,0,0,0,1,0,0
8715,791635,35,4,10,0,0,4,10,3,4,0,1,2,3,0,2,0,15
8715,796438,40,4,6,3,4,1,2,2,2,2,3,3,3,3,3,0,11
8715,790883,42,6,13,5,10,1,3,2,2,1,5,3,4,2,3,0,15
8715,796436,44,12,21,9,13,3,8,13,14,1,10,1,1,3,6,2,40
8715,796439,32,3,7,3,7,0,0,1,2,4,8,0,1,1,2,0,7
8715,790884,22,2,6,2,6,0,0,2,2,3,1,0,2,1,2,2,6
8715,790885,5,0,0,0,0,0,0,0,0,0,1,0,0,0,2,0,0
8715,781262,3,0,1,0,0,0,1,0,0,1,0,0,0,0,0,0,0
8715,796442,2,0,0,0,0,0,0,0,0,0,1,0,1,0,0,0,0
8716,796585,11,2,2,2,2,0,0,0,0,0,1,1,2,1,2,0,4
8716,780192,35,7,11,5,5,2,6,1,2,0,5,3,2,1,2,0,17
8716,798139,30,4,9,2,6,2,3,0,0,0,4,2,2,1,1,0,10
8716,786818,32,6,14,5,13,1,1,2,4,3,2,3,1,1,2,0,15
8716,780182,34,3,13,0,4,3,9,0,0,0,3,3,4,0,2,0,9
8716,796587,2,0,1,0,1,0,0,0,0,1,0,0,0,0,0,0,0
8716,780186,27,1,1,1,1,0,0,0,0,0,4,3,3,1,2,0,2
8716,798138,12,2,3,0,1,2,2,0,0,0,0,0,1,0,0,0,6
8716,786820,2,0,0,0,0,0,0,0,0,0,0,0,1,0,0,0,0
8716,780184,15,0,2,0,0,0,2,0,0,0,3,1,0,0,1,0,0
8717,780282,31,3,7,3,7,0,0,3,4,1,8,3,1,0,2,1,9
8717,780277,34,4,9,2,5,2,4,1,2,1,3,2,1,1,1,1,11
8717,785327,32,6,10,0,1,6,9,0,0,0,6,3,0,1,1,0,18
8717,780280,31,1,7,0,3,1,4,5,6,0,6,4,0,1,1,0,8
8717,780279,9,1,2,0,0,1,2,0,0,0,0,0,0,0,0,0,3
8717,785329,9,3,4,1,1,2,3,3,4,0,0,1,3,1,2,1,11
8717,796662,8,1,2,0,1,1,1,0,0,0,0,2,1,0,0,0,3
8717,791002,23,2,3,1,1,1,2,2,2,0,0,2,3,0,2,0,7
8717,785330,14,2,3,1,2,1,1,0,0,0,1,0,1,0,0,0,5
8717,785326,9,0,3,0,2,0,1,0,0,0,0,0,1,0,0,0,0
8718,797222,16,4,4,4,4,0,0,3,4,3,2,1,4,1,2,3,11
8718,781526,35,2,4,2,3,0,1,2,2,2,1,1,1,1,2,1,6
8718,797218,32,3,10,2,6,1,4,6,6,0,3,1,1,0,1,0,13
8718,781529,2,0,0,0,0,0,0,0,0,0,1,0,1,0,1,0,0
8718,775697,39,7,14,5,5,2,9,5,5,0,3,1,0,3,2,1,21
8718,791454,21,1,5,1,4,0,1,2,2,2,2,0,2,0,3,1,4
8718,797217,30,0,5,0,2,0,3,1,2,1,1,3,4,1,3,0,1
8718,791846,21,2,6,1,4,1,2,6,8,1,2,0,1,0,1,0,11
8718,791453,4,0,0,0,0,0,0,0,0,0,0,0,1,0,0,0,0
8719,785368,34,5,7,5,7,0,0,4,4,2,3,4,3,1,3,0,14
8719,780281,33,5,9,5,9,0,0,0,0,0,3,2,3,1,1,0,10
8719,790793,35,7,11,5,9,2,2,5,6,2,6,1,1,1,2,0,21
8719,785246,24,2,4,0,0,2,4,0,0,0,2,0,0,0,1,0,6
8719,780886,34,3,10,1,6,2,4,3,4,1,4,5,3,3,5,0,11
8719,796351,8,0,0,0,0,0,0,0,0,0,0,0,1,0,0,0,0
8719,790794,6,0,0,0,0,0,0,2,2,0,0,0,3,0,0,0,2
8719,790792,14,2,5,1,1,1,4,0,0,0,0,0,3,0,2,0,5
8719,790789,2,0,0,0,0,0,0,0,0,0,0,0,1,0,0,0,0
8719,796350,10,1,2,1,1,0,1,0,0,0,0,0,0,0,0,0,2
8720,781342,20,9,11,4,6,5,5,0,0,2,6,1,0,1,1,2,23
8720,781593,24,3,7,2,5,1,2,2,2,0,5,2,1,2,2,1,9
8720,790901,28,4,8,1,2,3,6,2,2,0,5,5,3,0,3,0,13
8720,785452,28,5,7,3,5,2,2,3,5,3,3,2,2,1,0,0,15
8720,781620,23,2,4,1,3,1,1,0,0,0,1,5,4,0,1,0,5
8720,774835,9,2,2,2,2,0,0,0,0,0,1,1,0,0,0,1,4
8720,790902,25,0,5,0,1,0,4,0,0,0,2,2,1,2,1,3,0
8720,796450,20,3,5,3,4,0,1,2,5,1,4,0,1,2,0,1,8
8720,796449,15,3,7,2,4,1,3,0,0,0,2,1,1,1,0,0,7
8720,790904,8,0,2,0,2,0,0,0,2,0,1,0,1,0,1,2,0
8721,790899,20,0,4,0,4,0,0,1,2,3,4,0,3,0,2,1,1
8721,785442,31,2,7,0,2,2,5,0,2,2,3,1,1,0,0,1,6
8721,785579,26,1,7,1,3,0,4,0,0,0,2,4,0,1,1,0,2
8721,781628,16,2,5,2,4,0,1,2,4,1,3,0,2,0,2,0,6
8721,775737,29,4,9,0,0,4,9,0,0,0,3,1,0,0,1,1,12
8721,796447,4,0,0,0,0,0,0,0,0,1,1,0,1,0,1,0,0
8721,799907,18,2,7,1,4,1,3,0,0,0,2,2,1,1,5,0,5
8721,790898,13,1,5,0,0,1,5,0,0,0,0,0,2,0,1,0,3
8721,775959,7,0,1,0,0,0,1,0,0,1,2,0,1,0,1,0,0
8721,790897,21,2,6,0,2,2,4,2,3,0,2,0,2,0,3,0,8
8721,796446,14,1,4,1,4,0,0,1,2,0,0,1,1,0,0,0,3
8721,785448,1,0,0,0,0,0,0,0,0,0,0,0,0,0,0,0,0
8722,797292,32,7,14,7,14,0,0,6,7,5,7,1,4,2,3,3,20
8722,780509,36,5,11,5,10,0,1,5,6,3,3,1,3,0,2,3,15
8722,797290,36,3,10,3,8,0,2,10,10,0,8,4,3,1,4,1,16
8722,797291,29,1,6,1,4,0,2,4,6,0,1,4,0,0,3,1,6
8722,786064,40,6,12,2,4,4,8,2,3,1,12,1,1,0,2,1,18
8722,791658,10,1,2,1,2,0,0,0,0,1,2,0,2,0,0,1,2
8722,785658,9,1,1,1,1,0,0,0,0,0,0,0,1,1,1,0,2
8722,791660,32,3,4,3,4,0,0,4,7,0,3,2,2,1,1,0,10
8722,797295,1,0,0,0,0,0,0,0,0,0,0,0,0,0,0,0,0
8723,785305,13,1,2,1,2,0,0,0,0,1,2,1,3,0,0,1,2
8723,782133,32,5,15,0,3,5,12,2,4,5,2,1,3,2,0,0,17
8723,790990,41,7,16,6,9,1,7,2,2,1,2,1,3,1,1,0,17
8723,789219,25,1,8,0,1,1,7,3,4,1,4,0,5,0,0,0,6
8723,785059,39,9,18,4,8,5,10,1,1,1,12,7,5,3,5,0,24
8723,796624,7,1,3,1,3,0,0,0,0,0,2,0,2,0,1,0,2
8723,790989,7,0,1,0,0,0,1,0,0,0,1,1,2,0,1,0,0
8723,796622,11,1,1,1,1,0,0,0,0,0,2,0,2,1,0,0,2
8723,796623,26,2,9,2,4,0,5,4,5,0,0,3,4,1,4,0,8
8723,790988,6,0,0,0,0,0,0,0,0,1,0,1,1,0,0,0,0
8723,785122,18,1,3,1,2,0,1,2,3,0,0,2,3,1,1,0,4
8724,781647,16,2,9,1,4,1,5,1,2,1,3,1,4,0,0,0,6
8724,776037,27,2,4,2,4,0,0,1,2,1,2,4,4,2,2,0,5
8724,780588,11,2,2,2,2,0,0,0,0,0,2,0,2,1,0,0,4
8724,786147,25,2,4,0,0,2,4,2,2,1,1,4,4,2,1,0,8
8724,780667,39,7,13,5,6,2,7,1,2,1,4,4,3,3,4,0,17
8724,792562,16,3,7,3,5,0,2,0,0,0,3,0,0,0,0,0,6
8724,791758,4,0,0,0,0,0,0,0,0,0,0,0,0,0,0,0,0
8724,782643,24,14,16,14,16,0,0,2,3,4,1,3,2,0,0,0,30
8724,791759,24,3,8,2,5,1,3,1,2,1,0,1,3,1,0,0,8
8724,775680,14,0,3,0,0,0,3,0,0,0,1,3,0,0,3,0,0
8725,786566,36,6,11,5,7,1,4,5,5,0,6,0,2,1,1,2,18
8725,786568,17,3,5,3,5,0,0,0,1,3,3,0,2,1,2,0,6
8725,791993,36,2,5,2,4,0,1,1,1,1,2,2,3,0,2,1,5
8725,781189,27,2,8,2,7,0,1,4,4,0,1,3,4,1,3,0,8
8725,781188,39,8,12,5,6,3,6,8,8,0,4,8,2,1,6,0,27
8725,791997,25,9,12,1,2,8,10,0,2,2,2,0,0,1,0,0,26
8725,797493,2,0,0,0,0,0,0,0,0,0,0,0,0,0,0,0,0
8725,786562,18,0,1,0,1,0,0,0,0,1,3,1,3,0,2,0,0
8726,791220,24,3,4,1,1,2,3,5,8,0,2,0,5,0,0,0,13
8726,791219,36,3,11,2,5,1,6,2,3,0,12,0,1,0,3,2,9
8726,776217,35,4,9,4,8,0,1,1,2,7,5,2,3,1,3,2,9
8726,790818,36,3,6,2,4,1,2,5,6,0,1,4,5,1,1,0,12
8726,786396,28,2,5,2,4,0,1,2,3,1,1,2,0,1,3,0,6
8726,786824,30,3,12,2,7,1,5,0,0,3,1,2,2,2,1,1,7
8726,780730,30,6,15,4,8,2,7,4,4,3,3,5,4,3,2,1,18
8726,796920,1,0,0,0,0,0,0,0,0,0,0,0,0,0,0,0,0
8726,800086,3,0,0,0,0,0,0,0,0,0,0,0,0,0,0,0,0
8726,791221,2,0,0,0,0,0,0,0,0,0,0,0,0,0,0,0,0
8726,792496,0,0,0,0,0,0,0,0,0,0,0,0,0,0,0,0,0
8727,785800,30,1,9,1,3,0,6,0,0,1,3,0,4,0,0,0,2
8727,785799,20,1,5,1,5,0,0,0,0,4,5,0,3,1,0,2,2
8727,791676,31,3,10,0,3,3,7,5,8,0,0,2,4,2,2,0,14
8727,780554,34,5,6,3,4,2,2,4,4,1,1,0,1,0,1,0,16
8727,780553,37,13,19,12,17,1,2,5,8,0,7,7,2,4,4,1,32
8727,797426,9,0,0,0,0,0,0,0,0,0,1,0,0,0,1,0,0
8727,791678,3,0,1,0,0,0,1,0,0,0,2,0,2,0,0,0,0
8727,785807,13,0,3,0,1,0,2,0,0,2,2,0,1,0,0,0,0
8727,780760,24,4,6,2,3,2,3,3,4,1,2,2,0,1,1,3,13
8727,797427,17,2,5,1,1,1,4,0,0,0,0,0,0,1,0,0,5
8727,791677,7,0,0,0,0,0,0,1,2,1,1,0,2,0,0,0,1
8728,785777,31,2,8,2,3,0,5,0,0,0,1,1,4,1,3,0,4
8728,785782,32,4,7,0,0,4,7,2,2,1,4,3,2,0,2,1,14
8728,791145,33,7,9,7,7,0,2,5,6,3,5,2,2,0,3,0,19
8728,791146,36,6,7,1,1,5,6,2,2,1,4,4,2,0,4,0,19
8728,791144,15,0,1,0,1,0,0,1,2,0,2,0,1,0,1,0,1
8728,791147,7,0,0,0,0,0,0,0,0,0,0,0,1,0,0,0,0
8728,796804,8,1,2,1,1,0,1,0,1,0,2,1,0,0,1,0,2
8728,791148,25,4,6,4,5,0,1,3,3,0,3,1,4,0,2,0,11
8728,786748,13,1,1,1,1,0,0,0,0,0,0,2,2,3,3,0,2
8729,792473,18,2,4,2,3,0,1,0,3,0,1,3,5,2,2,0,4
8729,780036,24,1,4,0,2,1,2,0,1,0,0,1,2,2,2,1,3
8729,792474,26,2,4,0,1,2,3,4,4,1,2,1,3,0,2,1,10
8729,785249,36,4,11,3,4,1,7,4,5,1,2,3,3,0,3,0,13
8729,780035,30,4,9,3,5,1,4,1,1,0,3,1,0,1,1,0,10
8729,785251,19,1,1,1,1,0,0,0,0,1,0,0,4,0,1,0,2
8729,780043,10,1,1,1,1,0,0,0,0,1,0,1,1,1,3,1,2
8729,799281,21,1,4,1,2,0,2,1,2,0,3,1,1,0,2,0,3
8729,792478,16,1,3,1,1,0,2,0,0,0,0,0,2,1,0,0,2
8730,774806,24,8,8,8,8,0,0,0,0,4,7,4,4,2,3,2,16
8730,775823,26,5,12,5,9,0,3,0,0,1,3,4,3,2,1,0,10
8730,791041,38,9,19,5,8,4,11,0,1,2,6,4,4,1,3,0,22
8730,791038,35,1,5,0,1,1,4,1,2,2,6,2,0,1,3,1,4
8730,789023,40,7,12,3,7,4,5,4,4,0,0,5,1,2,0,0,22
8730,796714,16,1,4,1,4,0,0,2,2,2,6,0,2,1,2,0,4
8730,775205,21,0,2,0,0,0,2,0,0,0,0,3,2,0,1,0,0
8732,776345,26,7,12,7,12,0,0,2,2,2,4,1,1,1,0,4,16
8732,781373,24,5,9,1,2,4,7,1,2,0,3,3,4,1,0,0,15
8732,785794,28,6,10,5,5,1,5,0,0,1,4,5,0,3,2,1,13
8732,785792,16,2,3,1,2,1,1,0,0,0,0,1,3,1,0,0,5
8732,781379,11,1,3,1,3,0,0,0,0,1,1,1,1,0,1,0,2
8732,796579,19,4,7,0,0,4,7,3,4,0,3,1,0,0,0,0,15
8732,796580,16,2,3,1,2,1,1,1,2,0,1,5,1,0,0,0,6
8732,791292,10,3,4,3,4,0,0,0,0,2,2,1,1,1,0,0,6
8732,796578,6,2,3,2,3,0,0,1,1,0,0,1,0,0,0,0,5
8732,791293,11,1,2,1,1,0,1,0,0,0,1,2,0,0,1,0,2
8732,791295,9,0,3,0,3,0,0,2,2,1,2,0,2,0,1,0,2
8732,791294,3,1,1,1,1,0,0,0,2,0,0,0,0,0,0,0,2
8732,796577,12,0,1,0,1,0,0,0,0,1,2,0,0,0,2,0,0
8732,781372,4,0,2,0,2,0,0,0,0,0,1,0,0,1,0,0,0
8732,792660,3,0,0,0,0,0,0,0,0,0,0,0,1,0,0,0,0
8732,800145,1,0,0,0,0,0,0,0,0,0,0,0,0,0,0,0,0
8732,800146,1,0,0,0,0,0,0,0,0,0,0,0,0,0,0,0,0
8733,786299,32,9,13,8,11,1,2,2,2,0,3,0,2,0,1,2,21
8733,780792,25,5,11,3,7,2,4,0,0,1,2,0,3,1,2,0,12
8733,775598,26,3,9,2,6,1,3,3,4,1,4,0,1,0,2,0,10
8733,791461,29,2,5,2,3,0,2,0,0,2,1,0,1,0,3,0,4
8733,797215,34,1,7,0,1,1,6,0,0,1,3,4,2,0,3,0,3
8733,791460,24,1,6,1,3,0,3,0,0,0,3,0,1,1,2,0,2
8733,797214,15,1,5,1,4,0,1,0,0,0,1,0,0,0,1,0,2
8733,797216,14,0,1,0,1,0,0,0,0,1,1,0,2,1,1,1,0
8733,789034,1,0,1,0,0,0,1,0,0,0,0,0,0,0,0,0,0
8734,780828,34,9,17,9,15,0,2,8,11,0,4,1,2,0,2,0,26
8734,792032,37,6,11,2,7,4,4,4,4,1,5,4,1,1,3,0,20
8734,792029,33,7,12,7,10,0,2,0,0,0,1,1,2,2,2,0,14
8734,792031,34,2,5,1,2,1,3,5,6,1,2,3,4,1,0,0,10
8734,761149,33,1,6,1,3,0,3,8,10,1,8,2,3,2,0,2,10
8734,797640,10,0,0,0,0,0,0,0,0,0,3,0,0,2,0,0,0
8734,792030,8,0,0,0,0,0,0,0,0,0,2,0,0,0,0,0,0
8734,797636,6,0,0,0,0,0,0,0,0,0,0,0,1,0,0,0,0
8734,785822,5,0,2,0,1,0,1,0,0,0,2,0,2,0,0,0,0
8735,781044,27,6,14,3,7,3,7,2,3,3,10,3,5,0,3,1,17
8735,791795,27,5,10,4,7,1,3,3,3,4,1,0,2,0,0,0,14
8735,786489,24,4,9,1,2,3,7,1,2,0,1,0,1,0,2,0,12
8735,781038,33,1,10,0,6,1,4,1,2,0,2,4,0,0,4,0,4
8735,786488,28,1,2,1,2,0,0,0,0,1,4,3,5,1,3,1,2
8735,797620,24,4,7,2,3,2,4,0,0,1,6,1,5,0,0,0,10
8735,797619,18,3,10,3,6,0,4,0,1,0,0,2,2,2,1,0,6
8735,786487,7,2,3,2,2,0,1,0,0,1,0,0,0,0,0,0,4
8735,786490,7,1,1,1,1,0,0,0,0,0,1,1,0,0,0,0,2
8735,797621,5,0,0,0,0,0,0,0,0,0,0,2,2,0,1,0,0
8736,789036,30,8,14,8,13,0,1,1,1,1,3,3,0,1,4,2,17
8736,776494,34,5,13,5,10,0,3,4,5,1,3,1,2,1,1,2,14
8736,791492,38,5,10,2,3,3,7,0,0,1,2,1,3,0,1,0,13
8736,791493,27,3,5,3,5,0,0,0,1,1,5,1,4,1,1,0,6
8736,778888,30,1,6,1,3,0,3,0,0,0,6,1,3,1,0,0,2
8736,797191,21,1,2,1,1,0,1,7,8,0,6,3,3,0,2,1,9
8736,780504,12,3,9,3,9,0,0,2,2,4,5,0,1,0,2,0,8
8736,791494,8,0,1,0,0,0,1,0,0,0,1,2,2,0,0,1,0
8736,791490,0,0,1,0,0,0,1,0,0,0,0,0,0,0,0,0,0
8737,781666,29,5,13,2,4,3,9,0,0,0,2,0,0,0,4,0,13
8737,799842,26,4,13,3,8,1,5,3,4,1,2,1,3,1,1,0,12
8737,786575,35,4,9,4,9,0,0,2,2,6,10,2,2,0,2,3,10
8737,792338,34,1,7,1,6,0,1,4,6,0,2,4,2,0,2,0,6
8737,792334,22,1,3,1,2,0,1,0,3,1,6,0,3,0,1,0,2
8737,791636,23,3,7,1,2,2,5,2,3,1,1,2,4,0,0,0,10
8737,786708,14,2,6,2,5,0,1,2,4,2,3,0,1,0,0,0,6
8737,798095,7,0,2,0,1,0,1,0,0,0,1,0,2,0,0,0,0
8737,798100,5,0,0,0,0,0,0,0,0,0,0,0,0,0,0,0,0
8737,798097,5,0,0,0,0,0,0,0,0,0,2,0,0,0,1,0,0
8738,791225,33,8,10,8,10,0,0,2,3,6,3,3,2,0,5,0,18
8738,775324,23,2,3,2,3,0,0,1,2,1,6,0,4,0,1,1,5
8738,791224,32,7,14,6,7,1,7,2,2,1,1,6,4,3,7,1,17
8738,785571,34,2,8,1,3,1,5,2,4,2,3,0,0,0,1,0,7
8738,781181,34,3,12,3,5,0,7,3,3,1,3,3,2,2,0,0,9
8738,796927,1,0,0,0,0,0,0,0,0,0,0,0,0,0,0,0,0
8738,796929,2,0,0,0,0,0,0,0,0,0,0,0,1,0,0,0,0
8738,791223,19,2,3,2,3,0,0,1,3,2,1,1,2,2,2,1,5
8738,791222,12,1,3,1,2,0,1,0,0,2,2,3,1,1,2,0,2
8738,785564,10,2,6,1,1,1,5,0,0,0,1,0,1,1,1,0,5
8739,797842,33,8,15,8,13,0,2,11,12,4,4,1,3,2,2,0,27
8739,797849,35,4,7,3,5,1,2,1,2,0,2,2,0,1,1,0,10
8739,779986,22,6,7,6,7,0,0,1,2,3,3,0,4,0,2,0,13
8739,797835,16,1,4,1,2,0,2,0,0,1,1,2,3,1,0,0,2
8739,792202,33,4,8,3,5,1,3,2,2,0,1,4,1,0,3,0,11
8739,781537,22,1,4,1,3,0,1,0,0,0,3,1,2,0,2,0,2
8739,797836,3,0,0,0,0,0,0,0,0,0,0,0,0,0,0,0,0
8739,797847,8,1,3,0,1,1,2,0,0,0,0,1,0,0,2,0,3
8739,797838,5,0,1,0,1,0,0,0,0,0,0,0,0,1,0,0,0
8739,797846,23,2,7,1,4,1,3,0,0,1,4,1,1,2,3,0,5
8740,781352,17,2,4,2,4,0,0,0,0,0,1,1,1,0,2,0,4
8740,781351,20,1,5,0,4,1,1,3,6,1,1,1,2,1,0,0,6
8740,797882,29,1,2,0,0,1,2,0,0,0,1,4,1,1,4,0,3
8740,792223,29,4,11,1,6,3,5,8,8,0,7,0,0,1,3,0,19
8740,781340,22,1,3,1,2,0,1,0,0,0,2,1,1,1,1,0,2
8740,797881,12,3,5,3,5,0,0,2,3,1,3,0,2,0,0,0,8
8740,797886,2,0,1,0,0,0,1,0,0,0,0,0,0,0,0,0,0
8740,797889,11,0,0,0,0,0,0,2,2,2,1,1,0,0,1,0,2
8740,792227,18,2,5,2,4,0,1,1,2,1,1,0,0,1,0,0,5
8740,797884,15,2,4,0,1,2,3,0,0,0,0,0,1,0,1,0,6
8740,792228,8,1,2,1,1,0,1,0,0,0,1,0,4,1,0,0,2
8740,786453,17,2,2,2,2,0,0,0,0,1,6,1,0,0,3,0,4
8741,791515,16,1,5,0,2,1,3,0,0,2,1,0,1,0,0,0,3
8741,797150,21,3,6,2,4,1,2,0,1,1,4,0,1,1,1,0,7
8741,780946,39,0,5,0,2,0,3,3,4,1,4,8,3,4,5,0,3
8741,791516,14,1,6,1,2,0,4,0,1,1,2,0,4,1,1,0,2
8741,791513,32,7,10,4,6,3,4,0,0,0,3,1,2,0,1,1,17
8741,797151,26,3,5,3,5,0,0,1,2,2,1,0,3,3,0,0,7
8741,791511,5,0,0,0,0,0,0,0,0,2,1,0,2,0,2,0,0
8741,778442,12,1,3,0,0,1,3,2,2,0,1,1,0,0,1,0,5
8741,797154,3,0,2,0,0,0,2,0,0,0,0,0,0,0,0,0,0
8741,786637,29,3,9,1,3,2,6,5,6,0,2,3,1,2,2,0,13
8741,797152,3,0,0,0,0,0,0,0,0,0,0,0,0,0,0,0,0
8742,791042,27,3,4,3,4,0,0,9,11,2,6,1,4,0,2,1,15
8742,774834,20,2,5,2,4,0,1,0,0,1,5,2,1,0,2,4,4
8742,791043,37,4,11,1,5,3,6,6,8,0,3,3,4,1,7,0,17
8742,776374,29,0,3,0,1,0,2,1,2,0,1,2,3,0,4,0,1
8742,775412,33,2,5,0,0,2,5,2,2,0,1,0,4,1,0,0,8
8742,796723,34,4,7,1,3,3,4,4,4,2,3,2,3,1,2,1,15
8742,785512,12,0,1,0,1,0,0,1,2,1,1,1,4,0,4,2,1
8742,796717,21,0,4,0,4,0,0,1,2,0,3,2,1,0,3,0,1
8742,796720,12,1,5,0,4,1,1,1,2,1,0,0,2,1,0,0,4
8743,792299,33,1,6,1,4,0,2,1,2,4,5,1,3,1,3,1,3
8743,786181,16,0,3,0,3,0,0,1,2,3,0,0,5,2,2,0,1
8743,792304,37,5,11,2,6,3,5,4,4,1,5,0,4,1,4,0,17
8743,792301,41,7,20,6,17,1,3,5,6,0,2,2,0,2,2,1,20
8743,786275,40,5,10,4,7,1,3,2,2,0,1,2,3,1,4,0,13
8743,798092,1,0,1,0,1,0,0,0,0,0,0,0,0,0,0,0,0
8743,798089,4,0,0,0,0,0,0,0,0,0,1,1,4,0,2,0,0
8743,792302,7,1,1,1,1,0,0,4,4,2,2,0,2,2,0,0,6
8743,792295,7,0,0,0,0,0,0,0,0,0,1,0,1,0,0,0,0
8743,786286,10,0,0,0,0,0,0,1,2,0,2,1,4,0,1,0,1
8743,786278,29,2,6,2,3,0,3,3,5,1,3,0,3,1,1,0,7
8744,781134,33,7,8,3,4,4,4,3,4,2,3,1,1,1,1,1,21
8744,786475,34,6,9,2,4,4,5,4,4,0,6,1,4,3,1,0,20
8744,796531,36,4,11,4,7,0,4,4,4,0,6,7,2,0,2,0,12
8744,774874,24,2,4,2,3,0,1,0,0,1,2,2,3,0,4,1,4
8744,785270,11,0,3,0,2,0,1,0,0,1,1,0,4,0,1,0,0
8744,775468,30,6,10,6,9,0,1,2,4,1,2,1,1,3,4,0,14
8744,780085,21,2,3,2,3,0,0,0,2,0,4,2,1,0,0,0,4
8744,790946,7,0,1,0,1,0,0,1,2,0,0,1,0,0,0,2,1
8744,780084,3,0,0,0,0,0,0,0,0,0,0,0,2,0,1,0,0
8744,786037,1,0,0,0,0,0,0,0,0,0,0,0,1,0,0,0,0
8745,780579,36,10,16,8,11,2,5,4,4,0,2,1,2,1,2,0,26
8745,797537,31,4,9,4,7,0,2,1,1,2,1,2,4,2,3,1,9
8745,785293,26,2,7,1,4,1,3,4,4,1,3,1,4,0,1,0,9
8745,785845,34,2,7,2,7,0,0,4,4,0,4,1,2,1,1,3,8
8745,780578,28,0,3,0,0,0,3,2,2,0,3,1,3,0,3,0,2
8745,791712,3,3,4,3,4,0,0,0,0,2,2,0,0,0,0,0,6
8745,785843,16,1,1,1,1,0,0,1,3,0,1,1,2,0,0,1,3
8745,797535,9,1,4,0,1,1,3,0,0,0,1,0,2,0,0,0,3
8745,785847,17,0,4,0,2,0,2,0,0,1,1,1,1,1,0,0,0
8746,791949,38,7,12,6,9,1,3,2,3,0,10,3,3,0,1,1,17
8746,776014,22,0,2,0,1,0,1,0,0,1,4,1,1,0,0,3,0
8746,797690,30,3,6,3,5,0,1,0,0,3,1,4,4,0,3,2,6
8746,797691,28,6,10,6,8,0,2,0,1,0,3,4,2,2,1,2,12
8746,780747,37,9,13,6,8,3,5,2,2,0,7,5,3,2,4,1,23
8746,784336,7,2,3,2,3,0,0,0,0,0,0,1,0,0,0,0,4
8746,785304,19,4,9,2,4,2,5,2,2,0,1,2,1,1,1,0,12
8746,791946,9,0,2,0,0,0,2,0,0,0,2,1,0,0,0,0,0
8746,797689,10,1,2,0,0,1,2,0,0,0,1,1,1,0,0,0,3
8747,785714,24,2,4,2,4,0,0,0,3,1,6,1,4,1,4,1,4
8747,775894,33,7,12,4,7,3,5,2,2,3,5,0,3,2,1,0,19
8747,785711,38,6,14,5,8,1,6,2,4,0,2,10,3,1,1,0,15
8747,780985,33,4,8,1,4,3,4,0,0,0,2,2,1,1,0,1,11
8747,775266,36,3,14,1,6,2,8,3,4,1,3,2,3,2,1,0,11
8747,796829,16,4,5,4,5,0,0,1,2,0,4,0,0,0,0,2,9
8747,785378,4,0,1,0,1,0,0,0,1,0,0,0,0,0,0,0,0
8747,779994,6,0,1,0,0,0,1,0,0,0,1,0,0,0,1,0,0
8747,791167,10,0,2,0,1,0,1,0,0,0,1,2,1,0,0,0,0
8748,792318,29,3,11,3,11,0,0,1,2,3,6,2,4,1,4,0,7
8748,796518,26,7,12,3,5,4,7,3,3,3,1,0,4,2,1,0,21
8748,796519,37,5,14,3,7,2,7,1,3,0,3,4,3,2,3,0,13
8748,796520,33,5,12,2,7,3,5,3,4,0,2,2,2,0,1,0,16
8748,786717,35,6,12,4,8,2,4,5,6,1,4,2,4,0,1,1,19
8748,792308,11,0,0,0,0,0,0,0,0,0,0,0,1,0,0,0,0
8748,792315,0,0,0,0,0,0,0,0,0,0,0,0,1,0,0,0,0
8748,780753,13,0,5,0,3,0,2,0,0,0,1,2,0,0,0,0,0
8748,775329,16,0,2,0,0,0,2,0,0,0,2,0,3,1,2,0,0
8749,799000,31,6,10,6,10,0,0,2,6,3,2,0,3,1,2,2,14
8749,785471,20,7,9,7,9,0,0,0,0,2,7,2,1,1,3,1,14
8749,780263,16,1,3,1,3,0,0,1,2,0,1,1,5,1,1,0,3
8749,786697,35,3,9,3,7,0,2,4,4,0,7,4,3,2,4,2,10
8749,775628,27,6,11,5,9,1,2,10,11,0,7,1,4,1,3,1,23
8749,792399,18,2,6,2,6,0,0,0,0,2,4,0,0,0,2,0,4
8749,775198,28,1,4,1,2,0,2,3,4,2,1,3,0,1,2,0,5
8749,780571,22,5,8,2,4,3,4,0,0,0,0,0,3,0,0,0,13
8749,792397,1,0,0,0,0,0,0,0,0,0,0,0,0,0,0,0,0
8749,786695,2,0,0,0,0,0,0,0,0,0,0,0,0,0,0,0,0
8750,780201,21,4,6,4,6,0,0,0,1,1,2,0,5,0,0,1,8
8750,791469,41,6,12,6,12,0,0,1,1,4,7,1,4,3,6,9,13
8750,797210,47,8,16,6,13,2,3,3,3,5,2,6,3,3,5,0,21
8750,786311,50,3,11,1,3,2,8,3,3,0,2,3,1,3,0,0,11
8750,791470,4,0,0,0,0,0,0,0,0,0,0,0,0,0,1,1,0
8750,791467,33,4,13,1,6,3,7,4,4,2,7,2,1,0,2,0,15
8750,775516,43,6,13,6,11,0,2,6,8,3,2,7,3,4,2,0,18
8750,798344,10,1,3,1,2,0,1,0,0,0,1,0,2,0,2,0,2
8750,791471,1,0,0,0,0,0,0,0,0,0,0,0,0,0,0,0,0
8751,792158,39,2,7,2,7,0,0,7,7,1,0,0,1,1,5,1,11
8751,780138,46,8,16,8,16,0,0,2,2,6,11,3,2,0,3,3,18
8751,792154,39,2,8,2,6,0,2,0,0,1,3,3,1,3,2,1,4
8751,792152,46,7,13,3,8,4,5,6,6,0,3,5,4,3,3,0,24
8751,780581,37,4,7,3,5,1,2,0,0,1,6,2,3,2,2,0,9
8751,797755,6,1,3,1,3,0,0,0,0,0,1,0,0,0,0,0,2
8751,792157,9,0,3,0,3,0,0,1,2,0,1,0,4,0,2,0,1
8751,786014,28,4,6,2,3,2,3,4,5,1,2,1,4,1,3,0,14
8752,780758,29,2,5,1,2,1,3,0,0,0,6,1,2,0,1,0,5
8752,775489,29,9,11,9,10,0,1,3,4,2,8,1,3,0,1,0,21
8752,785563,36,3,9,2,5,1,4,6,7,1,7,2,2,2,4,0,13
8752,785561,28,4,7,4,6,0,1,3,8,2,1,2,2,0,1,1,11
8752,780313,39,7,15,4,9,3,6,9,14,1,2,7,3,1,4,2,26
8752,791087,2,0,0,0,0,0,0,0,0,0,0,0,4,0,0,0,0
8752,791088,21,2,4,0,1,2,3,0,0,1,2,0,0,2,0,0,6
8752,785560,16,1,4,1,3,0,1,0,0,2,2,3,3,0,2,1,2
8752,796750,0,0,0,0,0,0,0,0,0,0,0,0,0,0,0,0,0
8753,786805,32,5,14,1,8,4,6,2,4,3,3,1,2,0,0,0,16
8753,774936,22,7,13,7,12,0,1,7,8,0,3,2,3,0,1,1,21
8753,790932,34,4,11,0,4,4,7,1,2,0,3,5,5,1,2,0,13
8753,781345,34,2,3,1,1,1,2,1,3,0,5,11,3,4,2,0,6
8753,786803,22,2,6,2,5,0,1,1,2,1,1,3,2,2,1,0,5
8753,796488,8,1,2,0,1,1,1,1,2,0,0,0,1,0,1,0,4
8753,790934,16,3,6,2,4,1,2,0,0,1,5,0,4,1,2,0,7
8753,790933,18,2,4,1,2,1,2,0,0,0,1,1,2,0,1,0,5
8753,780033,14,2,3,2,2,0,1,1,1,1,4,0,3,1,1,0,5
8754,785999,35,6,9,6,9,0,0,0,2,5,8,0,3,1,4,0,12
8754,775654,29,4,6,4,6,0,0,1,2,2,7,1,0,1,1,4,9
8754,775171,20,3,7,2,3,1,4,0,0,1,2,0,1,0,1,0,7
8754,791639,35,5,15,5,14,0,1,1,2,1,5,0,4,0,4,1,11
8754,785389,34,4,12,4,9,0,3,7,9,0,1,4,1,1,4,1,15
8754,791640,5,0,1,0,0,0,1,0,0,0,1,0,2,0,0,1,0
8754,796401,19,1,3,1,1,0,2,1,2,1,1,1,2,0,1,0,3
8754,785255,3,0,0,0,0,0,0,0,0,0,0,0,1,0,0,0,0
8754,796399,20,1,6,1,5,0,1,0,0,0,3,4,2,2,0,0,2
8754,796398,0,0,0,0,0,0,0,0,0,0,0,0,1,0,0,0,0
8755,776110,17,0,3,0,1,0,2,0,0,2,0,2,1,2,0,1,0
8755,780059,34,1,9,1,6,0,3,0,0,6,8,2,3,2,2,0,2
8755,796496,21,0,3,0,1,0,2,2,2,2,2,1,0,0,2,0,2
8755,790944,31,5,14,4,9,1,5,4,5,0,6,0,1,0,0,0,15
8755,780061,33,2,9,1,3,1,6,4,4,1,4,2,2,1,2,1,9
8755,780058,9,1,5,0,3,1,2,0,0,1,3,0,2,1,0,0,3
8755,796494,8,1,1,1,1,0,0,0,0,1,1,0,2,0,1,0,2
8755,790941,6,1,1,1,1,0,0,1,2,0,0,0,2,2,3,0,3
8755,786754,27,8,16,5,10,3,6,0,0,0,1,2,2,2,3,0,19
8755,790943,14,2,4,1,2,1,2,4,4,3,3,0,2,1,1,1,9
8756,792373,35,6,10,6,8,0,2,2,4,1,5,2,4,1,1,1,14
8756,781598,10,0,3,0,3,0,0,0,0,0,0,0,2,0,2,1,0
8756,792370,13,0,1,0,1,0,0,0,0,0,1,1,4,0,1,0,0
8756,797951,24,2,4,2,2,0,2,0,0,1,5,1,0,1,3,0,4
8756,775303,24,1,4,0,3,1,1,0,0,1,2,3,2,0,5,0,3
8756,797958,25,7,9,2,3,5,6,0,0,1,4,0,3,0,1,1,19
8756,790499,29,4,6,3,5,1,1,3,3,3,8,2,2,2,3,0,12
8756,786739,11,1,2,0,0,1,2,0,0,0,0,0,0,0,1,0,3
8756,776491,25,6,11,6,11,0,0,3,3,0,5,5,1,2,0,1,15
8756,792369,1,0,0,0,0,0,0,0,0,0,0,0,0,0,0,0,0
8756,797949,1,0,0,0,0,0,0,0,0,0,0,0,0,0,0,0,0
8756,792368,1,0,0,0,0,0,0,0,0,0,0,0,0,0,0,0,0
8756,781597,1,0,0,0,0,0,0,0,0,0,0,0,0,0,0,0,0
8757,791391,37,6,11,6,11,0,0,5,11,2,3,2,1,2,0,4,17
8757,797156,22,2,5,1,2,1,3,1,2,1,1,1,3,0,0,0,6
8757,791390,37,2,8,2,7,0,1,8,8,2,3,3,2,4,3,1,12
8757,775743,29,5,12,2,3,3,9,4,4,0,2,2,0,2,2,0,17
8757,780133,26,1,6,0,2,1,4,0,0,0,1,0,4,1,0,0,3
8757,797157,1,0,0,0,0,0,0,0,0,0,0,0,0,1,0,0,0
8757,791388,9,0,1,0,1,0,0,0,0,0,0,0,0,0,3,0,0
8757,776446,11,0,3,0,1,0,2,0,0,0,0,0,1,0,1,0,0
8757,780407,25,1,6,0,2,1,4,0,0,0,1,2,1,0,0,0,3
8757,797158,3,0,0,0,0,0,0,0,0,0,0,0,0,0,0,0,0
8758,775897,20,2,3,2,3,0,0,0,0,2,2,0,2,2,1,0,4
8758,780324,37,8,15,8,15,0,0,4,6,3,3,2,0,2,2,2,20
8758,791543,35,2,5,2,3,0,2,0,0,0,0,0,1,0,0,0,4
8758,786530,42,4,10,2,4,2,6,2,2,1,1,5,4,0,2,0,12
8758,780317,39,5,14,4,6,1,8,2,3,1,4,2,4,5,0,1,13
8758,784246,21,0,0,0,0,0,0,0,0,0,5,2,1,0,1,1,0
8758,791546,3,0,0,0,0,0,0,0,0,0,0,1,1,0,2,0,0
8758,791545,24,3,8,3,6,0,2,4,4,0,4,0,1,1,2,0,10
8758,797092,2,1,1,1,1,0,0,0,1,1,0,0,0,0,0,0,2
8758,786360,2,0,0,0,0,0,0,0,0,0,0,0,0,0,1,0,0
8759,784640,29,7,9,6,7,1,2,1,1,0,1,2,5,0,1,1,16
8759,797655,21,0,4,0,4,0,0,1,2,1,5,3,4,0,3,0,1
8759,797657,42,2,5,1,2,1,3,0,0,1,3,1,1,0,3,0,5
8759,792072,41,1,2,1,1,0,1,0,0,0,2,2,2,2,1,0,2
8759,792069,43,11,17,6,9,5,8,3,6,0,2,1,1,1,7,0,30
8759,786025,4,1,4,1,4,0,0,0,0,1,1,0,1,0,1,0,2
8759,797652,16,0,1,0,1,0,0,0,0,0,3,0,3,1,2,0,0
8759,785572,29,1,3,1,3,0,0,0,0,1,4,0,1,1,2,0,2
8760,797103,32,8,9,8,9,0,0,4,5,3,6,0,4,3,2,1,20
8760,797105,45,2,7,0,3,2,4,0,0,1,6,1,3,0,0,0,6
8760,797100,23,1,3,1,1,0,2,0,0,2,5,3,2,0,6,0,2
8760,791413,42,4,12,4,8,0,4,3,3,1,2,2,4,0,4,0,11
8760,785776,43,5,12,3,4,2,8,2,3,0,4,2,4,1,1,0,14
8760,797099,2,0,0,0,0,0,0,0,0,1,0,0,1,0,0,0,0
8760,791414,1,0,0,0,0,0,0,0,0,0,0,0,0,0,1,0,0
8760,785911,16,0,1,0,0,0,1,0,0,1,4,1,3,0,2,1,0
8760,791411,42,13,23,9,13,4,10,4,5,0,3,5,3,1,3,0,34
8760,781209,4,0,0,0,0,0,0,0,0,0,0,0,0,0,0,0,0
8761,781103,47,9,18,9,18,0,0,0,0,4,5,5,4,0,2,1,18
8761,797568,49,6,12,3,6,3,6,6,8,0,2,7,2,3,0,0,21
8761,797566,38,3,8,2,3,1,5,1,2,0,5,1,5,4,1,0,8
8761,781191,44,5,14,1,5,4,9,0,2,0,6,3,4,0,1,0,14
8761,781102,22,3,3,3,3,0,0,3,6,1,0,1,0,1,0,0,9
8761,797569,7,0,0,0,0,0,0,0,0,0,1,0,2,0,3,0,0
8761,791905,40,8,12,5,5,3,7,3,4,0,3,1,2,2,3,1,22
8761,791904,3,1,2,1,1,0,1,0,0,1,1,0,2,0,0,0,2
8762,786302,22,5,8,5,8,0,0,2,3,3,5,0,0,0,3,1,12
8762,786293,33,4,8,3,6,1,2,0,0,0,4,0,1,2,3,1,9
8762,797750,31,2,5,1,3,1,2,0,0,0,0,2,4,1,2,0,5
8762,796192,2,0,0,0,0,0,0,0,0,0,0,0,0,0,0,0,0
8762,780955,18,0,2,0,0,0,2,0,0,0,1,0,1,0,0,0,0
8762,792143,19,4,12,2,4,2,8,0,0,3,2,1,4,0,2,1,10
8762,797753,28,5,9,2,3,3,6,1,2,0,2,2,4,0,3,0,14
8762,797748,13,0,0,0,0,0,0,0,0,0,1,0,1,0,1,1,0
8762,786287,26,2,3,1,2,1,1,2,2,2,1,4,2,1,2,0,7
8762,797751,3,1,3,1,2,0,1,0,0,0,0,0,0,0,0,0,2
8762,797742,5,1,1,0,0,1,1,0,0,0,2,0,0,0,0,0,3
8763,796404,23,5,6,5,6,0,0,0,2,2,6,2,2,1,0,0,10
8763,790853,21,2,3,2,3,0,0,1,1,1,2,1,4,1,2,2,5
8763,790850,35,7,11,5,8,2,3,10,11,0,3,1,2,3,0,0,26
8763,781164,17,1,4,1,3,0,1,0,1,0,2,0,1,1,1,0,2
8763,781163,34,4,13,2,9,2,4,3,4,1,3,3,0,1,2,0,13
8763,781223,13,1,3,1,3,0,0,0,0,0,1,2,0,0,0,0,2
8763,796405,4,1,1,1,1,0,0,0,0,0,0,0,0,0,1,0,2
8763,790849,21,0,4,0,3,0,1,0,0,1,0,1,1,1,0,0,0
8763,796406,15,4,7,4,7,0,0,0,0,4,2,0,1,1,1,0,8
8763,785434,13,1,4,0,0,1,4,2,2,0,1,0,2,0,1,0,5
8763,790854,4,0,0,0,0,0,0,0,0,0,0,0,0,0,0,0,0
8764,781249,38,6,9,1,2,5,7,0,2,0,2,4,3,0,1,3,17
8764,775165,39,0,2,0,0,0,2,1,2,0,6,3,2,0,1,0,1
8764,785514,33,6,13,4,8,2,5,6,6,1,4,3,3,1,2,0,20
8764,785515,35,9,16,5,10,4,6,0,4,0,7,1,4,0,0,0,22
8764,781253,38,4,8,4,6,0,2,1,1,1,1,2,2,0,1,0,9
8764,796953,2,0,0,0,0,0,0,0,0,0,0,0,0,0,0,0,0
8764,791251,15,0,2,0,1,0,1,0,0,1,1,0,1,0,0,0,0
8764,776804,0,1,1,0,0,1,1,0,0,0,0,0,0,0,0,0,3
8765,790870,31,7,13,7,13,0,0,3,4,2,4,1,4,1,2,0,17
8765,790869,38,9,21,9,20,0,1,4,4,1,4,1,3,1,4,0,22
8765,780116,33,1,2,1,2,0,0,2,2,2,4,0,4,1,1,0,4
8765,796421,37,5,9,5,7,0,2,3,5,1,5,2,3,1,1,1,13
8765,790866,30,1,4,0,1,1,3,0,0,0,5,2,1,0,0,1,3
8765,796426,4,0,0,0,0,0,0,0,0,0,0,0,0,0,0,0,0
8765,796425,0,0,0,0,0,0,0,0,0,0,0,0,0,0,0,0,0
8765,780493,20,1,3,1,2,0,1,0,0,0,2,0,0,0,1,0,2
8765,780492,0,1,1,1,1,0,0,0,0,0,0,0,0,0,0,0,2
8765,796428,0,0,0,0,0,0,0,0,0,0,0,0,0,0,0,0,0
8765,796427,7,0,1,0,1,0,0,0,0,1,1,1,2,0,0,0,0
8765,796424,0,0,0,0,0,0,0,0,0,0,0,0,0,0,0,0,0
8766,796455,30,6,9,6,9,0,0,2,4,2,3,2,3,0,0,1,14
8766,787175,37,3,11,0,1,3,10,0,0,0,5,1,1,2,0,0,9
8766,790909,20,1,7,1,4,0,3,0,0,0,2,2,3,0,3,0,2
8766,781393,40,4,10,2,3,2,7,2,2,0,6,5,4,2,3,0,12
8766,775351,40,11,16,11,16,0,0,8,12,2,1,2,4,1,3,0,30
8766,790907,7,0,1,0,1,0,0,4,4,0,0,0,0,0,0,0,4
8766,782126,26,0,3,0,1,0,2,2,2,2,2,3,0,2,0,0,2
8767,791316,36,8,14,8,13,0,1,0,0,3,9,1,3,0,0,3,16
8767,780870,25,5,6,5,6,0,0,0,0,4,5,3,2,0,0,0,10
8767,781079,31,5,13,3,7,2,6,4,8,1,1,5,1,1,7,1,16
8767,781443,37,5,7,3,4,2,3,1,3,0,3,2,2,2,1,0,13
8767,775822,32,4,12,1,4,3,8,4,4,1,2,3,2,0,2,0,15
8767,796625,2,0,1,0,1,0,0,0,0,0,0,0,0,1,1,0,0
8767,796621,20,1,5,0,1,1,4,2,3,0,1,3,1,0,1,0,5
8767,791314,7,0,1,0,1,0,0,0,0,1,0,0,1,0,0,0,0
8767,785380,10,3,3,2,2,1,1,0,0,1,2,0,3,0,0,1,7
8767,796626,0,0,0,0,0,0,0,0,0,0,0,0,0,0,0,0,0
8768,796912,31,5,7,2,3,3,4,8,9,0,6,2,4,3,3,3,21
8768,775626,35,12,20,11,17,1,3,3,6,6,8,0,2,0,2,1,28
8768,774964,29,3,6,3,5,0,1,4,6,2,5,4,3,0,0,3,10
8768,796907,20,4,6,3,5,1,1,0,0,1,0,1,3,1,1,2,9
8768,774962,39,5,12,1,4,4,8,0,2,0,3,6,2,1,5,0,14
8768,796910,3,0,1,0,1,0,0,0,0,0,0,0,1,0,0,0,0
8768,785606,11,1,3,1,3,0,0,0,0,1,0,0,3,0,1,1,2
8768,796908,18,1,1,1,1,0,0,0,0,0,1,5,2,0,0,0,2
8768,796906,4,0,0,0,0,0,0,0,0,0,1,1,1,0,1,0,0
8768,791203,9,0,2,0,2,0,0,0,0,1,0,0,0,0,1,0,0
8768,785609,1,0,0,0,0,0,0,0,0,0,0,0,0,0,0,0,0
8769,781407,25,4,9,4,7,0,2,1,2,1,4,2,3,1,0,1,9
8769,791583,12,4,7,4,7,0,0,0,1,3,1,2,4,0,1,0,8
8769,797445,17,1,5,1,4,0,1,1,2,0,1,0,0,1,3,0,3
8769,780580,36,8,21,7,15,1,6,10,15,1,2,5,3,2,2,0,27
8769,776150,14,2,5,2,3,0,2,0,0,0,2,1,0,1,0,0,4
8769,797448,15,2,3,0,0,2,3,0,0,0,4,1,1,0,0,0,6
8769,786608,18,0,2,0,2,0,0,0,0,0,3,0,3,0,0,0,0
8769,786110,21,2,5,2,4,0,1,0,0,2,1,0,2,3,2,0,4
8769,785623,29,2,5,2,3,0,2,6,6,5,1,2,4,1,0,1,10
8769,786659,13,2,3,2,3,0,0,0,0,0,1,1,0,0,0,0,4
8770,786542,26,3,5,3,4,0,1,0,2,1,4,1,3,1,1,1,6
8770,786540,14,0,0,0,0,0,0,0,0,0,2,0,4,0,1,0,0
8770,792019,30,7,16,5,5,2,11,0,0,1,1,1,1,0,1,0,16
8770,792015,13,4,8,4,7,0,1,2,2,0,2,1,0,1,0,0,10
8770,775995,38,4,9,3,7,1,2,0,0,0,3,3,1,2,2,0,9
8770,797514,1,0,0,0,0,0,0,0,0,0,0,0,0,0,0,0,0
8770,785364,25,5,8,5,8,0,0,1,3,1,7,0,1,0,0,2,11
8770,781147,1,0,0,0,0,0,0,0,0,0,0,0,0,0,0,0,0
8770,797515,6,0,1,0,1,0,0,0,0,1,1,2,0,0,1,0,0
8770,797513,1,0,0,0,0,0,0,0,0,0,0,0,0,0,0,0,0
8770,792016,27,7,10,4,6,3,4,0,0,0,4,6,4,1,1,0,17
8770,791845,18,2,5,2,4,0,1,0,0,2,5,2,2,2,1,1,4
8771,796979,26,3,7,0,1,3,6,2,2,0,3,1,1,0,0,2,11
8771,776200,19,2,4,2,4,0,0,0,0,2,1,0,3,3,0,0,4
8771,786437,21,3,6,3,4,0,2,0,1,0,4,3,0,0,4,0,6
8771,780925,26,4,9,2,3,2,6,2,2,0,4,4,2,0,4,0,12
8771,781034,36,2,7,1,3,1,4,1,2,0,4,2,0,0,2,0,6
8771,796980,6,1,1,1,1,0,0,0,0,1,0,1,0,0,0,0,2
8771,791625,14,3,6,1,3,2,3,2,2,3,1,0,2,0,0,0,10
8771,796978,3,0,2,0,0,0,2,0,0,0,0,0,0,1,0,0,0
8771,791622,15,1,3,1,3,0,0,1,1,1,5,1,0,0,0,1,3
8771,791624,11,0,5,0,3,0,2,0,0,0,0,0,1,0,1,0,0
8771,791637,11,1,6,0,2,1,4,3,4,1,1,1,0,1,0,1,6
8771,780446,12,0,4,0,3,0,1,0,0,2,2,2,1,0,2,0,0
8772,786054,27,9,11,9,11,0,0,1,1,1,6,2,3,1,1,1,19
8772,791964,27,5,9,3,4,2,5,0,0,1,2,1,1,0,1,0,12
8772,786056,30,1,2,0,0,1,2,0,0,0,5,3,2,1,1,0,3
8772,781339,36,5,8,2,2,3,6,0,0,0,1,2,1,1,3,0,13
8772,781337,33,5,12,3,8,2,4,3,4,0,1,4,2,1,4,0,15
8772,797712,9,0,1,0,1,0,0,0,0,1,1,0,1,0,0,0,0
8772,792041,8,2,3,2,3,0,0,3,3,0,0,0,1,0,0,1,7
8772,799737,3,0,0,0,0,0,0,0,0,0,1,0,1,0,0,0,0
8772,797711,27,2,3,2,2,0,1,1,2,0,4,1,1,1,3,0,5
8773,785775,22,2,2,2,2,0,0,0,0,1,1,3,2,2,0,0,4
8773,781335,33,11,22,7,14,4,8,3,6,4,3,2,4,0,2,1,29
8773,776351,35,4,10,3,3,1,7,3,3,2,5,1,0,3,0,1,12
8773,785770,36,4,9,4,7,0,2,4,4,1,5,5,1,2,2,0,12
8773,781341,36,3,11,0,3,3,8,2,2,0,1,1,1,1,2,0,11
8773,796542,6,0,0,0,0,0,0,0,0,0,0,0,0,1,0,0,0
8773,791285,2,0,0,0,0,0,0,0,0,0,0,0,0,0,1,0,0
8773,796538,4,0,0,0,0,0,0,0,0,0,0,0,0,0,0,0,0
8773,791284,26,2,3,1,1,1,2,0,0,0,1,0,1,0,1,0,5
8774,781454,30,5,11,3,9,2,2,2,4,5,6,1,1,0,3,1,14
8774,786424,26,7,17,7,17,0,0,2,2,4,12,0,3,0,3,1,16
8774,792366,31,4,9,3,7,1,2,5,8,1,2,0,2,1,1,1,14
8774,791015,19,1,1,0,0,1,1,0,0,0,0,5,3,0,1,0,3
8774,785483,25,1,4,0,2,1,2,2,2,0,3,4,5,0,2,0,5
8774,785959,14,1,2,1,2,0,0,3,4,4,3,0,3,2,1,2,5
8774,797988,21,1,5,1,3,0,2,2,4,2,0,7,1,1,2,0,4
8774,797979,23,2,4,1,2,1,2,4,4,2,2,0,0,0,0,0,9
8774,775335,11,1,4,0,0,1,4,0,0,0,0,0,0,0,0,0,3
8775,786656,21,0,4,0,4,0,0,2,4,2,2,0,2,0,1,4,2
8775,781408,25,4,12,2,7,2,5,0,0,1,3,1,0,0,0,0,10
8775,786691,26,0,3,0,2,0,1,0,0,2,4,2,2,0,1,0,0
8775,786693,30,7,13,5,9,2,4,1,2,0,2,1,5,0,1,0,17
8775,781329,34,6,14,4,11,2,3,1,1,0,3,6,3,1,1,0,15
8775,797876,4,0,2,0,2,0,0,0,0,1,0,0,1,0,1,1,0
8775,792219,20,7,10,7,10,0,0,0,1,2,3,0,4,0,1,1,14
8775,792046,16,2,5,0,1,2,4,0,0,0,2,3,3,1,1,0,6
8775,792221,7,0,0,0,0,0,0,0,0,0,0,0,0,1,0,0,0
8775,792220,6,0,0,0,0,0,0,0,0,0,0,0,1,0,0,0,0
8775,781455,11,0,0,0,0,0,0,0,0,0,0,2,1,0,2,0,0
8776,781659,21,3,6,3,4,0,2,1,2,2,5,1,2,0,2,1,7
8776,781005,32,6,14,5,8,1,6,3,4,2,9,2,2,0,3,0,16
8776,792684,28,2,6,2,4,0,2,1,2,0,8,4,5,0,1,0,5
8776,782162,34,7,21,6,16,1,5,2,3,2,2,0,4,1,4,0,17
8776,781665,36,1,10,1,5,0,5,0,0,0,1,3,3,3,0,0,2
8776,790494,3,0,1,0,0,0,1,0,0,0,1,0,2,0,0,0,0
8776,788866,3,0,0,0,0,0,0,0,0,1,0,0,0,0,0,0,0
8776,796853,17,3,5,2,4,1,1,1,3,2,2,0,3,0,1,0,8
8776,792683,2,1,2,1,1,0,1,0,0,0,0,0,2,0,2,0,2
8776,780610,24,2,11,0,2,2,9,5,5,1,3,1,1,1,2,0,11
8777,786690,21,3,7,3,5,0,2,0,2,2,5,0,1,0,2,1,6
8777,780629,34,5,9,5,8,0,1,2,4,4,5,2,1,1,2,1,12
8777,774845,39,2,10,2,6,0,4,10,12,0,5,6,3,1,3,0,14
8777,796816,32,7,13,4,7,3,6,4,8,2,4,1,3,2,2,3,21
8777,775888,32,5,14,4,10,1,4,4,7,2,13,5,4,2,5,4,15
8777,791161,13,0,1,0,0,0,1,0,0,0,1,1,1,0,2,0,0
8777,785346,25,5,9,2,2,3,7,0,0,0,4,2,2,1,0,0,13
8777,796815,4,0,0,0,0,0,0,0,0,0,0,0,0,0,0,0,0
8778,787524,29,2,9,2,5,0,4,0,0,2,2,1,3,2,3,2,4
8778,787522,28,5,6,5,6,0,0,2,3,1,3,0,3,2,0,0,12
8778,781019,34,5,19,4,15,1,4,1,5,4,5,2,1,3,1,0,12
8778,780328,19,0,4,0,4,0,0,0,0,2,1,0,2,2,0,1,0
8778,775961,32,4,12,1,5,3,7,0,0,0,3,4,1,0,2,1,11
8778,775541,4,0,1,0,1,0,0,0,0,0,0,0,0,0,0,0,0
8778,797611,5,1,1,1,1,0,0,0,0,0,2,2,0,1,0,0,2
8778,783269,6,0,1,0,0,0,1,0,0,0,0,0,0,0,1,0,0
8778,791774,8,1,1,1,1,0,0,0,0,0,2,0,1,0,0,0,2
8778,791772,14,2,4,0,0,2,4,0,0,0,4,1,1,0,1,0,6
8778,791722,3,0,0,0,0,0,0,0,0,0,1,1,0,0,0,0,0
8778,780017,18,2,6,1,2,1,4,1,2,0,1,2,1,1,2,0,6
8779,786163,31,2,7,2,5,0,2,0,1,1,8,1,4,1,4,1,4
8779,781149,35,5,9,3,4,2,5,0,0,2,6,1,2,2,4,2,12
8779,798152,3,0,1,0,1,0,0,0,0,1,1,0,0,0,0,1,0
8779,789025,18,0,3,0,2,0,1,2,2,2,2,1,1,1,3,1,2
8779,782157,30,1,5,1,5,0,0,2,4,2,5,4,3,2,5,0,4
8779,780852,2,0,0,0,0,0,0,0,0,0,0,0,0,0,0,1,0
8779,786214,10,0,3,0,1,0,2,0,0,0,1,1,1,0,0,1,0
8779,792670,17,1,5,0,3,1,2,0,0,0,2,0,1,2,1,0,3
8779,780193,21,3,9,1,5,2,4,6,6,1,3,1,0,0,0,0,14
8779,774985,29,3,9,2,7,1,2,4,4,2,5,1,2,0,4,1,11
8779,775276,4,1,1,0,0,1,1,0,0,0,0,0,1,0,2,0,3
8780,792351,33,3,7,3,7,0,0,0,0,4,3,3,3,0,2,0,6
8780,786723,36,6,12,6,11,0,1,3,4,0,3,8,4,2,4,1,15
8780,792349,23,2,6,1,5,1,1,2,2,0,2,1,4,0,2,3,7
8780,798060,37,3,8,2,6,1,2,2,2,0,5,4,2,1,5,2,9
8780,792355,30,7,12,2,5,5,7,0,0,0,3,0,0,0,0,0,19
8780,786724,16,2,3,1,1,1,2,0,0,0,3,1,2,0,0,0,5
8780,792352,2,0,0,0,0,0,0,0,0,0,0,0,1,0,0,0,0
8780,798061,15,4,6,3,5,1,1,1,1,2,0,1,2,1,0,1,10
8780,786726,3,0,0,0,0,0,0,0,0,1,0,0,0,0,1,0,0
8780,792348,5,0,2,0,1,0,1,0,0,0,0,1,0,0,0,0,0
8781,790893,24,2,8,2,8,0,0,2,5,5,5,0,1,1,1,0,6
8781,796444,33,2,7,2,6,0,1,7,8,2,6,2,2,2,2,1,11
8781,790890,19,2,5,2,4,0,1,2,2,2,2,1,2,2,4,0,6
8781,786732,26,4,9,3,7,1,2,0,0,2,4,1,1,4,0,0,9
8781,775260,34,2,10,2,7,0,3,0,1,1,1,2,1,1,2,0,4
8781,786615,33,8,15,7,11,1,4,2,3,2,2,2,1,0,1,0,19
8781,775536,7,0,0,0,0,0,0,2,2,1,1,0,2,0,0,0,2
8781,790889,10,1,2,1,1,0,1,0,0,1,0,0,2,0,2,0,2
8781,780702,10,1,2,1,2,0,0,0,0,0,0,0,0,1,0,0,2
8781,799891,3,0,1,0,0,0,1,0,0,0,1,0,1,0,0,1,0
8781,796445,1,0,0,0,0,0,0,0,0,0,0,0,0,0,0,0,0
8782,792035,20,6,7,6,7,0,0,8,10,2,3,2,4,0,6,0,20
8782,780833,35,4,5,4,5,0,0,8,12,1,2,2,0,0,1,0,16
8782,792034,36,4,8,2,5,2,3,6,6,0,5,3,3,1,3,0,16
8782,791688,28,2,4,1,2,1,2,2,2,1,4,2,3,1,1,0,7
8782,780830,31,3,4,3,4,0,0,5,5,0,4,2,2,0,1,1,11
8782,797645,22,5,5,5,5,0,0,6,7,0,2,0,3,0,3,0,16
8782,785982,2,0,0,0,0,0,0,0,0,0,0,0,0,0,0,0,0
8782,797644,2,0,0,0,0,0,0,0,0,0,0,0,1,0,0,0,0
8782,785980,24,1,1,0,0,1,1,0,0,0,0,2,2,1,0,0,3
8783,792340,24,8,11,7,9,1,2,0,0,2,1,2,5,0,3,0,17
8783,792345,35,4,10,4,8,0,2,0,0,1,2,5,3,2,1,0,8
8783,792342,26,2,3,0,0,2,3,4,4,0,0,1,4,2,1,0,10
8783,792346,34,2,7,1,4,1,3,2,4,0,2,2,4,0,2,0,7
8783,781553,19,5,6,3,4,2,2,4,5,1,1,0,5,1,2,1,16
8783,798085,8,3,4,2,3,1,1,0,0,0,0,0,1,0,0,1,7
8783,798080,17,1,3,0,0,1,3,0,0,0,0,0,5,0,0,0,3
8783,798086,2,0,0,0,0,0,0,0,0,0,0,1,0,0,0,0,0
8783,798088,2,1,1,0,0,1,1,0,0,0,0,0,0,0,0,0,3
8783,792344,9,0,2,0,0,0,2,1,2,0,1,2,0,0,0,0,1
8783,792341,24,2,4,1,2,1,2,0,0,0,1,2,3,1,0,0,5
8784,775116,30,3,8,1,2,2,6,0,0,2,7,2,3,1,3,2,8
8784,797822,32,6,16,6,11,0,5,0,0,3,4,1,2,2,1,0,12
8784,792190,36,5,12,2,6,3,6,2,2,0,3,3,1,2,1,0,15
8784,786664,38,7,17,3,9,4,8,2,2,0,2,6,1,1,3,0,20
8784,781266,2,0,0,0,0,0,0,0,0,0,0,0,0,0,0,0,0
8784,797824,13,1,2,0,1,1,1,0,0,0,3,1,4,0,0,0,3
8784,797825,19,4,7,4,7,0,0,0,0,4,1,1,4,0,0,0,8
8784,792191,22,1,2,1,2,0,0,3,4,1,2,2,1,0,1,0,5
8784,791928,8,0,0,0,0,0,0,0,0,0,0,3,0,0,0,0,0
8785,797414,18,0,3,0,3,0,0,0,2,2,1,0,1,0,1,0,0
8785,785762,33,7,12,6,9,1,3,0,2,3,5,0,3,0,1,0,15
8785,797407,22,3,4,1,1,2,3,0,2,0,2,2,0,0,4,0,8
8785,791666,33,9,18,6,12,3,6,6,6,1,4,4,3,3,5,0,27
8785,780531,39,2,9,1,4,1,5,0,0,0,7,6,1,1,2,3,5
8785,780534,19,1,3,1,3,0,0,0,0,2,2,1,3,0,1,0,2
8785,797409,14,1,3,1,2,0,1,0,0,0,1,5,1,0,2,0,2
8785,797415,9,0,1,0,0,0,1,0,0,1,0,0,1,0,1,0,0
8785,785760,13,1,1,1,1,0,0,0,0,0,0,0,0,0,0,1,2
8786,790781,30,3,6,3,6,0,0,5,8,6,6,0,4,1,0,4,11
8786,780040,43,7,12,7,12,0,0,0,1,1,4,3,0,2,2,0,14
8786,790785,41,3,9,2,7,1,2,2,2,2,4,9,3,2,5,0,9
8786,781232,29,2,6,1,2,1,4,3,3,1,0,2,1,1,1,0,8
8786,780037,41,7,23,4,10,3,13,6,7,1,2,2,4,0,3,0,23
8786,796339,29,4,8,2,2,2,6,0,0,0,2,1,1,2,0,0,10
8786,796343,12,1,1,1,1,0,0,0,0,0,1,0,4,0,0,1,2
8787,797831,7,0,2,0,1,0,1,0,0,0,0,0,2,0,3,0,0
8787,785950,38,6,9,4,4,2,5,1,1,2,6,1,2,1,0,0,15
8787,797823,15,1,2,0,0,1,2,1,2,2,2,0,1,1,2,1,4
8787,797826,27,5,7,3,5,2,2,2,2,1,3,2,0,0,2,0,14
8787,792280,28,6,13,6,10,0,3,3,3,1,2,6,5,2,0,0,15
8787,797829,37,3,11,3,11,0,0,7,7,1,8,0,2,2,2,3,13
8787,792283,36,2,6,1,4,1,2,5,6,3,4,2,1,1,2,0,10
8787,792284,28,1,6,0,4,1,2,0,0,0,1,2,1,0,3,0,3
8787,792286,3,0,0,0,0,0,0,0,0,0,1,0,2,0,0,0,0
8787,799468,6,0,3,0,3,0,0,0,0,0,1,2,1,0,1,0,0
8788,790798,29,5,9,5,8,0,1,6,11,1,6,4,4,0,1,0,16
8788,780140,36,6,12,0,2,6,10,6,6,0,5,0,3,2,1,1,24
8788,796355,33,3,7,3,5,0,2,6,7,0,2,7,1,2,4,0,12
8788,780137,31,6,7,5,6,1,1,0,0,0,0,3,2,1,0,0,13
8788,775553,11,1,2,0,1,1,1,0,0,0,0,1,2,2,1,0,3
8788,785245,27,2,4,1,2,1,2,0,0,0,3,2,3,0,2,0,5
8788,790799,22,5,6,5,6,0,0,1,4,1,0,0,0,2,1,0,11
8788,796359,3,0,1,0,1,0,0,1,2,0,0,0,1,0,0,0,1
8788,790796,2,0,0,0,0,0,0,0,0,0,1,0,1,0,0,0,0
8788,799892,2,0,0,0,0,0,0,1,2,0,0,0,1,0,1,0,1
8788,788844,1,0,0,0,0,0,0,0,0,0,0,0,0,0,0,0,0
8788,796354,3,0,0,0,0,0,0,0,0,0,0,0,0,0,0,0,0
8789,791537,23,2,4,0,1,2,3,0,0,0,3,3,5,0,1,1,6
8789,775418,30,8,9,8,9,0,0,3,4,1,9,0,3,1,0,0,19
8789,797116,37,1,10,1,8,0,2,2,2,0,1,3,4,1,3,0,4
8789,780312,29,2,6,1,2,1,4,1,3,0,1,2,5,2,3,0,6
8789,780306,38,9,17,9,16,0,1,2,4,6,5,3,2,1,5,0,20
8789,786358,25,4,5,1,1,3,4,0,0,1,3,3,3,2,4,1,11
8789,791535,15,0,2,0,1,0,1,3,4,0,0,0,1,0,0,0,3
8789,775846,2,0,0,0,0,0,0,0,0,0,0,0,1,0,1,0,0
8789,791538,1,0,0,0,0,0,0,0,0,0,0,0,0,0,0,0,0
8790,796673,22,4,9,1,5,3,4,0,1,1,3,0,3,0,2,0,11
8790,796674,34,1,3,1,2,0,1,0,0,0,7,1,0,0,0,0,2
8790,779857,24,4,10,4,10,0,0,3,5,3,7,1,1,0,1,6,11
8790,779976,28,2,7,2,5,0,2,4,4,0,5,5,3,0,2,0,8
8790,774990,23,4,9,3,6,1,3,2,2,1,1,4,3,1,2,0,11
8790,785126,1,0,1,0,0,0,1,0,0,0,0,0,0,0,0,0,0
8790,781586,15,0,2,0,2,0,0,0,2,1,4,1,2,1,2,0,0
8790,785961,9,0,0,0,0,0,0,0,0,0,1,0,0,1,0,0,0
8790,796672,1,0,0,0,0,0,0,0,0,0,0,0,0,0,0,0,0
8790,791016,1,0,0,0,0,0,0,0,0,0,0,0,0,0,0,0,0
8790,791014,22,5,7,1,2,4,5,1,2,0,4,1,1,0,0,0,15
8790,787090,1,0,0,0,0,0,0,0,0,0,0,0,0,0,0,0,0
8790,785339,18,3,6,2,3,1,3,0,0,1,2,0,0,0,1,0,7
8790,780142,1,0,0,0,0,0,0,0,0,0,0,0,0,0,0,0,0
8791,797721,18,0,3,0,1,0,2,0,0,0,1,1,2,0,0,0,0
8791,786257,36,5,16,4,13,1,3,1,2,1,5,2,2,0,1,1,12
8791,786263,32,3,10,1,5,2,5,2,2,3,8,0,0,2,0,0,10
8791,785661,39,6,12,6,9,0,3,5,6,1,5,1,2,0,2,1,17
8791,775825,33,3,13,2,8,1,5,0,2,2,3,3,2,3,4,0,7
8791,792121,23,2,3,1,1,1,2,0,0,0,0,0,4,1,1,0,5
8791,797725,3,0,0,0,0,0,0,0,0,0,0,0,3,0,0,0,0
8791,792356,1,0,0,0,0,0,0,0,0,0,0,1,0,0,1,0,0
8791,797724,3,0,0,0,0,0,0,0,0,0,0,0,0,0,0,0,0
8791,786249,12,0,1,0,1,0,0,0,0,0,3,0,2,0,0,0,0
8792,791051,35,5,6,5,6,0,0,2,2,3,3,1,3,0,2,1,12
8792,780739,16,1,1,1,1,0,0,0,0,3,1,1,3,0,2,2,2
8792,790819,32,7,13,4,6,3,7,0,0,0,3,4,1,2,3,0,17
8792,785524,25,6,16,3,6,3,10,3,4,1,4,0,2,0,0,0,18
8792,781115,24,0,1,0,1,0,0,0,0,0,0,4,5,0,0,0,0
8792,796731,10,0,1,0,1,0,0,0,0,0,0,2,2,0,0,0,0
8792,786310,16,4,5,2,2,2,3,0,0,1,0,2,0,0,1,0,10
8792,775094,17,0,3,0,2,0,1,0,0,2,3,1,4,0,1,0,0
8792,775456,25,9,12,7,10,2,2,8,9,2,2,4,4,2,3,1,28
8793,796838,26,2,3,2,3,0,0,2,6,1,1,1,3,3,2,0,6
8793,796837,35,9,14,6,10,3,4,3,5,0,4,1,0,0,2,0,24
8793,796834,34,5,8,1,2,4,6,0,2,0,4,1,1,1,0,0,14
8793,785700,38,1,1,0,0,1,1,10,11,0,1,7,1,0,2,0,13
8793,780269,35,7,13,7,12,0,1,11,12,0,1,4,3,1,1,0,25
8793,791171,14,4,4,4,4,0,0,0,0,0,2,0,2,0,0,0,8
8793,796833,12,0,1,0,0,0,1,0,0,0,0,2,0,0,0,0,0
8793,785706,6,0,1,0,0,0,1,0,0,0,0,0,3,0,1,1,0
8802,785811,32,4,13,2,9,2,4,6,7,1,3,0,2,0,3,0,16
8802,797894,26,2,6,2,5,0,1,1,2,4,1,4,3,0,1,0,5
8802,785954,25,2,5,0,0,2,5,4,4,0,3,4,5,0,1,0,10
8802,792229,33,3,6,3,5,0,1,4,5,0,5,3,2,4,1,1,10
8802,780323,32,4,8,4,8,0,0,2,3,2,7,0,0,1,1,1,10
8802,792234,6,1,1,1,1,0,0,0,1,0,2,1,1,0,1,1,2
8802,792230,14,0,0,0,0,0,0,0,0,0,0,0,4,0,1,0,0
8802,797893,1,0,1,0,1,0,0,0,0,0,0,0,0,0,0,0,0
8802,792233,26,5,7,5,7,0,0,1,2,0,3,1,2,1,1,0,11
8802,781356,2,0,0,0,0,0,0,0,0,0,0,0,1,0,0,0,0
8802,797891,3,1,3,1,1,0,2,2,2,0,0,0,1,0,0,1,4
8803,776003,21,2,8,1,3,1,5,3,6,0,6,1,3,1,1,0,8
8803,779978,38,3,6,1,3,2,3,2,2,0,3,6,4,2,3,0,10
8803,785463,37,1,10,0,5,1,5,3,4,0,4,4,2,1,1,0,6
8803,796469,13,2,7,1,3,1,4,0,0,1,0,0,3,0,3,0,5
8803,779981,28,4,5,4,5,0,0,3,4,1,6,1,3,0,2,0,11
8803,790923,22,3,6,3,4,0,2,3,5,4,2,0,3,0,0,1,9
8803,785466,20,1,4,0,1,1,3,4,6,1,2,0,2,1,1,1,7
8803,779979,17,1,2,0,0,1,2,0,0,0,0,0,2,0,0,0,3
8803,790924,2,0,1,0,1,0,0,0,0,0,0,0,0,0,0,0,0
8803,779980,2,0,0,0,0,0,0,0,0,0,0,0,0,0,0,0,0
8804,785353,38,7,16,4,6,3,10,1,2,1,5,5,0,2,2,0,18
8804,781457,37,1,4,1,3,0,1,2,2,0,0,6,5,1,2,0,4
8804,780876,39,7,11,7,10,0,1,5,6,2,5,7,3,3,4,0,19
8804,781462,40,14,25,14,25,0,0,3,7,9,7,2,2,2,2,1,31
8804,785355,34,3,8,2,4,1,4,2,4,2,3,6,3,1,0,1,9
8804,781673,7,1,2,0,0,1,2,0,0,1,1,0,2,0,1,0,3
8804,790895,5,0,0,0,0,0,0,0,0,0,0,0,1,0,0,0,0
8805,785902,33,9,15,5,8,4,7,4,4,3,1,1,3,1,2,1,26
8805,792179,26,4,11,4,8,0,3,2,2,0,1,3,1,2,2,0,10
8805,786662,33,4,11,3,6,1,5,3,4,2,3,1,3,1,1,0,12
8805,792181,29,6,12,5,8,1,4,0,1,2,3,0,2,0,1,0,13
8805,780986,10,1,1,1,1,0,0,0,0,0,3,0,5,0,4,0,2
8805,786661,11,1,2,0,0,1,2,2,2,0,1,1,0,2,0,0,5
8805,792176,9,0,0,0,0,0,0,0,0,0,1,0,1,0,0,1,0
8805,797796,26,0,5,0,5,0,0,2,4,1,3,6,0,0,3,0,2
8805,792177,23,3,5,3,5,0,0,1,2,1,7,0,2,0,0,1,7
8806,791401,35,3,12,3,12,0,0,4,7,1,3,3,2,1,2,1,10
8806,786837,26,2,4,1,1,1,3,0,0,2,4,0,2,0,2,0,5
8806,780125,33,3,5,3,4,0,1,5,6,1,5,2,2,1,1,2,11
8806,785931,32,3,9,2,6,1,3,0,0,0,2,0,1,0,1,0,7
8806,780118,29,6,9,5,6,1,3,2,2,0,2,1,2,1,1,0,15
8806,797125,8,0,1,0,1,0,0,0,0,0,1,0,2,0,2,0,0
8806,797126,12,0,2,0,2,0,0,0,0,3,1,0,1,0,1,0,0
8806,797130,16,3,8,2,5,1,3,0,0,0,1,2,3,1,1,0,7
8806,797132,8,0,1,0,0,0,1,0,0,0,0,0,0,0,0,0,0
8806,791398,1,0,1,0,0,0,1,2,2,0,0,0,0,0,0,0,2
8806,791399,0,0,0,0,0,0,0,0,0,0,0,0,0,0,0,0,0
8807,780012,28,5,11,1,4,4,7,2,2,3,7,1,4,2,0,0,16
8807,796309,29,6,11,6,11,0,0,1,1,2,5,2,3,0,3,1,13
8807,790824,35,6,9,5,5,1,4,8,8,0,6,1,1,3,1,1,21
8807,780011,35,2,4,2,3,0,1,2,2,0,1,1,0,3,1,0,6
8807,775667,34,4,5,2,2,2,3,4,4,0,3,3,1,0,5,0,14
8807,774895,10,0,2,0,2,0,0,0,2,2,1,0,3,0,0,0,0
8807,785370,6,0,2,0,2,0,0,0,0,0,2,0,2,0,0,1,0
8807,781524,18,1,7,0,1,1,6,0,0,0,2,0,0,0,1,0,3
8807,783865,1,0,1,0,1,0,0,0,0,0,0,0,0,0,0,0,0
8807,780941,1,0,1,0,1,0,0,0,0,0,0,0,0,0,0,0,0
8807,785600,1,0,0,0,0,0,0,0,0,0,0,0,1,0,0,0,0
8807,796382,1,0,0,0,0,0,0,0,0,0,0,0,0,0,0,0,0
8807,796383,1,0,0,0,0,0,0,0,0,0,0,0,0,0,0,0,0
8808,791548,39,8,12,7,8,1,4,10,12,1,6,0,2,2,6,3,27
8808,791550,28,2,5,2,5,0,0,0,0,2,5,0,5,0,7,1,4
8808,786364,36,3,8,2,5,1,3,2,4,3,8,1,4,1,0,1,9
8808,780330,16,2,2,2,2,0,0,0,0,0,2,0,5,2,1,0,4
8808,780329,27,4,10,3,8,1,2,1,2,0,1,1,4,3,6,0,10
8808,797082,11,1,1,1,1,0,0,1,3,0,1,0,3,0,1,0,3
8808,780332,1,0,0,0,0,0,0,0,0,0,0,0,1,0,0,0,0
8808,797080,5,0,0,0,0,0,0,0,0,0,0,0,1,0,0,0,0
8808,791552,17,2,5,2,4,0,1,6,6,0,3,2,1,2,0,0,10
8808,786368,20,0,3,0,2,0,1,0,0,0,0,2,3,0,2,0,0
8809,792481,20,3,6,3,6,0,0,1,1,1,1,0,3,3,4,2,7
8809,792486,17,3,10,3,9,0,1,1,3,3,1,2,5,1,0,1,7
8809,797419,31,1,8,1,5,0,3,2,6,0,1,4,0,0,3,0,4
8809,792482,25,0,3,0,2,0,1,0,0,1,2,0,4,0,1,0,0
8809,785778,32,5,5,5,5,0,0,10,17,1,7,3,3,4,1,0,20
8809,792488,23,1,3,1,2,0,1,0,0,0,1,1,3,1,1,0,2
8809,780544,20,3,5,3,5,0,0,1,1,0,3,0,3,2,1,0,7
8809,792489,5,0,0,0,0,0,0,0,0,0,0,0,0,0,0,0,0
8809,785766,27,8,11,4,6,4,5,6,7,1,2,0,3,1,3,1,26
8810,791302,26,4,11,4,9,0,2,2,3,4,5,2,3,0,0,1,10
8810,781622,29,5,10,1,3,4,7,3,4,0,4,0,3,0,1,0,17
8810,791309,40,2,13,2,9,0,4,3,4,0,7,5,2,1,7,0,7
8810,785835,14,0,2,0,0,0,2,0,0,3,1,2,1,0,3,0,0
8810,776334,35,5,6,2,2,3,4,3,5,0,7,2,0,2,2,0,16
8810,775862,16,3,7,3,7,0,0,4,4,1,0,1,3,0,0,1,10
8810,796601,27,2,9,2,7,0,2,4,7,1,2,0,0,2,2,1,8
8810,791304,13,1,2,1,2,0,0,0,0,0,1,0,2,3,2,0,2
8811,785458,28,7,10,6,8,1,2,2,3,0,7,4,2,3,3,1,17
8811,780798,26,4,9,3,7,1,2,0,1,2,4,2,3,0,2,0,9
8811,800055,10,3,4,3,4,0,0,0,0,0,3,0,2,0,1,1,6
8811,785454,32,1,6,1,2,0,4,0,0,1,2,5,1,2,1,1,2
8811,785453,31,4,11,1,5,3,6,0,2,1,3,1,3,4,1,0,11
8811,790914,17,3,4,3,4,0,0,0,0,1,0,1,2,0,0,1,6
8811,785455,28,8,16,4,8,4,8,3,4,1,4,2,4,2,5,0,23
8811,790913,22,6,8,5,7,1,1,2,3,1,7,5,2,4,0,0,15
8811,790915,5,1,1,1,1,0,0,0,0,1,0,0,4,0,0,0,2
8811,785456,1,0,0,0,0,0,0,0,0,0,0,0,0,0,0,0,0
8812,780406,16,1,2,1,1,0,1,0,0,0,3,0,2,0,2,0,2
8812,775087,29,6,10,5,7,1,3,1,2,3,2,6,3,1,0,1,14
8812,785296,30,8,13,2,4,6,9,2,2,0,4,6,2,0,5,0,24
8812,780212,36,10,17,6,8,4,9,9,10,0,3,0,2,1,0,0,33
8812,767245,31,4,11,4,9,0,2,3,4,1,4,0,2,0,4,0,11
8812,780215,9,2,2,2,2,0,0,0,0,2,2,1,1,0,1,0,4
8812,790984,27,2,3,0,0,2,3,1,2,0,3,5,3,2,1,0,7
8812,785297,22,0,1,0,1,0,0,2,2,2,1,5,1,0,3,1,2
8813,796761,19,2,2,2,2,0,0,2,2,0,3,0,3,2,1,1,6
8813,780109,37,8,14,5,7,3,7,8,14,4,8,2,1,1,1,1,27
8813,796758,37,9,15,7,11,2,4,4,4,4,1,3,1,0,2,1,24
8813,796757,38,9,24,6,16,3,8,3,5,3,2,4,4,4,3,0,24
8813,780794,34,2,7,1,1,1,6,0,0,2,5,2,3,1,1,0,5
8813,791103,1,0,0,0,0,0,0,0,0,0,1,0,1,1,0,0,0
8813,796760,3,1,1,1,1,0,0,0,0,0,0,0,0,0,0,0,2
8813,785597,31,1,4,0,2,1,2,0,0,0,0,1,5,1,2,0,3
8814,792197,26,7,13,6,6,1,7,0,0,0,4,0,3,0,1,0,15
8814,781132,33,0,6,0,2,0,4,3,3,0,6,1,1,3,3,1,3
8814,797517,24,4,9,4,9,0,0,0,0,2,1,0,1,0,1,0,8
8814,791940,23,3,9,3,7,0,2,4,4,1,1,0,1,1,1,0,10
8814,786534,29,4,10,2,6,2,4,0,0,1,4,6,0,0,5,0,10
8814,797521,9,3,5,3,4,0,1,0,0,1,0,0,0,0,0,0,6
8814,797519,5,0,1,0,1,0,0,1,2,0,1,0,0,0,0,0,1
8814,797522,4,0,0,0,0,0,0,0,0,1,0,1,2,0,1,0,0
8814,786539,2,0,0,0,0,0,0,0,0,0,0,0,0,0,0,0,0
8814,797520,5,1,2,1,1,0,1,1,1,0,2,0,0,0,0,0,3
8814,797518,24,2,9,1,5,1,4,0,0,3,2,6,1,1,1,0,5
8814,791938,14,1,3,1,2,0,1,1,1,0,2,1,2,0,1,0,3
8814,797516,1,0,0,0,0,0,0,0,0,0,0,0,0,0,0,0,0
8814,789070,1,0,0,0,0,0,0,2,2,0,0,0,0,0,0,0,2
8815,785495,20,2,10,2,9,0,1,2,2,0,3,2,1,1,2,1,6
8815,785958,27,9,14,8,13,1,1,4,5,2,7,0,1,3,2,0,23
8815,785659,17,3,3,3,3,0,0,0,0,0,4,4,3,3,3,0,6
8815,785494,26,2,6,2,4,0,2,0,0,0,2,4,1,0,1,0,4
8815,780698,28,5,10,4,7,1,3,1,1,0,5,7,0,3,3,0,12
8815,796704,3,0,0,0,0,0,0,0,0,0,0,0,1,0,0,0,0
8815,785490,20,4,5,2,2,2,3,0,0,1,0,0,2,1,0,1,10
8815,791034,16,1,3,0,1,1,2,0,0,1,1,1,2,0,0,1,3
8815,775377,16,1,3,1,3,0,0,0,0,2,5,0,0,0,0,2,2
8815,791033,5,1,4,1,2,0,2,0,0,0,1,0,4,0,0,0,2
8815,785486,4,1,1,1,1,0,0,0,2,0,0,0,1,0,0,0,2
8815,780427,18,7,8,6,7,1,1,1,3,1,3,1,1,0,1,0,16
8816,786846,33,4,12,4,8,0,4,0,0,1,3,3,1,3,1,0,8
8816,791575,22,2,3,2,3,0,0,3,3,1,2,0,2,0,1,0,7
8816,797046,32,2,5,0,1,2,4,3,5,0,4,2,1,0,3,1,9
8816,791579,39,7,10,2,5,5,5,1,5,0,5,5,3,6,4,0,20
8816,786387,38,7,15,6,14,1,1,3,4,3,4,0,2,2,4,0,18
8816,797047,7,1,2,1,2,0,0,1,3,0,2,0,0,1,0,1,3
8816,780400,8,0,0,0,0,0,0,0,0,1,0,0,0,0,0,0,0
8816,775515,14,3,5,1,1,2,4,0,0,0,2,0,1,0,0,0,8
8816,791577,7,0,1,0,1,0,0,0,0,0,0,0,0,0,0,0,0
8817,791883,33,4,11,2,7,2,4,3,3,3,4,1,3,3,2,1,13
8817,781066,30,2,4,2,4,0,0,0,0,1,7,6,1,0,4,0,4
8817,797594,17,2,6,1,2,1,4,0,0,0,2,3,2,0,1,0,5
8817,791884,34,10,15,4,8,6,7,2,2,0,2,2,3,0,4,0,28
8817,780695,33,5,10,1,1,4,9,1,2,0,4,0,3,1,1,1,15
8817,797598,5,1,2,1,2,0,0,0,0,2,0,0,3,0,0,0,2
8817,791885,5,0,0,0,0,0,0,0,0,0,0,1,0,0,0,0,0
8817,797596,18,2,6,1,3,1,3,0,0,1,0,1,0,0,3,1,5
8817,786496,25,0,3,0,1,0,2,0,0,0,1,2,2,2,2,0,0
8818,785224,23,3,6,0,2,3,4,1,2,0,6,0,3,1,1,1,10
8818,780879,40,8,12,5,8,3,4,0,0,2,4,1,3,1,4,2,19
8818,790767,24,2,5,1,3,1,2,0,0,0,2,2,3,0,1,0,5
8818,785743,21,3,7,3,4,0,3,0,0,0,1,3,0,3,0,0,6
8818,780875,33,2,7,2,5,0,2,1,1,0,4,4,0,1,2,0,5
8818,775785,13,1,3,1,3,0,0,0,0,1,1,1,0,0,0,0,2
8818,796324,4,0,0,0,0,0,0,0,0,0,0,0,1,0,0,0,0
8818,790769,9,0,3,0,1,0,2,0,0,0,0,2,2,0,0,0,0
8818,790768,28,7,9,3,5,4,4,1,2,0,3,1,1,3,0,1,19
8818,785226,5,0,1,0,0,0,1,0,0,0,0,0,0,0,0,0,0
8819,790821,38,5,12,4,7,1,5,2,2,3,7,1,1,1,3,1,13
8819,775585,31,1,4,1,3,0,1,1,2,1,0,3,3,1,1,0,3
8819,790822,39,10,18,7,12,3,6,5,5,0,3,1,1,0,1,1,28
8819,780982,37,3,8,2,6,1,2,1,1,3,6,0,4,1,3,0,8
8819,774980,37,3,8,3,7,0,1,0,0,0,4,7,0,0,4,0,6
8819,780445,11,0,0,0,0,0,0,0,0,0,2,0,0,0,1,0,0
8819,785365,7,0,0,0,0,0,0,0,0,0,0,0,1,0,0,0,0
8820,785243,19,7,9,7,7,0,2,1,1,0,2,0,3,0,1,1,15
8820,781027,15,1,3,0,1,1,2,0,0,0,2,2,1,0,0,0,3
8820,790788,31,3,8,1,3,2,5,2,2,1,4,2,1,3,2,0,10
8820,781028,38,5,13,4,7,1,6,2,2,0,4,3,0,1,3,1,13
8820,781026,20,1,1,0,0,1,1,0,0,0,2,0,5,1,1,0,3
8820,796347,30,4,8,3,4,1,4,0,1,1,2,1,1,1,1,1,9
8820,785242,16,0,0,0,0,0,0,0,0,1,3,3,3,3,1,0,0
8820,796348,14,2,4,2,4,0,0,1,3,0,0,1,2,1,2,0,5
8820,796349,17,2,5,1,1,1,4,2,2,0,0,1,0,0,0,0,7
8821,792378,29,3,7,3,6,0,1,4,5,5,5,0,3,2,3,1,10
8821,797890,37,4,16,3,8,1,8,5,7,3,7,0,0,2,0,0,14
8821,786746,24,4,8,1,2,3,6,0,0,0,1,3,2,1,1,0,11
8821,780178,16,1,5,1,5,0,0,0,0,1,0,1,2,0,0,0,2
8821,797883,39,1,6,1,2,0,4,4,4,0,3,2,3,1,5,0,6
8821,797888,8,0,1,0,1,0,0,0,0,0,1,0,1,0,1,0,0
8821,775075,24,3,5,3,5,0,0,0,0,2,2,0,3,0,1,1,6
8821,785744,3,0,0,0,0,0,0,1,2,1,0,0,0,0,1,0,1
8821,797885,20,3,4,3,4,0,0,1,2,0,2,1,2,0,3,0,7
8822,791524,29,6,10,5,9,1,1,1,2,4,5,4,0,2,0,0,14
8822,797139,25,6,9,6,9,0,0,5,6,3,3,2,1,2,0,0,17
8822,775394,28,3,9,3,5,0,4,0,0,3,5,2,0,1,2,0,6
8822,791526,27,3,7,2,6,1,1,2,2,1,5,1,1,0,2,2,9
8822,780272,31,4,9,2,5,2,4,0,0,0,3,5,2,1,2,0,10
8822,786354,6,0,1,0,1,0,0,0,0,0,1,0,1,1,0,0,0
8822,797141,1,0,1,0,0,0,1,0,0,0,0,0,0,0,0,0,0
8822,791523,13,0,2,0,0,0,2,0,0,0,2,2,0,2,1,0,0
8822,791525,2,1,1,0,0,1,1,0,0,0,0,0,0,0,0,0,3
8822,797137,1,0,0,0,0,0,0,0,0,0,0,0,0,0,0,0,0
8822,780273,17,1,3,0,0,1,3,0,0,0,0,1,3,1,0,0,3
8822,775592,20,4,8,1,2,3,6,6,7,0,5,2,3,0,2,0,17
8823,791839,26,4,7,4,7,0,0,2,2,4,6,3,4,0,3,0,10
8823,797444,25,0,3,0,1,0,2,4,4,1,3,1,4,1,1,0,4
8823,792381,36,3,11,2,4,1,7,0,0,0,2,3,2,0,0,0,7
8823,791842,27,4,16,1,3,3,13,5,5,2,4,0,1,0,4,0,16
8823,786616,33,3,9,3,7,0,2,0,0,1,2,1,3,1,2,0,6
8823,785322,25,5,9,0,0,5,9,0,0,0,3,0,2,1,1,1,15
8823,797442,2,0,0,0,0,0,0,0,0,0,0,0,0,0,0,0,0
8823,776341,6,0,0,0,0,0,0,0,0,0,1,0,0,0,0,0,0
8823,786736,20,0,1,0,0,0,1,0,0,0,2,2,1,2,2,0,0
8824,792167,21,5,5,5,5,0,0,3,4,2,5,0,3,0,3,0,13
8824,797767,30,1,3,0,2,1,1,0,0,0,3,11,1,1,2,0,3
8824,791372,35,5,10,2,5,3,5,1,1,0,1,3,2,0,0,0,14
8824,792164,22,3,5,1,2,2,3,1,2,0,3,1,3,0,2,0,9
8824,780974,37,8,20,8,18,0,2,4,4,2,3,3,1,2,1,0,20
8824,797766,19,5,7,5,7,0,0,3,4,5,3,2,2,1,1,0,13
8824,792169,1,0,1,0,1,0,0,0,0,0,0,0,0,0,0,0,0
8824,797765,1,0,0,0,0,0,0,0,0,0,0,0,0,0,0,0,0
8824,797772,10,0,0,0,0,0,0,0,0,0,0,2,2,0,1,0,0
8824,792163,21,5,8,2,3,3,5,0,0,1,3,0,0,1,0,0,13
8824,797764,3,0,0,0,0,0,0,0,0,0,0,0,0,0,0,0,0
8825,797616,21,3,3,3,3,0,0,4,5,2,3,0,3,0,0,1,10
8825,786493,16,1,7,1,5,0,2,2,2,1,3,2,0,0,2,0,4
8825,791881,30,2,5,0,1,2,4,0,0,0,0,5,1,0,5,0,6
8825,797613,26,3,10,0,1,3,9,0,0,1,2,2,1,0,0,2,9
8825,786420,33,4,9,1,3,3,6,0,0,0,1,1,4,2,3,0,11
8825,797618,19,3,4,3,4,0,0,3,4,1,3,0,3,0,0,0,9
8825,797617,28,6,8,3,3,3,5,0,1,0,4,1,1,1,2,0,15
8825,797614,25,2,4,2,2,0,2,0,0,0,1,2,1,2,1,0,4
8825,786492,2,0,0,0,0,0,0,0,0,0,0,0,0,0,0,0,0
8826,787996,31,2,4,2,4,0,0,1,1,0,1,0,2,0,0,0,5
8826,798962,17,3,6,3,6,0,0,1,2,0,4,0,4,1,1,1,7
8826,791717,28,4,9,3,5,1,4,4,5,1,2,1,2,1,3,0,13
8826,798963,32,3,5,3,5,0,0,1,3,0,3,0,3,0,2,0,7
8826,791718,31,2,7,1,3,1,4,0,0,0,1,3,1,1,6,0,5
8826,798966,1,0,0,0,0,0,0,0,0,0,0,0,2,0,0,0,0
8826,798964,3,1,1,1,1,0,0,1,2,0,3,0,0,0,0,0,3
8826,798968,19,5,9,2,3,3,6,2,3,1,0,1,0,0,0,0,15
8826,798961,3,1,2,1,1,0,1,0,0,1,0,0,0,0,1,0,2
8826,798965,25,1,2,1,1,0,1,1,2,1,1,0,2,0,2,0,3
8826,781446,10,1,4,1,3,0,1,1,2,0,1,1,1,0,2,0,3
8827,781658,26,1,5,1,5,0,0,0,0,3,9,0,3,1,4,0,2
8827,781656,36,6,9,6,9,0,0,3,5,4,3,3,3,0,2,2,15
8827,796962,36,8,14,6,9,2,5,2,2,1,4,2,3,0,3,1,20
8827,786798,38,1,10,1,10,0,0,2,2,0,5,1,3,0,4,0,4
8827,780129,36,2,6,1,2,1,4,5,6,0,1,1,2,1,2,0,10
8827,798206,2,0,1,0,1,0,0,0,0,0,0,0,1,0,0,0,0
8827,791263,16,2,7,2,7,0,0,2,2,2,2,2,3,1,3,0,6
8827,796967,4,0,0,0,0,0,0,0,0,0,0,0,1,0,0,0,0
8827,796964,6,0,1,0,1,0,0,0,0,0,0,0,1,0,2,0,0
8828,790930,24,1,5,1,4,0,1,0,0,2,3,1,1,1,1,0,2
8828,780358,16,3,10,3,7,0,3,0,0,3,1,1,3,0,0,2,6
8828,775011,24,1,7,0,3,1,4,0,0,2,1,1,2,1,0,0,3
8828,780357,28,1,9,1,6,0,3,2,2,0,4,2,4,5,0,0,4
8828,775018,38,9,16,3,7,6,9,5,6,0,0,2,5,1,4,0,29
8828,776004,24,5,12,3,4,2,8,3,3,2,4,1,3,2,0,1,15
8828,796480,28,2,7,2,5,0,2,1,2,1,3,1,0,3,1,0,5
8828,776270,18,2,3,1,2,1,1,0,2,1,0,1,1,0,1,0,5
8829,791416,25,7,13,7,13,0,0,5,11,3,4,0,4,0,3,0,19
8829,781614,29,1,4,0,1,1,3,2,2,0,8,2,3,1,2,0,5
8829,797096,28,2,3,1,2,1,1,1,2,0,5,1,3,1,1,0,6
8829,780100,28,4,6,2,3,2,3,2,2,0,4,4,2,0,1,1,12
8829,780096,39,1,3,1,3,0,0,4,4,0,6,4,3,1,3,0,6
8829,797094,10,1,2,1,2,0,0,0,0,0,1,1,1,0,2,2,2
8829,785907,16,3,4,3,4,0,0,1,2,1,0,0,0,0,2,0,7
8829,797093,25,6,13,5,11,1,2,4,4,1,6,1,2,2,6,0,17
8830,786635,36,9,15,8,14,1,1,7,11,3,10,3,2,0,3,0,26
8830,791822,38,2,8,1,4,1,4,0,0,1,2,2,2,0,0,0,5
8830,781543,30,3,6,1,4,2,2,0,0,1,3,2,2,2,2,0,8
8830,780642,31,3,11,3,9,0,2,4,4,1,1,5,1,2,2,2,10
8830,776449,34,5,10,5,9,0,1,0,4,0,5,1,1,1,0,0,10
8830,798157,11,3,3,3,3,0,0,0,2,0,3,1,4,1,2,1,6
8830,797383,7,0,0,0,0,0,0,0,0,0,0,0,1,0,0,0,0
8830,786182,13,2,2,1,1,1,1,0,0,0,0,1,3,0,1,1,5
8831,783072,22,2,4,2,4,0,0,0,1,0,5,1,2,0,1,0,4
8831,781463,21,2,6,2,6,0,0,0,0,3,4,4,3,0,2,0,4
8831,791540,29,2,6,1,2,1,4,1,4,0,1,2,1,0,3,0,6
8831,787782,37,9,12,7,9,2,3,0,0,0,2,4,1,2,2,1,20
8831,776068,33,8,16,6,11,2,5,0,0,0,3,1,3,2,1,0,18
8831,797817,30,4,4,4,4,0,0,4,6,0,8,2,1,1,1,0,12
8831,774879,19,1,4,1,1,0,3,6,6,1,2,0,4,0,0,0,8
8831,792153,9,0,2,0,0,0,2,0,0,0,0,0,0,0,0,0,0
8832,785664,15,1,2,1,2,0,0,1,2,2,4,1,2,0,0,0,3
8832,785841,33,7,8,5,6,2,2,2,2,3,6,1,1,1,5,0,18
8832,792869,32,6,12,2,5,4,7,0,0,0,5,3,0,0,2,1,16
8832,781504,38,5,12,4,8,1,4,1,2,1,0,4,2,0,2,0,12
8832,766623,31,1,4,1,3,0,1,1,2,0,3,0,4,1,2,0,3
8832,792232,13,2,3,2,3,0,0,0,0,0,3,0,1,0,0,0,4
8832,791312,9,1,1,1,1,0,0,0,0,1,1,0,2,0,1,4,2
8832,785840,8,0,1,0,0,0,1,0,0,0,0,0,0,0,0,0,0
8832,796611,21,3,8,2,5,1,3,0,1,2,3,3,1,1,1,1,7
8832,791313,0,0,0,0,0,0,0,0,0,0,0,0,0,0,0,0,0
8832,785848,0,0,0,0,0,0,0,0,0,0,0,0,0,0,0,0,0
8833,790961,31,2,7,2,7,0,0,2,4,6,2,2,3,3,2,0,6
8833,796553,39,4,5,4,5,0,0,0,1,1,5,1,2,1,1,0,8
8833,785278,37,7,15,2,3,5,12,0,0,0,3,0,1,0,1,0,19
8833,780146,33,5,16,5,8,0,8,2,4,3,3,1,1,0,2,0,12
8833,775860,37,4,13,3,5,1,8,1,3,1,1,2,3,4,0,0,10
8833,796556,4,0,0,0,0,0,0,0,0,0,0,0,1,0,0,0,0
8833,796554,6,1,1,1,1,0,0,0,0,1,1,0,0,0,1,1,2
8833,796555,3,0,1,0,0,0,1,0,0,0,0,0,0,0,1,0,0
8833,786240,10,0,1,0,1,0,0,0,0,0,0,0,0,0,0,0,0
8834,791785,15,1,1,1,1,0,0,0,0,0,0,1,1,0,1,0,2
8834,789048,32,5,8,5,8,0,0,0,2,4,13,3,4,0,3,0,10
8834,789046,35,6,10,1,3,5,7,2,2,0,4,3,1,2,2,0,19
8834,791786,30,4,5,0,0,4,5,4,5,0,2,3,1,1,3,0,16
8834,789041,27,2,6,2,4,0,2,4,4,0,0,2,0,1,2,0,8
8834,791787,25,6,11,5,6,1,5,0,0,4,9,1,4,1,3,0,13
8834,785540,3,0,2,0,2,0,0,0,0,0,0,0,1,0,0,0,0
8834,797631,8,0,1,0,0,0,1,0,0,0,1,0,2,0,0,0,0
8834,797630,15,1,7,0,2,1,5,0,0,0,0,2,2,0,1,0,3
8834,797629,3,0,0,0,0,0,0,0,0,0,0,2,0,0,0,0,0
8834,789044,7,1,2,1,1,0,1,0,0,0,0,0,1,0,1,1,2
8835,780229,32,4,9,4,9,0,0,1,3,2,9,3,3,1,3,0,9
8835,795572,29,6,11,5,8,1,3,1,2,0,4,1,4,1,1,0,14
8835,791483,35,5,11,2,5,3,6,5,7,0,4,3,4,1,1,1,18
8835,786322,24,4,8,2,3,2,5,3,4,0,1,0,0,1,1,0,13
8835,780228,27,2,7,0,2,2,5,0,0,0,1,0,3,0,0,0,6
8835,781592,21,1,5,1,3,0,2,1,2,1,1,1,1,1,0,1,3
8835,797195,1,0,0,0,0,0,0,0,0,0,0,0,0,0,0,0,0
8835,791488,5,0,2,0,1,0,1,0,0,0,0,0,0,0,1,0,0
8835,797194,8,0,0,0,0,0,0,0,0,0,0,0,0,0,1,0,0
8835,797193,18,1,2,1,1,0,1,1,1,1,0,1,2,1,1,0,3
8836,781605,5,2,3,2,3,0,0,0,0,1,0,0,0,0,0,0,4
8836,776424,29,1,1,0,0,1,1,4,6,0,5,1,2,1,0,3,7
8836,792300,29,6,10,6,9,0,1,0,3,0,1,5,2,0,4,0,12
8836,781607,4,0,1,0,1,0,0,0,0,0,0,1,1,0,0,0,0
8836,781603,33,5,9,4,7,1,2,2,2,0,6,2,1,0,1,0,13
8836,797914,23,4,9,0,1,4,8,2,3,1,0,1,4,1,1,0,14
8836,780456,24,3,5,1,2,2,3,2,2,0,3,2,1,0,0,1,10
8836,790813,31,4,9,1,2,3,7,2,2,0,2,2,2,2,2,0,13
8836,797912,3,0,1,0,0,0,1,0,0,0,2,1,0,0,0,0,0
8836,797907,1,1,1,1,1,0,0,0,0,1,0,0,1,0,0,0,2
8836,786618,5,0,0,0,0,0,0,0,0,1,1,1,1,0,1,0,0
8836,796155,13,0,0,0,0,0,0,0,0,0,1,0,2,1,1,0,0
8837,786447,30,3,8,2,6,1,2,3,5,1,4,2,3,1,0,1,10
8837,775074,36,6,10,6,10,0,0,5,7,5,3,0,3,0,4,3,17
8837,786448,25,1,3,0,1,1,2,1,2,0,6,1,5,0,2,0,4
8837,780731,34,3,9,3,8,0,1,4,6,0,4,2,2,1,1,0,10
8837,780462,37,10,20,8,13,2,7,3,6,2,1,2,0,1,1,0,25
8837,791632,2,0,1,0,1,0,0,0,0,0,0,0,0,0,0,0,0
8837,786132,11,0,2,0,2,0,0,0,0,0,0,1,0,1,0,0,0
8837,796971,15,1,3,1,2,0,1,0,0,0,1,0,1,0,1,0,2
8837,791631,10,1,1,1,1,0,0,0,0,2,0,0,1,1,0,0,2
8838,790856,15,2,3,2,3,0,0,2,2,2,2,0,3,0,3,1,6
8838,780452,25,1,2,1,2,0,0,2,2,3,3,1,1,0,0,1,4
8838,796408,31,3,13,3,9,0,4,6,6,1,1,2,3,3,6,1,12
8838,796409,23,3,11,1,4,2,7,4,4,0,3,1,1,1,5,0,12
8838,796411,24,9,10,9,10,0,0,2,2,5,3,0,3,1,1,4,20
8838,796410,12,0,4,0,4,0,0,3,4,3,3,0,4,0,4,1,3
8838,796413,26,3,10,0,0,3,10,4,4,0,2,3,1,2,1,1,13
8838,796407,28,1,5,1,4,0,1,4,6,3,4,4,0,2,1,0,6
8838,790858,11,1,2,1,1,0,1,0,0,0,0,0,1,1,0,0,2
8838,780450,5,0,0,0,0,0,0,0,0,0,0,0,1,1,0,0,0
8839,781300,32,5,12,4,10,1,2,6,10,3,5,2,3,2,6,1,17
8839,790803,24,4,5,4,5,0,0,0,0,4,1,1,3,1,0,3,8
8839,781305,9,1,2,0,1,1,1,0,0,0,0,0,1,0,0,0,3
8839,790801,17,1,5,1,5,0,0,1,1,0,1,0,2,0,3,0,3
8839,781304,29,3,9,3,6,0,3,3,4,1,1,2,0,3,2,0,9
8839,796360,22,5,11,5,10,0,1,2,3,4,3,2,4,6,2,1,12
8839,796363,19,2,8,1,4,1,4,0,0,1,2,0,0,1,3,0,5
8839,796364,1,0,0,0,0,0,0,0,0,0,0,0,2,0,0,0,0
8839,781302,26,4,12,2,6,2,6,0,0,1,3,1,3,1,0,0,10
8839,780598,20,1,3,1,3,0,0,1,2,2,0,0,4,2,1,0,3
8839,796362,1,0,0,0,0,0,0,0,0,0,0,0,0,0,0,0,0
8840,791923,25,2,5,2,5,0,0,6,8,1,3,1,0,0,1,3,10
8840,781122,17,3,7,3,7,0,0,4,4,2,4,0,2,1,0,0,10
8840,791925,25,7,9,6,6,1,3,0,2,1,7,1,2,1,2,0,15
8840,786527,22,1,6,1,3,0,3,0,0,1,2,3,2,2,1,0,2
8840,781112,24,2,4,2,3,0,1,3,4,0,2,1,1,1,2,0,7
8840,800210,5,0,1,0,1,0,0,0,0,1,0,0,0,0,0,0,0
8840,786529,15,1,2,1,2,0,0,0,0,1,1,0,3,0,1,0,2
8840,797541,17,2,3,2,3,0,0,4,4,2,4,0,1,2,2,2,8
8840,797543,8,0,3,0,0,0,3,0,0,0,0,0,0,1,1,0,0
8840,797542,13,4,6,1,1,3,5,1,4,0,1,1,4,0,1,0,12
8840,791927,13,2,4,0,1,2,3,2,2,0,2,1,2,2,2,0,8
8840,786858,16,1,3,0,1,1,2,2,2,0,2,2,1,0,0,0,5
8841,791512,21,2,2,2,2,0,0,1,2,1,2,2,4,0,1,2,5
8841,786338,25,2,14,0,9,2,5,2,2,7,2,1,0,0,0,0,8
8841,792050,17,0,6,0,4,0,2,0,0,0,1,1,3,0,1,0,0
8841,785347,19,3,10,3,6,0,4,0,4,0,1,1,1,2,2,0,6
8841,775601,19,2,3,1,2,1,1,6,6,0,3,0,3,0,3,0,11
8841,792045,10,0,1,0,1,0,0,0,0,1,2,0,2,0,3,0,0
8841,797648,16,5,6,4,4,1,2,0,0,2,3,0,1,0,0,1,11
8841,797647,17,1,3,1,3,0,0,0,0,0,0,0,2,1,2,0,2
8841,792052,16,3,6,3,5,0,1,1,3,0,0,1,1,0,1,0,7
8841,792047,16,2,6,2,5,0,1,2,4,1,2,1,3,0,1,0,6
8841,792051,11,1,3,1,3,0,0,0,0,1,4,1,2,0,1,1,2
8841,780862,12,1,3,0,0,1,3,0,0,0,0,0,1,0,0,0,3
8841,792048,1,0,1,0,0,0,1,0,0,0,0,0,0,0,0,0,0
8842,791980,19,3,4,2,3,1,1,1,1,1,3,0,3,1,0,3,8
8842,785972,31,3,6,3,5,0,1,2,2,2,2,3,1,0,0,2,8
8842,785967,18,4,8,4,8,0,0,3,4,0,6,0,3,0,4,0,11
8842,791977,36,6,16,2,7,4,9,0,0,0,3,1,1,2,0,0,16
8842,785973,21,2,6,2,3,0,3,3,3,0,1,2,0,0,0,0,7
8842,780160,19,0,0,0,0,0,0,0,0,3,4,3,2,3,1,2,0
8842,791976,23,1,5,1,2,0,3,6,7,1,2,1,2,0,5,1,8
8842,797800,4,0,0,0,0,0,0,0,0,0,0,0,1,0,1,0,0
8842,791978,23,2,6,1,4,1,2,0,0,0,1,1,2,3,1,0,5
8842,797801,2,0,0,0,0,0,0,0,0,1,1,0,2,0,0,0,0
8842,799649,1,1,1,1,1,0,0,0,0,0,0,0,0,0,1,0,2
8842,791979,1,0,1,0,0,0,1,0,0,0,0,0,1,0,0,0,0
8842,797803,2,0,0,0,0,0,0,0,0,0,0,0,0,0,0,0,0
8843,796372,26,4,8,4,8,0,0,3,5,5,1,1,2,0,0,0,11
8843,790814,28,3,8,3,8,0,0,0,1,4,3,3,2,0,2,0,6
8843,796377,31,2,8,2,6,0,2,0,0,0,4,0,3,1,4,0,4
8843,790815,25,0,5,0,3,0,2,0,1,1,4,0,2,1,5,0,0
8843,780176,35,3,11,1,3,2,8,2,2,1,2,4,4,1,5,0,10
8843,786013,12,1,1,1,1,0,0,2,2,0,0,1,0,0,0,0,4
8843,796378,14,1,3,0,1,1,2,2,2,1,2,1,2,1,1,0,5
8843,796374,24,1,6,1,2,0,4,0,0,2,1,1,4,1,0,0,2
8843,796375,2,0,0,0,0,0,0,1,2,0,0,0,0,0,0,0,1
8843,790817,1,0,1,0,0,0,1,0,0,0,0,0,0,0,0,0,0
8843,796373,2,0,0,0,0,0,0,0,0,0,1,0,0,0,0,0,0
8844,780615,14,1,3,1,3,0,0,0,1,0,2,1,4,0,1,0,2
8844,781624,19,4,4,3,3,1,1,0,0,1,3,0,2,0,2,1,9
8844,797925,23,4,7,1,2,3,5,2,2,1,2,2,1,0,2,0,13
8844,781420,38,8,13,5,9,3,4,3,4,0,7,7,1,2,1,0,22
8844,781405,36,13,21,7,11,6,10,0,0,0,3,5,3,1,1,0,32
8844,797924,4,0,1,0,1,0,0,0,0,0,1,1,0,1,0,0,0
8844,781417,2,0,0,0,0,0,0,0,0,1,1,0,0,0,1,0,0
8844,792246,23,3,8,3,8,0,0,2,4,3,5,1,2,0,0,1,8
8844,797920,2,0,0,0,0,0,0,0,0,0,0,0,0,0,0,0,0
8844,797930,2,0,0,0,0,0,0,0,0,0,0,0,0,0,0,0,0
8844,797933,2,0,1,0,0,0,1,0,0,0,0,0,0,0,0,0,0
8844,791701,22,5,7,5,7,0,0,0,0,1,0,3,3,0,0,1,10
8844,792245,13,0,1,0,0,0,1,0,0,0,4,1,1,0,0,0,0
8845,792288,25,2,5,2,5,0,0,0,0,3,2,0,2,1,2,0,4
8845,785227,21,4,8,4,8,0,0,3,6,3,2,0,3,1,1,1,11
8845,786237,18,2,5,1,4,1,1,2,3,1,0,1,2,0,3,0,7
8845,786232,23,5,11,4,7,1,4,2,2,0,1,1,1,0,1,0,13
8845,776309,27,4,8,4,8,0,0,1,3,1,3,1,1,2,1,0,9
8845,798077,2,0,0,0,0,0,0,0,0,0,0,0,0,0,0,0,0
8845,798072,9,1,2,1,2,0,0,0,0,0,0,0,1,0,0,0,2
8845,798067,20,0,0,0,0,0,0,0,0,0,4,0,2,0,1,2,0
8845,798084,9,0,1,0,1,0,0,2,2,1,2,1,0,0,0,0,2
8845,798068,2,0,0,0,0,0,0,0,0,0,1,0,0,0,0,0,0
8845,792278,24,7,15,3,7,4,8,3,4,1,1,1,4,1,1,0,21
8845,780287,20,3,10,1,3,2,7,2,2,0,1,1,1,0,0,0,10
8846,785532,25,6,9,6,9,0,0,0,0,2,4,0,2,1,0,0,12
8846,780063,21,1,3,1,2,0,1,0,0,0,3,4,0,0,2,0,2
8846,791055,19,1,2,1,2,0,0,0,0,1,1,4,3,0,1,0,2
8846,785530,34,4,11,3,7,1,4,3,3,0,6,2,3,0,4,0,12
8846,775926,26,5,12,2,3,3,9,0,0,0,2,1,0,0,1,1,13
8846,791057,17,1,1,1,1,0,0,3,4,1,2,1,3,0,0,0,5
8846,796734,20,2,3,1,2,1,1,0,0,2,2,1,0,0,1,0,5
8846,791280,15,3,7,1,4,2,3,2,3,0,1,1,1,0,1,0,10
8846,791058,9,1,3,1,3,0,0,0,1,0,0,0,0,0,0,0,2
8846,775573,7,0,2,0,1,0,1,0,0,0,0,0,0,1,1,0,0
8846,791059,5,0,0,0,0,0,0,0,0,0,0,0,1,0,0,0,0
8846,791056,1,0,0,0,0,0,0,0,0,0,0,0,0,0,0,0,0
8846,796733,1,0,0,0,0,0,0,0,0,0,0,0,0,0,0,0,0
8847,780094,31,2,5,1,1,1,4,0,0,2,2,1,1,0,1,0,5
8847,775142,33,8,18,8,16,0,2,5,6,1,2,1,1,1,2,0,21
8847,790843,36,5,11,2,6,3,5,4,5,0,3,1,1,1,2,0,17
8847,786212,31,9,13,7,10,2,3,0,0,3,11,1,3,5,1,0,20
8847,785392,32,3,5,3,4,0,1,1,2,0,1,3,4,1,0,0,7
8847,790844,18,2,2,2,2,0,0,0,0,0,3,1,0,1,1,1,4
8847,781563,15,0,1,0,1,0,0,0,0,0,0,2,1,0,0,0,0
8847,796914,3,0,0,0,0,0,0,0,0,0,0,1,0,0,0,0,0
8847,799986,1,0,0,0,0,0,0,0,0,0,0,0,0,0,0,0,0
8848,780676,32,2,11,1,10,1,1,3,6,2,6,2,0,4,1,0,8
8848,775533,18,3,3,3,3,0,0,1,2,3,1,0,1,0,3,2,7
8848,791756,31,3,9,3,8,0,1,0,0,0,4,4,2,1,0,0,6
8848,780992,27,4,9,3,4,1,5,0,0,0,4,1,2,0,3,0,9
8848,780677,18,4,9,1,2,3,7,6,6,0,2,0,4,0,1,0,17
8848,791754,15,1,2,1,2,0,0,0,0,0,2,0,5,0,0,0,2
8848,786157,21,4,7,4,7,0,0,0,0,2,1,0,2,1,0,1,8
8848,786150,4,1,2,1,2,0,0,0,0,1,0,0,3,0,1,0,2
8848,797348,9,1,2,1,2,0,0,1,2,0,1,3,2,0,3,0,3
8848,780673,25,0,4,0,0,0,4,0,0,0,0,1,1,2,0,0,0
8849,781174,29,3,5,3,5,0,0,4,4,5,7,0,3,0,3,0,10
8849,781159,21,0,5,0,4,0,1,1,2,2,2,3,2,0,2,2,1
8849,791001,29,2,6,2,3,0,3,3,4,0,5,1,0,1,1,0,7
8849,781215,32,6,12,5,7,1,5,0,0,0,7,1,3,3,2,1,13
8849,775255,33,2,12,1,3,1,9,2,2,1,6,2,2,0,5,0,7
8849,796644,2,0,0,0,0,0,0,0,0,0,0,0,0,0,0,0,0
8849,785320,12,1,3,1,1,0,2,0,0,1,1,0,3,0,1,0,2
8849,785231,25,4,7,2,4,2,3,3,4,0,1,1,2,1,0,0,13
8849,779972,17,1,4,0,1,1,3,2,2,0,1,0,2,0,1,1,5
8850,797873,13,0,2,0,2,0,0,0,0,1,3,1,2,2,0,0,0
8850,797877,33,6,14,6,13,0,1,3,3,5,3,4,3,1,4,1,15
8850,797872,27,3,7,3,3,0,4,0,1,1,0,1,2,0,1,0,6
8850,791338,22,1,3,0,1,1,2,1,2,1,1,4,1,2,2,0,4
8850,791339,38,7,17,5,10,2,7,8,9,2,8,2,1,2,1,0,24
8850,791337,21,1,3,1,3,0,0,3,4,3,8,0,4,0,1,3,5
8850,785881,5,0,1,0,1,0,0,0,0,0,1,0,0,0,0,0,0
8850,781599,9,2,5,2,5,0,0,0,0,0,1,0,2,0,0,1,4
8850,797875,8,0,0,0,0,0,0,2,2,1,0,0,1,0,1,0,2
8850,797874,1,0,0,0,0,0,0,0,0,0,0,0,1,0,0,0,0
8850,781595,23,2,6,1,4,1,2,0,0,0,0,3,0,1,1,0,5
8851,785948,32,6,9,6,9,0,0,8,10,3,7,1,2,0,1,0,20
8851,785946,12,0,1,0,0,0,1,0,0,0,0,0,3,1,2,0,0
8851,797634,22,0,2,0,1,0,1,0,0,1,4,0,4,1,1,0,0
8851,785939,38,5,15,2,8,3,7,4,8,0,5,0,3,2,3,0,17
8851,785938,32,3,9,2,4,1,5,0,0,0,3,7,0,2,2,0,7
8851,792026,13,1,1,1,1,0,0,3,4,1,2,0,1,0,0,0,5
8851,792025,9,0,1,0,1,0,0,0,0,0,1,0,0,0,0,0,0
8851,792023,15,0,2,0,0,0,2,0,0,0,2,3,3,0,1,0,0
8851,785941,27,4,8,1,2,3,6,0,0,0,0,0,4,0,3,2,11
8852,786432,33,6,9,4,4,2,5,0,1,1,1,0,3,2,2,0,14
8852,780440,20,4,11,1,2,3,9,0,0,0,4,0,4,1,0,0,11
8852,786431,34,2,10,0,6,2,4,2,2,0,4,5,1,0,5,0,8
8852,791621,31,1,6,1,3,0,3,0,0,0,2,2,0,0,0,0,2
8852,775620,20,1,2,1,2,0,0,0,0,1,5,0,1,1,1,1,2
8852,781125,25,4,9,4,9,0,0,3,4,2,3,0,2,0,0,0,11
8852,781088,21,1,4,0,1,1,3,0,0,1,1,3,2,0,0,0,3
8852,791620,8,0,1,0,0,0,1,0,0,0,0,0,0,0,0,0,0
8852,786434,5,0,1,0,1,0,0,0,1,0,0,0,0,0,0,0,0
8852,775622,3,0,2,0,2,0,0,0,0,0,0,0,1,0,0,0,0
8853,781558,36,6,14,5,12,1,2,6,6,4,8,3,1,0,2,1,19
8853,775248,30,6,18,3,10,3,8,0,0,4,6,1,3,0,5,1,15
8853,780993,31,7,10,7,10,0,0,0,0,2,5,0,1,0,0,1,14
8853,791452,24,3,5,1,2,2,3,0,0,0,4,3,3,0,1,0,8
8853,797225,25,2,6,2,5,0,1,0,1,0,6,4,4,1,2,0,4
8853,791449,34,1,2,1,1,0,1,0,0,0,1,0,1,0,2,0,2
8853,797231,17,1,4,1,3,0,1,0,0,1,2,0,1,0,0,0,2
8853,797230,3,0,0,0,0,0,0,0,0,0,0,0,1,0,0,0,0
8854,791355,6,0,1,0,0,0,1,0,0,0,1,0,0,0,0,0,0
8854,791352,27,3,8,1,5,2,3,1,2,1,8,2,2,0,1,0,9
8854,780455,22,7,8,7,8,0,0,4,6,6,6,0,0,1,1,1,18
8854,797247,33,3,7,3,7,0,0,2,2,0,2,4,4,2,4,0,8
8854,776297,38,4,9,3,5,1,4,3,6,1,4,3,3,3,7,0,12
8854,791354,12,2,2,2,2,0,0,2,3,0,2,0,2,1,1,0,6
8854,785837,18,4,4,3,3,1,1,2,4,1,3,0,2,0,0,0,11
8854,797251,13,0,0,0,0,0,0,0,0,0,2,1,0,0,0,0,0
8854,797249,3,1,2,1,1,0,1,0,0,0,0,0,1,0,0,0,2
8854,797248,28,3,5,0,0,3,5,0,0,1,0,2,0,0,2,0,9
8855,791306,32,3,5,3,4,0,1,0,0,3,2,3,4,1,1,0,6
8855,780210,34,6,13,6,9,0,4,5,8,2,5,0,3,2,3,1,17
8855,792432,33,7,11,4,7,3,4,3,3,0,2,2,2,2,1,0,20
8855,792427,18,0,8,0,6,0,2,0,0,0,0,0,0,1,1,0,0
8855,775005,20,2,6,1,4,1,2,0,0,0,1,2,1,1,0,0,5
8855,796592,13,0,4,0,4,0,0,0,0,5,0,1,2,1,1,0,0
8855,796594,22,2,8,1,3,1,5,2,2,0,0,1,3,3,1,0,7
8855,792433,21,4,9,0,1,4,8,0,0,0,1,1,2,0,0,0,12
8855,786422,7,0,1,0,0,0,1,0,0,1,0,0,1,0,1,0,0
8856,789058,27,5,9,2,3,3,6,0,0,1,2,0,0,1,1,1,13
8856,797898,31,5,15,3,12,2,3,0,1,2,2,9,0,1,2,1,12
8856,781374,30,4,10,3,7,1,3,3,4,0,9,2,2,2,1,0,12
8856,776337,15,2,3,2,3,0,0,1,2,0,1,1,1,0,1,1,5
8856,792240,19,1,5,1,3,0,2,2,3,2,4,0,1,0,1,0,4
8856,792237,19,2,7,1,3,1,4,2,2,0,1,1,0,1,0,0,7
8856,785818,13,2,3,1,2,1,1,0,0,1,0,0,3,0,0,0,5
8856,792236,21,2,4,2,4,0,0,0,0,3,4,1,1,0,1,0,4
8856,787239,20,1,1,1,1,0,0,0,1,4,3,0,3,0,0,2,2
8856,792238,5,0,2,0,2,0,0,0,0,0,1,0,2,0,0,0,0
8857,780166,31,6,18,4,11,2,7,1,2,0,3,8,1,0,0,0,15
8857,790969,31,3,9,2,6,1,3,2,2,1,2,4,4,1,0,0,9
8857,796566,21,3,7,3,7,0,0,3,4,3,8,0,3,1,1,0,9
8857,775107,16,3,4,1,2,2,2,0,0,1,1,2,2,1,2,0,8
8857,796568,31,3,10,3,10,0,0,0,0,1,4,1,0,0,1,0,6
8857,790967,23,2,5,1,1,1,4,2,2,0,1,0,0,0,0,0,7
8857,790971,15,1,2,1,2,0,0,0,0,0,2,0,0,0,0,0,2
8857,790968,19,0,5,0,0,0,5,0,0,1,0,0,2,1,2,0,0
8857,796569,8,0,1,0,1,0,0,0,0,1,1,0,1,0,0,0,0
8857,796564,5,0,1,0,1,0,0,0,0,2,1,0,0,0,1,0,0
8858,792265,37,9,19,5,9,4,10,2,2,3,6,1,2,0,1,0,24
8858,792266,27,3,14,1,5,2,9,2,2,1,6,3,2,1,1,0,10
8858,786152,34,5,7,5,6,0,1,1,3,1,5,1,2,1,1,0,11
8858,798003,32,6,10,4,6,2,4,5,6,2,2,8,3,3,0,0,19
8858,792267,38,1,6,1,4,0,2,2,2,0,5,1,4,2,2,0,4
8858,798007,9,0,0,0,0,0,0,0,0,1,0,0,0,0,0,1,0
8858,797998,4,0,2,0,0,0,2,0,0,0,1,0,0,0,0,0,0
8858,798006,12,0,5,0,0,0,5,0,2,0,4,2,1,0,1,0,0
8858,792263,7,1,4,0,1,1,3,0,0,0,0,1,0,0,0,0,3
8859,791135,26,5,7,5,7,0,0,3,3,4,7,2,3,0,0,1,13
8859,796791,27,5,11,2,3,3,8,0,0,0,4,0,0,0,0,0,13
8859,791132,21,4,6,1,2,3,4,0,0,2,4,0,4,0,1,0,11
8859,786090,33,8,20,6,13,2,7,5,8,1,8,2,2,2,1,3,23
8859,786088,30,1,4,1,2,0,2,1,2,1,6,7,3,1,3,1,3
8859,791133,11,0,0,0,0,0,0,0,0,0,1,1,1,1,1,0,0
8859,791134,2,0,1,0,0,0,1,0,0,0,0,0,0,0,0,0,0
8859,791131,9,0,2,0,2,0,0,0,0,0,3,0,0,0,1,0,0
8859,791521,7,0,1,0,1,0,0,0,0,0,0,0,2,0,0,2,0
8859,796790,31,4,11,1,3,3,8,2,3,0,0,1,1,0,3,0,13
8859,786092,3,0,0,0,0,0,0,0,0,0,0,0,0,0,0,0,0
8860,781453,29,9,17,5,8,4,9,0,0,1,7,8,0,5,3,1,22
8860,774869,32,6,10,1,2,5,8,0,0,0,3,1,1,2,1,0,17
8860,797970,26,7,10,5,7,2,3,0,0,1,4,6,1,1,2,0,16
8860,797972,19,5,7,4,4,1,3,2,2,0,5,1,3,0,1,1,13
8860,797967,26,1,4,1,3,0,1,0,0,1,9,3,0,0,0,0,2
8860,786098,22,5,9,4,6,1,3,2,2,2,0,1,1,0,1,0,13
8860,792254,24,3,6,3,4,0,2,2,2,1,8,1,2,0,1,0,8
8860,797962,12,0,0,0,0,0,0,0,0,1,2,2,0,0,0,0,0
8860,792256,5,0,2,0,1,0,1,0,0,0,0,0,0,1,0,0,0
8860,786106,5,0,1,0,0,0,1,0,0,0,1,0,0,0,1,0,0
8861,775455,28,6,14,6,13,0,1,2,2,1,5,1,1,0,5,0,14
8861,792124,19,3,5,3,5,0,0,2,3,1,3,0,0,2,1,0,8
8861,792123,30,2,12,0,1,2,11,0,0,0,1,0,0,2,2,0,6
8861,781397,23,1,5,1,4,0,1,0,0,0,3,2,0,0,0,0,2
8861,786005,16,0,4,0,2,0,2,1,2,2,1,0,0,0,0,0,1
8861,797749,21,2,5,1,2,1,3,0,0,0,1,0,2,0,1,0,5
8861,786003,13,1,1,1,1,0,0,1,3,0,2,0,1,1,1,0,3
8861,797747,9,1,4,1,1,0,3,0,1,1,0,0,3,0,0,0,2
8861,792119,8,1,2,1,2,0,0,0,0,1,0,1,0,0,0,0,2
8861,786002,9,0,3,0,1,0,2,1,2,0,1,0,0,0,2,0,1
8861,786008,8,0,3,0,0,0,3,0,0,0,2,0,0,0,0,0,0
8861,792120,7,0,0,0,0,0,0,0,0,0,2,0,1,1,1,0,0
8861,797754,6,0,1,0,1,0,0,0,0,0,1,0,2,0,1,0,0
8861,786009,3,0,0,0,0,0,0,0,0,0,1,0,0,0,0,0,0
8862,785591,32,10,16,6,8,4,8,8,10,0,6,1,4,2,4,0,32
8862,780258,33,2,10,2,4,0,6,6,6,0,4,2,3,2,4,0,10
8862,797662,23,3,7,2,5,1,2,1,2,2,0,0,2,0,4,1,8
8862,774898,9,1,2,0,0,1,2,0,0,0,0,0,0,0,0,0,3
8862,786067,37,1,3,1,3,0,0,0,0,0,6,1,2,0,2,3,2
8862,797660,21,2,5,2,4,0,1,1,2,0,1,0,1,1,1,0,5
8862,797661,20,2,8,1,3,1,5,0,0,0,1,0,4,1,0,0,5
8862,792079,6,0,0,0,0,0,0,1,3,0,1,0,1,0,0,0,1
8862,791952,14,0,1,0,1,0,0,0,0,1,0,0,4,0,1,0,0
8862,792082,5,0,2,0,2,0,0,0,2,1,0,0,1,1,0,0,0
8863,775651,24,5,7,3,4,2,3,3,5,2,4,0,4,0,2,1,15
8863,791627,34,4,6,2,2,2,4,3,4,0,6,4,3,3,2,0,13
8863,785665,29,4,8,1,2,3,6,0,0,2,5,1,2,1,2,0,11
8863,791070,26,2,5,1,3,1,2,5,5,0,0,1,5,2,2,1,10
8863,776178,13,0,1,0,1,0,0,0,0,0,0,1,1,0,2,0,0
8863,776253,24,4,10,3,7,1,3,3,4,0,6,2,2,2,2,0,12
8863,791071,11,3,3,3,3,0,0,1,2,0,2,0,2,2,6,0,7
8863,796501,17,1,6,0,3,1,3,0,0,0,2,2,2,0,1,0,3
8863,796505,6,1,1,1,1,0,0,0,0,0,1,0,0,0,1,0,2
8863,796502,11,0,1,0,1,0,0,0,0,2,3,0,1,0,2,0,0
8863,796504,5,0,1,0,0,0,1,0,0,0,0,0,0,1,0,0,0
8864,786547,19,0,1,0,0,0,1,0,0,2,3,2,2,0,2,0,0
8864,786544,38,6,12,4,9,2,3,6,6,3,9,1,2,0,1,2,20
8864,797507,30,4,11,2,6,2,5,0,0,0,2,0,4,1,0,2,10
8864,792012,40,11,20,5,8,6,12,13,15,0,2,2,2,2,1,1,41
8864,786546,31,2,7,2,4,0,3,1,2,0,3,3,2,0,1,3,5
8864,786860,12,0,1,0,0,0,1,2,2,0,0,0,0,0,1,0,2
8864,797509,2,0,0,0,0,0,0,0,0,0,0,0,0,0,0,1,0
8864,797510,16,3,5,2,2,1,3,0,0,0,1,3,0,1,0,0,7
8864,797508,5,0,1,0,1,0,0,0,0,0,1,0,0,0,0,0,0
8864,792013,7,0,0,0,0,0,0,0,0,0,1,1,1,1,1,0,0
8865,797779,40,3,13,0,4,3,9,1,2,2,7,0,1,0,1,1,10
8865,785568,24,0,0,0,0,0,0,0,0,1,4,3,5,1,2,1,0
8865,797778,32,7,17,4,10,3,7,1,2,2,8,0,3,0,1,1,18
8865,786256,33,4,6,4,6,0,0,4,6,4,6,2,3,0,4,2,12
8865,797774,35,11,20,2,7,9,13,1,3,1,2,2,2,1,1,1,32
8865,797770,7,2,4,2,4,0,0,0,0,2,0,1,1,0,2,0,4
8865,797780,4,1,1,1,1,0,0,0,0,0,0,0,0,1,0,0,2
8865,797776,1,0,1,0,0,0,1,0,0,0,0,0,0,0,0,0,0
8865,797768,4,1,2,0,1,1,1,0,0,0,0,0,3,0,0,0,3
8865,775106,20,0,4,0,4,0,0,0,0,0,1,1,3,0,0,0,0
8866,792067,35,3,5,2,2,1,3,4,4,0,2,4,2,3,1,0,11
8866,775523,22,5,7,5,7,0,0,4,5,1,7,0,2,2,0,0,14
8866,797649,38,6,13,3,4,3,9,7,8,0,2,1,3,1,3,0,22
8866,792058,13,2,4,2,4,0,0,2,2,0,2,0,5,1,3,1,6
8866,789028,27,6,6,5,5,1,1,3,5,0,4,4,2,4,3,0,16
8866,786836,3,1,1,1,1,0,0,0,0,0,0,0,1,0,1,0,2
8866,792062,18,2,2,2,2,0,0,1,2,0,1,0,2,0,1,0,5
8866,789053,28,4,8,3,5,1,3,1,2,0,1,8,2,0,2,0,10
8866,789029,16,1,5,1,4,0,1,1,2,1,1,1,3,1,1,0,3
8867,790951,15,0,1,0,1,0,0,2,2,0,3,0,5,0,1,1,2
8867,786309,22,3,6,0,2,3,4,0,0,0,1,0,5,0,2,0,9
8867,780087,31,6,11,6,11,0,0,4,4,0,7,1,4,1,3,0,16
8867,776076,28,4,8,4,7,0,1,4,4,0,4,3,1,1,2,1,12
8867,776136,19,1,7,1,4,0,3,3,3,0,1,3,2,0,4,0,5
8867,796543,27,2,3,2,3,0,0,5,6,2,1,1,2,1,0,2,9
8867,796540,2,0,0,0,0,0,0,2,2,1,0,0,1,0,0,0,2
8867,796545,22,6,11,5,8,1,3,3,4,0,2,0,0,1,3,0,16
8867,790952,15,0,1,0,0,0,1,0,0,0,0,0,1,1,1,0,0
8867,786089,19,1,4,1,3,0,1,2,2,0,0,3,2,0,0,0,4
8868,791988,35,7,9,7,9,0,0,3,7,1,4,0,3,0,5,0,17
8868,780077,11,1,2,0,0,1,2,0,0,0,2,2,1,0,2,0,3
8868,796507,28,2,8,2,5,0,3,1,3,0,10,0,2,0,4,2,5
8868,796503,36,3,10,2,7,1,3,0,2,1,4,5,0,0,5,1,7
8868,791989,35,6,11,4,6,2,5,2,2,1,5,1,2,1,3,0,16
8868,796509,8,0,0,0,0,0,0,0,0,0,1,0,0,0,0,0,0
8868,785292,13,0,1,0,0,0,1,0,0,0,2,2,4,1,2,0,0
8868,796506,1,0,0,0,0,0,0,0,0,0,0,0,1,0,0,0,0
8868,792443,13,0,2,0,2,0,0,0,0,0,1,1,1,0,0,1,0
8868,796508,18,2,5,0,1,2,4,0,0,1,4,0,1,0,3,0,6
8868,785258,2,0,0,0,0,0,0,0,0,0,0,0,0,0,0,0,0
8869,781081,22,3,6,3,6,0,0,0,0,3,4,0,4,0,2,0,6
8869,791864,29,6,16,6,13,0,3,0,0,2,5,0,1,2,1,0,12
8869,791863,27,2,7,2,6,0,1,0,0,1,2,2,3,2,0,0,4
8869,797472,12,3,8,2,2,1,6,0,1,0,0,0,2,0,1,0,7
8869,780965,40,2,8,2,3,0,5,2,2,1,3,6,1,4,1,0,6
8869,797473,20,0,1,0,1,0,0,0,0,0,3,0,2,1,1,3,0
8869,786791,8,2,2,2,2,0,0,0,0,1,3,1,0,0,0,0,4
8869,797470,10,1,4,1,1,0,3,4,5,0,0,0,2,0,1,0,6
8869,786592,32,3,12,2,9,1,3,3,5,1,4,1,1,1,5,0,10
8870,791723,17,3,3,3,3,0,0,4,6,1,2,1,5,0,1,0,10
8870,797310,29,4,8,3,4,1,4,7,8,1,5,5,4,2,1,0,16
8870,791724,35,3,8,2,5,1,3,4,7,0,3,0,5,0,1,1,11
8870,797308,30,1,7,0,4,1,3,1,2,0,3,2,0,0,1,0,4
8870,781617,37,3,10,3,6,0,4,2,2,0,4,0,4,0,3,0,8
8870,797312,20,2,5,2,5,0,0,1,2,5,1,0,3,0,1,0,5
8870,780706,27,3,9,2,5,1,4,2,2,0,4,2,1,1,4,0,9
8870,800056,5,0,0,0,0,0,0,0,0,0,0,0,0,0,0,0,0
8871,781516,15,1,4,1,4,0,0,2,2,1,0,0,4,1,0,0,4
8871,797331,34,3,11,2,3,1,8,2,3,1,4,1,3,0,0,0,9
8871,791737,35,4,8,1,4,3,4,0,0,0,2,6,3,0,2,0,11
8871,783524,34,4,9,2,5,2,4,6,10,2,2,5,3,2,3,0,16
8871,780561,35,2,7,2,4,0,3,7,9,1,9,0,3,0,1,0,11
8871,791734,16,4,6,4,6,0,0,2,4,1,4,0,3,1,0,1,10
8871,797332,8,0,2,0,2,0,0,0,0,0,1,1,0,0,1,0,0
8871,797333,11,1,3,0,1,1,2,2,2,1,2,1,4,0,0,0,5
8871,786223,9,1,2,0,0,1,2,0,0,0,1,0,1,1,0,0,3
8871,795372,3,0,0,0,0,0,0,0,0,0,0,0,0,0,0,0,0
8872,796860,17,2,5,2,5,0,0,2,4,3,4,0,5,2,2,0,6
8872,791187,27,4,8,4,8,0,0,5,8,1,9,1,2,1,1,5,13
8872,796856,32,4,11,1,3,3,8,3,4,1,0,1,3,0,4,1,14
8872,785650,24,1,3,1,1,0,2,2,2,0,1,1,3,0,2,0,4
8872,785649,29,9,17,6,11,3,6,1,1,0,3,4,4,0,2,0,22
8872,791183,7,2,2,2,2,0,0,3,4,2,0,0,2,1,1,0,7
8872,791185,17,0,2,0,0,0,2,1,2,1,3,0,3,3,2,0,1
8872,775208,6,1,2,1,2,0,0,2,2,0,0,1,1,0,0,1,4
8872,796861,10,1,1,0,0,1,1,0,0,0,1,0,1,1,0,0,3
8872,796857,9,0,2,0,1,0,1,0,0,0,2,0,1,0,1,0,0
8872,791184,22,1,4,1,2,0,2,0,0,0,1,4,2,0,1,0,2
8873,780569,17,5,7,5,7,0,0,2,3,2,3,0,5,0,1,1,12
8873,791695,16,0,2,0,2,0,0,3,4,1,5,0,3,1,1,0,3
8873,791696,34,3,11,3,9,0,2,6,8,2,5,0,3,1,2,1,12
8873,781556,15,1,4,1,2,0,2,2,2,0,3,0,2,1,2,0,4
8873,780565,35,6,11,6,8,0,3,5,5,0,3,6,0,0,1,0,17
8873,797433,19,0,0,0,0,0,0,3,4,1,3,0,4,0,2,1,3
8873,797432,15,0,5,0,2,0,3,4,4,2,1,1,2,1,0,0,4
8873,797436,22,4,10,1,2,3,8,2,2,0,0,1,1,1,2,0,13
8873,785824,27,4,8,1,3,3,5,1,2,0,4,0,5,1,1,0,12
8874,790761,38,3,6,2,2,1,4,6,7,2,7,4,4,1,2,0,13
8874,790764,43,15,21,13,15,2,6,5,6,1,6,0,5,1,0,1,37
8874,796322,26,4,8,4,8,0,0,0,1,3,3,3,1,1,1,3,8
8874,796319,37,2,13,1,8,1,5,3,4,0,3,3,1,2,2,1,8
8874,779993,35,0,3,0,2,0,1,1,2,0,2,6,3,1,4,0,1
8874,796320,22,1,5,1,1,0,4,1,2,0,0,1,4,1,3,0,3
8874,785219,9,0,0,0,0,0,0,0,0,0,2,0,0,0,0,0,0
8874,796321,13,1,2,1,1,0,1,1,1,0,1,0,2,0,0,0,3
8874,796323,2,0,0,0,0,0,0,0,0,0,0,0,0,0,0,0,0
8875,791534,36,6,10,5,7,1,3,3,5,4,5,0,5,1,2,1,16
8875,791533,42,5,7,5,7,0,0,4,4,2,10,3,4,1,1,0,14
8875,780301,19,2,8,1,6,1,2,0,2,3,2,0,1,1,2,0,5
8875,791528,31,4,11,4,8,0,3,1,2,2,0,3,5,1,5,0,9
8875,775045,44,9,18,8,17,1,1,6,8,0,6,4,3,2,0,0,25
8875,797124,9,2,4,2,4,0,0,0,0,1,1,0,1,0,0,0,4
8875,797127,28,1,7,1,5,0,2,0,1,1,0,0,2,0,2,0,2
8875,791531,16,1,1,0,0,1,1,2,2,1,1,2,0,0,0,0,5
8876,774846,23,3,4,3,4,0,0,4,4,1,3,2,2,1,2,3,10
8876,786558,15,2,5,2,3,0,2,0,0,0,2,1,0,0,2,0,4
8876,786194,2,0,0,0,0,0,0,0,0,0,0,0,0,0,0,0,0
8876,786187,2,0,2,0,2,0,0,0,0,0,0,0,0,0,0,0,0
8876,766611,37,8,11,4,5,4,6,1,1,2,2,3,4,0,1,1,21
8876,791376,36,5,10,3,5,2,5,2,2,0,4,0,0,3,1,1,14
8876,797272,27,3,9,2,3,1,6,0,0,1,2,2,5,1,3,0,7
8876,786185,17,1,4,1,4,0,0,0,0,2,2,2,1,0,0,2,2
8876,781480,29,5,10,3,6,2,4,0,1,0,3,3,1,0,1,1,12
8876,797273,12,1,2,1,2,0,0,0,0,0,1,2,2,0,2,0,2
8877,780874,24,3,7,0,2,3,5,2,2,2,1,0,1,2,0,1,11
8877,781326,22,5,7,5,7,0,0,0,0,1,3,1,3,0,0,0,10
8877,797870,36,6,10,4,6,2,4,5,5,0,6,5,3,1,4,0,19
8877,792210,26,1,3,1,2,0,1,0,0,0,2,3,1,1,1,0,2
8877,781323,35,5,19,4,13,1,6,8,8,0,2,2,1,3,3,0,19
8877,785430,18,1,2,1,2,0,0,3,3,4,2,0,3,2,0,0,5
8877,797868,3,1,1,1,1,0,0,0,0,0,0,0,0,0,1,0,2
8877,792215,21,3,6,1,4,2,2,0,0,0,4,1,0,0,0,0,8
8877,785638,15,0,2,0,1,0,1,0,0,0,2,0,1,0,0,0,0
8878,780095,22,5,6,5,6,0,0,0,0,2,1,1,0,1,0,1,10
8878,776321,14,4,5,4,4,0,1,1,2,0,4,3,3,1,1,0,9
8878,786081,26,2,5,2,2,0,3,2,2,0,5,2,1,1,0,0,6
8878,785431,26,2,5,1,2,1,3,0,0,0,2,5,1,4,2,0,5
8878,780232,27,5,12,2,4,3,8,2,2,1,4,3,1,0,2,1,15
8878,797917,3,0,1,0,1,0,0,0,0,1,0,0,1,0,0,1,0
8878,786020,20,6,10,6,10,0,0,3,6,1,3,0,3,1,0,0,15
8878,785356,17,0,2,0,1,0,1,0,0,0,2,2,3,0,0,0,0
8878,781328,6,0,1,0,1,0,0,0,0,1,1,0,0,0,0,0,0
8878,789019,5,0,4,0,0,0,4,0,0,0,0,0,0,0,0,0,0
8878,797918,12,1,1,0,0,1,1,0,0,0,0,0,1,0,0,0,3
8878,797911,3,0,1,0,1,0,0,0,0,0,1,0,0,0,0,0,0
8878,789040,19,1,5,0,2,1,3,4,4,2,4,0,0,1,0,0,7
8879,791115,21,0,3,0,3,0,0,0,2,1,1,0,3,0,3,0,0
8879,791118,29,4,11,3,7,1,4,3,3,2,1,0,0,0,1,0,12
8879,785947,25,1,3,0,0,1,3,0,0,0,3,0,0,0,4,1,3
8879,785676,22,0,4,0,2,0,2,0,0,0,0,1,2,0,2,0,0
8879,774974,33,4,10,4,8,0,2,1,3,0,7,4,0,0,3,1,9
8879,796771,16,1,1,1,1,0,0,3,4,0,4,0,4,0,2,0,5
8879,800022,11,1,1,1,1,0,0,1,1,0,1,2,0,0,0,0,3
8879,796768,5,1,3,0,1,1,2,0,0,0,0,0,0,0,0,0,3
8879,791117,24,0,6,0,2,0,4,2,2,1,7,1,2,1,1,0,2
8879,791116,14,3,3,2,2,1,1,3,5,0,0,0,2,0,0,0,10
8880,791356,36,9,12,8,10,1,2,2,3,1,5,1,1,0,3,1,21
8880,797431,31,1,6,0,1,1,5,4,4,1,2,4,2,0,2,0,7
8880,791680,27,2,3,0,0,2,3,0,0,1,7,1,1,1,1,0,6
8880,785812,36,7,12,5,7,2,5,4,4,0,4,2,2,0,0,0,20
8880,780104,36,5,14,4,9,1,5,1,2,0,6,3,0,2,4,0,12
8880,791682,12,0,0,0,0,0,0,0,2,2,1,0,3,0,0,1,0
8880,791683,22,4,8,4,8,0,0,3,5,0,1,3,2,0,0,0,11
8881,785522,25,1,3,1,2,0,1,0,0,1,2,0,2,1,0,0,2
8881,781247,15,0,1,0,0,0,1,0,0,0,1,0,3,0,1,0,0
8881,796947,37,10,15,8,13,2,2,1,1,0,3,3,1,3,0,0,23
8881,791249,28,7,16,4,6,3,10,0,0,3,2,1,5,0,0,0,17
8881,775358,33,5,11,4,9,1,2,2,3,0,9,4,3,1,0,0,13
8881,796949,9,4,7,4,7,0,0,0,0,2,1,1,2,0,1,0,8
8881,785523,1,0,1,0,1,0,0,0,0,0,0,0,0,0,0,0,0
8881,791250,33,2,7,1,4,1,3,0,0,1,6,4,0,1,1,1,5
8881,785521,19,4,7,0,1,4,6,0,0,0,1,0,1,0,0,0,12
8882,791011,38,6,11,5,8,1,3,1,1,1,7,3,2,0,1,1,14
8882,796671,24,3,7,3,6,0,1,1,2,2,5,0,4,2,1,2,7
8882,785337,8,2,3,2,2,0,1,0,0,0,1,0,0,0,0,0,4
8882,791594,40,5,15,5,9,0,6,4,4,3,3,5,3,1,1,0,14
8882,791013,38,2,6,2,4,0,2,7,8,0,0,4,1,2,3,0,11
8882,796670,18,1,3,1,3,0,0,0,0,3,2,0,3,0,0,1,2
8882,796668,34,5,12,0,3,5,9,0,0,1,3,2,4,1,2,0,15
8883,785631,35,2,5,2,2,0,3,1,3,0,3,3,2,0,4,2,5
8883,786248,35,2,6,2,6,0,0,3,4,3,9,0,1,1,0,1,7
8883,791200,39,6,15,6,11,0,4,9,10,0,1,1,5,2,2,0,21
8883,785630,37,5,12,3,5,2,7,2,2,1,1,2,5,1,2,0,14
8883,785632,40,5,8,5,8,0,0,2,3,3,8,0,3,2,4,0,12
8883,791199,4,0,0,0,0,0,0,0,0,0,2,0,1,0,0,0,0
8883,791198,10,1,4,1,1,0,3,0,0,0,0,0,0,0,0,0,2
8884,797562,9,1,3,1,3,0,0,1,1,1,0,0,2,1,0,0,3
8884,791766,38,3,6,2,4,1,2,0,0,0,2,3,2,0,1,0,7
8884,786230,41,12,19,6,7,6,12,2,3,1,4,3,4,0,6,0,32
8884,780604,40,7,14,7,13,0,1,7,7,1,5,2,4,1,7,0,21
8884,780602,38,5,10,5,9,0,1,7,8,1,8,3,3,1,1,2,17
8884,791768,25,3,4,3,4,0,0,4,8,1,6,3,4,0,3,2,10
8884,786460,11,2,3,2,3,0,0,0,0,2,1,0,2,0,0,0,4
8884,791767,13,1,2,1,1,0,1,0,3,0,1,1,3,1,0,0,2
8884,780603,7,2,5,1,1,1,4,0,0,0,0,0,0,0,2,0,5
8884,786071,3,0,0,0,0,0,0,0,0,0,0,0,0,0,0,0,0
8885,775806,35,4,10,3,6,1,4,7,11,4,5,3,1,2,1,0,16
8885,781011,14,4,4,4,4,0,0,0,1,1,0,0,5,1,1,0,8
8885,797601,40,11,22,7,13,4,9,0,0,0,1,6,5,0,4,0,26
8885,781012,38,2,10,1,5,1,5,2,2,0,0,4,2,4,2,0,7
8885,775119,32,3,6,2,5,1,1,4,6,2,4,8,2,1,2,0,11
8885,775188,6,0,0,0,0,0,0,0,0,1,0,0,0,0,0,1,0
8885,775563,36,12,20,11,18,1,2,3,5,3,11,1,5,1,3,1,28
8885,797604,10,0,1,0,0,0,1,0,0,0,3,1,3,2,1,0,0
8885,786466,14,3,3,0,0,3,3,0,0,1,2,0,4,0,0,0,9
8886,797313,23,2,5,1,1,1,4,0,0,1,3,0,3,0,2,0,5
8886,786569,33,6,10,6,10,0,0,6,7,2,2,2,2,1,1,2,18
8886,791726,36,3,8,2,4,1,4,0,0,0,1,1,2,2,1,0,7
8886,786273,38,3,11,2,7,1,4,0,0,2,2,5,2,1,4,3,7
8886,780773,39,6,11,5,10,1,1,12,14,0,9,4,0,1,3,0,25
8886,797315,5,0,0,0,0,0,0,0,0,0,0,0,1,0,0,0,0
8886,791728,6,1,4,1,4,0,0,0,0,1,0,0,2,0,0,0,2
8886,786272,20,0,1,0,0,0,1,0,1,1,3,0,3,1,1,0,0
8887,786404,22,3,6,3,5,0,1,0,0,0,2,0,5,2,3,0,6
8887,780378,32,4,7,4,7,0,0,0,1,4,6,2,4,0,2,0,8
8887,786378,32,4,11,1,2,3,9,2,2,0,1,0,3,2,1,0,13
8887,786374,39,7,21,7,19,0,2,4,6,3,2,2,1,2,0,1,18
8887,786253,38,2,10,2,7,0,3,2,2,0,4,0,4,3,5,0,6
8887,797062,2,0,0,0,0,0,0,0,0,0,0,0,0,0,0,0,0
8887,797065,5,0,1,0,0,0,1,0,0,1,1,0,0,0,1,0,0
8887,797061,19,2,4,2,3,0,1,1,2,3,1,0,2,0,2,0,5
8887,791562,6,0,0,0,0,0,0,0,0,0,1,0,0,0,0,0,0
8887,780381,5,0,0,0,0,0,0,0,0,0,1,0,1,0,0,0,0
8887,780121,0,0,0,0,0,0,0,0,0,0,0,0,0,0,0,0,0
8888,781007,25,6,10,6,10,0,0,0,1,3,6,2,3,0,3,3,12
8888,781322,24,3,6,0,0,3,6,0,0,0,1,1,4,0,2,0,9
8888,786571,31,5,7,4,6,1,1,0,2,0,4,5,4,2,2,0,11
8888,781419,33,3,6,1,3,2,3,2,2,0,1,4,1,2,3,0,10
8888,780563,25,3,4,2,2,1,2,3,4,0,4,2,1,0,3,0,10
8888,785989,21,6,10,5,8,1,2,1,3,2,5,2,3,1,2,1,14
8888,797299,15,3,4,3,4,0,0,1,2,2,4,0,2,0,0,0,7
8888,781207,16,1,5,0,4,1,1,2,2,0,4,1,2,0,2,1,5
8888,781439,10,0,3,0,1,0,2,0,0,0,1,2,1,2,1,0,0
8889,776462,29,3,7,3,6,0,1,1,2,2,4,1,2,0,1,0,7
8889,775642,33,4,6,4,6,0,0,0,0,3,5,0,0,2,1,2,8
8889,791629,19,1,6,1,3,0,3,0,2,0,1,1,3,0,1,0,2
8889,796974,35,4,15,2,9,2,6,2,2,0,1,0,4,0,1,0,12
8889,781199,40,11,27,5,12,6,15,13,16,1,3,3,2,4,2,0,41
8889,791626,7,0,0,0,0,0,0,0,0,0,0,0,2,0,1,0,0
8889,786720,26,1,8,1,4,0,4,2,2,2,6,2,3,1,2,1,4
8889,791628,11,0,1,0,0,0,1,0,0,2,2,0,0,0,0,0,0
8890,781530,30,7,16,4,10,3,6,2,2,2,10,2,1,1,0,1,19
8890,776423,26,3,7,3,7,0,0,0,0,1,7,1,4,0,1,2,6
8890,798096,23,7,12,6,10,1,2,3,3,0,0,3,0,3,1,0,18
8890,792307,16,0,0,0,0,0,0,2,2,0,2,1,0,3,2,0,2
8890,792319,22,2,4,0,1,2,3,2,2,0,1,3,2,0,1,0,8
8890,792314,14,4,5,4,5,0,0,0,0,2,1,0,1,1,1,2,8
8890,786296,16,1,3,1,3,0,0,0,0,0,2,1,0,0,2,0,2
8890,792320,3,0,0,0,0,0,0,0,0,0,0,0,0,0,0,0,0
8890,798106,9,1,1,1,1,0,0,1,3,0,4,3,1,0,0,0,3
8890,798104,24,3,6,3,6,0,0,3,4,0,1,1,1,0,1,0,9
8890,792309,9,0,4,0,3,0,1,0,0,0,1,0,0,0,2,0,0
8890,792321,8,0,1,0,1,0,0,0,0,0,1,0,1,1,1,1,0
8891,780913,30,10,18,5,6,5,12,3,4,1,2,2,1,1,1,1,28
8891,798119,34,4,9,2,4,2,5,0,1,0,3,0,3,0,2,0,10
8891,798117,35,3,6,1,2,2,4,0,2,0,3,8,2,1,4,1,8
8891,780594,37,3,7,2,3,1,4,0,0,0,6,2,2,3,2,0,7
8891,775664,31,2,6,0,0,2,6,0,0,1,2,3,3,1,1,0,6
8891,798123,19,2,9,2,7,0,2,1,3,3,6,2,3,2,2,1,5
8891,798124,10,0,2,0,2,0,0,0,0,0,0,1,1,0,0,0,0
8891,798121,4,0,1,0,1,0,0,0,0,0,2,0,0,0,0,0,0
8892,791230,26,3,8,1,3,2,5,2,2,0,4,2,1,0,2,1,10
8892,785557,32,4,9,4,8,0,1,2,2,0,3,0,2,1,2,1,10
8892,791227,18,2,5,1,3,1,2,0,0,0,1,1,0,0,0,0,5
8892,781201,5,1,1,1,1,0,0,0,0,0,1,0,0,1,0,0,2
8892,781198,9,3,5,3,4,0,1,0,0,0,0,1,0,1,1,0,6
8892,796935,5,1,2,0,0,1,2,0,0,1,0,0,1,0,0,0,3
8892,796933,13,1,2,1,2,0,0,4,4,3,1,2,1,2,0,0,6
8892,791228,31,7,12,6,10,1,2,5,5,1,5,0,1,0,0,0,20
8892,796932,31,5,11,4,8,1,3,12,13,0,5,5,1,1,2,0,23
8892,785624,22,0,7,0,4,0,3,2,2,4,3,6,2,2,3,1,2
8892,791226,8,1,1,1,1,0,0,0,0,0,1,0,1,0,0,0,2
8893,792186,34,9,11,9,11,0,0,1,2,2,4,1,0,1,2,1,19
8893,781447,23,2,4,1,3,1,1,4,4,2,3,0,2,0,1,1,9
8893,781490,28,4,6,3,3,1,3,3,3,0,4,1,2,2,1,0,12
8893,792188,29,1,4,1,2,0,2,1,2,1,3,0,3,1,1,0,3
8893,792183,37,7,18,5,11,2,7,5,6,0,2,5,4,1,7,0,21
8893,797821,7,0,0,0,0,0,0,0,0,0,2,0,0,0,3,1,0
8893,792187,5,0,1,0,1,0,0,0,0,0,1,2,3,0,0,0,0
8893,792185,8,1,2,0,1,1,1,0,0,0,1,1,0,0,0,0,3
8893,786675,27,8,14,7,10,1,4,0,1,0,3,1,5,0,0,0,17
8893,780433,2,0,0,0,0,0,0,0,0,0,0,0,0,0,0,0,0
8893,796255,0,0,0,0,0,0,0,0,0,0,0,0,0,0,0,0,0
8894,795730,40,6,11,3,5,3,6,2,2,0,5,1,2,1,1,0,17
8894,797802,30,3,5,2,2,1,3,0,1,0,0,3,1,4,1,0,7
8894,797809,34,3,9,3,7,0,2,2,3,3,4,0,3,0,1,0,8
8894,797807,40,8,14,8,13,0,1,3,3,1,4,5,1,0,0,0,19
8894,786058,31,3,4,2,3,1,1,2,2,0,4,3,5,2,1,0,9
8894,792264,24,1,5,1,3,0,2,2,2,0,2,2,2,0,1,1,4
8894,781113,1,0,0,0,0,0,0,0,0,0,0,0,0,0,0,0,0
8895,775910,32,2,5,2,2,0,3,7,7,6,2,2,5,0,4,2,11
8895,797561,37,3,8,0,1,3,7,0,0,1,1,0,0,0,2,0,9
8895,780020,30,3,10,1,5,2,5,4,4,1,2,2,2,0,1,0,12
8895,786451,36,4,9,3,3,1,6,0,0,5,1,3,2,0,0,0,9
8895,780600,36,2,11,0,2,2,9,0,0,0,8,2,4,1,1,0,6
8895,790888,13,2,7,1,4,1,3,0,1,2,2,0,0,0,2,0,5
8895,786456,5,1,1,1,1,0,0,0,0,0,0,0,1,0,1,0,2
8895,781577,11,0,1,0,1,0,0,1,2,0,2,1,2,0,1,0,1
8896,790810,31,3,6,3,4,0,2,1,4,3,11,0,1,1,4,2,7
8896,785362,25,8,10,8,10,0,0,4,4,3,0,1,5,0,3,3,20
8896,790808,37,2,6,2,3,0,3,7,9,2,7,3,1,0,0,0,11
8896,785361,37,3,10,2,3,1,7,0,0,1,2,4,3,0,2,1,7
8896,779997,35,4,9,4,8,0,1,6,9,1,6,2,2,0,0,0,14
8896,774854,13,2,2,2,2,0,0,0,0,2,2,0,2,0,1,1,4
8896,796370,11,1,2,0,1,1,1,0,0,0,0,1,1,0,3,0,3
8896,790809,9,2,3,1,1,1,2,0,0,0,2,0,0,0,1,0,5
8896,790811,2,0,1,0,1,0,0,0,0,0,1,0,0,0,0,0,0
8897,785298,20,4,4,4,4,0,0,1,1,2,2,0,3,0,0,1,9
8897,775224,27,3,6,3,6,0,0,2,8,5,1,3,2,2,0,0,8
8897,778046,29,2,9,1,2,1,7,0,0,0,2,2,5,0,1,0,5
8897,782121,38,5,15,4,10,1,5,2,4,0,2,3,3,2,2,0,13
8897,775793,36,7,20,4,12,3,8,1,1,4,4,1,3,0,0,0,18
8897,785302,5,0,1,0,0,0,1,0,2,0,1,0,3,0,0,0,0
8897,786594,28,1,8,0,3,1,5,0,0,0,2,1,1,0,0,0,3
8897,796598,6,0,0,0,0,0,0,0,0,0,0,0,1,1,0,0,0
8897,785485,11,1,3,1,3,0,0,0,0,0,0,0,2,0,0,0,2
8898,792131,20,2,2,1,1,1,1,8,12,3,3,0,4,1,2,1,13
8898,786838,28,9,12,9,11,0,1,3,5,2,3,0,4,3,4,1,21
8898,797736,23,1,3,0,1,1,2,2,2,3,1,1,3,1,0,0,5
8898,792132,22,1,6,0,2,1,4,1,2,1,1,1,1,0,4,0,4
8898,792127,19,0,5,0,2,0,3,0,0,0,0,2,2,0,1,0,0
8898,792128,27,1,5,1,3,0,2,3,4,1,3,1,3,2,3,0,5
8898,799908,8,0,1,0,1,0,0,0,0,0,0,0,1,0,0,0,0
8898,797739,17,2,7,1,4,1,3,1,2,2,1,1,4,2,2,1,6
8898,792126,17,2,5,1,2,1,3,0,1,0,2,1,1,0,0,0,5
8898,791668,19,2,4,1,1,1,3,1,3,0,0,1,4,1,2,0,6
8899,786624,9,2,3,2,3,0,0,0,0,1,0,0,3,0,0,0,4
8899,797405,36,3,7,3,6,0,1,6,7,1,1,2,2,1,5,2,12
8899,791834,40,7,9,0,1,7,8,4,4,0,2,4,4,1,3,0,25
8899,791833,34,3,5,2,3,1,2,7,11,1,6,0,4,2,5,0,14
8899,785920,40,6,11,4,7,2,4,3,4,0,7,4,1,2,3,0,17
8899,786623,20,2,6,2,6,0,0,1,2,2,4,2,4,1,1,0,5
8899,797404,2,0,1,0,0,0,1,0,0,0,0,1,0,0,0,0,0
8899,784077,19,0,0,0,0,0,0,1,2,0,0,1,4,0,0,0,1
8900,800091,24,0,5,0,5,0,0,1,2,1,5,2,2,0,1,0,1
8900,800005,19,1,2,1,2,0,0,0,0,0,3,0,5,0,2,0,2
8900,799129,40,4,9,2,6,2,3,2,4,0,6,4,4,1,3,2,12
8900,799130,26,2,6,1,3,1,3,0,0,0,4,0,2,1,1,0,5
8900,792634,37,4,14,2,9,2,5,1,2,0,6,7,1,1,3,0,11
8900,799135,7,0,0,0,0,0,0,0,0,0,0,0,0,0,0,0,0
8900,799133,16,1,2,0,1,1,1,0,1,0,0,0,3,0,3,0,3
8900,799134,31,8,14,5,10,3,4,1,3,0,6,2,4,0,1,1,20
8901,789177,35,6,12,6,12,0,0,4,10,6,11,2,3,2,0,3,16
8901,780227,17,2,4,2,4,0,0,1,2,1,3,0,2,0,0,0,5
8901,791340,32,5,9,4,8,1,1,5,9,3,6,4,1,1,3,0,16
8901,780181,29,6,12,3,8,3,4,5,5,1,2,0,2,0,0,0,20
8901,776089,30,2,10,2,5,0,5,1,2,0,6,4,4,1,1,0,5
8901,775758,20,0,4,0,2,0,2,0,2,0,2,0,2,0,1,0,0
8901,797261,1,0,2,0,2,0,0,0,0,0,0,0,0,0,1,0,0
8901,791336,22,2,5,2,5,0,0,0,1,1,1,2,0,0,0,0,4
8901,797264,5,0,1,0,1,0,0,0,0,0,0,0,1,0,0,0,0
8901,789178,9,1,3,1,3,0,0,0,0,0,0,0,1,0,0,0,2
8902,796996,27,4,8,4,8,0,0,3,3,3,5,2,4,1,1,0,11
8902,780471,15,3,3,3,3,0,0,0,0,0,6,1,4,2,2,1,6
8902,791613,12,3,4,2,2,1,2,0,1,1,1,0,0,0,1,0,7
8902,791608,35,6,12,1,1,5,11,3,3,0,3,1,3,4,0,0,20
8902,776011,31,7,10,5,7,2,3,3,5,0,1,5,0,1,7,1,19
8902,791610,30,4,6,4,6,0,0,2,3,2,7,5,1,2,3,0,10
8902,796994,10,1,2,0,0,1,2,0,0,0,2,2,4,0,0,0,3
8902,791612,2,0,1,0,1,0,0,0,0,0,0,1,0,0,0,0,0
8902,791611,1,0,1,0,0,0,1,0,0,0,0,1,0,0,0,0,0
8902,792071,23,1,6,1,1,0,5,0,0,1,7,1,1,1,1,0,2
8902,785680,3,0,0,0,0,0,0,0,0,0,1,0,1,0,0,0,0
8902,780417,11,3,5,2,4,1,1,0,0,0,1,0,2,0,1,0,7
8903,791440,20,4,5,4,5,0,0,0,0,3,1,1,4,1,2,0,8
8903,797019,23,0,3,0,3,0,0,3,4,1,1,6,3,0,1,0,3
8903,797016,29,1,6,0,2,1,4,0,0,1,3,0,2,5,0,0,3
8903,781378,33,6,17,4,12,2,5,3,3,3,4,3,1,1,5,0,17
8903,775267,26,5,14,0,1,5,13,0,0,0,9,3,1,2,2,0,15
8903,791443,16,1,3,1,1,0,2,2,5,0,0,0,1,0,0,0,4
8903,781629,11,0,0,0,0,0,0,0,2,0,1,0,1,1,0,0,0
8903,775739,3,0,0,0,0,0,0,0,0,0,0,0,1,0,1,0,0
8903,797015,13,0,4,0,3,0,1,0,0,1,1,0,0,1,1,0,0
8903,797013,6,1,4,1,1,0,3,0,0,0,0,0,0,0,1,0,2
8903,791441,17,2,4,1,1,1,3,1,1,0,2,0,1,1,2,0,6
8903,789009,3,0,1,0,0,0,1,0,0,0,0,0,0,0,0,0,0
8904,797325,26,2,5,2,5,0,0,2,2,2,2,1,3,1,1,1,6
8904,797329,29,3,6,2,3,1,3,0,0,2,0,1,5,1,0,1,7
8904,797327,29,0,2,0,1,0,1,0,0,0,2,0,3,1,1,0,0
8904,797323,38,7,18,4,12,3,6,11,11,0,4,5,5,1,4,0,28
8904,786236,36,10,20,9,17,1,3,4,4,1,3,1,4,2,1,0,25
8904,786246,6,0,0,0,0,0,0,0,0,0,1,1,1,0,0,0,0
8904,776478,7,0,1,0,0,0,1,0,0,1,1,0,1,1,1,0,0
8904,797322,20,2,6,1,2,1,4,0,0,0,2,0,2,0,2,0,5
8904,786233,9,0,2,0,0,0,2,0,0,0,0,0,1,0,1,0,0
8904,781002,0,0,0,0,0,0,0,0,0,0,0,0,0,0,0,0,0
8904,797330,0,0,0,0,0,0,0,0,0,0,0,0,0,0,0,0,0
8905,776279,22,1,2,0,0,1,2,0,0,0,3,0,4,0,4,1,3
8905,781505,34,5,9,3,6,2,3,2,3,3,3,1,2,0,5,0,14
8905,780353,36,3,5,3,5,0,0,10,12,4,12,1,3,2,3,0,16
8905,791317,36,5,14,4,10,1,4,6,6,0,4,7,2,3,4,0,17
8905,777573,28,5,10,2,4,3,6,1,2,0,1,1,2,0,1,0,14
8905,786222,10,3,3,3,3,0,0,1,2,1,3,0,4,0,1,0,7
8905,796649,16,3,7,1,1,2,6,0,0,0,0,2,2,0,0,0,8
8905,790851,18,0,2,0,0,0,2,2,2,1,2,6,2,0,0,0,2
8906,775640,16,1,4,1,4,0,0,0,0,1,1,0,2,0,0,0,2
8906,780919,26,2,9,2,9,0,0,8,9,2,4,0,2,1,2,0,12
8906,785803,26,2,5,2,4,0,1,0,0,1,1,0,1,2,1,0,4
8906,780920,37,10,16,8,13,2,3,4,6,2,3,6,2,1,3,1,26
8906,780914,26,2,5,2,3,0,2,0,0,0,1,1,2,0,0,0,4
8906,791142,19,2,5,1,1,1,4,0,0,0,6,0,0,0,0,0,5
8906,775816,27,3,7,2,3,1,4,3,3,1,3,1,3,0,0,0,10
8906,796797,10,0,0,0,0,0,0,0,0,0,0,1,2,0,0,1,0
8906,796799,10,3,3,2,2,1,1,0,0,0,0,0,0,0,0,0,7
8906,791141,3,0,0,0,0,0,0,0,0,0,0,0,0,0,0,0,0
8907,780283,23,2,3,2,3,0,0,3,4,1,2,2,5,0,2,0,7
8907,790925,35,1,6,1,4,0,2,1,3,2,6,2,2,1,0,0,3
8907,791456,37,7,12,4,8,3,4,8,8,0,5,1,1,0,4,0,25
8907,785476,34,4,11,3,8,1,3,0,0,0,1,4,3,1,4,0,9
8907,785474,38,2,5,1,2,1,3,2,4,0,4,0,1,1,3,0,7
8907,800121,5,0,0,0,0,0,0,0,0,0,2,0,2,0,0,0,0
8907,790926,4,0,2,0,2,0,0,0,0,0,0,0,0,0,0,0,0
8907,796470,16,5,6,5,6,0,0,0,0,2,2,0,3,0,1,1,10
8907,785480,6,0,1,0,0,0,1,0,0,0,0,0,0,0,0,0,0
8907,785478,2,0,0,0,0,0,0,0,0,0,0,0,0,0,0,0,0
8908,786550,35,3,5,2,3,1,2,9,9,2,4,2,2,0,4,1,16
8908,776054,27,5,10,3,7,2,3,0,0,1,7,0,1,2,1,2,12
8908,792007,36,6,11,6,11,0,0,4,7,2,6,1,2,2,0,0,16
8908,792009,34,5,13,4,11,1,2,0,0,0,3,2,2,0,1,1,11
8908,792006,35,8,12,8,12,0,0,1,1,0,3,8,4,0,1,0,17
8908,797506,7,0,2,0,1,0,1,0,0,0,0,0,1,0,0,0,0
8908,786552,26,2,6,2,4,0,2,0,0,2,5,3,2,0,2,0,4
8909,791750,35,4,10,3,6,1,4,0,0,1,3,0,3,1,1,1,9
8909,786177,19,0,3,0,1,0,2,0,0,1,3,0,0,0,1,0,0
8909,791752,9,1,1,1,1,0,0,0,0,1,0,0,0,0,0,0,2
8909,786179,34,6,15,6,9,0,6,3,4,2,3,3,2,1,1,0,15
8909,780238,36,10,19,8,16,2,3,0,0,1,9,2,2,1,0,0,22
8909,791749,13,0,4,0,0,0,4,0,0,0,2,0,2,1,1,0,0
8909,780244,25,0,3,0,0,0,3,0,0,0,0,1,3,1,1,1,0
8909,790773,29,7,11,6,7,1,4,6,7,1,2,0,2,2,1,1,21
8910,791760,25,8,11,5,8,3,3,1,5,9,3,0,2,0,2,0,20
8910,780256,29,4,15,3,10,1,5,1,2,2,3,2,3,1,0,1,10
8910,796879,14,0,1,0,1,0,0,0,0,1,1,0,0,2,0,0,0
8910,796880,30,4,11,2,5,2,6,3,3,1,5,4,2,2,2,0,13
8910,791334,26,6,13,5,6,1,7,1,2,0,8,2,0,0,1,0,14
8910,785874,15,1,2,1,2,0,0,0,0,0,3,0,4,0,1,0,2
8910,796885,5,0,0,0,0,0,0,2,2,0,0,0,0,0,1,0,2
8910,796883,26,2,8,2,4,0,4,4,4,0,1,2,1,1,2,0,8
8910,791757,19,3,6,1,3,2,3,0,1,1,1,2,2,0,2,0,8
8910,781590,11,1,1,1,1,0,0,0,0,1,0,1,0,0,1,0,2
8911,774812,16,5,8,4,7,1,1,2,4,1,1,1,4,0,1,1,13
8911,797180,36,5,9,2,2,3,7,0,0,0,7,0,2,1,1,2,13
8911,791497,26,5,9,3,5,2,4,0,0,0,6,1,3,0,2,0,12
8911,781486,34,6,14,4,10,2,4,6,7,2,5,3,3,1,3,0,20
8911,780461,38,3,7,3,5,0,2,2,2,0,2,5,3,2,4,0,8
8911,791500,15,2,3,2,3,0,0,2,2,1,1,0,2,2,1,0,6
8911,791498,8,1,4,1,4,0,0,0,2,0,0,0,0,0,0,0,2
8911,790517,1,0,0,0,0,0,0,0,0,0,0,0,0,0,0,0,0
8911,791503,14,0,0,0,0,0,0,0,0,0,2,0,2,0,0,0,0
8911,780240,12,1,2,1,2,0,0,0,0,0,1,0,1,1,1,0,2
8912,776344,30,3,9,3,9,0,0,2,2,2,4,1,2,2,1,0,8
8912,775821,18,4,7,2,3,2,4,1,2,0,2,1,4,0,2,1,11
8912,792453,32,8,16,7,14,1,2,4,5,1,1,5,0,1,2,0,21
8912,776233,22,1,4,1,2,0,2,5,6,1,3,0,0,1,1,0,7
8912,781538,26,0,5,0,2,0,3,0,0,0,3,2,3,0,0,0,0
8912,798113,19,2,5,2,5,0,0,0,0,4,7,1,5,0,2,1,4
8912,785152,13,0,0,0,0,0,0,1,2,0,1,0,2,0,1,0,1
8912,798115,11,2,3,0,0,2,3,0,0,0,1,1,0,0,1,0,6
8912,785131,29,4,7,2,4,2,3,0,0,1,4,1,1,2,1,1,10
8913,786704,24,6,11,6,11,0,0,5,7,3,3,0,4,1,2,0,17
8913,785395,26,1,3,1,3,0,0,1,2,0,5,1,2,0,1,0,3
8913,775840,39,3,11,1,3,2,8,0,0,3,5,1,2,3,3,0,8
8913,775955,37,7,15,6,12,1,3,2,3,1,0,4,5,1,6,1,17
8913,775811,13,0,1,0,1,0,0,0,0,0,0,0,3,2,2,1,0
8913,792327,3,0,0,0,0,0,0,0,0,0,1,0,0,0,0,0,0
8913,786706,13,1,1,1,1,0,0,2,2,0,1,0,0,0,0,0,4
8913,786703,10,0,2,0,0,0,2,0,0,0,3,0,0,1,0,0,0
8913,775287,14,0,4,0,2,0,2,0,0,1,0,0,1,1,0,0,0
8913,786702,21,1,4,0,3,1,1,0,0,1,2,0,0,0,2,0,3
8918,792708,1,0,0,0,0,0,0,0,0,0,0,0,0,0,0,0,0
8918,780867,4,2,2,1,1,1,1,0,0,0,1,0,2,0,3,0,5
8918,781107,26,0,0,0,0,0,0,1,4,1,6,0,2,3,0,2,1
8918,780873,1,0,0,0,0,0,0,0,0,0,0,0,0,0,1,0,0
8918,780863,33,7,18,5,13,2,5,3,4,0,5,6,0,2,4,3,19
8918,791972,34,3,8,2,3,1,5,2,2,1,2,2,3,0,1,0,9
8918,796777,31,6,8,4,4,2,4,5,7,1,2,2,1,1,1,0,19
8918,791974,34,4,8,4,6,0,2,2,2,1,3,1,1,0,2,0,10
8918,796780,20,2,6,0,2,2,4,0,2,0,2,0,3,0,1,0,6
8918,796778,16,2,7,1,4,1,3,0,0,2,1,0,5,1,2,1,5
8919,785518,29,3,10,3,8,0,2,4,5,4,3,10,2,2,3,0,10
8919,796390,21,5,8,5,8,0,0,1,2,2,5,0,3,1,0,1,11
8919,790832,28,5,11,1,3,4,8,3,4,2,5,2,4,2,1,0,17
8919,790834,20,3,10,2,4,1,6,0,0,0,3,1,2,0,2,0,7
8919,785451,30,6,15,4,7,2,8,0,0,3,1,1,0,2,3,0,14
8919,790833,22,1,5,1,3,0,2,1,2,1,4,3,1,0,1,1,3
8919,790831,18,6,8,6,8,0,0,2,2,2,1,2,2,0,2,0,14
8919,790830,26,1,3,1,3,0,0,2,2,2,3,1,3,1,2,0,4
8919,800099,1,0,0,0,0,0,0,0,0,0,1,0,0,0,1,0,0
8919,785379,5,0,0,0,0,0,0,0,0,0,0,2,0,0,0,0,0
8920,798963,26,4,9,4,8,0,1,1,4,0,2,5,1,0,2,0,9
8920,787996,29,2,4,2,4,0,0,3,3,1,6,0,2,0,2,0,7
8920,791718,35,2,8,0,2,2,6,0,0,0,1,1,2,0,2,0,6
8920,798962,27,0,4,0,4,0,0,4,6,1,6,1,3,1,1,0,4
8920,791717,16,2,5,2,4,0,1,0,0,2,3,1,4,0,1,1,4
8920,798968,22,5,7,2,3,3,4,0,3,1,3,0,4,0,0,0,13
8920,781446,21,2,5,1,3,1,2,2,2,0,0,1,0,0,1,0,7
8920,798965,14,2,6,2,5,0,1,0,0,1,1,0,2,0,0,0,4
8920,798961,4,0,0,0,0,0,0,2,2,0,1,0,0,0,1,0,2
8920,798964,4,1,1,1,1,0,0,0,0,0,0,0,2,0,2,0,2
8920,798966,2,0,0,0,0,0,0,0,0,0,0,0,0,0,0,0,0
8921,786798,39,7,12,6,11,1,1,5,8,3,3,2,1,2,2,0,20
8921,781656,29,5,7,5,7,0,0,1,1,0,8,3,4,0,2,1,11
8921,781658,31,3,5,3,5,0,0,1,3,0,1,0,4,0,1,0,7
8921,796962,40,2,7,1,1,1,6,0,0,0,4,3,1,1,4,0,5
8921,780129,19,1,3,0,2,1,1,1,2,0,1,2,4,0,2,0,4
8921,791264,17,3,4,3,4,0,0,3,5,0,1,1,3,1,0,0,9
8921,791263,17,3,6,3,6,0,0,1,3,0,3,1,2,0,1,0,7
8921,790256,4,0,0,0,0,0,0,0,2,0,1,0,1,0,0,0,0
8921,796967,2,0,0,0,0,0,0,0,0,0,0,0,1,0,1,0,0
8921,798206,2,0,1,0,0,0,1,0,0,0,1,1,0,0,1,0,0
8922,792417,27,5,7,5,7,0,0,4,4,2,5,3,5,0,3,1,14
8922,786861,36,3,7,2,3,1,4,6,6,0,3,1,3,0,0,0,13
8922,786867,40,6,10,2,4,4,6,1,4,0,1,0,2,0,0,0,17
8922,780387,22,3,6,3,5,0,1,5,7,0,1,3,4,2,1,1,11
8922,767033,40,8,17,6,10,2,7,2,2,1,4,4,3,2,3,0,20
8922,792416,18,1,1,1,1,0,0,2,2,0,2,1,2,0,0,0,4
8922,786866,16,1,3,0,1,1,2,1,2,0,1,0,1,2,2,0,4
8922,785801,1,0,0,0,0,0,0,0,0,0,0,0,0,0,0,0,0
8923,781134,38,4,7,4,5,0,2,8,9,1,3,2,3,3,3,0,16
8923,774874,30,5,7,5,7,0,0,2,3,0,1,2,4,2,2,0,12
8923,796531,38,5,11,5,9,0,2,2,2,1,7,7,2,1,4,1,12
8923,786475,34,5,8,3,3,2,5,6,7,0,6,1,3,1,4,0,18
8923,785270,37,4,9,2,4,2,5,2,5,0,1,0,2,0,0,0,12
8923,780085,12,0,0,0,0,0,0,0,0,0,3,0,1,0,0,0,0
8923,790946,0,0,0,0,0,0,0,0,0,0,0,0,1,0,0,0,0
8923,780084,3,0,1,0,0,0,1,2,2,0,0,0,0,0,0,0,2
8923,775468,8,2,2,1,1,1,1,0,0,0,0,0,4,0,0,0,5
8923,786037,0,0,0,0,0,0,0,0,0,0,0,0,0,0,0,0,0
8924,776100,23,5,6,4,4,1,2,7,8,3,1,1,1,1,0,1,18
8924,785991,25,9,13,9,12,0,1,1,5,4,10,1,0,3,0,1,19
8924,792133,32,4,14,1,6,3,8,0,0,1,1,5,1,2,0,0,11
8924,797762,29,3,7,3,7,0,0,2,2,1,4,4,1,2,2,0,8
8924,781406,30,5,12,4,10,1,2,0,0,2,4,2,1,1,2,0,11
8924,797760,17,3,7,2,4,1,3,2,2,3,3,1,1,0,1,0,9
8924,792129,11,3,3,3,3,0,0,0,0,2,2,0,1,0,0,1,6
8924,797758,11,2,5,2,4,0,1,1,3,1,3,0,1,0,4,0,5
8924,792130,5,0,1,0,1,0,0,0,0,0,1,0,0,1,0,0,0
8924,785997,2,0,1,0,0,0,1,0,0,0,0,0,0,0,0,0,0
8924,775317,15,1,2,0,1,1,1,1,2,1,1,1,1,2,1,1,4
8925,791266,20,3,3,3,3,0,0,0,0,2,2,1,3,1,3,2,6
8925,785977,26,6,15,5,10,1,5,0,0,2,5,2,2,1,2,1,13
8925,791265,25,4,10,1,4,3,6,0,0,0,4,6,0,1,2,0,11
8925,791269,22,0,4,0,1,0,3,0,0,0,0,0,2,1,2,0,0
8925,781294,20,0,2,0,1,0,1,0,0,2,0,1,3,0,1,0,0
8925,797879,2,0,1,0,0,0,1,0,0,1,0,0,2,0,0,1,0
8925,796523,11,2,6,0,1,2,5,0,0,0,1,0,1,0,0,0,6
8925,796522,22,3,7,0,1,3,6,0,0,0,0,1,0,1,2,0,9
8925,796525,7,1,3,1,2,0,1,2,2,0,2,0,1,1,0,0,4
8925,791270,8,0,1,0,1,0,0,0,0,0,0,0,0,0,1,0,0
8925,791271,19,3,4,3,4,0,0,0,0,2,6,0,2,0,3,2,6
8925,781313,18,1,7,0,4,1,3,0,0,0,0,3,1,0,2,0,3
8926,780192,32,6,10,4,6,2,4,5,6,1,5,1,1,0,1,1,19
8926,780186,28,2,3,2,3,0,0,1,4,2,7,2,1,0,1,0,5
8926,780188,8,1,2,1,1,0,1,0,0,0,1,0,2,1,0,0,2
8926,780184,13,0,1,0,0,0,1,0,0,0,1,2,3,0,2,0,0
8926,780182,34,2,11,0,2,2,9,3,4,1,7,5,2,2,4,0,9
8926,796585,11,1,1,1,1,0,0,0,1,1,2,0,3,0,0,0,2
8926,798138,8,0,0,0,0,0,0,0,0,0,0,0,0,0,0,0,0
8926,798139,24,4,12,3,8,1,4,0,0,0,2,0,0,0,0,0,9
8926,786820,8,1,2,1,1,0,1,0,0,0,1,0,0,0,0,0,2
8926,786818,34,4,8,3,5,1,3,0,0,2,1,0,1,0,2,0,9
8927,780282,26,3,7,3,7,0,0,0,0,2,5,3,2,0,1,0,6
8927,780277,32,5,15,4,11,1,4,2,4,6,6,0,2,2,0,2,13
8927,791002,29,1,3,0,1,1,2,0,0,0,0,4,1,1,2,0,3
8927,785327,32,4,7,1,1,3,6,0,0,0,1,0,3,2,0,0,11
8927,780280,32,7,14,5,12,2,2,0,0,1,8,2,3,2,2,1,16
8927,785329,14,1,4,1,1,0,3,0,0,1,2,0,1,0,0,0,2
8927,796662,9,0,2,0,2,0,0,0,0,0,0,0,2,0,0,0,0
8927,785330,16,2,6,2,6,0,0,0,1,1,1,0,0,0,1,0,4
8927,785326,4,0,1,0,0,0,1,0,0,0,0,0,0,1,0,0,0
8927,780279,6,0,2,0,1,0,1,0,0,0,0,1,0,0,1,0,0
8928,785409,32,4,7,4,7,0,0,2,2,1,2,0,4,0,2,6,10
8928,785408,38,5,13,3,9,2,4,3,5,2,7,5,3,2,0,0,15
8928,785407,23,4,7,4,7,0,0,5,8,1,2,0,5,0,1,1,13
8928,796416,38,1,8,0,1,1,7,3,4,0,5,2,1,2,0,0,6
8928,790861,14,1,2,1,1,0,1,1,2,1,0,1,0,0,2,0,3
8928,796415,19,0,3,0,2,0,1,2,4,2,3,3,3,2,2,0,2
8928,780539,29,2,5,0,2,2,3,8,9,0,2,1,2,0,2,0,14
8928,796418,7,1,1,1,1,0,0,0,0,0,2,0,2,0,0,1,2
8929,791876,38,4,13,4,12,0,1,7,8,5,7,1,3,2,3,1,15
8929,791877,7,1,3,1,3,0,0,0,0,1,1,0,4,0,1,0,2
8929,797486,38,6,11,5,9,1,2,5,7,1,3,5,4,1,1,0,18
8929,785667,18,0,4,0,4,0,0,1,2,1,2,0,3,1,2,0,1
8929,780436,38,3,10,2,5,1,5,2,5,2,3,3,2,1,2,0,9
8929,781205,33,5,10,5,10,0,0,1,2,5,6,0,3,0,1,2,11
8929,797491,19,1,5,0,3,1,2,0,2,2,0,1,2,0,1,1,3
8929,790396,2,0,0,0,0,0,0,0,0,0,1,0,1,0,0,0,0
8929,791878,5,0,1,0,0,0,1,2,2,1,1,0,1,0,1,0,2
8929,797487,2,0,1,0,1,0,0,1,2,1,0,0,1,0,0,0,1
8930,785287,18,3,3,3,3,0,0,2,2,2,1,2,2,1,0,2,8
8930,776286,20,5,6,5,5,0,1,0,1,2,3,1,0,0,0,0,10
8930,791445,28,2,10,2,3,0,7,2,2,0,4,7,1,3,1,0,6
8930,785357,20,8,16,2,4,6,12,0,0,0,1,1,1,2,1,0,22
8930,775560,26,6,8,2,3,4,5,0,0,3,5,6,3,1,0,0,16
8930,781627,18,5,7,5,6,0,1,0,0,1,2,1,1,2,1,2,10
8930,797010,20,3,6,1,3,2,3,0,0,1,1,4,2,0,0,0,8
8930,797012,15,2,2,2,2,0,0,1,1,0,1,4,1,1,1,0,5
8930,775557,14,1,1,1,1,0,0,0,0,0,2,0,3,1,0,2,2
8930,785895,11,3,4,0,0,3,4,0,0,0,1,0,2,0,0,0,9
8930,791444,8,0,0,0,0,0,0,0,0,0,3,1,0,0,0,0,0
8930,797011,2,1,2,1,2,0,0,0,0,0,0,0,0,0,0,0,2
8931,792235,22,2,3,2,3,0,0,1,3,1,1,0,1,0,1,0,5
8931,797646,35,4,9,3,7,1,2,1,3,0,2,0,1,1,3,0,10
8931,785990,35,3,8,1,4,2,4,3,4,1,6,4,2,0,2,0,11
8931,780849,25,2,8,0,2,2,6,0,0,1,0,0,2,1,2,0,6
8931,780853,29,3,9,2,7,1,2,2,3,0,0,5,1,0,1,0,9
8931,786010,17,2,5,1,2,1,3,0,0,0,3,1,2,0,3,0,5
8931,780776,18,2,5,2,5,0,0,0,0,2,0,0,0,1,0,1,4
8931,792039,17,1,5,1,4,0,1,0,0,2,3,1,0,0,2,0,2
8931,786001,2,0,0,0,0,0,0,0,0,0,0,1,0,0,0,0,0
8932,792486,16,3,3,3,3,0,0,2,3,1,2,2,3,1,1,0,8
8932,780544,12,1,1,1,1,0,0,1,1,1,2,0,1,0,1,1,3
8932,797419,30,0,0,0,0,0,0,1,3,0,0,2,3,3,3,0,1
8932,792482,31,2,9,1,3,1,6,2,4,2,2,2,0,1,1,0,7
8932,785778,28,3,4,3,4,0,0,3,3,2,7,1,2,1,4,0,9
8932,792481,27,6,11,6,10,0,1,3,4,0,4,2,2,0,3,1,15
8932,792488,24,2,5,2,3,0,2,3,4,1,0,2,2,1,4,0,7
8932,785774,3,0,0,0,0,0,0,0,0,0,1,0,0,1,0,0,0
8932,785766,29,5,12,3,6,2,6,4,4,2,2,0,2,1,1,0,16
8933,791548,37,6,13,3,8,3,5,6,10,3,3,1,3,2,3,1,21
8933,791550,35,3,8,3,8,0,0,1,2,4,5,2,3,1,4,0,7
8933,786364,39,4,6,1,1,3,5,0,0,0,2,4,3,4,1,0,11
8933,780330,16,2,4,2,4,0,0,0,0,0,1,2,3,0,1,0,4
8933,780329,24,1,4,1,2,0,2,2,2,0,0,1,4,1,4,0,4
8933,797082,3,0,0,0,0,0,0,0,0,1,0,0,3,0,1,0,0
8933,780332,2,0,0,0,0,0,0,0,0,0,0,0,3,0,2,0,0
8933,791552,25,4,11,3,7,1,4,2,2,1,4,1,1,1,2,1,11
8933,786368,19,0,2,0,0,0,2,0,0,0,0,1,2,0,0,0,0
8934,786547,20,2,8,1,3,1,5,0,0,0,3,1,2,1,0,1,5
8934,786544,25,3,4,3,4,0,0,6,6,1,11,2,2,0,2,2,12
8934,797507,20,5,8,3,6,2,2,0,0,2,0,2,1,1,0,2,12
8934,792012,25,7,11,4,5,3,6,8,8,0,3,3,2,3,2,0,25
8934,786546,19,3,4,3,3,0,1,0,0,0,0,2,3,1,0,0,6
8934,797512,8,2,3,2,3,0,0,0,2,1,3,0,1,0,0,0,4
8934,786860,12,1,1,0,0,1,1,0,1,0,2,0,4,0,0,0,3
8934,797509,15,1,6,1,6,0,0,0,1,2,7,0,3,0,0,0,2
8934,797511,6,1,3,0,1,1,2,2,2,0,1,1,2,0,0,1,5
8934,797510,14,1,3,0,0,1,3,0,0,0,1,1,1,1,3,0,3
8934,797508,15,3,6,2,3,1,3,2,2,0,2,1,4,0,3,0,9
8934,792013,11,3,4,3,3,0,1,0,1,1,3,1,1,1,3,0,6
8934,787622,10,1,4,0,0,1,4,0,0,0,0,0,2,1,2,0,3
8935,797779,23,1,9,0,3,1,6,0,0,2,0,0,0,0,1,0,3
8935,785568,20,3,4,3,4,0,0,2,2,2,0,0,3,1,1,0,8
8935,797778,21,1,4,1,1,0,3,2,2,2,7,0,3,0,3,0,4
8935,786256,11,0,5,0,5,0,0,0,0,1,1,0,2,0,3,0,0
8935,797774,25,5,11,5,7,0,4,8,9,1,3,4,0,0,1,0,18
8935,797770,15,2,7,2,7,0,0,6,8,4,3,0,0,1,2,2,10
8935,797781,4,0,2,0,2,0,0,0,0,0,0,0,0,0,0,0,0
8935,797780,7,0,2,0,1,0,1,0,0,0,1,0,2,0,0,0,0
8935,797776,16,1,6,1,4,0,2,3,8,1,4,0,1,2,0,0,5
8935,797775,8,0,1,0,0,0,1,0,2,0,1,0,2,0,0,0,0
8935,797771,19,2,4,0,1,2,3,0,0,1,4,0,4,0,0,0,6
8935,797768,16,0,4,0,1,0,3,2,6,0,2,1,2,1,1,0,2
8935,775106,15,1,5,1,4,0,1,1,3,0,2,2,4,0,2,0,3
8936,797205,13,5,7,3,4,2,3,1,1,0,2,0,0,0,0,0,13
8936,786316,21,3,10,3,10,0,0,1,2,3,3,0,0,0,1,2,7
8936,791477,33,4,11,0,6,4,5,0,1,2,4,4,2,2,0,0,12
8936,791476,35,2,8,1,3,1,5,2,2,0,8,3,2,1,1,0,7
8936,780220,34,5,15,4,11,1,4,0,0,1,4,6,2,0,3,0,11
8936,797206,24,4,9,4,9,0,0,0,1,2,1,0,4,0,1,0,8
8936,791473,6,0,0,0,0,0,0,0,0,0,2,1,0,0,0,0,0
8936,786314,26,2,6,1,2,1,4,0,0,2,3,2,0,1,1,0,5
8936,791475,8,3,3,2,2,1,1,0,0,1,0,0,0,0,0,0,7
8937,798342,29,6,7,2,2,4,5,0,0,0,6,1,2,1,2,0,16
8937,791465,24,6,8,6,8,0,0,1,1,1,6,2,3,0,2,1,13
8937,791464,22,2,6,1,3,1,3,1,1,0,2,4,0,0,0,0,6
8937,786304,30,3,8,1,3,2,5,2,2,0,2,2,1,0,0,0,10
8937,780197,35,3,13,2,8,1,5,2,2,0,2,2,1,1,2,0,9
8937,786303,10,1,2,1,2,0,0,0,0,0,4,0,3,0,1,0,2
8937,780200,6,0,0,0,0,0,0,0,0,0,2,1,1,0,0,0,0
8937,780616,11,2,4,1,2,1,2,0,0,1,0,0,0,0,0,0,5
8937,798343,3,0,1,0,1,0,0,0,0,0,0,0,0,0,0,0,0
8937,780196,30,2,7,0,2,2,5,4,4,0,6,3,1,1,1,0,10
8940,785498,26,5,8,5,8,0,0,3,5,2,4,1,1,1,0,1,13
8940,776469,36,6,9,6,9,0,0,0,2,3,8,5,0,0,3,0,12
8940,796705,39,7,14,3,5,4,9,2,2,0,5,4,3,1,3,0,20
8940,796708,26,2,6,1,2,1,4,1,2,0,0,3,1,2,3,1,6
8940,776322,36,5,10,2,5,3,5,2,3,0,2,1,1,1,1,0,15
8940,796706,7,0,2,0,0,0,2,0,0,0,1,0,2,0,0,0,0
8940,781169,21,2,5,0,1,2,4,1,6,2,2,1,1,1,0,0,7
8940,791036,9,0,0,0,0,0,0,0,0,0,2,0,1,0,0,0,0
8940,780700,0,0,0,0,0,0,0,0,0,0,0,0,0,0,0,0,0
8941,791981,37,7,15,7,11,0,4,2,2,7,9,1,2,1,3,1,16
8941,780342,30,2,8,2,4,0,4,0,0,1,5,1,5,0,2,0,4
8941,791982,33,5,13,5,7,0,6,0,0,0,2,1,1,0,0,0,10
8941,780333,37,4,12,3,7,1,5,5,6,1,4,2,1,0,2,0,14
8941,781493,29,4,12,4,6,0,6,2,2,1,0,1,3,0,1,0,10
8941,786756,16,1,1,0,0,1,1,2,2,0,0,0,1,0,0,0,5
8941,791986,6,0,1,0,1,0,0,0,0,0,1,0,0,0,0,0,0
8941,786755,12,1,3,1,2,0,1,0,0,0,1,0,1,1,0,0,2
8942,785836,38,6,15,4,8,2,7,0,0,2,6,0,2,0,0,0,14
8942,785833,38,6,13,4,7,2,6,2,2,1,3,2,3,2,1,1,16
8942,791707,40,2,6,2,4,0,2,2,2,1,4,6,4,3,0,0,6
8942,791704,38,5,11,5,11,0,0,4,9,3,4,1,5,0,0,0,14
8942,785892,15,0,8,0,6,0,2,0,0,0,1,1,0,0,0,0,0
8942,775872,6,1,1,0,0,1,1,0,0,0,0,0,1,0,0,0,3
8942,785332,10,1,3,1,3,0,0,1,1,1,0,0,0,0,0,0,3
8942,797533,15,0,3,0,1,0,2,8,11,1,1,0,3,1,0,0,8
8943,791606,32,5,6,4,5,1,1,0,0,0,7,1,4,0,1,1,11
8943,786410,35,1,4,1,4,0,0,2,2,1,2,1,3,0,1,0,4
8943,775095,12,3,6,3,6,0,0,1,1,1,3,0,0,0,0,3,7
8943,786406,25,3,7,2,4,1,3,2,2,3,0,3,3,0,3,0,9
8943,780414,33,10,16,8,12,2,4,6,11,0,7,2,2,0,5,0,28
8943,797020,2,0,0,0,0,0,0,0,0,0,0,0,1,0,0,0,0
8943,792392,18,0,2,0,2,0,0,0,0,1,3,2,2,0,0,0,0
8943,797021,16,2,2,2,2,0,0,1,2,0,1,0,3,0,0,0,5
8943,791605,22,2,4,1,1,1,3,0,0,0,4,1,4,0,1,0,5
8943,791603,5,1,2,0,0,1,2,0,0,0,3,0,0,0,0,0,3
8944,791585,30,2,5,1,3,1,2,2,2,0,8,5,1,0,2,0,7
8944,791581,35,4,6,2,3,2,3,0,0,0,2,2,1,0,0,0,10
8944,786395,34,4,11,3,6,1,5,13,13,1,5,3,2,1,1,1,22
8944,786394,31,4,10,3,7,1,3,4,4,1,5,0,4,1,2,0,13
8944,780404,34,4,5,3,4,1,1,2,3,0,3,3,2,1,1,1,11
8944,780062,11,1,3,1,3,0,0,2,2,0,2,0,4,0,1,2,4
8944,785228,22,2,3,0,1,2,2,0,0,0,3,0,2,0,0,0,6
8944,780403,3,0,0,0,0,0,0,0,0,0,0,0,0,0,0,0,0
8945,790828,4,0,1,0,1,0,0,0,0,0,0,0,1,0,1,0,0
8945,785373,39,2,5,0,0,2,5,1,2,2,4,1,2,0,1,1,7
8945,785372,36,4,16,4,12,0,4,3,4,3,3,4,1,0,2,0,11
8945,790825,20,2,7,1,3,1,4,0,0,1,0,1,4,0,1,0,5
8945,774905,37,3,13,1,5,2,8,4,4,2,4,4,4,1,2,1,12
8945,785374,1,0,0,0,0,0,0,0,0,0,1,0,0,0,0,0,0
8945,786384,26,4,8,1,2,3,6,0,2,3,5,1,2,0,0,0,11
8945,796385,11,1,3,1,2,0,1,0,0,0,1,1,3,0,1,0,2
8945,785375,3,0,0,0,0,0,0,0,0,0,1,0,0,0,0,0,0
8945,790827,23,3,4,3,4,0,0,1,3,2,1,1,2,1,0,1,7
8945,780007,0,0,0,0,0,0,0,0,0,0,0,0,0,0,0,0,0
8946,780095,19,0,2,0,2,0,0,0,0,2,4,3,4,0,1,0,0
8946,776321,31,11,17,10,15,1,2,0,0,3,11,1,2,0,1,0,23
8946,786081,28,3,8,2,5,1,3,2,2,1,0,3,3,2,2,0,9
8946,785431,30,0,5,0,3,0,2,0,0,1,2,1,3,1,2,0,0
8946,780232,34,8,14,2,5,6,9,1,2,0,2,3,2,0,2,0,23
8946,797917,2,1,2,1,2,0,0,0,0,0,0,0,1,0,1,0,2
8946,786020,16,6,8,6,8,0,0,0,0,1,4,1,0,0,0,0,12
8946,785356,9,2,2,0,0,2,2,0,0,0,1,0,0,0,0,0,6
8946,781328,3,0,0,0,0,0,0,0,0,0,0,0,0,0,0,0,0
8946,789019,2,0,0,0,0,0,0,0,0,0,0,0,1,0,0,0,0
8946,797911,2,0,1,0,0,0,1,0,0,0,0,0,0,0,0,0,0
8946,789040,24,1,4,1,3,0,1,0,0,0,1,3,3,2,1,0,2
8947,791115,21,2,4,2,4,0,0,1,2,3,0,0,1,2,2,0,5
8947,791118,32,3,10,3,7,0,3,6,7,0,1,2,1,0,2,1,12
8947,785947,16,1,6,0,3,1,3,2,2,1,4,0,0,0,1,0,5
8947,785676,31,3,7,2,4,1,3,0,0,0,0,3,0,1,0,0,7
8947,774974,34,2,5,2,5,0,0,2,5,0,3,7,2,0,1,1,6
8947,796771,19,3,5,3,4,0,1,2,2,1,4,0,3,0,3,0,8
8947,800022,2,0,0,0,0,0,0,0,0,0,2,1,0,0,0,0,0
8947,796768,2,0,0,0,0,0,0,0,0,0,0,0,0,0,0,0,0
8947,791117,32,4,10,2,5,2,5,5,7,2,5,0,1,2,0,0,15
8947,791116,11,2,2,2,2,0,0,0,0,0,1,0,2,0,2,0,4
8948,781650,14,2,5,2,5,0,0,2,2,1,0,0,4,0,3,0,6
8948,776079,15,1,2,1,2,0,0,0,0,0,1,1,5,2,2,0,2
8948,791432,35,4,6,2,3,2,3,0,0,0,0,0,3,0,2,0,10
8948,777865,22,0,4,0,3,0,1,5,5,0,1,3,2,0,3,0,5
8948,791429,26,3,5,2,3,1,2,0,0,0,2,0,1,1,3,0,7
8948,797066,25,5,6,5,6,0,0,2,2,2,3,1,3,0,3,1,12
8948,791431,1,0,0,0,0,0,0,0,0,0,0,0,0,0,0,0,0
8948,797067,17,3,3,3,3,0,0,2,2,3,1,2,1,1,0,0,8
8948,797070,25,3,9,2,7,1,2,2,2,1,6,2,1,0,0,0,9
8948,797068,20,0,4,0,2,0,2,2,2,0,2,3,0,2,0,0,2
8949,775705,17,0,0,0,0,0,0,0,0,0,0,0,0,1,0,0,0
8949,791652,25,4,5,4,5,0,0,4,6,3,3,0,4,0,3,0,12
8949,786495,25,5,7,5,6,0,1,1,2,3,4,1,0,0,2,1,11
8949,791650,36,8,11,8,11,0,0,5,6,2,5,1,2,4,4,0,21
8949,776384,34,4,12,1,7,3,5,3,4,1,1,4,2,1,2,0,14
8949,797284,1,0,0,0,0,0,0,0,0,0,0,0,1,0,0,0,0
8949,791653,8,1,1,1,1,0,0,1,2,0,0,1,2,1,1,0,3
8949,791654,3,1,1,1,1,0,0,0,0,0,0,0,1,0,0,0,2
8949,797289,16,2,3,2,3,0,0,1,3,0,1,0,2,3,0,0,5
8949,797286,5,0,2,0,1,0,1,0,0,0,0,0,0,0,0,0,0
8949,797285,20,0,2,0,1,0,1,0,0,0,1,1,1,1,1,0,0
8949,797283,4,0,1,0,0,0,1,0,0,0,0,0,0,0,0,0,0
8949,791651,6,1,2,0,0,1,2,0,0,0,0,0,0,0,0,0,3
8950,790957,27,5,10,3,4,2,6,0,2,3,2,3,2,2,2,1,12
8950,785275,21,4,6,4,6,0,0,0,0,0,1,3,2,1,2,1,8
8950,790956,13,0,4,0,1,0,3,0,0,0,0,1,0,1,0,0,0
8950,785089,33,4,7,3,4,1,3,4,4,0,6,1,1,2,0,0,13
8950,780460,36,9,13,4,5,5,8,1,1,0,2,4,0,0,1,0,24
8950,796550,21,4,6,1,2,3,4,1,2,1,5,3,2,0,1,1,12
8950,796551,19,2,3,2,2,0,1,2,2,0,6,1,4,0,3,0,6
8950,796548,1,0,1,0,1,0,0,0,0,0,0,0,0,0,0,0,0
8950,796547,5,0,0,0,0,0,0,0,0,0,1,0,2,0,0,0,0
8950,796552,22,3,6,3,4,0,2,0,0,0,2,4,3,1,1,0,6
8950,785276,2,0,0,0,0,0,0,0,0,0,0,0,0,0,0,0,0
8951,780338,23,5,7,5,7,0,0,1,3,1,6,0,3,0,2,1,11
8951,796687,25,1,7,1,4,0,3,1,2,1,3,0,1,1,1,0,3
8951,791030,33,7,7,5,5,2,2,0,0,0,1,1,0,2,2,0,16
8951,785477,30,3,9,3,4,0,5,7,10,0,3,2,1,0,1,0,13
8951,785475,30,5,9,5,5,0,4,2,2,0,1,2,1,0,0,0,12
8951,791032,22,2,6,0,1,2,5,0,0,0,0,0,2,1,2,0,6
8951,796690,2,0,0,0,0,0,0,0,0,0,0,0,0,1,0,0,0
8951,796688,12,2,6,1,4,1,2,0,2,3,3,0,4,0,1,0,5
8951,786655,20,1,4,1,2,0,2,0,0,0,3,1,1,0,0,0,2
8951,780344,3,0,0,0,0,0,0,0,0,0,0,1,0,0,0,0,0
8952,790873,32,7,11,7,10,0,1,1,4,0,3,1,1,0,2,0,15
8952,780054,20,4,8,2,4,2,4,2,2,0,1,0,2,0,1,0,12
8952,781140,25,1,4,0,3,1,1,0,0,0,5,1,2,0,0,1,3
8952,786851,29,3,10,2,5,1,5,0,0,1,2,2,0,0,4,0,7
8952,776357,27,5,9,5,8,0,1,0,0,1,0,4,3,1,4,0,10
8952,799973,6,0,1,0,0,0,1,1,2,0,2,0,1,0,0,0,1
8952,796433,12,0,1,0,1,0,0,0,0,0,3,0,2,0,0,0,0
8952,781139,17,2,3,2,3,0,0,0,0,0,5,0,2,0,0,1,4
8952,785429,18,1,2,0,0,1,2,0,0,0,2,0,0,1,0,0,3
8952,776245,9,0,2,0,0,0,2,2,2,0,2,0,0,1,1,0,2
8952,796432,5,0,0,0,0,0,0,0,0,0,1,0,0,0,0,0,0
8953,780027,38,10,16,8,13,2,3,2,3,3,8,1,3,0,1,0,24
8953,786176,35,7,13,2,4,5,9,0,2,0,6,2,1,1,0,0,19
8953,786173,29,2,6,1,3,1,3,0,0,0,2,0,0,0,1,0,5
8953,780028,23,1,4,1,3,0,1,0,0,0,1,5,4,0,1,0,2
8953,774828,26,3,8,1,3,2,5,0,0,0,4,5,1,0,1,0,8
8953,797175,22,4,8,4,6,0,2,0,0,1,4,0,3,2,0,1,8
8953,791379,13,1,4,1,3,0,1,2,2,0,0,2,0,1,0,0,4
8953,791380,14,1,3,1,3,0,0,1,2,1,1,7,1,1,1,0,3
8954,791564,28,3,12,1,3,2,9,1,2,1,8,1,1,1,0,0,9
8954,775549,16,3,4,3,4,0,0,4,5,1,2,1,3,0,2,0,10
8954,797056,30,5,13,2,5,3,8,0,0,0,7,1,1,0,3,0,13
8954,791568,19,1,3,1,3,0,0,3,7,1,4,1,1,1,0,0,5
8954,797055,26,1,2,0,0,1,2,6,6,0,1,4,2,0,0,0,9
8954,797058,15,1,5,0,1,1,4,0,0,0,1,1,1,0,0,0,3
8954,791566,24,3,3,1,1,2,2,0,0,1,3,2,0,0,1,1,8
8954,797054,25,4,6,4,6,0,0,2,2,0,0,2,1,2,2,1,10
8954,786381,17,3,6,2,2,1,4,2,2,1,6,1,5,0,1,0,9
8955,780377,36,8,18,1,6,7,12,0,0,0,5,1,1,0,1,0,23
8955,791852,13,0,0,0,0,0,0,2,4,2,0,0,0,0,0,1,2
8955,797460,22,2,9,1,3,1,6,0,0,0,2,1,5,0,0,0,5
8955,786601,23,1,7,0,0,1,7,0,0,1,3,2,4,1,2,0,3
8955,786600,25,0,2,0,2,0,0,4,6,1,4,3,3,2,3,0,4
8955,791851,30,2,7,0,1,2,6,0,0,0,3,4,4,0,1,0,6
8955,797461,33,5,14,2,7,3,7,4,8,5,7,4,3,2,2,0,17
8955,786599,18,3,7,3,4,0,3,1,1,1,4,0,0,1,0,0,7
8956,792029,34,7,10,2,4,5,6,3,4,1,2,0,2,1,0,0,22
8956,761149,24,1,5,1,4,0,1,2,2,0,8,0,5,0,0,0,4
8956,792030,22,1,2,1,1,0,1,2,2,0,0,2,3,2,2,0,4
8956,792031,36,1,5,1,4,0,1,4,4,0,0,2,3,1,0,0,6
8956,780828,37,14,25,9,17,5,8,6,7,0,2,4,1,1,1,0,39
8956,785822,5,0,0,0,0,0,0,0,0,0,0,0,1,0,0,0,0
8956,797640,3,0,0,0,0,0,0,0,0,0,0,0,0,0,0,0,0
8956,797638,3,0,0,0,0,0,0,0,0,0,0,1,1,0,1,0,0
8956,797637,16,0,1,0,0,0,1,0,0,0,0,1,4,1,1,0,0
8956,797636,20,1,2,1,2,0,0,0,0,0,4,3,0,0,2,0,2
8957,781044,29,3,9,0,5,3,4,4,4,1,3,3,3,0,2,0,13
8957,791795,25,3,5,2,2,1,3,1,2,2,3,2,1,0,2,0,8
8957,786489,27,2,7,1,3,1,4,8,8,1,4,0,0,0,0,0,13
8957,786488,29,10,15,6,8,4,7,2,5,0,5,1,3,0,3,1,26
8957,781038,35,7,11,7,9,0,2,4,4,2,2,3,2,2,0,0,18
8957,797620,18,3,4,1,2,2,2,0,0,1,3,0,4,0,1,0,8
8957,791796,1,0,0,0,0,0,0,0,0,0,0,0,0,0,0,0,0
8957,786490,10,0,0,0,0,0,0,0,0,2,0,0,1,0,0,0,0
8957,797623,1,0,0,0,0,0,0,1,2,0,0,0,1,0,1,0,1
8957,797621,5,1,3,1,2,0,1,0,0,1,0,0,1,1,0,0,2
8957,797619,19,0,3,0,2,0,1,0,0,0,3,2,3,0,0,0,0
8957,786487,1,0,0,0,0,0,0,0,0,0,0,0,0,0,0,0,0
8958,781659,19,2,4,1,1,1,3,4,4,1,4,0,3,2,1,0,9
8958,781005,20,1,3,1,2,0,1,0,0,0,3,1,4,0,1,0,2
8958,792684,19,1,3,1,2,0,1,2,2,0,3,0,1,2,1,0,4
8958,782162,33,5,13,4,9,1,4,3,3,2,4,2,2,0,4,0,14
8958,781665,39,0,10,0,3,0,7,0,0,1,4,4,1,3,3,0,0
8958,796855,3,0,0,0,0,0,0,0,0,0,0,0,1,0,1,0,0
8958,790494,22,5,11,5,7,0,4,3,3,3,2,0,1,1,1,1,13
8958,788866,6,1,1,1,1,0,0,0,0,1,1,0,1,0,0,0,2
8958,781411,7,1,3,1,3,0,0,0,3,1,1,0,1,0,1,0,2
8958,796853,4,0,2,0,2,0,0,0,0,2,0,0,0,0,0,0,0
8958,780610,28,10,18,5,9,5,9,3,4,1,2,1,1,2,1,0,28
8959,786690,24,5,9,3,7,2,2,2,2,2,4,1,3,0,1,0,14
8959,780629,27,4,10,4,7,0,3,1,1,1,4,1,2,1,2,0,9
8959,796816,26,5,9,4,5,1,4,2,5,3,6,1,2,5,1,0,13
8959,774845,27,5,9,3,4,2,5,3,3,0,4,1,2,1,2,0,15
8959,775888,29,11,11,8,8,3,3,6,9,1,2,8,0,1,1,0,31
8959,796817,5,1,2,1,2,0,0,0,0,0,1,0,0,0,0,0,2
8959,791161,21,1,4,0,0,1,4,0,0,0,2,1,4,2,4,0,3
8959,796815,13,2,3,2,2,0,1,0,0,0,1,2,1,0,2,0,4
8959,796819,5,0,0,0,0,0,0,0,0,0,0,0,0,0,0,0,0
8959,791159,7,0,1,0,0,0,1,0,0,0,1,0,2,0,0,0,0
8959,785346,16,1,5,0,0,1,5,0,0,0,3,1,1,0,1,0,3
8960,781579,27,5,10,4,7,1,3,6,6,6,7,4,3,3,4,0,17
8960,775696,24,4,10,3,5,1,5,3,3,0,2,0,2,2,2,0,12
8960,786731,33,9,19,9,19,0,0,8,9,6,7,6,3,1,0,1,26
8960,781584,17,0,7,0,2,0,5,0,0,0,0,0,1,0,1,0,0
8960,780347,31,4,8,4,6,0,2,3,4,1,1,3,1,0,0,2,11
8960,798021,1,0,0,0,0,0,0,0,0,0,1,0,0,0,0,0,0
8960,798026,2,0,0,0,0,0,0,0,0,0,0,0,0,0,1,0,0
8960,792360,1,1,1,1,1,0,0,0,0,0,0,0,0,0,0,0,2
8960,776481,4,1,1,1,1,0,0,0,0,0,1,0,0,0,2,0,2
8960,798023,14,1,3,0,0,1,3,0,0,1,2,2,4,1,0,0,3
8960,798018,2,0,0,0,0,0,0,0,0,0,0,1,0,0,0,0,0
8960,798017,24,2,5,1,2,1,3,0,0,1,7,2,2,4,2,0,5
8960,798008,20,2,4,2,3,0,1,5,5,0,1,4,1,0,0,0,9
8961,797523,31,4,6,0,0,4,6,0,0,0,2,2,2,0,2,1,12
8961,785402,24,5,8,5,8,0,0,2,3,0,2,0,2,1,3,1,12
8961,797524,28,4,5,3,4,1,1,1,3,0,2,0,2,1,2,0,10
8961,792118,30,2,8,2,5,0,3,2,4,0,5,7,2,1,6,0,6
8961,782593,29,4,15,3,9,1,6,4,4,1,3,2,3,2,3,0,13
8961,785828,19,1,3,1,3,0,0,0,0,0,3,0,4,0,2,1,2
8961,791702,4,0,0,0,0,0,0,0,0,0,0,0,2,0,0,0,0
8961,797525,4,0,0,0,0,0,0,0,0,0,0,0,1,0,1,0,0
8961,797526,5,0,1,0,0,0,1,0,0,0,0,0,0,1,0,0,0
8961,792663,3,0,0,0,0,0,0,0,0,0,0,1,0,0,0,0,0
8961,791700,23,4,5,2,3,2,2,1,1,0,4,1,1,1,0,0,11
8964,780758,14,0,1,0,1,0,0,0,0,0,0,0,2,0,0,0,0
8964,775489,35,7,15,7,13,0,2,4,4,2,4,1,1,1,2,2,18
8964,785563,35,5,9,1,4,4,5,2,2,0,4,2,2,4,2,0,16
8964,785561,31,4,8,4,7,0,1,2,2,5,2,0,1,0,3,1,10
8964,780313,34,4,12,3,9,1,3,3,4,1,4,9,3,1,5,1,12
8964,791087,2,0,0,0,0,0,0,0,0,0,0,0,1,0,0,0,0
8964,791088,18,2,4,2,3,0,1,0,0,1,1,1,2,1,1,0,4
8964,791069,9,1,4,0,1,1,3,0,0,0,0,0,3,1,1,0,3
8964,785560,22,1,5,0,0,1,5,0,0,0,1,3,2,1,1,0,3
8965,792158,23,1,2,1,1,0,1,0,0,0,3,3,2,1,3,2,2
8965,780138,36,5,10,5,9,0,1,4,6,1,4,0,2,3,2,0,14
8965,792154,35,5,9,5,8,0,1,8,10,0,5,3,1,2,1,2,18
8965,792152,34,8,13,6,11,2,2,0,0,2,4,2,2,1,0,1,18
8965,780581,29,4,8,3,4,1,4,2,2,1,2,3,2,1,4,0,11
8965,797755,3,0,1,0,1,0,0,0,0,0,0,0,0,0,0,0,0
8965,792162,1,0,1,0,0,0,1,2,2,0,0,0,0,0,0,0,2
8965,792157,16,5,8,5,8,0,0,0,1,3,3,2,4,1,1,0,10
8965,786014,20,1,3,1,1,0,2,2,2,0,1,0,2,0,1,0,4
8965,797759,1,0,0,0,0,0,0,0,0,0,0,0,0,0,0,0,0
8965,792159,2,0,0,0,0,0,0,0,0,0,0,0,0,0,0,0,0
8966,775549,28,2,5,2,5,0,0,1,4,2,5,2,1,0,2,1,5
8966,791568,12,0,0,0,0,0,0,0,0,0,2,0,1,0,1,0,0
8966,797055,19,2,5,1,2,1,3,3,3,0,2,2,0,2,2,0,8
8966,786381,34,3,6,1,1,2,5,2,2,0,6,3,3,2,3,0,10
8966,780388,3,0,0,0,0,0,0,0,0,0,0,0,0,0,0,0,0
8966,797058,9,2,4,1,1,1,3,0,0,1,2,1,2,0,2,0,5
8966,791564,24,1,6,1,4,0,2,0,0,1,5,1,1,2,0,0,2
8966,791566,12,1,1,1,1,0,0,0,0,0,2,2,1,0,0,0,2
8966,797056,30,8,17,5,6,3,11,0,0,1,7,1,2,1,2,0,19
8966,797054,29,5,12,4,7,1,5,3,4,0,3,2,1,0,3,0,14
8967,780377,35,2,9,0,1,2,8,3,3,0,8,1,1,0,2,1,9
8967,791852,12,1,2,1,2,0,0,0,2,0,1,0,1,1,1,0,2
8967,797460,33,3,11,3,5,0,6,0,2,2,2,0,2,0,2,1,6
8967,786601,18,1,7,0,0,1,7,0,0,0,3,1,2,0,1,0,3
8967,786600,32,5,9,5,8,0,1,2,2,0,3,3,1,4,2,0,12
8967,791851,26,1,6,0,5,1,1,1,2,1,2,1,2,0,0,0,4
8967,797461,29,3,11,2,7,1,4,5,7,2,4,2,1,2,1,0,12
8967,786599,15,2,5,2,5,0,0,0,0,2,1,0,4,0,0,1,4
8968,785622,33,4,9,1,4,3,5,0,0,2,6,0,3,0,4,0,11
8968,781058,22,1,5,1,4,0,1,0,0,0,2,0,3,0,1,0,2
8968,780327,18,5,7,5,7,0,0,2,4,2,0,1,3,0,1,1,12
8968,797458,25,3,4,2,2,1,2,2,3,0,4,1,4,1,0,0,9
8968,797451,36,2,7,2,5,0,2,4,4,1,4,7,0,1,6,0,8
8968,797455,20,5,6,5,6,0,0,5,7,2,8,0,2,1,1,0,15
8968,797456,19,3,7,1,2,2,5,0,0,0,3,0,3,1,2,0,8
8968,797453,2,0,0,0,0,0,0,0,0,0,0,0,0,0,0,0,0
8968,791848,6,1,2,1,1,0,1,0,0,1,0,0,0,1,0,0,2
8968,791849,8,0,1,0,0,0,1,0,0,0,0,1,0,0,2,0,0
8968,786607,11,0,1,0,0,0,1,0,0,0,0,1,0,2,0,0,0
8969,780023,29,1,3,1,3,0,0,0,0,0,5,1,4,1,4,1,2
8969,792493,21,2,5,0,1,2,4,0,0,0,1,0,3,0,1,0,6
8969,792495,38,6,19,5,9,1,10,9,11,1,4,2,2,5,4,0,22
8969,792491,31,5,11,5,11,0,0,4,4,1,1,1,4,0,3,0,14
8969,781144,35,1,4,1,3,0,1,2,3,0,3,0,3,2,1,0,4
8969,798959,11,0,1,0,0,0,1,0,0,0,0,1,1,0,0,1,0
8969,788128,11,2,6,2,4,0,2,0,0,1,2,0,1,0,0,0,4
8969,786832,24,0,2,0,2,0,0,0,1,2,1,1,1,0,1,0,0
8970,775510,32,7,13,3,4,4,9,0,0,0,6,1,1,1,0,2,18
8970,774976,24,2,10,1,7,1,3,2,2,3,4,0,2,0,1,1,7
8970,792291,15,1,3,0,0,1,3,0,0,0,2,1,1,2,1,0,3
8970,786614,29,3,9,1,4,2,5,4,4,1,5,2,1,3,2,0,12
8970,786759,28,1,4,1,4,0,0,0,0,0,3,5,1,1,1,0,2
8970,792294,21,4,8,4,7,0,1,0,1,1,5,0,0,2,1,0,8
8970,797865,28,2,3,2,3,0,0,0,0,0,0,4,1,0,0,0,4
8970,786761,8,1,2,1,2,0,0,2,2,1,2,0,0,0,0,0,4
8970,792293,15,1,4,1,3,0,1,0,0,0,0,0,0,0,0,1,2
8970,792296,0,1,1,1,1,0,0,0,0,0,0,0,1,0,0,0,2
8970,786760,0,0,0,0,0,0,0,0,0,0,0,0,0,0,0,0,0
8970,797866,0,0,0,0,0,0,0,0,0,0,0,0,0,0,0,0,0
8970,780349,0,0,0,0,0,0,0,0,0,0,0,0,0,0,0,0,0
8971,790821,36,3,10,3,8,0,2,2,2,1,9,1,3,2,1,1,8
8971,775585,38,2,4,2,3,0,1,1,2,0,1,1,1,1,3,0,5
8971,790822,37,3,13,1,10,2,3,2,2,1,5,2,3,0,4,1,10
8971,780982,39,5,12,3,7,2,5,0,0,1,5,0,2,1,1,2,12
8971,774980,37,6,11,6,8,0,3,2,2,0,5,1,1,1,2,0,14
8971,780445,6,1,1,1,1,0,0,0,0,0,0,0,1,0,0,0,2
8971,785365,6,0,1,0,0,0,1,0,0,0,0,0,0,0,0,0,0
8971,792436,1,0,0,0,0,0,0,0,0,0,0,0,0,0,0,0,0
8972,785791,28,5,9,3,3,2,6,0,3,0,2,2,0,1,0,1,12
8972,791674,35,2,5,2,3,0,2,0,0,1,1,2,2,1,5,0,4
8972,785787,33,5,12,5,8,0,4,1,1,0,4,2,1,4,1,0,11
8972,780552,37,5,9,3,3,2,6,2,3,3,6,1,1,1,3,0,14
8972,780550,16,2,5,2,4,0,1,1,2,0,1,0,1,1,4,0,5
8972,785793,8,0,1,0,0,0,1,0,0,0,1,0,1,0,0,0,0
8972,797423,7,1,1,1,1,0,0,0,0,0,0,0,0,1,0,0,2
8972,791672,24,6,8,6,8,0,0,1,3,1,0,0,1,0,0,0,13
8972,780538,8,0,1,0,0,0,1,0,0,0,0,1,4,1,5,0,0
8972,797424,4,0,0,0,0,0,0,0,0,0,0,0,0,0,0,0,0
8973,797174,24,4,6,4,6,0,0,2,2,2,3,0,0,1,3,1,10
8973,791510,24,3,6,3,6,0,0,1,2,0,0,0,3,0,1,0,7
8973,786699,19,3,4,3,4,0,0,0,0,1,3,0,2,3,3,1,6
8973,785593,28,6,11,4,6,2,5,3,3,1,1,2,0,0,0,0,17
8973,775357,28,4,7,2,3,2,4,0,0,2,4,3,2,2,3,0,10
8973,791507,19,9,11,9,11,0,0,0,0,4,2,1,2,2,2,2,18
8973,797168,25,2,7,2,5,0,2,0,0,0,5,3,1,1,3,0,4
8973,791504,21,1,5,1,5,0,0,0,0,1,2,3,0,2,0,0,2
8973,791505,12,1,4,0,2,1,2,0,0,0,1,0,2,1,0,1,3
8974,792181,32,8,13,6,8,2,5,0,0,4,2,2,3,1,1,1,18
8974,780986,36,3,7,3,7,0,0,2,3,2,3,5,4,3,1,3,8
8974,785902,23,1,10,1,5,0,5,2,2,0,4,0,0,1,1,3,4
8974,792179,10,1,3,1,1,0,2,2,4,0,1,0,1,1,2,0,4
8974,786662,39,9,20,3,7,6,13,2,3,0,2,1,2,1,0,0,26
8974,792177,24,2,5,2,5,0,0,2,2,3,5,0,5,4,1,1,6
8974,797796,31,3,8,3,7,0,1,0,0,2,1,10,2,4,4,0,6
8974,786661,5,0,0,0,0,0,0,0,0,0,1,0,1,0,1,1,0
8975,790856,25,7,10,7,10,0,0,4,5,8,7,1,3,0,3,1,18
8975,780452,29,5,9,5,9,0,0,1,2,1,5,1,2,0,4,0,11
8975,796413,21,1,10,1,3,0,7,0,0,0,1,2,2,0,1,0,2
8975,796408,29,3,10,1,5,2,5,2,4,1,7,3,1,2,3,0,10
8975,796407,27,2,6,2,5,0,1,2,3,3,1,3,3,2,0,0,6
8975,796411,11,2,3,2,3,0,0,0,0,2,1,1,1,1,2,0,4
8975,796410,14,2,5,2,5,0,0,2,4,4,3,1,2,0,3,0,6
8975,796409,23,3,9,2,6,1,3,2,2,0,1,3,1,1,4,0,9
8975,790858,9,0,3,0,1,0,2,1,2,0,1,0,0,0,0,0,1
8975,780450,12,1,3,0,1,1,2,0,0,2,0,1,1,0,0,0,3
8976,775806,26,7,10,6,6,1,4,3,4,1,2,0,2,0,0,0,18
8976,781011,30,6,12,6,12,0,0,0,0,3,6,1,1,1,1,4,12
8976,797601,33,4,8,3,3,1,5,0,0,0,3,3,0,2,2,0,9
8976,781012,32,3,10,2,5,1,5,2,3,0,3,5,1,2,2,0,9
8976,775119,31,8,11,8,9,0,2,0,0,0,14,5,1,1,3,1,16
8976,775188,7,2,3,2,3,0,0,0,2,2,0,0,1,0,1,0,4
8976,775563,20,3,10,3,9,0,1,5,6,0,5,0,3,3,1,0,11
8976,797604,4,0,1,0,1,0,0,0,0,0,0,0,1,0,0,0,0
8976,791770,1,0,1,0,0,0,1,0,0,0,0,0,1,0,0,0,0
8976,786466,12,3,3,1,1,2,2,0,0,1,1,0,2,0,1,0,8
8976,797599,1,0,0,0,0,0,0,0,0,0,0,0,0,0,0,0,0
8976,797602,2,0,0,0,0,0,0,0,0,0,0,0,0,0,0,0,0
8976,797605,1,0,0,0,0,0,0,0,0,0,0,0,0,0,0,0,0
8977,791923,24,7,11,7,11,0,0,1,4,2,3,2,1,2,4,0,15
8977,781122,20,3,7,3,7,0,0,1,3,2,5,0,1,0,3,0,7
8977,791925,24,6,12,3,8,3,4,0,1,0,3,0,0,1,0,0,15
8977,786527,25,1,7,0,2,1,5,0,0,1,3,1,3,0,2,0,3
8977,781112,21,0,3,0,1,0,2,0,0,0,0,1,1,2,0,0,0
8977,786529,11,0,2,0,2,0,0,0,0,0,2,1,0,0,1,0,0
8977,797541,18,4,10,4,10,0,0,1,1,4,4,0,2,0,0,0,9
8977,797543,4,1,1,1,1,0,0,0,0,0,0,0,0,0,0,0,2
8977,797542,21,2,9,0,4,2,5,0,0,0,3,3,1,1,2,0,6
8977,791927,11,1,4,0,1,1,3,1,2,0,1,0,0,0,0,0,4
8977,786858,17,4,6,3,4,1,2,1,1,0,2,2,2,0,1,0,10
8977,800210,4,0,0,0,0,0,0,0,0,0,0,0,0,0,0,0,0
8978,780201,32,3,6,3,6,0,0,5,8,2,10,3,3,1,1,0,11
8978,791469,39,6,9,6,9,0,0,0,0,3,10,1,2,0,1,4,12
8978,797210,32,7,12,6,9,1,3,0,1,1,0,2,1,4,6,0,15
8978,786311,36,6,14,3,8,3,6,0,0,0,2,2,2,3,5,0,15
8978,775516,25,3,6,3,6,0,0,0,1,1,3,4,4,1,1,0,6
8978,798344,6,0,0,0,0,0,0,1,2,0,1,0,2,0,2,0,1
8978,791467,27,2,8,0,3,2,5,0,0,0,6,2,2,2,3,2,6
8978,797209,1,0,0,0,0,0,0,0,0,0,0,0,0,0,0,0,0
8978,791470,1,0,0,0,0,0,0,0,0,0,0,0,0,0,0,0,0
8978,791471,1,0,0,0,0,0,0,0,0,0,0,0,0,0,0,0,0
8979,797861,33,3,11,3,10,0,1,0,0,0,7,1,1,3,1,0,6
8979,797859,20,3,6,2,3,1,3,2,2,1,6,1,0,1,3,0,9
8979,792208,28,2,9,2,7,0,2,0,2,0,1,2,3,2,5,1,4
8979,786262,36,2,6,0,2,2,4,0,0,1,1,3,2,1,0,0,6
8979,781314,29,3,8,1,2,2,6,0,0,0,3,2,2,2,3,0,8
8979,797862,10,3,3,3,3,0,0,3,6,0,2,0,1,0,0,1,9
8979,776018,9,1,3,1,3,0,0,0,2,3,1,1,2,0,0,0,2
8979,797856,8,0,1,0,1,0,0,0,0,1,0,0,0,0,2,0,0
8979,792204,13,1,6,0,3,1,3,0,0,1,2,0,0,2,1,1,3
8979,786682,3,0,1,0,0,0,1,0,0,0,0,0,0,0,0,0,0
8979,781317,11,0,1,0,1,0,0,0,2,0,0,1,1,0,2,0,0
8980,791988,30,8,17,8,17,0,0,0,1,7,6,1,3,0,0,0,16
8980,792443,16,0,5,0,5,0,0,0,2,2,3,0,0,0,0,2,0
8980,796507,16,0,3,0,3,0,0,0,0,0,3,0,1,0,1,1,0
8980,796503,33,5,13,4,9,1,4,2,2,1,1,0,4,1,4,0,13
8980,791989,40,6,13,6,9,0,4,4,6,2,0,3,3,1,1,1,16
8980,796509,4,0,1,0,1,0,0,0,0,0,0,0,1,0,0,0,0
8980,785292,16,1,6,0,3,1,3,1,2,1,0,0,2,0,2,0,4
8980,780077,1,0,0,0,0,0,0,0,0,0,0,0,0,0,0,0,0
8980,796506,3,0,0,0,0,0,0,0,0,0,0,0,0,0,0,0,0
8980,796508,28,3,5,0,0,3,5,0,0,0,4,0,0,0,2,0,9
8980,785258,13,0,2,0,1,0,1,0,0,1,3,1,2,0,0,0,0
8981,792399,33,4,12,4,10,0,2,0,0,5,5,1,2,0,3,0,8
8981,799000,20,6,8,6,8,0,0,1,1,5,4,2,4,0,4,1,13
8981,780263,37,5,10,3,4,2,6,1,3,1,10,0,2,0,0,0,13
8981,786697,29,1,6,1,4,0,2,2,2,0,3,2,0,1,2,0,4
8981,775628,36,6,13,5,11,1,2,5,8,0,2,3,3,2,1,0,18
8981,775198,26,2,4,2,4,0,0,1,2,0,3,1,0,1,0,1,5
8981,792397,4,0,1,0,1,0,0,0,0,0,0,0,0,0,0,0,0
8981,780571,15,3,5,2,2,1,3,0,0,0,1,1,2,0,0,0,7
8982,799131,31,5,6,5,6,0,0,5,7,1,11,1,4,1,3,3,15
8982,800005,26,1,3,1,3,0,0,2,4,2,5,0,3,0,2,5,4
8982,799129,39,3,13,1,5,2,8,3,5,1,11,6,2,2,2,1,11
8982,799134,23,3,8,1,6,2,2,0,0,1,3,4,4,0,1,1,8
8982,792634,36,7,14,2,6,5,8,2,2,3,4,3,1,0,2,1,21
8982,799132,17,2,5,0,1,2,4,0,0,0,1,0,1,0,3,0,6
8982,799130,13,0,4,0,1,0,3,0,0,0,1,0,1,0,1,0,0
8982,799133,15,1,4,1,2,0,2,0,0,0,0,0,0,0,2,1,2
8983,796637,22,4,9,4,9,0,0,2,4,0,3,1,0,1,0,0,10
8983,792629,28,1,8,1,6,0,2,1,2,0,3,2,2,0,1,0,3
8983,792631,23,2,7,1,4,1,3,0,0,0,2,1,0,0,0,0,5
8983,781491,27,2,6,1,4,1,2,2,2,1,4,3,5,1,1,0,7
8983,780250,33,6,11,3,4,3,7,3,6,1,6,4,2,4,3,1,18
8983,796634,2,0,2,0,2,0,0,0,0,0,1,0,1,0,0,0,0
8983,792632,17,2,6,2,6,0,0,1,2,2,4,0,5,0,1,0,5
8983,796642,17,2,4,1,2,1,2,1,2,0,0,0,0,0,0,0,6
8983,792627,14,3,4,3,4,0,0,0,1,0,1,0,2,1,2,0,6
8983,792626,17,1,8,1,8,0,0,1,1,2,2,2,1,2,0,0,3
8984,790883,21,4,7,4,7,0,0,3,4,0,2,0,1,2,3,0,11
8984,796436,40,3,8,3,5,0,3,9,10,0,7,4,1,1,5,0,15
8984,796438,32,2,7,1,4,1,3,1,3,1,5,3,2,0,0,0,6
8984,791635,38,4,11,1,5,3,6,3,4,0,2,3,4,2,1,1,14
8984,790884,24,8,9,8,9,0,0,1,2,1,8,1,4,0,4,1,17
8984,781262,3,0,1,0,0,0,1,0,0,0,1,1,1,0,0,0,0
8984,796439,19,3,5,3,5,0,0,3,4,2,3,3,2,1,0,0,9
8984,790885,23,3,3,2,2,1,1,0,0,2,1,0,1,1,1,0,7
8985,781062,39,5,12,2,4,3,8,0,0,0,2,0,2,1,2,0,13
8985,790876,35,6,15,4,7,2,8,0,0,1,3,0,1,3,1,0,14
8985,774987,35,5,14,2,8,3,6,6,7,1,6,4,4,1,2,1,19
8985,785699,33,3,7,2,5,1,2,0,3,0,5,5,3,1,2,0,7
8985,779985,38,7,14,3,5,4,9,2,2,5,4,4,2,2,2,1,20
8985,790877,9,0,2,0,1,0,1,2,2,0,0,0,1,1,1,0,2
8985,790882,8,0,0,0,0,0,0,0,0,0,0,0,2,0,1,0,0
8985,785432,3,0,0,0,0,0,0,0,0,0,0,0,1,0,1,0,0
8986,791144,11,2,3,2,3,0,0,2,2,1,0,0,3,1,1,0,6
8986,785782,26,1,5,0,1,1,4,3,3,5,4,4,2,0,2,0,6
8986,791145,33,8,13,8,12,0,1,6,8,4,8,1,1,0,1,1,22
8986,791146,31,4,9,2,4,2,5,5,8,2,2,3,1,0,0,0,15
8986,785777,33,3,12,3,3,0,9,4,4,1,4,3,2,2,1,0,10
8986,791147,14,2,2,2,2,0,0,0,0,2,3,0,2,0,1,0,4
8986,796805,1,1,1,1,1,0,0,0,0,0,1,0,0,0,0,0,2
8986,796804,14,2,3,0,1,2,2,0,0,0,1,0,2,0,0,1,6
8986,791148,21,0,5,0,0,0,5,3,3,0,2,0,2,0,2,1,3
8986,786748,15,0,2,0,0,0,2,0,0,0,1,3,1,1,3,0,0
8986,796803,1,0,0,0,0,0,0,0,0,0,0,0,0,0,0,0,0
8987,792473,29,0,1,0,0,0,1,0,0,1,4,2,5,0,2,0,0
8987,780036,23,1,2,1,2,0,0,0,0,2,1,3,3,2,4,0,2
8987,792474,24,2,7,1,2,1,5,2,2,0,2,0,3,0,0,0,7
8987,785249,34,3,12,2,6,1,6,0,0,0,2,0,1,0,2,0,7
8987,780035,24,3,6,3,5,0,1,4,4,0,2,0,1,2,1,1,10
8987,785251,9,0,2,0,1,0,1,0,0,0,0,1,2,0,2,0,0
8987,780043,17,1,5,0,3,1,2,0,1,0,3,1,2,1,0,1,3
8987,799281,23,3,7,2,5,1,2,0,2,2,4,0,1,0,3,0,7
8987,792478,13,1,2,0,0,1,2,3,4,0,1,0,2,0,0,0,6
8987,792477,2,1,1,1,1,0,0,0,0,0,0,0,1,0,0,0,2
8987,792471,2,0,0,0,0,0,0,0,0,0,0,0,0,0,0,0,0
8988,776100,33,3,6,3,5,0,1,0,1,1,3,2,2,1,0,1,6
8988,785991,32,9,13,9,12,0,1,4,4,4,11,0,0,0,1,5,22
8988,792133,34,5,13,1,3,4,10,0,0,1,2,2,0,0,3,0,14
8988,797762,30,3,4,3,4,0,0,3,4,1,5,5,2,1,5,0,9
8988,781406,37,9,14,8,12,1,2,1,1,2,5,2,1,1,3,0,20
8988,797760,13,0,3,0,2,0,1,0,0,1,1,0,0,0,0,0,0
8988,792129,1,0,0,0,0,0,0,0,0,1,0,0,1,0,0,0,0
8988,797758,3,0,2,0,2,0,0,0,0,0,1,0,0,0,1,0,0
8988,775317,15,0,1,0,0,0,1,0,0,0,1,2,1,1,4,1,0
8988,792130,1,0,0,0,0,0,0,0,0,0,0,0,0,0,0,0,0
8988,785997,1,0,0,0,0,0,0,0,0,0,0,0,0,0,0,0,0
8989,791266,19,0,2,0,1,0,1,0,0,1,2,0,3,0,1,6,0
8989,785977,36,8,18,6,11,2,7,3,6,4,6,1,0,2,1,0,21
8989,791265,36,3,13,2,7,1,6,0,0,0,0,6,2,1,0,0,7
8989,791269,24,3,11,1,3,2,8,1,2,0,1,0,0,2,2,1,9
8989,781294,31,4,6,3,5,1,1,0,0,1,2,3,2,1,3,0,9
8989,797879,7,2,2,0,0,2,2,0,0,0,1,0,1,0,0,0,6
8989,796523,12,1,5,0,1,1,4,0,0,1,1,1,1,0,0,0,3
8989,796522,10,0,3,0,0,0,3,0,0,1,0,0,1,0,0,0,0
8989,791270,7,0,0,0,0,0,0,0,0,0,1,0,0,1,1,0,0
8989,791271,14,2,2,2,2,0,0,0,0,1,2,0,3,0,2,0,4
8989,781313,4,0,2,0,1,0,1,0,0,1,0,0,0,0,1,0,0
8990,786123,39,4,9,4,9,0,0,2,4,6,9,2,3,1,1,7,10
8990,780437,31,7,15,4,8,3,7,0,1,1,3,0,1,0,1,0,17
8990,797673,32,0,7,0,5,0,2,0,0,0,0,2,2,1,1,0,0
8990,786118,40,3,11,1,4,2,7,0,0,2,6,1,1,2,2,0,8
8990,786117,39,3,12,2,7,1,5,2,2,2,0,6,4,2,2,0,9
8990,797675,1,0,0,0,0,0,0,0,0,1,0,0,1,0,0,0,0
8990,792093,18,1,6,0,3,1,3,5,6,1,1,1,2,3,2,0,8
8991,796846,27,3,4,2,2,1,2,2,2,2,3,0,3,0,1,1,9
8991,775833,27,2,4,2,4,0,0,1,2,1,6,1,3,0,3,1,5
8991,781036,22,2,9,2,9,0,0,2,4,0,0,5,5,0,4,0,6
8991,775571,26,2,6,2,5,0,1,0,0,0,3,1,1,0,4,0,4
8991,774894,30,5,7,3,4,2,3,2,5,0,5,0,2,1,2,0,14
8991,799906,18,3,3,2,2,1,1,2,2,1,4,1,0,0,2,0,9
8991,796847,15,1,5,0,3,1,2,0,0,1,5,1,2,0,0,0,3
8991,796845,21,1,3,0,0,1,3,0,0,0,1,0,0,0,3,0,3
8991,785439,14,1,3,1,3,0,0,0,0,0,1,1,2,1,1,0,2
8992,785459,18,3,6,3,6,0,0,6,6,1,4,1,2,0,1,2,12
8992,789101,20,1,5,0,1,1,4,0,1,2,3,1,3,0,3,0,3
8992,789102,25,3,6,2,5,1,1,3,4,1,11,10,2,0,3,0,10
8992,781371,15,3,5,0,0,3,5,0,0,0,0,0,2,1,1,0,9
8992,781367,15,4,7,2,3,2,4,0,0,3,0,0,1,0,0,0,10
8992,797731,18,3,3,3,3,0,0,2,2,3,3,0,2,0,0,0,8
8992,792066,16,2,2,2,2,0,0,0,3,0,2,0,2,3,1,1,4
8992,781362,4,0,0,0,0,0,0,0,0,0,1,0,1,0,0,1,0
8992,797730,0,0,1,0,1,0,0,0,0,0,0,0,0,0,0,0,0
8992,797729,1,0,0,0,0,0,0,0,1,0,0,0,0,0,0,0,0
8992,792064,19,2,8,1,2,1,6,0,0,0,4,1,0,0,2,0,5
8992,792063,18,0,8,0,6,0,2,0,0,1,4,10,2,0,1,0,0
8992,792061,9,1,1,0,0,1,1,1,2,1,1,0,5,0,1,0,4
8992,788037,21,5,13,3,7,2,6,3,5,3,2,1,2,1,2,0,15
8992,789982,1,1,1,0,0,1,1,0,0,0,0,0,0,0,0,0,3
8993,791338,17,0,4,0,4,0,0,0,0,0,2,0,0,1,0,1,0
8993,797873,19,0,2,0,2,0,0,2,4,2,4,1,2,0,0,0,2
8993,797877,14,2,4,2,4,0,0,2,3,0,3,0,5,0,1,0,6
8993,797872,25,2,6,2,6,0,0,2,6,0,2,0,1,4,1,0,6
8993,791339,34,6,17,5,10,1,7,4,7,2,3,2,2,1,3,1,17
8993,792444,0,0,0,0,0,0,0,0,0,0,1,0,0,0,0,0,0
8993,791337,17,1,3,1,3,0,0,4,4,1,0,0,4,0,1,0,6
8993,785881,18,0,3,0,2,0,1,1,2,2,2,1,3,0,3,0,1
8993,781599,16,0,0,0,0,0,0,0,0,0,1,0,2,1,3,2,0
8993,797875,15,2,6,2,3,0,3,3,5,1,1,1,2,2,0,0,7
8993,797874,3,0,0,0,0,0,0,0,0,0,0,0,0,0,0,0,0
8993,781595,22,4,11,4,9,0,2,1,2,0,2,1,3,1,0,0,9
8994,791809,9,1,1,1,1,0,0,0,0,1,1,1,3,0,1,0,2
8994,780651,27,6,12,6,12,0,0,0,0,2,4,2,2,2,3,0,12
8994,791815,30,6,13,5,10,1,3,3,3,1,0,2,0,0,2,1,16
8994,791813,4,0,0,0,0,0,0,0,0,0,0,1,1,2,1,0,0
8994,780650,36,3,14,2,11,1,3,6,8,3,8,8,0,1,2,2,13
8994,791812,10,4,4,2,2,2,2,0,0,1,1,1,1,1,0,0,10
8994,781596,16,3,6,3,6,0,0,0,0,1,1,0,2,0,0,0,6
8994,797373,1,0,0,0,0,0,0,0,0,0,0,0,1,0,0,0,0
8994,791810,23,1,3,1,3,0,0,0,0,0,1,4,2,1,2,0,2
8994,791814,16,0,0,0,0,0,0,0,0,1,0,1,0,1,0,0,0
8994,786645,21,4,5,2,3,2,2,3,4,2,3,1,0,2,0,0,13
8994,786644,7,2,2,2,2,0,0,0,0,0,0,0,1,0,0,0,4
8995,797028,21,0,2,0,2,0,0,0,0,2,1,0,1,0,2,0,0
8995,791598,27,2,7,1,4,1,3,5,6,0,5,4,3,2,2,3,10
8995,797025,20,3,7,3,3,0,4,0,0,0,1,2,2,2,2,0,6
8995,792116,32,6,11,2,3,4,8,0,0,1,1,1,1,0,4,0,16
8995,780410,31,5,11,3,6,2,5,0,0,0,1,0,0,0,1,0,12
8995,797026,6,0,0,0,0,0,0,0,0,0,0,0,1,0,2,0,0
8995,775047,13,3,4,3,4,0,0,0,0,0,4,0,1,0,1,0,6
8995,797027,25,0,1,0,1,0,0,0,0,1,2,2,4,1,2,0,0
8995,791597,6,0,0,0,0,0,0,0,0,0,0,1,0,0,0,0,0
8995,791600,19,2,7,1,4,1,3,2,4,2,1,3,1,2,1,0,7
8996,791837,27,3,6,3,5,0,1,1,1,0,8,0,0,2,1,0,7
8996,780613,34,11,21,11,21,0,0,3,4,2,2,3,2,1,1,0,25
8996,775097,22,3,7,3,7,0,0,0,0,0,4,0,0,0,3,0,6
8996,780609,39,5,9,3,4,2,5,6,6,0,8,2,1,4,3,0,18
8996,776395,9,0,4,0,2,0,2,0,0,0,0,0,0,0,0,0,0
8996,786621,18,2,5,0,0,2,5,0,0,0,0,2,2,0,0,0,6
8996,786619,6,1,1,1,1,0,0,0,0,0,0,0,2,0,0,0,2
8996,797439,10,1,2,1,1,0,1,0,0,0,2,0,2,0,0,0,2
8996,797437,12,1,2,1,2,0,0,0,1,1,1,0,3,3,2,0,2
8996,786622,23,2,5,2,3,0,2,1,1,0,2,1,2,0,2,1,5
8997,797715,39,2,7,1,3,1,4,6,7,0,10,3,1,2,6,0,11
8997,780937,30,8,14,4,5,4,9,2,2,2,4,2,4,1,2,0,22
8997,792115,25,3,7,3,4,0,3,4,4,1,0,3,2,0,0,0,10
8997,792113,34,6,11,3,4,3,7,0,0,0,3,2,2,1,2,0,15
8997,775754,39,5,16,4,10,1,6,3,3,1,8,3,2,3,2,0,14
8997,797716,5,0,1,0,1,0,0,0,0,1,0,0,0,0,0,0,0
8997,797717,7,1,3,0,0,1,3,0,0,1,1,0,0,0,0,0,3
8997,791950,16,0,3,0,2,0,1,1,2,1,0,1,0,1,0,0,1
8997,780938,5,0,0,0,0,0,0,0,0,0,1,0,0,0,1,0,0
8998,791062,38,2,8,2,8,0,0,2,2,0,6,0,1,0,1,2,6
8998,791063,24,5,9,4,8,1,1,0,0,4,5,3,0,0,1,1,11
8998,785542,38,3,8,2,6,1,2,2,4,2,3,3,2,2,1,0,9
8998,780743,38,5,12,4,8,1,4,7,7,0,0,4,2,0,2,0,18
8998,780055,21,0,2,0,1,0,1,0,0,0,4,0,0,0,0,0,0
8998,791060,2,0,2,0,1,0,1,0,0,0,0,0,0,0,1,0,0
8998,785548,13,3,4,1,2,2,2,0,0,2,3,0,1,0,1,0,8
8998,796735,3,1,1,0,0,1,1,0,0,1,0,1,0,0,1,0,3
8998,791064,23,3,4,1,1,2,3,0,0,0,1,4,3,0,2,0,8
8999,791289,18,1,1,1,1,0,0,0,0,2,1,0,1,0,0,0,2
8999,796576,28,5,15,2,7,3,8,0,0,0,3,2,4,1,1,0,13
8999,796571,26,2,7,1,3,1,4,0,0,0,5,1,1,0,2,0,5
8999,796572,24,1,3,1,3,0,0,0,0,2,3,1,3,0,1,1,2
8999,781346,36,4,13,3,6,1,7,0,0,0,2,5,1,0,0,0,9
8999,785786,22,3,5,3,4,0,1,0,0,3,2,0,3,2,1,2,6
8999,796574,27,7,9,5,5,2,4,4,4,1,1,0,2,3,1,0,20
8999,791290,19,0,3,0,0,0,3,0,0,0,3,1,0,0,3,0,0
9000,781007,24,7,11,7,11,0,0,0,1,0,6,1,1,0,0,0,14
9000,781322,28,9,11,4,4,5,7,2,2,1,4,0,1,1,2,0,25
9000,786571,27,4,5,2,3,2,2,2,2,0,3,5,1,0,1,0,12
9000,781419,25,1,9,1,4,0,5,1,3,1,4,2,0,2,1,0,3
9000,780563,34,1,5,1,1,0,4,0,0,3,4,5,1,4,1,0,2
9000,797299,14,1,1,1,1,0,0,0,0,2,1,1,4,0,2,1,2
9000,785989,24,2,5,2,3,0,2,3,5,0,6,4,1,3,3,0,7
9000,784248,10,1,4,0,0,1,4,0,0,0,0,0,0,0,1,0,3
9000,781207,9,1,2,1,2,0,0,0,0,0,2,1,1,0,1,0,2
9000,797300,2,1,1,1,1,0,0,0,0,0,0,0,0,1,1,0,2
9000,791692,1,0,0,0,0,0,0,0,0,0,0,0,0,0,0,0,0
9000,791691,2,0,0,0,0,0,0,0,0,0,0,0,0,0,0,0,0
9001,780634,22,1,2,1,2,0,0,0,0,0,4,0,1,1,2,4,2
9001,791826,15,2,3,0,0,2,3,0,0,0,0,1,3,0,2,0,6
9001,786785,26,5,9,5,5,0,4,0,0,2,4,2,1,0,2,1,10
9001,780633,28,2,10,2,4,0,6,0,0,0,1,0,0,1,3,0,4
9001,776009,34,6,13,6,9,0,4,0,0,0,3,2,2,3,1,0,12
9001,797389,18,2,3,2,3,0,0,1,2,2,6,0,0,0,0,1,5
9001,786784,20,1,8,1,5,0,3,2,2,1,1,1,1,0,1,0,4
9001,786783,21,0,3,0,1,0,2,1,2,0,3,0,3,1,1,0,1
9001,797387,3,0,0,0,0,0,0,0,0,0,0,0,2,0,0,0,0
9001,797388,7,2,2,2,2,0,0,0,0,0,0,0,0,0,0,0,4
9001,797390,3,0,0,0,0,0,0,0,0,0,0,0,0,0,1,0,0
9001,800144,3,1,4,0,3,1,1,0,0,1,0,0,0,0,0,0,3
9002,791440,1,0,0,0,0,0,0,0,0,1,0,1,5,0,1,0,0
9002,797019,21,0,4,0,2,0,2,0,0,0,2,2,0,1,3,0,0
9002,797016,19,0,4,0,1,0,3,5,5,0,2,2,0,1,2,0,5
9002,781378,33,3,8,3,5,0,3,2,2,0,6,0,4,3,0,0,8
9002,775267,16,1,4,1,1,0,3,3,3,0,1,0,0,0,1,0,5
9002,791443,20,0,2,0,1,0,1,0,0,0,4,2,0,0,0,1,0
9002,781629,7,1,1,1,1,0,0,0,0,0,2,0,1,0,0,0,2
9002,775739,7,0,0,0,0,0,0,0,0,0,0,2,0,0,1,0,0
9002,797015,32,9,18,9,16,0,2,6,12,3,6,0,1,0,3,2,24
9002,797013,24,6,10,2,5,4,5,4,4,0,1,2,2,0,2,0,20
9002,791441,19,3,6,3,4,0,2,0,0,0,2,1,0,0,1,0,6
9002,789009,1,0,0,0,0,0,0,0,0,0,0,0,0,0,0,0,0
9003,797367,28,6,10,6,10,0,0,0,1,2,5,1,2,1,0,1,12
9003,797369,29,6,9,5,7,1,2,0,0,0,4,2,3,5,3,0,13
9003,797366,28,3,6,3,5,0,1,1,2,4,4,2,3,2,2,0,7
9003,791807,31,6,12,2,3,4,9,3,4,2,3,2,1,1,1,0,19
9003,786130,25,4,9,3,4,1,5,1,2,1,5,5,2,2,2,1,10
9003,797371,7,2,3,2,3,0,0,0,0,0,1,0,2,0,0,0,4
9003,797364,4,1,1,1,1,0,0,2,2,0,1,0,2,0,1,1,4
9003,797365,15,1,5,0,0,1,5,0,0,0,2,0,2,0,0,1,3
9003,797363,23,4,12,3,7,1,5,2,2,1,2,2,2,0,1,0,11
9003,791808,10,0,1,0,0,0,1,0,0,0,0,0,0,0,0,0,0
9004,791403,2,0,1,0,1,0,0,0,0,0,0,0,1,0,0,0,0
9004,800038,37,5,8,4,6,1,2,1,1,2,2,0,1,0,0,0,12
9004,797114,24,0,7,0,5,0,2,6,7,1,1,0,5,2,4,0,6
9004,785928,28,3,9,3,6,0,3,0,0,2,3,0,3,2,2,0,6
9004,785923,29,5,10,4,6,1,4,3,3,0,1,5,0,0,0,0,14
9004,797113,14,0,1,0,0,0,1,0,2,0,1,0,3,0,0,1,0
9004,797110,9,1,5,0,0,1,5,0,0,0,0,0,0,0,0,0,3
9004,797115,3,0,1,0,0,0,1,0,0,0,1,0,0,0,1,0,0
9004,797109,8,1,1,1,1,0,0,4,6,1,1,0,0,0,0,0,6
9004,791406,17,3,4,3,4,0,0,1,3,1,7,0,4,0,1,1,7
9004,791404,29,4,8,2,3,2,5,8,8,0,3,2,3,2,3,0,18
9005,797562,4,1,1,1,1,0,0,0,0,0,0,0,1,0,1,0,2
9005,791766,19,2,5,1,1,1,4,0,0,0,0,1,4,1,1,0,5
9005,786230,34,5,10,3,5,2,5,4,4,0,2,2,1,0,0,0,16
9005,780604,34,5,12,4,11,1,1,7,9,3,4,4,2,2,4,0,18
9005,780602,35,4,7,4,6,0,1,3,4,2,10,5,1,1,0,4,11
9005,786071,7,2,3,2,3,0,0,1,3,3,0,0,1,0,0,0,5
9005,791768,20,6,6,6,6,0,0,2,2,1,4,2,3,0,1,0,14
9005,786460,11,1,3,1,3,0,0,0,0,1,1,0,5,1,0,0,2
9005,791767,20,4,7,3,6,1,1,2,2,1,3,1,4,0,0,0,11
9005,780605,5,0,1,0,0,0,1,0,0,0,1,1,1,1,0,0,0
9005,780603,11,1,5,1,3,0,2,2,2,0,0,1,2,0,2,0,4
9006,775758,17,1,4,1,3,0,1,0,0,1,0,0,4,1,2,0,2
9006,780227,32,1,5,1,5,0,0,7,13,4,6,2,3,2,2,0,9
9006,791340,42,4,11,4,10,0,1,3,3,1,5,2,2,1,1,0,11
9006,780181,45,8,21,6,9,2,12,14,14,1,12,1,2,0,5,1,32
9006,776089,44,1,10,0,2,1,8,0,0,2,2,4,4,0,1,0,3
9006,797262,0,0,0,0,0,0,0,0,0,0,0,0,1,0,0,0,0
9006,797260,14,2,4,2,3,0,1,0,1,1,2,1,3,0,0,0,4
9006,791336,4,0,0,0,0,0,0,0,0,0,0,0,0,0,1,0,0
9006,789178,27,1,2,0,1,1,1,0,0,0,1,1,1,1,1,0,3
9007,792418,32,4,8,4,8,0,0,1,2,1,4,0,5,1,2,1,9
9007,782654,31,3,3,3,3,0,0,4,5,1,3,2,2,1,1,0,10
9007,796693,35,3,9,3,8,0,1,0,1,0,5,1,1,2,1,0,6
9007,796691,39,3,9,2,4,1,5,2,2,1,4,2,2,1,4,0,9
9007,789484,24,2,8,2,8,0,0,2,4,1,3,0,4,0,2,0,6
9007,796695,5,0,2,0,2,0,0,0,0,1,1,0,1,0,0,0,0
9007,796692,1,0,0,0,0,0,0,0,0,0,0,0,0,0,0,0,0
9007,792424,8,1,1,1,1,0,0,0,3,0,2,0,2,0,0,1,2
9007,800100,9,1,2,1,2,0,0,0,2,0,0,0,0,2,0,0,2
9007,792421,18,0,4,0,2,0,2,2,2,1,1,1,2,0,1,0,2
9007,792422,23,6,10,6,10,0,0,0,0,0,4,1,5,1,2,0,12
9008,792308,3,0,1,0,1,0,0,0,0,0,0,0,0,0,0,0,0
9008,792318,25,2,7,2,7,0,0,3,7,2,4,0,5,2,3,0,7
9008,796518,30,3,5,2,2,1,3,1,2,2,6,1,3,0,3,0,8
9008,780753,37,7,12,5,8,2,4,7,8,0,4,3,3,1,5,0,23
9008,775329,21,4,5,2,3,2,2,1,1,2,1,0,3,2,1,1,11
9008,796519,31,3,5,3,4,0,1,3,4,3,1,0,1,1,4,1,9
9008,796520,21,1,5,1,4,0,1,1,2,0,2,1,1,1,0,0,3
9008,792315,1,0,0,0,0,0,0,0,0,0,0,0,1,0,0,0,0
9008,786717,31,1,11,1,9,0,2,4,5,2,8,0,1,1,2,1,6
9009,781081,17,4,5,4,5,0,0,3,3,1,4,0,5,1,1,2,11
9009,791864,34,9,16,8,13,1,3,0,1,1,4,0,3,0,0,0,19
9009,791863,23,4,7,4,6,0,1,2,4,6,4,0,5,1,4,0,10
9009,797472,25,3,10,3,5,0,5,1,2,1,1,0,1,0,3,0,7
9009,780965,40,2,11,2,5,0,6,3,3,1,3,8,1,4,5,0,7
9009,797473,21,2,2,2,2,0,0,0,2,1,2,0,3,0,2,5,4
9009,786791,5,0,0,0,0,0,0,0,0,0,1,0,0,0,0,0,0
9009,797470,22,5,11,4,6,1,5,0,3,1,1,2,4,1,1,0,11
9009,786592,13,0,2,0,1,0,1,1,2,0,1,0,3,0,0,0,1
9010,780094,31,2,3,2,3,0,0,5,7,2,4,2,4,0,0,1,9
9010,775142,35,5,14,2,8,3,6,8,9,2,3,0,2,4,1,0,21
9010,790843,38,7,10,3,5,4,5,4,4,0,7,2,1,0,3,0,22
9010,786212,24,6,11,4,8,2,3,0,0,1,4,2,4,0,0,0,14
9010,785392,37,4,10,1,3,3,7,1,2,0,1,5,1,0,2,0,12
9010,790844,24,0,5,0,4,0,1,0,0,1,3,2,1,0,1,1,0
9010,799986,6,1,2,1,2,0,0,0,0,2,1,0,1,0,0,0,2
9010,781563,5,0,0,0,0,0,0,0,0,0,1,0,1,0,0,0,0
9011,796336,31,2,6,0,1,2,5,0,0,0,1,4,2,2,1,0,6
9011,796334,31,4,10,4,6,0,4,4,7,0,4,0,4,1,3,0,12
9011,790776,20,3,5,3,5,0,0,0,0,4,1,1,4,0,0,3,6
9011,796330,28,2,8,0,3,2,5,3,3,1,6,1,3,0,1,1,9
9011,785813,37,6,14,3,7,3,7,4,4,0,2,8,2,0,2,0,19
9011,796337,11,2,2,2,2,0,0,0,0,0,2,1,0,0,0,0,4
9011,796332,16,1,2,0,0,1,2,0,0,0,1,0,1,0,1,0,3
9011,785827,17,2,3,2,3,0,0,1,3,0,3,1,1,0,0,0,5
9011,779975,9,2,3,2,3,0,0,1,2,1,2,0,1,0,1,0,5
9012,775910,26,4,11,4,9,0,2,2,3,6,0,1,2,0,0,1,10
9012,797561,20,1,6,1,4,0,2,0,0,0,1,0,0,0,0,0,2
9012,786451,37,6,12,4,7,2,5,1,3,2,3,1,2,2,1,0,15
9012,780600,36,6,13,4,6,2,7,2,2,1,7,4,1,2,4,2,16
9012,781387,32,0,5,0,1,0,4,2,2,0,4,5,3,0,4,0,2
9012,790888,10,3,9,1,4,2,5,0,0,3,1,1,2,0,0,0,8
9012,786456,6,2,2,2,2,0,0,0,0,1,0,0,1,0,0,1,4
9012,780268,7,0,0,0,0,0,0,0,0,1,0,0,1,0,0,0,0
9012,780020,24,4,10,2,6,2,4,2,2,1,5,0,2,1,0,0,12
9012,793065,1,0,0,0,0,0,0,0,0,0,0,0,0,0,0,0,0
9012,786457,1,0,0,0,0,0,0,0,0,0,0,0,0,0,0,0,0
9013,786656,24,4,4,4,4,0,0,3,8,3,2,0,2,1,2,3,11
9013,781408,12,1,2,1,1,0,1,0,0,0,4,0,1,1,2,0,2
9013,786691,27,0,2,0,1,0,1,0,0,0,2,6,4,0,5,0,0
9013,786693,25,2,8,1,4,1,4,3,3,0,3,1,1,1,0,0,8
9013,781329,29,3,14,1,5,2,9,0,0,0,2,0,3,2,3,0,8
9013,797876,5,0,0,0,0,0,0,0,0,0,1,0,1,0,1,0,0
9013,792219,16,1,4,1,4,0,0,2,4,0,1,0,1,0,0,0,4
9013,792222,12,3,4,1,1,2,3,1,1,0,1,0,0,0,0,0,9
9013,792046,14,3,8,3,5,0,3,1,2,0,1,1,0,1,2,0,7
9013,792221,12,0,1,0,1,0,0,0,0,1,2,0,2,0,1,1,0
9013,792220,6,1,1,1,1,0,0,0,0,0,0,0,2,0,0,0,2
9013,781455,18,0,1,0,1,0,0,0,0,0,2,2,1,0,0,0,0
9014,780109,27,2,6,0,2,2,4,5,5,0,10,0,4,0,2,0,11
9014,780794,40,2,9,0,1,2,8,2,2,0,5,1,2,0,1,1,8
9014,796761,16,1,1,1,1,0,0,1,1,0,2,0,5,0,1,1,3
9014,796757,37,10,19,6,9,4,10,2,2,0,4,4,5,2,0,0,26
9014,796758,37,11,17,11,15,0,2,2,4,2,7,3,4,1,3,0,24
9014,796760,2,0,1,0,1,0,0,0,0,1,0,0,0,0,0,0,0
9014,785597,35,2,6,0,2,2,4,2,2,0,1,1,3,0,0,0,8
9014,791103,6,0,0,0,0,0,0,1,2,0,1,0,0,0,0,0,1
9015,774869,31,5,8,1,1,4,7,2,3,0,0,0,2,0,1,0,16
9015,797967,36,7,12,7,10,0,2,0,0,0,4,3,3,0,1,0,14
9015,781453,35,4,14,1,7,3,7,4,4,2,12,4,3,1,2,0,15
9015,797972,26,2,5,2,5,0,0,3,4,1,2,0,4,2,0,1,7
9015,797970,34,5,11,3,6,2,5,5,6,1,5,0,0,1,0,0,17
9015,786098,20,0,5,0,3,0,2,2,2,0,1,1,1,0,0,0,2
9015,797962,7,0,0,0,0,0,0,0,0,0,1,0,1,0,0,0,0
9015,792254,11,2,2,2,2,0,0,4,4,1,2,0,4,0,0,0,8
9016,781205,14,2,3,2,3,0,0,0,0,1,3,1,1,0,4,0,4
9016,797491,37,3,9,3,7,0,2,2,2,1,2,2,4,0,2,2,8
9016,797486,34,1,4,1,4,0,0,3,8,0,4,2,1,1,2,1,5
9016,785667,11,0,4,0,2,0,2,0,0,0,1,1,0,0,2,0,0
9016,780436,37,7,13,4,8,3,5,6,6,1,8,4,0,1,1,1,23
9016,791876,31,7,13,5,9,2,4,4,6,4,9,2,1,1,1,2,20
9016,791877,24,3,5,2,3,1,2,1,2,1,5,3,4,2,0,1,8
9016,790396,8,1,1,1,1,0,0,0,0,0,0,1,1,1,0,0,2
9016,797487,4,0,0,0,0,0,0,0,0,0,0,0,1,0,0,0,0
9017,790899,23,1,3,1,3,0,0,3,4,2,4,0,3,0,2,1,5
9017,785442,30,4,8,3,5,1,3,0,0,0,3,0,2,1,0,0,9
9017,799907,18,1,7,0,3,1,4,0,1,0,0,2,2,1,1,0,3
9017,785579,36,5,12,2,4,3,8,4,4,0,1,4,1,3,1,0,17
9017,781628,21,1,6,0,2,1,4,2,5,2,5,2,0,1,1,1,5
9017,790897,27,4,10,2,5,2,5,0,0,0,1,3,4,0,1,0,10
9017,796446,11,1,2,1,2,0,0,0,0,0,1,0,3,0,1,0,2
9017,790898,4,0,1,0,0,0,1,0,0,0,0,1,0,0,0,0,0
9017,775737,28,2,4,0,0,2,4,0,0,0,4,2,2,0,2,1,6
9017,785448,2,0,0,0,0,0,0,0,0,0,0,0,0,0,0,0,0
9018,776110,17,1,4,0,0,1,4,0,0,1,0,0,0,2,0,1,3
9018,780059,33,5,11,5,8,0,3,0,1,2,7,6,1,3,4,0,10
9018,796494,13,0,5,0,2,0,3,2,2,2,1,0,1,0,0,0,2
9018,790944,31,8,16,3,7,5,9,2,2,0,3,0,2,2,2,0,23
9018,780061,31,4,10,1,2,3,8,0,0,0,6,2,2,2,0,1,11
9018,780058,7,0,1,0,0,0,1,0,0,0,1,0,2,0,0,0,0
9018,796496,15,2,3,2,2,0,1,1,4,0,2,2,1,2,1,0,5
9018,790941,11,2,3,2,3,0,0,0,0,4,0,0,1,1,0,0,4
9018,790943,7,0,1,0,1,0,0,0,0,0,0,0,2,0,0,0,0
9018,796499,1,0,0,0,0,0,0,0,0,1,0,0,0,0,0,0,0
9018,796497,1,0,0,0,0,0,0,1,2,0,0,0,0,0,0,0,1
9018,796495,1,0,1,0,0,0,1,0,0,0,0,0,0,0,0,0,0
9018,788853,1,0,0,0,0,0,0,0,0,0,0,0,1,0,0,0,0
9018,786754,30,5,13,4,8,1,5,0,0,0,1,3,2,1,0,0,11
9018,785097,1,0,0,0,0,0,0,0,0,0,0,0,0,0,0,0,0
9019,796699,25,3,10,3,7,0,3,1,3,2,5,0,3,1,1,0,7
9019,790983,31,5,6,5,5,0,1,3,4,1,2,1,3,0,2,1,13
9019,790978,36,4,9,1,3,3,6,0,0,0,6,1,3,1,3,0,11
9019,790979,34,2,8,2,4,0,4,3,4,1,8,1,1,0,4,0,7
9019,788820,36,4,13,2,6,2,7,0,0,1,3,7,3,2,5,0,10
9019,796698,9,0,0,0,0,0,0,0,2,1,2,0,1,0,1,0,0
9019,796701,13,2,3,2,3,0,0,2,2,2,2,0,1,0,3,1,6
9019,790976,7,0,1,0,1,0,0,0,0,2,2,0,0,0,1,1,0
9019,790977,4,1,1,0,0,1,1,1,1,0,0,0,1,0,0,0,4
9019,789457,1,0,1,0,0,0,1,0,0,0,0,0,0,0,0,0,0
9019,790980,4,0,1,0,0,0,1,0,0,0,0,0,0,0,0,0,0
9020,791004,28,6,16,1,2,5,14,2,4,2,4,0,4,2,1,1,19
9020,780291,38,5,17,3,10,2,7,7,8,6,12,2,0,0,1,2,19
9020,796665,35,4,11,2,4,2,7,0,0,0,4,2,4,4,4,0,10
9020,785333,32,2,4,2,3,0,1,1,1,2,3,1,2,1,1,0,5
9020,775305,30,7,19,6,12,1,7,1,3,1,3,3,3,1,1,0,16
9020,796663,2,0,1,0,1,0,0,0,0,1,1,0,0,0,0,0,0
9020,791006,11,0,1,0,1,0,0,0,0,0,0,0,0,1,1,0,0
9020,785607,4,2,2,2,2,0,0,0,0,1,0,0,0,0,0,0,4
9020,796666,7,0,2,0,2,0,0,0,0,1,0,1,1,0,0,0,0
9020,796664,36,2,9,2,5,0,4,0,0,4,0,2,3,2,1,1,4
9020,791005,2,1,1,1,1,0,0,0,0,0,0,0,0,0,0,0,2
9021,780440,37,10,18,5,9,5,9,4,4,2,12,0,1,0,1,1,29
9021,775620,20,1,1,1,1,0,0,0,0,0,2,1,4,0,1,2,2
9021,791621,40,6,13,4,5,2,8,4,5,2,5,3,1,1,2,0,18
9021,786432,30,2,3,1,2,1,1,2,2,0,5,1,3,1,2,0,7
9021,786431,38,6,11,4,7,2,4,5,6,0,4,5,0,0,6,0,19
9021,791620,7,0,1,0,1,0,0,0,0,0,2,0,1,0,1,0,0
9021,786434,10,0,4,0,4,0,0,0,0,1,2,2,1,0,0,1,0
9021,781125,15,3,6,3,6,0,0,0,0,1,2,2,1,0,1,2,6
9021,781088,25,1,6,1,3,0,3,1,1,1,1,2,3,1,2,0,3
9021,775622,3,0,0,0,0,0,0,0,0,0,0,0,0,0,0,0,0
9022,781174,34,2,4,2,4,0,0,2,2,1,6,1,1,0,2,5,6
9022,781159,19,2,4,1,2,1,2,2,2,0,1,1,3,0,2,0,7
9022,791001,31,1,5,0,4,1,1,1,2,2,8,0,2,0,0,1,4
9022,781215,28,2,5,1,4,1,1,6,7,1,3,0,4,1,1,1,11
9022,775255,29,4,16,3,8,1,8,3,3,1,3,1,2,0,2,0,12
9022,796644,3,0,1,0,1,0,0,0,0,0,0,0,1,1,0,0,0
9022,785320,11,2,3,2,3,0,0,0,0,0,0,0,0,0,1,0,4
9022,785231,13,1,3,1,1,0,2,0,0,0,2,0,1,0,0,1,2
9022,779972,32,6,12,3,7,3,5,3,4,1,3,3,2,3,4,0,18
9023,791281,34,3,14,2,10,1,4,4,4,3,5,2,0,0,0,2,11
9023,792276,34,3,7,2,4,1,3,1,1,2,8,3,2,2,0,0,8
9023,791278,27,4,8,0,0,4,8,0,0,0,2,1,5,0,2,1,12
9023,786026,32,6,13,5,11,1,2,3,3,2,4,1,2,0,1,1,16
9023,785507,23,2,9,0,4,2,5,0,0,0,1,0,1,1,1,0,6
9023,796534,14,1,1,1,1,0,0,0,0,0,1,2,2,0,0,1,2
9023,785764,13,2,3,2,3,0,0,3,3,0,0,0,2,1,2,0,7
9023,796535,6,0,0,0,0,0,0,0,0,0,1,1,1,0,1,0,0
9023,785398,17,2,5,1,4,1,1,0,0,0,1,1,2,1,1,0,5
9024,792388,15,1,2,1,2,0,0,0,0,2,3,1,2,1,2,0,2
9024,797851,39,4,7,3,4,1,3,0,0,1,2,3,1,2,1,0,9
9024,792393,32,8,15,8,13,0,2,5,5,4,2,0,2,0,2,0,21
9024,792391,27,4,7,4,7,0,0,6,7,1,4,4,4,1,0,0,14
9024,792395,38,7,15,6,12,1,3,6,7,2,4,2,2,1,3,1,21
9024,781533,30,2,5,1,3,1,2,2,2,0,2,2,2,2,1,1,7
9024,792394,3,0,1,0,0,0,1,0,0,0,0,0,0,0,0,0,0
9024,781541,16,0,3,0,0,0,3,0,0,0,1,2,0,0,1,0,0
9025,792593,20,6,7,6,7,0,0,1,2,3,1,3,5,1,4,1,13
9025,792594,38,3,10,2,6,1,4,2,3,0,4,2,4,2,1,1,9
9025,792588,39,2,5,2,2,0,3,0,1,0,8,2,3,0,1,0,4
9025,792595,35,5,8,3,4,2,4,0,0,0,1,1,3,1,4,0,12
9025,792583,32,5,8,1,1,4,7,0,0,0,1,0,0,1,1,0,14
9025,792580,20,3,3,3,3,0,0,0,0,0,0,2,3,0,1,1,6
9025,796987,13,4,6,4,6,0,0,1,2,0,0,2,1,0,1,0,9
9025,792591,3,0,1,0,0,0,1,0,0,0,0,0,1,0,1,0,0
9026,780323,24,2,7,2,7,0,0,0,0,5,1,4,0,3,2,2,4
9026,797894,25,3,7,3,7,0,0,1,2,3,4,2,1,1,2,0,7
9026,792229,27,4,8,3,5,1,3,0,1,1,4,2,3,1,1,1,9
9026,785954,27,7,8,3,3,4,5,2,2,0,0,4,1,0,2,1,20
9026,785811,17,2,4,2,3,0,1,0,0,0,1,6,2,0,1,0,4
9026,792234,14,4,4,4,4,0,0,1,3,0,6,1,1,0,0,0,9
9026,792233,22,3,7,2,5,1,2,1,2,0,0,2,1,1,0,0,8
9026,792230,15,1,3,1,2,0,1,0,0,0,2,0,1,0,0,0,2
9026,797893,7,1,3,1,3,0,0,0,0,1,0,0,1,1,0,0,2
9026,797891,12,2,4,2,3,0,1,0,0,1,0,1,1,0,0,0,4
9026,781356,10,0,1,0,1,0,0,0,0,0,0,0,2,0,0,0,0
9027,780874,18,2,5,0,2,2,3,0,0,0,3,0,3,1,1,0,6
9027,781326,22,3,3,3,3,0,0,1,3,1,2,0,1,1,1,2,7
9027,797870,27,1,8,1,3,0,5,0,0,1,0,2,3,1,1,0,2
9027,792210,30,3,8,3,5,0,3,0,1,2,2,2,1,2,3,0,6
9027,781323,31,4,12,3,9,1,3,1,1,3,1,2,1,0,4,0,10
9027,785638,21,2,4,2,3,0,1,0,0,1,1,1,3,1,2,0,4
9027,785430,14,2,3,2,3,0,0,4,4,2,4,0,1,0,0,0,8
9027,792215,21,2,6,1,4,1,2,1,2,0,4,0,1,0,0,0,6
9027,797868,7,0,0,0,0,0,0,0,0,0,0,0,1,0,1,0,0
9027,797869,4,0,0,0,0,0,0,0,0,1,0,0,0,0,0,0,0
9027,792213,5,0,0,0,0,0,0,0,0,0,0,0,0,0,0,0,0
9028,785681,11,0,1,0,1,0,0,0,0,0,3,0,0,0,0,1,0
9028,796789,27,4,11,3,8,1,3,0,0,0,4,1,5,2,1,0,9
9028,791126,54,9,17,9,17,0,0,4,5,8,5,6,2,0,3,1,22
9028,791124,50,6,14,4,10,2,4,3,4,0,2,5,1,0,2,0,17
9028,780050,50,13,24,13,18,0,6,4,5,2,11,4,1,1,4,0,30
9028,784479,8,1,3,1,3,0,0,0,0,1,1,0,3,0,0,0,2
9028,796786,8,1,3,0,0,1,3,0,0,0,0,0,0,0,0,0,3
9028,796788,0,0,0,0,0,0,0,0,0,0,0,0,0,0,0,0,0
9028,775813,37,7,12,6,11,1,1,5,7,3,3,5,4,0,2,1,20
9028,796784,2,0,0,0,0,0,0,0,0,0,0,0,0,0,0,0,0
9028,796782,24,2,2,1,1,1,1,0,0,0,0,0,0,0,0,0,5
9028,792711,4,0,0,0,0,0,0,0,0,0,0,0,0,1,0,0,0
9029,780521,39,6,10,3,4,3,6,2,2,1,1,1,3,2,3,0,17
9029,775163,4,1,1,1,1,0,0,0,0,0,1,0,5,1,1,0,2
9029,791370,38,4,10,1,2,3,8,0,0,0,3,3,3,0,1,2,11
9029,786199,54,8,21,5,11,3,10,4,7,0,5,12,2,4,2,0,23
9029,780991,49,7,13,4,8,3,5,2,3,1,4,1,1,1,3,1,19
9029,797269,22,2,3,2,3,0,0,0,3,2,2,0,1,0,0,3,4
9029,781611,28,3,4,3,4,0,0,2,2,4,5,0,2,0,0,2,8
9029,797271,32,6,10,3,4,3,6,0,0,1,2,3,2,1,2,0,15
9029,743593,9,1,4,0,3,1,1,2,2,2,1,0,0,0,0,0,5
9030,780406,17,5,5,3,3,2,2,8,8,2,3,0,2,2,2,0,20
9030,775087,21,2,6,2,5,0,1,0,0,3,8,6,2,1,0,0,4
9030,785296,23,5,10,3,3,2,7,1,2,1,4,2,2,1,2,1,13
9030,780212,32,5,13,2,2,3,11,0,0,0,4,2,1,0,2,0,13
9030,767245,29,13,21,13,21,0,0,6,6,5,3,1,1,2,2,0,32
9030,780214,7,1,1,1,1,0,0,0,0,0,2,0,1,0,0,0,2
9030,790985,4,1,2,1,2,0,0,0,0,1,0,0,0,0,0,0,2
9030,780215,8,0,1,0,1,0,0,0,0,0,1,0,1,0,0,1,0
9030,796597,2,0,1,0,0,0,1,0,0,0,0,0,0,0,0,0,0
9030,796596,8,0,1,0,0,0,1,0,0,0,2,1,1,0,1,0,0
9030,790984,23,2,2,0,0,2,2,0,0,0,1,6,2,0,1,0,6
9030,791168,4,1,2,0,0,1,2,0,0,0,0,0,0,0,0,0,3
9030,785297,22,2,6,1,3,1,3,0,0,1,3,4,3,0,0,0,5
9031,776209,39,6,14,4,7,2,7,7,10,2,5,2,4,0,1,1,21
9031,796938,39,4,10,1,3,3,7,1,2,2,1,2,3,0,2,0,12
9031,791240,37,2,6,2,6,0,0,4,6,0,0,1,0,2,4,0,8
9031,791237,20,3,8,2,3,1,5,0,0,2,2,0,2,0,1,1,7
9031,791238,40,5,14,4,10,1,4,1,3,0,5,5,0,2,1,0,12
9031,781227,18,2,5,1,3,1,2,0,0,1,5,1,1,0,0,0,5
9031,791235,3,0,1,0,1,0,0,0,0,0,1,0,2,0,1,0,0
9031,791236,4,0,2,0,1,0,1,0,0,0,0,0,1,0,0,0,0
9032,797529,40,3,5,2,4,1,1,1,2,3,6,2,3,3,1,1,8
9032,797527,44,6,9,6,7,0,2,0,0,2,2,2,2,4,3,1,12
9032,791936,42,8,20,8,20,0,0,1,4,6,4,3,2,1,3,0,17
9032,797532,45,8,18,6,12,2,6,2,3,0,5,11,2,1,2,0,20
9032,785688,30,6,13,1,3,5,10,5,5,0,1,0,1,1,1,0,22
9032,791932,1,0,0,0,0,0,0,0,0,0,0,0,0,0,1,0,0
9032,785988,23,2,6,1,4,1,2,3,3,1,5,0,1,1,1,0,8
9033,780686,40,5,8,5,8,0,0,4,5,4,9,11,4,2,4,0,14
9033,780683,37,2,8,1,1,1,7,0,0,1,7,0,1,1,2,2,5
9033,797681,22,4,7,2,3,2,4,0,0,0,1,2,4,0,3,0,10
9033,786112,43,6,14,3,6,3,8,3,3,0,3,6,3,1,5,0,18
9033,780688,38,12,21,7,10,5,11,1,1,4,2,3,4,0,2,0,30
9033,797682,2,0,0,0,0,0,0,0,0,0,1,0,1,0,1,0,0
9033,797680,9,0,2,0,1,0,1,0,0,0,0,1,0,0,1,0,0
9033,797677,5,1,2,0,0,1,2,0,0,0,0,0,0,0,1,0,3
9033,791942,6,0,0,0,0,0,0,0,0,0,0,0,0,0,1,0,0
9033,780689,23,1,1,0,0,1,1,0,0,0,3,0,2,1,0,0,3
9034,785355,39,2,4,2,3,0,1,3,4,0,6,1,2,1,1,0,7
9034,781462,43,13,20,12,19,1,1,2,4,8,6,5,4,0,4,3,29
9034,780876,24,6,11,4,7,2,4,0,1,0,4,2,2,1,4,0,14
9034,785353,44,3,13,2,6,1,7,8,10,0,7,4,3,2,1,1,15
9034,781457,45,3,10,3,6,0,4,4,4,1,3,3,2,3,1,0,10
9034,790895,5,2,3,0,0,2,3,0,0,0,0,1,1,0,1,0,6
9034,781673,23,0,3,0,1,0,2,0,0,2,0,1,4,2,1,0,0
9034,791305,2,0,0,0,0,0,0,0,0,0,0,0,0,0,0,1,0
9035,790761,40,9,19,7,15,2,4,0,0,2,6,3,3,4,1,0,20
9035,790764,29,5,8,4,6,1,2,1,1,1,3,2,5,1,2,0,12
9035,796322,35,9,9,9,9,0,0,2,7,4,3,1,5,3,1,3,20
9035,796319,31,2,8,1,2,1,6,3,3,1,2,1,0,0,3,0,8
9035,796320,26,1,3,0,0,1,3,0,0,0,1,2,3,0,3,0,3
9035,796321,19,1,8,1,4,0,4,0,1,0,2,1,0,0,1,0,2
9035,779993,32,2,6,1,3,1,3,0,0,1,5,8,2,0,2,0,5
9035,785219,11,1,5,0,1,1,4,3,3,0,1,1,1,0,0,0,6
9035,796323,1,0,1,0,1,0,0,0,0,1,0,0,1,0,0,0,0
9035,775668,1,0,1,0,1,0,0,1,2,1,0,0,0,1,0,0,1
9036,786447,24,5,8,5,8,0,0,6,8,4,6,2,5,1,4,0,16
9036,775074,31,4,6,4,6,0,0,3,3,2,8,0,4,0,1,0,11
9036,786448,30,2,6,2,5,0,1,1,2,1,7,1,1,1,1,1,5
9036,780731,27,2,10,1,8,1,2,2,2,0,3,3,2,1,0,0,7
9036,780462,36,6,10,3,7,3,3,2,2,2,1,7,1,1,2,0,17
9036,786132,5,0,0,0,0,0,0,0,0,0,0,0,2,0,2,0,0
9036,791632,20,3,5,0,0,3,5,2,2,0,2,0,3,0,2,2,11
9036,796971,21,1,5,0,3,1,2,0,0,1,1,1,1,0,1,1,3
9036,791631,6,0,0,0,0,0,0,0,0,0,0,1,0,0,1,0,0
9037,797222,24,5,8,5,8,0,0,3,6,0,3,1,5,1,1,3,13
9037,797217,18,0,1,0,0,0,1,0,0,0,1,0,0,0,1,0,0
9037,797218,32,1,9,0,3,1,6,0,0,0,1,3,1,1,2,0,3
9037,775697,37,3,10,0,2,3,8,1,4,1,1,8,2,0,1,0,10
9037,791454,25,8,14,8,13,0,1,0,1,3,5,3,2,0,2,0,16
9037,791846,30,1,3,1,2,0,1,3,4,2,3,1,3,3,0,0,5
9037,791453,3,0,1,0,0,0,1,0,0,0,0,0,0,0,0,0,0
9037,781526,31,3,10,2,8,1,2,8,10,2,1,0,2,0,0,1,15
9038,792235,22,1,4,1,4,0,0,0,0,0,2,0,2,1,0,1,2
9038,797646,22,1,3,1,3,0,0,0,0,1,1,1,3,0,4,0,2
9038,785990,31,4,12,3,8,1,4,8,9,0,5,4,4,1,2,1,17
9038,780849,31,2,10,0,2,2,8,0,0,1,0,0,4,0,0,0,6
9038,780853,34,2,9,2,7,0,2,2,8,0,3,3,4,1,7,0,6
9038,792039,21,2,4,2,3,0,1,4,4,0,4,1,2,2,1,0,8
9038,786010,15,1,3,1,2,0,1,2,2,0,1,0,1,2,2,0,4
9038,785998,4,1,2,1,1,0,1,0,0,0,0,0,1,0,0,0,2
9038,780776,18,2,2,2,2,0,0,1,2,0,2,0,1,1,0,0,5
9038,786001,2,0,1,0,0,0,1,0,0,0,0,0,0,0,0,0,0
9039,785518,22,3,9,1,6,2,3,5,5,5,5,3,2,2,2,0,13
9039,796390,22,2,4,2,3,0,1,2,6,3,2,0,3,0,3,1,6
9039,785451,18,2,6,1,3,1,3,2,2,0,5,0,3,2,2,0,7
9039,790832,27,6,11,1,3,5,8,1,2,0,4,2,3,2,0,0,18
9039,790834,27,5,7,4,5,1,2,1,1,1,6,1,4,0,2,1,12
9039,790831,10,1,3,1,3,0,0,0,0,2,2,0,5,0,3,1,2
9039,790833,27,3,6,2,3,1,3,2,4,0,4,4,1,0,5,1,9
9039,790830,29,0,3,0,2,0,1,1,2,1,3,3,1,0,1,1,1
9039,785379,13,0,3,0,1,0,2,2,4,0,0,1,0,0,1,0,2
9039,800099,3,1,2,0,0,1,2,0,0,0,0,0,1,0,0,0,3
9039,796389,2,0,0,0,0,0,0,0,0,0,0,0,1,0,0,0,0
9040,785495,30,5,17,4,14,1,3,2,2,1,5,0,1,0,1,2,13
9040,785958,34,5,13,5,12,0,1,5,8,5,4,4,2,4,4,1,15
9040,785659,31,2,6,2,4,0,2,2,2,0,5,1,3,1,1,0,6
9040,785494,32,3,9,3,7,0,2,8,10,1,2,3,3,1,3,0,14
9040,780698,32,6,11,5,8,1,3,0,0,4,6,11,2,3,4,1,13
9040,785490,14,3,4,2,2,1,2,0,0,1,2,1,0,1,1,0,7
9040,775377,12,2,2,2,2,0,0,2,3,2,2,0,1,0,1,1,6
9040,780427,15,2,5,0,3,2,2,0,0,1,4,0,2,0,1,1,6
9041,790935,13,0,1,0,0,0,1,0,0,0,1,1,0,0,3,0,0
9041,792442,25,5,5,5,5,0,0,1,1,3,9,0,3,1,1,3,11
9041,790938,17,2,6,2,5,0,1,1,1,1,1,0,0,1,0,1,5
9041,780933,20,0,7,0,3,0,4,0,0,0,0,0,5,0,0,1,0
9041,775340,36,10,28,5,15,5,13,2,2,1,2,4,2,3,2,0,27
9041,796491,2,0,0,0,0,0,0,0,0,0,1,0,1,0,0,0,0
9041,796190,21,2,5,2,2,0,3,3,4,3,1,1,3,0,0,0,7
9041,790937,14,1,3,1,3,0,0,0,0,1,2,1,2,1,1,1,2
9041,785445,22,4,9,3,5,1,4,2,2,2,4,1,4,2,2,1,11
9041,796492,14,3,7,3,7,0,0,4,4,0,3,1,0,2,0,0,10
9041,774826,16,2,4,1,3,1,1,0,0,0,2,2,0,0,1,0,5
9042,791980,33,4,9,2,4,2,5,2,2,4,3,0,3,1,1,1,12
9042,785972,21,1,5,1,5,0,0,2,2,4,0,0,0,0,2,0,4
9042,785967,25,0,3,0,3,0,0,9,10,4,5,0,3,0,3,0,9
9042,791977,39,7,11,3,3,4,8,0,0,0,4,0,0,0,0,0,18
9042,791978,40,5,14,3,8,2,6,7,8,0,4,8,3,2,2,2,19
9042,791976,31,9,14,8,10,1,4,7,8,0,1,1,1,1,5,0,26
9042,780160,25,0,0,0,0,0,0,0,0,1,3,3,5,2,0,2,0
9042,785973,7,0,0,0,0,0,0,0,0,0,1,2,1,0,2,0,0
9042,797800,4,0,0,0,0,0,0,1,2,0,0,0,1,0,1,0,1
9043,785298,12,1,1,1,1,0,0,1,2,0,2,0,3,0,1,0,3
9043,778046,39,10,21,5,10,5,11,0,1,1,2,6,5,0,2,1,25
9043,782121,43,7,14,3,7,4,7,2,2,0,3,5,4,0,3,0,20
9043,775793,33,5,11,4,4,1,7,0,0,1,3,2,1,0,4,0,11
9043,775224,34,3,4,3,4,0,0,1,4,5,3,2,3,2,0,2,7
9043,785485,17,2,3,2,3,0,0,0,0,1,0,0,4,2,0,0,4
9043,785302,27,7,12,4,7,3,5,1,1,2,3,0,2,4,2,0,18
9043,786594,20,1,4,1,3,0,1,4,4,3,0,1,0,0,1,0,6
9044,785458,31,5,15,5,13,0,2,3,9,3,6,0,1,3,2,2,13
9044,780798,27,1,5,1,2,0,3,0,2,2,2,2,2,2,0,0,2
9044,800055,16,2,4,2,4,0,0,0,0,2,4,0,3,0,1,0,4
9044,785454,23,1,3,1,2,0,1,2,2,0,1,7,0,3,5,0,4
9044,785453,28,6,17,2,8,4,9,2,2,0,3,0,0,0,0,0,18
9044,785455,23,2,6,1,2,1,4,3,4,1,2,1,2,0,1,0,8
9044,790914,4,0,1,0,1,0,0,0,0,0,1,0,0,0,0,0,0
9044,790913,16,3,6,3,6,0,0,2,2,1,6,2,0,1,3,0,8
9044,774940,12,2,7,1,4,1,3,1,2,0,0,1,2,0,0,0,6
9044,790915,15,5,7,5,7,0,0,0,0,2,0,0,4,0,1,0,10
9044,785456,3,0,0,0,0,0,0,0,0,0,0,0,0,0,1,0,0
9044,790912,2,0,1,0,0,0,1,0,0,0,0,0,0,0,0,0,0
9045,785536,20,1,5,0,2,1,3,0,0,0,6,1,1,0,1,4,3
9045,780119,34,8,12,8,12,0,0,6,7,1,7,2,1,1,1,0,22
9045,796558,20,1,2,1,2,0,0,2,2,2,6,2,2,2,5,0,4
9045,796559,34,10,15,6,6,4,9,4,4,0,7,2,3,2,0,0,28
9045,776097,18,1,5,1,3,0,2,0,0,1,0,1,2,0,3,0,2
9045,780149,30,9,16,6,8,3,8,0,0,0,5,5,1,5,3,0,21
9045,785280,26,5,8,0,1,5,7,0,0,0,1,2,5,0,2,0,15
9045,775679,9,2,4,0,0,2,4,0,0,0,0,2,1,0,0,0,6
9045,785285,6,0,0,0,0,0,0,0,0,0,0,0,2,0,0,0,0
9045,780972,1,0,0,0,0,0,0,0,0,0,1,0,0,0,0,0,0
9045,781908,2,0,0,0,0,0,0,0,0,0,0,0,0,0,0,0,0
9046,797573,12,0,3,0,3,0,0,0,2,4,1,0,2,0,1,0,0
9046,791903,20,5,9,3,4,2,5,0,1,3,1,0,1,1,0,1,12
9046,797571,34,4,11,3,8,1,3,1,4,1,4,6,2,6,3,0,10
9046,791899,39,8,18,8,15,0,3,3,6,5,5,0,2,2,1,0,19
9046,786512,36,6,15,2,7,4,8,0,0,0,2,2,3,1,1,0,16
9046,797574,19,1,4,1,2,0,2,0,0,1,1,0,1,0,0,1,2
9046,797575,12,0,1,0,1,0,0,0,0,0,0,0,4,0,0,0,0
9046,786032,28,2,9,2,9,0,0,0,0,0,3,1,0,1,2,0,4
9047,775455,26,4,8,3,6,1,2,1,2,0,6,5,3,2,2,0,10
9047,792124,21,3,5,3,5,0,0,4,5,2,6,0,2,0,4,0,10
9047,792123,28,5,6,0,0,5,6,0,0,0,7,1,2,0,1,0,15
9047,786005,26,4,7,1,1,3,6,2,2,1,3,0,1,0,1,0,13
9047,781397,29,5,8,5,6,0,2,0,0,1,3,3,2,0,3,0,10
9047,797754,9,0,0,0,0,0,0,0,0,1,0,2,1,0,0,0,0
9047,786009,16,1,6,1,5,0,1,1,2,1,2,1,0,1,3,0,3
9047,797749,18,0,3,0,2,0,1,2,2,0,1,0,2,0,0,0,2
9047,797747,15,2,2,0,0,2,2,0,0,1,2,0,2,0,3,0,6
9047,792120,3,1,1,1,1,0,0,2,2,0,0,0,0,1,1,0,4
9047,786002,9,0,1,0,0,0,1,0,0,0,0,0,1,0,0,0,0
9048,786857,32,5,12,1,5,4,7,2,5,2,9,0,3,1,1,3,16
9048,781403,38,6,17,4,11,2,6,4,5,1,6,2,2,1,2,0,18
9048,792654,30,6,7,6,7,0,0,1,1,4,3,1,2,0,2,0,13
9048,797301,36,2,7,1,4,1,3,0,0,2,5,2,2,1,4,0,5
9048,780524,26,1,4,0,2,1,2,1,2,0,3,2,5,1,1,0,4
9048,781400,29,3,13,2,6,1,7,5,6,1,2,3,2,0,2,0,12
9048,792653,7,1,1,1,1,0,0,2,2,3,1,0,1,0,0,1,4
9048,797303,0,0,0,0,0,0,0,0,1,0,0,0,0,0,0,0,0
9048,797302,2,0,0,0,0,0,0,0,0,0,0,0,0,0,0,0,0
9049,791949,31,4,15,1,7,3,8,1,2,2,10,1,2,0,2,1,12
9049,776014,20,0,2,0,0,0,2,0,0,2,2,1,1,0,0,0,0
9049,797690,32,3,9,2,7,1,2,4,5,3,4,4,4,1,1,0,11
9049,797691,26,3,8,2,5,1,3,1,2,0,2,0,2,1,3,0,8
9049,780747,23,1,5,1,3,0,2,3,3,0,2,3,5,1,2,0,5
9049,785304,21,4,10,2,2,2,8,0,0,0,1,3,3,2,2,0,10
9049,784336,4,1,2,1,2,0,0,0,0,0,0,0,1,0,1,0,2
9049,791946,23,5,11,3,5,2,6,2,2,2,3,1,1,1,0,0,14
9049,797689,20,1,6,1,3,0,3,2,2,3,3,1,3,1,1,1,4
9050,796754,33,7,13,4,7,3,6,2,3,1,2,0,1,1,3,1,19
9050,796755,14,3,4,3,4,0,0,0,0,0,2,1,2,2,1,1,6
9050,791099,36,5,14,1,3,4,11,0,0,1,4,3,0,1,1,0,14
9050,785470,22,1,5,1,3,0,2,2,2,1,3,2,0,2,2,2,4
9050,780298,29,5,11,4,4,1,7,3,3,1,2,2,3,3,4,0,14
9050,780814,24,4,5,4,5,0,0,0,0,3,1,3,3,0,1,0,8
9050,780315,15,0,1,0,0,0,1,0,0,0,1,0,2,0,0,0,0
9050,785586,27,1,2,1,2,0,0,6,6,0,5,1,1,0,0,0,8
9051,792277,5,0,1,0,1,0,0,0,0,0,2,0,1,0,0,0,0
9051,781464,25,3,4,0,0,3,4,0,0,0,0,0,0,0,1,0,9
9051,785282,34,4,8,3,4,1,4,2,2,0,4,2,1,1,1,0,11
9051,781502,36,4,13,3,7,1,6,2,4,0,2,7,3,2,1,0,11
9051,780259,30,7,11,5,7,2,4,0,0,2,7,1,3,0,2,0,16
9051,785913,29,3,8,3,8,0,0,3,3,3,2,1,4,2,3,0,9
9051,781501,26,4,7,3,5,1,2,4,4,0,3,2,3,2,3,0,13
9051,798058,4,0,0,0,0,0,0,0,0,0,0,1,0,0,2,0,0
9051,786516,11,0,1,0,0,0,1,0,0,0,0,0,0,0,1,0,0
9052,780012,30,2,7,1,4,1,3,2,2,0,6,0,1,0,1,1,7
9052,796309,22,1,8,1,8,0,0,4,6,0,5,0,3,2,0,0,6
9052,790824,31,1,9,1,8,0,1,0,0,2,3,2,3,1,1,2,2
9052,780011,31,3,8,3,7,0,1,5,5,0,1,2,1,2,0,0,11
9052,775667,27,2,6,1,5,1,1,0,0,0,0,0,0,0,2,0,5
9052,774895,13,4,4,4,4,0,0,1,2,1,2,0,2,0,4,1,9
9052,781524,17,1,2,1,1,0,1,1,3,0,1,0,1,0,0,0,3
9052,785370,6,2,3,2,3,0,0,0,0,0,0,0,1,0,1,0,4
9052,796384,4,0,0,0,0,0,0,2,4,0,1,0,1,0,1,0,2
9052,796382,4,0,1,0,1,0,0,0,0,0,1,0,0,0,0,0,0
9052,785367,4,1,1,1,1,0,0,0,0,0,0,0,0,0,0,0,2
9052,796383,7,0,0,0,0,0,0,2,2,0,1,0,0,0,0,0,2
9052,780941,4,0,0,0,0,0,0,0,0,0,0,0,1,0,0,0,0
9053,791416,22,6,10,6,10,0,0,0,1,2,5,0,4,0,2,1,12
9053,797096,32,2,7,0,3,2,4,0,0,0,4,0,2,0,3,0,6
9053,781614,31,1,2,0,1,1,1,0,0,3,3,5,1,1,1,0,3
9053,780100,31,2,6,1,3,1,3,2,2,1,5,0,4,0,0,0,7
9053,780096,34,7,18,5,13,2,5,6,7,1,3,1,1,2,3,0,22
9053,797093,19,8,14,8,14,0,0,1,2,1,5,2,4,0,2,0,17
9053,785907,15,2,3,2,3,0,0,0,0,2,0,0,1,1,0,1,4
9053,797094,9,1,2,1,2,0,0,1,2,1,2,1,2,1,0,0,3
9053,785903,2,1,1,1,1,0,0,0,0,0,1,0,0,0,0,0,2
9053,767484,2,0,1,0,1,0,0,0,0,0,1,0,1,0,1,0,0
9053,791417,2,0,0,0,0,0,0,0,0,0,0,0,0,0,0,0,0
9053,797097,1,0,0,0,0,0,0,0,0,0,0,0,0,0,0,0,0
9054,781480,33,5,12,4,8,1,4,2,2,2,4,5,3,0,3,1,13
9054,774846,18,3,4,3,4,0,0,4,4,0,1,0,5,0,0,0,10
9054,791376,37,2,11,1,3,1,8,0,0,1,4,4,3,1,0,0,5
9054,797272,32,1,8,0,2,1,6,0,0,0,3,3,2,3,4,0,3
9054,766611,38,9,16,5,9,4,7,0,0,1,2,3,3,2,3,0,22
9054,786185,22,5,8,5,8,0,0,1,3,3,2,1,4,1,1,1,11
9054,797273,20,1,3,0,0,1,3,0,0,0,3,2,1,3,4,1,3
9055,796469,27,3,7,2,4,1,3,5,5,1,3,1,3,1,2,1,12
9055,779981,10,3,4,3,4,0,0,0,2,0,0,0,5,1,1,0,6
9055,785463,34,3,7,1,3,2,4,6,6,0,7,4,2,1,3,0,14
9055,779978,35,5,7,3,4,2,3,0,0,0,3,5,1,0,4,0,12
9055,776003,31,4,10,3,5,1,5,0,0,0,4,4,1,2,4,0,9
9055,790923,27,4,7,4,7,0,0,9,10,3,5,0,2,3,3,2,17
9055,785466,6,0,1,0,0,0,1,0,0,0,0,0,0,0,0,0,0
9055,779980,6,0,2,0,2,0,0,0,0,1,1,0,3,0,1,0,0
9055,779979,21,3,5,0,1,3,4,0,0,0,2,1,0,0,0,0,9
9055,785467,3,1,1,1,1,0,0,0,0,1,1,0,0,0,0,0,2
9056,786519,38,4,5,4,5,0,0,1,2,3,5,1,1,2,3,0,9
9056,791911,10,0,6,0,0,0,6,0,0,0,0,0,0,0,0,0,0
9056,797556,36,7,14,3,5,4,9,2,2,0,2,2,1,1,0,0,20
9056,791913,40,7,15,5,8,2,7,1,1,0,2,6,0,2,5,0,17
9056,786520,33,3,8,2,4,1,4,3,3,5,4,4,3,2,1,0,10
9056,797558,22,5,11,4,8,1,3,0,0,4,4,2,2,0,0,0,11
9056,797560,2,0,0,0,0,0,0,0,0,0,0,0,0,0,0,0,0
9056,781105,19,1,3,0,1,1,2,0,0,1,3,1,4,0,2,0,3
9057,786792,28,3,3,3,3,0,0,0,0,0,5,0,4,0,0,1,6
9057,792414,37,7,9,2,2,5,7,0,1,2,3,1,2,0,0,0,19
9057,789020,37,7,16,3,5,4,11,2,2,0,1,3,0,2,1,0,20
9057,786787,39,5,13,1,2,4,11,2,2,0,1,5,1,1,5,0,16
9057,774954,25,1,1,1,1,0,0,2,2,1,3,2,1,1,2,0,4
9057,786795,9,0,0,0,0,0,0,0,0,0,3,0,1,0,0,0,0
9057,781497,3,0,0,0,0,0,0,0,0,0,0,0,1,1,1,0,0
9057,792091,16,2,6,2,4,0,2,0,0,0,2,1,1,0,0,0,4
9057,781456,6,0,1,0,1,0,0,0,0,0,1,0,0,0,1,0,0
9058,786059,39,11,18,10,15,1,3,12,15,7,7,0,5,2,4,2,35
9058,776174,23,5,7,5,7,0,0,4,4,1,5,1,5,0,3,2,14
9058,791958,39,4,9,4,8,0,1,9,10,2,8,3,1,2,3,0,17
9058,791960,37,2,7,0,4,2,3,0,0,0,4,2,4,1,6,0,6
9058,785861,44,3,9,0,2,3,7,1,2,0,8,0,0,2,2,0,10
9058,797704,9,0,1,0,0,0,1,0,0,0,2,1,1,0,0,0,0
9058,781332,34,4,10,4,6,0,4,2,4,0,0,0,4,1,2,0,10
9059,786039,32,3,5,3,5,0,0,2,2,3,3,0,4,0,0,0,8
9059,792043,17,2,4,1,2,1,2,0,0,1,1,0,5,0,0,0,5
9059,786266,40,9,19,5,9,4,10,9,9,1,8,0,4,4,3,0,31
9059,792040,30,5,13,3,9,2,4,2,2,1,3,2,5,0,4,0,14
9059,775028,40,9,17,6,13,3,4,4,9,1,1,5,3,1,1,0,25
9059,797728,10,1,3,0,0,1,3,2,2,0,1,0,0,0,0,0,5
9059,797726,21,3,10,3,7,0,3,0,0,1,5,0,3,1,4,0,6
9059,797719,8,0,2,0,0,0,2,0,0,0,0,0,2,2,1,0,0
9059,797718,27,0,2,0,1,0,1,0,0,0,3,3,1,4,0,0,0
9060,790827,12,0,2,0,1,0,1,4,4,0,3,0,2,0,1,1,4
9060,790828,12,1,2,1,2,0,0,4,6,0,3,0,4,0,0,1,6
9060,785372,37,8,16,7,14,1,2,5,8,2,6,5,3,2,3,1,22
9060,796385,13,0,0,0,0,0,0,0,0,1,2,2,1,0,2,0,0
9060,774905,34,4,9,3,4,1,5,4,7,2,5,1,2,2,1,2,13
9060,796387,5,0,0,0,0,0,0,0,0,1,1,0,0,0,0,1,0
9060,785373,29,4,9,2,5,2,4,0,0,2,5,1,0,0,0,1,10
9060,786384,22,2,6,2,3,0,3,2,3,2,2,2,4,0,1,0,6
9060,790825,16,0,4,0,2,0,2,0,0,0,0,0,0,0,1,0,0
9060,785375,16,1,5,1,5,0,0,1,2,3,3,0,2,1,0,3,3
9060,785374,4,0,0,0,0,0,0,0,0,0,0,0,3,0,0,0,0
9061,791401,27,1,5,1,5,0,0,7,10,5,2,1,4,3,2,1,9
9061,786837,29,2,7,2,3,0,4,2,2,1,4,0,4,0,1,0,6
9061,780125,27,3,7,3,7,0,0,2,5,0,4,1,2,0,1,2,8
9061,785931,34,6,16,4,8,2,8,2,2,1,5,4,3,2,2,0,16
9061,780118,22,0,7,0,4,0,3,3,4,0,1,0,5,0,0,0,3
9061,797126,10,1,3,1,2,0,1,1,2,1,2,0,3,0,1,0,3
9061,797125,22,2,3,2,2,0,1,2,2,1,5,0,2,0,1,0,6
9061,797130,22,3,5,3,4,0,1,1,2,0,3,2,1,1,0,0,7
9061,797132,7,0,2,0,0,0,2,0,0,1,0,1,0,0,0,0,0
9062,791522,35,5,10,4,7,1,3,3,4,2,11,4,1,1,6,1,14
9062,786351,28,5,8,2,3,3,5,0,0,2,8,4,4,1,3,1,13
9062,786348,17,2,3,2,2,0,1,0,0,2,2,0,0,0,0,0,4
9062,797146,35,6,20,3,14,3,6,8,9,3,7,1,1,0,1,0,23
9062,797143,37,4,13,2,4,2,9,2,2,0,2,3,4,1,3,0,12
9062,797142,9,1,1,1,1,0,0,0,0,0,4,0,3,0,1,1,2
9062,785816,16,4,4,4,4,0,0,0,1,2,2,2,2,0,0,1,8
9062,797147,12,1,2,1,2,0,0,0,0,0,0,1,1,0,2,0,2
9062,797144,10,2,4,1,2,1,2,0,0,0,1,2,1,1,0,0,5
9062,797148,1,0,0,0,0,0,0,0,0,0,0,0,0,0,0,0,0
9063,776424,11,0,1,0,1,0,0,0,2,0,0,0,3,0,2,1,0
9063,796155,15,1,2,0,0,1,2,0,0,1,1,0,2,0,0,0,3
9063,792300,30,5,11,2,6,3,5,0,0,1,5,2,1,2,4,1,13
9063,781607,4,0,1,0,0,0,1,0,0,0,0,0,0,0,0,0,0
9063,781603,36,8,18,8,13,0,5,4,6,0,4,3,2,1,0,0,20
9063,797912,13,1,2,0,0,1,2,2,4,1,4,1,3,2,0,0,5
9063,790813,24,2,7,1,2,1,5,2,2,0,3,0,1,1,0,0,7
9063,797914,28,3,9,1,4,2,5,1,4,0,1,2,1,3,0,0,9
9063,780456,16,0,4,0,2,0,2,2,2,0,1,0,1,0,1,0,2
9063,797907,6,1,2,1,2,0,0,0,0,1,0,0,0,0,0,0,2
9063,786618,12,2,3,2,3,0,0,1,1,1,1,1,1,1,0,0,5
9063,781605,5,1,2,1,2,0,0,0,0,0,2,0,1,0,1,0,2
9064,790839,20,1,1,1,1,0,0,0,0,1,2,3,2,0,0,0,2
9064,785388,22,4,8,4,8,0,0,1,1,3,4,1,4,1,3,0,9
9064,796395,31,4,9,3,5,1,4,9,10,1,2,2,1,0,2,1,18
9064,785386,28,1,5,1,3,0,2,0,2,0,1,0,3,1,1,0,2
9064,780373,34,2,5,2,4,0,1,0,0,0,1,8,1,1,1,0,4
9064,780370,20,3,3,0,0,3,3,2,2,1,5,2,4,0,1,1,11
9064,796393,18,8,11,8,11,0,0,5,7,4,3,1,3,0,1,1,21
9064,790840,15,0,5,0,3,0,2,1,2,0,5,1,1,0,1,0,1
9064,790841,12,1,3,0,1,1,2,2,2,0,1,0,0,0,0,0,5
9065,790930,36,3,5,3,3,0,2,1,2,6,4,2,1,0,1,0,7
9065,780358,25,5,10,5,7,0,3,1,3,0,2,0,3,0,2,2,11
9065,775011,28,4,9,3,5,1,4,2,2,1,1,1,3,0,0,0,11
9065,780357,38,4,12,1,4,3,8,4,6,0,3,3,3,0,1,0,15
9065,775018,35,2,10,0,2,2,8,4,4,0,3,4,3,0,0,0,10
9065,776004,15,3,5,2,2,1,3,4,4,2,1,1,4,1,1,1,11
9065,796480,16,1,4,1,3,0,1,0,0,0,2,0,3,0,0,2,2
9065,776270,7,1,2,1,2,0,0,0,0,0,0,0,1,0,1,0,2
9066,791194,33,4,8,3,7,1,1,3,3,2,8,3,4,2,0,1,12
9066,780384,32,8,12,8,12,0,0,4,4,3,3,0,3,1,1,3,20
9066,780159,24,0,2,0,1,0,1,1,4,0,2,1,4,0,2,0,1
9066,775694,33,6,14,5,11,1,3,0,0,2,5,0,4,2,3,0,13
9066,774827,35,4,16,3,7,1,9,0,0,1,2,6,2,0,4,0,9
9066,796863,10,1,2,1,2,0,0,0,0,0,2,1,3,0,1,0,2
9066,800119,18,4,11,4,9,0,2,0,0,2,0,1,0,0,0,1,8
9066,796865,12,2,6,0,1,2,5,0,0,0,1,0,2,0,0,0,6
9066,799890,3,0,0,0,0,0,0,0,0,1,0,0,1,0,0,0,0
9067,797048,18,2,4,2,3,0,1,1,2,0,1,0,3,0,4,0,5
9067,797050,29,4,8,4,7,0,1,4,4,1,4,1,3,0,3,0,12
9067,780394,33,3,9,3,5,0,4,3,4,0,9,0,1,1,3,0,9
9067,790871,34,7,12,6,8,1,4,5,7,2,5,3,0,2,2,1,20
9067,780392,28,4,8,2,3,2,5,1,2,0,3,1,2,1,0,2,11
9067,776473,27,3,5,1,2,2,3,4,4,0,4,4,3,0,1,0,12
9067,780391,2,0,1,0,1,0,0,0,0,0,0,0,0,0,0,0,0
9067,785783,18,3,6,2,3,1,3,1,2,0,2,1,2,0,1,1,8
9067,791573,11,0,2,0,0,0,2,0,0,0,1,1,0,1,0,0,0
9068,786299,23,3,5,3,5,0,0,3,6,1,6,1,2,0,2,0,9
9068,797215,28,3,7,3,5,0,2,0,0,0,3,2,0,0,5,0,6
9068,786295,22,4,11,3,5,1,6,3,3,3,5,0,2,2,1,0,12
9068,780792,21,4,6,3,4,1,2,0,0,0,3,3,2,0,1,0,9
9068,775598,26,4,7,1,3,3,4,0,0,2,1,1,2,0,1,0,11
9068,780122,12,3,6,2,3,1,3,0,0,1,4,0,0,0,1,2,7
9068,797214,21,1,7,0,5,1,2,1,2,1,2,1,4,0,1,0,4
9068,791461,24,2,6,1,2,1,4,1,3,2,6,1,3,0,1,0,6
9068,791460,23,1,5,1,3,0,2,0,0,0,1,1,5,0,0,0,2
9069,797715,33,3,10,2,5,1,5,10,11,0,7,2,3,1,2,0,17
9069,780937,39,4,8,2,4,2,4,2,3,0,7,1,2,1,2,1,12
9069,792115,23,1,3,0,2,1,1,0,0,0,2,2,1,0,0,0,3
9069,792113,35,3,6,2,4,1,2,2,3,2,3,1,3,1,2,0,9
9069,775754,40,8,20,7,15,1,5,6,8,0,5,2,2,1,0,1,23
9069,797717,4,0,0,0,0,0,0,0,0,0,0,0,1,0,0,0,0
9069,791950,25,2,5,1,2,1,3,3,6,0,2,0,1,0,1,0,8
9069,780938,1,0,1,0,1,0,0,0,0,1,0,0,0,0,0,0,0
9070,792388,17,1,1,1,1,0,0,0,0,1,1,1,3,0,0,1,2
9070,797851,29,1,7,1,2,0,5,4,4,0,0,0,1,1,1,0,6
9070,792393,36,5,11,5,9,0,2,4,5,0,8,2,4,2,5,0,14
9070,792391,35,8,15,8,13,0,2,5,6,6,7,2,1,7,2,0,21
9070,792395,40,1,8,1,7,0,1,2,4,4,4,2,4,2,3,0,4
9070,781533,28,4,9,1,3,3,6,2,2,1,2,0,2,1,1,0,13
9070,781541,15,1,3,1,2,0,1,2,3,0,2,0,2,1,0,0,4
9070,792394,0,0,0,0,0,0,0,0,0,0,0,0,0,0,0,0,0
9071,792593,31,3,9,3,8,0,1,5,8,0,1,1,3,2,3,1,11
9071,792594,34,4,7,2,3,2,4,6,7,0,5,0,5,2,4,0,16
9071,792588,38,4,8,0,1,4,7,4,5,1,7,3,2,0,0,0,16
9071,792595,38,3,7,2,5,1,2,1,1,0,5,4,3,1,4,0,8
9071,792583,30,2,8,0,1,2,7,0,0,0,0,0,3,0,2,0,6
9071,792580,9,0,0,0,0,0,0,0,0,0,2,1,1,0,0,1,0
9071,792591,8,0,3,0,3,0,0,0,0,1,0,0,0,1,0,0,0
9071,796987,12,1,1,1,1,0,0,0,0,0,0,1,3,1,4,0,2
9072,791686,24,6,11,6,9,0,2,1,3,0,6,3,4,0,3,1,13
9072,798028,30,3,6,2,5,1,1,0,0,0,4,3,2,2,3,0,7
9072,792270,28,2,3,1,2,1,1,5,5,2,7,0,3,2,0,0,10
9072,790940,37,1,9,1,5,0,4,3,4,1,3,3,4,2,2,0,5
9072,780770,33,5,11,4,10,1,1,6,7,0,2,4,4,2,3,0,17
9072,792269,15,1,2,1,1,0,1,0,1,1,1,0,1,0,0,1,2
9072,792271,9,0,2,0,2,0,0,2,2,0,1,0,2,0,0,0,2
9072,786060,23,5,9,1,3,4,6,0,0,0,1,1,0,0,0,0,14
9072,798022,1,0,0,0,0,0,0,0,0,0,0,0,0,0,0,0,0
9073,786029,27,5,7,5,7,0,0,2,5,2,8,0,3,0,1,0,12
9073,781398,31,9,12,5,7,4,5,1,6,3,2,0,4,0,0,2,23
9073,792114,34,3,12,0,4,3,8,3,4,2,2,6,0,3,2,0,12
9073,786018,35,7,12,3,4,4,8,2,3,3,10,0,2,0,0,1,20
9073,775678,33,1,10,0,3,1,7,0,2,0,1,12,1,1,6,0,3
9073,797746,16,1,4,1,3,0,1,1,2,2,1,3,2,1,1,2,3
9073,797740,11,1,3,0,1,1,2,2,2,0,1,1,1,0,2,0,5
9073,797737,11,0,0,0,0,0,0,0,0,0,1,0,1,0,0,0,0
9073,786022,2,0,0,0,0,0,0,0,0,0,0,0,0,0,0,0,0
9074,785368,24,3,6,3,5,0,1,4,4,1,2,1,2,0,0,1,10
9074,780281,34,1,3,1,2,0,1,0,0,1,10,0,2,1,2,1,2
9074,790793,37,9,11,9,10,0,1,3,3,0,3,3,0,0,4,1,21
9074,785246,29,4,8,1,2,3,6,0,0,0,1,1,1,1,2,1,11
9074,780886,32,3,7,2,3,1,4,5,7,1,4,5,1,1,5,0,12
9074,790794,14,1,1,1,1,0,0,2,2,1,3,0,1,1,0,0,4
9074,790789,3,0,1,0,1,0,0,0,0,0,0,0,1,1,1,0,0
9074,790792,18,3,5,2,4,1,1,1,2,0,0,1,3,0,2,0,8
9074,796351,6,0,0,0,0,0,0,0,0,0,1,0,0,0,0,0,0
9074,790790,2,1,1,1,1,0,0,0,0,0,0,0,0,0,0,0,2
9074,796350,1,0,0,0,0,0,0,0,0,0,0,0,0,0,0,0,0
9075,790863,11,1,4,1,3,0,1,0,0,1,2,0,3,0,1,0,2
9075,780021,30,6,8,6,8,0,0,0,2,2,3,1,5,1,4,0,12
9075,785412,27,5,11,1,4,4,7,0,0,0,1,2,2,1,2,0,14
9075,780099,34,4,10,2,4,2,6,1,2,0,1,1,3,0,1,0,11
9075,776214,38,7,15,6,12,1,3,2,2,2,1,9,2,6,1,1,17
9075,775686,33,4,7,2,4,2,3,4,5,4,2,1,0,1,0,0,14
9075,785413,11,1,3,1,3,0,0,0,0,0,1,0,0,0,1,0,2
9075,785417,4,0,2,0,1,0,1,0,0,1,0,0,0,0,0,0,0
9075,776221,12,0,1,0,0,0,1,0,0,0,0,0,1,0,1,0,0
9076,786163,17,0,5,0,4,0,1,2,5,2,1,0,2,0,1,0,2
9076,781149,28,3,7,3,4,0,3,2,2,1,1,0,1,2,2,0,8
9076,798152,8,0,3,0,1,0,2,0,0,0,2,1,0,2,1,0,0
9076,789025,29,2,4,2,2,0,2,3,3,3,2,1,4,1,4,0,7
9076,782157,17,4,4,4,4,0,0,0,1,1,1,1,2,3,1,0,8
9076,798153,8,0,0,0,0,0,0,0,0,0,1,0,1,1,0,1,0
9076,780852,6,0,0,0,0,0,0,0,0,0,1,0,0,1,0,0,0
9076,786214,12,4,9,3,3,1,6,2,2,0,1,0,1,0,1,0,11
9076,792670,17,1,4,0,2,1,2,0,0,0,2,0,1,1,0,0,3
9076,792669,11,0,3,0,3,0,0,0,0,1,0,1,0,0,0,0,0
9076,780193,14,2,6,0,1,2,5,2,2,0,0,1,3,0,2,0,8
9076,774985,28,4,16,3,10,1,6,2,3,2,4,2,3,0,1,0,11
9076,775276,5,0,0,0,0,0,0,0,0,0,0,0,0,2,0,0,0
9077,781656,25,4,10,4,10,0,0,0,0,4,7,1,4,1,1,0,8
9077,781658,39,5,7,5,7,0,0,2,2,4,6,0,3,3,7,1,12
9077,796962,33,3,6,2,3,1,3,3,4,0,3,3,4,1,1,0,10
9077,786798,38,4,11,4,11,0,0,5,7,0,9,3,1,2,3,0,13
9077,780129,29,4,8,1,1,3,7,2,2,0,5,2,3,2,2,0,13
9077,798206,13,1,3,0,0,1,3,4,4,0,0,0,1,0,0,0,7
9077,791263,9,0,3,0,3,0,0,0,0,1,1,1,0,0,1,0,0
9077,796967,4,0,2,0,0,0,2,0,0,1,0,0,0,0,1,0,0
9077,796966,5,1,1,1,1,0,0,0,0,0,0,0,2,0,0,0,2
9077,796964,2,0,0,0,0,0,0,0,0,0,0,1,0,0,0,0,0
9077,791264,3,0,1,0,1,0,0,0,0,0,0,0,0,0,0,0,0
9078,792351,29,2,8,1,4,1,4,2,2,1,6,3,2,0,2,0,7
9078,786723,40,10,15,10,14,0,1,3,3,1,4,6,0,0,4,0,23
9078,792349,33,3,5,2,4,1,1,3,4,0,2,2,3,0,1,2,10
9078,798060,25,3,3,1,1,2,2,4,4,0,3,2,3,1,4,1,12
9078,792355,36,6,10,3,3,3,7,0,0,0,0,0,0,1,2,0,15
9078,786724,13,0,2,0,0,0,2,0,0,0,0,2,0,0,1,0,0
9078,786726,2,0,0,0,0,0,0,0,0,1,0,0,0,0,1,0,0
9078,798061,19,1,3,0,1,1,2,0,0,0,2,1,2,0,0,0,3
9078,792348,3,0,0,0,0,0,0,0,0,0,0,0,2,0,0,0,0
9079,796404,30,5,7,5,7,0,0,0,2,6,4,4,3,4,4,0,10
9079,790853,21,3,3,3,3,0,0,1,1,2,3,0,4,1,1,0,7
9079,790850,33,5,13,2,8,3,5,3,4,0,1,0,0,0,0,0,16
9079,781164,27,3,7,0,0,3,7,0,0,0,3,1,0,0,1,0,9
9079,781163,29,2,9,2,5,0,4,2,2,1,1,2,4,1,2,1,6
9079,796406,19,3,3,3,3,0,0,1,2,3,4,2,2,0,3,0,7
9079,790849,26,7,10,4,6,3,4,0,0,0,1,2,1,1,3,0,17
9079,785434,10,0,2,0,1,0,1,0,0,0,1,1,1,0,0,0,0
9079,781223,5,1,1,0,0,1,1,0,0,0,0,1,0,0,0,0,3
9080,780282,28,7,10,7,10,0,0,2,3,1,6,3,1,1,3,3,16
9080,780277,31,7,9,6,7,1,2,4,4,0,8,2,2,1,3,1,19
9080,791002,32,1,2,0,1,1,1,2,3,0,0,1,1,0,0,1,5
9080,785327,34,4,12,2,4,2,8,0,1,1,8,1,1,3,2,0,10
9080,780280,31,5,9,4,8,1,1,2,4,1,3,2,1,2,2,0,13
9080,785329,14,2,3,2,3,0,0,0,0,0,2,1,0,2,2,0,4
9080,796662,7,0,0,0,0,0,0,0,0,0,1,0,1,0,0,0,0
9080,785330,11,1,1,1,1,0,0,0,0,0,0,0,1,1,2,0,2
9080,785326,10,0,3,0,2,0,1,0,0,0,1,1,0,0,1,1,0
9080,780279,2,0,0,0,0,0,0,0,0,0,0,0,0,0,0,0,0
9081,797205,9,1,2,1,1,0,1,0,0,0,1,1,1,0,2,0,2
9081,786316,17,0,5,0,5,0,0,0,0,0,1,0,3,1,2,0,0
9081,791477,30,1,7,1,5,0,2,0,2,1,2,3,3,0,2,1,2
9081,791476,30,1,4,0,0,1,4,0,0,1,3,1,1,0,0,0,3
9081,780220,36,8,18,5,13,3,5,0,0,2,6,1,2,2,3,0,19
9081,797206,24,1,6,1,6,0,0,0,0,1,4,0,0,2,1,0,2
9081,791473,17,3,3,3,3,0,0,4,4,2,1,0,2,0,2,0,10
9081,786314,30,7,15,7,12,0,3,3,4,2,3,1,1,2,0,0,17
9081,791474,0,0,0,0,0,0,0,0,0,0,0,0,0,0,0,0,0
9081,791475,7,1,2,0,0,1,2,0,0,0,0,0,2,0,1,0,3
9082,775489,32,8,16,8,15,0,1,0,0,2,7,3,1,1,1,1,16
9082,785563,30,8,15,5,8,3,7,0,0,5,4,4,3,0,2,0,19
9082,791088,30,1,5,1,4,0,1,6,6,3,1,1,3,2,3,0,8
9082,785561,27,2,6,2,6,0,0,1,2,1,7,7,4,0,3,1,5
9082,780313,35,7,9,3,4,4,5,2,3,0,2,4,2,2,2,0,20
9082,791087,2,0,0,0,0,0,0,0,0,0,0,0,1,0,2,0,0
9082,796750,1,0,0,0,0,0,0,0,0,0,0,0,0,0,0,0,0
9082,791069,24,4,7,0,1,4,6,0,0,1,2,2,2,0,1,0,12
9082,785560,19,2,5,0,2,2,3,2,2,2,3,1,2,0,3,0,8
9083,792047,28,8,13,8,13,0,0,0,0,3,3,1,0,2,1,1,16
9083,786338,32,5,15,3,8,2,7,2,2,1,1,0,2,1,4,1,14
9083,792050,31,1,5,0,3,1,2,0,0,1,3,0,2,1,0,0,3
9083,785347,23,3,8,1,5,2,3,5,7,1,2,2,0,1,0,0,13
9083,775601,27,5,9,3,7,2,2,2,4,0,1,1,2,3,4,0,14
9083,792048,1,0,1,0,0,0,1,0,0,0,0,0,0,0,0,0,0
9083,792045,8,1,2,1,2,0,0,0,0,1,0,0,0,0,0,0,2
9083,797648,9,0,0,0,0,0,0,0,0,0,2,0,0,0,1,0,0
9083,797647,18,2,4,1,1,1,3,0,0,0,1,0,1,1,0,0,5
9083,792052,13,2,3,2,2,0,1,0,0,0,1,0,1,0,0,0,4
9083,792051,5,0,1,0,1,0,0,0,0,0,1,0,1,0,0,0,0
9083,780862,5,0,1,0,0,0,1,0,0,0,0,0,0,0,0,0,0
9084,791440,18,3,7,3,7,0,0,2,4,2,3,0,3,0,1,0,8
9084,797019,25,4,6,4,4,0,2,0,0,0,1,4,0,1,1,0,8
9084,797016,22,0,3,0,1,0,2,0,0,1,1,2,1,1,1,0,0
9084,781378,28,6,15,4,10,2,5,4,4,2,9,2,2,1,1,2,18
9084,775267,22,1,3,0,0,1,3,0,0,0,5,2,1,0,1,0,3
9084,791443,6,0,1,0,1,0,0,0,0,1,0,1,0,0,1,0,0
9084,781629,13,3,7,3,7,0,0,2,4,5,1,0,2,0,0,0,8
9084,797015,22,6,9,6,9,0,0,0,0,1,4,1,3,0,3,1,12
9084,797013,18,3,9,1,4,2,5,0,0,0,1,0,2,0,1,0,8
9084,791441,26,2,5,1,4,1,1,2,4,1,0,1,2,0,0,0,7
9085,797110,27,6,11,3,4,3,7,2,2,0,3,1,0,0,0,0,17
9085,791406,29,1,3,1,3,0,0,0,1,2,6,0,2,1,1,2,2
9085,791404,36,4,9,3,5,1,4,8,10,0,0,3,4,1,0,0,17
9085,791407,26,6,15,5,11,1,4,1,2,2,4,1,3,1,2,0,14
9085,785923,32,4,6,4,5,0,1,0,0,1,3,3,2,0,3,0,8
9085,797111,16,1,2,1,2,0,0,0,0,0,1,0,3,0,0,1,2
9085,800038,5,0,0,0,0,0,0,0,0,0,0,0,0,0,0,0,0
9085,797114,26,2,8,1,4,1,4,2,3,2,4,1,1,0,2,0,7
9085,785928,3,0,1,0,0,0,1,0,0,0,1,0,0,0,0,0,0
9086,791144,22,3,8,3,8,0,0,0,1,2,5,1,3,1,2,3,6
9086,785782,22,11,13,6,6,5,7,0,0,0,5,2,3,0,0,1,27
9086,791145,29,6,10,6,8,0,2,0,0,3,11,9,0,1,0,0,12
9086,791146,32,3,11,2,5,1,6,2,2,2,2,10,2,0,3,0,9
9086,785777,31,6,11,3,5,3,6,2,2,1,1,1,3,2,2,0,17
9086,798159,1,1,2,1,1,0,1,0,0,0,0,0,1,0,0,0,2
9086,791147,13,1,1,1,1,0,0,2,2,1,1,1,2,0,3,0,4
9086,796804,15,2,4,2,3,0,1,2,2,0,1,0,1,0,1,0,6
9086,791148,19,1,4,1,3,0,1,0,0,2,2,1,0,0,1,0,2
9086,786748,16,1,2,1,1,0,1,0,0,0,1,2,3,0,0,0,2
9087,797549,25,2,6,2,5,0,1,1,5,4,1,5,1,0,3,3,5
9087,797545,23,4,8,3,4,1,4,0,1,0,2,2,2,0,1,0,9
9087,797540,30,2,10,2,5,0,5,4,6,2,4,2,1,0,1,1,8
9087,790857,35,3,9,2,7,1,2,3,4,2,2,4,3,2,1,0,10
9087,780586,30,7,16,6,14,1,2,5,6,2,6,2,2,1,1,1,20
9087,791799,11,3,4,2,2,1,2,1,1,0,1,1,3,0,0,0,8
9087,797547,8,2,3,0,0,2,3,0,0,0,0,0,0,0,0,0,6
9087,791715,18,3,6,2,2,1,4,0,0,0,1,1,1,0,1,3,7
9087,791714,14,0,1,0,0,0,1,0,0,0,0,2,3,0,0,1,0
9087,789065,6,0,1,0,0,0,1,0,0,0,0,1,0,0,0,0,0
9088,776333,9,0,1,0,0,0,1,0,0,0,0,0,0,0,0,0,0
9088,792563,30,5,11,4,9,1,2,2,2,2,2,0,2,2,1,1,13
9088,792561,26,0,11,0,6,0,5,0,0,2,3,5,1,0,1,0,0
9088,780270,31,5,11,3,6,2,5,0,0,1,1,1,0,2,0,0,12
9088,780266,28,3,13,2,4,1,9,0,0,2,0,3,1,1,1,0,7
9088,792560,12,0,0,0,0,0,0,1,2,0,1,0,3,0,1,0,1
9088,792565,35,9,17,9,17,0,0,6,6,4,9,1,0,2,1,0,24
9088,798134,13,0,3,0,0,0,3,0,0,0,2,3,2,1,0,0,0
9088,785472,13,0,1,0,1,0,0,0,0,1,2,0,4,0,0,0,0
9088,798135,2,0,1,0,1,0,0,0,0,0,0,0,0,1,0,0,0
9088,798132,1,0,0,0,0,0,0,0,0,0,0,0,0,0,0,0,0
9089,796401,22,1,4,1,3,0,1,0,0,0,5,2,1,0,0,1,2
9089,785999,36,4,7,4,7,0,0,0,3,2,4,5,1,1,3,1,8
9089,775654,27,4,5,4,5,0,0,0,3,3,3,1,1,0,2,5,8
9089,791639,35,7,12,5,7,2,5,2,4,1,4,3,1,0,1,0,18
9089,785389,38,5,13,1,4,4,9,0,0,1,4,1,1,1,3,1,14
9089,785255,3,0,0,0,0,0,0,0,0,0,0,0,2,0,1,0,0
9089,775171,3,0,0,0,0,0,0,0,0,0,0,0,0,0,1,0,0
9089,796399,26,2,5,0,1,2,4,1,2,0,8,6,1,0,2,0,7
9089,791640,10,3,3,3,3,0,0,0,0,1,1,0,0,0,2,0,6
9090,781306,5,1,1,0,0,1,1,0,0,0,0,0,1,0,0,2,3
9090,776372,5,1,2,1,2,0,0,0,0,0,0,0,0,0,0,0,2
9090,790801,16,2,4,2,4,0,0,2,2,1,1,2,1,1,1,2,6
9090,781303,5,2,2,2,2,0,0,0,0,0,0,2,0,1,1,0,4
9090,776366,5,0,2,0,0,0,2,0,0,0,1,0,0,0,0,0,0
9090,796360,21,3,6,2,4,1,2,0,0,1,2,7,3,0,5,1,7
9090,781304,24,6,10,0,1,6,9,0,0,1,1,2,1,0,0,2,18
9090,781302,25,4,7,3,4,1,3,4,5,0,6,2,1,4,0,0,13
9090,781300,19,7,7,6,6,1,1,1,1,0,2,2,0,2,3,0,16
9090,796364,8,2,3,2,3,0,0,1,1,0,2,0,2,0,2,0,5
9090,796363,11,1,3,0,1,1,2,1,2,0,2,1,1,0,0,0,4
9090,790803,23,2,5,2,5,0,0,1,2,2,4,0,3,0,3,1,5
9090,790802,12,2,7,1,2,1,5,0,0,1,1,0,1,0,0,0,5
9090,781305,16,1,2,0,0,1,2,0,0,1,3,1,1,1,2,0,3
9090,796362,5,1,2,1,2,0,0,0,0,1,0,0,1,0,0,0,2
9091,780218,21,0,3,0,3,0,0,1,2,2,4,2,1,0,1,0,1
9091,767736,21,1,8,0,5,1,3,0,3,3,4,0,3,2,4,0,3
9091,790772,37,9,16,1,2,8,14,2,4,0,1,1,1,1,1,0,28
9091,796328,32,1,6,1,5,0,1,1,2,1,2,2,0,2,6,0,3
9091,780022,24,6,10,4,5,2,5,0,2,1,3,1,4,1,2,0,14
9091,790774,18,1,4,0,1,1,3,0,0,0,2,2,2,1,2,0,3
9091,790771,21,2,8,2,5,0,3,2,2,1,1,2,0,1,2,1,6
9091,796329,14,1,1,1,1,0,0,2,2,2,3,0,1,1,1,0,4
9091,792438,4,0,2,0,0,0,2,0,0,0,1,0,0,0,0,0,0
9091,782637,5,1,1,1,1,0,0,0,0,0,0,0,1,0,1,0,2
9091,782638,3,0,1,0,1,0,0,0,0,0,0,0,0,0,1,0,0
9092,792157,7,0,0,0,0,0,0,0,0,0,1,1,4,0,1,0,0
9092,780138,36,6,7,6,7,0,0,6,10,1,2,0,4,2,4,0,18
9092,792154,35,6,12,5,8,1,4,6,6,0,6,0,2,3,3,0,19
9092,792152,32,1,9,0,4,1,5,4,6,0,1,1,2,2,5,1,7
9092,780581,33,5,10,5,6,0,4,3,6,0,1,3,1,7,1,0,13
9092,797755,16,0,0,0,0,0,0,1,2,0,2,0,4,0,0,0,1
9092,792158,21,0,1,0,1,0,0,3,4,2,3,1,4,1,0,0,3
9092,786014,20,0,2,0,0,0,2,0,1,0,3,1,0,0,1,0,0
9093,786805,24,2,4,2,4,0,0,1,2,1,3,2,4,1,0,0,5
9093,774936,26,5,9,5,9,0,0,1,5,3,2,1,2,1,3,1,11
9093,790932,25,4,7,3,5,1,2,6,10,0,0,2,4,0,3,0,15
9093,781345,34,2,4,2,4,0,0,1,2,0,5,1,4,1,6,0,5
9093,786803,26,1,4,1,2,0,2,0,0,1,4,4,4,0,1,0,2
9093,796488,2,0,0,0,0,0,0,0,0,0,0,0,0,0,1,0,0
9093,790934,22,4,6,3,3,1,3,3,3,1,0,2,5,0,3,0,12
9093,796487,2,0,1,0,0,0,1,0,0,0,0,0,0,0,0,0,0
9093,790933,22,2,8,1,4,1,4,2,2,0,3,0,4,0,2,0,7
9093,780033,17,2,2,1,1,1,1,1,2,1,1,1,3,1,3,0,6
9094,796479,31,2,4,2,3,0,1,0,0,3,1,1,2,3,2,0,4
9094,781560,26,1,5,1,5,0,0,0,0,2,1,2,2,0,1,1,2
9094,791375,36,1,6,0,1,1,5,0,0,1,6,3,4,0,1,0,3
9094,785482,29,3,14,3,13,0,1,3,5,1,5,2,5,0,1,0,9
9094,780837,38,11,23,4,9,7,14,3,3,0,2,0,1,1,1,0,32
9094,796477,16,1,1,1,1,0,0,0,0,0,2,3,4,0,4,1,2
9094,796473,2,1,2,1,2,0,0,1,1,1,1,0,0,0,0,0,3
9094,786164,22,3,4,2,2,1,2,0,0,1,5,0,2,0,2,4,7
9095,786157,20,4,6,4,6,0,0,6,6,3,3,0,3,0,1,1,14
9095,780676,33,5,10,3,7,2,3,7,9,1,2,2,0,2,2,0,19
9095,791756,23,2,7,2,5,0,2,0,1,0,1,8,2,2,3,0,4
9095,780992,31,0,7,0,2,0,5,3,4,0,1,2,0,1,0,0,3
9095,780677,30,5,8,1,2,4,6,2,2,1,8,0,4,1,1,0,16
9095,775533,15,1,3,1,3,0,0,0,0,1,3,0,3,0,1,0,2
9095,797348,9,0,4,0,4,0,0,0,0,0,2,1,0,1,1,0,0
9095,780673,23,2,6,0,0,2,6,2,2,0,3,1,1,1,0,0,8
9095,791754,16,1,4,0,2,1,2,2,2,1,3,0,1,0,0,0,5
9096,796444,26,4,9,4,7,0,2,2,2,3,5,3,2,0,3,2,10
9096,790893,20,1,3,1,3,0,0,5,6,2,6,2,2,0,1,1,7
9096,786615,27,6,10,4,6,2,4,1,2,1,8,6,0,2,1,1,15
9096,786732,9,0,1,0,0,0,1,0,0,0,1,0,0,3,1,0,0
9096,775260,21,6,8,2,2,4,6,0,0,0,1,2,2,0,1,0,16
9096,790889,22,3,6,1,2,2,4,0,0,0,2,1,2,2,3,1,8
9096,790890,23,2,7,2,5,0,2,0,0,2,1,2,1,0,2,0,4
9096,775536,20,4,6,4,6,0,0,0,3,2,3,2,1,0,1,0,8
9096,799891,10,0,2,0,0,0,2,0,0,0,2,0,0,0,0,0,0
9096,796445,6,2,2,2,2,0,0,0,0,0,1,1,0,0,1,0,4
9096,791501,6,1,1,1,1,0,0,0,0,1,1,0,0,0,1,0,2
9096,780702,7,1,2,1,1,0,1,0,0,0,2,1,0,0,0,0,2
9096,796132,2,1,2,0,0,1,2,0,0,0,0,0,0,0,0,0,3
9096,792678,1,0,0,0,0,0,0,0,0,0,0,1,0,0,0,0,0
9097,792143,30,3,10,2,4,1,6,2,2,1,3,1,3,1,2,0,9
9097,797753,26,1,8,1,4,0,4,0,0,0,2,1,2,2,4,0,2
9097,786302,20,0,2,0,2,0,0,1,2,0,0,0,2,1,1,0,1
9097,786293,29,3,14,3,11,0,3,0,0,4,4,1,0,2,2,0,6
9097,797750,28,0,3,0,3,0,0,0,0,0,4,0,0,1,2,0,0
9097,797748,17,2,4,1,1,1,3,2,2,1,1,2,2,1,1,1,7
9097,797751,17,2,5,1,2,1,3,0,0,1,1,2,0,0,1,0,5
9097,792147,8,0,2,0,2,0,0,1,2,1,0,0,0,0,0,0,1
9097,797742,17,3,8,0,3,3,5,0,0,0,4,1,3,0,1,0,9
9097,786294,4,0,2,0,1,0,1,0,0,0,0,0,0,0,0,0,0
9097,792145,2,1,1,1,1,0,0,0,0,0,0,0,0,0,0,0,2
9097,786301,1,0,0,0,0,0,0,0,0,0,0,0,0,0,0,0,0
9097,796192,1,0,0,0,0,0,0,0,0,0,0,0,0,0,0,0,0
9098,791299,21,1,6,1,5,0,1,0,0,1,2,0,1,2,3,0,2
9098,791296,40,7,15,4,5,3,10,0,0,0,4,0,1,1,0,0,17
9098,786397,40,7,11,6,7,1,4,6,8,2,12,2,3,3,2,0,21
9098,796590,15,0,2,0,2,0,0,0,0,1,3,1,0,0,0,0,0
9098,791519,40,4,12,3,5,1,7,0,0,0,2,5,2,2,2,0,9
9098,792084,8,0,1,0,0,0,1,0,0,0,1,0,0,0,0,1,0
9098,796593,11,0,1,0,1,0,0,0,0,0,3,0,0,0,0,0,0
9098,796591,25,1,5,0,1,1,4,1,2,0,0,2,0,0,2,0,4
9099,791276,29,5,6,5,6,0,0,0,0,2,8,1,1,0,2,2,10
9099,796529,32,0,5,0,3,0,2,0,0,0,2,3,1,0,3,0,0
9099,791275,32,1,3,1,1,0,2,0,0,0,6,4,3,1,1,0,2
9099,785746,34,4,12,3,6,1,6,3,4,0,3,1,1,1,0,0,12
9099,785741,28,4,9,2,4,2,5,0,0,0,2,1,4,2,4,0,10
9099,785755,10,0,1,0,1,0,0,0,0,0,0,0,1,0,0,0,0
9099,776283,16,3,7,3,7,0,0,0,2,2,4,0,2,0,1,0,6
9099,785748,19,3,8,0,0,3,8,0,0,0,1,0,1,1,0,0,9
9100,792181,32,3,9,3,5,0,4,2,2,2,7,0,1,0,2,0,8
9100,780986,37,0,2,0,2,0,0,0,1,2,6,1,4,0,0,1,0
9100,785902,39,8,14,2,4,6,10,0,0,3,7,1,1,0,1,4,22
9100,792179,23,3,8,2,5,1,3,0,0,0,2,7,0,0,1,0,7
9100,786662,39,6,15,4,5,2,10,3,3,2,3,1,0,1,1,0,17
9100,797796,18,0,4,0,3,0,1,5,6,0,1,4,1,0,1,0,5
9100,786661,9,1,3,0,1,1,2,2,3,0,1,0,2,0,0,0,5
9100,792177,3,0,0,0,0,0,0,0,0,0,0,0,2,0,0,0,0
9101,785224,19,3,9,3,7,0,2,0,0,1,6,0,3,0,0,0,6
9101,780879,37,3,10,3,9,0,1,0,0,3,5,3,4,0,0,1,6
9101,790767,24,3,7,0,1,3,6,2,2,0,1,2,2,0,2,0,11
9101,785743,14,0,3,0,1,0,2,0,0,0,1,1,0,1,0,0,0
9101,780875,27,1,7,0,2,1,5,0,0,0,5,5,2,0,5,0,3
9101,790768,27,4,6,1,1,3,5,0,0,1,1,2,1,1,0,0,11
9101,785226,7,1,4,0,2,1,2,0,0,1,0,0,0,0,0,0,3
9101,790769,20,3,6,2,2,1,4,0,0,0,2,4,2,1,0,0,7
9101,796326,7,0,2,0,2,0,0,2,4,0,1,0,0,0,0,2,2
9101,775785,14,2,5,1,3,1,2,0,0,2,1,0,0,0,0,0,5
9101,796324,4,0,0,0,0,0,0,0,0,0,0,0,0,0,0,0,0
9102,780765,37,7,20,4,12,3,8,3,3,4,6,3,3,2,2,0,20
9102,781301,22,1,1,1,1,0,0,0,0,0,2,0,0,0,2,3,2
9102,786255,37,6,9,5,7,1,2,3,4,0,2,2,2,1,0,0,16
9102,780762,30,3,10,2,4,1,6,2,2,0,1,1,3,1,1,0,9
9102,780768,29,2,4,2,3,0,1,0,1,1,6,4,4,2,2,0,4
9102,791729,14,1,2,1,2,0,0,0,0,2,1,0,1,0,2,0,2
9102,780755,15,0,4,0,3,0,1,1,2,0,0,0,2,1,1,0,1
9102,776241,16,2,5,2,4,0,1,0,2,0,0,0,1,0,1,0,4
9102,797320,0,0,0,0,0,0,0,0,0,0,0,0,0,0,0,0,0
9103,796812,31,7,11,7,11,0,0,2,2,4,5,1,3,1,1,2,16
9103,780952,33,8,14,7,11,1,3,0,0,5,5,2,0,1,1,2,17
9103,791155,29,4,13,3,10,1,3,7,8,0,6,2,4,1,3,0,16
9103,786609,31,0,3,0,1,0,2,0,0,1,5,1,2,2,2,0,0
9103,796810,35,5,12,3,9,2,3,2,2,0,3,1,1,0,1,0,14
9103,780950,13,0,1,0,1,0,0,0,0,0,0,0,0,0,0,0,0
9103,796814,16,0,0,0,0,0,0,2,2,0,1,1,2,0,2,0,2
9103,791156,12,1,3,1,2,0,1,2,2,0,1,0,2,0,2,0,4
9104,786180,9,1,2,1,2,0,0,1,2,2,3,0,1,1,0,0,3
9104,792104,37,4,9,2,2,2,7,6,8,0,10,2,1,2,1,1,16
9104,797709,28,3,7,3,5,0,2,2,2,0,2,2,2,0,1,0,8
9104,786198,31,4,11,3,7,1,4,6,6,1,1,0,1,0,0,1,15
9104,775779,32,8,15,6,12,2,3,3,3,0,2,3,3,1,2,0,21
9104,786204,14,1,6,1,4,0,2,0,0,2,2,1,2,2,0,0,2
9104,785608,20,4,6,4,6,0,0,2,2,4,7,3,3,0,3,0,10
9104,797707,21,3,4,3,3,0,1,0,3,0,2,1,1,0,3,1,6
9104,792106,8,0,1,0,0,0,1,0,0,0,0,0,1,0,1,0,0
9105,781046,25,1,5,1,1,0,4,0,0,4,3,1,2,0,2,0,2
9105,780025,33,9,13,9,13,0,0,1,5,1,4,0,2,0,0,3,19
9105,796391,10,0,4,0,3,0,1,0,0,0,1,1,1,0,1,0,0
9105,785385,32,3,11,2,2,1,9,2,2,0,3,1,0,4,2,1,9
9105,785383,35,6,14,4,10,2,4,2,4,1,8,3,5,2,5,0,16
9105,790837,24,3,5,3,4,0,1,2,2,2,2,1,1,0,0,0,8
9105,786297,6,0,0,0,0,0,0,0,0,0,0,0,1,0,1,1,0
9105,786228,28,6,13,5,9,1,4,0,0,1,1,3,2,1,0,0,13
9105,792180,7,0,0,0,0,0,0,0,0,0,0,1,2,0,0,0,0
9106,785423,30,3,7,1,4,2,3,0,0,3,6,0,3,2,0,1,8
9106,775676,24,5,10,5,10,0,0,0,0,2,3,1,2,1,1,1,10
9106,786210,33,5,12,3,7,2,5,0,0,1,4,2,3,1,3,1,12
9106,786298,29,3,11,2,7,1,4,2,2,5,4,4,0,1,2,0,9
9106,785422,37,5,15,2,6,3,9,1,2,2,1,3,2,0,3,0,14
9106,785425,28,3,10,2,5,1,5,1,1,1,4,4,1,0,1,0,8
9106,774957,13,2,5,1,2,1,3,0,1,0,2,0,3,1,1,1,5
9106,796431,4,1,2,1,2,0,0,1,2,0,0,0,1,0,0,0,3
9106,796429,2,0,0,0,0,0,0,0,0,0,0,0,1,0,0,0,0
9107,785409,28,3,4,3,4,0,0,0,0,1,5,2,3,0,1,3,6
9107,785408,37,6,12,5,6,1,6,0,1,0,6,0,0,0,4,1,13
9107,785407,29,3,9,3,8,0,1,2,2,1,3,2,2,0,0,2,8
9107,796416,27,7,11,4,5,3,6,3,4,0,4,3,3,2,2,0,20
9107,790861,31,8,12,7,10,1,2,0,1,4,9,2,3,1,1,3,17
9107,796415,17,3,6,1,3,2,3,0,2,1,1,3,1,1,0,1,8
9107,780539,29,3,7,1,2,2,5,0,0,0,1,3,1,0,1,0,8
9107,796419,1,0,0,0,0,0,0,0,0,0,0,0,0,0,0,0,0
9107,796418,1,0,0,0,0,0,0,0,0,0,0,0,0,0,0,0,0
9107,796417,0,0,0,0,0,0,0,0,0,0,0,0,0,0,0,0,0
9107,790860,0,0,0,0,0,0,0,0,0,0,0,0,0,0,0,0,0
9108,781177,14,4,7,1,1,3,6,2,3,3,4,0,1,1,0,2,13
9108,781175,26,6,9,6,9,0,0,0,4,7,4,2,3,0,2,0,12
9108,786557,10,0,1,0,1,0,0,0,0,0,2,1,1,1,0,0,0
9108,781173,3,0,1,0,0,0,1,0,0,0,0,0,0,0,0,0,0
9108,781172,28,4,8,3,5,1,3,1,2,2,2,5,2,1,1,0,10
9108,780895,25,5,9,5,8,0,1,4,4,0,7,1,1,0,2,0,14
9108,786555,25,2,5,1,1,1,4,0,0,0,2,1,3,1,1,0,5
9108,786553,29,6,16,2,9,4,7,1,2,1,1,3,0,0,0,0,17
9108,785312,16,2,6,2,5,0,1,2,2,1,2,5,2,1,0,0,6
9108,792005,18,2,6,1,5,1,1,0,0,1,3,1,1,0,0,0,5
9108,797503,2,1,1,1,1,0,0,0,0,0,0,0,1,0,0,0,2
9108,797502,1,0,0,0,0,0,0,0,2,1,1,0,0,0,0,0,0
9108,797501,1,0,1,0,0,0,1,0,0,0,0,0,0,0,0,0,0
9108,797500,1,0,0,0,0,0,0,0,0,0,0,0,0,0,0,0,0
9108,792004,1,0,0,0,0,0,0,0,0,0,0,0,0,0,0,0,0
9109,776462,9,1,3,1,2,0,1,0,0,0,1,0,0,0,1,0,2
9109,775642,28,1,4,1,3,0,1,0,2,1,4,1,3,1,0,2,2
9109,791629,35,8,14,7,10,1,4,0,1,2,3,3,1,1,1,0,17
9109,796974,28,1,9,1,7,0,2,0,0,0,1,3,2,1,0,0,2
9109,781199,40,4,13,3,9,1,4,13,15,1,1,4,1,2,3,1,22
9109,791626,10,0,1,0,1,0,0,1,2,1,2,0,4,0,0,0,1
9109,791628,32,3,8,1,4,2,4,4,4,2,8,0,2,0,1,2,12
9109,786720,18,3,7,2,5,1,2,0,0,0,2,0,3,0,1,0,7
9110,797367,17,2,4,2,4,0,0,1,2,2,5,4,3,0,2,0,5
9110,797369,21,2,3,0,0,2,3,0,0,1,2,2,0,3,0,1,6
9110,797366,19,1,3,1,2,0,1,1,2,0,2,1,3,1,0,0,3
9110,791807,23,5,11,0,0,5,11,2,3,1,6,2,1,0,0,0,17
9110,786130,26,8,16,4,6,4,10,0,1,0,4,3,1,1,2,0,20
9110,797371,16,4,7,4,7,0,0,0,0,3,4,0,3,2,0,0,8
9110,797368,5,2,2,2,2,0,0,0,0,2,2,0,0,0,1,0,4
9110,797364,6,0,0,0,0,0,0,0,0,0,0,0,1,0,0,0,0
9110,786127,9,1,3,1,3,0,0,0,0,0,2,1,2,0,0,0,2
9110,797370,2,0,0,0,0,0,0,0,0,0,0,0,0,0,0,0,0
9110,797365,18,3,11,2,5,1,6,0,0,2,0,1,2,3,1,0,7
9110,797363,22,5,9,5,8,0,1,0,0,1,0,2,1,1,4,0,10
9110,791805,4,0,0,0,0,0,0,0,0,0,0,1,0,0,1,0,0
9110,791808,12,1,2,1,1,0,1,0,0,1,0,1,0,0,2,0,2
9111,797861,18,4,7,4,7,0,0,0,0,0,5,1,0,0,0,0,8
9111,797859,25,1,8,1,5,0,3,2,2,2,3,0,1,0,4,1,4
9111,792208,30,5,13,5,11,0,2,6,8,0,3,2,0,2,1,0,16
9111,786262,19,1,2,0,0,1,2,0,0,1,1,0,1,0,1,0,3
9111,781314,23,2,8,0,3,2,5,0,0,0,1,0,1,1,0,0,6
9111,786983,7,0,1,0,0,0,1,0,0,0,2,0,0,1,0,0,0
9111,797862,17,2,3,2,3,0,0,2,2,2,1,0,1,0,0,0,6
9111,776018,6,1,1,1,1,0,0,0,0,0,0,0,0,0,0,1,2
9111,797858,5,3,5,1,2,2,3,0,0,0,0,0,0,2,1,0,8
9111,797856,13,1,2,1,2,0,0,0,0,0,1,0,3,1,1,0,2
9111,792206,4,0,0,0,0,0,0,1,2,0,1,2,0,0,0,0,1
9111,792204,12,1,3,0,0,1,3,0,0,0,1,0,3,1,5,0,3
9111,786682,9,0,4,0,1,0,3,2,2,1,0,1,0,0,1,0,2
9111,781317,12,0,2,0,0,0,2,0,0,0,2,2,0,1,1,1,0
9112,797562,14,4,5,4,5,0,0,1,2,1,3,1,0,0,3,1,9
9112,791766,32,7,9,6,7,1,2,1,2,1,1,1,3,1,0,0,16
9112,786230,32,2,10,1,6,1,4,4,4,1,2,7,3,2,6,0,9
9112,780604,35,8,14,7,12,1,2,2,2,3,5,7,2,0,1,0,19
9112,780602,27,5,10,5,10,0,0,3,3,0,4,4,3,3,1,0,13
9112,786071,9,1,1,1,1,0,0,1,2,3,2,0,0,1,2,1,3
9112,791768,27,6,11,6,10,0,1,0,1,2,1,5,2,2,0,1,12
9112,786460,10,2,3,2,3,0,0,0,0,0,1,0,3,0,0,1,4
9112,791767,8,2,3,1,1,1,2,2,2,0,2,1,3,0,2,2,7
9112,780603,6,0,0,0,0,0,0,0,0,0,0,0,0,0,0,0,0
9113,791923,34,7,11,7,11,0,0,2,4,3,6,0,2,5,1,2,16
9113,781122,26,6,8,6,8,0,0,5,6,2,2,1,0,2,0,0,17
9113,791925,32,5,11,4,8,1,3,5,6,0,5,6,3,1,2,0,16
9113,786527,23,1,3,0,0,1,3,2,3,0,0,1,1,0,2,0,5
9113,781112,21,1,3,1,3,0,0,0,0,0,0,1,1,0,2,0,2
9113,786529,11,1,2,1,2,0,0,0,0,1,0,0,1,0,1,1,2
9113,797541,12,2,2,2,2,0,0,1,2,3,2,0,2,1,1,3,5
9113,797542,17,2,10,1,6,1,4,0,0,0,0,4,3,3,1,0,5
9113,791927,5,1,3,0,1,1,2,0,0,0,1,0,2,1,2,0,3
9113,786858,19,5,7,5,6,0,1,2,2,0,0,4,2,0,4,0,12
9114,782133,21,7,14,4,7,3,7,0,0,3,2,2,1,0,1,1,17
9114,785123,18,2,3,2,3,0,0,1,2,0,5,2,2,0,2,2,5
9114,790990,29,3,8,2,6,1,2,0,0,3,3,3,4,1,3,0,7
9114,789219,35,4,9,2,3,2,6,0,0,0,1,3,1,1,2,0,10
9114,785059,32,6,10,6,9,0,1,1,1,2,6,7,0,5,2,0,13
9114,796624,1,0,0,0,0,0,0,0,1,0,0,0,0,0,0,0,0
9114,790989,2,0,0,0,0,0,0,0,0,0,0,0,2,0,0,0,0
9114,785305,2,0,0,0,0,0,0,1,2,1,0,0,1,0,1,0,1
9114,796622,13,2,5,2,5,0,0,2,2,3,4,0,0,0,0,1,6
9114,796623,25,5,9,1,3,4,6,5,6,0,2,1,2,1,3,0,19
9114,790988,3,0,1,0,1,0,0,0,0,1,2,0,0,0,0,0,0
9114,785303,3,0,0,0,0,0,0,0,0,0,0,0,0,0,0,0,0
9114,785122,16,0,3,0,0,0,3,0,0,0,1,2,0,0,0,0,0
9115,791723,32,3,5,3,5,0,0,3,6,3,2,1,4,0,1,7,9
9115,797310,37,2,7,2,4,0,3,0,0,0,1,4,0,1,6,0,4
9115,791724,25,3,8,3,6,0,2,4,4,1,3,1,4,2,1,0,10
9115,797308,31,1,5,1,3,0,2,0,0,0,2,1,2,0,3,0,2
9115,781617,35,5,10,3,5,2,5,4,5,0,6,3,3,3,3,3,16
9115,797312,5,1,2,1,2,0,0,0,0,0,0,0,0,0,0,1,2
9115,800056,4,0,0,0,0,0,0,0,0,0,0,0,0,0,0,0,0
9115,790085,0,0,1,0,1,0,0,0,0,0,0,0,0,0,0,0,0
9115,780706,31,8,13,6,9,2,4,0,0,0,4,1,2,4,0,0,18
9116,791524,17,5,9,4,5,1,4,2,3,1,2,3,2,1,0,1,13
9116,797139,15,5,5,5,5,0,0,1,2,4,5,2,1,0,4,2,11
9116,775394,15,3,6,3,5,0,1,0,0,2,1,0,0,2,1,0,6
9116,791526,11,4,5,3,3,1,2,0,0,0,1,1,1,1,1,0,9
9116,780272,17,4,7,3,4,1,3,0,0,0,2,5,0,1,0,0,9
9116,786354,22,4,5,4,5,0,0,2,5,5,1,1,1,0,0,1,10
9116,797141,16,0,5,0,1,0,4,0,2,0,0,0,2,0,1,0,0
9116,791523,26,6,9,3,3,3,6,1,1,0,3,4,1,1,3,0,16
9116,791525,12,1,6,1,3,0,3,0,0,1,2,1,2,1,0,0,2
9116,797137,14,5,11,4,10,1,1,0,2,7,2,0,1,0,2,2,11
9116,780273,19,1,3,0,0,1,3,0,0,0,3,3,1,0,0,1,3
9116,775592,16,3,7,0,1,3,6,0,0,0,4,1,0,1,2,0,9
9118,791981,36,6,13,6,10,0,3,2,3,0,14,5,1,0,1,0,14
9118,780342,39,3,11,2,6,1,5,0,0,0,4,7,1,1,1,0,7
9118,791982,31,9,12,6,7,3,5,3,3,0,5,5,2,1,0,1,24
9118,780333,13,2,3,1,1,1,2,0,0,0,2,2,0,0,2,0,5
9118,781493,31,1,7,0,1,1,6,2,2,1,1,0,3,2,4,0,5
9118,786756,15,1,3,0,1,1,2,0,0,1,3,0,0,0,0,0,3
9118,786755,24,5,8,4,6,1,2,0,0,2,3,1,4,2,1,0,11
9118,791986,11,1,1,0,0,1,1,0,0,1,0,1,0,1,0,0,3
9119,785714,26,2,5,2,5,0,0,1,1,1,6,1,1,1,4,2,5
9119,775894,32,6,10,5,6,1,4,0,2,2,6,4,3,0,0,0,13
9119,785711,33,4,13,2,5,2,8,0,0,0,2,4,1,2,1,0,10
9119,780985,32,5,11,1,2,4,9,0,0,0,1,1,1,2,0,0,14
9119,775266,19,1,6,0,1,1,5,0,0,0,1,1,2,0,2,0,3
9119,796829,14,3,4,3,4,0,0,1,4,2,2,0,0,1,0,1,7
9119,791167,22,3,8,1,3,2,5,0,0,0,3,3,2,0,1,0,8
9119,779994,13,0,4,0,2,0,2,0,0,1,2,1,1,1,1,0,0
9119,785378,9,0,1,0,1,0,0,0,0,0,1,1,3,0,0,0,0
9120,780094,35,3,6,1,3,2,3,0,0,3,5,1,3,0,1,0,8
9120,775142,32,6,11,5,8,1,3,2,3,1,5,4,3,1,3,1,15
9120,790843,35,7,12,6,8,1,4,8,10,0,4,1,2,2,3,1,23
9120,786212,34,8,11,6,7,2,4,0,0,2,1,2,2,4,1,1,18
9120,785392,40,6,8,4,5,2,3,1,2,0,2,2,3,1,2,0,15
9120,790844,15,1,3,1,3,0,0,1,1,0,1,0,1,1,1,0,3
9120,781563,5,0,0,0,0,0,0,0,0,0,0,1,0,0,0,0,0
9120,799986,4,0,0,0,0,0,0,0,0,0,0,0,2,0,0,0,0
9121,780283,32,4,6,4,6,0,0,3,3,1,3,2,2,0,1,0,11
9121,790925,28,6,8,4,4,2,4,1,1,2,2,1,2,1,3,1,15
9121,791456,31,3,12,3,6,0,6,0,0,1,0,1,4,1,4,0,6
9121,785476,31,2,5,2,3,0,2,2,2,0,2,8,1,0,3,0,6
9121,785474,39,10,16,7,11,3,5,0,1,2,1,4,1,1,2,0,23
9121,796470,12,3,5,3,5,0,0,0,0,2,4,0,2,0,0,0,6
9121,800121,8,2,2,2,2,0,0,0,0,0,1,0,1,0,1,0,4
9121,785480,19,1,2,0,1,1,1,0,0,0,2,1,1,0,0,0,3
9122,791917,23,1,2,1,2,0,0,1,1,1,1,2,3,0,0,1,3
9122,786526,26,5,7,3,3,2,4,0,0,1,5,1,1,0,2,2,12
9122,786525,32,0,11,0,3,0,8,0,0,0,6,0,3,1,2,0,0
9122,791914,31,5,12,2,5,3,7,2,2,1,0,1,1,1,0,0,15
9122,786030,26,5,11,1,6,4,5,0,0,1,2,0,4,1,4,0,14
9122,786856,17,2,3,2,3,0,0,3,4,1,6,1,0,1,2,0,7
9122,797550,16,1,4,0,1,1,3,2,2,0,1,2,0,2,1,0,5
9122,781109,17,0,3,0,2,0,1,0,0,3,1,0,0,0,0,0,0
9122,786524,12,1,2,1,1,0,1,2,2,0,1,4,0,1,0,0,4
9123,791585,32,1,7,1,3,0,4,2,4,1,3,1,4,1,5,1,4
9123,791581,27,2,7,0,2,2,5,0,0,2,6,1,1,0,1,1,6
9123,786395,37,2,12,1,6,1,6,0,0,0,4,3,1,1,1,0,5
9123,786394,38,10,15,5,6,5,9,1,1,0,3,2,0,3,3,0,26
9123,780404,35,6,8,5,6,1,2,1,2,1,7,5,3,1,2,1,14
9123,785228,18,0,1,0,1,0,0,0,0,0,2,0,2,0,2,0,0
9123,780062,7,0,0,0,0,0,0,0,0,0,1,0,2,0,1,0,0
9123,780403,6,0,0,0,0,0,0,0,0,0,0,1,0,0,0,0,0
9124,781244,35,7,14,6,9,1,5,4,7,0,6,0,3,1,1,0,19
9124,791243,11,0,1,0,1,0,0,0,0,0,1,2,0,0,1,0,0
9124,791241,33,2,5,1,2,1,3,2,2,2,7,3,1,0,0,0,7
9124,785537,36,7,15,7,14,0,1,0,0,1,2,4,1,0,1,0,14
9124,781243,34,6,14,5,7,1,7,0,1,2,3,2,3,4,2,1,13
9124,791245,19,1,4,1,1,0,3,0,0,0,0,5,2,1,3,0,2
9124,791246,5,1,1,1,1,0,0,0,0,0,0,0,0,0,0,0,2
9124,781237,22,2,2,0,0,2,2,0,0,0,1,0,2,1,0,0,6
9124,776205,5,0,2,0,1,0,1,0,0,0,1,0,2,1,0,0,0
9125,785509,26,4,10,2,3,2,7,0,0,2,1,1,2,1,0,0,10
9125,791424,30,5,10,4,8,1,2,2,2,3,6,2,4,3,2,1,13
9125,797085,37,6,8,3,5,3,3,2,2,1,6,3,2,2,2,0,17
9125,791421,35,6,13,6,10,0,3,0,1,0,7,3,1,0,3,0,12
9125,785899,37,0,5,0,1,0,4,0,0,0,6,0,1,0,3,0,0
9125,797079,8,0,1,0,1,0,0,2,2,0,0,0,1,0,0,0,2
9125,791425,14,3,6,3,6,0,0,2,2,1,1,1,0,0,0,1,8
9125,797086,2,0,1,0,0,0,1,0,0,0,0,0,0,0,0,0,0
9125,797090,2,1,1,1,1,0,0,0,0,0,0,0,2,0,0,0,2
9125,797088,9,2,3,2,2,0,1,0,0,1,0,0,0,0,2,0,4
9126,797292,25,5,9,5,9,0,0,4,5,3,8,0,2,0,3,0,14
9126,780509,31,1,5,1,3,0,2,2,2,3,3,1,2,0,0,0,4
9126,797290,35,3,8,3,7,0,1,6,6,0,5,2,0,0,1,1,12
9126,797291,24,1,2,1,1,0,1,0,0,0,3,1,0,1,3,1,2
9126,786064,30,2,7,1,2,1,5,0,0,1,5,2,3,0,3,0,5
9126,791658,14,3,3,3,3,0,0,1,2,2,0,0,1,0,1,0,7
9126,785658,9,0,2,0,2,0,0,0,0,1,0,0,0,1,1,0,0
9126,791660,32,6,12,4,10,2,2,3,7,0,1,3,3,1,2,0,17
9127,781516,19,2,5,2,5,0,0,3,3,2,4,1,3,0,1,1,7
9127,797331,37,6,16,1,7,5,9,0,0,1,4,1,0,0,0,0,17
9127,791737,22,0,3,0,1,0,2,0,0,0,0,1,1,1,1,1,0
9127,783524,29,3,9,2,4,1,5,2,3,0,1,4,2,0,0,0,9
9127,780561,31,3,12,1,4,2,8,1,2,1,5,1,5,2,0,0,9
9127,791734,12,4,6,4,6,0,0,0,0,0,2,0,3,0,3,0,8
9127,797332,10,0,1,0,1,0,0,0,0,0,0,1,1,0,1,0,0
9127,797333,16,0,0,0,0,0,0,0,0,0,1,1,2,0,1,0,0
9127,795372,6,0,1,0,1,0,0,0,0,1,0,0,0,0,1,0,0
9127,786223,18,2,3,2,3,0,0,0,0,2,2,0,2,3,3,0,4
9128,780609,40,3,12,2,5,1,7,5,6,0,3,4,1,3,2,0,12
9128,791837,36,6,15,5,10,1,5,5,6,2,9,0,0,3,1,0,18
9128,797437,15,2,3,0,1,2,2,2,5,0,1,2,4,1,0,0,8
9128,786622,27,1,2,0,0,1,2,4,4,2,2,1,1,0,2,0,7
9128,780613,30,0,5,0,5,0,0,4,8,0,6,2,2,1,3,0,4
9128,786619,12,1,1,1,1,0,0,1,2,0,2,0,3,1,0,1,3
9128,775097,29,5,11,5,11,0,0,0,0,1,5,0,2,1,6,2,10
9128,786621,11,0,2,0,0,0,2,0,0,1,0,1,1,0,2,0,0
9129,774964,33,5,13,5,12,0,1,1,1,2,8,4,3,5,3,2,11
9129,775626,35,4,9,3,6,1,3,3,5,3,7,2,3,0,4,2,12
9129,796912,27,7,11,6,8,1,3,1,3,1,3,0,3,3,2,2,16
9129,774962,36,3,8,1,5,2,3,3,4,0,2,2,1,1,2,0,11
9129,796906,25,3,8,2,4,1,4,2,2,0,2,0,3,1,1,0,9
9129,796907,18,2,5,2,4,0,1,0,5,2,1,0,0,1,2,0,4
9129,791203,10,0,0,0,0,0,0,0,0,0,1,0,1,0,0,0,0
9129,796908,4,0,0,0,0,0,0,0,0,0,0,0,0,0,0,0,0
9129,785606,7,2,3,2,3,0,0,0,0,0,1,0,4,0,1,0,4
9129,796910,5,0,1,0,1,0,0,0,0,0,1,0,0,0,0,0,0
9130,797025,29,7,9,6,7,1,2,2,2,2,3,7,0,2,2,0,17
9130,792116,26,5,7,2,3,3,4,1,2,0,5,4,1,2,1,0,14
9130,780410,27,5,9,1,2,4,7,0,0,0,7,3,2,0,0,0,14
9130,797028,22,8,11,6,6,2,5,1,3,0,4,1,1,0,0,0,19
9130,797024,2,0,1,0,0,0,1,0,0,0,0,0,0,0,0,0,0
9130,791598,26,7,10,6,7,1,3,0,0,5,6,2,3,1,2,2,15
9130,791597,11,1,2,1,2,0,0,0,0,1,1,1,1,0,1,0,2
9130,797026,12,0,4,0,1,0,3,1,2,0,3,0,0,0,0,0,1
9130,797027,15,0,3,0,1,0,2,0,0,1,3,1,1,1,0,0,0
9130,775047,5,1,4,1,2,0,2,0,0,0,0,0,0,0,0,0,2
9130,797029,3,0,1,0,0,0,1,0,0,1,1,0,0,0,0,0,0
9130,791600,15,5,8,1,2,4,6,0,0,0,3,1,2,2,2,0,14
9130,785687,7,1,3,1,1,0,2,0,0,1,0,0,0,0,0,0,2
9131,775754,28,2,10,0,6,2,4,1,2,0,1,0,1,1,1,0,7
9131,792113,36,5,12,4,7,1,5,0,1,2,5,1,0,1,1,2,11
9131,792115,16,0,2,0,1,0,1,0,0,0,0,0,1,0,1,0,0
9131,797715,36,5,9,2,4,3,5,5,5,1,5,5,1,1,3,0,18
9131,780937,29,4,10,2,2,2,8,4,4,2,0,3,4,1,1,0,14
9131,791950,22,4,13,2,4,2,9,1,1,1,6,0,1,1,1,0,11
9131,797716,5,0,0,0,0,0,0,0,0,1,1,0,0,0,0,0,0
9131,780938,6,0,0,0,0,0,0,0,0,0,0,0,0,0,0,0,0
9131,797717,10,2,5,1,3,1,2,0,0,0,0,2,3,0,1,0,5
9131,791149,12,0,4,0,1,0,3,0,0,0,0,0,2,1,3,0,0
9132,791881,33,4,9,2,4,2,5,4,4,0,2,2,2,0,1,0,14
9132,797613,8,0,3,0,1,0,2,0,0,2,0,0,0,0,1,0,0
9132,786420,34,5,12,4,8,1,4,4,5,0,1,1,4,2,1,0,15
9132,797616,24,2,5,2,3,0,2,1,2,1,3,0,2,0,1,2,5
9132,786493,33,5,12,5,7,0,5,1,4,1,4,2,1,2,2,0,11
9132,781052,11,0,2,0,0,0,2,0,0,0,0,0,0,2,0,0,0
9132,797614,11,0,3,0,2,0,1,0,0,0,0,0,1,0,0,0,0
9132,797617,25,5,10,3,5,2,5,0,0,2,4,0,0,0,1,0,12
9132,797618,5,0,0,0,0,0,0,0,0,0,2,0,2,0,1,0,0
9132,791882,11,0,3,0,3,0,0,1,2,1,2,0,2,0,0,0,1
9132,786491,5,1,2,1,2,0,0,0,0,0,1,0,2,0,0,0,2
9133,791786,29,0,3,0,2,0,1,4,4,1,3,2,4,1,4,0,4
9133,789046,26,2,7,1,3,1,4,4,4,1,0,1,2,1,1,1,9
9133,789048,31,9,11,9,11,0,0,2,4,4,9,1,3,0,4,0,20
9133,789041,27,1,4,1,1,0,3,3,3,0,5,1,0,0,1,0,5
9133,791787,30,8,18,8,18,0,0,1,1,1,10,0,4,0,3,0,17
9133,797629,2,0,0,0,0,0,0,0,0,0,1,0,0,0,0,0,0
9133,797630,17,1,6,1,3,0,3,0,0,1,1,0,1,0,0,0,2
9133,791785,16,3,5,3,5,0,0,0,0,1,1,2,0,0,1,0,6
9133,797631,2,0,1,0,1,0,0,0,0,0,0,0,0,0,0,0,0
9133,789044,11,1,3,0,2,1,1,0,0,0,0,0,1,1,0,0,3
9133,785540,9,1,2,1,2,0,0,0,0,2,1,0,1,1,0,0,2
9134,786623,22,2,3,2,3,0,0,1,3,1,2,0,1,0,3,1,5
9134,797405,34,2,13,1,11,1,2,1,2,3,6,2,3,1,2,2,6
9134,791834,35,4,14,1,5,3,9,0,0,0,2,2,3,0,2,0,11
9134,791833,38,2,8,2,7,0,1,4,4,0,7,7,4,1,5,0,8
9134,785920,45,8,12,5,7,3,5,2,2,0,2,2,2,0,3,0,21
9134,786624,20,2,2,2,2,0,0,1,2,1,4,1,3,0,0,0,5
9134,785698,13,3,7,0,1,3,6,0,0,1,1,1,2,2,0,0,9
9134,784077,18,4,7,3,5,1,2,0,0,0,2,0,1,0,2,0,9
9135,780494,34,10,12,9,11,1,1,3,4,2,4,2,2,3,2,1,24
9135,797276,31,2,6,2,4,0,2,0,0,1,4,3,2,4,3,0,4
9135,780497,37,3,5,3,5,0,0,6,10,3,8,3,1,2,3,1,12
9135,780496,36,6,11,1,4,5,7,0,2,0,4,4,1,2,1,0,17
9135,780495,33,6,16,5,10,1,6,1,3,1,1,1,2,0,1,0,14
9135,797274,3,0,0,0,0,0,0,0,0,0,0,0,0,0,0,0,0
9135,791645,7,0,0,0,0,0,0,0,0,1,2,0,0,0,0,0,0
9135,785693,12,0,2,0,2,0,0,1,4,2,2,0,4,0,1,0,1
9135,797275,3,0,1,0,1,0,0,0,0,0,0,0,0,0,0,0,0
9135,791643,4,0,1,0,1,0,0,0,0,0,1,0,0,0,1,0,0
9135,785692,14,2,4,2,4,0,0,1,2,0,0,0,1,0,0,0,5
9135,785644,11,0,3,0,1,0,2,0,0,0,1,0,1,0,1,0,0
9136,776345,21,3,4,3,4,0,0,0,0,2,4,0,3,0,0,2,6
9136,796579,32,3,9,2,5,1,4,0,0,0,5,2,2,0,2,0,7
9136,785794,37,8,17,8,15,0,2,3,5,5,5,2,2,0,3,0,19
9136,785792,20,4,7,3,4,1,3,0,0,0,2,1,2,2,0,0,9
9136,781373,32,1,8,0,5,1,3,5,6,0,8,3,2,2,0,0,8
9136,791295,23,2,2,2,2,0,0,1,4,0,6,1,2,2,1,2,5
9136,796577,4,0,1,0,1,0,0,0,0,0,0,0,2,0,0,1,0
9136,791293,4,0,0,0,0,0,0,2,2,0,0,0,2,0,0,1,2
9136,796580,26,7,10,5,6,2,4,1,2,0,3,0,1,0,0,0,17
9136,791292,1,0,0,0,0,0,0,0,0,0,0,0,0,0,0,0,0
9137,792084,14,1,3,1,2,0,1,0,1,2,0,0,2,0,1,1,2
9137,791299,14,1,3,0,2,1,1,0,0,0,1,2,2,0,1,0,3
9137,791296,39,5,14,4,10,1,4,0,1,0,3,0,3,0,1,0,11
9137,786397,36,2,7,2,5,0,2,0,0,1,13,3,4,1,0,0,4
9137,791519,40,9,24,7,20,2,4,9,10,0,0,4,1,1,2,0,29
9137,796593,14,1,1,1,1,0,0,0,0,0,1,0,1,0,1,0,2
9137,796590,7,0,0,0,0,0,0,0,0,0,3,0,1,1,0,0,0
9137,796591,36,2,5,1,2,1,3,3,5,0,4,0,1,1,3,0,8
9138,786404,19,3,4,3,3,0,1,3,4,3,2,1,4,2,3,1,9
9138,780378,21,5,6,5,6,0,0,2,5,2,0,1,5,0,1,3,12
9138,786378,27,4,9,1,4,3,5,1,1,1,1,4,2,2,1,0,12
9138,786374,26,4,10,4,8,0,2,0,0,1,4,1,5,1,4,1,8
9138,786253,28,2,10,2,8,0,2,3,6,1,5,3,3,4,3,1,7
9138,797065,23,2,4,1,1,1,3,0,0,0,5,0,3,0,1,1,5
9138,797061,28,1,7,1,4,0,3,0,1,0,1,3,1,3,0,0,2
9138,791562,19,3,3,2,2,1,1,1,1,0,3,2,0,1,1,0,8
9138,780121,6,2,2,0,0,2,2,0,0,0,0,0,2,0,0,0,6
9138,780381,3,0,0,0,0,0,0,0,0,0,0,0,0,0,0,0,0
9139,791257,11,2,4,2,4,0,0,1,2,2,0,1,2,0,1,0,5
9139,791838,25,2,4,2,3,0,1,2,3,1,3,2,2,0,3,1,6
9139,786620,20,2,5,1,2,1,3,0,0,1,2,2,4,1,2,0,5
9139,781606,40,7,13,4,9,3,4,4,4,0,3,1,2,0,1,0,21
9139,781257,27,3,9,1,5,2,4,0,1,0,4,0,4,0,4,0,8
9139,796955,13,2,3,2,3,0,0,3,3,2,2,0,0,0,4,0,7
9139,791255,19,0,2,0,1,0,1,2,4,0,2,1,4,0,2,0,2
9139,780900,16,0,1,0,1,0,0,0,0,1,4,2,1,0,2,1,0
9139,781263,29,1,6,1,3,0,3,3,4,0,1,2,5,3,3,0,5
9140,791011,36,10,16,6,8,4,8,0,0,2,8,2,0,0,2,1,24
9140,796671,13,2,2,2,2,0,0,0,2,1,1,0,0,0,1,0,4
9140,791594,37,7,14,5,11,2,3,0,0,1,2,4,1,0,2,1,16
9140,791012,35,2,5,1,1,1,4,0,0,2,4,1,3,1,2,0,5
9140,781221,25,1,6,1,3,0,3,2,2,0,3,2,2,0,3,0,4
9140,796670,10,1,1,1,1,0,0,0,0,0,3,1,0,0,0,0,2
9140,796668,19,1,4,1,1,0,3,0,0,0,2,0,4,0,0,0,2
9140,791013,25,3,9,3,9,0,0,0,0,0,2,1,3,1,1,0,6
9141,784640,19,2,4,2,4,0,0,0,0,1,2,4,0,2,0,1,4
9141,797655,29,6,8,6,8,0,0,0,0,1,6,2,1,1,0,0,12
9141,797657,37,4,7,2,2,2,5,0,0,0,1,4,3,0,0,0,10
9141,792072,40,3,9,0,0,3,9,4,5,0,1,0,0,3,1,0,13
9141,792069,6,2,3,0,0,2,3,0,0,0,0,1,0,0,1,0,6
9141,786025,5,0,1,0,1,0,0,0,0,0,1,0,0,0,0,0,0
9141,797652,34,2,6,2,3,0,3,0,0,1,7,5,3,1,0,1,4
9141,785572,27,8,16,5,9,3,7,5,5,0,5,1,0,0,2,0,24
9141,774844,3,0,0,0,0,0,0,0,0,0,0,0,0,0,0,0,0
9142,780229,30,6,13,6,13,0,0,2,6,5,6,1,3,2,6,1,14
9142,795572,31,2,8,2,6,0,2,2,4,0,4,2,2,3,2,0,6
9142,791483,35,8,18,7,12,1,6,1,1,2,2,2,1,2,3,0,18
9142,786322,24,2,5,1,2,1,3,1,2,1,3,2,0,1,1,1,6
9142,781592,21,1,3,1,2,0,1,0,0,4,4,0,1,0,3,0,2
9142,797194,14,2,5,0,0,2,5,0,0,0,4,1,1,0,0,0,6
9142,797193,22,3,5,1,2,2,3,0,0,1,4,2,2,0,2,0,8
9142,780228,23,0,7,0,1,0,6,0,0,0,0,0,1,0,1,0,0
9143,785294,30,5,9,4,8,1,1,0,0,1,6,2,3,1,4,2,11
9143,796514,35,0,7,0,5,0,2,0,0,0,6,9,2,2,2,0,0
9143,791085,22,5,11,2,5,3,6,0,0,0,2,2,3,0,1,0,13
9143,791080,39,7,12,7,11,0,1,5,6,1,4,1,1,2,6,0,19
9143,785675,34,6,13,5,8,1,5,0,0,0,4,2,2,0,1,0,13
9143,796511,21,3,7,3,5,0,2,0,0,4,2,1,1,1,0,0,6
9143,791083,6,2,3,1,1,1,2,0,0,1,1,0,0,0,1,1,5
9143,791081,4,0,1,0,1,0,0,0,0,0,1,0,0,0,0,0,0
9143,796512,4,1,1,0,0,1,1,0,0,0,0,0,0,0,0,0,3
9143,796515,5,1,2,1,1,0,1,0,0,1,0,0,0,0,0,0,2
9144,797313,27,1,4,1,1,0,3,0,0,0,4,0,3,2,2,0,2
9144,786569,34,7,10,7,10,0,0,4,4,3,5,1,3,0,3,2,18
9144,791726,37,4,10,3,5,1,5,6,6,1,0,2,0,1,2,0,15
9144,786273,37,5,11,0,3,5,8,0,0,1,6,6,1,1,3,0,15
9144,780773,40,5,18,3,14,2,4,5,10,4,7,2,1,2,5,0,17
9144,791728,2,1,1,1,1,0,0,0,0,0,1,0,0,0,0,1,2
9144,789091,4,1,1,1,1,0,0,2,3,0,1,0,1,0,0,0,4
9144,786272,19,0,0,0,0,0,0,0,0,1,1,0,1,0,0,1,0
9145,785642,9,0,2,0,1,0,1,0,0,2,1,0,1,0,2,0,0
9145,780751,19,2,7,2,5,0,2,1,3,0,0,0,3,0,1,2,5
9145,796743,22,4,6,4,4,0,2,1,2,0,0,3,3,2,1,0,9
9145,791068,24,2,10,0,5,2,5,0,2,2,4,0,3,1,0,0,6
9145,785551,31,2,6,1,3,1,3,0,0,1,6,1,1,0,3,0,5
9145,780512,28,9,13,6,9,3,4,0,0,3,3,2,4,1,2,0,21
9145,780756,19,3,6,2,3,1,3,1,2,0,1,2,0,2,2,1,8
9145,796744,9,0,1,0,0,0,1,0,0,0,2,0,2,1,0,0,0
9145,791066,27,6,11,6,8,0,3,0,0,0,1,2,1,2,2,1,12
9145,791065,12,0,1,0,0,0,1,0,0,0,2,0,0,0,0,0,0
9146,780012,36,3,7,2,5,1,2,2,3,1,6,1,1,2,0,0,9
9146,796309,23,6,8,6,8,0,0,2,3,1,9,0,2,0,6,0,14
9146,790824,35,6,12,2,6,4,6,3,4,2,4,0,2,1,1,0,19
9146,780011,30,4,8,3,5,1,3,0,0,2,3,2,1,1,1,0,9
9146,775667,34,4,9,3,4,1,5,0,0,0,1,5,0,0,1,0,9
9146,774895,8,0,0,0,0,0,0,1,2,0,0,0,5,0,2,0,1
9146,781524,12,0,2,0,2,0,0,0,0,0,3,0,5,0,1,1,0
9146,785370,9,2,2,2,2,0,0,2,2,1,0,0,2,0,1,0,6
9146,780941,3,1,1,1,1,0,0,0,0,0,0,0,2,0,0,0,2
9146,783865,4,0,1,0,1,0,0,0,0,0,0,0,0,0,0,0,0
9146,785092,3,0,2,0,2,0,0,0,0,0,0,0,0,0,1,0,0
9146,780016,2,0,0,0,0,0,0,0,0,0,0,1,0,0,0,0,0
9146,785600,1,0,0,0,0,0,0,0,0,0,1,0,0,0,0,0,0
9147,790827,10,0,1,0,1,0,0,0,0,0,2,1,2,0,1,0,0
9147,790828,14,1,2,1,2,0,0,2,2,0,2,0,3,0,1,0,4
9147,785372,32,6,15,6,14,0,1,2,3,1,4,1,2,1,4,2,14
9147,790825,22,3,8,3,6,0,2,0,1,0,0,0,1,0,2,0,6
9147,774905,33,2,10,2,10,0,0,2,2,0,1,0,2,2,1,0,6
9147,785373,27,0,2,0,1,0,1,2,2,2,2,0,0,0,0,2,2
9147,785375,14,1,1,1,1,0,0,0,0,0,4,0,2,1,0,1,2
9147,796385,14,1,4,1,3,0,1,0,0,0,2,2,1,0,0,0,2
9147,785374,2,0,0,0,0,0,0,0,0,1,0,0,1,0,0,0,0
9147,786384,20,3,7,3,4,0,3,0,0,2,2,2,2,1,2,0,6
9147,780007,6,0,2,0,1,0,1,0,1,0,0,1,0,0,0,0,0
9147,796387,6,3,3,3,3,0,0,2,3,1,1,0,0,0,0,0,8
9147,796386,0,0,0,0,0,0,0,0,0,0,0,0,0,0,0,0,0
9147,790826,0,0,0,0,0,0,0,0,0,0,0,0,0,0,0,0,0
9148,785298,8,0,1,0,1,0,0,0,0,0,1,0,3,1,1,0,0
9148,775224,27,2,4,2,4,0,0,0,0,1,3,1,4,0,0,1,4
9148,778046,32,8,14,4,7,4,7,2,2,1,2,5,2,3,5,0,22
9148,782121,38,4,10,2,2,2,8,2,2,1,1,7,1,2,3,1,12
9148,775793,35,7,12,5,9,2,3,3,5,2,2,5,0,2,1,0,19
9148,785485,24,1,2,1,2,0,0,0,0,0,2,0,1,2,2,1,2
9148,786594,15,1,3,1,3,0,0,1,2,3,3,1,3,1,0,0,3
9148,785302,21,7,13,6,9,1,4,4,7,2,5,1,0,0,1,0,19
9149,790884,23,4,6,4,6,0,0,2,4,1,3,2,3,0,4,0,10
9149,791635,38,2,6,1,4,1,2,1,1,1,1,4,0,0,3,0,6
9149,796438,18,0,3,0,1,0,2,1,2,1,0,1,2,0,2,0,1
9149,790883,25,3,6,2,3,1,3,2,2,0,1,2,4,2,2,0,9
9149,796436,39,10,19,6,11,4,8,0,0,0,7,4,2,0,5,1,24
9149,796439,15,3,3,3,3,0,0,0,0,0,0,0,3,0,2,0,6
9149,790885,23,3,4,3,3,0,1,0,0,2,4,1,2,1,0,0,6
9149,796442,7,2,2,2,2,0,0,0,0,2,0,0,0,0,0,0,4
9149,781262,12,1,3,0,0,1,3,1,2,0,0,0,1,0,0,0,4
9150,781624,13,1,3,1,1,0,2,0,0,0,4,3,1,0,1,0,2
9150,792246,11,3,5,3,5,0,0,2,2,0,1,0,0,0,0,1,8
9150,797925,20,5,5,5,5,0,0,1,1,3,1,6,1,4,1,0,11
9150,781420,20,9,15,6,9,3,6,2,2,2,4,1,1,0,0,0,23
9150,781405,20,9,11,4,5,5,6,0,0,1,3,5,0,1,3,0,23
9150,797924,18,7,11,7,11,0,0,0,0,5,9,3,1,3,1,2,14
9150,781417,15,6,7,6,7,0,0,0,0,2,5,1,0,0,0,0,12
9150,780615,13,1,1,1,1,0,0,4,4,3,3,0,0,0,0,0,6
9150,797920,7,3,5,2,2,1,3,0,0,0,1,0,0,0,1,0,7
9150,797930,12,2,8,0,1,2,7,0,0,0,3,0,0,0,0,0,6
9150,797933,17,3,6,3,4,0,2,0,0,1,0,2,2,2,0,1,6
9150,791701,17,0,0,0,0,0,0,0,0,0,3,4,1,0,1,1,0
9150,792245,17,2,2,1,1,1,1,0,0,0,0,5,2,1,0,0,5
9152,785459,13,3,7,3,7,0,0,0,2,2,2,0,1,0,2,0,6
9152,789101,25,0,4,0,3,0,1,2,2,2,2,0,1,3,0,0,2
9152,789102,29,7,10,7,10,0,0,2,2,2,6,9,2,0,2,0,16
9152,781371,16,2,6,2,2,0,4,0,0,1,2,1,0,0,1,0,4
9152,781367,25,6,9,1,2,5,7,2,2,1,2,0,1,2,1,0,19
9152,797731,14,3,4,3,4,0,0,5,7,4,0,0,2,1,1,0,11
9152,792066,18,2,2,2,2,0,0,0,0,2,0,0,1,0,0,1,4
9152,792064,15,2,7,0,0,2,7,0,0,1,2,1,2,1,0,0,6
9152,792063,11,1,4,1,2,0,2,4,4,1,2,1,2,1,0,0,6
9152,792061,16,0,5,0,0,0,5,0,0,0,0,1,3,1,1,0,0
9152,788037,14,2,4,2,3,0,1,4,5,1,3,0,1,0,0,1,8
9152,789982,1,0,0,0,0,0,0,0,0,0,1,0,0,0,0,0,0
9152,797729,1,0,0,0,0,0,0,0,0,0,0,0,0,0,0,0,0
9152,781362,2,0,0,0,0,0,0,0,0,0,0,0,0,0,0,0,0
9153,797174,21,1,4,1,3,0,1,0,2,0,3,1,2,0,0,0,2
9153,791510,24,1,4,0,1,1,3,0,0,2,1,1,1,1,1,0,3
9153,786699,21,2,4,2,4,0,0,1,3,4,1,0,1,0,3,0,5
9153,785593,22,5,9,3,5,2,4,0,0,0,5,1,1,0,1,0,12
9153,775357,31,6,10,2,4,4,6,1,1,0,1,2,3,0,5,0,17
9153,791509,1,1,1,1,1,0,0,0,0,1,0,0,1,0,0,0,2
9153,791507,18,4,7,4,7,0,0,1,4,0,0,0,3,0,1,0,9
9153,798345,1,0,1,0,1,0,0,0,0,0,0,0,0,0,0,0,0
9153,797168,20,3,8,2,6,1,2,2,3,0,1,0,3,0,4,0,9
9153,791504,24,0,5,0,5,0,0,0,0,1,2,3,2,2,2,0,0
9153,791505,15,1,4,1,2,0,2,0,0,1,2,2,2,1,0,0,2
9153,791506,1,0,0,0,0,0,0,0,0,0,0,0,0,0,0,0,0
9153,791508,1,0,0,0,0,0,0,0,0,0,0,0,0,0,0,0,0
9154,791352,36,5,8,4,5,1,3,3,6,2,3,0,1,0,0,0,14
9154,780455,32,4,10,4,10,0,0,2,3,2,12,1,0,0,2,4,10
9154,797251,22,1,2,1,1,0,1,0,0,0,1,1,3,1,1,2,2
9154,797247,43,2,11,2,9,0,2,0,0,1,3,4,2,0,3,0,4
9154,776297,42,6,15,3,8,3,7,7,8,0,3,1,2,1,1,0,22
9154,791354,12,3,4,1,2,2,2,0,0,0,0,0,2,0,0,0,8
9154,785837,10,0,5,0,3,0,2,1,2,2,2,0,2,0,1,1,1
9154,797248,28,2,4,0,0,2,4,1,2,0,2,1,0,0,0,0,7
9154,797250,0,0,0,0,0,0,0,0,0,0,0,0,0,0,0,0,0
9154,791355,0,0,0,0,0,0,0,0,0,0,0,0,0,0,0,0,0
9154,786227,0,0,0,0,0,0,0,0,0,0,0,0,0,0,0,0,0
9155,797414,34,0,3,0,3,0,0,0,0,0,1,0,4,0,0,1,0
9155,785762,37,10,19,9,15,1,4,2,2,4,5,1,2,1,3,1,23
9155,797407,15,1,7,1,4,0,3,0,0,0,2,2,1,0,3,0,2
9155,791666,38,2,6,1,4,1,2,0,0,0,1,1,3,2,3,1,5
9155,780531,42,8,18,6,11,2,7,6,9,1,6,2,2,0,1,0,24
9155,780534,19,2,2,2,2,0,0,0,0,1,7,0,2,0,0,1,4
9155,797409,30,2,7,1,3,1,4,0,0,1,4,3,2,0,1,0,5
9155,785760,10,1,2,1,2,0,0,0,0,0,2,1,2,0,0,0,2
9156,781081,23,2,9,2,8,0,1,4,6,2,4,1,4,0,2,4,8
9156,791864,37,6,10,3,5,3,5,0,0,2,5,2,1,1,2,0,15
9156,791863,23,2,2,2,2,0,0,1,1,1,1,0,4,4,4,1,5
9156,797472,25,3,8,1,3,2,5,4,4,1,3,3,3,1,4,0,12
9156,780965,40,2,12,0,6,2,6,5,8,1,1,9,1,2,2,1,11
9156,797473,12,0,0,0,0,0,0,0,0,1,3,0,1,0,0,2,0
9156,786791,4,0,2,0,2,0,0,0,2,2,2,0,0,0,1,0,0
9156,797470,18,5,8,5,6,0,2,3,3,0,4,0,5,0,0,0,13
9156,786592,18,2,4,2,3,0,1,0,0,0,0,1,4,0,2,0,4
9157,792067,29,3,5,2,2,1,3,1,3,0,3,2,5,0,0,0,8
9157,775523,16,1,5,1,4,0,1,0,0,2,2,0,1,0,1,0,2
9157,797649,33,8,16,6,11,2,5,3,3,1,7,1,2,1,4,0,21
9157,792058,20,0,5,0,5,0,0,2,4,0,0,1,4,1,0,1,2
9157,789028,35,4,9,4,9,0,0,6,13,2,3,5,3,4,4,0,14
9157,786836,7,0,1,0,0,0,1,0,0,1,1,0,0,0,0,0,0
9157,792062,24,2,5,2,5,0,0,0,0,3,9,2,3,0,2,0,4
9157,789053,21,1,5,1,4,0,1,2,4,0,0,1,0,1,3,0,4
9157,789029,15,2,3,0,1,2,2,0,0,0,0,1,0,0,2,0,6
9158,785589,38,5,12,3,10,2,2,6,10,1,6,2,2,0,4,0,18
9158,791209,20,0,3,0,3,0,0,4,4,2,3,0,2,0,2,2,4
9158,791215,34,4,12,4,9,0,3,0,0,1,5,3,0,3,2,0,8
9158,791213,28,3,11,1,3,2,8,0,0,0,2,1,0,1,1,0,8
9158,791214,33,6,10,2,4,4,6,2,2,1,3,5,2,1,4,1,18
9158,791216,16,1,3,1,3,0,0,2,2,1,3,0,2,0,0,0,4
9158,791212,19,0,1,0,1,0,0,0,0,0,4,1,3,1,1,0,0
9158,791210,6,0,2,0,0,0,2,0,0,0,0,0,1,0,0,0,0
9158,796917,6,0,1,0,0,0,1,0,0,0,0,1,0,0,0,0,0
9159,796754,38,6,13,3,7,3,6,0,0,2,4,3,1,0,3,0,15
9159,796755,18,3,6,3,6,0,0,1,1,1,2,0,2,0,2,1,7
9159,791099,36,5,14,1,4,4,10,0,0,1,3,1,3,3,1,0,14
9159,785586,27,0,2,0,0,0,2,1,2,0,3,4,4,1,3,1,1
9159,780298,36,6,13,6,10,0,3,2,3,0,11,5,0,3,4,0,14
9159,780814,22,4,4,4,4,0,0,2,2,1,4,1,1,0,0,0,10
9159,780315,23,1,6,0,2,1,4,0,0,0,2,1,3,2,0,1,3
9160,780027,25,5,8,4,5,1,3,3,4,2,6,1,0,0,2,4,14
9160,786176,22,4,9,2,3,2,6,1,4,2,5,2,1,1,1,1,11
9160,786173,8,1,2,0,0,1,2,0,0,0,0,0,1,1,0,0,3
9160,780028,24,1,8,0,1,1,7,0,0,0,2,8,1,2,1,0,3
9160,774828,25,8,13,0,1,8,12,2,2,0,2,2,0,1,1,0,26
9160,797175,18,3,7,3,4,0,3,2,2,1,3,1,1,1,1,2,8
9160,791379,20,8,13,5,7,3,6,0,0,1,5,0,1,0,1,0,19
9160,791380,16,2,2,2,2,0,0,0,0,0,4,4,2,3,1,0,4
9160,797178,11,0,1,0,0,0,1,0,2,0,3,3,0,1,0,0,0
9160,797179,12,1,2,1,2,0,0,0,0,0,2,4,2,1,0,0,2
9160,797176,10,1,4,1,2,0,2,2,2,1,1,0,1,0,0,0,4
9160,797177,3,2,2,2,2,0,0,0,0,1,0,0,0,0,0,0,4
9160,786170,3,1,1,1,1,0,0,0,0,0,1,0,0,1,0,0,2
9160,780026,3,1,2,1,1,0,1,0,0,0,2,0,0,0,0,0,2
9161,781007,12,0,1,0,1,0,0,0,2,0,2,0,2,0,2,0,0
9161,781322,26,5,12,1,4,4,8,0,0,2,11,1,2,0,1,0,14
9161,786571,25,1,7,0,3,1,4,0,0,0,2,0,2,1,5,1,3
9161,781419,29,6,12,1,4,5,8,0,0,0,2,1,0,0,1,0,17
9161,780563,27,1,8,1,4,0,4,0,0,1,4,5,0,1,2,0,2
9161,797299,15,2,2,2,2,0,0,0,0,3,0,2,2,0,0,0,4
9161,785989,20,5,11,4,6,1,5,3,3,2,6,3,2,0,5,1,14
9161,791690,11,0,2,0,2,0,0,0,0,0,0,0,0,1,1,0,0
9161,781207,17,1,3,1,2,0,1,2,2,0,1,0,1,0,1,0,4
9161,784248,11,1,6,0,0,1,6,3,3,0,0,1,0,0,1,0,6
9161,797300,3,0,1,0,1,0,0,0,0,0,0,0,0,0,0,0,0
9161,791691,3,0,0,0,0,0,0,0,0,0,0,0,0,0,1,0,0
9161,791692,1,0,0,0,0,0,0,0,0,0,0,1,0,0,0,0,0
9162,791750,33,3,7,2,4,1,3,2,2,3,2,0,3,0,2,0,9
9162,786177,27,5,8,3,3,2,5,1,1,0,9,0,2,0,0,1,13
9162,780244,26,2,4,0,0,2,4,5,8,0,5,2,1,0,0,0,11
9162,786179,33,4,13,4,8,0,5,0,0,1,2,2,2,4,1,0,8
9162,780238,32,8,14,7,12,1,2,1,1,1,5,6,0,1,1,0,18
9162,791749,3,0,0,0,0,0,0,0,0,0,0,0,3,0,0,0,0
9162,791752,16,0,2,0,2,0,0,0,0,0,1,0,3,0,2,0,0
9162,797346,1,0,1,0,1,0,0,0,0,0,0,0,0,0,0,0,0
9162,790773,19,2,4,0,1,2,3,0,0,0,6,0,3,0,2,1,6
9162,781500,9,1,3,1,1,0,2,0,0,0,2,1,0,1,3,0,2
9162,791748,1,0,0,0,0,0,0,0,0,0,1,0,0,0,0,0,0
9163,781647,7,0,4,0,1,0,3,0,0,0,1,0,3,0,0,0,0
9163,776037,33,5,5,5,5,0,0,1,2,1,1,0,0,1,1,0,11
9163,780588,18,2,6,2,6,0,0,0,0,1,3,1,1,1,0,0,4
9163,786147,27,4,10,3,6,1,4,3,5,2,1,4,1,0,1,0,12
9163,780667,36,3,12,2,8,1,4,1,2,0,3,0,0,0,1,1,8
9163,792562,26,2,7,2,5,0,2,2,4,2,6,1,0,1,1,0,6
9163,782643,22,3,7,3,7,0,0,2,3,3,8,2,2,0,4,3,8
9163,797355,1,0,1,0,1,0,0,0,0,0,0,0,0,0,0,0,0
9163,791759,12,1,5,1,4,0,1,0,0,0,1,0,1,0,1,0,2
9163,775680,14,0,4,0,1,0,3,0,0,0,2,1,0,2,1,0,0
9163,797356,1,0,0,0,0,0,0,0,0,0,0,0,0,0,0,0,0
9163,797354,1,0,0,0,0,0,0,0,0,0,0,0,0,0,0,0,0
9163,791758,2,0,0,0,0,0,0,0,0,0,0,0,0,0,0,0,0
9164,780919,28,2,5,2,5,0,0,4,4,4,3,3,0,1,1,0,8
9164,775640,11,0,0,0,0,0,0,3,4,1,3,0,4,0,1,0,3
9164,785803,25,0,3,0,2,0,1,0,0,0,0,1,2,0,2,2,0
9164,780920,35,10,17,9,13,1,4,3,3,1,3,4,2,1,2,0,24
9164,780914,30,3,7,2,5,1,2,4,4,1,3,1,3,0,1,1,11
9164,796797,17,4,7,3,5,1,2,0,0,1,4,0,0,0,2,0,9
9164,796799,4,0,0,0,0,0,0,0,0,0,1,1,1,0,0,0,0
9164,775816,23,4,10,3,6,1,4,3,4,3,9,1,1,2,1,0,12
9164,791142,16,1,3,1,1,0,2,0,0,1,4,0,1,0,1,0,2
9164,791141,9,2,5,0,1,2,4,0,0,0,1,1,1,0,2,0,6
9164,775639,1,0,0,0,0,0,0,0,0,0,0,0,0,0,0,0,0
9164,785805,1,0,0,0,0,0,0,0,0,0,0,0,0,0,0,0,0
9165,790781,27,2,7,2,7,0,0,2,2,2,5,1,2,0,3,1,6
9165,780040,30,4,11,4,11,0,0,2,2,1,4,1,4,1,1,0,10
9165,790785,25,3,12,1,8,2,4,0,0,0,1,1,3,0,3,0,8
9165,781232,36,4,8,2,3,2,5,5,5,0,1,1,2,2,0,0,15
9165,780037,26,1,9,1,7,0,2,4,4,1,2,1,2,1,2,0,6
9165,796344,20,0,3,0,0,0,3,0,0,1,6,1,2,0,0,0,0
9165,796339,26,5,7,2,2,3,5,0,1,0,1,3,3,2,2,0,13
9165,796343,10,1,1,1,1,0,0,1,2,2,0,0,0,0,0,1,3
9166,781579,31,10,20,10,17,0,3,1,1,1,9,2,1,2,3,0,21
9166,775696,28,2,9,2,7,0,2,2,3,3,1,2,2,0,0,0,6
9166,786731,31,7,10,7,10,0,0,0,0,2,11,2,5,1,0,5,14
9166,798023,34,2,5,1,3,1,2,3,4,0,0,6,1,0,0,0,8
9166,780347,32,1,3,1,2,0,1,0,2,1,3,3,2,0,0,0,2
9166,798017,10,3,7,1,1,2,6,0,0,2,1,0,0,1,2,0,8
9166,798008,29,5,10,2,6,3,4,0,0,0,3,3,4,1,4,0,13
9166,792358,5,0,2,0,0,0,2,0,0,0,1,2,0,0,0,0,0
9167,797695,19,1,6,1,6,0,0,0,0,0,2,1,4,1,2,0,2
9167,780844,36,3,10,0,0,3,10,2,2,0,11,1,1,1,1,0,11
9167,797699,22,2,8,2,5,0,3,0,0,0,1,2,2,0,4,0,4
9167,797692,30,4,10,2,4,2,6,2,2,0,3,1,1,1,0,0,12
9167,780846,38,6,10,5,7,1,3,1,4,2,6,3,2,2,5,0,14
9167,797698,2,0,0,0,0,0,0,0,0,0,0,1,0,0,0,0,0
9167,797694,21,3,6,0,0,3,6,0,0,0,1,0,3,1,0,1,9
9167,791954,23,2,4,2,2,0,2,3,4,1,2,1,1,0,0,0,7
9167,791956,9,0,2,0,1,0,1,0,0,0,1,1,0,0,0,0,0
9168,791230,29,1,7,1,4,0,3,0,0,2,4,1,1,0,0,2,2
9168,785557,33,6,11,5,9,1,2,4,5,0,7,1,2,1,3,0,17
9168,791228,17,1,6,1,4,0,2,1,2,1,5,0,5,0,2,0,3
9168,796932,39,7,13,4,9,3,4,6,7,0,3,5,2,6,1,0,23
9168,785624,33,4,11,1,4,3,7,0,2,0,2,2,1,2,0,0,11
9168,796935,4,1,2,0,0,1,2,0,0,0,0,0,0,0,0,0,3
9168,796933,28,5,7,5,7,0,0,1,1,3,1,0,1,1,1,1,11
9168,791226,7,0,0,0,0,0,0,0,0,0,0,0,2,0,1,0,0
9168,791227,9,0,2,0,0,0,2,0,0,0,0,0,2,0,1,0,0
9168,781198,1,0,0,0,0,0,0,0,0,0,0,0,0,0,0,0,0
9169,791306,33,4,6,3,4,1,2,4,6,2,5,1,2,0,2,0,13
9169,780210,36,8,17,8,15,0,2,3,5,7,9,2,1,2,4,1,19
9169,792432,35,4,9,3,5,1,4,0,0,1,3,3,1,0,2,0,9
9169,792427,34,2,9,2,6,0,3,1,1,0,5,4,1,1,4,0,5
9169,775005,21,4,7,3,4,1,3,2,2,0,1,0,4,1,2,1,11
9169,796592,11,2,3,2,2,0,1,0,0,0,0,0,1,0,0,0,4
9169,796594,4,0,0,0,0,0,0,0,0,0,0,0,2,0,0,0,0
9169,792433,18,3,8,3,6,0,2,0,0,3,3,0,3,0,1,0,6
9169,786422,8,0,0,0,0,0,0,0,0,0,1,0,2,0,1,0,0
9170,785913,17,5,7,5,7,0,0,0,3,1,0,2,0,0,1,0,10
9170,781464,29,2,6,0,0,2,6,3,4,0,6,3,2,2,2,0,9
9170,785282,26,5,6,1,1,4,5,0,2,1,1,2,3,2,2,1,14
9170,781502,19,3,3,3,3,0,0,0,0,0,2,4,3,0,3,0,6
9170,780259,24,6,11,5,8,1,3,5,7,1,5,3,1,2,1,0,18
9170,798038,3,1,2,1,1,0,1,1,1,1,0,0,1,0,1,0,3
9170,792274,5,2,2,2,2,0,0,0,0,0,1,0,0,0,0,0,4
9170,792277,9,5,5,5,5,0,0,1,2,2,0,0,0,0,0,0,11
9170,798048,3,0,0,0,0,0,0,0,0,0,1,0,0,0,0,0,0
9170,798051,4,0,0,0,0,0,0,0,0,0,1,0,0,0,0,0,0
9170,798056,9,2,3,0,0,2,3,0,0,0,1,1,3,0,1,0,6
9170,798058,7,0,2,0,1,0,1,0,0,0,0,1,0,0,2,0,0
9170,786516,26,5,9,1,1,4,8,1,1,0,5,3,1,0,0,1,15
9170,781501,19,4,5,3,3,1,2,2,2,0,3,7,0,1,1,0,11
9172,784268,29,4,8,3,6,1,2,3,4,0,2,3,2,0,3,0,12
9172,780223,31,1,4,0,0,1,4,0,0,1,1,1,1,2,2,0,3
9172,786318,32,4,11,1,4,3,7,5,6,0,3,3,1,0,1,0,16
9172,791482,34,5,8,2,5,3,3,2,2,1,4,1,2,2,1,0,15
9172,786319,16,4,7,4,7,0,0,0,0,1,4,1,1,1,1,0,8
9172,797199,20,3,6,3,6,0,0,5,6,0,1,2,2,1,2,0,11
9172,797200,3,0,0,0,0,0,0,0,0,0,0,0,1,0,0,0,0
9172,780225,19,0,4,0,0,0,4,0,0,0,6,1,2,1,1,0,0
9172,791481,16,2,4,2,3,0,1,0,1,0,3,0,3,0,0,0,4
9173,791367,34,12,16,12,15,0,1,3,5,1,6,4,2,0,5,1,27
9173,797235,35,4,5,4,5,0,0,3,8,4,8,0,3,5,1,0,11
9173,797239,36,1,13,0,7,1,6,1,2,0,4,2,4,2,1,0,4
9173,797232,38,6,9,3,5,3,4,0,0,0,2,1,3,1,6,0,15
9173,797234,17,1,3,1,2,0,1,0,0,0,6,0,3,0,0,0,2
9173,785446,8,0,0,0,0,0,0,0,0,0,0,0,0,0,0,0,0
9173,797237,9,0,2,0,1,0,1,0,0,0,0,0,1,0,1,0,0
9173,786535,17,0,3,0,1,0,2,0,0,0,2,1,2,0,1,0,0
9173,791368,1,0,0,0,0,0,0,0,0,0,0,0,0,0,0,0,0
9173,797233,5,0,0,0,0,0,0,0,0,0,0,0,1,0,0,0,0
9174,775571,28,1,4,1,4,0,0,0,2,0,3,7,2,3,3,0,2
9174,774894,33,9,17,3,6,6,11,1,1,1,1,3,0,0,0,0,25
9174,781036,35,4,11,2,7,2,4,4,4,0,4,7,2,0,1,0,14
9174,796846,15,3,6,1,2,2,4,0,0,3,1,2,2,0,1,0,8
9174,775833,8,2,3,2,3,0,0,0,2,2,5,0,4,1,1,0,4
9174,796844,1,0,0,0,0,0,0,0,0,0,0,0,0,0,0,0,0
9174,796845,16,3,4,1,2,2,2,0,0,0,6,0,0,0,0,0,8
9174,785439,3,0,0,0,0,0,0,0,0,0,0,0,0,0,1,0,0
9174,796847,34,2,6,2,5,0,1,5,6,0,3,0,4,0,2,0,9
9174,799906,26,5,6,5,5,0,1,4,4,2,1,0,3,0,0,0,14
9174,789925,1,0,0,0,0,0,0,0,0,0,0,0,0,0,0,0,0
9175,780580,39,3,9,2,3,1,6,1,3,0,9,8,3,0,2,0,8
9175,781407,28,6,8,6,7,0,1,1,2,3,3,2,3,0,0,0,13
9175,797445,32,3,10,1,4,2,6,2,2,1,4,2,1,1,1,0,10
9175,785623,36,7,11,4,5,3,6,0,2,1,1,0,0,0,1,1,17
9175,791583,21,3,6,3,6,0,0,1,4,1,1,0,5,0,5,1,7
9175,786608,9,0,1,0,0,0,1,0,1,2,0,1,0,0,1,1,0
9175,786110,14,4,5,2,2,2,3,0,0,0,0,0,2,0,1,1,10
9175,786659,13,1,3,1,3,0,0,0,0,0,1,0,0,0,0,0,2
9175,797448,8,1,2,0,0,1,2,2,2,1,1,0,1,0,0,0,5
9175,797447,0,0,0,0,0,0,0,0,0,0,0,0,0,0,0,0,0
9176,780377,26,0,4,0,1,0,3,6,7,0,2,1,3,0,3,0,6
9176,791852,29,4,5,4,5,0,0,2,2,3,6,0,4,2,0,7,10
9176,786604,0,0,0,0,0,0,0,0,0,0,0,0,0,0,0,0,0
9176,786601,28,3,8,3,3,0,5,3,4,0,4,0,0,0,2,0,9
9176,786600,32,3,4,2,3,1,1,4,6,0,6,1,2,4,6,0,11
9176,791851,28,2,5,1,3,1,2,0,0,1,6,2,1,2,2,1,5
9176,791853,11,3,8,3,7,0,1,0,0,2,1,1,3,0,0,0,6
9176,797461,14,2,10,2,7,0,3,4,6,1,4,1,1,1,3,0,8
9176,797460,32,4,12,3,8,1,4,1,2,2,4,0,3,1,1,0,10
9177,792131,22,0,6,0,6,0,0,3,4,6,3,1,2,1,2,1,3
9177,786838,32,1,11,1,11,0,0,12,14,1,7,1,3,2,1,5,14
9177,792132,34,4,7,3,5,1,2,0,0,0,2,3,3,1,2,0,9
9177,792127,32,5,13,3,7,2,6,3,3,2,1,1,3,3,2,1,15
9177,792126,25,1,9,0,0,1,9,0,0,0,2,0,3,1,1,0,3
9177,792128,26,3,5,3,3,0,2,2,2,3,8,0,5,1,4,0,8
9177,797736,11,2,3,1,1,1,2,0,0,0,1,1,0,0,2,0,5
9177,797739,12,1,6,0,2,1,4,0,0,0,1,0,0,1,1,0,3
9177,791668,6,0,0,0,0,0,0,0,0,1,0,1,0,0,1,0,0
9178,775651,25,7,9,6,7,1,2,0,0,0,2,0,2,1,1,3,15
9178,791070,27,3,7,3,6,0,1,5,6,0,1,2,1,3,3,0,11
9178,791627,24,2,4,0,1,2,3,0,0,0,6,1,1,2,1,0,6
9178,785665,26,4,9,0,1,4,8,2,2,0,6,3,1,2,1,0,14
9178,776178,22,1,3,1,2,0,1,1,1,1,3,6,2,0,2,0,3
9178,796505,5,0,0,0,0,0,0,0,0,1,2,0,1,0,0,0,0
9178,791071,10,2,3,2,3,0,0,0,0,1,2,1,2,0,1,0,4
9178,785660,4,2,2,2,2,0,0,0,0,0,2,0,0,0,0,0,4
9178,776253,14,2,8,2,5,0,3,1,2,1,4,0,2,0,3,0,5
9178,796504,7,1,2,1,1,0,1,2,3,0,0,1,1,3,1,0,4
9178,796502,13,2,5,1,3,1,2,0,0,2,4,1,1,0,1,1,5
9178,796501,18,3,6,3,5,0,1,3,3,2,2,3,1,2,0,1,9
9178,791073,4,0,3,0,2,0,1,0,0,0,0,0,1,0,0,0,0
9178,791076,1,0,0,0,0,0,0,0,0,0,0,0,0,0,0,0,0
9179,796979,19,0,3,0,1,0,2,0,0,1,1,0,2,2,0,0,0
9179,776200,15,3,5,3,5,0,0,4,6,3,3,1,0,0,1,0,10
9179,786437,23,1,4,1,4,0,0,0,0,0,2,0,0,0,2,1,2
9179,780925,27,2,11,1,6,1,5,2,2,0,2,1,2,1,1,0,7
9179,781034,23,1,8,1,4,0,4,1,2,0,2,1,1,1,2,0,3
9179,796980,7,0,1,0,1,0,0,0,0,1,1,0,2,0,1,0,0
9179,791625,17,2,5,1,2,1,3,0,0,1,3,0,3,0,0,0,5
9179,791622,18,4,7,4,7,0,0,0,0,3,1,0,1,1,2,0,8
9179,791624,21,2,7,1,3,1,4,4,9,0,5,0,3,1,2,1,9
9179,791637,12,2,4,1,1,1,3,1,1,0,1,0,0,1,2,1,6
9179,780446,18,0,3,0,2,0,1,0,0,0,2,2,1,0,3,0,0
9180,785622,28,1,7,1,2,0,5,2,2,2,2,0,2,0,3,0,4
9180,781058,17,0,3,0,3,0,0,0,0,0,1,0,3,0,2,0,0
9180,780327,18,1,2,1,2,0,0,1,4,2,1,0,2,0,0,0,3
9180,797458,18,0,2,0,2,0,0,0,0,0,0,2,2,0,2,0,0
9180,797451,36,6,10,2,3,4,7,3,3,1,3,1,2,2,4,0,19
9180,797455,15,1,2,1,2,0,0,1,2,0,3,1,0,1,1,0,3
9180,797456,20,5,9,2,3,3,6,3,4,0,0,0,1,0,0,0,16
9180,797453,8,2,4,1,3,1,1,0,0,1,0,0,1,1,0,0,5
9180,791848,12,1,1,1,1,0,0,1,2,1,1,0,2,1,1,2,3
9180,791849,15,2,4,1,2,1,2,0,0,1,0,1,1,0,1,0,5
9180,786607,13,0,3,0,3,0,0,2,2,1,0,2,0,1,0,1,2
9181,791062,34,4,6,4,6,0,0,2,2,1,3,3,3,1,3,0,10
9181,791063,27,5,5,3,3,2,2,2,2,2,6,5,3,0,1,2,14
9181,785542,36,8,10,8,9,0,1,3,5,0,4,3,2,1,1,0,19
9181,780743,36,5,13,5,10,0,3,1,1,0,2,4,1,0,4,0,11
9181,780055,22,3,4,1,1,2,3,1,1,1,1,1,1,2,1,0,9
9181,791060,12,1,2,1,2,0,0,2,2,0,0,2,1,1,0,0,4
9181,785548,11,1,1,0,0,1,1,0,0,1,0,0,2,0,2,0,3
9181,791064,22,3,10,1,6,2,4,0,0,0,1,2,3,1,0,0,8
9182,781107,10,1,3,1,3,0,0,0,0,0,1,1,3,0,0,0,2
9182,791972,37,6,9,3,3,3,6,0,0,2,4,5,1,0,1,0,15
9182,796777,17,1,4,1,3,0,1,1,2,0,2,3,0,1,3,0,3
9182,791974,40,6,9,5,6,1,3,3,3,0,0,2,4,1,1,0,16
9182,780863,29,6,12,3,8,3,4,5,7,1,1,1,3,1,3,0,20
9182,796778,21,1,2,1,2,0,0,0,1,1,4,2,5,2,6,1,2
9182,780867,12,1,3,0,1,1,2,0,0,0,2,0,4,0,3,0,3
9182,796780,33,1,11,0,2,1,9,0,0,0,3,0,1,3,1,1,3
9182,791973,1,0,0,0,0,0,0,0,0,0,0,0,0,0,0,0,0
9183,776424,17,0,2,0,2,0,0,0,1,0,2,0,4,0,1,0,0
9183,797914,15,1,3,1,2,0,1,2,2,0,5,1,2,0,3,0,4
9183,792300,32,5,9,5,8,0,1,5,6,2,9,1,2,1,2,1,15
9183,792303,35,10,13,5,7,5,6,11,12,1,2,3,1,4,4,0,36
9183,781603,30,3,5,2,2,1,3,0,2,1,3,0,1,2,1,0,7
9183,790813,11,0,2,0,1,0,1,0,0,0,0,0,1,1,3,0,0
9183,786618,14,3,5,3,5,0,0,0,0,1,1,0,2,0,0,0,6
9183,780456,22,4,7,2,2,2,5,0,0,2,1,2,1,1,2,1,10
9183,796155,10,0,2,0,0,0,2,0,0,0,1,2,1,0,0,0,0
9183,797912,12,0,3,0,1,0,2,0,0,0,1,1,0,0,0,0,0
9183,781605,2,0,0,0,0,0,0,0,0,0,0,0,1,0,0,0,0
9184,796617,5,0,0,0,0,0,0,1,2,0,0,1,0,0,0,0,1
9184,775131,31,2,2,0,0,2,2,0,0,1,3,3,4,1,2,0,6
9184,796616,33,7,10,3,6,4,4,0,0,0,2,0,2,2,1,1,18
9184,796612,33,9,14,9,14,0,0,1,1,0,3,5,3,0,2,0,19
9184,785562,33,3,9,3,6,0,3,4,5,0,2,1,2,1,3,0,10
9184,792429,9,0,3,0,2,0,1,0,0,0,0,0,0,1,0,1,0
9184,796614,8,0,3,0,2,0,1,2,2,0,1,0,0,0,0,0,2
9184,796607,25,3,5,3,3,0,2,1,1,0,1,2,1,0,0,1,7
9184,796606,23,3,3,2,2,1,1,0,3,1,5,5,2,3,3,0,7
9185,792167,21,6,8,6,8,0,0,5,9,5,6,0,4,0,3,0,17
9185,797767,15,2,6,0,1,2,5,0,0,0,0,2,4,1,4,0,6
9185,791372,34,3,7,1,2,2,5,0,0,1,2,3,1,2,2,0,8
9185,792164,33,3,13,1,5,2,8,1,2,0,3,6,3,0,1,0,9
9185,780974,37,7,12,4,7,3,5,2,2,2,7,1,1,4,4,0,19
9185,797777,2,1,3,1,3,0,0,0,0,1,0,0,0,0,0,0,2
9185,797766,19,3,4,2,2,1,2,0,2,2,3,4,2,0,0,0,7
9185,797772,10,1,2,1,1,0,1,0,0,1,1,1,0,0,1,0,2
9185,792163,29,1,1,0,0,1,1,0,0,1,2,0,0,0,0,2,3
9186,786163,29,6,8,5,6,1,2,1,1,4,1,1,3,1,1,1,14
9186,781149,15,0,0,0,0,0,0,0,0,0,1,1,1,0,1,0,0
9186,798152,5,0,2,0,1,0,1,0,0,1,0,0,0,0,1,0,0
9186,789025,36,4,6,2,3,2,3,1,1,0,3,1,2,3,1,0,11
9186,782157,13,1,2,1,2,0,0,1,2,0,0,1,0,0,1,0,3
9186,798153,3,0,0,0,0,0,0,0,0,0,1,0,2,0,1,0,0
9186,780852,7,1,2,1,2,0,0,0,0,0,0,0,1,0,0,0,2
9186,786214,0,0,0,0,0,0,0,2,2,0,0,0,0,0,0,0,2
9186,792670,22,4,12,3,7,1,5,8,8,1,9,0,1,2,1,2,17
9186,792669,26,2,3,2,3,0,0,3,4,0,4,6,2,1,4,0,7
9186,774985,28,5,11,3,6,2,5,1,3,0,3,3,4,1,1,0,13
9186,775276,16,2,5,1,1,1,4,0,0,0,0,0,4,0,1,0,5
9187,781656,26,3,4,3,4,0,0,0,2,1,3,4,2,1,2,0,6
9187,781658,33,4,6,4,6,0,0,0,0,2,3,3,1,1,2,0,8
9187,796962,31,5,10,3,6,2,4,2,3,0,1,1,4,0,2,0,14
9187,786798,35,5,8,5,8,0,0,4,6,1,4,5,3,0,5,0,14
9187,780129,30,5,10,1,3,4,7,0,0,0,4,2,4,0,3,0,14
9187,798206,10,0,2,0,1,0,1,0,0,0,2,1,1,0,0,0,0
9187,791263,13,2,3,2,3,0,0,1,3,0,2,1,2,0,0,0,5
9187,796967,13,3,7,0,1,3,6,0,0,0,0,1,0,0,2,0,9
9187,796966,1,0,0,0,0,0,0,0,0,0,0,0,1,0,0,0,0
9187,796964,3,0,1,0,0,0,1,0,0,0,0,0,1,0,0,0,0
9187,791264,5,0,1,0,1,0,0,1,2,1,1,0,0,1,0,0,1
9188,780323,25,6,8,6,8,0,0,2,2,1,6,2,2,0,1,2,14
9188,797894,25,6,8,6,8,0,0,0,0,1,3,3,2,1,3,0,12
9188,792229,24,0,0,0,0,0,0,2,4,0,7,2,3,1,0,1,2
9188,785954,28,4,5,1,1,3,4,0,0,0,3,1,2,3,3,0,11
9188,785811,27,7,12,6,9,1,3,5,6,0,0,2,0,2,1,0,20
9188,792233,22,4,7,4,5,0,2,4,6,0,1,1,1,1,3,0,12
9188,792230,14,0,3,0,0,0,3,3,5,0,2,0,2,0,0,0,3
9188,792234,12,1,1,0,0,1,1,2,2,0,6,1,1,0,0,0,5
9188,781356,9,0,1,0,0,0,1,0,0,1,0,1,1,1,0,1,0
9188,797891,8,1,2,1,1,0,1,0,0,0,0,0,0,0,0,0,2
9188,797893,5,0,0,0,0,0,0,0,0,0,0,0,0,0,1,0,0
9188,800234,1,0,0,0,0,0,0,0,0,0,0,0,0,0,0,0,0
9189,781480,38,3,12,2,7,1,5,0,0,1,2,2,4,0,4,0,7
9189,774846,28,4,9,4,9,0,0,2,2,0,2,1,2,1,1,0,10
9189,791376,18,1,5,0,1,1,4,0,0,0,1,2,4,2,0,0,3
9189,797272,36,5,14,2,4,3,10,2,2,1,1,1,3,2,2,0,15
9189,766611,36,4,13,1,6,3,7,4,4,1,2,0,2,1,1,0,15
9189,786185,12,1,1,1,1,0,0,2,2,2,1,0,2,1,2,1,4
9189,797273,8,0,2,0,1,0,1,0,0,0,1,0,1,0,0,0,0
9189,797182,20,0,2,0,2,0,0,0,0,0,4,3,0,0,2,0,0
9189,797181,4,0,0,0,0,0,0,0,0,0,1,0,0,0,0,0,0
9190,791980,33,5,8,1,2,4,6,8,9,6,6,0,1,2,0,1,22
9190,785972,26,4,8,3,6,1,2,0,0,2,1,1,2,0,0,1,9
9190,785967,25,5,13,5,13,0,0,7,9,5,3,2,3,0,2,0,17
9190,791977,32,3,11,2,5,1,6,7,8,0,5,0,1,1,2,0,14
9190,791978,31,3,11,1,7,2,4,2,2,0,3,5,1,0,3,1,10
9190,780160,12,0,1,0,0,0,1,0,0,1,3,0,5,2,1,1,0
9190,791976,21,1,8,1,6,0,2,2,2,2,0,3,3,2,3,0,4
9190,797800,15,0,1,0,1,0,0,0,0,1,1,2,0,0,0,0,0
9190,797801,5,0,0,0,0,0,0,0,0,0,0,0,1,0,0,0,0
9191,780874,25,2,7,1,1,1,6,2,2,0,5,1,4,1,0,0,7
9191,781326,20,5,7,5,7,0,0,2,6,3,5,0,3,1,1,1,12
9191,797870,38,4,11,1,5,3,6,4,4,0,2,2,1,1,2,0,15
9191,792210,29,0,4,0,2,0,2,4,4,1,1,2,3,1,3,0,4
9191,781323,31,2,8,1,4,1,4,0,0,0,3,5,5,1,4,1,5
9191,785430,19,7,10,7,10,0,0,6,8,5,3,0,2,0,0,0,20
9191,785638,15,0,2,0,1,0,1,2,2,1,4,0,3,0,1,0,2
9191,792215,19,1,4,1,4,0,0,0,0,0,0,0,2,0,2,0,2
9191,797868,3,0,1,0,1,0,0,0,0,0,0,0,0,0,0,0,0
9191,797869,1,0,0,0,0,0,0,0,0,0,0,0,0,0,0,0,0
9192,796996,30,6,10,6,10,0,0,3,4,1,5,1,4,0,0,1,15
9192,780471,32,4,11,4,10,0,1,3,4,4,5,2,3,0,4,2,11
9192,791608,34,4,9,1,1,3,8,2,2,0,3,1,2,0,2,0,13
9192,792071,34,4,9,0,0,4,9,2,3,0,6,0,1,0,1,0,14
9192,776011,28,1,8,1,8,0,0,1,2,0,3,5,5,0,3,0,3
9192,791610,10,0,0,0,0,0,0,0,0,1,2,1,1,0,2,1,0
9192,786413,6,0,0,0,0,0,0,0,0,0,0,0,1,0,1,0,0
9192,796994,19,2,7,0,3,2,4,0,0,0,2,0,2,1,1,0,6
9192,785680,5,0,1,0,1,0,0,2,2,0,0,0,0,0,0,0,2
9192,780417,2,1,1,0,0,1,1,0,0,0,0,0,0,0,1,0,3
9193,775806,18,0,4,0,4,0,0,2,5,2,4,1,1,1,0,0,2
9193,781011,30,3,7,3,7,0,0,0,2,4,3,0,4,1,2,3,6
9193,797601,37,7,19,5,8,2,11,1,2,0,0,0,1,1,1,0,17
9193,781012,37,7,11,4,5,3,6,2,2,1,2,4,2,2,0,0,19
9193,775119,31,3,8,2,6,1,2,2,2,0,8,4,1,1,1,0,9
9193,775188,12,3,4,3,4,0,0,1,1,2,2,0,2,0,0,0,7
9193,775563,31,7,12,7,12,0,0,6,8,2,6,2,4,1,2,0,20
9193,797604,2,0,0,0,0,0,0,0,0,0,0,0,1,0,0,0,0
9193,786466,2,0,0,0,0,0,0,0,0,0,0,0,0,0,0,0,0
9194,790810,17,1,7,0,3,1,4,0,2,1,1,0,2,0,0,1,3
9194,785362,30,6,13,6,13,0,0,6,8,5,5,2,3,1,3,2,18
9194,790808,30,3,7,3,6,0,1,0,0,1,5,2,1,1,2,0,6
9194,785361,35,7,12,4,6,3,6,2,5,1,5,1,0,2,1,0,19
9194,779997,38,3,9,2,6,1,3,4,4,0,2,5,1,4,2,0,11
9194,774854,10,1,2,1,2,0,0,0,1,0,2,0,2,0,1,1,2
9194,790809,24,1,1,1,1,0,0,4,4,1,1,2,2,2,1,0,6
9194,796370,16,1,4,1,3,0,1,0,0,0,2,0,0,0,1,0,2
9195,780095,29,1,2,1,2,0,0,0,0,2,4,1,3,2,2,5,2
9195,776321,36,9,19,7,13,2,6,3,4,6,7,2,4,0,1,1,23
9195,786081,36,2,8,0,4,2,4,0,0,2,6,0,3,0,2,0,6
9195,785431,38,2,5,0,1,2,4,2,3,1,2,5,0,1,3,0,8
9195,780232,38,5,16,4,8,1,8,5,6,0,6,0,2,3,4,0,16
9195,789040,9,1,4,1,2,0,2,0,0,1,1,0,2,1,0,0,2
9195,786020,7,1,3,1,3,0,0,0,0,0,0,1,1,0,1,1,2
9195,785356,7,1,2,0,0,1,2,0,0,0,1,0,1,0,1,0,3
9196,789177,31,6,11,6,11,0,0,3,6,6,10,1,0,1,2,1,15
9196,780227,33,2,9,2,8,0,1,1,2,1,5,0,2,0,2,0,5
9196,791340,27,0,9,0,9,0,0,4,4,0,2,5,1,3,4,0,4
9196,780181,25,2,11,1,8,1,3,4,5,1,4,0,3,2,1,0,9
9196,776089,36,3,5,1,3,2,2,0,1,0,2,1,2,1,1,0,8
9196,797260,3,0,0,0,0,0,0,0,0,0,1,0,0,0,0,0,0
9196,775758,15,0,0,0,0,0,0,3,4,1,0,1,3,0,1,0,3
9196,791336,22,2,5,2,4,0,1,2,2,2,7,1,0,2,3,0,6
9196,789178,8,0,0,0,0,0,0,0,0,0,1,0,0,0,1,1,0
9197,785292,20,1,2,1,1,0,1,0,0,1,2,0,0,0,0,0,2
9197,791988,27,1,8,1,8,0,0,1,2,1,4,0,2,2,2,1,3
9197,796503,31,6,13,5,9,1,4,0,0,2,4,1,1,1,4,0,13
9197,791989,33,2,8,2,6,0,2,4,4,0,3,0,2,1,4,0,8
9197,785258,17,0,4,0,4,0,0,0,0,0,1,0,2,0,1,0,0
9197,780077,10,1,3,1,2,0,1,0,0,0,1,0,2,2,0,0,2
9197,796506,5,0,1,0,1,0,0,0,0,0,0,0,1,1,0,1,0
9197,792443,21,1,4,1,4,0,0,0,1,0,4,0,0,0,0,2,2
9197,796508,17,0,4,0,1,0,3,0,0,1,2,0,3,0,0,0,0
9197,796507,19,1,4,1,2,0,2,3,4,0,2,0,2,0,1,0,5
9198,792399,23,1,5,1,5,0,0,2,4,1,4,1,1,0,1,1,4
9198,799000,28,4,6,4,6,0,0,5,5,2,2,0,3,0,2,3,13
9198,780263,37,2,7,2,4,0,3,10,10,2,7,0,2,2,2,1,14
9198,786697,27,4,8,3,5,1,3,2,2,0,3,2,4,3,3,0,11
9198,775628,38,6,11,6,8,0,3,6,9,1,6,3,3,1,1,0,18
9198,775198,32,4,11,2,3,2,8,7,9,2,2,1,2,1,3,0,17
9198,792397,2,0,0,0,0,0,0,0,0,0,1,0,1,0,0,0,0
9198,780571,13,1,7,0,2,1,5,0,0,1,0,1,3,0,2,0,3
9199,790951,32,0,2,0,2,0,0,0,0,0,1,1,4,0,0,2,0
9199,796545,37,10,16,6,12,4,4,6,8,0,8,4,3,2,8,0,30
9199,786309,34,5,11,4,9,1,2,2,2,1,2,1,4,1,0,0,13
9199,780087,18,2,6,2,5,0,1,4,4,0,4,0,4,0,5,0,8
9199,776076,17,0,1,0,1,0,0,0,0,0,0,1,2,1,2,1,0
9199,796543,17,1,2,1,2,0,0,0,0,1,1,0,4,0,1,0,2
9199,796540,13,3,9,3,7,0,2,1,2,4,4,0,2,0,0,1,7
9199,790954,3,0,1,0,0,0,1,0,0,0,2,2,1,0,0,0,0
9199,786089,28,6,13,2,5,4,8,2,2,0,2,0,3,0,2,0,18
9199,796544,1,0,0,0,0,0,0,0,0,0,0,0,0,0,0,0,0
9200,779985,24,5,8,2,2,3,6,0,0,2,0,1,2,2,0,0,13
9200,790876,29,4,10,3,7,1,3,3,5,0,3,4,1,0,0,0,12
9200,785699,36,3,11,3,8,0,3,2,3,0,2,3,3,2,0,0,8
9200,781062,25,1,5,0,0,1,5,0,0,0,3,0,2,1,0,0,3
9200,774987,37,4,12,2,6,2,6,6,6,2,4,1,1,2,0,0,16
9200,790882,29,5,11,5,10,0,1,3,4,0,3,1,1,1,1,1,13
9200,790877,4,0,2,0,1,0,1,0,0,0,0,0,0,0,0,0,0
9200,790879,4,0,0,0,0,0,0,0,0,1,0,0,2,0,0,0,0
9200,785432,12,0,0,0,0,0,0,0,0,0,3,0,2,0,0,2,0
9201,796469,20,3,7,3,4,0,3,3,3,0,4,0,4,0,0,3,9
9201,779981,33,8,10,8,10,0,0,0,3,3,9,0,1,0,1,2,16
9201,785463,36,4,11,1,7,3,4,0,0,1,7,5,1,0,3,0,11
9201,779978,36,1,5,1,4,0,1,0,0,1,1,1,2,0,5,0,2
9201,776003,36,5,8,3,6,2,2,4,4,0,1,2,1,0,0,0,16
9201,785466,3,0,0,0,0,0,0,0,0,1,0,1,0,0,0,0,0
9201,779979,18,4,8,1,1,3,7,0,0,0,1,1,2,1,1,0,11
9201,790923,16,1,4,1,3,0,1,2,2,1,2,0,4,0,1,0,4
9201,779980,2,0,0,0,0,0,0,0,0,0,1,0,2,0,0,0,0
9202,781103,29,9,14,9,14,0,0,3,4,4,5,0,3,2,5,1,21
9202,797568,36,2,12,2,5,0,7,3,4,1,2,3,1,0,1,0,7
9202,797566,30,2,5,1,2,1,3,0,1,0,6,3,1,1,1,0,5
9202,781191,35,2,10,0,3,2,7,2,2,0,5,2,1,3,1,0,8
9202,781102,28,5,6,5,6,0,0,1,2,2,7,5,2,3,2,0,11
9202,797569,3,0,0,0,0,0,0,0,0,1,0,0,0,0,0,0,0
9202,791905,28,4,8,3,5,1,3,0,0,1,1,2,2,2,2,1,9
9202,791904,11,2,5,2,4,0,1,0,1,1,1,2,0,0,1,3,4
9203,797103,29,7,12,7,12,0,0,1,2,4,3,0,3,1,7,1,15
9203,797105,31,2,6,2,3,0,3,0,0,0,3,1,3,1,2,1,4
9203,797100,21,1,4,1,3,0,1,0,0,2,5,2,2,1,2,0,2
9203,791413,29,4,9,3,3,1,6,1,1,0,2,2,3,1,2,0,10
9203,791411,33,2,8,1,4,1,4,5,5,0,7,4,1,3,2,0,10
9203,791414,8,0,1,0,1,0,0,0,0,0,0,0,1,0,0,0,0
9203,785911,11,3,4,2,2,1,2,0,0,0,0,0,1,1,0,1,7
9203,785776,26,4,10,4,6,0,4,0,0,0,4,2,0,2,1,0,8
9203,781209,12,1,4,0,1,1,3,1,2,0,1,1,0,0,0,0,4
9204,783072,24,3,7,2,4,1,3,0,1,1,2,0,4,0,2,0,7
9204,781463,31,1,4,1,3,0,1,3,4,2,4,2,1,1,1,2,5
9204,791540,36,4,11,4,11,0,0,0,0,0,5,3,0,1,2,0,8
9204,787782,25,0,3,0,0,0,3,0,0,0,1,2,2,0,4,0,0
9204,776068,34,7,15,7,13,0,2,4,4,0,3,1,3,1,0,1,18
9204,797817,27,7,10,7,10,0,0,4,4,2,7,0,2,1,3,0,18
9204,774879,10,0,3,0,2,0,1,2,2,0,2,0,0,0,1,0,2
9204,792153,13,1,1,1,1,0,0,0,0,0,0,0,0,0,0,0,2
9205,797579,14,2,2,1,1,1,1,0,0,0,3,0,1,0,0,0,5
9205,786509,33,5,9,5,9,0,0,5,6,6,9,1,1,1,1,1,15
9205,786508,34,4,14,1,5,3,9,0,0,2,7,1,3,1,2,1,11
9205,785796,38,5,9,3,4,2,5,2,2,0,1,1,5,1,6,0,14
9205,797576,39,1,13,0,5,1,8,2,2,0,1,3,1,2,3,0,5
9205,797577,7,0,0,0,0,0,0,0,0,0,0,0,2,0,0,1,0
9205,786507,8,1,4,0,2,1,2,0,0,0,3,0,0,1,0,0,3
9205,786505,25,2,4,1,1,1,3,1,2,0,0,5,1,1,1,0,6
9205,781325,2,0,1,0,0,0,1,0,0,1,0,0,1,0,2,0,0
9206,792632,14,3,3,3,3,0,0,2,3,1,5,1,2,2,2,1,8
9206,792629,26,2,5,2,4,0,1,2,2,0,1,8,1,2,1,0,6
9206,792631,15,2,5,1,4,1,1,0,0,0,1,3,0,1,0,0,5
9206,781491,24,7,11,5,9,2,2,4,4,2,5,3,1,2,2,1,20
9206,780250,22,5,7,2,3,3,4,0,0,1,1,1,3,2,0,0,13
9206,796637,21,4,7,3,6,1,1,0,0,0,8,0,3,1,0,0,9
9206,796634,17,5,8,4,7,1,1,0,2,2,1,2,3,2,2,1,11
9206,796638,7,0,2,0,0,0,2,0,0,0,2,0,1,0,2,0,0
9206,796642,15,2,6,1,3,1,3,3,6,1,1,2,3,1,3,0,8
9206,792627,16,2,5,2,4,0,1,0,0,0,4,0,0,0,2,1,4
9206,792626,23,2,2,2,2,0,0,3,4,1,4,4,4,0,2,0,7
9207,792318,31,6,12,6,12,0,0,4,9,5,2,1,2,1,4,0,16
9207,796518,17,0,6,0,4,0,2,0,0,1,3,0,2,0,0,0,0
9207,786717,22,3,9,2,8,1,1,3,3,1,6,2,0,1,2,0,10
9207,780753,34,3,9,1,5,2,4,1,2,0,1,5,3,3,4,0,9
9207,775329,32,5,13,1,5,4,8,7,8,0,0,1,3,4,2,0,21
9207,792308,11,0,1,0,1,0,0,0,0,1,1,1,1,0,0,0,0
9207,796519,20,0,3,0,1,0,2,1,2,0,3,1,5,0,2,0,1
9207,796520,29,5,9,4,5,1,4,0,0,1,3,3,1,0,2,0,11
9207,792315,4,0,1,0,1,0,0,0,1,0,0,0,1,1,0,0,0
9208,790784,24,3,13,2,5,1,8,0,0,2,1,0,3,0,3,1,7
9208,786235,18,2,3,2,3,0,0,2,8,3,1,0,4,1,0,0,6
9208,797475,29,2,6,1,2,1,4,0,0,0,4,1,3,0,0,0,5
9208,786229,22,0,5,0,1,0,4,0,0,0,4,0,0,1,0,0,0
9208,786583,5,0,0,0,0,0,0,0,0,0,1,0,1,0,0,0,0
9208,776219,20,0,3,0,2,0,1,0,0,1,2,2,2,0,0,1,0
9208,786581,18,1,3,0,2,1,1,2,2,1,1,0,1,0,0,0,5
9208,786770,18,5,14,3,11,2,3,3,3,1,3,0,2,1,2,0,15
9208,781518,13,0,0,0,0,0,0,0,0,1,2,0,2,0,1,0,0
9208,775229,33,8,20,6,16,2,4,2,2,3,5,3,3,1,3,0,20
9209,775738,14,1,2,1,1,0,1,1,2,1,2,0,3,0,0,2,3
9209,786091,28,2,7,2,3,0,4,2,2,3,10,0,3,0,0,2,6
9209,786728,39,7,11,7,9,0,2,12,16,1,6,4,3,2,3,0,26
9209,785904,33,8,17,5,9,3,8,2,2,0,2,0,3,2,5,0,21
9209,780892,36,2,8,1,3,1,5,0,1,0,4,5,4,1,2,0,5
9209,797666,7,0,2,0,0,0,2,0,0,1,0,0,1,0,0,0,0
9209,786788,6,0,1,0,0,0,1,2,2,0,2,1,1,0,1,0,2
9209,786096,33,2,4,1,3,1,1,0,1,2,6,1,2,0,2,0,5
9209,781030,4,0,0,0,0,0,0,0,0,0,0,0,0,0,0,0,0
9210,786203,35,7,12,2,4,5,8,3,4,1,4,1,0,0,0,1,22
9210,791742,38,6,12,3,6,3,6,6,8,1,3,4,3,1,4,0,21
9210,776266,36,4,7,4,6,0,1,6,6,0,1,1,1,0,1,0,14
9210,786197,33,7,10,7,9,0,1,0,0,2,5,3,3,0,3,0,14
9210,780717,10,2,3,2,2,0,1,0,0,1,0,2,5,0,2,0,4
9210,776328,24,3,4,2,3,1,1,5,5,2,4,2,3,1,2,0,12
9210,791741,18,2,4,1,1,1,3,3,4,0,3,2,3,0,0,0,8
9210,791738,6,0,0,0,0,0,0,0,0,0,2,0,1,0,1,0,0
9210,774859,0,0,0,0,0,0,0,0,0,0,0,0,0,0,0,0,0
9211,785944,39,8,19,5,12,3,7,2,5,0,1,5,4,2,4,0,21
9211,797482,36,5,7,3,5,2,2,6,6,1,2,1,4,2,2,0,18
9211,797480,22,4,8,4,6,0,2,4,6,0,0,1,3,0,0,0,12
9211,797481,28,3,7,1,4,2,3,2,2,1,3,2,5,0,2,0,10
9211,797485,28,3,5,2,2,1,3,0,0,0,5,0,3,1,4,0,7
9211,797479,21,3,3,0,0,3,3,0,0,1,2,1,2,0,0,0,9
9211,797483,12,1,1,1,1,0,0,2,3,2,2,2,1,0,0,0,4
9211,797478,9,1,4,0,3,1,1,0,0,1,0,0,2,0,0,0,3
9211,791875,1,1,1,1,1,0,0,0,0,0,0,0,0,0,0,0,2
9211,781217,4,0,1,0,0,0,1,0,0,0,0,0,0,0,0,0,0
9212,786117,40,4,11,3,5,1,6,2,4,1,4,5,2,3,4,0,11
9212,786118,38,7,15,3,5,4,10,0,1,3,6,2,2,2,2,0,18
9212,797673,30,6,11,5,7,1,4,1,1,1,0,3,4,2,2,0,14
9212,786123,38,9,13,9,13,0,0,0,0,6,8,6,2,1,3,3,18
9212,780437,40,5,14,5,11,0,3,2,2,2,3,2,3,1,0,1,12
9212,792093,12,1,1,1,1,0,0,0,0,0,2,1,0,0,0,0,2
9212,797675,2,0,0,0,0,0,0,0,0,0,0,0,2,0,0,0,0
9213,774962,31,5,10,5,6,0,4,2,3,0,1,6,4,0,1,0,12
9213,796907,29,2,8,1,5,1,3,0,0,3,6,0,1,3,2,1,5
9213,775626,35,2,11,1,7,1,4,1,1,1,5,0,1,0,4,0,6
9213,774964,33,5,10,5,10,0,0,5,7,3,5,0,2,1,4,3,15
9213,796912,10,1,3,1,2,0,1,0,0,1,2,0,0,0,1,0,2
9213,796906,27,3,12,1,6,2,6,4,4,2,0,2,2,1,3,0,12
9213,791203,20,1,2,0,0,1,2,0,0,0,1,2,1,1,0,0,3
9213,796908,3,0,0,0,0,0,0,0,0,0,0,0,0,0,0,0,0
9213,785606,9,1,3,1,3,0,0,0,1,2,0,0,0,0,0,0,2
9213,796910,3,1,2,1,2,0,0,0,0,0,0,0,0,0,0,0,2
9214,792684,31,4,7,3,6,1,1,2,3,2,2,2,4,1,3,0,11
9214,781665,36,5,11,5,7,0,4,0,0,0,6,2,2,6,4,0,10
9214,782162,32,2,9,2,4,0,5,4,4,1,2,1,0,0,4,0,8
9214,790494,12,1,2,1,2,0,0,0,1,1,3,0,2,0,3,0,2
9214,781659,12,0,4,0,3,0,1,0,0,2,3,1,4,0,2,0,0
9214,780610,30,7,15,4,7,3,8,8,8,0,0,0,1,1,0,0,25
9214,781005,16,2,7,1,5,1,2,2,2,0,1,0,5,0,2,1,7
9214,788866,7,1,3,1,3,0,0,0,0,0,0,0,1,0,0,0,2
9214,781411,7,0,0,0,0,0,0,2,2,0,1,0,1,0,0,0,2
9214,796853,10,0,1,0,1,0,0,0,0,1,3,0,2,0,0,0,0
9214,792683,6,0,2,0,0,0,2,0,0,0,0,0,2,0,2,0,0
9214,796855,1,0,0,0,0,0,0,0,0,0,1,0,0,0,0,0,0
9215,776497,27,5,13,1,4,4,9,4,8,2,6,2,2,0,2,1,18
9215,785731,27,5,11,5,11,0,0,3,3,2,1,3,4,2,4,1,13
9215,785729,32,2,5,2,5,0,0,4,4,2,2,3,3,3,1,0,8
9215,780864,23,2,3,1,2,1,1,3,6,0,3,2,0,1,2,0,8
9215,788113,27,2,5,1,1,1,4,0,1,2,4,1,4,1,5,0,5
9215,786231,28,10,17,8,10,2,7,7,10,2,8,3,4,2,3,0,29
9215,796211,17,2,5,2,4,0,1,0,0,2,1,2,1,1,0,2,4
9215,799881,9,2,3,2,3,0,0,0,0,0,2,0,1,0,1,1,4
9215,792402,10,1,2,0,1,1,1,0,0,0,1,0,2,1,1,0,3
9216,786495,31,4,6,2,3,2,3,0,1,2,5,1,3,2,3,0,10
9216,776384,37,1,9,1,4,0,5,8,10,1,2,7,2,0,3,0,10
9216,791650,35,5,10,4,8,1,2,7,7,0,3,0,3,5,4,0,18
9216,791652,23,2,5,2,5,0,0,8,8,1,6,1,3,0,3,1,12
9216,775705,17,1,3,1,3,0,0,0,0,2,3,1,3,0,1,0,2
9216,797283,10,3,4,1,1,2,3,3,4,0,0,0,1,0,1,0,11
9216,791654,5,1,1,1,1,0,0,0,0,0,0,0,1,0,1,0,2
9216,797285,12,0,2,0,0,0,2,0,0,0,0,0,1,0,1,0,0
9216,797286,2,0,0,0,0,0,0,0,0,0,0,0,0,0,0,0,0
9216,791653,11,3,3,2,2,1,1,0,0,0,1,2,0,1,0,0,7
9216,797289,17,1,2,1,2,0,0,3,4,0,3,0,1,1,0,0,5
9217,781543,31,4,6,4,6,0,0,1,1,0,3,3,5,3,4,0,9
9217,791822,39,7,10,0,0,7,10,2,3,0,4,1,1,0,0,0,23
9217,786635,37,6,11,6,10,0,1,5,7,1,7,1,4,2,3,0,17
9217,780642,22,3,8,3,7,0,1,1,2,0,1,2,4,3,3,0,7
9217,776449,34,4,10,4,8,0,2,3,4,1,2,2,1,1,1,0,11
9217,797383,7,0,3,0,0,0,3,0,0,0,0,0,2,1,0,1,0
9217,786182,12,2,3,1,2,1,1,1,2,0,1,1,5,1,1,0,6
9217,786632,8,1,1,1,1,0,0,0,0,0,0,0,1,1,0,0,2
9217,798157,10,0,2,0,2,0,0,0,0,0,0,0,3,0,0,0,0
9218,791839,34,3,6,3,6,0,0,3,5,3,9,4,0,0,3,0,9
9218,797444,24,3,8,2,4,1,4,0,0,5,4,2,2,1,2,0,7
9218,792381,24,2,7,1,3,1,4,7,7,1,1,2,4,2,2,1,12
9218,791842,29,9,20,5,9,4,11,3,3,1,4,1,1,0,2,0,25
9218,786616,26,4,12,3,7,1,5,1,1,1,4,1,3,0,1,0,10
9218,791840,5,1,1,0,0,1,1,1,2,1,2,0,0,1,0,1,4
9218,785322,20,1,6,1,3,0,3,0,0,0,5,1,0,0,0,0,2
9218,797442,5,0,2,0,0,0,2,1,2,0,1,0,1,0,0,0,1
9218,786613,13,4,7,4,6,0,1,0,0,0,2,1,0,1,3,0,8
9218,786736,20,1,5,1,1,0,4,0,0,1,1,3,1,1,4,0,2
9220,781244,18,4,6,3,4,1,2,1,1,0,3,1,5,0,2,0,10
9220,785537,36,4,10,3,7,1,3,2,2,1,2,2,3,0,1,0,11
9220,781243,25,1,8,1,5,0,3,2,2,5,9,3,2,1,2,3,4
9220,781237,33,4,6,1,2,3,4,0,0,1,3,3,0,3,0,0,11
9220,776205,29,6,11,4,8,2,3,4,4,1,0,1,3,2,2,1,18
9220,796940,4,0,1,0,0,0,1,0,0,0,0,0,0,0,0,0,0
9220,791243,8,0,3,0,2,0,1,0,0,0,0,0,2,0,0,0,0
9220,791241,11,3,3,3,3,0,0,0,1,0,4,2,4,0,1,0,6
9220,791245,29,4,11,2,4,2,7,3,4,0,2,1,1,1,1,0,13
9220,791246,7,1,2,1,1,0,1,0,0,0,0,0,2,0,1,0,2
9221,785509,26,1,6,0,2,1,4,0,0,2,1,0,2,0,1,0,3
9221,791424,15,1,2,1,1,0,1,0,0,1,2,1,5,1,2,0,2
9221,797085,36,5,12,2,4,3,8,3,4,3,6,2,5,2,4,0,16
9221,791421,37,6,17,5,11,1,6,2,2,0,2,2,0,2,3,1,15
9221,785899,34,1,8,0,4,1,4,4,5,0,1,1,2,0,0,0,7
9221,797079,13,1,4,1,4,0,0,2,3,4,2,0,3,0,1,0,4
9221,791425,24,5,11,5,11,0,0,4,5,3,6,3,1,0,1,0,14
9221,797086,5,0,1,0,0,0,1,0,0,0,1,0,0,0,0,0,0
9221,797090,3,0,0,0,0,0,0,1,2,0,0,0,1,0,1,0,1
9221,797083,1,0,0,0,0,0,0,0,0,0,0,0,0,0,0,0,0
9221,797088,6,0,0,0,0,0,0,0,0,0,1,1,0,0,1,0,0
9222,786624,16,2,2,2,2,0,0,0,1,1,3,0,1,0,0,1,4
9222,797405,27,3,7,3,7,0,0,1,2,3,3,2,4,1,2,0,7
9222,791834,36,3,11,2,7,1,4,1,2,0,0,4,2,0,0,0,8
9222,791833,29,0,4,0,2,0,2,1,4,0,1,1,1,2,1,0,1
9222,785920,36,8,16,6,13,2,3,5,5,1,10,1,5,1,5,0,23
9222,786623,20,3,4,3,4,0,0,0,2,3,3,2,2,0,0,1,6
9222,797404,3,1,2,1,1,0,1,0,0,0,0,0,0,0,0,0,2
9222,785698,18,2,7,0,0,2,7,0,2,1,2,0,1,0,0,1,6
9222,784077,15,2,8,1,3,1,5,0,0,1,0,0,1,0,0,0,5
9223,780494,33,4,13,2,9,2,4,2,2,1,4,3,3,2,0,3,12
9223,797276,23,2,6,2,4,0,2,4,5,1,1,1,2,0,2,0,8
9223,780497,34,5,6,5,6,0,0,5,5,1,8,2,2,2,1,0,15
9223,780496,32,0,4,0,0,0,4,3,3,0,3,0,4,0,0,0,3
9223,780495,32,6,16,5,12,1,4,4,4,2,6,0,2,0,5,0,17
9223,797277,2,0,0,0,0,0,0,0,0,0,0,0,0,0,0,0,0
9223,797274,4,0,0,0,0,0,0,0,0,0,0,0,0,0,0,0,0
9223,785693,8,0,1,0,1,0,0,0,0,0,5,0,3,1,0,0,0
9223,785692,13,1,1,1,1,0,0,0,0,0,1,1,1,0,2,0,2
9223,785644,19,3,6,2,2,1,4,1,2,0,2,1,1,0,2,0,8
9224,796761,29,3,5,3,5,0,0,1,2,1,1,0,2,0,0,2,7
9224,780109,35,1,9,0,5,1,4,1,2,3,6,0,4,3,1,2,4
9224,796758,37,11,22,11,21,0,1,8,10,3,7,0,2,0,1,0,30
9224,796757,22,3,12,2,8,1,4,4,4,0,3,4,5,2,4,0,11
9224,780794,39,2,9,0,2,2,7,0,0,0,4,2,1,0,0,0,6
9224,791103,1,0,0,0,0,0,0,2,2,1,0,0,0,0,0,0,2
9224,796760,1,0,1,0,0,0,1,0,0,0,0,0,1,0,0,0,0
9224,785597,36,4,7,2,4,2,3,4,4,0,6,3,3,2,0,1,14
9225,797573,16,1,4,1,4,0,0,0,0,1,1,0,3,0,1,3,2
9225,791903,28,5,9,4,6,1,3,2,2,2,4,1,2,3,1,1,13
9225,797571,29,3,7,1,4,2,3,0,0,0,3,1,2,0,3,0,8
9225,791899,37,3,10,3,8,0,2,2,3,2,6,3,2,1,2,0,8
9225,786512,36,9,16,5,10,4,6,5,5,1,7,1,2,1,2,0,27
9225,797574,19,1,6,0,3,1,3,0,0,1,4,1,2,0,0,1,3
9225,791900,5,0,0,0,0,0,0,0,0,0,0,0,0,0,0,0,0
9225,797575,6,0,2,0,2,0,0,2,2,0,2,0,3,0,0,1,2
9225,786032,24,6,12,6,12,0,0,4,4,2,3,0,2,0,0,1,16
9226,796347,20,2,5,2,3,0,2,0,0,1,4,1,3,2,3,0,4
9226,785243,24,6,10,2,5,4,5,1,2,2,3,4,0,1,1,0,17
9226,790788,28,8,12,5,5,3,7,1,2,0,4,1,1,2,1,0,20
9226,781028,31,10,16,6,8,4,8,8,8,0,6,3,1,1,1,0,32
9226,781026,21,1,5,0,2,1,3,0,0,1,3,3,2,0,0,0,3
9226,790787,4,0,0,0,0,0,0,0,0,0,0,0,2,1,1,0,0
9226,785242,15,0,1,0,1,0,0,0,0,0,0,2,2,0,1,0,0
9226,781027,13,4,5,1,1,3,4,0,0,0,1,2,3,1,0,0,11
9226,790786,3,0,0,0,0,0,0,0,0,0,0,1,0,0,0,0,0
9226,796346,4,1,2,0,1,1,1,0,0,0,0,1,1,0,0,0,3
9226,796348,13,0,0,0,0,0,0,0,0,0,1,2,5,1,1,0,0
9226,796349,24,4,5,3,4,1,1,0,0,0,4,1,2,0,1,0,9
9227,776345,18,1,6,1,4,0,2,0,0,0,1,1,0,0,2,1,2
9227,796579,25,2,5,0,0,2,5,3,3,0,3,1,1,0,3,0,9
9227,785794,30,5,10,5,7,0,3,5,6,2,2,0,2,2,1,1,15
9227,785792,18,0,2,0,2,0,0,4,4,0,0,0,2,0,0,0,4
9227,781373,23,3,4,2,2,1,2,3,3,0,2,1,4,3,3,0,10
9227,796578,3,1,1,1,1,0,0,2,4,2,1,0,0,0,0,0,4
9227,791295,18,4,7,4,7,0,0,0,0,0,4,3,2,0,1,0,8
9227,781379,4,1,2,1,2,0,0,0,1,1,0,0,0,0,1,0,2
9227,796577,13,2,4,0,1,2,3,0,0,2,2,0,1,2,0,1,6
9227,791294,1,0,0,0,0,0,0,0,0,0,0,0,0,0,0,0,0
9227,791292,11,1,4,1,4,0,0,0,2,1,2,0,0,0,0,0,2
9227,791293,13,0,1,0,1,0,0,2,2,0,0,2,2,0,0,0,2
9227,796580,20,1,6,1,4,0,2,1,2,0,1,0,1,0,2,0,3
9227,781372,3,0,1,0,0,0,1,0,0,0,0,0,0,0,0,0,0
9228,785665,32,6,8,2,2,4,6,0,0,1,4,0,1,1,1,0,16
9228,791070,28,4,8,3,5,1,3,3,6,1,3,3,3,1,3,0,12
9228,776178,27,4,6,3,4,1,2,0,0,1,3,1,1,0,2,0,9
9228,791627,31,2,6,1,2,1,4,2,5,0,3,3,2,0,3,0,7
9228,775651,18,2,4,2,2,0,2,1,3,2,4,1,4,0,3,0,5
9228,791071,14,2,3,2,3,0,0,2,2,3,2,1,3,2,0,0,6
9228,776253,24,2,11,2,7,0,4,0,0,3,9,1,1,0,2,0,4
9228,796502,7,1,3,1,1,0,2,0,0,0,0,0,1,2,0,0,2
9228,785660,5,1,2,1,2,0,0,0,1,1,0,0,1,0,0,0,2
9228,796501,11,0,2,0,1,0,1,0,0,0,0,1,1,0,1,0,0
9228,796505,3,0,0,0,0,0,0,0,0,0,0,0,0,0,1,0,0
9229,780925,36,4,13,3,10,1,3,8,10,1,2,3,2,0,0,0,17
9229,781034,33,5,11,4,7,1,4,1,1,0,4,3,1,1,1,0,12
9229,776200,25,3,7,3,7,0,0,2,3,1,4,1,2,4,0,0,8
9229,791624,25,2,7,1,4,1,3,1,3,1,2,0,3,2,3,0,6
9229,786437,20,1,7,1,4,0,3,2,2,2,1,0,1,0,2,0,4
9229,791625,6,1,5,0,2,1,3,0,0,1,0,0,2,0,0,0,3
9229,796979,26,1,5,1,2,0,3,0,0,1,7,1,2,0,2,1,2
9229,791637,4,0,1,0,0,0,1,2,2,0,0,0,0,0,0,0,2
9229,791622,12,0,2,0,2,0,0,0,0,1,1,0,3,0,1,1,0
9229,780446,9,0,0,0,0,0,0,0,0,0,0,0,1,0,0,0,0
9229,796980,4,0,0,0,0,0,0,0,0,1,0,0,1,0,2,0,0
9230,785490,20,1,4,1,1,0,3,0,2,0,5,0,2,1,0,2,2
9230,775377,18,2,3,2,3,0,0,0,0,4,1,1,0,1,0,0,4
9230,780427,18,4,7,2,4,2,3,0,0,2,1,1,3,0,3,2,10
9230,785486,6,1,3,1,2,0,1,0,0,0,0,0,0,1,0,2,2
9230,780698,37,7,17,6,12,1,5,2,2,3,6,7,2,3,2,1,17
9230,785495,27,8,11,6,8,2,3,3,3,2,4,2,1,1,5,1,21
9230,785958,23,4,8,3,7,1,1,3,4,3,5,0,2,0,2,0,12
9230,785659,21,2,4,1,2,1,2,0,0,0,2,1,2,1,1,0,5
9230,791034,2,0,0,0,0,0,0,0,0,0,0,0,0,0,0,0,0
9230,785494,28,2,6,2,3,0,3,4,4,0,4,7,2,1,4,0,8
9230,791033,0,0,0,0,0,0,0,0,0,0,0,0,0,0,0,0,0
9231,797230,17,1,4,1,4,0,0,0,0,1,4,1,3,0,0,0,2
9231,791446,34,3,14,2,6,1,8,0,0,3,3,1,1,1,0,1,7
9231,781558,35,7,12,6,6,1,6,4,6,1,1,0,0,0,5,0,19
9231,797225,34,6,12,6,11,0,1,4,4,1,5,4,3,5,5,1,16
9231,791452,39,4,12,1,4,3,8,2,2,1,3,7,3,0,2,0,13
9231,797231,15,3,6,2,4,1,2,0,0,1,2,0,2,1,0,0,7
9231,791449,21,1,2,1,1,0,1,1,2,0,1,0,2,0,1,0,3
9231,797226,5,0,2,0,1,0,1,0,0,0,0,0,0,0,0,0,0
9231,797229,0,0,0,0,0,0,0,0,0,0,0,0,0,0,0,0,0
9232,781393,36,9,15,4,7,5,8,11,12,0,5,4,3,0,3,0,34
9232,787175,33,3,9,0,0,3,9,1,2,0,4,2,2,0,1,0,10
9232,790909,25,3,5,2,3,1,2,3,3,1,3,2,2,0,3,0,10
9232,796455,28,2,2,2,2,0,0,2,4,2,7,0,1,0,0,2,6
9232,775351,38,1,6,1,6,0,0,2,5,2,8,3,3,0,3,1,4
9232,782126,22,4,8,2,3,2,5,2,3,0,1,1,2,1,2,0,12
9232,790907,18,0,1,0,1,0,0,4,4,0,2,0,3,0,0,0,4
9232,796454,0,0,0,0,0,0,0,0,0,0,0,0,0,0,0,0,0
9233,780946,35,5,13,3,7,2,6,2,3,0,1,3,3,3,2,0,14
9233,778442,39,4,13,3,9,1,4,4,4,3,10,2,3,1,0,0,13
9233,797150,35,4,16,3,7,1,9,0,0,4,10,4,3,2,2,0,9
9233,786637,35,2,11,2,7,0,4,2,3,1,2,4,5,1,0,0,6
9233,791511,14,3,6,3,6,0,0,0,0,3,1,0,1,0,0,0,6
9233,797151,24,4,6,4,6,0,0,1,3,3,0,1,1,2,0,1,9
9233,791513,8,3,3,1,1,2,2,0,0,0,0,1,1,0,0,0,8
9233,797154,5,1,2,0,0,1,2,0,0,0,0,0,0,0,1,0,3
9233,791516,3,0,1,0,0,0,1,2,2,0,0,1,3,0,1,0,2
9233,791515,2,1,2,1,1,0,1,0,0,0,0,0,2,0,0,0,2
9234,797313,33,6,7,5,5,1,2,0,2,0,1,1,2,1,1,0,13
9234,786569,28,4,9,4,8,0,1,0,0,2,3,4,1,0,0,0,8
9234,791726,34,4,11,3,7,1,4,0,0,0,3,1,2,2,2,0,9
9234,786273,35,9,14,7,9,2,5,3,3,1,4,8,1,1,2,1,23
9234,780773,37,8,18,8,14,0,4,2,3,0,8,2,3,3,4,0,18
9234,797315,4,0,0,0,0,0,0,0,0,0,0,0,0,0,0,0,0
9234,791728,9,2,3,2,3,0,0,0,0,0,2,0,2,1,1,0,4
9234,789091,3,0,0,0,0,0,0,0,0,0,0,0,1,0,0,0,0
9234,786272,17,0,0,0,0,0,0,0,0,0,0,0,1,0,0,0,0
9235,780756,7,2,5,1,3,1,2,0,0,0,0,0,1,0,0,0,5
9235,780751,22,3,3,2,2,1,1,0,0,1,2,4,0,1,0,1,7
9235,796743,36,6,12,5,6,1,6,3,4,0,5,1,3,0,2,0,16
9235,791068,28,4,7,4,5,0,2,3,3,1,2,1,4,2,0,2,11
9235,785551,23,3,9,2,5,1,4,0,0,0,4,2,2,0,2,1,7
9235,785642,6,0,0,0,0,0,0,0,0,1,0,0,0,0,2,0,0
9235,780512,32,4,6,3,4,1,2,3,3,1,7,1,0,0,1,0,12
9235,796745,3,0,0,0,0,0,0,0,0,0,0,0,0,0,0,0,0
9235,796744,11,0,1,0,1,0,0,2,2,0,0,1,1,0,0,0,2
9235,791066,22,6,12,4,6,2,6,2,2,0,2,1,2,2,4,0,16
9235,791065,10,0,2,0,1,0,1,0,0,1,0,0,1,0,2,0,0
9236,797972,31,2,3,2,2,0,1,2,3,0,3,0,3,0,1,2,6
9236,797967,33,7,15,7,14,0,1,5,6,2,5,2,0,2,0,0,19
9236,797970,25,7,11,7,10,0,1,1,2,0,2,1,4,2,2,0,15
9236,781453,33,8,16,3,7,5,9,1,2,0,13,10,2,0,3,0,22
9236,774869,36,4,11,1,4,3,7,0,0,0,3,1,1,1,0,0,11
9236,792254,15,1,3,1,3,0,0,6,8,4,3,2,0,0,0,0,8
9236,792256,2,0,0,0,0,0,0,0,0,0,1,0,0,0,0,0,0
9236,786098,21,3,4,1,2,2,2,0,0,0,1,1,3,0,2,0,8
9236,786106,2,0,1,0,0,0,1,0,0,0,0,0,0,0,1,0,0
9236,797962,2,0,0,0,0,0,0,0,0,0,0,0,0,0,0,0,0
9237,780406,14,0,4,0,2,0,2,0,0,0,4,0,4,0,5,0,0
9237,775087,25,5,7,5,7,0,0,2,2,2,3,2,4,1,2,1,12
9237,785296,32,4,13,1,3,3,10,3,4,3,8,5,2,1,0,0,14
9237,780212,37,9,17,6,9,3,8,1,1,0,4,4,1,0,2,0,22
9237,767245,22,6,10,6,10,0,0,1,1,1,4,0,4,0,3,0,13
9237,790985,2,0,0,0,0,0,0,0,0,1,0,0,0,0,0,0,0
9237,780215,7,2,3,2,3,0,0,0,0,0,1,1,2,0,0,0,4
9237,796597,2,1,2,0,0,1,2,0,0,0,0,0,0,0,0,0,3
9237,796596,2,0,1,0,0,0,1,0,0,0,0,1,0,0,0,0,0
9237,790984,28,0,5,0,1,0,4,0,0,1,0,0,3,0,1,0,0
9237,791168,2,0,1,0,0,0,1,0,0,0,0,0,0,0,0,0,0
9237,785297,25,1,7,1,3,0,4,0,0,1,3,2,0,0,0,0,2
9237,780214,2,0,0,0,0,0,0,0,0,0,0,0,0,0,0,0,0
9238,792299,31,0,2,0,0,0,2,1,2,1,6,3,4,0,2,1,1
9238,786181,12,2,5,2,4,0,1,0,0,1,1,0,3,1,2,2,4
9238,792304,34,7,16,4,11,3,5,2,2,1,2,3,1,6,1,0,19
9238,792301,35,7,16,7,14,0,2,3,3,0,0,2,2,1,0,0,17
9238,786275,34,5,6,4,5,1,1,2,2,0,3,2,3,2,1,0,13
9238,798089,9,0,1,0,1,0,0,0,0,0,1,0,0,0,0,0,0
9238,792302,2,0,1,0,1,0,0,0,0,0,0,0,1,0,0,1,0
9238,792295,17,1,2,1,1,0,1,0,0,0,1,0,1,0,2,3,2
9238,786278,26,5,9,3,4,2,5,0,0,0,2,0,1,0,1,1,12
9239,791760,18,3,6,2,5,1,1,4,4,3,5,2,2,0,1,0,11
9239,780256,28,4,10,2,6,2,4,0,0,2,2,0,1,1,5,0,10
9239,796879,17,1,4,0,3,1,1,2,2,0,1,4,2,0,2,0,5
9239,796880,31,1,8,0,3,1,5,2,2,2,2,2,2,0,2,0,5
9239,791334,32,6,9,2,2,4,7,1,1,0,7,3,2,0,3,0,17
9239,791757,13,0,2,0,0,0,2,0,0,0,1,2,0,2,1,0,0
9239,785874,20,6,9,6,8,0,1,0,0,2,4,1,1,0,0,0,12
9239,796885,1,0,1,0,1,0,0,0,0,0,0,0,0,0,0,0,0
9239,796883,23,2,4,1,3,1,1,0,0,0,0,4,4,0,4,0,5
9239,781590,17,3,6,1,3,2,3,0,0,2,4,0,1,1,1,1,8
9240,780461,39,6,13,5,9,1,4,4,4,1,6,6,5,1,3,0,17
9240,791497,38,5,16,2,8,3,8,2,4,2,11,2,1,1,6,1,15
9240,781486,33,7,16,6,12,1,4,0,0,2,1,3,4,1,4,0,15
9240,774812,37,5,12,5,11,0,1,2,4,5,3,1,2,2,0,0,12
9240,797180,36,3,8,2,2,1,6,0,0,0,6,1,2,1,0,1,7
9240,791503,10,1,3,1,3,0,0,0,0,0,3,0,1,0,0,0,2
9240,776379,18,0,2,0,0,0,2,0,0,0,1,0,3,0,0,0,0
9240,791498,6,0,1,0,1,0,0,0,0,0,1,0,0,0,0,1,0
9240,791500,5,0,0,0,0,0,0,0,0,0,0,0,0,0,0,0,0
9240,780240,3,0,1,0,1,0,0,0,0,0,0,0,0,0,1,0,0
9241,781530,35,6,14,6,14,0,0,6,6,2,4,1,0,0,1,1,18
9241,776423,28,5,9,5,9,0,0,1,3,4,5,0,4,2,3,3,11
9241,798096,28,2,12,2,10,0,2,0,0,0,2,0,1,2,3,0,4
9241,792307,25,1,2,1,1,0,1,0,1,0,3,1,1,0,0,0,2
9241,792319,18,0,0,0,0,0,0,0,0,1,2,0,1,1,2,0,0
9241,798104,28,6,17,4,12,2,5,4,6,0,1,5,1,1,2,0,18
9241,786296,15,3,4,2,3,1,1,2,2,1,6,1,1,0,0,0,9
9241,798106,19,1,4,1,3,0,1,3,4,1,3,1,2,1,0,0,5
9241,792314,20,2,5,2,5,0,0,0,0,2,4,0,1,0,1,1,4
9241,792320,5,0,0,0,0,0,0,0,0,0,0,0,0,0,1,0,0
9241,792309,2,0,1,0,1,0,0,0,0,0,0,0,0,0,0,0,0
9241,792321,2,0,0,0,0,0,0,0,0,0,0,0,1,0,0,0,0
9242,776100,28,2,3,2,3,0,0,1,4,1,4,0,2,1,1,1,5
9242,785991,34,8,11,8,10,0,1,7,8,4,11,0,3,0,3,2,23
9242,792133,36,4,10,1,3,3,7,1,1,0,3,2,1,1,2,0,12
9242,797762,34,3,9,3,8,0,1,3,4,0,2,5,3,0,1,1,9
9242,781406,33,3,11,2,6,1,5,5,5,0,3,5,1,3,1,0,12
9242,781401,15,1,5,0,4,1,1,3,6,1,2,0,5,1,0,0,6
9242,781029,13,0,3,0,0,0,3,2,3,0,1,2,1,1,3,0,2
9242,775317,7,0,1,0,0,0,1,0,0,0,0,0,1,0,1,0,0
9243,786542,19,2,6,2,5,0,1,0,0,1,1,1,2,0,0,0,4
9243,786540,17,1,5,1,5,0,0,2,2,3,4,0,5,3,1,1,4
9243,792019,24,3,7,0,0,3,7,0,1,0,1,0,3,0,1,1,9
9243,792015,29,9,16,6,13,3,3,4,4,1,3,1,3,1,4,0,25
9243,775995,37,3,8,3,8,0,0,2,5,0,4,0,3,1,2,0,8
9243,785364,23,3,4,3,4,0,0,0,2,1,4,0,3,1,1,3,6
9243,797515,1,0,0,0,0,0,0,0,0,0,0,0,0,0,0,0,0
9243,792016,18,3,7,2,5,1,2,2,2,0,1,2,2,1,1,0,9
9243,791845,32,2,4,2,3,0,1,2,4,0,7,2,1,2,0,1,6
9244,800005,25,3,9,3,9,0,0,0,0,2,1,0,2,0,0,0,6
9244,800091,34,6,11,6,11,0,0,2,4,1,4,0,3,1,5,1,14
9244,799129,38,6,9,3,5,3,4,0,0,0,3,4,3,3,2,1,15
9244,799134,27,2,4,1,1,1,3,0,5,0,3,3,4,1,0,0,5
9244,792634,36,5,12,1,4,4,8,2,5,1,0,7,1,2,0,0,16
9244,799135,2,0,0,0,0,0,0,0,0,0,0,0,0,0,0,0,0
9244,799132,11,0,6,0,4,0,2,0,0,1,4,0,1,0,0,0,0
9244,799130,19,1,4,0,0,1,4,0,0,0,2,1,3,0,0,0,3
9244,799133,8,0,2,0,1,0,1,0,0,0,0,0,0,0,0,0,0
9245,792418,27,5,9,5,9,0,0,0,0,0,3,1,3,0,0,0,10
9245,782654,23,4,13,4,11,0,2,4,5,5,0,3,3,0,1,1,12
9245,796693,28,3,6,1,3,2,3,0,0,1,5,2,3,1,3,0,8
9245,796691,25,3,5,0,1,3,4,0,0,0,3,1,0,0,0,0,9
9245,789484,36,8,9,7,7,1,2,7,11,2,12,1,3,0,2,0,24
9245,796695,2,0,0,0,0,0,0,0,0,0,0,0,1,0,1,0,0
9245,796692,2,0,0,0,0,0,0,0,2,0,0,0,0,0,0,0,0
9245,792424,7,0,2,0,2,0,0,0,0,1,0,1,1,1,0,0,0
9245,792419,2,0,0,0,0,0,0,0,0,0,1,0,0,0,0,0,0
9245,800100,2,0,0,0,0,0,0,0,0,0,0,0,0,0,0,0,0
9245,792421,10,1,3,1,1,0,2,0,0,0,2,0,0,0,0,0,2
9245,792422,31,8,13,8,13,0,0,1,2,2,4,1,3,2,1,0,17
9245,792423,5,0,0,0,0,0,0,0,0,0,1,0,0,0,0,1,0
9245,796694,0,0,0,0,0,0,0,0,0,0,0,0,0,0,0,0,0
9246,780913,28,8,12,5,8,3,4,0,0,1,3,1,4,2,1,1,19
9246,798124,32,4,9,4,8,0,1,2,4,1,3,2,3,1,0,1,10
9246,798117,37,2,5,1,2,1,3,0,2,1,4,14,1,4,2,1,5
9246,780594,37,8,15,4,5,4,10,1,4,0,2,2,3,2,2,0,21
9246,775664,37,6,11,0,1,6,10,1,2,3,6,5,0,2,1,1,19
9246,798123,14,4,7,4,7,0,0,1,4,1,2,0,5,0,2,0,9
9246,798121,15,2,6,0,1,2,5,0,0,0,0,0,0,2,2,0,6
9247,785829,3,0,1,0,1,0,0,0,0,0,0,0,3,0,1,0,0
9247,775838,36,5,9,5,8,0,1,6,8,2,9,3,2,0,3,0,16
9247,796729,31,6,10,3,4,3,6,0,1,0,3,3,0,1,3,0,15
9247,791048,37,4,11,3,8,1,3,3,4,2,10,4,3,1,5,0,12
9247,786531,40,7,15,5,8,2,7,5,6,0,1,2,1,0,2,0,21
9247,791044,30,6,12,6,12,0,0,2,2,4,4,1,5,0,2,0,14
9247,780723,4,1,2,1,1,0,1,0,0,1,0,1,0,0,1,0,2
9247,796727,19,2,3,1,1,1,2,0,0,0,3,0,1,2,0,0,5
9248,790899,18,1,4,1,4,0,0,0,4,1,2,0,2,0,2,0,2
9248,785442,26,2,8,1,4,1,4,0,0,2,2,1,5,1,1,0,5
9248,799907,24,3,8,1,4,2,4,0,0,1,2,4,0,1,2,0,8
9248,785579,36,5,9,4,5,1,4,4,5,1,0,1,1,0,2,0,15
9248,781628,27,7,9,6,8,1,1,3,4,1,1,3,4,4,4,0,18
9248,775959,11,2,4,1,2,1,2,0,0,0,2,0,1,1,1,0,5
9248,790897,33,3,10,2,5,1,5,1,1,0,5,0,1,0,2,0,8
9248,796446,18,1,2,1,2,0,0,0,0,1,1,0,1,2,0,0,2
9248,775737,7,0,0,0,0,0,0,0,0,0,0,0,0,0,1,0,0
9249,785355,16,0,1,0,0,0,1,1,2,0,1,0,0,0,1,0,1
9249,781462,33,7,12,7,12,0,0,3,5,1,3,3,3,1,4,0,17
9249,780876,27,6,11,5,8,1,3,1,2,0,6,1,4,3,2,0,14
9249,785353,34,8,10,6,7,2,3,2,3,0,5,2,4,0,1,1,20
9249,781457,37,4,7,3,4,1,3,2,2,1,3,5,0,4,3,0,11
9249,791305,9,2,2,2,2,0,0,2,2,1,4,0,2,0,0,1,6
9249,790895,16,1,5,1,5,0,0,2,2,1,0,2,0,0,0,0,4
9249,781673,28,1,4,1,1,0,3,0,0,0,1,0,2,0,1,0,2
9250,782133,16,1,7,1,3,0,4,0,0,2,1,0,3,1,4,0,2
9250,785123,28,3,9,3,8,0,1,7,10,3,7,1,2,2,0,1,13
9250,790990,35,1,10,1,4,0,6,2,2,4,1,3,3,1,1,0,4
9250,789219,31,8,11,2,2,6,9,2,2,0,1,0,2,2,1,0,24
9250,785059,35,5,7,4,5,1,2,3,5,0,6,12,2,3,2,0,14
9250,790989,1,0,0,0,0,0,0,0,0,0,0,0,0,0,0,0,0
9250,785305,7,1,1,1,1,0,0,1,1,1,0,0,2,0,0,0,3
9250,796622,11,2,3,2,3,0,0,0,0,0,1,0,2,0,1,2,4
9250,796623,18,0,5,0,1,0,4,0,0,0,2,1,1,1,1,0,0
9250,785122,18,2,4,0,1,2,3,2,4,1,3,0,1,1,1,0,8
9251,791352,32,3,9,1,4,2,5,2,3,4,7,1,2,0,0,2,10
9251,780455,9,1,4,1,4,0,0,0,1,0,2,0,5,0,1,2,2
9251,797251,22,1,2,0,0,1,2,0,0,1,1,0,2,0,2,1,3
9251,797247,40,4,8,4,7,0,1,3,4,2,4,4,3,4,3,0,11
9251,776297,37,4,17,2,5,2,12,3,4,0,4,1,0,1,5,0,13
9251,797250,0,0,0,0,0,0,0,0,0,0,0,0,0,1,0,0,0
9251,791354,9,1,3,1,2,0,1,0,0,1,0,1,0,0,1,0,2
9251,785837,21,8,11,7,9,1,2,3,4,2,4,0,3,1,2,1,20
9251,786227,10,1,1,1,1,0,0,0,1,2,2,0,2,0,0,1,2
9251,797248,20,2,4,1,1,1,3,1,1,1,1,2,3,0,1,0,6
9251,797255,0,0,0,0,0,0,0,0,0,0,0,0,0,0,0,0,0
9252,790870,34,4,11,4,11,0,0,3,4,2,4,2,3,1,4,2,11
9252,790869,38,11,21,9,16,2,5,5,6,0,12,0,2,0,2,0,29
9252,780116,36,3,9,1,6,2,3,0,1,2,3,1,2,0,0,1,8
9252,796421,38,0,6,0,5,0,1,2,2,2,6,6,3,0,2,0,2
9252,790866,33,3,7,2,2,1,5,0,0,0,5,2,2,1,2,0,7
9252,796426,1,0,0,0,0,0,0,0,0,0,0,0,0,0,0,0,0
9252,780493,19,3,5,0,0,3,5,0,0,0,4,0,2,0,1,1,9
9252,796427,1,0,0,0,0,0,0,0,0,0,0,0,0,0,0,0,0
9253,792373,30,5,12,5,11,0,1,2,2,1,4,0,1,1,3,2,12
9253,781598,9,0,4,0,1,0,3,2,2,0,1,1,3,1,0,0,2
9253,792370,39,3,12,2,5,1,7,3,4,2,5,3,2,0,0,1,10
9253,797951,30,6,16,2,6,4,10,1,1,3,5,1,2,1,1,0,17
9253,775303,31,1,3,0,0,1,3,1,4,1,6,1,2,1,0,0,4
9253,797958,12,0,1,0,1,0,0,0,0,1,3,0,1,0,2,0,0
9253,790499,14,2,5,2,3,0,2,1,2,1,2,0,0,2,0,0,5
9253,786739,18,0,4,0,2,0,2,2,2,0,0,2,1,1,0,0,2
9253,776491,17,1,8,1,8,0,0,1,2,0,3,3,2,1,1,0,3
9254,776279,26,4,6,2,3,2,3,0,0,0,3,1,5,1,3,1,10
9254,781505,35,6,15,3,6,3,9,1,2,1,5,2,3,2,1,1,16
9254,780353,31,4,9,4,9,0,0,0,0,0,6,1,2,0,1,2,8
9254,791317,37,3,11,2,6,1,5,0,0,0,2,9,1,3,0,0,7
9254,777573,31,4,12,3,8,1,4,1,1,0,1,0,2,1,1,0,10
9254,786222,14,0,1,0,1,0,0,0,0,1,1,0,1,0,0,1,0
9254,785966,0,0,0,0,0,0,0,0,0,0,0,0,1,0,0,0,0
9254,796646,5,0,1,0,0,0,1,0,0,0,0,1,0,0,1,0,0
9254,796649,11,0,2,0,1,0,1,0,0,0,2,0,0,0,3,0,0
9254,790851,10,2,2,2,2,0,0,0,0,3,4,0,1,1,2,1,4
9255,781454,34,8,15,6,11,2,4,2,4,2,2,0,3,3,1,0,20
9255,786424,33,4,10,3,9,1,1,0,0,3,12,2,0,0,5,2,9
9255,792366,29,3,16,3,16,0,0,0,4,3,4,1,2,1,1,0,6
9255,791015,29,0,1,0,0,0,1,3,4,0,1,3,0,2,2,0,3
9255,785483,29,7,12,6,11,1,1,1,2,0,3,2,3,0,2,0,16
9255,785959,13,0,2,0,2,0,0,0,0,1,3,0,0,0,0,1,0
9255,797988,4,1,2,1,2,0,0,0,0,1,0,1,0,0,1,0,2
9255,797979,25,1,1,0,0,1,1,0,0,3,4,0,2,0,1,1,3
9255,775335,4,0,1,0,0,0,1,0,0,0,0,0,0,0,0,0,0
9256,787239,15,0,0,0,0,0,0,0,0,0,1,0,3,0,0,4,0
9256,789058,35,3,9,0,2,3,7,1,2,0,8,2,5,3,0,1,10
9256,797898,24,7,17,6,13,1,4,4,5,1,3,3,4,3,7,1,19
9256,792236,21,4,8,4,8,0,0,0,1,2,2,3,1,2,1,0,8
9256,781374,30,4,12,2,8,2,4,11,12,0,2,1,5,1,1,0,21
9256,797895,4,0,0,0,0,0,0,0,0,0,0,0,0,0,1,0,0
9256,792238,7,0,0,0,0,0,0,0,0,0,0,0,1,0,0,0,0
9256,785818,3,0,0,0,0,0,0,0,0,0,0,0,0,0,0,0,0
9256,785286,23,2,8,1,3,1,5,6,7,0,2,0,1,1,0,0,11
9256,776337,11,2,2,2,2,0,0,0,0,2,4,0,1,0,0,1,4
9256,792240,5,2,2,1,1,1,1,0,0,1,0,0,2,0,0,0,5
9256,792237,22,3,10,1,6,2,4,0,0,0,1,1,0,0,1,0,8
9257,792265,39,4,11,2,5,2,6,0,3,2,8,0,1,1,1,0,10
9257,792266,27,4,13,2,9,2,4,7,8,6,4,2,2,0,6,0,17
9257,786152,22,4,7,4,7,0,0,1,5,1,6,0,5,0,1,1,9
9257,798003,35,8,11,8,10,0,1,10,12,1,4,9,3,4,3,0,26
9257,792267,37,6,10,0,1,6,9,2,2,0,7,1,4,1,3,1,20
9257,798007,17,2,4,2,3,0,1,1,1,0,0,0,3,0,1,0,5
9257,798006,8,0,0,0,0,0,0,0,0,0,1,0,1,0,0,0,0
9257,792263,15,1,4,1,3,0,1,2,2,0,2,0,2,0,0,0,4
9258,786358,40,4,9,2,4,2,5,0,0,0,0,1,2,0,1,0,10
9258,775418,32,5,6,5,6,0,0,7,7,1,5,0,0,0,2,1,17
9258,780306,39,9,11,9,11,0,0,6,8,3,11,4,2,0,1,0,24
9258,797116,31,3,4,2,2,1,2,3,4,0,1,1,3,1,2,0,10
9258,780312,32,2,7,1,3,1,4,2,2,0,2,1,3,2,4,1,7
9258,791535,11,1,1,1,1,0,0,0,0,1,1,0,0,0,1,0,2
9258,775846,15,0,2,0,1,0,1,0,0,1,2,0,1,1,2,0,0
9259,791750,40,4,13,1,1,3,12,0,0,1,1,1,5,0,0,0,11
9259,786177,38,6,8,0,0,6,8,1,1,1,1,2,2,0,0,0,19
9259,780244,1,1,1,1,1,0,0,0,0,0,0,0,0,0,0,0,2
9259,786179,29,3,8,1,2,2,6,0,0,0,2,1,2,1,3,0,8
9259,780238,37,6,13,6,11,0,2,0,0,0,6,7,2,2,1,0,12
9259,791752,12,0,2,0,2,0,0,0,2,1,0,0,2,0,0,0,0
9259,785909,13,2,4,2,4,0,0,0,0,2,0,0,3,0,1,0,4
9259,790773,22,2,5,0,0,2,5,0,0,0,1,0,1,0,0,1,6
9259,781500,8,2,2,2,2,0,0,0,2,0,0,1,0,3,1,0,4
9260,786550,32,5,19,3,10,2,9,2,2,3,4,2,3,3,2,0,14
9260,776054,26,6,10,5,5,1,5,0,0,1,8,1,4,2,1,0,13
9260,792007,31,4,8,4,5,0,3,1,1,2,1,1,1,1,3,0,9
9260,792009,34,7,12,5,7,2,5,0,0,1,2,6,4,2,2,0,16
9260,792006,40,6,12,6,12,0,0,2,2,2,4,4,1,0,2,0,14
9260,792008,13,0,0,0,0,0,0,0,0,0,1,0,1,0,1,1,0
9260,786552,24,4,5,2,2,2,3,0,0,0,2,0,2,0,2,0,10
9261,786203,36,4,8,2,4,2,4,1,1,0,3,1,1,2,4,0,11
9261,786197,27,6,10,6,9,0,1,2,3,2,4,1,4,0,2,1,14
9261,780717,31,10,13,9,10,1,3,3,3,1,4,2,0,1,3,0,24
9261,791742,36,4,10,3,6,1,4,2,5,0,6,4,2,1,2,0,11
9261,776266,29,4,8,4,8,0,0,0,0,0,1,1,3,2,0,0,8
9261,776328,12,1,2,0,1,1,1,2,2,0,2,1,0,0,0,0,5
9261,791738,10,0,2,0,2,0,0,0,0,1,2,2,0,0,0,0,0
9261,791741,19,2,3,0,0,2,3,2,2,0,2,0,1,0,0,0,8
9262,775897,26,4,6,3,4,1,2,0,0,1,3,0,1,1,0,0,9
9262,780324,21,3,8,3,8,0,0,2,3,1,5,3,1,2,2,1,8
9262,791543,19,2,6,0,2,2,4,0,0,0,1,1,3,0,0,0,6
9262,786530,28,3,6,2,3,1,3,4,4,0,5,9,1,0,1,1,11
9262,780317,27,4,9,1,2,3,7,0,0,0,4,1,2,1,1,0,11
9262,791546,4,0,0,0,0,0,0,0,0,0,2,0,0,0,0,0,0
9262,797092,15,5,7,3,5,2,2,1,3,2,1,1,1,0,2,0,13
9262,797091,6,2,3,2,3,0,0,0,0,0,0,0,1,1,1,0,4
9262,791547,6,1,4,0,3,1,1,0,0,0,1,0,0,0,0,0,3
9262,791545,16,1,5,1,4,0,1,0,0,3,2,1,1,4,1,0,2
9262,786360,10,0,1,0,0,0,1,0,0,0,1,0,0,0,2,0,0
9262,784246,19,2,2,2,2,0,0,2,2,2,3,3,0,0,2,0,6
9262,775437,2,0,0,0,0,0,0,0,0,0,0,0,0,0,0,0,0
9262,785932,1,0,0,0,0,0,0,0,0,0,0,0,0,0,0,0,0
9263,784640,27,7,11,5,7,2,4,2,2,0,5,0,3,2,3,2,18
9263,797655,27,1,5,1,5,0,0,0,2,0,5,1,2,0,1,0,2
9263,797657,39,2,9,2,4,0,5,2,2,0,1,1,1,1,0,0,6
9263,797652,37,4,9,3,7,1,2,3,4,2,4,3,3,3,4,0,12
9263,792072,39,2,7,2,3,0,4,0,0,0,4,0,1,1,2,0,4
9263,786025,4,2,2,2,2,0,0,0,0,0,2,0,2,0,0,1,4
9263,797654,1,0,1,0,0,0,1,0,0,0,0,0,0,0,0,0,0
9263,785572,20,1,4,0,2,1,2,0,0,0,2,0,3,1,3,0,3
9263,774844,5,0,0,0,0,0,0,0,0,0,0,1,0,1,0,0,0
9263,797653,1,0,0,0,0,0,0,0,0,0,0,0,0,0,0,0,0
9264,780650,40,8,19,7,17,1,2,1,1,5,9,4,1,0,2,0,18
9264,791810,38,5,11,3,6,2,5,5,7,0,5,5,0,1,4,0,17
9264,791815,36,7,15,7,12,0,3,11,13,1,5,1,1,1,2,1,25
9264,780651,30,4,8,4,8,0,0,0,0,2,9,4,4,1,0,1,8
9264,791809,11,0,0,0,0,0,0,0,0,0,0,0,3,0,0,0,0
9264,781596,11,2,2,2,2,0,0,5,6,2,0,0,5,0,4,1,9
9264,786645,27,4,5,3,4,1,1,0,0,3,2,1,4,0,0,0,9
9264,791812,5,0,1,0,1,0,0,0,0,0,0,0,0,0,0,0,0
9264,791814,2,0,0,0,0,0,0,0,0,0,0,0,0,0,1,0,0
9265,797025,32,4,9,4,7,0,2,3,3,0,3,0,4,2,3,2,11
9265,792116,29,1,9,0,4,1,5,1,2,0,1,3,4,2,2,0,4
9265,780410,35,2,6,0,1,2,5,2,4,0,1,0,3,0,0,0,8
9265,797028,17,2,5,2,4,0,1,2,2,1,1,0,5,0,0,0,6
9265,797024,0,0,0,0,0,0,0,0,0,0,0,0,0,0,0,0,0
9265,791598,37,10,16,8,13,2,3,8,8,0,6,1,2,3,2,1,30
9265,791597,6,0,0,0,0,0,0,0,0,0,0,0,1,0,0,0,0
9265,797026,2,0,0,0,0,0,0,0,0,0,0,0,0,0,0,0,0
9265,797027,23,4,5,3,3,1,2,0,2,1,3,1,3,0,0,1,9
9265,775047,2,0,0,0,0,0,0,0,0,0,1,0,0,1,0,0,0
9265,797029,0,0,0,0,0,0,0,0,0,0,0,0,0,0,0,0,0
9265,791600,13,1,5,1,2,0,3,0,0,1,3,2,0,0,1,0,2
9265,785687,4,0,0,0,0,0,0,2,2,0,0,0,1,0,0,0,2
9266,784268,28,6,9,6,7,0,2,4,5,0,0,1,1,0,1,0,16
9266,780223,35,3,7,1,2,2,5,0,0,1,4,4,3,1,1,0,8
9266,786318,38,5,14,3,7,2,7,1,1,0,5,9,1,1,4,1,13
9266,791482,33,4,6,3,4,1,2,0,0,1,2,2,1,1,1,0,9
9266,786319,18,6,8,6,8,0,0,1,1,5,5,2,4,0,0,0,13
9266,797199,15,1,2,0,0,1,2,0,0,0,3,3,1,1,1,0,3
9266,780225,21,4,6,3,4,1,2,0,0,0,0,0,1,0,1,0,9
9266,791481,12,3,4,3,4,0,0,0,0,0,1,0,2,0,1,1,6
9267,780974,36,6,11,2,5,4,6,4,4,2,3,1,0,0,0,0,20
9267,791372,36,5,12,1,2,4,10,2,2,0,0,1,1,4,2,0,16
9267,792167,20,1,4,1,4,0,0,5,7,1,4,0,3,0,1,1,7
9267,792164,29,3,10,3,7,0,3,0,0,2,2,1,0,1,3,0,6
9267,797767,35,3,4,3,4,0,0,0,0,1,3,5,3,1,5,0,6
9267,792163,21,2,5,1,2,1,3,0,0,1,2,1,1,1,0,0,5
9267,797766,12,1,2,1,1,0,1,2,2,0,3,1,0,0,0,0,4
9267,797777,6,0,0,0,0,0,0,0,0,0,0,0,0,0,1,0,0
9267,797772,5,0,3,0,1,0,2,0,0,0,0,0,1,0,1,0,0
9268,791391,38,5,8,5,8,0,0,0,0,2,4,0,2,1,0,1,10
9268,797156,29,1,5,1,3,0,2,0,2,0,0,1,1,1,0,0,2
9268,791390,37,3,9,3,8,0,1,2,2,0,9,5,2,2,3,1,8
9268,775743,23,2,4,1,1,1,3,1,4,0,1,0,0,0,0,0,6
9268,780130,34,5,14,4,12,1,2,8,9,2,7,2,2,2,3,0,19
9268,797158,1,0,0,0,0,0,0,0,0,1,0,0,1,0,0,0,0
9268,791388,4,1,1,1,1,0,0,0,0,0,0,0,0,0,1,0,2
9268,776446,4,0,1,0,1,0,0,0,0,0,0,0,0,0,0,0,0
9268,780133,23,2,5,0,1,2,4,0,0,1,3,0,1,0,1,0,6
9268,780407,7,0,0,0,0,0,0,0,0,0,0,0,1,0,0,0,0
9269,781249,38,4,10,2,3,2,7,0,0,0,5,0,3,0,2,0,10
9269,775165,35,0,3,0,1,0,2,0,0,1,6,0,2,3,0,0,0
9269,785514,34,2,11,2,8,0,3,2,2,5,4,2,3,0,1,0,6
9269,785515,35,4,14,4,11,0,3,0,2,1,6,4,3,2,6,0,8
9269,781253,38,4,7,2,5,2,2,0,0,0,2,0,3,0,1,0,10
9269,796953,8,1,1,1,1,0,0,3,3,0,0,1,0,0,0,0,5
9269,791251,12,2,3,2,3,0,0,0,0,0,0,0,1,0,0,0,4
9270,792378,31,4,6,4,6,0,0,2,4,0,5,1,2,0,1,3,10
9270,786746,17,0,3,0,2,0,1,0,0,0,2,2,0,2,1,0,0
9270,780178,14,2,3,2,3,0,0,0,0,0,1,0,4,1,1,0,4
9270,792376,37,11,18,8,11,3,7,5,8,1,9,3,3,3,2,0,30
9270,797883,39,3,8,2,5,1,3,3,4,0,0,2,3,2,3,0,10
9270,797890,21,3,4,2,2,1,2,0,0,0,1,1,4,2,2,0,7
9270,797888,4,0,0,0,0,0,0,0,0,0,0,0,0,0,2,0,0
9270,775075,19,3,5,3,5,0,0,2,2,2,0,1,2,2,0,3,8
9270,785744,8,0,2,0,2,0,0,0,0,0,2,0,3,0,1,0,0
9270,797885,10,1,2,1,1,0,1,2,2,0,1,0,1,0,1,0,4
9271,796846,13,2,4,2,3,0,1,2,2,2,3,0,3,0,0,0,6
9271,775833,22,4,6,4,6,0,0,2,4,4,6,0,2,1,2,1,10
9271,781036,38,7,15,3,8,4,7,3,5,0,1,2,3,1,4,0,21
9271,775571,27,2,7,1,3,1,4,1,2,0,2,1,4,0,4,0,6
9271,774894,32,2,10,0,5,2,5,4,6,1,5,2,0,3,5,0,10
9271,799906,24,1,4,0,0,1,4,0,0,0,6,2,4,0,2,0,3
9271,796847,21,2,4,2,3,0,1,2,2,0,0,1,2,1,1,0,6
9271,796845,17,2,4,0,0,2,4,0,0,0,1,0,0,1,0,1,6
9271,785439,6,0,0,0,0,0,0,0,0,0,0,1,0,0,0,0,0
9272,780377,33,0,8,0,5,0,3,0,0,1,3,2,2,1,2,0,0
9272,791852,29,5,6,5,6,0,0,3,4,2,5,0,1,0,1,4,13
9272,797460,27,1,5,0,1,1,4,2,3,0,1,2,2,4,3,0,5
9272,797461,31,4,10,2,5,2,5,8,9,1,4,2,3,0,1,2,18
9272,786601,24,2,8,0,2,2,6,1,2,1,4,4,4,3,2,0,7
9272,791851,31,5,8,2,4,3,4,0,0,2,4,5,1,0,4,1,13
9272,791853,10,2,4,2,4,0,0,0,0,2,1,0,2,0,2,0,4
9272,797459,12,2,4,2,4,0,0,0,0,0,0,0,0,2,3,0,4
9272,786599,3,0,0,0,0,0,0,0,0,0,0,0,0,0,0,0,0
9273,792128,28,3,8,3,8,0,0,1,2,2,10,0,2,1,2,1,7
9273,786838,25,6,10,6,9,0,1,3,4,3,4,1,2,3,4,3,15
9273,792132,34,2,5,1,1,1,4,4,4,1,1,8,1,3,7,1,9
9273,792127,33,4,14,1,6,3,8,2,2,2,1,3,1,1,2,1,13
9273,792126,32,4,9,1,2,3,7,0,0,3,1,2,4,3,0,0,11
9273,799273,11,0,0,0,0,0,0,0,0,0,2,0,0,0,0,0,0
9273,792131,12,1,2,1,1,0,1,0,0,0,3,0,4,0,1,1,2
9273,799908,4,0,0,0,0,0,0,0,0,0,0,0,0,0,2,0,0
9273,797739,15,3,8,2,6,1,2,2,2,1,0,0,1,1,1,0,9
9273,791668,6,0,1,0,1,0,0,0,0,0,1,0,0,0,0,0,0
9274,792249,29,6,8,5,6,1,2,5,6,1,5,2,2,1,1,0,18
9274,781430,26,8,15,7,11,1,4,2,3,4,9,5,5,2,3,1,19
9274,792248,37,5,13,2,5,3,8,4,4,0,4,3,4,0,0,1,17
9274,781445,36,4,8,3,3,1,5,2,2,2,3,0,3,0,5,0,11
9274,768845,28,6,11,3,6,3,5,3,4,0,4,0,4,1,1,0,18
9274,781448,22,0,1,0,1,0,0,4,6,0,3,2,2,0,1,0,4
9274,792250,18,3,5,0,0,3,5,4,4,1,2,0,3,0,1,0,13
9274,792251,4,0,0,0,0,0,0,0,0,0,0,0,1,0,0,0,0
9275,792140,33,6,9,6,9,0,0,2,3,4,6,1,3,1,3,1,14
9275,786596,24,1,6,1,4,0,2,0,0,1,3,1,5,1,3,0,2
9275,785976,30,5,13,3,4,2,9,3,4,0,0,1,3,1,0,0,15
9275,776092,32,8,15,5,9,3,6,10,14,0,5,5,3,2,3,0,29
9275,781429,36,3,10,1,1,2,9,2,3,0,4,0,2,1,0,0,10
9275,797791,7,1,1,1,1,0,0,0,0,0,3,0,3,0,0,0,2
9275,797786,24,4,8,1,2,3,6,1,2,1,1,3,3,0,0,0,12
9275,792144,14,1,3,1,1,0,2,0,0,0,0,1,2,0,0,0,2
9275,781431,0,0,0,0,0,0,0,0,0,0,0,0,0,0,0,0,0
9276,796568,14,0,3,0,3,0,0,0,0,0,1,0,1,0,0,1,0
9276,796566,31,5,7,5,7,0,0,0,3,3,15,1,4,2,2,0,10
9276,790969,30,3,8,2,5,1,3,2,2,1,0,4,2,0,3,0,9
9276,780166,28,6,16,6,15,0,1,2,3,0,5,4,4,0,1,0,14
9276,775107,27,2,7,2,5,0,2,2,3,1,1,0,2,0,0,0,6
9276,790971,9,1,2,1,2,0,0,0,0,2,2,0,0,0,0,0,2
9276,796569,4,0,1,0,1,0,0,0,0,0,2,1,0,0,0,0,0
9276,796563,20,0,2,0,1,0,1,2,2,0,0,0,1,1,1,1,2
9276,790968,10,1,1,0,0,1,1,0,0,0,0,0,0,0,1,0,3
9276,790967,27,5,10,1,2,4,8,2,2,0,2,0,2,1,0,0,16
9277,785664,17,2,4,2,4,0,0,0,2,0,4,0,2,0,1,0,4
9277,785841,30,4,8,4,7,0,1,1,3,2,8,2,2,0,1,0,9
9277,796611,27,3,9,2,7,1,2,0,0,4,6,0,0,1,0,0,7
9277,792869,31,5,11,5,7,0,4,2,2,2,1,3,4,0,1,1,12
9277,781504,38,3,6,3,5,0,1,3,3,0,2,1,3,1,4,3,9
9277,796613,19,3,6,1,1,2,5,0,0,0,0,0,4,0,1,0,8
9277,792232,8,0,3,0,2,0,1,0,0,0,4,0,1,0,0,0,0
9277,791312,7,1,2,1,2,0,0,0,0,1,0,0,0,0,0,0,2
9277,796609,17,1,8,1,5,0,3,2,5,1,3,1,2,2,1,0,4
9277,766623,6,1,3,1,2,0,1,1,2,0,2,0,0,0,0,0,3
9278,780378,35,8,10,8,10,0,0,4,7,2,3,1,3,0,1,2,20
9278,786374,32,6,14,5,11,1,3,0,2,1,5,1,4,3,0,1,13
9278,786253,31,5,8,4,7,1,1,2,2,0,4,5,3,1,5,0,13
9278,786404,32,4,6,4,6,0,0,2,3,1,4,1,3,0,0,0,10
9278,786378,16,1,4,0,0,1,4,0,0,1,0,1,5,0,2,0,3
9278,797065,16,0,4,0,1,0,3,5,5,1,2,2,1,0,0,0,5
9278,780121,16,1,5,0,0,1,5,0,0,0,0,0,1,0,0,0,3
9278,791562,14,0,2,0,0,0,2,0,2,0,2,1,2,0,1,0,0
9278,780382,5,0,0,0,0,0,0,0,0,1,0,0,0,0,0,0,0
9278,797061,3,0,0,0,0,0,0,0,0,0,1,0,0,0,0,0,0
9279,786620,36,9,15,4,5,5,10,10,10,0,7,5,1,3,1,0,33
9279,781257,36,4,10,2,6,2,4,4,4,1,5,1,3,1,2,0,14
9279,781606,39,4,9,2,5,2,4,2,2,0,1,6,1,1,1,0,12
9279,796956,18,4,5,4,5,0,0,0,1,3,0,1,1,0,0,1,8
9279,791838,24,1,4,1,1,0,3,1,1,0,3,0,4,0,1,0,3
9279,781263,25,2,7,0,2,2,5,3,4,1,2,1,3,0,1,0,9
9279,796955,12,2,4,2,4,0,0,0,1,0,1,0,5,0,1,0,4
9279,791256,8,1,1,1,1,0,0,0,0,0,1,0,1,1,0,0,2
9279,791255,1,0,0,0,0,0,0,0,0,0,0,0,0,0,0,0,0
9279,796029,1,0,0,0,0,0,0,0,0,0,0,0,0,0,0,0,0
9280,780445,8,0,1,0,0,0,1,0,0,1,4,0,0,0,1,0,0
9280,775585,36,8,11,8,11,0,0,5,8,1,3,0,4,0,1,3,21
9280,785365,14,0,3,0,1,0,2,0,0,0,1,0,2,0,0,0,0
9280,780982,40,2,13,2,7,0,6,2,4,2,6,1,2,1,3,1,6
9280,774980,39,9,12,5,5,4,7,5,5,0,6,5,2,2,1,0,27
9280,790821,36,5,12,4,9,1,3,6,7,2,5,4,2,2,1,2,17
9280,790822,27,3,11,1,6,2,5,1,2,0,1,5,2,1,0,0,9
9281,780218,27,3,6,3,6,0,0,9,9,2,3,1,3,0,1,0,15
9281,767736,21,3,11,1,6,2,5,3,4,0,8,2,3,0,1,1,11
9281,790772,39,4,16,2,6,2,10,0,0,1,3,2,2,0,3,0,10
9281,796328,32,2,6,2,6,0,0,2,4,3,4,0,2,0,0,0,6
9281,780022,33,6,10,6,8,0,2,1,1,0,4,8,2,1,2,0,13
9281,790771,28,4,7,2,3,2,4,0,0,1,2,0,5,1,2,6,10
9281,790774,18,4,6,1,1,3,5,0,0,2,4,0,0,0,2,0,11
9281,796329,2,0,0,0,0,0,0,0,0,0,0,0,0,0,0,0,0
9281,782637,0,0,0,0,0,0,0,0,0,0,0,0,0,0,0,0,0
9282,791787,28,9,18,9,16,0,2,2,2,0,6,3,3,0,2,0,20
9282,789048,32,3,6,3,6,0,0,3,4,3,7,1,4,2,2,1,9
9282,789046,35,8,11,3,4,5,7,5,7,0,6,0,4,0,2,3,26
9282,791786,31,3,5,2,3,1,2,4,4,0,4,3,4,2,0,0,11
9282,789041,26,5,8,3,6,2,2,4,4,0,2,6,1,1,2,0,16
9282,791785,12,2,4,2,2,0,2,0,0,0,0,1,0,1,0,1,4
9282,785540,8,0,0,0,0,0,0,0,0,0,2,0,0,0,0,0,0
9282,797631,3,0,1,0,1,0,0,0,0,0,1,0,0,0,0,0,0
9282,797630,22,3,7,0,2,3,5,1,3,1,1,3,3,2,0,1,10
9282,789044,3,0,1,0,0,0,1,0,0,0,1,1,1,0,0,0,0
9283,785294,31,7,12,5,10,2,2,1,4,2,5,0,4,0,2,0,17
9283,796514,24,0,3,0,1,0,2,0,0,0,1,4,2,0,4,0,0
9283,791085,37,7,15,5,7,2,8,3,3,0,2,3,4,0,2,0,19
9283,791080,30,3,7,3,7,0,0,4,6,1,6,2,3,1,3,0,10
9283,785675,31,6,11,4,5,2,6,2,6,0,5,2,2,2,2,0,16
9283,796511,17,2,3,1,2,1,1,4,5,1,6,1,2,2,2,0,9
9283,791083,20,4,9,4,5,0,4,0,0,1,2,0,1,0,0,4,8
9283,796512,10,0,0,0,0,0,0,2,3,0,0,1,1,0,0,0,2
9284,797281,17,3,5,3,5,0,0,2,3,2,9,3,4,0,3,0,8
9284,791648,19,4,6,2,4,2,2,1,4,1,8,0,4,1,1,0,11
9284,785694,17,2,2,2,2,0,0,4,4,1,2,0,4,0,0,1,8
9284,797280,19,2,6,2,4,0,2,1,4,0,0,2,1,0,0,1,5
9284,797279,25,1,5,1,2,0,3,2,2,0,3,3,1,0,3,0,4
9284,791647,13,3,4,3,4,0,0,1,1,1,0,1,1,2,0,0,7
9284,797278,13,3,7,3,5,0,2,1,3,2,3,0,3,1,0,2,7
9284,791649,22,4,10,0,2,4,8,0,0,1,1,0,1,0,0,0,12
9284,786640,22,5,7,5,6,0,1,3,3,1,0,7,1,1,1,0,13
9284,785697,24,4,8,2,3,2,5,4,5,2,3,2,1,0,0,1,14
9284,785695,9,1,2,0,1,1,1,0,0,0,1,0,0,0,0,0,3
9286,775455,29,7,13,7,13,0,0,0,2,2,9,3,1,0,4,0,14
9286,792124,28,3,6,3,6,0,0,6,8,3,4,0,2,0,2,1,12
9286,792120,35,2,5,1,1,1,4,0,1,0,7,5,3,2,2,0,5
9286,786002,28,1,7,0,1,1,6,0,0,0,1,2,4,1,0,0,3
9286,781397,17,1,3,1,2,0,1,0,0,1,2,3,1,0,1,0,2
9286,797754,1,0,0,0,0,0,0,0,0,0,1,0,0,0,1,0,0
9286,786009,22,4,6,4,6,0,0,0,0,1,5,0,1,0,0,0,8
9286,797749,21,6,9,1,2,5,7,0,0,1,0,1,2,0,1,0,17
9286,797747,2,0,1,0,1,0,0,0,0,0,1,0,2,0,2,1,0
9286,786005,17,1,2,1,1,0,1,0,0,0,0,0,1,0,1,0,2
9287,776209,31,6,10,5,7,1,3,0,1,3,8,1,2,1,1,0,13
9287,796938,37,5,13,3,8,2,5,2,3,0,0,3,3,2,1,0,14
9287,791240,31,2,7,2,7,0,0,0,0,1,1,2,1,2,1,0,4
9287,791237,29,7,13,4,7,3,6,3,5,1,3,0,2,2,1,1,20
9287,791238,35,4,11,2,6,2,5,1,3,0,4,1,4,0,1,0,11
9287,788124,20,1,2,1,2,0,0,0,0,1,2,0,4,1,1,2,2
9287,774875,6,0,0,0,0,0,0,0,0,0,0,0,0,0,0,0,0
9287,791236,11,0,2,0,1,0,1,0,0,1,1,1,0,1,0,0,0
9288,796838,34,4,6,4,6,0,0,3,4,4,3,0,2,1,2,1,11
9288,796837,32,6,11,3,6,3,5,2,3,2,11,0,3,1,1,0,17
9288,796834,32,2,5,1,2,1,3,3,4,0,6,2,0,2,1,0,8
9288,785700,33,3,12,1,8,2,4,0,0,2,2,2,4,0,0,0,8
9288,780269,39,9,20,9,16,0,4,1,2,1,1,6,3,0,4,0,19
9288,791171,2,1,3,1,3,0,0,1,2,1,0,0,1,1,0,0,3
9288,780194,6,0,3,0,3,0,0,0,0,0,0,0,0,1,0,0,0
9288,796833,11,0,2,0,0,0,2,0,0,0,0,0,1,0,1,0,0
9288,785706,11,1,1,1,1,0,0,0,0,0,2,0,0,0,1,1,2
9289,785152,30,2,5,2,4,0,1,3,5,1,4,1,2,0,3,0,7
9289,775821,25,6,11,5,7,1,4,0,0,2,6,1,0,1,1,1,13
9289,792453,32,6,12,4,8,2,4,3,3,0,2,7,0,0,1,0,17
9289,785131,26,4,7,0,0,4,7,2,2,0,4,0,4,0,3,0,14
9289,781538,25,3,8,1,2,2,6,0,0,1,4,3,2,2,1,0,8
9289,798113,14,0,1,0,0,0,1,1,2,0,4,2,2,0,2,0,1
9289,798115,17,2,4,0,0,2,4,0,0,0,3,0,3,0,2,0,6
9289,792324,9,1,1,1,1,0,0,0,0,2,2,0,0,0,1,0,2
9289,776233,22,1,6,0,3,1,3,1,2,0,0,1,1,0,0,0,4
9290,775515,31,6,12,3,4,3,8,0,1,1,7,1,5,1,1,5,15
9290,791575,9,2,3,2,2,0,1,0,0,0,1,0,1,0,3,0,4
9290,791579,36,7,12,4,6,3,6,0,0,0,8,3,0,1,2,0,17
9290,786387,40,8,18,7,15,1,3,2,2,5,4,2,1,0,0,0,19
9290,780399,26,0,1,0,0,0,1,0,0,0,1,4,1,2,0,0,0
9290,797047,18,1,4,1,2,0,2,2,2,0,2,1,1,1,0,0,4
9290,786846,22,4,8,4,5,0,3,0,0,0,4,2,1,1,2,3,8
9290,797046,18,3,5,1,3,2,2,0,0,0,0,1,2,0,2,0,8
9291,791115,21,6,6,6,6,0,0,2,2,2,1,0,3,0,0,0,14
9291,791118,31,5,16,4,10,1,6,1,2,0,4,2,0,3,1,1,12
9291,785947,10,1,2,1,1,0,1,0,0,0,0,1,0,0,0,0,2
9291,785676,31,1,6,1,4,0,2,2,2,2,8,3,3,2,3,1,4
9291,774974,34,6,9,6,9,0,0,3,4,0,3,1,2,1,4,0,15
9291,796771,8,1,4,1,3,0,1,0,3,2,0,0,0,0,0,1,2
9291,796769,20,2,4,1,2,1,2,0,0,0,3,0,0,1,0,0,5
9291,791117,32,4,9,1,3,3,6,2,4,0,2,1,1,1,1,0,13
9291,791116,13,0,4,0,3,0,1,0,0,1,3,0,0,0,1,0,0
9292,791883,27,5,8,4,7,1,1,1,2,5,4,1,4,1,1,0,12
9292,781066,30,4,8,4,8,0,0,2,3,3,5,0,3,0,1,3,10
9292,797594,18,1,5,1,1,0,4,0,0,0,0,3,0,1,2,0,2
9292,791884,36,7,16,5,8,2,8,0,0,0,2,5,3,0,3,0,16
9292,780695,34,3,12,2,6,1,6,0,0,2,3,0,2,0,0,0,7
9292,797600,8,0,0,0,0,0,0,2,2,0,1,0,0,1,0,0,2
9292,797598,9,0,2,0,2,0,0,0,2,1,0,0,1,0,0,0,0
9292,797597,1,0,1,0,1,0,0,0,2,0,0,0,0,1,0,0,0
9292,797596,25,1,6,1,3,0,3,0,1,0,3,3,1,0,3,1,2
9292,786496,11,0,0,0,0,0,0,0,0,0,0,0,1,1,0,0,0
9292,791885,1,0,0,0,0,0,0,0,0,0,0,0,0,0,0,0,0
9293,792288,31,4,7,4,7,0,0,2,2,4,4,0,2,1,1,1,10
9293,785227,31,5,6,5,6,0,0,1,1,0,2,0,4,0,2,2,11
9293,792278,11,0,3,0,0,0,3,0,0,0,1,1,1,0,3,0,0
9293,786237,29,5,9,5,9,0,0,2,2,1,4,2,2,3,2,0,12
9293,776309,32,1,5,1,5,0,0,1,4,1,6,1,0,1,0,1,3
9293,798072,6,0,1,0,1,0,0,1,2,1,1,0,1,0,2,0,1
9293,798067,3,0,1,0,1,0,0,0,0,0,0,0,1,0,0,0,0
9293,798084,3,0,0,0,0,0,0,0,0,0,0,0,0,0,1,0,0
9293,786232,25,3,6,2,4,1,2,0,0,0,7,1,1,1,3,3,7
9293,780287,29,5,11,1,4,4,7,7,8,0,0,1,1,0,0,0,21
9294,791616,19,5,7,5,7,0,0,2,2,0,1,0,0,1,1,0,12
9294,780797,21,6,9,1,1,5,8,0,0,1,7,2,3,0,0,1,17
9294,785505,25,2,7,2,6,0,1,0,1,2,2,3,1,4,3,0,4
9294,780555,30,2,5,1,2,1,3,3,4,0,4,3,2,2,0,0,8
9294,775604,28,4,10,1,3,3,7,6,7,1,4,3,1,1,1,0,17
9294,796985,3,1,2,1,2,0,0,0,0,0,2,0,0,0,0,0,2
9294,786429,12,0,0,0,0,0,0,1,2,1,4,1,2,0,0,0,1
9294,796983,3,0,4,0,4,0,0,0,0,1,0,0,0,0,1,0,0
9294,786430,3,1,1,1,1,0,0,0,0,0,0,0,0,0,1,1,2
9294,796986,5,2,2,1,1,1,1,0,0,0,1,1,0,0,0,0,5
9294,796981,27,7,12,5,8,2,4,1,1,1,3,5,2,2,1,0,17
9294,791617,6,0,1,0,1,0,0,0,0,0,1,1,0,1,0,0,0
9294,791618,14,1,5,1,4,0,1,0,0,0,3,1,3,0,0,0,2
9294,780432,4,0,1,0,0,0,1,0,0,0,0,1,0,0,0,0,0
9295,786136,20,3,12,3,10,0,2,6,6,4,4,0,4,0,1,0,12
9295,786578,17,2,6,1,3,1,3,0,2,2,2,0,0,0,3,1,5
9295,797358,26,2,11,2,7,0,4,1,2,1,5,2,2,2,3,1,5
9295,797357,28,1,5,1,2,0,3,0,0,0,5,3,2,1,3,0,2
9295,776236,29,4,12,4,10,0,2,2,3,1,7,0,2,2,2,0,10
9295,791802,7,0,1,0,1,0,0,2,2,1,1,1,0,0,0,0,2
9295,797362,5,0,2,0,0,0,2,0,0,0,2,1,0,0,0,0,0
9295,786140,8,0,1,0,1,0,0,1,2,1,0,0,1,0,1,0,1
9295,775747,13,3,6,1,3,2,3,0,0,1,0,0,1,1,1,1,8
9295,797359,23,3,5,1,2,2,3,0,0,0,1,0,4,0,1,1,8
9295,791365,9,1,3,0,0,1,3,0,0,1,1,0,1,0,0,0,3
9295,775195,15,1,2,0,0,1,2,0,0,0,1,1,1,0,0,0,3
9296,786704,25,6,11,6,11,0,0,1,1,3,3,1,1,2,1,0,13
9296,785395,27,4,6,4,4,0,2,3,3,0,7,5,2,1,3,1,11
9296,775840,33,2,5,1,4,1,1,0,0,0,1,3,1,0,1,0,5
9296,775955,31,4,10,3,5,1,5,6,8,0,2,7,1,3,3,0,15
9296,775811,9,1,2,1,2,0,0,0,0,0,0,0,2,0,1,0,2
9296,786706,15,5,5,5,5,0,0,2,3,1,2,0,3,0,0,0,12
9296,775287,13,0,2,0,0,0,2,0,0,2,0,1,0,1,1,0,0
9296,786702,5,1,3,1,2,0,1,0,0,1,1,0,0,1,0,0,2
9296,790921,15,2,6,2,5,0,1,3,4,1,0,2,3,4,1,0,7
9296,786551,27,1,5,0,1,1,4,1,2,1,5,0,2,0,0,0,4
9296,792327,0,0,0,0,0,0,0,0,0,0,0,0,0,0,0,0,0
9296,786703,0,0,0,0,0,0,0,0,0,0,0,0,0,0,0,0,0
9296,798110,0,0,0,0,0,0,0,0,0,0,0,0,0,0,0,0,0
9297,791042,27,8,11,8,10,0,1,1,1,1,4,0,2,1,1,0,17
9297,774834,26,2,3,2,3,0,0,2,2,2,1,0,1,0,1,0,6
9297,791043,38,8,17,5,12,3,5,2,2,0,2,3,4,1,4,0,21
9297,776374,36,2,8,2,7,0,1,0,1,0,4,6,2,2,3,0,4
9297,775412,30,1,2,0,0,1,2,0,0,0,3,2,1,1,0,0,3
9297,796719,6,0,0,0,0,0,0,0,0,0,1,0,2,2,1,0,0
9297,785512,14,0,1,0,1,0,0,0,1,0,1,0,2,0,3,2,0
9297,796717,4,1,1,1,1,0,0,0,0,0,2,0,0,0,0,0,2
9297,796720,19,2,6,2,5,0,1,0,0,1,2,0,2,0,4,0,4
9298,786656,15,0,2,0,2,0,0,2,2,2,1,0,2,0,0,5,2
9298,781408,22,3,8,2,4,1,4,1,3,1,0,0,2,0,0,1,8
9298,786691,19,2,9,0,2,2,7,0,1,2,3,1,3,0,1,0,6
9298,786693,31,4,10,2,3,2,7,1,2,1,3,0,1,1,3,0,11
9298,781329,38,3,10,2,4,1,6,0,0,1,6,4,4,2,6,0,7
9298,797876,9,0,0,0,0,0,0,0,0,0,0,0,4,0,2,0,0
9298,792219,2,0,0,0,0,0,0,0,0,0,0,0,1,0,0,0,0
9298,792222,10,0,2,0,0,0,2,0,0,0,0,0,1,0,0,0,0
9298,792046,18,1,4,0,1,1,3,1,2,1,0,1,4,0,2,0,4
9298,792221,16,0,0,0,0,0,0,0,0,0,2,0,1,1,0,0,0
9298,781455,20,1,5,0,3,1,2,6,6,0,2,4,1,0,1,0,9
9299,795730,4,0,2,0,1,0,1,0,0,0,1,1,0,0,0,0,0
9299,797802,33,1,4,1,3,0,1,0,0,0,5,2,3,0,2,1,2
9299,797809,31,5,7,3,5,2,2,9,10,3,8,2,4,0,1,1,21
9299,797807,37,7,13,4,9,3,4,0,0,1,3,1,3,0,2,0,17
9299,786058,37,3,7,2,6,1,1,3,3,0,3,2,3,0,1,0,10
9299,791868,32,1,6,1,5,0,1,7,8,0,3,4,2,1,5,0,9
9299,797810,3,0,2,0,1,0,1,0,0,0,0,0,0,1,0,0,0
9299,797798,3,0,0,0,0,0,0,0,0,0,0,0,0,0,0,0,0
9299,797808,15,2,5,2,5,0,0,0,0,0,3,1,3,0,1,0,4
9299,797811,3,0,0,0,0,0,0,2,2,0,1,0,0,1,1,0,2
9299,792264,2,0,0,0,0,0,0,0,0,0,0,0,1,0,1,0,0
9300,780832,29,0,3,0,3,0,0,2,2,0,3,0,1,0,0,0,2
9300,790961,31,4,6,4,6,0,0,3,4,2,5,4,1,0,2,1,11
9300,785278,36,5,15,1,2,4,13,0,0,1,4,2,2,1,2,0,14
9300,780146,34,8,18,3,9,5,9,3,4,0,1,2,2,1,3,0,24
9300,775860,31,4,9,1,2,3,7,2,2,1,6,7,2,4,2,0,13
9300,796554,9,0,1,0,0,0,1,0,0,1,0,0,3,0,0,1,0
9300,796555,11,0,0,0,0,0,0,0,0,0,1,0,2,0,1,0,0
9300,796553,14,1,1,1,1,0,0,1,2,0,1,0,0,0,0,0,3
9300,786240,5,0,0,0,0,0,0,0,0,0,0,1,0,0,1,0,0
9301,791493,34,7,13,7,13,0,0,3,5,3,7,0,4,0,2,2,17
9301,789036,35,2,5,2,5,0,0,0,0,1,2,3,5,0,2,1,4
9301,791492,38,5,13,5,10,0,3,3,4,2,1,2,2,3,1,1,13
9301,778888,20,0,4,0,2,0,2,0,0,0,2,1,1,0,2,1,0
9301,776494,40,7,14,4,6,3,8,2,4,2,4,3,1,3,2,0,19
9301,780504,8,1,2,1,2,0,0,0,0,0,3,0,0,0,0,1,2
9301,797191,19,2,4,1,3,1,1,0,0,0,2,2,1,0,2,0,5
9301,791494,6,0,0,0,0,0,0,0,0,0,0,0,3,0,1,0,0
9302,785828,12,1,1,0,0,1,1,2,4,0,1,0,5,0,0,0,5
9302,797523,34,3,5,1,2,2,3,3,4,1,5,2,2,1,0,0,11
9302,785402,24,2,4,2,4,0,0,5,6,3,3,3,3,1,3,1,9
9302,792118,33,6,17,5,9,1,8,5,6,0,2,6,3,2,3,0,18
9302,782593,27,4,14,1,5,3,9,9,9,1,5,1,4,0,1,0,20
9302,791702,16,0,0,0,0,0,0,0,0,2,2,0,3,0,0,0,0
9302,797525,1,0,0,0,0,0,0,0,0,0,0,0,2,0,0,0,0
9302,797524,29,2,4,2,4,0,0,1,2,1,2,1,3,1,3,0,5
9302,791700,24,5,7,1,1,4,6,3,6,1,2,1,2,1,1,0,17
9303,791144,31,3,5,3,4,0,1,3,4,2,4,2,1,1,0,1,9
9303,785782,14,0,1,0,0,0,1,0,0,1,3,0,5,0,0,0,0
9303,791145,35,4,10,3,8,1,2,11,11,3,7,3,3,1,4,1,20
9303,791146,37,7,18,5,11,2,7,4,5,0,0,2,2,0,3,0,20
9303,785777,29,3,7,0,1,3,6,6,6,0,0,1,4,0,2,0,15
9303,791147,9,1,3,1,1,0,2,2,2,1,1,0,3,1,1,0,4
9303,796804,2,0,0,0,0,0,0,0,0,0,0,0,2,0,0,0,0
9303,791148,29,3,7,1,1,2,6,4,4,1,3,2,4,0,0,1,12
9303,786748,14,0,1,0,0,0,1,2,2,0,0,2,2,0,1,0,2
9304,774806,34,5,10,5,10,0,0,8,8,2,10,2,1,1,2,3,18
9304,775823,29,7,11,6,9,1,2,3,4,0,1,2,3,2,4,0,18
9304,791041,27,2,6,2,5,0,1,0,0,0,5,2,4,1,2,0,4
9304,791038,35,7,11,2,4,5,7,2,3,0,3,3,4,1,2,0,21
9304,789023,40,5,11,3,7,2,4,4,4,1,1,7,3,1,2,0,16
9304,796716,1,0,0,0,0,0,0,0,0,0,1,0,0,0,0,0,0
9304,796714,6,1,2,1,2,0,0,0,0,1,2,0,2,0,1,0,2
9304,775205,28,0,2,0,0,0,2,0,0,0,0,1,2,2,2,0,0
9305,797325,36,3,8,3,8,0,0,4,6,3,6,1,3,1,0,0,10
9305,797329,26,2,4,2,3,0,1,2,2,2,4,0,4,0,2,0,6
9305,797327,38,6,12,4,9,2,3,4,4,0,5,0,0,0,2,0,18
9305,797323,40,8,19,3,7,5,12,7,9,0,3,4,4,3,4,0,28
9305,786236,39,6,14,6,11,0,3,2,2,3,2,2,0,4,3,1,14
9305,781002,11,2,4,2,4,0,0,0,2,2,0,0,1,1,0,1,4
9305,786233,10,0,2,0,0,0,2,0,0,2,0,0,3,1,0,0,0
9306,796891,36,7,12,6,9,1,3,5,6,2,5,1,4,0,0,2,20
9306,796884,16,0,2,0,1,0,1,0,0,0,0,0,3,0,3,0,0
9306,796896,21,2,6,0,1,2,5,0,0,0,2,0,2,1,2,0,6
9306,796882,32,6,9,4,5,2,4,2,3,1,4,5,2,1,7,0,16
9306,790447,26,0,4,0,4,0,0,2,2,0,2,5,3,2,2,0,2
9306,796892,20,3,5,3,5,0,0,0,2,3,3,0,4,1,3,1,6
9306,796890,6,1,2,1,2,0,0,0,0,0,1,0,0,0,0,1,2
9306,796888,10,0,0,0,0,0,0,2,2,0,1,0,2,0,1,0,2
9306,796887,18,4,6,2,3,2,3,0,0,0,2,1,0,1,0,0,10
9306,796881,15,0,1,0,0,0,1,2,2,0,0,1,0,1,0,0,2
9307,781577,25,4,10,4,8,0,2,5,6,4,1,1,0,1,2,1,13
9307,775910,26,2,5,1,2,1,3,1,6,10,2,2,2,1,1,1,6
9307,786451,26,2,9,2,3,0,6,2,2,2,2,1,2,2,2,0,6
9307,780600,31,7,16,2,4,5,12,1,2,2,7,3,3,1,2,0,20
9307,781387,27,5,10,3,5,2,5,0,1,2,2,2,2,2,1,0,12
9307,800084,0,0,0,0,0,0,0,0,0,0,0,0,0,0,0,0,0
9307,791763,15,1,4,0,2,1,2,0,0,1,2,1,2,1,1,0,3
9307,790888,7,1,3,1,2,0,1,0,0,1,0,0,0,0,0,0,2
9307,786456,6,1,2,1,2,0,0,0,0,0,0,1,3,0,1,0,2
9307,780268,6,1,1,1,1,0,0,0,0,0,0,0,2,0,0,0,2
9307,797561,13,0,0,0,0,0,0,0,0,0,2,4,1,2,0,0,0
9307,780020,18,4,10,3,6,1,4,1,2,2,1,1,0,0,0,0,10
9307,793065,0,0,0,0,0,0,0,0,0,0,0,0,0,0,0,0,0
9307,786457,0,0,0,0,0,0,0,0,0,0,0,0,0,0,0,0,0
9308,797292,30,7,13,7,13,0,0,3,4,1,12,0,2,0,1,2,17
9308,780509,34,2,5,1,3,1,2,3,5,1,6,0,1,0,1,0,8
9308,797290,35,7,11,4,7,3,4,8,8,1,5,4,3,0,5,0,25
9308,797291,14,0,2,0,1,0,1,0,0,0,1,2,1,0,4,0,0
9308,786064,34,4,5,3,3,1,2,0,0,1,2,2,1,2,4,0,9
9308,791658,8,1,1,1,1,0,0,0,0,2,1,0,2,0,1,0,2
9308,785658,8,0,2,0,2,0,0,0,0,0,2,0,1,0,2,0,0
9308,791660,37,3,10,3,7,0,3,0,1,0,1,5,1,2,1,0,6
9309,791230,34,5,15,1,5,4,10,0,0,1,7,2,3,1,0,0,14
9309,785557,22,2,8,2,7,0,1,1,4,2,1,1,4,0,1,0,5
9309,791228,31,4,9,3,5,1,4,2,2,1,2,2,0,2,0,0,11
9309,796932,37,12,20,8,14,4,6,1,2,0,3,4,2,0,1,0,29
9309,785624,26,0,6,0,3,0,3,0,2,1,2,1,2,6,1,0,0
9309,796933,17,2,2,2,2,0,0,0,0,0,2,1,3,1,2,0,4
9309,791226,13,0,0,0,0,0,0,1,2,0,2,1,1,0,0,1,1
9309,791227,17,0,1,0,1,0,0,0,0,0,0,0,1,0,2,0,0
9309,781198,3,0,0,0,0,0,0,0,0,0,0,0,1,0,2,0,0
9312,780879,27,5,8,4,6,1,2,1,2,0,3,5,3,0,1,0,12
9312,775785,18,2,4,2,3,0,1,0,0,1,2,1,1,0,0,0,4
9312,790767,5,1,2,1,1,0,1,0,0,0,0,0,0,0,0,0,2
9312,785743,21,2,7,0,2,2,5,0,0,1,2,3,1,0,2,1,6
9312,780875,32,3,6,1,3,2,3,0,0,1,5,3,2,1,3,1,8
9312,790769,21,2,4,2,2,0,2,0,0,0,0,0,1,0,1,0,4
9312,796326,12,1,4,1,4,0,0,0,0,1,2,1,1,0,0,1,2
9312,785224,20,5,6,3,3,2,3,4,4,1,2,0,2,0,1,0,16
9312,790768,32,7,10,2,2,5,8,2,3,0,2,5,1,1,2,0,21
9312,785226,7,1,1,1,1,0,0,0,0,0,0,0,1,1,0,0,2
9312,796324,5,0,0,0,0,0,0,0,0,0,2,0,0,0,0,0,0
9313,791876,30,6,13,5,9,1,4,0,0,0,4,1,3,2,3,1,13
9313,791877,24,3,5,3,5,0,0,1,2,2,2,0,2,0,1,0,7
9313,797491,28,0,2,0,1,0,1,4,4,1,0,0,1,1,1,0,4
9313,790396,11,1,1,0,0,1,1,0,0,0,0,2,1,1,2,0,3
9313,780436,27,3,4,2,3,1,1,0,1,1,3,2,3,0,3,0,7
9313,797486,31,2,7,0,4,2,3,3,4,0,3,3,0,4,1,1,9
9313,781205,16,0,0,0,0,0,0,3,4,2,3,0,2,0,2,1,3
9313,785667,25,4,9,1,4,3,5,0,0,0,0,0,0,1,0,0,11
9313,791878,8,1,4,0,1,1,3,2,2,0,0,0,1,0,0,0,5
9314,796812,20,4,6,4,6,0,0,2,2,1,9,1,2,1,1,2,10
9314,780952,14,5,5,4,4,1,1,0,1,0,2,0,4,1,1,1,11
9314,791155,29,8,12,3,3,5,9,0,0,1,2,2,3,0,3,1,21
9314,786609,26,5,8,5,6,0,2,1,2,1,4,2,1,1,0,1,11
9314,796810,27,1,7,1,4,0,3,5,6,1,1,8,1,0,2,0,7
9314,796814,23,0,0,0,0,0,0,1,2,0,1,3,4,1,1,0,1
9314,780945,13,2,4,2,4,0,0,3,4,4,3,2,4,0,2,0,7
9314,791156,23,6,6,3,3,3,3,0,0,0,1,2,2,0,2,0,15
9314,780950,19,3,9,0,0,3,9,2,2,0,1,0,0,0,0,1,11
9314,785752,4,0,1,0,0,0,1,2,2,0,1,2,0,0,0,0,2
9314,791158,1,1,1,1,1,0,0,0,0,0,0,0,1,0,0,0,2
9314,796811,1,0,0,0,0,0,0,0,0,0,0,0,0,0,0,0,0
9315,786857,27,4,6,1,3,3,3,4,5,0,0,0,5,3,4,1,15
9315,781403,30,2,5,2,4,0,1,4,6,0,0,2,1,1,0,0,8
9315,792654,29,7,11,7,11,0,0,2,3,2,5,0,3,0,3,0,16
9315,797301,37,2,11,2,7,0,4,0,0,1,2,6,2,1,2,0,4
9315,780524,26,1,4,1,2,0,2,0,0,0,2,1,1,0,2,0,2
9315,792653,7,0,1,0,1,0,0,2,2,0,1,0,2,1,0,0,2
9315,781400,24,6,9,2,4,4,5,6,7,0,1,1,1,0,1,0,22
9315,797306,4,0,0,0,0,0,0,0,0,0,1,0,0,0,0,0,0
9315,797305,3,1,5,1,4,0,1,1,1,3,0,1,0,0,0,0,3
9315,797304,6,3,4,3,4,0,0,1,1,1,1,0,2,1,0,0,7
9315,797303,3,1,2,0,0,1,2,0,0,0,1,0,0,0,0,0,3
9315,797302,4,0,0,0,0,0,0,0,0,0,0,0,0,0,0,0,0
9316,792481,29,3,8,3,6,0,2,0,0,5,0,6,3,1,2,1,6
9316,792486,19,1,2,1,2,0,0,0,1,1,1,1,3,0,1,0,2
9316,797419,21,4,4,3,3,1,1,0,1,0,1,2,3,2,3,0,9
9316,792482,34,4,11,1,3,3,8,1,2,1,3,2,3,3,0,0,12
9316,785778,39,9,12,9,10,0,2,3,4,1,2,2,2,2,1,2,21
9316,792488,21,4,13,3,11,1,2,0,1,1,2,0,1,1,0,0,9
9316,780544,10,0,0,0,0,0,0,0,0,1,2,1,1,0,1,0,0
9316,792489,2,0,0,0,0,0,0,0,0,0,0,1,0,0,0,0,0
9316,785774,8,1,3,0,1,1,2,0,0,0,0,0,0,0,0,0,3
9316,785766,17,2,5,0,1,2,4,0,0,0,2,0,0,0,0,0,6
9317,791548,38,7,14,7,10,0,4,1,3,2,10,3,1,1,4,2,15
9317,791550,23,4,5,4,5,0,0,0,3,3,2,0,0,0,2,0,8
9317,791552,33,4,8,2,5,2,3,0,0,1,4,7,2,2,3,0,10
9317,786368,28,3,7,2,2,1,5,0,0,2,0,4,2,1,1,0,7
9317,786364,38,7,11,5,8,2,3,1,2,2,3,2,3,2,1,0,17
9317,797082,17,5,6,4,5,1,1,2,2,1,1,0,2,0,1,0,13
9317,780330,9,0,1,0,1,0,0,0,0,0,1,0,0,0,1,0,0
9317,780329,14,2,3,1,1,1,2,1,1,0,1,2,3,0,2,0,6
9318,791023,32,8,9,8,9,0,0,2,2,4,5,0,1,0,3,3,18
9318,796684,39,6,11,5,7,1,4,0,0,0,4,2,4,0,1,1,13
9318,791027,40,5,9,4,6,1,3,5,5,2,9,0,2,1,0,0,16
9318,781507,35,5,8,4,5,1,3,1,3,0,5,5,4,0,5,0,12
9318,777572,36,8,14,5,8,3,6,0,0,1,4,6,2,0,1,1,19
9318,796686,15,3,4,2,3,1,1,0,0,2,1,1,0,0,1,0,7
9318,791025,3,0,0,0,0,0,0,0,0,0,0,1,0,0,0,0,0
9319,797380,12,0,4,0,2,0,2,0,0,0,0,0,1,0,0,0,0
9319,789043,18,3,5,3,5,0,0,0,0,1,0,0,2,1,0,0,6
9319,791818,37,5,14,2,6,3,8,1,2,3,2,4,2,0,1,1,14
9319,786636,32,3,14,1,7,2,7,0,0,0,1,4,1,0,1,0,8
9319,780646,26,1,4,0,2,1,2,3,4,1,2,1,1,1,1,0,6
9319,797379,14,0,1,0,1,0,0,0,0,0,2,0,2,0,0,0,0
9319,797377,30,2,4,1,2,1,2,2,2,0,1,3,2,1,1,0,7
9319,775168,17,0,4,0,3,0,1,0,0,1,0,1,2,1,2,0,0
9319,797382,8,5,6,3,4,2,2,1,1,1,1,0,0,0,0,0,13
9319,797378,3,0,0,0,0,0,0,1,2,0,0,0,0,1,1,0,1
9319,797375,3,0,0,0,0,0,0,0,0,0,0,0,0,0,0,0,0
9320,786029,28,4,7,4,7,0,0,4,6,1,6,0,2,1,2,0,12
9320,781398,24,4,7,4,4,0,3,0,0,1,8,1,3,1,1,0,8
9320,792114,30,6,15,0,3,6,12,3,3,0,0,3,2,1,1,0,21
9320,786018,30,5,8,2,3,3,5,1,2,1,2,1,1,0,1,0,14
9320,775678,30,4,9,3,6,1,3,0,0,1,2,6,1,3,0,0,9
9320,797745,9,2,4,2,4,0,0,0,0,1,0,0,3,0,1,0,4
9320,797746,18,2,3,2,3,0,0,1,1,3,0,2,4,2,1,0,5
9320,797744,3,0,1,0,0,0,1,0,0,0,0,0,1,0,0,0,0
9320,797740,15,2,6,1,4,1,2,2,2,0,0,1,0,1,1,1,7
9320,797737,8,0,0,0,0,0,0,0,0,0,0,1,0,0,0,0,0
9320,780354,2,0,0,0,0,0,0,0,0,0,1,0,0,0,0,0,0
9320,780352,2,0,1,0,0,0,1,0,0,0,0,1,0,0,0,0,0
9320,797743,1,0,0,0,0,0,0,0,0,0,0,0,0,0,0,0,0
9321,785996,30,6,10,4,5,2,5,4,4,3,6,0,1,0,0,0,18
9321,785998,16,1,2,0,0,1,2,0,0,0,1,0,4,2,0,0,3
9321,785990,33,1,9,0,2,1,7,5,5,0,4,6,1,0,6,0,8
9321,780849,29,1,8,0,2,1,6,0,0,2,5,0,1,0,1,1,3
9321,780853,34,6,12,6,10,0,2,2,5,1,2,2,1,1,3,0,14
9321,786010,15,0,1,0,0,0,1,2,2,0,1,0,1,0,2,0,2
9321,780776,9,4,4,4,4,0,0,0,0,1,4,0,2,0,1,2,8
9321,792235,10,0,2,0,2,0,0,0,1,3,1,0,1,0,0,0,0
9321,792039,23,3,9,3,7,0,2,1,2,3,0,0,1,2,2,1,7
9321,786001,1,0,0,0,0,0,0,0,0,0,0,0,0,0,0,0,0
9322,796699,22,3,8,2,5,1,3,3,3,4,5,2,2,1,2,3,10
9322,790983,32,7,14,6,9,1,5,3,4,2,3,1,3,0,0,1,18
9322,790978,36,1,7,0,0,1,7,0,0,0,1,1,1,0,2,1,3
9322,790979,29,7,13,4,6,3,7,5,6,0,4,2,2,0,0,0,22
9322,788820,38,4,9,0,1,4,8,2,2,0,1,7,2,2,2,1,14
9322,796701,16,2,3,1,2,1,1,0,0,3,2,1,2,0,2,0,5
9322,790976,5,1,2,1,2,0,0,0,0,0,1,0,1,0,0,0,2
9322,796698,15,2,5,2,4,0,1,0,0,2,1,1,1,0,0,0,4
9322,790980,2,0,1,0,0,0,1,0,0,1,2,0,0,0,0,0,0
9322,789457,3,0,0,0,0,0,0,0,0,0,0,0,0,0,1,0,0
9322,790977,2,0,0,0,0,0,0,0,0,0,0,0,0,0,0,0,0
9323,785999,36,7,17,7,17,0,0,6,14,5,4,0,2,2,2,0,20
9323,775654,33,1,2,1,2,0,0,3,4,3,2,2,2,0,2,1,5
9323,796399,21,3,9,3,7,0,2,0,0,2,5,2,3,2,3,0,6
9323,791639,38,6,14,5,11,1,3,4,4,1,4,2,2,0,0,0,17
9323,785389,37,8,15,7,11,1,4,2,2,2,3,1,0,1,1,0,19
9323,791640,8,0,0,0,0,0,0,0,0,0,2,0,0,0,0,1,0
9323,785255,3,0,0,0,0,0,0,0,0,0,0,0,2,0,1,0,0
9323,796401,6,0,1,0,0,0,1,0,0,0,0,0,0,0,0,0,0
9323,796398,18,2,2,2,2,0,0,0,0,2,0,2,4,1,0,0,4
9324,791923,38,3,8,3,8,0,0,0,0,0,6,1,0,1,2,0,6
9324,786529,20,0,2,0,2,0,0,0,0,2,2,0,2,1,1,0,0
9324,791925,21,8,13,5,7,3,6,1,2,1,5,0,2,0,2,0,20
9324,786527,24,2,5,0,2,2,3,2,2,1,0,2,1,3,0,0,8
9324,781112,20,1,5,0,4,1,1,2,2,1,1,1,0,0,0,0,5
9324,800210,3,0,0,0,0,0,0,0,0,0,0,0,0,0,1,0,0
9324,797541,19,4,8,4,8,0,0,1,2,1,7,0,4,0,0,0,9
9324,797542,19,2,5,1,1,1,4,2,4,0,1,3,0,0,2,0,7
9324,791927,18,4,6,1,2,3,4,4,5,0,3,1,1,0,0,0,15
9324,786858,18,4,5,3,3,1,2,0,0,0,1,3,0,1,1,0,9
9324,797543,0,0,0,0,0,0,0,0,0,0,0,0,0,0,0,0,0
9325,775489,29,4,10,4,10,0,0,3,5,2,2,0,2,2,2,2,11
9325,785563,32,6,10,4,7,2,3,2,2,4,7,0,4,0,3,0,16
9325,791088,33,2,9,1,4,1,5,0,0,0,3,2,1,0,0,0,5
9325,785561,23,1,1,1,1,0,0,2,2,2,3,0,3,1,1,0,4
9325,780313,37,4,16,3,10,1,6,2,4,1,1,11,1,0,1,0,11
9325,791069,28,4,7,1,1,3,6,0,0,0,2,1,2,0,1,0,11
9325,785560,18,4,9,0,1,4,8,0,0,0,3,0,2,3,1,0,12
9326,786846,28,1,3,1,2,0,1,2,2,0,4,1,3,0,0,3,4
9326,775515,31,4,11,3,6,1,5,2,2,0,6,1,1,1,0,2,11
9326,791579,38,8,14,5,8,3,6,2,2,0,4,4,0,3,3,0,21
9326,786387,39,8,19,7,16,1,3,6,6,3,5,2,3,1,2,0,23
9326,780399,36,2,2,0,0,2,2,0,0,0,1,2,2,2,0,0,6
9326,797047,13,1,4,1,3,0,1,2,2,0,5,1,3,0,2,1,4
9326,791575,3,0,1,0,0,0,1,0,0,0,0,0,1,0,0,0,0
9326,797046,12,2,5,0,0,2,5,0,0,1,2,0,1,1,1,0,6
9327,791115,14,0,3,0,3,0,0,0,0,0,0,0,4,0,1,0,0
9327,791118,38,6,15,4,11,2,4,1,2,1,6,1,2,1,1,0,15
9327,785947,3,0,0,0,0,0,0,0,0,0,0,0,0,0,0,0,0
9327,785676,22,1,5,0,2,1,3,0,0,0,3,1,2,1,0,1,3
9327,774974,36,7,12,6,10,1,2,5,8,1,3,2,0,2,4,0,20
9327,796771,26,6,13,4,9,2,4,0,0,4,7,0,4,1,3,0,14
9327,796769,28,1,3,1,1,0,2,1,2,0,2,2,1,0,1,0,3
9327,791117,33,4,11,2,9,2,2,1,2,1,5,0,4,2,0,1,11
9328,781158,21,3,7,3,7,0,0,2,2,2,3,1,1,0,2,0,8
9328,781652,38,3,10,3,8,0,2,2,3,3,7,1,2,0,1,1,8
9328,786034,36,5,9,2,3,3,6,0,2,1,2,0,4,0,2,0,13
9328,786419,28,5,10,4,6,1,4,7,9,2,4,3,3,0,2,0,18
9328,781283,25,4,6,1,2,3,4,2,2,0,0,0,3,0,2,0,13
9328,791614,2,0,0,0,0,0,0,0,0,0,1,0,1,0,0,0,0
9328,781653,20,2,3,2,3,0,0,0,1,1,3,2,2,0,0,1,4
9328,791615,20,1,6,0,4,1,2,2,2,0,0,2,0,1,3,0,5
9328,785277,10,3,5,1,2,2,3,0,0,0,0,1,0,0,0,0,8
9329,791606,35,9,16,0,3,9,13,1,2,2,4,0,1,0,3,1,28
9329,786410,22,0,3,0,0,0,3,0,0,0,4,0,4,0,1,0,0
9329,775095,6,0,0,0,0,0,0,0,0,0,1,0,3,0,1,0,0
9329,786406,24,2,5,2,3,0,2,0,0,1,1,4,2,2,1,0,4
9329,780414,33,7,13,5,9,2,4,6,6,0,1,4,4,0,2,0,22
9329,797020,22,3,6,3,6,0,0,1,2,0,3,0,3,0,0,2,7
9329,792392,5,0,1,0,1,0,0,1,2,0,0,0,0,0,0,0,1
9329,797021,21,3,6,3,4,0,2,1,1,0,1,1,3,1,1,0,7
9329,791605,30,4,5,2,2,2,3,0,0,0,4,2,0,0,0,0,10
9329,791603,2,0,1,0,1,0,0,0,0,0,1,0,0,0,0,0,0
9330,791302,28,5,10,4,9,1,1,2,5,1,6,0,4,2,4,1,13
9330,781622,32,2,5,0,0,2,5,2,2,0,5,1,2,1,1,0,8
9330,791309,38,7,17,7,14,0,3,4,5,0,0,10,3,3,4,0,18
9330,785835,16,3,5,3,4,0,1,1,3,1,1,1,1,0,3,0,7
9330,776334,34,3,4,2,2,1,2,2,4,0,5,3,2,2,2,0,9
9330,796601,21,6,11,3,5,3,6,1,3,0,1,1,3,2,3,0,16
9330,791301,6,0,0,0,0,0,0,0,0,0,0,1,0,0,0,0,0
9330,775862,16,2,7,2,7,0,0,1,1,3,2,0,0,0,2,0,5
9330,796604,1,0,1,0,1,0,0,0,0,0,0,0,0,1,0,0,0
9330,791304,8,1,2,0,1,1,1,0,0,0,3,1,2,0,0,0,3
9331,776110,15,2,3,0,0,2,3,0,0,0,0,0,2,1,0,1,6
9331,780059,30,4,8,4,8,0,0,2,5,3,3,4,2,1,6,1,10
9331,796494,23,5,14,4,9,1,5,0,0,2,3,2,1,0,1,1,11
9331,790944,32,6,14,4,8,2,6,0,2,1,5,2,3,2,3,0,14
9331,780061,29,5,8,3,5,2,3,3,4,2,5,1,4,1,3,0,15
9331,786754,24,5,8,3,4,2,4,6,6,1,3,4,0,1,5,0,18
9331,790941,8,0,4,0,4,0,0,0,0,3,2,0,0,0,0,1,0
9331,790943,10,2,3,2,3,0,0,0,0,1,3,0,1,2,1,0,4
9331,796496,20,3,5,2,4,1,1,2,3,0,5,1,3,0,2,1,9
9331,780058,4,1,1,1,1,0,0,0,0,0,0,0,0,1,0,1,2
9331,796495,5,0,0,0,0,0,0,0,0,0,1,0,1,1,0,1,0
9332,792388,9,0,2,0,2,0,0,1,2,2,1,0,4,0,0,1,1
9332,797851,34,4,10,2,6,2,4,0,1,3,1,2,3,0,2,0,10
9332,792393,39,6,16,4,11,2,5,3,4,2,2,2,3,4,3,0,17
9332,792391,38,6,13,6,13,0,0,3,5,5,8,2,4,3,3,1,15
9332,792395,40,3,15,2,10,1,5,3,4,2,2,4,2,2,1,1,10
9332,781533,31,3,5,2,2,1,3,0,0,1,2,2,3,1,1,0,7
9332,781541,9,0,0,0,0,0,0,0,0,0,0,0,2,1,1,0,0
9333,785740,28,4,5,4,5,0,0,2,4,3,7,0,4,0,2,2,10
9333,785809,26,1,8,1,6,0,2,5,6,1,7,4,4,0,1,0,7
9333,780530,35,7,9,7,9,0,0,0,0,3,2,1,2,2,5,3,14
9333,797402,26,0,1,0,0,0,1,1,2,0,4,1,1,1,4,0,1
9333,785738,40,5,13,5,8,0,5,4,6,0,3,4,4,2,3,0,14
9333,797396,14,3,4,2,3,1,1,0,0,0,1,0,2,1,1,0,7
9333,786144,31,2,6,0,3,2,3,7,9,1,2,3,1,0,2,0,13
9334,790837,21,0,0,0,0,0,0,0,0,0,3,0,3,0,1,0,0
9334,781046,32,4,6,2,3,2,3,0,0,2,11,1,5,0,3,0,10
9334,780025,37,8,13,8,13,0,0,4,7,0,4,1,3,0,1,2,20
9334,785385,33,1,6,1,2,0,4,0,0,0,3,2,1,1,1,1,2
9334,785383,39,8,21,5,11,3,10,1,2,1,6,3,4,1,2,0,20
9334,786297,3,0,0,0,0,0,0,0,0,0,0,0,1,0,1,0,0
9334,796391,6,0,1,0,1,0,0,0,0,0,0,0,1,0,0,0,0
9334,786228,29,1,8,1,5,0,3,0,0,0,1,1,1,1,1,0,2
9335,791981,36,5,15,5,12,0,3,1,2,4,9,1,2,1,2,1,11
9335,786756,15,1,4,0,1,1,3,0,0,0,2,1,1,0,0,0,3
9335,780342,34,7,11,7,11,0,0,7,8,2,6,1,0,0,0,0,21
9335,791982,12,0,2,0,1,0,1,0,0,0,1,1,1,0,2,0,0
9335,781493,20,1,8,0,5,1,3,4,6,1,0,1,4,1,1,0,7
9335,791986,22,1,3,0,0,1,3,0,0,0,2,1,1,1,0,0,3
9335,786755,29,1,3,0,2,1,1,1,5,1,2,0,2,3,1,2,4
9335,791984,7,1,2,1,2,0,0,1,2,1,0,0,1,0,0,0,3
9335,791985,25,0,4,0,0,0,4,0,0,0,4,2,0,0,1,0,0
9336,796585,11,1,2,1,2,0,0,0,0,1,3,0,3,0,2,0,2
9336,780192,30,8,11,8,9,0,2,4,7,1,8,3,1,1,2,0,20
9336,798139,25,3,4,3,4,0,0,2,2,0,2,5,1,0,1,0,8
9336,786818,37,6,11,5,8,1,3,4,4,0,6,3,1,1,0,0,17
9336,780182,31,2,8,0,1,2,7,2,2,0,1,2,2,1,3,0,8
9336,796587,1,0,0,0,0,0,0,0,0,0,0,0,0,0,0,0,0
9336,786821,1,0,0,0,0,0,0,0,0,0,0,0,0,0,0,0,0
9336,780186,26,7,9,7,9,0,0,0,0,2,2,2,3,1,1,0,14
9336,798138,11,4,4,2,2,2,2,0,0,0,0,1,1,1,1,0,10
9336,796584,1,0,0,0,0,0,0,0,0,0,0,1,0,0,0,0,0
9336,786819,1,0,0,0,0,0,0,0,0,0,1,0,0,0,0,0,0
9336,786820,14,0,1,0,0,0,1,0,0,0,2,3,0,2,0,0,0
9336,780188,1,1,1,1,1,0,0,0,0,0,0,0,0,0,0,0,2
9336,780184,10,3,4,1,2,2,2,0,0,0,0,2,0,0,0,0,8
9337,790957,30,2,5,0,2,2,3,0,0,2,0,4,3,0,2,0,6
9337,785275,25,4,5,4,5,0,0,1,2,0,3,1,0,0,2,0,9
9337,790956,15,2,4,0,1,2,3,0,0,0,0,1,1,0,1,0,6
9337,785089,32,5,11,2,5,3,6,0,0,0,4,1,3,2,4,0,13
9337,780460,37,6,14,3,5,3,9,3,4,0,2,3,2,0,2,0,18
9337,796550,24,1,5,0,1,1,4,1,2,1,3,0,2,0,2,0,4
9337,796549,1,0,0,0,0,0,0,0,0,0,0,0,0,0,0,0,0
9337,796551,14,2,3,2,3,0,0,0,0,0,2,1,1,0,0,1,4
9337,796548,1,0,1,0,0,0,1,0,0,0,0,0,0,0,0,0,0
9337,796547,1,1,1,1,1,0,0,0,1,1,0,0,0,0,0,0,2
9337,796552,19,2,4,2,4,0,0,0,0,0,1,1,4,4,2,0,4
9337,785276,1,0,0,0,0,0,0,0,0,0,0,0,0,0,0,0,0
9338,790784,24,4,10,4,5,0,5,3,5,2,3,1,3,1,2,0,11
9338,786235,20,0,1,0,1,0,0,0,3,0,0,0,0,0,0,1,0
9338,797475,30,5,12,2,4,3,8,0,0,1,2,2,4,0,1,0,13
9338,786229,16,1,4,0,1,1,3,0,0,2,1,0,0,0,2,0,3
9338,775229,29,6,12,3,6,3,6,2,3,2,3,1,2,1,2,0,17
9338,786583,2,1,1,1,1,0,0,0,0,0,1,0,0,0,0,0,2
9338,776219,13,0,1,0,1,0,0,0,0,0,0,0,0,0,0,0,0
9338,797477,2,0,1,0,0,0,1,0,0,0,0,0,0,0,0,0,0
9338,797476,2,0,0,0,0,0,0,0,0,2,0,1,0,0,0,0,0
9338,791871,2,0,1,0,0,0,1,0,0,0,0,0,0,0,0,0,0
9338,786581,13,0,2,0,2,0,0,0,0,1,0,1,0,0,0,0,0
9338,786770,18,2,8,1,5,1,3,1,2,0,5,0,0,1,1,0,6
9338,786719,13,1,2,1,1,0,1,0,2,1,1,1,2,0,1,0,2
9338,781518,16,0,0,0,0,0,0,0,0,1,1,2,1,0,1,0,0
9339,775738,20,0,0,0,0,0,0,0,0,0,3,0,1,0,0,1,0
9339,786091,23,0,0,0,0,0,0,2,2,1,7,1,4,1,0,1,2
9339,786728,34,11,13,10,12,1,1,3,6,0,4,5,4,2,3,1,26
9339,785904,38,4,12,1,6,3,6,2,2,1,4,0,1,1,1,0,13
9339,780892,36,8,12,6,8,2,4,1,2,1,1,3,0,1,2,0,19
9339,797670,2,1,2,1,1,0,1,0,0,0,0,0,0,0,0,0,2
9339,792087,1,0,0,0,0,0,0,0,0,0,1,0,1,0,0,0,0
9339,786788,8,0,0,0,0,0,0,2,2,0,0,0,0,0,1,0,2
9339,786096,25,3,4,3,4,0,0,3,4,0,2,1,2,2,1,0,9
9339,781030,7,0,2,0,0,0,2,0,0,0,1,0,1,1,0,0,0
9339,786350,2,0,0,0,0,0,0,0,0,0,0,0,0,0,0,0,0
9339,797669,2,0,0,0,0,0,0,0,0,0,0,0,0,0,0,0,0
9339,797665,2,0,0,0,0,0,0,0,0,0,0,0,0,0,0,0,0
9340,791531,18,2,3,2,2,0,1,3,4,3,2,0,0,0,0,0,7
9340,791534,31,4,10,2,6,2,4,2,5,3,3,0,1,2,2,0,12
9340,791533,38,4,7,4,7,0,0,1,2,1,9,1,1,0,0,0,9
9340,791528,40,6,17,5,12,1,5,1,2,0,2,1,2,0,1,0,14
9340,775045,40,2,15,2,15,0,0,2,2,0,0,6,2,0,0,0,6
9340,797127,29,2,4,0,1,2,3,2,2,2,1,0,3,0,0,0,8
9340,797124,4,1,1,1,1,0,0,0,0,0,0,0,0,0,0,0,2
9341,775510,30,9,14,7,9,2,5,4,4,0,8,1,4,0,1,2,24
9341,774976,26,5,6,5,5,0,1,0,0,1,5,0,2,0,2,4,10
9341,797865,37,2,4,2,3,0,1,2,2,0,3,4,2,0,0,0,6
9341,786614,38,7,12,6,7,1,5,2,2,2,4,1,2,0,0,1,17
9341,786759,32,1,7,1,6,0,1,0,0,0,1,3,3,1,2,0,2
9341,792294,19,2,4,2,4,0,0,0,0,2,4,0,0,0,0,0,4
9341,792291,15,1,3,1,2,0,1,3,3,1,2,1,0,0,0,1,5
9341,792293,3,0,2,0,1,0,1,0,0,0,0,0,0,0,0,0,0
9342,790873,35,8,17,5,10,3,7,0,3,1,3,0,3,0,2,0,19
9342,780054,34,4,6,3,4,1,2,6,7,2,6,0,5,1,2,0,15
9342,781140,28,1,5,1,4,0,1,0,0,2,2,1,3,0,2,2,2
9342,786851,35,6,18,4,10,2,8,1,1,1,2,6,1,0,2,0,15
9342,776357,28,3,9,2,5,1,4,0,0,2,4,3,4,2,0,0,7
9342,785429,22,2,7,0,0,2,7,0,0,0,1,0,2,1,0,1,6
9342,796433,7,2,2,2,2,0,0,0,0,1,0,0,3,0,0,2,4
9342,781139,6,0,1,0,1,0,0,0,0,2,0,0,1,0,1,0,0
9342,776245,5,0,0,0,0,0,0,0,0,0,2,0,2,0,0,0,0
9343,791416,25,6,11,6,11,0,0,0,5,3,3,0,4,1,3,0,12
9343,781614,21,4,7,4,6,0,1,1,1,1,3,1,1,0,0,0,9
9343,797096,24,1,6,1,3,0,3,0,0,0,4,0,1,0,1,0,2
9343,785906,36,7,10,7,10,0,0,5,6,0,4,3,1,0,1,0,19
9343,780096,26,1,5,0,1,1,4,0,0,0,1,2,2,0,0,0,3
9343,797093,29,6,8,5,7,1,1,6,7,0,5,6,1,1,2,0,19
9343,780100,25,2,5,0,2,2,3,1,2,3,3,0,3,1,1,0,7
9343,785907,14,0,0,0,0,0,0,2,3,3,1,0,1,1,1,1,2
9344,792329,27,4,8,4,8,0,0,0,0,2,2,2,2,0,2,0,8
9344,786752,33,6,8,6,8,0,0,4,4,1,3,0,0,0,2,1,16
9344,781384,37,4,9,3,6,1,3,0,0,2,2,2,0,1,1,0,9
9344,781616,35,4,15,3,7,1,8,2,2,1,1,1,3,1,2,0,11
9344,776350,36,5,10,3,7,2,3,2,3,0,1,6,2,2,0,0,14
9344,781075,7,2,2,1,1,1,1,0,0,0,2,0,3,2,0,0,5
9344,781615,14,0,4,0,1,0,3,0,0,1,1,2,4,0,1,2,0
9344,786749,11,1,2,1,2,0,0,0,0,2,0,0,1,0,1,0,2
9345,792417,26,3,6,3,6,0,0,0,0,0,2,2,4,0,4,1,6
9345,786861,39,4,6,3,4,1,2,0,0,1,4,2,1,0,3,0,9
9345,786867,29,1,6,0,1,1,5,0,0,0,2,0,3,1,0,0,3
9345,780387,39,9,12,5,6,4,6,3,4,0,9,0,3,1,5,1,25
9345,767033,37,8,11,5,6,3,5,3,4,0,4,3,3,1,2,0,22
9345,796870,12,1,1,1,1,0,0,1,2,0,0,1,1,0,0,0,3
9345,792416,18,1,1,0,0,1,1,0,1,1,0,2,2,2,0,0,3
9346,785631,29,8,10,8,8,0,2,4,4,2,5,1,2,1,0,0,20
9346,786248,27,3,8,3,8,0,0,0,0,2,8,0,4,0,0,1,6
9346,791200,40,8,23,7,19,1,4,8,10,0,2,0,0,2,1,0,25
9346,785630,36,4,11,3,5,1,6,0,0,0,0,4,0,1,0,0,9
9346,785632,40,4,6,3,5,1,1,0,1,3,6,1,0,1,1,1,9
9346,791199,13,1,4,1,4,0,0,0,0,1,0,0,1,0,0,0,2
9346,791198,15,0,3,0,0,0,3,0,0,0,0,1,1,0,0,0,0
9347,790870,33,7,19,7,18,0,1,5,7,8,7,0,2,1,1,4,19
9347,790869,30,2,9,1,6,1,3,0,0,0,4,2,3,0,4,0,5
9347,780116,36,5,7,1,2,4,5,4,5,0,5,0,3,1,2,1,18
9347,796421,40,8,15,8,14,0,1,0,0,0,4,8,3,0,2,2,16
9347,790866,30,2,3,1,1,1,2,0,0,1,5,2,2,0,0,0,5
9347,796426,7,3,3,3,3,0,0,0,0,1,1,0,0,0,0,0,6
9347,780493,23,0,3,0,1,0,2,0,0,0,2,0,0,0,0,0,0
9347,796427,1,0,0,0,0,0,0,0,0,0,0,0,0,0,0,0,0
9348,796372,20,2,3,2,3,0,0,0,0,0,3,0,5,1,1,0,4
9348,796377,35,4,9,3,5,1,4,0,0,0,5,7,2,0,2,0,9
9348,796379,36,4,12,2,5,2,7,0,0,0,2,2,3,1,2,0,10
9348,790815,21,3,7,1,3,2,4,4,6,0,5,0,3,2,0,0,12
9348,780176,38,3,9,1,2,2,7,9,10,0,5,1,1,0,2,0,17
9348,786013,19,2,4,2,4,0,0,2,6,1,2,0,1,1,0,2,6
9348,796378,7,1,5,1,3,0,2,0,0,0,0,0,0,0,0,0,2
9348,796374,24,0,1,0,1,0,0,1,2,1,0,0,2,0,0,0,1
9349,781480,39,2,9,1,4,1,5,1,4,2,9,4,4,1,2,0,6
9349,774846,29,6,10,6,10,0,0,6,7,2,2,0,2,1,1,0,18
9349,791376,30,0,3,0,1,0,2,0,0,0,1,1,3,0,1,0,0
9349,797272,30,3,9,2,2,1,7,0,0,0,5,2,3,0,6,0,7
9349,766611,36,7,16,4,7,3,9,2,3,2,3,2,0,1,2,0,19
9349,786185,11,0,3,0,3,0,0,0,0,2,1,0,0,0,2,1,0
9349,797182,4,0,1,0,1,0,0,0,0,0,2,0,0,0,0,0,0
9349,797273,21,1,2,1,2,0,0,4,4,0,7,0,4,0,1,0,6
9349,791377,0,0,0,0,0,0,0,0,0,0,0,0,2,0,0,0,0
9350,776100,29,1,3,0,2,1,1,3,7,3,5,0,1,1,1,0,6
9350,785991,28,1,5,1,5,0,0,5,6,2,7,0,4,0,1,4,7
9350,781406,32,5,9,2,3,3,6,6,6,1,3,1,1,1,7,0,19
9350,781401,28,1,9,1,5,0,4,3,4,2,5,0,1,1,2,1,5
9350,775317,14,1,3,1,1,0,2,0,0,0,0,0,1,1,1,0,2
9350,797760,6,1,1,0,0,1,1,0,0,0,1,1,0,0,0,0,3
9350,792133,26,3,7,2,4,1,3,2,2,1,2,3,1,1,2,0,9
9350,797762,21,0,4,0,3,0,1,0,0,0,1,2,3,0,3,0,0
9350,781029,16,2,3,0,0,2,3,3,3,0,3,1,0,1,0,0,9
9351,786540,24,2,8,2,7,0,1,6,7,2,7,0,3,1,1,3,10
9351,792019,17,0,4,0,1,0,3,0,0,0,1,1,2,0,0,1,0
9351,792015,36,9,19,5,11,4,8,1,2,0,3,4,1,2,2,0,23
9351,791845,26,3,5,3,4,0,1,1,1,0,3,0,4,0,2,0,7
9351,775995,37,1,6,1,3,0,3,1,2,2,3,3,2,2,1,0,3
9351,785364,16,2,4,2,4,0,0,0,0,1,1,0,4,1,2,1,4
9351,781147,13,0,1,0,1,0,0,0,0,0,0,0,1,1,1,1,0
9351,792016,31,4,7,2,2,2,5,0,0,0,2,1,3,3,1,0,10
9352,785714,22,5,7,5,7,0,0,0,0,3,7,4,2,0,1,0,10
9352,775894,28,4,10,2,7,2,3,2,7,0,5,2,2,1,0,0,12
9352,785711,32,10,12,5,5,5,7,7,8,0,2,0,3,1,1,0,32
9352,780985,34,3,6,1,2,2,4,1,2,0,8,6,1,0,2,0,9
9352,775266,34,4,15,1,7,3,8,4,4,0,1,3,1,2,0,0,15
9352,796829,15,3,4,3,4,0,0,1,2,4,0,0,2,0,0,0,7
9352,791167,20,2,5,2,4,0,1,0,0,0,4,4,2,1,1,1,4
9352,779994,5,1,2,1,1,0,1,0,0,0,0,0,2,0,2,0,2
9352,785378,3,0,0,0,0,0,0,0,0,0,1,1,1,0,1,0,0
9352,796826,1,0,0,0,0,0,0,0,0,0,1,0,0,0,0,0,0
9352,796827,2,1,1,1,1,0,0,0,0,0,0,0,0,0,0,0,2
9352,780988,1,0,0,0,0,0,0,0,0,1,1,0,0,0,0,0,0
9352,796828,2,0,1,0,0,0,1,0,0,0,0,0,1,0,0,0,0
9352,785710,1,0,0,0,0,0,0,0,0,0,0,0,0,0,0,0,0
9353,785498,27,8,11,7,8,1,3,2,2,0,2,0,2,0,1,0,19
9353,776469,11,3,7,3,5,0,2,0,2,2,2,1,1,0,1,1,6
9353,796705,36,10,18,7,10,3,8,6,7,0,6,4,3,0,3,0,29
9353,796708,32,3,6,3,5,0,1,5,7,1,2,4,4,0,0,0,11
9353,776322,35,2,11,1,4,1,7,2,2,0,2,0,1,1,1,0,7
9353,796706,28,0,2,0,1,0,1,0,0,0,6,0,4,1,1,1,0
9353,780704,8,0,1,0,0,0,1,0,0,0,1,0,0,0,1,0,0
9353,791036,10,0,0,0,0,0,0,1,2,0,1,0,3,1,0,0,1
9353,780700,10,0,2,0,0,0,2,0,0,0,1,0,2,0,0,0,0
9353,791037,3,0,1,0,0,0,1,0,0,0,0,0,0,0,0,0,0
9354,786054,22,8,10,8,10,0,0,0,0,3,1,1,2,1,2,0,16
9354,791964,23,2,8,0,4,2,4,0,0,0,3,3,0,0,0,1,6
9354,786056,35,1,4,0,1,1,3,0,0,0,5,4,3,2,0,0,3
9354,781339,30,2,9,0,1,2,8,0,0,0,3,0,1,0,1,0,6
9354,781337,36,7,18,3,6,4,12,3,3,0,5,3,2,1,2,0,21
9354,797712,8,0,1,0,1,0,0,0,0,1,1,0,0,0,0,0,0
9354,792041,12,1,1,1,1,0,0,2,2,0,2,0,2,0,1,1,4
9354,799737,8,0,2,0,0,0,2,0,0,0,0,1,0,0,0,0,0
9354,797711,25,2,7,1,1,1,6,0,0,1,0,1,3,2,1,0,5
9354,797710,1,0,1,0,0,0,1,0,0,0,0,0,0,0,0,0,0
9355,791616,27,3,5,3,5,0,0,0,0,2,3,0,2,0,0,0,6
9355,780797,30,4,8,3,5,1,3,0,1,3,4,0,0,0,2,1,9
9355,785505,35,6,13,6,12,0,1,1,1,0,5,6,1,0,4,0,13
9355,780555,36,5,9,1,2,4,7,0,0,2,3,1,1,1,0,1,14
9355,775604,32,1,8,1,5,0,3,0,0,0,8,1,2,0,2,1,2
9355,796981,27,7,12,6,10,1,2,1,1,0,1,0,1,4,2,0,16
9355,791618,13,1,4,1,2,0,2,0,0,0,0,1,2,1,0,0,2
9356,786123,29,4,5,4,5,0,0,0,0,1,4,2,3,0,1,7,8
9356,780437,35,7,13,7,9,0,4,3,4,2,5,2,1,1,0,1,17
9356,797673,40,4,13,3,9,1,4,6,6,3,4,3,0,2,2,0,15
9356,786118,27,3,7,1,1,2,6,1,2,0,0,0,4,1,0,0,9
9356,786117,40,5,10,5,7,0,3,2,2,1,9,6,0,0,2,1,12
9356,797675,11,1,2,1,2,0,0,0,0,0,2,0,2,0,0,0,2
9356,797672,7,1,1,1,1,0,0,0,0,1,0,0,0,0,1,0,2
9356,792093,11,2,6,0,2,2,4,0,0,0,0,2,0,1,1,0,6
9357,791809,11,1,2,1,2,0,0,0,0,0,1,0,0,0,1,0,2
9357,780651,21,2,8,2,8,0,0,0,0,2,3,1,4,0,2,1,4
9357,791815,31,5,11,5,7,0,4,0,0,0,4,0,1,0,0,0,10
9357,791810,34,0,4,0,2,0,2,1,2,0,2,9,2,0,2,0,1
9357,780650,36,3,9,2,6,1,3,4,6,2,5,3,0,5,5,1,11
9357,791812,10,1,2,0,0,1,2,0,0,0,0,0,4,0,0,0,3
9357,781596,11,2,6,2,6,0,0,2,2,1,0,0,1,0,0,0,6
9357,791814,21,3,6,0,1,3,5,0,0,0,0,0,1,0,0,0,9
9357,786645,21,2,4,2,3,0,1,3,4,0,2,0,3,0,1,0,7
9357,786644,4,0,0,0,0,0,0,0,0,0,0,0,0,0,0,0,0
9358,781629,10,1,2,0,0,1,2,2,2,2,0,1,2,0,3,0,5
9358,775739,15,1,4,1,4,0,0,1,2,1,4,0,3,0,1,1,3
9358,797019,18,1,4,1,3,0,1,2,2,0,0,1,2,1,3,0,4
9358,781378,29,6,12,2,6,4,6,1,1,0,6,1,2,1,1,0,17
9358,774959,21,2,5,2,3,0,2,1,1,0,2,2,0,0,1,0,5
9358,791440,14,0,2,0,2,0,0,0,0,0,1,0,4,1,2,1,0
9358,797015,8,0,1,0,0,0,1,0,0,0,1,0,1,0,0,0,0
9358,797013,19,6,12,5,6,1,6,1,2,1,1,2,0,0,1,0,14
9358,797016,20,3,6,0,0,3,6,3,4,1,1,3,0,1,0,0,12
9358,791441,22,3,8,2,6,1,2,0,0,1,1,0,2,0,3,0,7
9358,775267,17,1,6,0,1,1,5,0,0,0,2,1,1,0,2,0,3
9358,789009,2,0,2,0,0,0,2,0,0,0,1,0,0,0,0,0,0
9358,791443,5,0,0,0,0,0,0,0,0,0,0,0,0,0,0,0,0
9359,797861,26,4,8,4,8,0,0,0,2,6,6,3,2,2,1,0,8
9359,797859,21,5,7,5,5,0,2,1,2,0,2,0,3,0,4,1,11
9359,792208,31,6,13,6,12,0,1,4,5,2,4,5,1,3,2,1,16
9359,786262,38,5,10,1,4,4,6,1,2,0,3,1,2,1,0,1,15
9359,781314,22,6,12,3,6,3,6,0,0,1,7,3,4,1,4,0,15
9359,776018,12,2,5,2,5,0,0,1,2,0,4,1,1,1,1,1,5
9359,797856,3,1,1,1,1,0,0,0,0,0,0,0,1,0,0,0,2
9359,792204,10,2,5,1,2,1,3,1,2,0,1,0,1,0,1,0,6
9359,781317,21,2,3,1,1,1,2,0,0,0,1,2,2,1,0,0,5
9359,786983,7,2,4,2,4,0,0,2,2,4,0,1,1,0,0,0,6
9359,797862,2,1,1,1,1,0,0,0,0,1,0,0,1,0,0,0,2
9359,797858,2,0,1,0,1,0,0,0,0,0,3,0,1,0,0,0,0
9359,786682,3,1,2,0,0,1,2,0,0,0,0,0,0,0,0,0,3
9359,792206,2,0,0,0,0,0,0,0,0,0,0,0,0,0,0,0,0
9360,780181,25,7,12,3,4,4,8,4,10,1,2,1,3,1,0,0,22
9360,791340,34,7,11,5,7,2,4,1,4,0,1,6,2,3,2,1,17
9360,776089,36,4,12,2,7,2,5,2,4,0,3,3,3,5,0,1,12
9360,780227,17,1,4,1,3,0,1,1,1,0,0,1,4,0,1,0,3
9360,775758,22,0,0,0,0,0,0,0,0,1,4,0,3,1,2,0,0
9360,789178,22,4,5,1,1,3,4,0,0,0,3,0,3,2,0,0,11
9360,789177,20,2,2,2,2,0,0,0,2,1,6,2,4,1,0,0,4
9360,791336,13,2,4,2,4,0,0,0,0,1,0,4,0,1,0,0,4
9360,797260,6,2,2,2,2,0,0,0,0,1,0,0,0,0,1,0,4
9360,797265,1,1,1,1,1,0,0,0,0,0,0,0,0,0,0,0,2
9360,797261,1,0,0,0,0,0,0,0,0,0,0,0,0,0,0,0,0
9360,797262,1,0,0,0,0,0,0,0,0,1,0,0,0,0,0,0,0
9360,797264,1,0,1,0,0,0,1,0,0,0,0,0,0,0,0,0,0
9360,797266,1,0,1,0,0,0,1,0,0,0,1,0,0,0,0,0,0
9361,792318,30,6,8,6,8,0,0,2,5,5,8,1,0,0,3,0,14
9361,796519,32,1,5,0,3,1,2,5,6,0,8,0,4,0,5,0,8
9361,775329,34,1,7,1,3,0,4,5,9,2,1,1,2,2,3,0,7
9361,786717,28,2,7,2,3,0,4,3,5,1,3,1,4,0,1,0,7
9361,780753,32,3,10,3,9,0,1,0,0,1,0,0,3,0,4,0,6
9361,796520,20,3,6,1,2,2,4,2,2,0,1,0,0,0,2,0,10
9361,792308,3,1,3,1,3,0,0,0,0,0,0,0,0,0,0,0,2
9361,796518,21,0,1,0,0,0,1,0,0,0,0,2,0,0,2,0,0
9361,792310,0,0,0,0,0,0,0,0,0,0,0,0,0,0,0,0,0
9362,792035,35,11,20,11,20,0,0,3,3,0,4,7,2,0,2,3,25
9362,780833,25,4,5,4,5,0,0,6,6,3,3,1,0,0,0,1,14
9362,792034,38,7,9,3,3,4,6,0,0,0,11,7,1,1,3,1,18
9362,791688,29,3,8,1,2,2,6,0,0,0,1,4,3,3,0,0,8
9362,780830,36,1,4,0,1,1,3,3,4,0,6,0,4,0,2,1,6
9362,797645,13,2,3,2,3,0,0,0,0,0,2,1,2,0,1,0,4
9362,785980,17,2,4,1,2,1,2,0,0,0,1,2,0,1,1,0,5
9362,785381,5,1,4,1,2,0,2,2,2,0,1,0,1,1,0,0,4
9362,785982,1,0,0,0,0,0,0,0,0,0,0,0,1,0,0,0,0
9362,797644,1,0,1,0,1,0,0,0,0,0,0,0,0,0,0,0,0
9363,780569,27,2,5,2,5,0,0,0,0,2,1,0,3,1,1,1,4
9363,791695,12,1,3,1,3,0,0,0,0,1,5,0,0,0,0,0,2
9363,791696,25,3,10,2,5,1,5,1,2,1,3,2,4,0,2,0,8
9363,781556,28,3,7,3,7,0,0,0,0,1,1,1,2,1,1,0,6
9363,780565,33,9,16,3,6,6,10,2,2,0,2,2,4,0,2,0,26
9363,797433,13,1,3,1,3,0,0,0,1,1,2,0,3,0,1,2,2
9363,797432,22,4,9,1,4,3,5,2,3,0,3,0,1,1,2,1,13
9363,797436,11,0,3,0,0,0,3,0,0,0,3,2,0,1,0,0,0
9363,785824,28,4,9,3,6,1,3,1,1,0,2,1,1,0,1,0,10
9363,791694,1,0,0,0,0,0,0,0,0,0,0,0,0,0,0,0,0
9364,792110,12,2,3,2,3,0,0,2,2,1,3,0,3,0,0,0,6
9364,786031,37,5,10,3,5,2,5,2,2,1,8,1,2,1,2,0,14
9364,797734,22,3,7,3,6,0,1,2,2,0,3,2,4,1,3,0,8
9364,797735,40,5,13,5,12,0,1,7,9,0,4,2,2,2,3,0,17
9364,781386,37,5,11,4,5,1,6,6,6,1,4,1,2,2,2,0,17
9364,786033,28,2,6,2,6,0,0,0,0,4,6,0,1,0,3,3,4
9364,797733,23,3,7,2,3,1,4,0,0,1,5,1,1,1,1,0,7
9364,792107,1,0,0,0,0,0,0,0,0,0,0,0,0,0,1,0,0
9365,791356,36,5,11,5,9,0,2,2,2,2,6,3,2,3,4,2,12
9365,797431,31,3,10,1,6,2,4,0,0,1,0,3,3,0,2,0,8
9365,791680,12,2,5,0,2,2,3,0,0,0,2,0,5,0,0,1,6
9365,785812,37,5,11,3,6,2,5,3,4,2,3,2,4,0,1,1,15
9365,780104,39,3,15,1,10,2,5,2,2,1,4,2,1,2,3,0,10
9365,791681,18,1,2,1,2,0,0,0,0,2,0,0,0,0,0,2,2
9365,791683,27,3,15,3,13,0,2,1,2,1,5,2,1,1,3,1,7
9366,796838,31,2,4,2,4,0,0,1,2,2,5,2,2,3,2,3,5
9366,796837,33,5,10,2,5,3,5,0,1,1,12,0,3,0,5,0,13
9366,796834,35,3,5,3,3,0,2,1,1,0,1,6,3,0,1,0,7
9366,785700,31,6,8,6,8,0,0,0,4,0,4,6,4,2,1,0,12
9366,780269,38,11,22,9,15,2,7,1,3,0,3,4,1,0,1,0,25
9366,791171,9,0,4,0,4,0,0,0,0,3,2,0,2,0,1,0,0
9366,796833,4,0,1,0,0,0,1,0,0,1,0,0,1,0,0,0,0
9366,785706,19,1,7,0,0,1,7,0,0,0,0,1,2,0,1,0,3
9367,785152,20,0,1,0,1,0,0,4,4,2,1,1,1,0,2,0,4
9367,775821,27,4,11,4,9,0,2,1,2,3,5,4,1,2,1,1,9
9367,792453,38,2,8,1,5,1,3,6,7,1,2,5,2,1,5,0,11
9367,785131,32,6,14,4,6,2,8,4,6,2,5,3,2,1,0,0,18
9367,781538,15,2,7,2,2,0,5,0,0,0,2,0,2,0,1,0,4
9367,798113,11,1,3,1,3,0,0,2,2,0,2,0,0,1,1,1,4
9367,798115,26,2,8,1,2,1,6,0,0,0,2,0,0,0,0,0,5
9367,792324,18,3,3,2,2,1,1,2,2,1,4,0,2,1,0,0,9
9367,776233,13,1,4,1,2,0,2,0,2,0,2,0,2,1,0,0,2
9368,776327,11,0,1,0,1,0,0,0,0,1,1,0,3,0,0,0,0
9368,792104,35,7,15,6,9,1,6,7,7,1,5,0,1,2,2,0,22
9368,797709,23,3,8,1,5,2,3,0,0,2,0,1,0,0,1,0,8
9368,786198,31,4,6,3,5,1,1,2,4,0,5,5,3,1,2,0,11
9368,775779,31,3,7,3,6,0,1,1,2,0,5,5,0,2,4,0,7
9368,785608,3,0,2,0,0,0,2,0,0,0,0,0,0,0,0,1,0
9368,797707,21,5,6,4,4,1,2,3,3,1,0,3,3,1,4,0,14
9368,792106,14,1,2,0,1,1,1,0,0,0,1,1,3,2,1,0,3
9368,786180,13,2,2,2,2,0,0,0,0,1,1,1,1,0,0,1,4
9368,786204,18,4,7,0,1,4,6,0,0,1,5,1,2,0,1,0,12
9368,799162,0,0,0,0,0,0,0,0,0,0,0,0,0,0,0,0,0
9369,780765,38,6,13,5,9,1,4,2,4,1,9,4,1,0,3,0,15
9369,781301,28,3,3,3,3,0,0,3,5,3,4,3,1,0,0,3,9
9369,786255,33,2,11,2,6,0,5,6,6,3,4,1,0,2,0,0,10
9369,780762,29,3,9,1,3,2,6,0,0,1,0,2,4,1,3,0,8
9369,780768,35,5,8,4,7,1,1,2,2,0,1,3,3,4,2,0,13
9369,791729,10,2,4,2,3,0,1,0,0,2,0,1,1,0,0,0,4
9369,776241,18,3,7,0,2,3,5,1,2,0,0,1,2,0,2,0,10
9369,780755,9,0,4,0,4,0,0,2,2,1,0,0,0,0,0,0,2
9369,797319,0,0,0,0,0,0,0,0,0,0,0,0,0,0,1,0,0
9370,780913,22,3,4,3,3,0,1,0,0,0,2,1,3,0,1,0,6
9370,798127,4,0,1,0,0,0,1,0,0,0,0,0,0,1,0,0,0
9370,780594,34,4,10,2,5,2,5,2,2,0,3,2,2,1,1,0,12
9370,775664,34,3,6,2,4,1,2,4,5,0,3,3,0,0,0,0,11
9370,798117,37,7,9,4,5,3,4,0,0,0,3,13,2,3,2,0,17
9370,798123,24,12,16,11,15,1,1,1,2,2,5,1,4,1,2,0,26
9370,798124,21,2,7,1,4,1,3,0,0,1,6,2,1,1,2,0,5
9370,798121,24,3,4,1,2,2,2,0,1,0,2,1,1,1,0,0,8
9371,785829,28,5,6,5,6,0,0,2,2,0,5,1,0,0,0,0,12
9371,775838,33,2,8,2,7,0,1,1,2,2,5,5,3,0,2,0,5
9371,786531,37,12,20,7,10,5,10,1,1,1,3,3,0,0,2,0,30
9371,796729,28,4,8,3,6,1,2,1,1,0,1,2,2,0,2,0,10
9371,791048,34,3,8,1,5,2,3,4,4,2,6,4,3,2,2,1,12
9371,796727,25,2,4,1,2,1,2,0,0,0,2,1,3,1,0,1,5
9371,796728,4,1,3,1,3,0,0,0,0,0,0,0,0,0,0,0,2
9371,791044,8,1,4,1,4,0,0,0,0,0,0,0,1,2,2,0,2
9371,780723,3,0,0,0,0,0,0,0,0,0,0,0,1,0,0,0,0
9372,786656,17,1,1,1,1,0,0,0,4,3,2,0,3,0,1,4,2
9372,792219,24,3,4,3,4,0,0,3,4,2,7,0,1,0,3,1,9
9372,792221,10,2,4,2,2,0,2,0,0,1,2,1,0,1,2,1,4
9372,781329,35,6,10,3,6,3,4,4,5,2,6,7,3,1,5,0,19
9372,776059,5,0,2,0,1,0,1,0,0,0,0,0,0,0,1,0,0
9372,797876,3,0,1,0,1,0,0,1,2,0,1,0,0,0,0,0,1
9372,792222,14,1,4,0,0,1,4,0,0,0,2,1,1,0,1,0,3
9372,781408,21,2,4,1,2,1,2,2,2,2,3,0,4,1,2,0,7
9372,792046,6,0,2,0,0,0,2,0,0,0,0,0,2,1,1,0,0
9372,792447,1,0,0,0,0,0,0,0,0,0,0,1,0,0,0,0,0
9372,786691,29,1,11,1,5,0,6,2,3,1,3,0,1,0,0,1,4
9372,786693,22,2,6,2,2,0,4,0,0,0,1,0,3,0,2,1,4
9372,781455,13,2,2,1,1,1,1,0,0,0,0,2,1,0,1,0,5
9373,791868,18,2,5,2,5,0,0,0,0,0,2,1,2,0,1,0,4
9373,797802,20,1,5,1,4,0,1,0,0,1,1,6,4,2,0,1,2
9373,797809,30,5,11,5,10,0,1,1,3,1,2,1,4,1,0,0,11
9373,797807,38,9,12,8,10,1,2,5,6,1,6,5,1,1,1,0,24
9373,786058,29,1,4,1,3,0,1,0,1,0,2,3,3,1,0,0,2
9373,795730,32,6,11,4,7,2,4,1,2,0,1,2,1,1,3,1,15
9373,797810,4,1,2,1,2,0,0,0,0,0,1,0,0,0,0,0,2
9373,797808,12,2,3,2,3,0,0,0,0,1,0,0,2,1,0,0,4
9373,792264,17,2,6,2,5,0,1,1,2,1,7,2,1,2,2,0,5
9373,797812,0,0,0,0,0,0,0,0,0,0,0,0,0,0,0,0,0
9374,782133,32,4,9,0,2,4,7,0,0,1,2,1,1,1,0,1,12
9374,785123,27,10,15,10,15,0,0,3,5,1,3,2,1,0,0,3,23
9374,790990,23,2,7,0,1,2,6,0,0,2,3,3,4,0,1,0,6
9374,789219,34,6,10,3,4,3,6,0,0,1,1,0,2,2,3,0,15
9374,785059,36,5,12,4,9,1,3,2,3,4,4,8,1,2,4,1,13
9374,785305,3,0,0,0,0,0,0,0,0,0,0,0,0,0,0,0,0
9374,796622,8,1,2,1,2,0,0,0,0,1,0,0,2,0,0,0,2
9374,796623,18,0,6,0,2,0,4,0,0,0,2,1,3,0,1,0,0
9374,785122,15,0,3,0,0,0,3,0,0,0,1,2,1,0,1,0,0
9374,796624,1,0,0,0,0,0,0,0,0,0,0,0,0,0,0,0,0
9374,790989,1,0,0,0,0,0,0,0,0,0,0,0,0,0,0,0,0
9374,790988,1,0,0,0,0,0,0,0,0,0,0,0,0,0,0,0,0
9374,785303,1,0,0,0,0,0,0,0,0,0,0,0,0,0,0,0,0
9375,797292,29,12,19,12,19,0,0,3,3,7,5,2,1,0,2,2,27
9375,780509,28,1,2,1,1,0,1,0,0,1,2,0,1,1,2,3,2
9375,797290,31,5,12,3,6,2,6,2,2,0,1,3,1,0,3,0,14
9375,797291,23,1,3,1,1,0,2,2,2,0,0,5,0,0,1,0,4
9375,786064,33,7,11,3,6,4,5,4,5,1,12,2,2,0,0,0,22
9375,791658,9,1,1,1,1,0,0,0,0,2,1,0,4,0,1,0,2
9375,785658,11,2,2,1,1,1,1,0,0,0,0,1,0,1,1,0,5
9375,791660,33,4,11,2,7,2,4,0,0,0,4,2,0,1,1,0,10
9375,791663,1,0,0,0,0,0,0,0,0,0,0,0,0,0,0,0,0
9375,791661,1,0,0,0,0,0,0,0,0,0,0,0,0,0,0,0,0
9375,797295,1,0,0,0,0,0,0,0,0,0,0,0,0,0,0,0,0
9376,775628,40,9,21,7,16,2,5,8,8,2,3,6,4,3,8,4,28
9376,799000,28,6,13,6,13,0,0,1,2,5,4,2,3,1,1,1,13
9376,775198,36,3,8,2,4,1,4,0,0,1,5,0,2,1,5,0,7
9376,780571,17,1,5,0,3,1,2,0,0,0,2,0,0,1,0,0,3
9376,780263,3,0,0,0,0,0,0,0,0,0,0,1,1,1,0,0,0
9376,785471,31,5,9,5,8,0,1,8,10,2,4,1,2,0,1,0,18
9376,786697,23,3,7,2,4,1,3,3,3,2,1,0,1,0,0,0,10
9376,792399,18,0,1,0,1,0,0,1,2,1,3,0,1,0,2,1,1
9376,792397,4,0,0,0,0,0,0,0,0,0,1,0,0,0,0,0,0
9377,797649,38,6,14,4,7,2,7,6,9,1,2,0,4,4,1,0,20
9377,792058,30,5,9,5,9,0,0,0,0,1,2,0,4,2,2,1,10
9377,789028,26,4,8,4,8,0,0,0,0,0,2,5,2,1,5,0,8
9377,792067,21,2,8,1,3,1,5,3,4,0,1,0,3,0,4,1,8
9377,775523,11,0,0,0,0,0,0,2,2,0,2,0,0,0,0,0,2
9377,789029,17,4,8,1,4,3,4,1,2,0,4,0,0,2,0,0,12
9377,789053,21,1,2,1,1,0,1,4,4,0,0,3,1,0,2,0,6
9377,792062,19,3,3,3,3,0,0,0,0,1,3,0,4,0,0,1,6
9377,790779,5,1,3,1,3,0,0,0,0,0,2,0,1,0,0,0,2
9377,786836,7,0,0,0,0,0,0,0,0,0,0,1,0,0,1,1,0
9377,792056,5,0,0,0,0,0,0,0,0,0,2,0,2,0,1,0,0
9378,774806,29,6,10,6,9,0,1,4,5,1,8,2,4,0,2,1,16
9378,775823,29,7,11,6,7,1,4,0,0,2,2,2,4,4,1,0,15
9378,791041,38,4,10,1,3,3,7,2,3,1,3,2,3,0,5,0,13
9378,789023,37,3,8,2,2,1,6,5,8,0,3,7,4,2,4,0,12
9378,791038,33,3,4,2,2,1,2,1,2,0,1,5,3,1,3,0,8
9378,775205,23,2,4,0,0,2,4,3,3,0,2,1,2,0,0,1,9
9378,796714,11,3,5,3,5,0,0,0,0,2,8,0,3,0,1,0,6
9379,797323,38,5,18,4,8,1,10,15,15,0,4,6,4,4,4,1,26
9379,786236,40,9,22,5,15,4,7,3,5,4,5,0,4,1,4,0,25
9379,797325,37,5,8,5,8,0,0,0,2,7,5,5,2,2,1,0,10
9379,797329,29,3,7,0,2,3,5,0,0,2,2,0,4,1,3,0,9
9379,797327,33,2,9,2,9,0,0,2,4,1,2,0,3,1,0,0,6
9379,776478,9,0,1,0,0,0,1,0,0,2,0,1,0,0,0,0,0
9379,781002,8,0,0,0,0,0,0,0,0,1,1,0,0,0,1,0,0
9379,786233,6,0,1,0,0,0,1,0,0,0,0,0,0,0,0,0,0
9379,786246,0,0,0,0,0,0,0,0,0,0,0,0,0,0,0,0,0
9380,797050,34,4,12,3,7,1,5,2,4,2,5,1,3,0,2,0,11
9380,780394,33,5,7,4,4,1,3,2,2,1,6,0,1,1,0,0,13
9380,780391,28,2,3,2,3,0,0,2,2,0,3,4,4,2,3,2,6
9380,790871,35,5,11,5,9,0,2,6,6,0,7,3,2,0,3,0,16
9380,776473,28,2,5,2,4,0,1,0,1,0,2,4,3,0,0,0,4
9380,797048,12,1,4,1,4,0,0,0,0,0,1,0,1,0,1,0,2
9380,780392,19,5,6,3,3,2,3,0,0,1,0,1,0,1,1,0,12
9380,791573,8,1,1,1,1,0,0,0,0,0,1,1,2,0,1,0,2
9380,785783,3,0,0,0,0,0,0,0,0,0,0,0,0,0,0,0,0
9381,791949,29,3,9,2,6,1,3,1,2,0,6,0,3,0,2,1,8
9381,797690,33,0,6,0,4,0,2,2,2,2,3,1,3,3,0,0,2
9381,797691,19,2,3,2,3,0,0,1,2,0,2,3,3,1,0,0,5
9381,797689,32,4,9,2,4,2,5,0,0,0,1,1,0,1,1,0,10
9381,780747,38,7,14,7,9,0,5,4,4,2,4,3,0,0,2,0,18
9381,776014,9,0,0,0,0,0,0,0,0,1,0,0,4,0,1,0,0
9381,785304,25,5,11,4,4,1,7,0,0,0,2,3,4,1,1,0,11
9381,784336,9,1,2,1,2,0,0,1,2,1,3,0,1,1,1,1,3
9381,791946,6,1,3,1,1,0,2,0,0,0,0,0,0,1,0,0,2
9381,791948,0,0,0,0,0,0,0,0,0,0,0,0,0,0,0,0,0
9382,797721,7,0,1,0,0,0,1,0,0,0,0,0,0,0,0,0,0
9382,786257,40,2,6,2,5,0,1,4,4,2,6,3,5,1,2,1,8
9382,786263,34,3,11,2,7,1,4,0,1,3,5,1,1,2,0,0,7
9382,785661,40,9,15,9,11,0,4,7,9,1,1,0,1,1,1,0,25
9382,775825,40,3,8,2,6,1,2,5,6,0,3,1,3,2,2,0,12
9382,792121,32,0,2,0,0,0,2,0,0,1,3,2,5,1,0,1,0
9382,797725,0,0,0,0,0,0,0,0,0,0,0,0,0,0,1,0,0
9382,792122,7,0,1,0,0,0,1,0,0,0,0,0,1,0,0,0,0
9383,786358,37,2,7,2,4,0,3,0,0,1,1,0,2,0,1,0,4
9383,775418,24,5,7,5,7,0,0,4,4,2,5,0,4,0,2,1,14
9383,780306,40,5,12,5,12,0,0,8,9,3,5,3,3,1,6,0,18
9383,797116,36,1,7,1,3,0,4,0,0,0,3,3,3,0,2,0,2
9383,780312,37,2,7,0,0,2,7,0,0,0,4,2,2,2,4,0,6
9383,791535,10,0,1,0,0,0,1,0,0,0,0,0,1,0,1,0,0
9383,775846,16,1,2,0,1,1,1,0,0,0,2,0,3,0,0,0,3
9384,796892,17,2,4,2,4,0,0,2,2,0,1,0,5,0,2,0,6
9384,796891,29,4,12,4,10,0,2,2,2,2,5,1,4,1,4,3,10
9384,796884,38,2,9,0,5,2,4,4,4,0,4,4,3,2,1,0,10
9384,796882,35,4,11,1,4,3,7,3,4,1,3,1,2,1,3,0,14
9384,790447,27,2,10,2,9,0,1,0,0,1,4,2,1,0,0,1,4
9384,796890,9,1,1,1,1,0,0,3,3,0,1,0,3,0,2,0,5
9384,796888,12,1,2,1,1,0,1,0,0,0,2,2,2,3,2,0,2
9384,796887,23,2,3,1,1,1,2,0,0,1,3,1,2,0,4,0,5
9384,796881,10,0,0,0,0,0,0,0,0,0,0,1,1,0,0,0,0
9385,781577,29,7,14,4,9,3,5,5,9,2,4,2,0,0,1,0,22
9385,775910,26,4,6,4,4,0,2,4,4,1,5,5,1,5,0,3,12
9385,786451,23,4,6,4,4,0,2,2,2,0,1,1,2,0,4,1,10
9385,780600,31,3,8,2,5,1,3,2,2,1,4,1,1,1,3,0,9
9385,781387,30,1,5,0,2,1,3,0,0,2,2,2,0,2,2,0,3
9385,800084,1,0,0,0,0,0,0,0,0,0,1,1,0,0,2,0,0
9385,791763,12,0,4,0,1,0,3,0,0,1,0,0,3,0,0,0,0
9385,790888,2,0,1,0,0,0,1,0,0,0,0,0,0,0,0,0,0
9385,786456,10,1,1,1,1,0,0,0,0,1,5,0,2,0,1,1,2
9385,780268,4,0,0,0,0,0,0,0,0,0,0,0,3,0,3,0,0
9385,797561,14,0,1,0,1,0,0,0,0,0,1,0,2,0,0,0,0
9385,780020,16,3,7,2,3,1,4,0,1,0,5,1,4,1,0,0,7
9385,793065,1,0,0,0,0,0,0,0,0,0,0,0,0,0,0,0,0
9385,786457,1,1,1,0,0,1,1,0,0,0,0,0,0,0,0,0,3
9386,791281,35,4,15,2,8,2,7,2,2,3,8,1,2,0,3,1,12
9386,792276,36,6,11,5,8,1,3,3,3,1,7,5,2,2,5,1,16
9386,791278,28,2,3,1,1,1,2,0,0,0,3,0,3,0,0,0,5
9386,786026,20,0,7,0,6,0,1,0,0,0,0,1,1,0,2,0,0
9386,785507,38,3,7,1,1,2,6,0,0,0,1,0,1,2,0,2,8
9386,796534,3,0,0,0,0,0,0,0,0,0,0,0,1,0,0,0,0
9386,785764,14,0,1,0,1,0,0,3,4,1,2,0,3,0,1,0,3
9386,796536,12,1,3,1,3,0,0,0,0,1,0,0,5,0,0,0,2
9386,796535,4,1,1,1,1,0,0,0,0,0,0,0,0,0,0,0,2
9386,785398,10,1,4,0,1,1,3,0,0,1,0,1,1,0,0,0,3
9387,781579,30,6,11,6,11,0,0,1,3,5,7,1,2,3,1,0,13
9387,775696,28,4,9,3,5,1,4,2,4,0,4,1,3,0,1,0,11
9387,786731,38,4,10,4,10,0,0,5,6,3,8,2,1,1,4,4,13
9387,798023,30,3,9,1,5,2,4,1,3,0,4,2,3,1,2,0,9
9387,780347,34,1,4,0,1,1,3,0,0,1,0,4,2,0,1,1,3
9387,776481,2,0,1,0,1,0,0,0,0,0,0,0,0,0,0,0,0
9387,798017,14,0,2,0,2,0,0,0,0,0,1,1,0,1,0,0,0
9387,798008,17,2,4,0,1,2,3,0,0,0,1,3,3,2,2,0,6
9387,792358,7,1,2,1,1,0,1,0,0,0,1,0,0,0,0,0,2
9388,786566,36,9,15,6,8,3,7,0,0,1,10,0,3,0,0,0,21
9388,786568,16,1,1,1,1,0,0,1,5,2,3,0,5,1,0,0,3
9388,791993,15,1,3,1,2,0,1,0,0,0,0,0,3,0,2,0,2
9388,781189,25,3,5,2,3,1,2,4,4,1,2,2,5,2,3,1,11
9388,781188,38,6,17,5,11,1,6,12,12,0,3,12,2,3,3,0,25
9388,791997,26,5,13,2,5,3,8,0,0,1,9,0,1,0,0,0,13
9388,781204,21,0,2,0,0,0,2,0,0,1,4,0,2,0,1,0,0
9388,786562,23,1,3,0,2,1,1,0,0,1,1,0,1,0,1,0,3
9389,786203,31,2,11,1,4,1,7,0,0,0,3,0,3,1,2,0,5
9389,786197,32,6,9,6,9,0,0,4,4,3,6,0,4,0,2,0,16
9389,780717,30,5,15,5,12,0,3,5,12,4,6,2,2,0,3,0,15
9389,791742,32,5,11,4,7,1,4,2,2,2,8,0,3,0,1,1,13
9389,776266,35,4,10,4,8,0,2,1,2,0,0,2,1,1,0,0,9
9389,776328,14,3,6,3,4,0,2,1,2,0,1,1,0,0,0,0,7
9389,791738,4,0,0,0,0,0,0,0,0,0,0,0,1,0,0,0,0
9389,791741,19,2,3,1,1,1,2,0,0,0,2,0,5,0,0,0,5
9389,774859,3,0,0,0,0,0,0,0,0,0,0,0,0,0,0,0,0
9390,785423,26,2,4,2,3,0,1,7,8,0,5,0,2,1,1,0,11
9390,775676,22,4,6,4,6,0,0,1,2,3,6,1,2,2,1,1,9
9390,786210,32,0,6,0,3,0,3,4,4,0,3,1,3,3,1,0,4
9390,785422,39,6,17,3,7,3,10,7,8,1,3,5,1,1,6,2,22
9390,774957,21,3,4,2,2,1,2,4,5,0,0,1,5,0,0,0,11
9390,786298,30,4,9,1,3,3,6,0,1,2,5,3,3,1,2,1,11
9390,785425,30,4,8,2,3,2,5,5,6,2,7,1,1,0,2,0,15
9391,781300,35,4,9,4,9,0,0,7,7,3,7,2,5,2,3,0,15
9391,790803,6,2,3,2,3,0,0,0,0,1,0,0,2,0,1,0,4
9391,790801,31,0,4,0,2,0,2,2,2,1,1,1,2,0,0,0,2
9391,781304,26,4,16,2,6,2,10,2,5,0,0,2,3,0,2,0,12
9391,781302,26,3,7,2,4,1,3,1,2,3,3,0,4,1,1,1,8
9391,796364,5,0,1,0,0,0,1,0,0,0,0,0,1,0,0,0,0
9391,796363,20,5,12,3,6,2,6,0,0,0,2,1,1,1,1,0,12
9391,796360,32,7,10,7,10,0,0,3,4,2,7,2,3,3,3,0,17
9391,781305,8,0,1,0,0,0,1,0,0,0,2,0,0,0,1,0,0
9391,780598,9,0,0,0,0,0,0,0,0,0,1,0,1,1,2,0,0
9391,790802,2,1,1,0,0,1,1,0,0,0,1,0,0,0,0,0,3
9392,776462,38,6,11,5,7,1,4,6,6,4,7,0,4,0,1,1,19
9392,775642,29,1,6,1,4,0,2,2,2,3,2,2,5,2,3,0,4
9392,791629,38,4,11,2,6,2,5,1,4,2,4,1,3,2,1,1,11
9392,796974,36,5,17,4,12,1,5,6,7,1,5,2,1,1,2,0,17
9392,781199,38,1,13,0,5,1,8,4,4,1,6,2,4,0,3,0,7
9392,791626,15,0,1,0,1,0,0,0,0,0,0,0,1,0,1,1,0
9392,791628,12,2,2,1,1,1,1,3,3,0,2,1,3,0,0,0,8
9392,786720,19,1,3,1,2,0,1,2,3,0,1,3,0,1,2,0,4
9393,780634,31,3,9,3,9,0,0,3,7,3,12,0,3,0,0,0,9
9393,791826,29,2,4,2,3,0,1,0,0,0,0,2,2,0,2,1,4
9393,786785,29,4,9,1,2,3,7,0,0,0,3,1,4,0,3,0,11
9393,780633,43,3,11,0,5,3,6,3,3,0,5,4,5,1,4,1,12
9393,776009,38,8,13,7,11,1,2,6,9,1,4,7,2,4,4,1,23
9393,797389,14,0,0,0,0,0,0,0,0,0,4,0,1,1,0,0,0
9393,786783,27,2,7,2,6,0,1,2,3,1,2,0,3,4,1,0,6
9393,786784,14,5,9,4,6,1,3,1,2,1,2,0,3,0,0,0,12
9394,791846,23,1,4,1,3,0,1,0,0,1,1,2,2,0,2,1,2
9394,797222,26,5,8,5,8,0,0,3,4,4,6,1,2,2,3,1,13
9394,781526,21,6,10,5,9,1,1,2,2,3,0,1,3,0,4,1,15
9394,797218,33,7,13,1,3,6,10,1,3,0,4,3,0,1,2,0,21
9394,775697,28,7,13,1,2,6,11,0,0,1,4,7,0,0,2,0,20
9394,797223,11,1,2,1,2,0,0,0,0,1,2,0,3,0,1,0,2
9394,791453,10,0,4,0,0,0,4,2,2,0,2,1,0,2,0,1,2
9394,791454,13,3,6,3,6,0,0,1,1,2,6,0,3,0,0,0,7
9394,797217,19,1,3,1,3,0,0,4,4,0,3,2,2,0,0,1,6
9394,797221,6,1,2,1,2,0,0,0,2,0,2,0,2,0,1,0,2
9394,786291,3,1,2,1,2,0,0,0,0,1,1,0,0,0,0,0,2
9394,791455,2,0,0,0,0,0,0,0,0,0,0,0,0,1,2,0,0
9394,781529,3,0,0,0,0,0,0,0,0,0,0,0,0,1,0,0,0
9394,798339,2,0,0,0,0,0,0,0,0,0,0,0,0,0,0,0,0
9395,785458,30,6,12,5,9,1,3,3,7,0,5,2,4,0,2,0,16
9395,780798,26,3,5,3,3,0,2,0,0,0,2,1,0,0,0,2,6
9395,800055,8,1,1,1,1,0,0,0,0,0,1,0,1,0,0,1,2
9395,785454,28,1,11,0,7,1,4,1,2,0,2,4,2,2,4,0,4
9395,785453,31,2,10,2,5,0,5,2,2,1,3,0,1,1,3,0,6
9395,790915,14,6,9,6,9,0,0,2,2,1,2,1,2,0,0,0,14
9395,790914,13,4,4,4,4,0,0,0,0,1,1,0,2,0,1,0,8
9395,790913,30,0,8,0,7,0,1,1,2,3,3,6,2,1,4,0,1
9395,774940,7,0,2,0,2,0,0,0,0,0,0,0,1,0,1,0,0
9395,790911,5,2,2,2,2,0,0,1,1,1,1,0,1,1,0,0,5
9395,790912,2,0,2,0,1,0,1,0,0,0,0,0,0,0,1,0,0
9395,785456,4,1,1,1,1,0,0,0,1,1,1,0,0,0,1,0,2
9395,796458,2,0,1,0,0,0,1,0,0,1,0,0,0,0,0,1,0
9396,785800,23,5,10,2,4,3,6,0,0,1,5,0,3,0,1,0,13
9396,785799,20,3,5,3,5,0,0,3,4,2,2,0,2,0,0,1,9
9396,791676,28,0,6,0,1,0,5,3,4,0,5,6,2,0,2,0,3
9396,780554,23,1,6,1,5,0,1,0,0,0,2,1,2,0,1,1,2
9396,780553,32,8,14,8,13,0,1,5,5,1,5,2,4,2,6,1,21
9396,797426,4,0,1,0,1,0,0,0,0,0,0,1,2,1,0,0,0
9396,791678,10,1,1,1,1,0,0,0,0,1,3,1,0,0,0,0,2
9396,785807,6,1,3,0,0,1,3,0,0,0,0,0,0,0,0,0,3
9396,780760,20,4,6,1,3,3,3,2,2,1,1,1,4,0,0,2,13
9396,797427,23,4,9,2,4,2,5,0,0,0,3,0,0,1,0,0,10
9396,791677,11,1,2,1,1,0,1,2,2,0,2,0,0,3,0,0,4
9397,792249,27,3,4,3,4,0,0,0,0,1,4,0,1,0,2,0,6
9397,781430,34,6,11,6,8,0,3,3,7,3,6,2,5,1,3,0,15
9397,792248,36,5,12,2,3,3,9,5,6,0,1,1,2,1,0,0,18
9397,781445,31,3,14,3,6,0,8,6,6,1,6,0,1,1,2,0,12
9397,768845,31,4,14,3,10,1,4,2,2,0,4,2,2,1,3,1,11
9397,781448,23,2,2,2,2,0,0,0,0,3,7,3,1,1,1,0,4
9397,792250,15,2,3,1,1,1,2,1,2,0,0,0,0,2,1,0,6
9397,792251,3,0,0,0,0,0,0,0,0,0,0,0,0,0,0,0,0
9398,791140,28,4,6,4,6,0,0,3,9,1,6,0,4,0,0,3,11
9398,791138,30,1,2,1,2,0,0,4,7,4,3,1,1,1,0,0,6
9398,786084,33,4,8,3,4,1,4,7,10,1,5,3,4,0,2,1,16
9398,780910,33,5,13,4,7,1,6,5,6,0,6,3,3,2,3,0,16
9398,780288,23,0,6,0,3,0,3,4,6,0,2,1,1,1,0,0,4
9398,796794,12,3,6,3,6,0,0,0,0,1,1,0,2,0,0,0,6
9398,780912,7,1,2,1,1,0,1,0,0,1,0,0,0,0,1,0,2
9398,780911,20,6,10,3,5,3,5,1,1,1,4,0,0,0,0,0,16
9398,781635,14,0,1,0,0,0,1,0,0,1,2,1,2,0,0,0,0
9399,780282,32,5,9,5,9,0,0,4,4,4,10,2,3,1,0,4,14
9399,785330,21,2,6,1,2,1,4,0,0,0,3,1,5,0,0,0,5
9399,780277,36,3,14,2,10,1,4,5,5,0,5,0,2,1,3,0,12
9399,785327,32,4,10,3,5,1,5,0,0,1,5,2,4,2,1,0,9
9399,780280,37,11,20,9,15,2,5,3,3,0,1,1,3,0,2,0,27
9399,785329,10,0,1,0,0,0,1,0,0,0,3,2,3,0,1,0,0
9399,796662,10,0,1,0,0,0,1,2,2,0,1,0,1,0,0,0,2
9399,791003,5,0,1,0,1,0,0,0,0,1,0,1,0,0,0,0,0
9399,785326,14,0,1,0,0,0,1,0,0,0,2,0,4,0,1,0,0
9399,780279,3,0,0,0,0,0,0,0,0,0,0,0,2,0,0,0,0
9400,775897,27,5,6,5,6,0,0,0,0,2,1,3,4,1,0,0,10
9400,780324,31,8,14,8,14,0,0,2,2,3,8,4,3,1,3,3,18
9400,791543,29,3,7,1,3,2,4,4,5,0,1,3,1,0,0,0,12
9400,786530,35,3,8,0,1,3,7,0,0,0,2,1,0,0,2,0,9
9400,780317,32,5,8,2,2,3,6,1,1,0,5,2,2,2,1,0,14
9400,797092,9,0,1,0,1,0,0,0,0,0,1,1,0,0,0,0,0
9400,791545,13,1,3,1,3,0,0,0,0,0,1,1,1,0,2,0,2
9400,791547,3,0,0,0,0,0,0,0,0,0,0,0,1,0,0,0,0
9400,784246,18,0,3,0,2,0,1,0,0,2,4,2,1,0,0,0,0
9400,797091,1,0,0,0,0,0,0,0,0,0,1,0,0,0,0,0,0
9400,775437,1,0,1,0,0,0,1,0,0,0,0,0,0,0,0,0,0
9400,791546,1,0,0,0,0,0,0,0,0,0,0,0,0,0,0,0,0
9401,791391,32,3,6,3,6,0,0,2,3,2,1,0,1,0,1,2,8
9401,797156,17,1,5,1,3,0,2,0,0,1,1,0,2,0,2,0,2
9401,791390,37,6,13,5,11,1,2,0,0,2,5,1,1,2,0,1,13
9401,775743,18,1,4,1,4,0,0,0,0,0,1,1,2,0,1,0,2
9401,780130,39,4,13,4,10,0,3,3,3,1,2,2,0,2,0,0,11
9401,791388,9,1,2,0,0,1,2,0,0,0,2,0,2,1,2,0,3
9401,780133,27,1,5,1,4,0,1,0,0,0,5,0,0,0,2,0,2
9401,780407,16,3,4,1,2,2,2,0,0,0,0,1,0,1,1,0,8
9401,797158,3,0,0,0,0,0,0,0,0,1,0,0,0,0,0,0,0
9401,791389,1,0,0,0,0,0,0,0,0,0,1,0,0,0,0,0,0
9401,797157,1,0,0,0,0,0,0,0,0,0,0,0,0,0,0,0,0
9402,775705,13,0,0,0,0,0,0,0,0,0,1,1,3,0,1,0,0
9402,791652,31,13,13,13,13,0,0,6,10,1,4,0,4,0,2,1,32
9402,786495,34,2,4,2,4,0,0,1,2,0,7,3,3,0,1,1,5
9402,791650,24,2,9,2,8,0,1,0,0,0,2,1,3,1,2,0,4
9402,776384,40,4,14,3,10,1,4,3,5,1,3,8,0,2,2,0,12
9402,791653,6,0,2,0,1,0,1,0,0,0,1,0,3,0,1,0,0
9402,797289,15,2,2,2,2,0,0,1,1,0,0,0,1,4,0,0,5
9402,797286,8,1,2,0,0,1,2,0,0,0,2,0,0,1,0,0,3
9402,797285,4,0,0,0,0,0,0,0,0,0,0,0,1,0,0,0,0
9402,797283,23,4,7,1,2,3,5,1,1,2,3,1,2,0,0,0,12
9402,791654,2,0,0,0,0,0,0,0,0,0,0,0,0,0,0,0,0
9403,786635,32,9,10,7,8,2,2,12,14,3,5,2,1,2,3,0,32
9403,791822,38,2,4,1,2,1,2,0,0,0,5,0,2,0,2,0,5
9403,781543,18,0,6,0,3,0,3,0,0,0,2,2,1,0,0,0,0
9403,780642,33,6,12,5,8,1,4,2,3,0,5,3,1,1,2,0,15
9403,776449,11,3,5,2,3,1,2,0,0,0,1,0,3,0,2,0,7
9403,798157,24,0,2,0,2,0,0,1,2,1,2,0,2,2,0,4,1
9403,791823,5,0,1,0,1,0,0,0,0,1,0,0,2,0,1,0,0
9403,791821,3,0,0,0,0,0,0,0,0,0,0,0,2,0,0,1,0
9403,786182,26,3,9,3,7,0,2,5,5,3,1,2,4,0,2,0,11
9403,786632,10,1,3,0,0,1,3,0,0,0,0,0,1,0,1,0,3
9404,790839,17,1,1,0,0,1,1,0,0,0,0,0,1,0,2,0,3
9404,785388,19,3,4,3,4,0,0,0,0,2,5,1,2,1,5,0,6
9404,796395,28,6,9,5,6,1,3,4,4,0,1,1,3,1,2,0,17
9404,785386,30,0,4,0,2,0,2,0,2,0,0,1,4,1,1,0,0
9404,780373,35,2,7,0,1,2,6,2,2,0,4,6,0,1,1,0,8
9404,780370,23,2,6,1,3,1,3,3,4,3,4,0,2,1,0,0,8
9404,796393,21,8,10,8,10,0,0,4,5,3,6,1,4,0,1,1,20
9404,790840,16,1,5,0,1,1,4,2,2,0,6,3,2,0,2,1,5
9404,790841,11,0,2,0,0,0,2,0,0,0,0,0,0,1,1,0,0
9405,791401,37,4,9,4,9,0,0,4,7,2,3,2,4,2,3,0,12
9405,786837,33,5,10,4,4,1,6,1,1,0,2,1,2,2,0,0,12
9405,780125,22,2,3,2,2,0,1,0,0,2,1,2,2,0,1,1,4
9405,785931,36,4,13,3,6,1,7,1,1,0,6,4,2,1,0,0,10
9405,780118,36,4,11,2,7,2,4,4,5,0,2,2,1,0,2,1,14
9405,797126,9,0,1,0,1,0,0,3,4,0,1,0,1,1,1,0,3
9405,797130,7,0,1,0,0,0,1,0,0,0,0,0,0,0,1,1,0
9405,797132,3,0,2,0,0,0,2,0,0,0,1,0,0,0,0,0,0
9405,797125,17,1,2,0,0,1,2,0,0,0,1,2,4,0,3,0,3
9406,792351,26,6,8,5,7,1,1,2,2,2,5,1,2,0,0,0,15
9406,786723,25,5,11,5,11,0,0,3,3,1,6,8,3,1,2,0,13
9406,792349,18,5,9,5,8,0,1,1,1,0,8,0,1,0,0,2,11
9406,798060,18,1,3,0,1,1,2,2,2,1,4,3,3,0,2,2,5
9406,792355,28,6,10,3,3,3,7,0,0,0,1,4,0,0,1,0,15
9406,786724,19,3,5,1,2,2,3,0,0,2,1,1,0,1,2,0,8
9406,786726,10,4,4,3,3,1,1,0,0,0,0,1,0,0,1,0,9
9406,798059,5,2,4,2,2,0,2,0,0,0,1,0,0,0,1,0,4
9406,798061,24,4,5,4,5,0,0,4,4,0,5,3,4,4,1,0,12
9406,792348,16,2,4,2,2,0,2,0,0,0,0,1,1,0,0,0,4
9406,781573,5,1,3,1,1,0,2,0,0,0,0,0,0,0,0,0,2
9406,792347,4,0,0,0,0,0,0,0,0,1,0,1,0,1,0,0,0
9406,798055,2,0,0,0,0,0,0,0,0,0,1,1,0,0,0,1,0
9407,790781,28,5,13,5,13,0,0,1,2,5,2,0,3,0,3,2,11
9407,780040,31,1,6,1,6,0,0,1,2,0,2,2,1,0,1,0,3
9407,790785,32,5,13,5,10,0,3,3,4,2,2,2,0,2,2,0,13
9407,781232,32,6,11,6,9,0,2,1,1,0,1,2,1,0,0,0,13
9407,780037,27,3,7,2,5,1,2,1,4,0,2,4,1,2,1,0,8
9407,796343,4,1,2,1,2,0,0,0,0,1,0,0,1,0,0,0,2
9407,790783,9,0,0,0,0,0,0,0,0,0,0,0,1,0,0,0,0
9407,790780,3,0,2,0,1,0,1,0,1,0,1,0,0,0,2,0,0
9407,796339,26,3,9,1,5,2,4,1,2,1,6,0,3,2,2,0,9
9407,785236,2,0,1,0,0,0,1,0,0,0,0,0,0,0,0,0,0
9407,796345,4,0,0,0,0,0,0,0,0,0,0,0,0,0,1,0,0
9407,780045,2,0,0,0,0,0,0,0,0,0,0,0,0,0,0,0,0
9408,791980,26,0,3,0,0,0,3,0,0,4,2,0,1,1,0,1,0
9408,785972,17,4,7,3,5,1,2,2,4,4,0,0,2,0,3,1,11
9408,780160,23,2,3,2,3,0,0,3,5,1,2,2,3,3,1,0,7
9408,791976,30,7,15,4,8,3,7,3,3,1,0,1,2,3,3,0,20
9408,791978,34,4,9,4,6,0,3,4,4,1,1,4,2,3,2,0,12
9408,785967,20,3,6,3,6,0,0,8,12,1,4,1,3,2,1,1,14
9408,791977,28,3,13,2,5,1,8,0,0,1,0,2,0,1,1,0,7
9408,785973,5,1,1,1,1,0,0,1,2,0,0,1,1,1,0,0,3
9408,797800,15,1,3,1,2,0,1,4,4,1,0,2,4,1,0,0,6
9408,797801,2,0,0,0,0,0,0,0,0,0,0,0,0,1,0,0,0
9409,796439,22,7,10,7,10,0,0,4,6,1,1,1,5,1,1,0,18
9409,790884,20,5,6,5,6,0,0,2,2,2,2,1,4,1,4,2,12
9409,791635,35,2,10,2,4,0,6,0,0,0,2,6,1,1,8,0,4
9409,796438,27,0,1,0,0,0,1,1,2,0,1,2,0,2,2,0,1
9409,790883,30,11,14,10,12,1,2,8,10,0,6,0,4,1,4,0,31
9409,796442,21,3,7,3,7,0,0,0,0,7,3,0,5,0,1,0,6
9409,790885,27,4,7,1,2,3,5,0,0,1,4,2,3,1,0,0,11
9409,781262,18,1,2,1,2,0,0,0,0,1,1,0,1,0,0,0,2
9409,790520,0,0,0,0,0,0,0,0,0,0,0,0,0,0,0,0,0
9410,798342,25,1,5,1,4,0,1,0,0,1,3,0,2,1,2,0,2
9410,791465,19,4,8,4,8,0,0,3,5,1,4,1,0,0,0,1,11
9410,791464,27,3,9,0,0,3,9,2,2,0,3,3,4,1,1,0,11
9410,786304,32,2,6,1,3,1,3,1,1,0,0,4,4,4,1,0,6
9410,780197,38,11,18,7,11,4,7,2,2,1,0,5,3,0,2,0,28
9410,786840,0,0,0,0,0,0,0,0,0,0,0,0,0,0,0,0,0
9410,786303,8,1,1,1,1,0,0,0,0,1,2,0,2,0,0,2,2
9410,780200,15,1,1,1,1,0,0,0,0,0,3,2,5,0,0,0,2
9410,780616,2,0,2,0,1,0,1,0,0,0,0,0,1,0,0,0,0
9410,798340,0,0,0,0,0,0,0,0,0,0,0,0,0,0,0,0,0
9410,798341,0,0,0,0,0,0,0,0,0,0,0,0,0,0,0,0,0
9410,798343,0,0,0,0,0,0,0,0,0,0,0,0,0,0,0,0,0
9410,786841,0,0,1,0,0,0,1,0,0,0,0,0,0,0,0,0,0
9410,780196,34,6,10,5,8,1,2,9,11,0,4,2,2,1,3,0,22
9411,780346,37,10,20,9,18,1,2,10,12,2,9,3,3,0,1,0,31
9411,780338,15,2,3,2,3,0,0,0,0,1,2,1,4,0,0,0,4
9411,791030,35,6,10,2,4,4,6,3,4,1,2,0,1,1,2,0,19
9411,785477,36,5,10,4,6,1,4,3,3,0,2,3,1,2,2,0,14
9411,785475,32,3,5,2,4,1,1,6,8,2,6,4,3,1,5,0,13
9411,791032,3,0,0,0,0,0,0,0,0,0,0,0,2,0,0,0,0
9411,796689,15,4,5,4,5,0,0,1,2,1,5,0,3,0,3,1,9
9411,791031,9,0,0,0,0,0,0,0,0,0,2,0,2,0,1,0,0
9411,786655,18,0,2,0,1,0,1,2,2,0,1,1,2,0,1,0,2
9411,780344,0,0,0,0,0,0,0,0,0,0,0,0,0,0,0,0,0
9412,786646,32,3,8,3,6,0,2,0,0,0,6,1,2,3,0,2,6
9412,780890,29,2,9,1,4,1,5,6,8,1,2,2,2,2,3,0,11
9412,791123,36,6,12,4,8,2,4,2,4,1,2,0,1,0,1,1,16
9412,785636,38,1,5,0,2,1,3,0,0,1,7,4,1,1,2,0,3
9412,775574,38,3,14,2,7,1,7,1,2,2,1,3,0,2,4,1,8
9412,775757,13,2,3,2,3,0,0,2,2,0,2,0,4,0,1,0,6
9412,791120,14,1,5,0,2,1,3,0,0,1,0,0,2,1,0,0,3
9413,791220,18,3,3,3,3,0,0,1,1,0,2,0,3,2,3,0,7
9413,791219,31,4,9,1,3,3,6,7,8,1,9,1,1,2,1,1,18
9413,776217,24,0,3,0,3,0,0,0,2,0,4,1,3,0,1,2,0
9413,790818,36,6,13,4,9,2,4,3,4,0,6,4,2,0,2,0,17
9413,786824,25,5,9,5,7,0,2,0,0,1,2,1,0,1,0,0,10
9413,780730,36,4,9,1,3,3,6,0,0,1,2,1,1,1,7,1,11
9413,791221,5,0,0,0,0,0,0,0,0,0,1,0,2,0,0,0,0
9413,796923,11,0,1,0,1,0,0,0,0,2,3,0,0,0,0,2,0
9413,796921,2,0,1,0,0,0,1,0,0,0,0,0,0,0,0,0,0
9413,792496,0,0,1,0,0,0,1,0,0,0,0,0,0,0,0,0,0
9413,786396,12,0,2,0,2,0,0,0,0,0,1,0,0,0,1,0,0
9414,785522,16,2,3,2,3,0,0,0,0,4,2,0,3,0,0,1,4
9414,781247,24,3,5,2,2,1,3,0,0,1,2,2,2,0,1,0,7
9414,796947,30,4,6,3,5,1,1,2,2,1,2,0,2,0,2,0,11
9414,791249,30,5,13,4,5,1,8,2,2,0,3,3,0,1,0,0,13
9414,775358,32,3,9,2,6,1,3,0,0,0,5,4,3,2,1,0,7
9414,796949,13,3,5,3,5,0,0,1,2,2,1,1,1,0,1,0,7
9414,785523,10,2,4,2,4,0,0,2,4,0,0,0,1,0,1,0,6
9414,796948,3,0,1,0,1,0,0,0,0,1,1,0,0,0,0,0,0
9414,796946,3,0,2,0,1,0,1,0,0,1,0,0,0,0,0,0,0
9414,796945,3,0,1,0,0,0,1,0,0,0,0,0,0,0,0,0,0
9414,791250,18,2,4,0,0,2,4,0,1,0,8,0,4,1,1,0,6
9414,791247,4,1,2,1,1,0,1,0,0,0,1,0,1,0,0,0,2
9414,785521,14,2,5,0,0,2,5,0,0,0,1,0,4,2,0,0,6
9415,792261,28,1,4,1,4,0,0,0,0,1,1,0,4,0,2,0,2
9415,786124,21,2,7,2,6,0,1,0,0,2,2,0,3,2,2,0,4
9415,792258,7,1,3,1,1,0,2,0,0,0,1,0,0,0,1,0,2
9415,786122,30,4,11,3,5,1,6,5,6,0,2,0,3,1,3,0,14
9415,786331,26,0,2,0,2,0,0,1,2,0,2,3,1,0,1,1,1
9415,797980,10,1,2,1,2,0,0,2,3,1,1,0,1,0,0,0,4
9415,780877,14,0,1,0,1,0,0,0,0,0,0,0,2,0,0,1,0
9415,797982,8,1,3,1,3,0,0,2,3,0,1,0,1,0,0,0,4
9415,786845,4,0,0,0,0,0,0,2,2,0,0,0,0,0,0,0,2
9415,786113,22,3,6,3,6,0,0,0,0,0,3,0,0,0,2,0,6
9415,780308,25,4,6,4,5,0,1,1,1,0,4,1,0,1,0,0,9
9415,784073,3,0,0,0,0,0,0,0,0,0,0,0,0,0,0,0,0
9415,792260,2,0,0,0,0,0,0,0,0,0,0,0,0,0,0,0,0
9416,790863,21,5,10,5,9,0,1,1,2,4,6,0,4,0,1,0,11
9416,780021,25,1,3,1,3,0,0,4,8,2,2,1,4,0,3,1,6
9416,785412,18,3,12,1,6,2,6,6,6,0,0,1,2,2,2,0,14
9416,780099,32,3,14,3,8,0,6,2,2,0,6,1,4,0,0,0,8
9416,776214,29,3,6,1,1,2,5,9,11,0,1,4,4,1,0,0,17
9416,775686,28,3,5,2,2,1,3,0,0,3,3,3,4,1,1,0,7
9416,785413,8,0,2,0,1,0,1,0,0,1,0,0,1,0,0,0,0
9416,776221,22,2,4,0,0,2,4,2,3,2,2,2,0,2,1,0,8
9416,785411,14,3,6,1,2,2,4,1,2,1,0,0,1,0,1,0,9
9416,785417,3,0,0,0,0,0,0,0,0,0,0,0,0,0,0,1,0
9417,791522,36,7,16,7,15,0,1,5,8,2,6,4,2,1,2,0,19
9417,786351,25,5,9,3,5,2,4,0,1,3,6,0,5,0,1,0,12
9417,786348,11,0,0,0,0,0,0,0,0,1,1,0,2,0,1,0,0
9417,797146,36,9,13,8,9,1,4,10,12,0,3,1,4,0,1,0,29
9417,797143,39,5,13,4,7,1,6,2,2,0,4,0,1,2,5,0,13
9417,785816,17,1,2,1,2,0,0,0,0,0,3,0,3,4,0,0,2
9417,797142,24,3,4,3,3,0,1,0,0,2,1,0,4,0,0,0,6
9417,797147,9,1,2,0,1,1,1,2,2,1,1,0,0,0,1,0,5
9417,797148,3,0,1,0,1,0,0,0,1,1,0,0,2,0,0,0,0
9418,781081,26,1,4,1,4,0,0,0,0,0,1,1,3,1,1,0,2
9418,791864,40,11,13,6,7,5,6,3,5,2,8,1,0,1,2,3,30
9418,791863,29,4,7,4,7,0,0,4,5,0,8,3,0,1,0,0,12
9418,797472,25,6,11,4,6,2,5,0,0,0,4,4,3,1,2,0,14
9418,780965,31,5,12,5,9,0,3,0,0,0,2,12,4,1,3,0,10
9418,797473,22,1,1,1,1,0,0,1,2,0,4,1,0,1,0,5,3
9418,797470,19,3,7,3,5,0,2,4,4,0,0,3,5,1,5,0,10
9418,786791,0,0,0,0,0,0,0,0,0,0,0,0,0,0,0,0,0
9418,791865,8,0,0,0,0,0,0,0,0,0,0,0,0,0,0,0,0
9419,796543,22,3,4,3,4,0,0,0,0,2,0,0,1,1,1,0,6
9419,790951,28,6,6,6,6,0,0,0,0,2,4,2,1,2,1,0,12
9419,796545,35,5,16,4,13,1,3,2,5,0,3,2,4,2,5,1,13
9419,796541,11,1,2,1,2,0,0,0,1,0,2,1,0,1,2,0,2
9419,790954,27,2,11,1,7,1,4,0,0,2,4,1,2,1,0,0,5
9419,796540,21,2,3,2,2,0,1,2,2,2,7,0,3,1,2,0,6
9419,796544,19,5,11,4,5,1,6,3,4,0,0,2,3,0,0,0,14
9419,798697,6,0,0,0,0,0,0,0,0,0,0,0,0,1,1,1,0
9419,786089,31,4,13,1,6,3,7,0,0,0,0,1,2,2,2,0,11
9420,786805,26,4,10,2,7,2,3,1,1,0,3,4,1,1,2,1,11
9420,774936,18,4,8,4,8,0,0,6,6,5,3,2,3,0,4,3,14
9420,790933,20,2,4,0,0,2,4,0,0,2,4,1,1,4,2,0,6
9420,781345,31,2,5,1,2,1,3,0,0,1,4,9,1,3,1,0,5
9420,780030,6,0,2,0,0,0,2,2,2,0,0,2,1,0,0,0,2
9420,790934,19,4,8,3,5,1,3,0,0,1,6,0,1,1,1,0,9
9420,786803,24,3,9,2,4,1,5,1,2,0,0,1,2,2,0,0,8
9420,780033,20,4,6,2,2,2,4,3,3,3,3,1,1,2,0,1,13
9420,796487,17,2,8,1,3,1,5,0,0,0,4,1,1,1,1,0,5
9420,796490,6,1,2,0,0,1,2,0,0,1,0,1,3,0,2,0,3
9420,796488,11,4,6,3,4,1,2,0,0,0,2,0,3,0,0,0,9
9420,796489,2,0,0,0,0,0,0,0,0,0,0,0,0,0,0,0,0
9421,797111,20,1,3,1,2,0,1,4,6,0,3,1,2,0,1,0,6
9421,797110,10,0,3,0,0,0,3,0,0,0,4,0,0,0,0,1,0
9421,797109,26,3,8,2,5,1,3,3,4,1,1,1,3,2,1,0,10
9421,791404,35,5,12,2,5,3,7,2,2,0,2,3,1,3,5,0,15
9421,785923,36,2,9,2,8,0,1,0,0,0,4,7,1,1,5,0,4
9421,797117,3,0,0,0,0,0,0,0,0,0,0,0,1,0,1,0,0
9421,800038,28,3,5,2,4,1,1,3,4,2,3,1,1,0,3,0,10
9421,797114,23,3,6,0,2,3,4,0,0,1,2,1,1,1,1,0,9
9421,797113,12,2,6,0,2,2,4,0,0,1,2,0,1,0,1,1,6
9421,791406,7,0,1,0,1,0,0,0,0,0,1,0,0,0,0,0,0
9422,800121,21,2,2,2,2,0,0,1,2,0,3,2,3,0,1,0,5
9422,780283,24,4,10,4,10,0,0,2,2,1,2,0,3,0,3,3,10
9422,790925,38,5,10,3,6,2,4,0,1,1,4,1,3,0,0,1,12
9422,785476,38,4,8,4,8,0,0,1,2,1,1,4,1,2,3,0,9
9422,785474,30,5,12,5,10,0,2,1,2,0,7,3,2,0,1,1,11
9422,796470,19,2,2,1,1,1,1,0,0,0,1,0,2,1,0,0,5
9422,785478,7,0,0,0,0,0,0,0,0,1,0,0,1,0,1,0,0
9422,785480,21,4,7,2,5,2,2,1,2,0,2,1,2,0,0,0,11
9422,790926,2,0,0,0,0,0,0,0,0,0,0,1,0,0,0,0,0
9423,790893,19,2,6,2,6,0,0,2,4,2,0,1,3,0,2,1,6
9423,796444,37,6,10,6,9,0,1,1,3,0,11,2,1,1,2,3,13
9423,790889,25,2,3,2,2,0,1,0,0,0,3,0,2,1,2,0,4
9423,786615,28,4,8,2,4,2,4,0,0,0,3,0,3,0,1,1,10
9423,775260,37,5,14,3,7,2,7,0,0,1,2,1,0,2,1,0,12
9423,775536,24,4,5,4,5,0,0,4,8,3,1,1,1,1,0,0,12
9423,790890,26,2,6,2,4,0,2,3,5,0,1,4,3,0,2,0,7
9423,780702,4,0,1,0,0,0,1,0,0,0,1,0,1,0,0,0,0
9424,797281,32,6,10,5,9,1,1,5,8,0,4,2,2,0,3,2,18
9424,791648,20,0,2,0,2,0,0,4,6,1,4,2,1,0,0,0,4
9424,785694,18,1,3,1,3,0,0,0,0,1,7,1,5,0,0,1,2
9424,797280,30,9,15,9,14,0,1,2,3,2,1,1,2,1,3,0,20
9424,797279,29,5,8,4,4,1,4,3,3,0,3,0,2,0,0,0,14
9424,791647,10,0,2,0,1,0,1,2,2,0,1,1,1,0,0,0,2
9424,791649,25,5,8,2,4,3,4,0,0,0,9,1,3,2,1,0,13
9424,786640,20,1,2,1,1,0,1,0,0,0,3,7,2,0,2,0,2
9424,785697,12,1,5,0,1,1,4,2,2,0,0,0,1,0,0,0,5
9424,785695,4,0,1,0,1,0,0,0,0,1,0,0,0,0,0,0,0
9426,790494,13,1,4,1,3,0,1,0,0,1,1,0,1,0,0,1,2
9426,781659,25,4,6,4,5,0,1,2,2,1,4,0,4,0,1,1,10
9426,792684,30,6,11,4,5,2,6,2,2,1,3,0,1,1,3,0,16
9426,782162,34,8,18,5,13,3,5,5,5,1,10,3,4,2,4,1,24
9426,781665,32,3,6,1,1,2,5,0,0,1,2,4,5,1,6,0,8
9426,788866,18,0,1,0,1,0,0,2,2,2,2,1,4,0,2,0,2
9426,781005,6,0,2,0,1,0,1,0,0,0,0,1,2,0,0,0,0
9426,781411,1,0,0,0,0,0,0,0,0,0,0,0,0,0,0,0,0
9426,796853,11,1,2,1,2,0,0,2,2,1,1,1,0,0,1,1,4
9426,792683,4,2,2,2,2,0,0,0,0,0,0,0,0,1,0,0,4
9426,780610,26,3,9,2,6,1,3,5,6,1,1,2,2,3,0,0,12
9427,788113,36,9,12,8,10,1,2,2,6,4,5,1,4,0,2,0,21
9427,776497,36,7,15,3,8,4,7,1,4,0,4,0,1,1,2,4,19
9427,785731,35,2,9,2,9,0,0,1,2,4,2,3,4,1,2,1,5
9427,785729,26,3,6,2,5,1,1,3,5,2,2,4,5,2,1,0,10
9427,780864,21,1,3,0,0,1,3,0,0,0,0,1,0,0,1,0,3
9427,799881,1,0,0,0,0,0,0,0,0,0,0,0,0,0,0,0,0
9427,792402,9,0,1,0,1,0,0,1,2,0,0,0,2,0,1,0,1
9427,796211,7,0,3,0,3,0,0,0,0,0,1,1,1,0,1,1,0
9427,786231,29,3,13,1,6,2,7,8,8,1,3,1,2,3,2,0,16
9428,785536,13,2,3,1,1,1,2,0,0,0,2,0,0,1,1,0,5
9428,780119,40,5,8,5,7,0,1,1,4,4,0,1,4,0,2,1,11
9428,796558,39,5,10,5,10,0,0,2,2,1,5,5,3,2,4,0,12
9428,796559,36,9,15,4,7,5,8,5,6,3,2,2,2,2,0,1,28
9428,776097,37,9,17,7,11,2,6,2,2,1,6,4,2,0,1,0,22
9428,780149,28,1,6,0,1,1,5,6,6,0,4,2,1,3,2,0,9
9428,785280,5,0,2,0,0,0,2,0,0,0,0,0,0,0,1,0,0
9428,775679,2,0,0,0,0,0,0,0,0,0,0,0,1,0,0,0,0
9429,792560,17,0,0,0,0,0,0,0,0,0,5,2,3,0,1,0,0
9429,792565,37,8,15,8,15,0,0,7,7,4,6,4,3,1,3,0,23
9429,792563,30,9,15,4,7,5,8,0,0,1,0,1,2,2,3,0,23
9429,792561,31,3,9,1,5,2,4,1,2,0,4,4,0,1,2,0,9
9429,780270,36,7,11,5,6,2,5,0,1,3,2,1,1,0,4,1,16
9429,785472,23,1,1,1,1,0,0,0,0,1,1,0,4,1,1,3,2
9429,798134,12,2,6,2,4,0,2,0,0,0,0,0,1,1,2,0,4
9429,780266,11,1,4,0,0,1,4,0,0,0,2,2,4,1,1,0,3
9429,798132,3,0,0,0,0,0,0,0,0,0,0,0,1,0,0,0,0
9430,791883,39,5,12,4,9,1,3,7,11,1,5,1,3,1,0,3,18
9430,781066,27,3,4,3,4,0,0,4,6,1,5,1,5,0,2,1,10
9430,797594,15,0,2,0,1,0,1,0,0,0,0,1,1,0,0,0,0
9430,791884,39,7,11,7,11,0,0,5,6,2,1,5,3,2,2,0,19
9430,780695,35,3,6,0,2,3,4,2,2,0,3,0,4,2,2,1,11
9430,797600,2,0,0,0,0,0,0,0,0,0,0,0,0,0,0,0,0
9430,797598,10,0,2,0,2,0,0,0,0,0,2,0,1,0,0,0,0
9430,791885,5,0,2,0,2,0,0,0,0,0,0,0,1,0,0,0,0
9430,797596,4,1,1,0,0,1,1,0,0,0,0,0,2,0,1,0,3
9430,786496,24,0,2,0,1,0,1,0,0,2,1,0,1,1,1,0,0
9431,792288,26,2,8,2,8,0,0,1,1,3,4,1,4,0,2,2,5
9431,785227,31,3,7,3,7,0,0,1,2,6,5,1,4,0,3,2,7
9431,786237,28,3,6,3,6,0,0,4,5,1,2,2,3,2,2,0,10
9431,780287,31,4,11,3,7,1,4,7,7,0,2,0,3,0,2,0,16
9431,776309,33,3,8,3,8,0,0,3,4,0,3,1,1,0,0,0,9
9431,798072,8,0,1,0,1,0,0,0,0,0,2,0,2,0,0,0,0
9431,798084,6,0,0,0,0,0,0,1,2,0,0,0,0,0,0,0,1
9431,792278,13,2,3,0,0,2,3,0,0,0,1,1,2,0,0,0,6
9431,786232,24,2,5,1,3,1,2,6,6,1,0,0,2,2,3,1,11
9432,796996,33,6,11,6,11,0,0,1,1,0,5,0,2,0,1,0,13
9432,780471,28,4,7,4,7,0,0,2,2,3,6,0,3,0,1,3,10
9432,791608,19,1,3,1,1,0,2,0,0,0,2,0,2,0,1,0,2
9432,792071,27,1,5,0,0,1,5,0,0,0,3,2,1,0,1,0,3
9432,776011,31,3,9,2,6,1,3,0,0,0,5,4,0,0,4,0,7
9432,791610,12,1,4,1,4,0,0,0,0,1,3,0,1,0,2,0,2
9432,786413,7,0,1,0,1,0,0,0,0,1,0,0,0,0,1,0,0
9432,796994,11,0,1,0,1,0,0,0,0,0,1,0,0,0,0,0,0
9432,791613,27,4,7,2,4,2,3,2,4,0,1,3,0,2,0,1,12
9432,785680,3,1,1,1,1,0,0,0,0,0,0,0,0,1,1,0,2
9432,780417,2,0,1,0,0,0,1,0,0,0,1,0,0,0,1,0,0
9433,780201,40,2,7,2,7,0,0,2,2,4,5,2,2,2,1,1,6
9433,791469,26,2,4,2,4,0,0,3,6,1,5,0,4,2,3,2,7
9433,797210,34,3,12,3,12,0,0,0,0,0,3,7,2,0,0,0,6
9433,786311,34,7,14,1,3,6,11,0,0,0,3,2,1,1,1,0,20
9433,775516,31,1,4,1,3,0,1,0,0,0,1,2,2,1,1,0,2
9433,798344,7,2,3,2,3,0,0,0,0,0,2,0,0,0,0,0,4
9433,791471,2,0,0,0,0,0,0,0,0,0,0,0,1,0,0,0,0
9433,791467,26,6,11,3,5,3,6,0,0,0,3,0,1,1,1,0,15
9434,792334,33,7,13,7,12,0,1,2,2,3,8,1,1,1,3,1,16
9434,786575,32,9,12,9,12,0,0,1,4,6,8,0,1,0,1,3,19
9434,799842,13,0,3,0,1,0,2,1,2,0,0,0,1,0,1,0,1
9434,792338,40,7,13,6,11,1,2,1,1,2,8,6,3,3,1,1,16
9434,781666,37,1,8,0,4,1,4,2,2,0,2,0,1,0,4,0,5
9434,798097,4,0,2,0,2,0,0,0,0,1,1,0,0,0,0,0,0
9434,786708,15,5,8,5,6,0,2,1,1,4,2,0,2,0,1,2,11
9434,798095,4,0,2,0,0,0,2,0,0,0,0,1,0,1,0,0,0
9434,791636,22,4,10,1,3,3,7,0,0,2,0,2,2,0,2,0,11
9435,796455,26,3,6,3,6,0,0,0,0,4,3,0,3,0,1,1,6
9435,787175,31,3,12,0,0,3,12,3,3,0,4,0,1,1,0,1,12
9435,790909,40,2,11,0,5,2,6,1,2,1,3,7,3,2,1,0,7
9435,781393,40,4,14,1,2,3,12,2,2,0,4,6,1,2,3,1,13
9435,775351,40,7,11,7,11,0,0,2,4,3,0,3,1,0,3,2,16
9435,790907,2,0,0,0,0,0,0,0,0,0,0,0,0,0,0,0,0
9435,782126,21,6,12,4,6,2,6,0,0,0,3,0,2,0,0,0,14
9436,780454,3,0,0,0,0,0,0,0,0,0,1,0,0,0,0,1,0
9436,780452,25,6,9,4,6,2,3,0,0,1,4,3,3,0,1,1,14
9436,796407,27,0,2,0,1,0,1,2,2,0,4,2,1,1,2,1,2
9436,775941,3,1,1,1,1,0,0,0,0,0,1,0,1,0,1,0,2
9436,780450,7,0,1,0,0,0,1,0,0,0,0,2,0,0,1,0,0
9436,790856,26,6,10,6,10,0,0,6,7,3,3,0,2,0,3,1,18
9436,796410,16,2,6,2,6,0,0,3,5,1,4,1,1,1,1,2,7
9436,796413,26,6,9,2,2,4,7,2,2,0,2,2,0,0,1,1,18
9436,796408,30,6,12,4,6,2,6,4,4,0,3,7,4,0,4,0,18
9436,796411,9,2,2,2,2,0,0,0,0,1,3,1,1,0,0,3,4
9436,790858,11,0,0,0,0,0,0,1,2,1,2,3,0,0,4,0,1
9436,796409,17,1,3,1,3,0,0,3,4,0,2,0,2,0,2,0,5
9436,780453,0,1,1,1,1,0,0,0,0,0,0,0,0,0,0,1,2
9436,781286,0,0,0,0,0,0,0,0,0,0,0,0,0,0,0,0,0
9437,790761,30,3,7,3,4,0,3,2,2,2,2,2,3,4,3,1,8
9437,790764,31,6,16,4,6,2,10,0,0,2,4,1,4,0,2,1,14
9437,796322,25,7,10,7,10,0,0,4,5,2,1,0,4,2,2,0,18
9437,796319,32,6,11,4,7,2,4,2,3,0,3,2,1,1,2,0,16
9437,796320,20,3,7,2,5,1,2,3,4,1,1,3,3,1,0,0,10
9437,775668,4,1,2,1,2,0,0,0,0,0,0,0,1,1,0,0,2
9437,796321,10,1,3,1,1,0,2,0,0,0,1,1,3,2,1,0,2
9437,785219,13,0,4,0,1,0,3,1,2,0,2,2,2,0,1,0,1
9437,796323,9,0,0,0,0,0,0,0,0,1,2,0,0,0,1,1,0
9437,779993,23,1,7,1,5,0,2,0,0,0,2,5,1,2,1,0,2
9437,779990,1,0,1,0,1,0,0,0,0,0,0,0,0,0,0,0,0
9437,790765,1,0,1,0,0,0,1,0,0,0,0,0,0,0,0,0,0
9437,790766,1,0,0,0,0,0,0,0,0,0,0,0,0,0,0,0,0
9438,797367,30,1,5,1,5,0,0,2,2,4,1,2,5,1,2,2,4
9438,797369,31,1,6,1,1,0,5,2,2,0,1,2,2,3,4,2,4
9438,797366,23,0,2,0,2,0,0,1,2,3,7,0,2,2,2,0,1
9438,791807,34,4,9,1,2,3,7,0,0,0,1,0,5,3,3,0,11
9438,786130,33,4,13,2,4,2,9,0,2,0,3,1,4,0,2,1,10
9438,797371,12,1,1,1,1,0,0,3,4,1,2,0,3,0,2,0,5
9438,797365,14,0,5,0,0,0,5,0,0,0,1,0,0,0,1,0,0
9438,797363,23,7,16,6,13,1,3,9,10,1,2,1,2,0,2,0,24
9439,792158,12,2,2,2,2,0,0,2,4,0,4,0,3,1,1,1,6
9439,780138,31,7,13,7,12,0,1,3,4,2,6,1,4,0,3,0,17
9439,792154,34,3,7,3,4,0,3,3,4,1,6,0,0,2,6,1,9
9439,792152,38,2,9,2,8,0,1,1,2,0,6,0,2,1,6,0,5
9439,780581,29,5,9,4,6,1,3,6,6,2,1,4,3,0,2,0,17
9439,797755,20,1,2,1,1,0,1,0,0,0,5,0,1,1,1,2,2
9439,792157,17,1,3,1,3,0,0,2,5,2,1,1,1,0,2,1,4
9439,786014,19,2,5,2,5,0,0,0,0,1,1,1,2,3,1,0,4
9440,791316,30,5,7,5,7,0,0,0,0,2,3,1,4,1,2,0,10
9440,780870,31,3,7,3,7,0,0,4,10,5,7,0,2,0,1,1,10
9440,781079,36,7,14,6,12,1,2,2,2,1,7,4,0,0,0,0,17
9440,781443,23,1,8,1,8,0,0,0,0,0,1,5,3,2,2,0,2
9440,775822,34,6,14,4,8,2,6,1,1,0,1,3,1,1,3,0,15
9440,796625,6,0,1,0,1,0,0,0,0,0,1,1,2,0,0,1,0
9440,796621,20,3,6,1,2,2,4,3,6,0,3,1,1,0,1,0,11
9440,791314,1,0,0,0,0,0,0,0,0,0,0,0,2,0,0,0,0
9440,785380,19,3,5,3,5,0,0,0,0,1,1,2,0,0,0,1,6
9441,796568,22,3,8,3,8,0,0,2,4,2,5,1,4,1,1,0,8
9441,796566,33,6,12,6,12,0,0,4,5,7,11,2,5,4,3,2,16
9441,790969,37,2,7,2,6,0,1,1,3,0,4,3,2,0,4,0,5
9441,780166,32,6,11,4,7,2,4,2,2,0,3,8,4,0,3,0,16
9441,775107,13,2,8,1,7,1,1,0,0,3,2,0,3,0,1,1,5
9441,790971,4,0,0,0,0,0,0,0,0,0,0,0,0,1,0,0,0
9441,796569,4,0,1,0,1,0,0,0,0,1,0,0,0,0,0,0,0
9441,796563,14,1,2,0,1,1,1,0,1,1,2,0,3,0,0,0,3
9441,790968,18,2,6,0,2,2,4,0,0,0,0,0,0,1,1,0,6
9441,790967,23,3,12,0,4,3,8,0,0,1,1,0,0,1,1,0,9
9442,786447,7,1,1,1,1,0,0,0,0,0,0,0,0,0,1,0,2
9442,775074,34,3,6,3,6,0,0,5,6,2,2,2,1,1,5,2,11
9442,786448,35,3,5,3,5,0,0,1,3,3,5,1,2,3,1,0,7
9442,780731,30,6,13,5,10,1,3,2,3,0,4,3,2,1,2,0,15
9442,780462,16,2,7,1,1,1,6,0,0,0,1,0,5,0,2,0,5
9442,796971,23,3,6,1,3,2,3,0,0,0,4,1,2,2,2,0,8
9442,786132,21,1,3,1,3,0,0,1,2,2,3,2,1,0,2,1,3
9442,791631,17,1,5,0,3,1,2,0,0,0,2,0,1,0,0,0,3
9442,791632,17,1,3,1,3,0,0,0,0,1,1,2,1,1,1,0,2
9443,786618,20,2,2,2,2,0,0,1,2,0,2,0,1,0,0,0,5
9443,776424,14,0,1,0,0,0,1,0,0,0,1,1,0,0,1,0,0
9443,792300,33,3,5,3,5,0,0,5,8,0,5,3,2,2,2,1,11
9443,792303,19,3,6,2,3,1,3,0,0,0,0,1,2,1,6,0,7
9443,781603,32,2,8,1,3,1,5,0,0,0,6,5,1,1,1,0,5
9443,797914,17,0,3,0,1,0,2,0,0,0,1,0,1,1,1,0,0
9443,796155,7,0,1,0,1,0,0,0,0,0,1,0,1,0,0,0,0
9443,780456,12,1,2,1,1,0,1,0,0,0,1,0,1,1,2,0,2
9443,797912,9,0,3,0,0,0,3,0,0,0,1,0,4,1,0,0,0
9443,781605,3,0,0,0,0,0,0,0,0,0,0,0,1,0,0,0,0
9443,790813,20,4,8,0,1,4,7,4,4,0,0,0,1,0,0,0,16
9443,797907,8,0,2,0,2,0,0,0,1,2,1,0,1,0,0,0,0
9443,797902,1,0,0,0,0,0,0,0,0,0,0,0,0,1,0,0,0
9443,792687,5,0,0,0,0,0,0,0,0,1,0,1,0,0,1,0,0
9443,781607,0,0,0,0,0,0,0,0,0,0,0,0,0,0,0,0,0
9444,792299,28,3,5,3,4,0,1,0,0,3,1,0,4,1,0,0,6
9444,786181,24,5,6,5,6,0,0,4,6,2,5,0,4,1,2,1,14
9444,792304,36,4,11,3,7,1,4,5,5,4,7,1,2,1,0,0,14
9444,792301,37,8,15,8,13,0,2,0,0,0,1,4,2,2,2,0,16
9444,786275,33,4,7,4,5,0,2,6,7,0,3,3,1,1,3,0,14
9444,798089,3,0,1,0,1,0,0,0,0,2,0,0,1,0,1,0,0
9444,792302,5,2,2,2,2,0,0,0,0,0,1,0,0,1,1,0,4
9444,792295,14,0,0,0,0,0,0,0,0,0,3,0,4,0,3,0,0
9444,786278,20,2,7,2,5,0,2,2,2,1,2,0,3,1,2,1,6
9445,791760,30,5,9,5,8,0,1,9,10,3,5,2,4,0,1,0,19
9445,780256,27,1,5,1,3,0,2,0,0,0,2,0,2,1,2,0,2
9445,796879,26,3,4,3,4,0,0,4,5,1,1,1,2,0,3,0,10
9445,796880,29,2,7,2,3,0,4,2,2,0,2,0,3,1,3,0,6
9445,791334,29,5,12,3,6,2,6,2,2,0,3,1,3,2,0,0,14
9445,785874,10,1,1,1,1,0,0,4,4,1,1,0,1,0,1,0,6
9445,796883,8,1,3,1,3,0,0,1,2,0,0,0,1,1,1,0,3
9445,791757,28,2,5,0,2,2,3,0,0,0,1,0,1,0,1,0,6
9445,781590,13,0,2,0,2,0,0,0,0,1,1,0,1,1,1,0,0
9446,774812,18,3,10,2,5,1,5,3,5,0,1,0,1,0,1,1,10
9446,797180,26,1,3,0,0,1,3,0,0,1,5,1,2,1,1,1,3
9446,791497,35,3,8,2,5,1,3,0,0,2,2,1,2,1,4,0,7
9446,791503,20,0,5,0,3,0,2,1,2,2,3,0,2,1,1,0,1
9446,780461,25,1,8,1,4,0,4,1,2,2,3,4,0,1,7,1,3
9446,791500,25,5,8,4,6,1,2,0,1,2,7,0,0,2,0,0,11
9446,791498,5,0,0,0,0,0,0,0,0,0,0,0,0,1,1,0,0
9446,791502,3,1,3,1,2,0,1,2,2,0,0,2,0,1,0,0,4
9446,780240,14,1,3,1,3,0,0,2,4,2,2,0,3,0,2,0,4
9446,776379,28,6,13,3,8,3,5,0,1,1,1,3,1,0,1,0,15
9446,790517,1,0,0,0,0,0,0,0,0,0,0,0,0,0,0,0,0
9447,781530,28,4,10,3,8,1,2,0,0,1,8,3,3,0,1,1,9
9447,776423,20,4,6,4,6,0,0,1,2,1,4,1,3,2,1,3,9
9447,798096,25,5,10,2,5,3,5,1,2,0,3,2,1,2,0,0,14
9447,792307,20,1,5,1,2,0,3,0,0,1,2,1,2,0,1,0,2
9447,792319,16,3,6,0,2,3,4,0,0,0,2,2,0,3,2,0,9
9447,798109,1,0,0,0,0,0,0,0,0,1,0,0,0,0,0,0,0
9447,792316,10,2,2,2,2,0,0,0,0,3,3,0,1,1,0,1,4
9447,792314,6,0,1,0,1,0,0,0,0,0,1,0,3,0,2,0,0
9447,786296,18,3,6,3,4,0,2,0,1,0,2,1,1,1,0,0,6
9447,792320,8,1,3,1,3,0,0,2,2,1,0,0,2,0,0,0,4
9447,798106,11,0,3,0,1,0,2,0,0,1,2,0,1,1,2,0,0
9447,798104,24,5,12,5,9,0,3,0,0,0,1,3,0,1,1,1,10
9447,798102,1,1,1,1,1,0,0,0,0,0,0,0,0,0,0,0,2
9447,792309,6,0,0,0,0,0,0,0,0,0,0,1,0,0,2,0,0
9447,792321,6,1,4,1,4,0,0,2,2,1,1,0,0,0,1,0,4
9448,797562,8,0,0,0,0,0,0,0,0,1,2,0,2,0,1,1,0
9448,791766,28,4,7,2,3,2,4,1,3,1,0,1,2,1,4,0,11
9448,786230,39,8,20,7,8,1,12,2,2,1,1,2,3,0,2,0,19
9448,780604,34,9,15,8,12,1,3,5,6,1,6,1,3,1,1,0,24
9448,780602,38,5,6,5,6,0,0,0,0,2,6,5,3,0,5,1,10
9448,791768,27,2,5,2,5,0,0,0,0,0,10,2,3,2,4,0,4
9448,786460,15,1,5,1,5,0,0,2,3,3,0,0,2,0,2,1,4
9448,791767,11,1,2,1,1,0,1,4,4,0,2,1,2,1,1,0,6
9448,780603,25,1,3,0,1,1,2,0,0,1,1,3,2,5,1,0,3
9448,780605,0,0,0,0,0,0,0,0,0,0,0,0,0,0,0,0,0
9449,792047,28,5,13,4,11,1,2,0,1,1,4,2,4,0,2,0,11
9449,786338,37,3,16,0,8,3,8,1,3,1,4,0,1,1,2,0,10
9449,792050,34,3,7,1,3,2,4,0,0,3,0,4,0,1,1,0,8
9449,785347,6,1,2,0,1,1,1,0,0,1,0,0,0,0,1,0,3
9449,775601,34,5,10,4,6,1,4,14,15,0,2,4,4,4,8,0,25
9449,791512,6,0,0,0,0,0,0,0,0,0,1,0,3,0,1,0,0
9449,792045,4,1,1,1,1,0,0,0,0,0,0,0,1,0,1,0,2
9449,797648,15,1,2,1,2,0,0,0,0,0,2,0,0,0,0,0,2
9449,797647,36,4,8,3,3,1,5,0,0,1,6,2,4,3,3,0,9
9449,792052,17,2,2,0,0,2,2,0,0,0,1,1,2,2,0,0,6
9449,792051,8,0,1,0,0,0,1,0,0,0,2,0,1,0,0,0,0
9450,775955,29,4,9,3,6,1,3,0,0,0,2,4,1,2,1,0,9
9450,775840,27,2,5,1,1,1,4,0,0,0,1,5,1,2,0,0,5
9450,775811,19,2,5,1,3,1,2,0,0,2,1,0,0,0,0,0,5
9450,775287,16,1,5,0,2,1,3,0,0,0,0,2,2,0,2,0,3
9450,786706,2,0,0,0,0,0,0,0,0,0,0,0,0,0,0,0,0
9450,786704,26,8,10,8,10,0,0,6,6,3,9,0,3,2,2,2,22
9450,786551,22,7,16,3,6,4,10,0,0,0,5,2,2,0,1,0,18
9450,790921,16,1,4,1,3,0,1,2,4,1,2,2,0,4,2,0,4
9450,785395,22,1,5,1,4,0,1,0,0,4,2,4,1,0,1,1,2
9450,786703,3,0,1,0,0,0,1,2,2,0,0,0,0,0,0,0,2
9450,792327,12,0,0,0,0,0,0,0,0,2,1,0,3,0,1,0,0
9450,786702,5,0,1,0,1,0,0,0,0,0,0,0,0,0,0,0,0
9450,798110,1,0,0,0,0,0,0,0,0,0,0,0,0,0,0,0,0
9451,776374,40,4,8,3,5,1,3,2,2,0,3,6,1,2,6,0,11
9451,791043,36,4,12,3,9,1,3,1,2,0,4,3,3,1,4,1,10
9451,775412,36,3,6,0,0,3,6,0,0,0,4,0,4,1,0,0,9
9451,791042,19,3,5,3,5,0,0,3,4,2,3,1,4,0,2,0,9
9451,774834,19,0,0,0,0,0,0,0,0,0,0,0,2,0,1,0,0
9451,785512,21,5,10,5,10,0,0,2,2,0,2,2,2,0,2,0,12
9451,796719,20,1,6,0,0,1,6,0,0,0,2,0,1,0,0,0,3
9451,796720,8,0,1,0,1,0,0,0,0,0,3,1,0,0,1,0,0
9451,796722,1,0,0,0,0,0,0,0,0,0,0,0,0,0,0,0,0
9452,781335,35,11,21,8,15,3,6,5,5,1,6,7,1,1,1,0,30
9452,781341,41,7,12,4,4,3,8,0,0,0,4,3,1,0,2,0,17
9452,776351,39,6,10,2,4,4,6,1,2,1,5,3,5,1,0,0,17
9452,785770,42,6,10,6,10,0,0,0,1,0,3,2,1,3,3,0,12
9452,785767,26,3,7,2,2,1,5,2,3,0,1,0,3,1,1,0,9
9452,785775,22,1,3,0,2,1,1,2,4,2,5,1,0,1,1,1,5
9452,796538,8,0,2,0,2,0,0,0,0,0,0,0,2,0,0,0,0
9452,791284,6,0,0,0,0,0,0,0,0,0,1,0,1,0,1,0,0
9452,791285,4,0,0,0,0,0,0,0,0,0,0,0,0,0,0,0,0
9452,796542,2,0,2,0,1,0,1,0,0,0,0,0,0,0,0,0,0
9453,786765,43,9,14,5,8,4,6,3,4,2,7,1,3,0,1,3,25
9453,781669,45,8,17,7,12,1,5,4,4,2,5,5,3,1,4,0,21
9453,781672,22,6,9,6,9,0,0,1,2,1,2,1,1,1,1,1,13
9453,792379,42,4,8,0,1,4,7,0,0,1,11,2,2,2,1,0,12
9453,792380,45,2,13,2,7,0,6,2,2,2,2,0,1,0,2,0,6
9453,797852,26,5,7,4,5,1,2,3,4,0,2,0,2,2,1,0,14
9453,797860,2,0,0,0,0,0,0,0,0,0,0,0,0,0,0,0,0
9454,786090,35,8,20,6,10,2,10,2,2,1,5,2,2,3,1,0,20
9454,791132,22,6,11,3,4,3,7,0,0,2,1,0,4,0,1,0,15
9454,791135,19,3,5,3,5,0,0,2,4,3,2,0,5,2,2,0,8
9454,786088,35,2,7,2,7,0,0,0,0,3,3,6,1,1,0,0,4
9454,796791,7,1,4,1,4,0,0,0,0,2,0,2,0,1,0,0,2
9454,796790,24,4,6,1,1,3,5,2,2,0,3,0,3,0,4,0,13
9454,774921,23,3,6,2,3,1,3,6,6,0,8,5,3,1,2,0,13
9454,791521,13,2,3,2,3,0,0,2,3,3,2,0,1,0,0,1,6
9454,791131,13,1,4,1,2,0,2,1,1,0,2,2,2,1,0,1,3
9454,791133,8,1,1,1,1,0,0,0,0,0,1,0,2,0,1,0,2
9454,786092,1,0,0,0,0,0,0,0,0,0,0,0,0,0,0,0,0
9455,786152,35,6,8,5,6,1,2,6,8,4,8,0,4,1,1,1,19
9455,798003,35,4,12,4,6,0,6,6,9,2,1,5,5,0,4,0,14
9455,792265,34,3,11,0,1,3,10,0,2,4,3,0,4,3,2,1,9
9455,792266,19,1,7,0,0,1,7,1,2,0,4,3,4,0,3,0,4
9455,792267,35,1,8,1,2,0,6,1,3,0,2,2,2,1,3,0,3
9455,792263,18,4,10,1,4,3,6,0,0,4,3,0,0,1,1,0,11
9455,798006,13,2,5,1,2,1,3,3,4,2,1,1,0,2,2,0,8
9455,798007,11,0,1,0,0,0,1,0,0,0,1,1,0,0,1,0,0
9456,781505,32,6,7,5,5,1,2,3,6,4,5,2,1,0,1,0,16
9456,780353,32,6,11,6,11,0,0,3,7,3,8,0,2,0,2,1,15
9456,791317,35,3,10,1,4,2,6,6,7,0,3,5,2,2,5,0,14
9456,777573,30,4,10,2,7,2,3,0,0,0,3,2,3,1,0,0,10
9456,776279,32,2,6,2,2,0,4,1,2,1,6,4,3,1,1,0,5
9456,786222,15,4,6,3,5,1,1,1,1,1,1,0,2,0,0,0,10
9456,790851,9,2,2,2,2,0,0,0,0,0,0,0,2,0,1,0,4
9456,796649,15,0,2,0,1,0,1,0,0,0,1,1,0,0,0,0,0
9457,786424,35,6,11,6,11,0,0,2,4,0,9,0,3,0,0,0,14
9457,792366,30,5,11,5,11,0,0,3,4,1,2,1,5,1,3,0,13
9457,785483,35,2,6,2,4,0,2,3,3,0,4,6,2,2,3,0,7
9457,781454,32,3,10,2,7,1,3,0,1,2,2,1,2,2,1,0,7
9457,791015,23,2,2,2,2,0,0,2,2,0,1,2,1,0,1,0,6
9457,775335,12,2,5,0,0,2,5,2,2,0,0,0,2,0,0,0,8
9457,797979,21,3,5,2,2,1,3,0,0,0,2,0,2,1,1,0,7
9457,785959,12,1,2,1,2,0,0,0,0,0,2,0,3,0,0,2,2
9458,792632,34,5,9,5,9,0,0,4,6,5,5,0,4,4,0,2,14
9458,792627,19,4,7,4,6,0,1,2,4,1,2,1,2,1,1,0,10
9458,792626,18,1,3,1,2,0,1,1,3,1,1,3,1,1,0,0,3
9458,781491,33,3,6,2,4,1,2,4,4,1,3,3,3,4,3,0,11
9458,780250,31,4,15,1,5,3,10,6,7,1,4,3,3,2,1,0,17
9458,796637,5,0,1,0,1,0,0,0,0,0,0,1,0,0,1,0,0
9458,796634,8,0,0,0,0,0,0,1,2,0,1,0,0,0,0,0,1
9458,796642,1,0,1,0,0,0,1,0,0,0,0,0,0,0,0,0,0
9458,792629,24,2,7,1,4,1,3,8,8,0,0,6,0,1,2,0,13
9458,792631,27,4,8,1,1,3,7,0,0,0,2,2,2,0,1,0,11
9459,791988,37,7,12,7,12,0,0,1,3,2,11,1,3,1,3,0,15
9459,792443,20,1,1,1,1,0,0,0,0,4,0,2,3,0,2,1,2
9459,796508,34,6,7,1,1,5,6,0,0,0,5,4,4,0,0,0,17
9459,796503,32,4,13,3,7,1,6,3,3,2,3,5,2,2,6,0,12
9459,791989,34,5,11,3,6,2,5,1,2,1,0,4,3,0,2,0,13
9459,780077,4,0,0,0,0,0,0,0,0,0,0,0,2,0,1,0,0
9459,796506,7,0,1,0,1,0,0,2,2,0,1,0,1,0,0,0,2
9459,796507,22,3,8,1,5,2,3,1,3,1,2,1,3,0,4,1,9
9459,785258,10,0,2,0,1,0,1,2,2,0,4,2,2,1,0,1,2
9460,792227,39,5,14,3,8,2,6,3,4,1,5,3,4,0,3,2,15
9460,781352,23,3,7,3,7,0,0,0,0,2,1,1,1,0,3,1,6
9460,792223,34,6,16,2,7,4,9,1,2,1,9,1,2,0,2,0,17
9460,785935,41,9,17,7,12,2,5,0,2,1,6,2,1,3,1,0,20
9460,781340,32,2,2,2,2,0,0,1,2,2,3,4,5,0,0,0,5
9460,797881,22,3,6,3,6,0,0,4,4,0,3,1,5,1,1,2,10
9460,781351,6,0,2,0,1,0,1,0,0,0,0,1,0,0,0,1,0
9460,797882,26,0,1,0,1,0,0,0,0,0,2,0,3,0,0,0,0
9460,786453,2,0,0,0,0,0,0,0,0,0,0,1,1,0,0,0,0
9461,780832,13,0,0,0,0,0,0,0,0,1,0,1,0,0,0,0,0
9461,790961,39,2,7,2,7,0,0,1,2,4,5,5,4,3,3,1,5
9461,785278,42,5,21,2,12,3,9,3,4,1,7,1,1,0,1,0,16
9461,780146,38,5,13,1,5,4,8,14,17,0,6,2,2,0,2,0,28
9461,775860,40,8,14,3,4,5,10,2,5,0,6,3,0,1,0,0,23
9461,796554,32,2,3,2,3,0,0,0,2,2,2,0,4,0,1,0,4
9461,796555,6,0,0,0,0,0,0,0,0,0,2,0,0,1,0,0,0
9461,796553,13,0,1,0,1,0,0,0,0,1,0,0,0,0,1,0,0
9461,786240,2,0,0,0,0,0,0,0,0,0,0,0,0,0,1,0,0
9462,792378,24,2,5,2,5,0,0,2,2,2,3,0,2,1,1,4,6
9462,786746,26,2,7,0,2,2,5,2,2,1,4,3,3,0,1,0,8
9462,780178,20,3,9,3,9,0,0,0,0,4,3,0,2,0,2,0,6
9462,792376,34,5,12,5,7,0,5,2,3,0,5,4,3,1,3,0,12
9462,797883,38,3,4,3,3,0,1,1,2,1,3,7,2,1,4,0,7
9462,797890,28,4,11,2,4,2,7,0,0,0,5,2,2,0,0,0,10
9462,797888,3,0,0,0,0,0,0,0,0,2,0,0,1,0,1,0,0
9462,775075,21,5,5,5,5,0,0,0,0,1,4,0,2,0,0,1,10
9462,785744,3,1,1,1,1,0,0,0,0,0,0,0,0,0,1,0,2
9462,797885,3,1,1,0,0,1,1,0,0,0,0,0,0,0,0,0,3
9463,796347,15,0,3,0,2,0,1,0,0,2,3,0,1,0,0,0,0
9463,785243,26,3,7,2,5,1,2,3,4,4,5,1,1,0,4,0,10
9463,790788,32,3,7,0,1,3,6,4,4,1,0,4,1,0,1,0,13
9463,781028,36,5,15,2,7,3,8,0,1,0,3,3,2,1,1,0,13
9463,781026,31,2,12,1,7,1,5,1,2,2,1,2,2,1,1,0,6
9463,785242,19,1,2,1,2,0,0,0,2,2,3,1,3,0,1,2,2
9463,781027,14,2,4,1,1,1,3,0,0,1,3,1,1,0,0,0,5
9463,796348,13,0,4,0,4,0,0,0,0,1,0,1,1,0,1,0,0
9463,796349,14,1,3,1,1,0,2,1,2,1,0,1,1,2,0,0,3
9464,792029,35,7,13,6,10,1,3,2,4,2,7,5,3,0,1,1,17
9464,797637,34,2,3,1,1,1,2,2,3,0,2,1,4,1,1,0,7
9464,761149,39,3,8,1,3,2,5,12,15,2,8,0,4,1,0,0,20
9464,792031,34,5,9,3,6,2,3,0,0,1,2,7,3,0,2,0,12
9464,780828,36,9,16,7,12,2,4,4,6,0,8,5,2,0,3,0,24
9464,785822,5,1,1,1,1,0,0,0,0,0,0,0,0,0,1,0,2
9464,797640,4,1,1,1,1,0,0,0,0,0,0,0,0,0,0,0,2
9464,797636,9,1,1,1,1,0,0,0,0,0,1,0,3,0,1,0,2
9464,792030,4,0,0,0,0,0,0,0,0,0,2,0,0,0,0,0,0
9465,797779,40,4,12,3,7,1,5,3,4,5,4,1,1,1,1,0,12
9465,785568,23,1,2,1,2,0,0,1,2,1,5,0,5,1,2,0,3
9465,797778,14,4,11,1,4,3,7,0,0,0,2,0,5,0,0,0,11
9465,786256,28,2,5,2,5,0,0,0,0,0,2,1,2,0,1,1,4
9465,797774,26,3,9,2,4,1,5,9,10,2,3,0,3,0,1,0,16
9465,797770,6,1,2,1,2,0,0,0,0,0,0,1,3,1,1,0,2
9465,797781,1,0,0,0,0,0,0,0,0,0,0,0,0,0,0,0,0
9465,797780,4,0,0,0,0,0,0,0,0,0,0,0,0,0,0,0,0
9465,797771,9,0,1,0,0,0,1,0,0,0,2,0,1,0,0,0,0
9465,797768,21,3,11,1,4,2,7,0,0,0,1,1,1,1,0,0,8
9465,775106,28,4,7,4,5,0,2,5,6,1,2,0,3,0,3,0,13
9466,797695,19,8,10,8,10,0,0,1,3,2,4,0,4,1,3,0,17
9466,797699,13,2,4,2,4,0,0,0,0,0,0,3,0,1,2,0,4
9466,797692,33,2,2,0,0,2,2,1,2,0,2,2,1,0,1,0,7
9466,791954,27,1,5,1,2,0,3,7,9,1,1,1,0,1,1,0,9
9466,780846,40,4,11,4,10,0,1,4,9,2,7,5,2,2,4,1,12
9466,797694,26,4,6,0,0,4,6,2,2,1,1,2,3,1,1,1,14
9466,780844,19,4,7,0,0,4,7,0,0,0,2,1,3,0,0,1,12
9466,791956,23,2,4,2,3,0,1,1,2,0,2,1,2,0,2,0,5
9467,796479,11,0,2,0,0,0,2,0,0,0,1,2,2,0,2,0,0
9467,781560,16,4,4,4,4,0,0,0,0,0,1,0,5,0,0,0,8
9467,791375,32,3,5,2,3,1,2,0,0,0,6,3,1,1,2,0,7
9467,785482,32,7,12,7,11,0,1,3,5,1,3,0,1,1,1,0,17
9467,780837,35,3,10,3,8,0,2,4,4,0,1,0,5,0,2,0,10
9467,786164,31,3,7,2,4,1,3,0,0,2,2,0,5,0,1,1,7
9467,796477,20,2,3,1,1,1,2,2,2,0,3,1,2,1,6,0,7
9467,796473,23,5,7,5,6,0,1,3,4,1,2,2,2,3,2,0,13
9468,791344,32,2,5,2,5,0,0,1,2,4,5,0,3,2,2,1,5
9468,781425,32,6,7,6,7,0,0,2,6,3,10,1,3,0,1,2,14
9468,791343,40,4,13,4,11,0,2,3,6,1,8,8,2,0,4,0,11
9468,781602,40,11,23,6,13,5,10,7,11,2,3,2,4,2,0,0,34
9468,775746,22,4,6,2,2,2,4,2,2,0,0,1,4,1,1,0,12
9468,781601,8,1,3,1,3,0,0,0,0,2,3,1,3,0,0,1,2
9468,797000,8,0,0,0,0,0,0,0,0,0,1,0,1,0,0,0,0
9468,786611,18,1,3,0,1,1,2,2,2,0,0,0,1,1,0,0,5
9469,796850,24,1,7,1,6,0,1,0,0,0,1,1,5,0,1,0,2
9469,774969,32,3,7,3,7,0,0,9,11,2,7,1,2,0,2,0,15
9469,791179,27,1,4,0,0,1,4,2,2,2,6,1,3,0,0,0,5
9469,781054,32,3,13,2,6,1,7,8,13,1,3,1,4,0,0,1,15
9469,781053,39,8,18,3,11,5,7,1,1,1,2,5,2,3,2,0,22
9469,785670,12,1,5,0,1,1,4,0,0,1,1,0,5,0,1,0,3
9469,780981,7,1,2,1,2,0,0,0,0,0,1,0,3,0,1,0,2
9469,791181,27,3,4,2,3,1,1,4,4,1,3,3,0,0,1,1,11
9469,796848,0,0,0,0,0,0,0,0,0,0,0,0,0,0,0,0,0
9470,776286,36,4,9,3,6,1,3,1,2,4,8,2,2,1,2,1,10
9470,775557,13,1,1,1,1,0,0,1,1,0,0,0,2,0,0,0,3
9470,791445,27,2,9,1,2,1,7,0,0,0,0,2,3,0,1,0,5
9470,785357,38,5,12,3,5,2,7,5,8,2,6,1,2,0,1,1,17
9470,775560,37,6,14,4,8,2,6,5,7,3,5,3,2,2,4,0,19
9470,785287,11,1,1,1,1,0,0,1,1,2,1,0,0,0,1,0,3
9470,781627,10,0,2,0,1,0,1,2,2,2,0,0,3,1,1,0,2
9470,797010,28,3,12,1,8,2,4,0,0,1,3,1,2,0,0,2,8
9471,785518,19,4,4,2,2,2,2,1,3,2,1,4,4,3,5,0,11
9471,796390,16,2,4,2,4,0,0,1,3,1,4,0,3,0,1,1,5
9471,785451,35,5,9,4,6,1,3,3,3,1,1,2,3,2,4,0,14
9471,790832,34,3,11,2,6,1,5,0,0,0,4,4,2,1,1,0,7
9471,790834,31,3,8,0,1,3,7,2,3,1,3,1,2,0,0,0,11
9471,790831,24,4,5,4,5,0,0,1,4,1,4,2,1,0,1,3,9
9471,790830,21,0,2,0,2,0,0,0,0,0,2,0,2,0,0,0,0
9471,790833,18,2,6,1,2,1,4,1,2,0,3,1,3,1,0,0,6
9471,785379,2,0,0,0,0,0,0,1,2,0,0,0,0,0,0,0,1
9472,780027,37,9,18,8,12,1,6,2,3,4,12,2,3,1,2,3,21
9472,786176,12,5,5,3,3,2,2,0,0,0,1,1,0,0,1,0,12
9472,786173,30,2,5,1,2,1,3,1,2,0,0,0,0,1,1,1,6
9472,780028,31,0,2,0,1,0,1,1,2,0,3,3,3,0,0,0,1
9472,774828,34,4,12,1,3,3,9,5,5,1,5,8,2,0,3,0,16
9472,791379,15,1,3,1,2,0,1,0,0,0,1,1,0,0,1,0,2
9472,797175,27,5,6,5,6,0,0,3,4,3,3,0,2,0,0,3,13
9472,791380,12,2,4,2,3,0,1,2,4,0,0,2,2,0,1,0,6
9472,797178,2,0,0,0,0,0,0,0,0,0,1,0,0,0,0,0,0
9473,790930,27,3,5,3,4,0,1,0,0,1,3,2,5,1,0,0,6
9473,780358,14,2,5,2,3,0,2,0,0,0,2,1,1,0,0,1,4
9473,775011,22,2,7,1,3,1,4,0,0,0,4,1,0,0,0,0,5
9473,780357,37,5,10,3,6,2,4,2,2,0,5,4,4,2,2,0,14
9473,775018,26,3,8,2,5,1,3,1,1,0,3,3,5,0,2,0,8
9473,776004,26,9,12,5,6,4,6,1,1,0,1,2,3,0,0,1,23
9473,776270,17,1,6,1,3,0,3,0,0,0,2,0,1,0,0,0,2
9473,796480,31,3,7,2,6,1,1,4,4,1,1,3,2,4,2,0,11
9474,791917,25,4,7,2,3,2,4,1,2,1,1,1,2,0,0,1,11
9474,786526,29,5,10,4,8,1,2,2,2,2,5,2,1,0,1,0,13
9474,786525,33,5,13,3,6,2,7,0,0,0,4,3,2,2,3,0,12
9474,791920,2,0,0,0,0,0,0,0,0,0,0,0,0,1,0,0,0
9474,791914,31,4,7,2,3,2,4,1,2,0,1,6,2,1,2,0,11
9474,786030,26,6,10,4,7,2,3,0,0,0,3,4,2,1,2,1,14
9474,786856,16,3,5,3,5,0,0,0,3,3,3,2,3,0,1,1,6
9474,797550,17,4,7,2,2,2,5,0,0,0,2,1,1,2,1,0,10
9474,781109,6,0,0,0,0,0,0,0,0,0,0,0,1,1,1,0,0
9474,786524,15,1,1,1,1,0,0,0,0,0,2,2,2,0,1,0,2
9475,781007,30,4,5,4,5,0,0,0,0,2,4,2,2,2,2,1,8
9475,781322,28,2,9,1,3,1,6,2,2,1,3,0,3,2,3,0,7
9475,786571,33,4,10,2,4,2,6,5,6,1,5,5,3,0,3,0,15
9475,781419,34,8,16,1,4,7,12,0,0,1,0,5,1,1,2,0,23
9475,780563,34,3,6,1,3,2,3,0,0,2,6,6,0,0,1,0,8
9475,797299,10,2,2,2,2,0,0,2,4,0,3,0,4,1,0,0,6
9475,785989,15,1,2,0,0,1,2,0,0,0,0,2,1,0,1,0,3
9475,781207,4,0,1,0,1,0,0,3,4,0,1,0,0,0,1,0,3
9475,784248,12,2,5,1,1,1,4,0,0,0,0,1,1,0,0,0,5
9476,775897,28,2,4,2,4,0,0,2,2,2,5,3,2,2,4,0,6
9476,780324,31,7,12,7,12,0,0,6,6,1,7,4,3,0,1,2,20
9476,791543,31,5,6,2,3,3,3,0,0,0,2,2,2,0,0,0,13
9476,786530,38,6,11,1,2,5,9,3,4,0,1,3,2,3,4,0,20
9476,780317,21,2,3,1,2,1,1,1,1,0,3,1,3,0,0,1,6
9476,791545,16,1,4,1,2,0,2,0,1,0,2,2,1,0,1,0,2
9476,784246,26,1,2,0,0,1,2,0,0,0,3,4,1,0,1,1,3
9476,797092,9,2,2,2,2,0,0,1,1,1,1,0,1,0,1,0,5
9477,785631,36,8,10,7,9,1,1,3,3,2,3,2,2,0,0,0,20
9477,786248,36,4,9,4,9,0,0,1,3,3,8,2,3,1,3,0,9
9477,791200,40,4,15,2,9,2,6,2,2,0,1,2,3,3,1,0,12
9477,785630,40,6,14,2,7,4,7,4,4,1,0,4,2,0,0,0,20
9477,785632,40,2,5,2,5,0,0,0,0,1,2,1,2,2,2,0,4
9477,791199,3,0,0,0,0,0,0,0,0,0,1,0,2,0,0,0,0
9477,791198,5,0,2,0,0,0,2,0,0,0,0,0,0,0,0,0,0
9478,785298,9,0,0,0,0,0,0,0,0,0,0,1,3,0,1,0,0
9478,775224,28,4,8,4,8,0,0,2,3,5,10,2,2,0,0,0,10
9478,778046,29,5,7,3,3,2,4,6,6,0,4,5,3,0,4,0,18
9478,782121,36,6,7,3,4,3,3,2,5,0,3,7,2,1,1,1,17
9478,775793,36,11,16,1,4,10,12,3,4,1,2,1,0,1,0,0,35
9478,785485,17,2,4,2,4,0,0,0,0,1,2,1,2,2,1,0,4
9478,785302,14,1,5,1,3,0,2,1,2,0,1,1,4,0,3,0,3
9478,786594,23,0,4,0,2,0,2,0,0,1,2,1,2,0,1,0,0
9478,796599,1,0,0,0,0,0,0,0,0,1,0,0,0,0,0,1,0
9478,790987,2,0,1,0,1,0,0,0,0,0,0,0,0,0,0,0,0
9478,778469,2,0,1,0,1,0,0,1,2,1,0,0,1,0,0,0,1
9478,796598,2,0,1,0,1,0,0,0,0,0,0,0,0,0,0,0,0
9478,785301,1,0,1,0,0,0,1,0,0,1,1,0,0,0,1,0,0
9479,780323,22,3,8,3,8,0,0,2,3,2,2,0,2,0,1,3,8
9479,797894,22,3,8,3,8,0,0,0,1,4,0,1,5,0,0,0,6
9479,792229,24,2,9,2,4,0,5,7,10,0,1,2,4,1,1,0,11
9479,785954,36,7,10,3,4,4,6,0,0,0,5,4,2,2,2,2,18
9479,785811,30,3,9,2,6,1,3,0,0,0,3,0,3,2,0,0,7
9479,792233,31,4,9,1,6,3,3,0,2,0,0,5,3,0,2,0,11
9479,792230,13,1,1,1,1,0,0,0,0,0,1,0,2,0,0,0,2
9479,792234,6,2,2,2,2,0,0,1,1,1,2,0,0,0,0,0,5
9479,797891,9,1,1,1,1,0,0,0,0,1,0,1,0,0,0,0,2
9479,781356,5,1,1,0,0,1,1,0,0,0,0,0,0,0,1,0,3
9479,797893,2,0,1,0,1,0,0,0,0,0,0,0,0,0,0,0,0
9480,785800,23,2,5,0,1,2,4,0,0,0,2,0,0,0,0,0,6
9480,785799,21,3,4,3,4,0,0,2,2,2,4,0,0,1,0,0,8
9480,791676,29,3,7,1,2,2,5,3,5,2,1,7,1,1,2,0,11
9480,780554,28,3,7,2,5,1,2,0,0,0,2,0,0,2,1,0,7
9480,780553,33,9,21,7,18,2,3,1,2,1,6,5,2,4,0,0,21
9480,797426,4,2,3,1,1,1,2,0,0,0,0,0,0,0,0,0,5
9480,791678,6,0,0,0,0,0,0,0,0,1,2,1,3,0,0,0,0
9480,785807,11,0,0,0,0,0,0,0,0,0,1,1,1,0,0,0,0
9480,780760,20,2,4,1,2,1,2,3,4,1,2,0,1,0,0,1,8
9480,797427,14,3,7,0,2,3,5,0,0,0,0,0,2,0,1,0,9
9480,791677,11,1,3,1,2,0,1,0,0,1,2,0,2,0,0,0,2
9481,791220,31,2,5,0,1,2,4,3,4,0,4,1,0,0,1,0,9
9481,791219,26,3,7,1,1,2,6,0,0,0,4,1,2,0,3,0,8
9481,776217,27,3,7,3,7,0,0,0,0,2,1,1,2,1,0,0,6
9481,790818,34,6,12,6,8,0,4,1,2,0,0,3,4,1,3,0,13
9481,780730,36,4,9,3,3,1,6,2,3,0,6,2,1,0,4,0,11
9481,786824,27,6,12,3,6,3,6,0,0,3,6,0,1,0,0,1,15
9481,791221,10,1,1,0,0,1,1,0,0,0,2,0,0,0,0,1,3
9481,786396,9,0,1,0,1,0,0,0,0,0,0,1,2,0,0,0,0
9482,791316,29,5,7,5,7,0,0,0,0,1,5,1,2,1,1,2,10
9482,780870,30,6,8,6,8,0,0,5,6,5,7,0,1,2,0,1,17
9482,781079,30,3,7,2,4,1,3,1,2,0,2,4,0,1,0,0,8
9482,781443,30,4,15,4,11,0,4,3,5,0,3,5,0,1,2,1,11
9482,775822,34,5,15,1,10,4,5,7,8,1,6,5,1,2,3,0,21
9482,796625,5,0,0,0,0,0,0,0,0,0,0,0,1,0,0,0,0
9482,796621,21,1,4,1,2,0,2,2,5,0,4,1,1,1,1,0,4
9482,785380,21,4,6,3,4,1,2,4,4,1,3,1,2,0,2,2,13
9483,792334,29,3,10,2,7,1,3,1,2,3,6,1,1,1,2,0,8
9483,786575,23,4,5,4,5,0,0,0,0,2,3,0,5,1,0,2,8
9483,799842,21,2,4,2,2,0,2,0,0,0,3,2,4,0,2,0,4
9483,792338,38,9,16,8,14,1,2,0,2,0,6,6,5,2,4,1,19
9483,781666,33,6,18,2,5,4,13,4,5,0,3,1,3,0,3,0,20
9483,798097,7,0,2,0,2,0,0,0,0,0,2,0,0,0,0,0,0
9483,786708,17,2,5,1,4,1,1,0,0,1,0,0,3,0,2,0,5
9483,785531,7,1,1,0,0,1,1,1,1,0,1,0,0,0,0,0,4
9483,798095,2,0,1,0,0,0,1,0,0,0,0,0,0,0,0,0,0
9483,791636,23,2,6,1,3,1,3,0,0,1,2,1,2,0,0,0,5
9484,780062,15,2,4,2,4,0,0,0,0,0,3,0,3,0,0,1,4
9484,786395,33,4,8,3,5,1,3,5,8,0,7,3,3,1,2,0,14
9484,786394,37,6,12,3,5,3,7,0,1,0,10,3,5,0,3,0,15
9484,780404,37,5,9,5,7,0,2,0,0,1,3,2,1,2,4,1,10
9484,780403,12,0,1,0,0,0,1,0,0,0,1,0,0,1,0,0,0
9484,791585,20,3,6,0,1,3,5,0,0,0,1,1,4,0,2,1,9
9484,791581,23,1,3,1,3,0,0,0,0,0,3,3,0,0,1,0,2
9484,785228,23,2,5,1,2,1,3,2,4,0,1,0,3,1,1,1,7
9485,781175,25,0,3,0,3,0,0,7,10,3,2,1,3,0,1,0,7
9485,786555,21,1,6,0,2,1,4,0,0,0,1,1,4,0,0,0,3
9485,786553,36,4,11,2,4,2,7,7,7,1,5,2,1,1,1,0,17
9485,780895,22,2,8,1,6,1,2,1,2,1,6,0,0,1,2,0,6
9485,781172,28,0,4,0,1,0,3,0,0,0,2,3,4,1,0,0,0
9485,792005,29,11,18,6,10,5,8,4,5,5,3,1,2,2,2,0,31
9485,781177,14,0,0,0,0,0,0,0,0,0,2,0,2,1,1,0,0
9485,785312,23,1,6,1,4,0,2,0,0,0,7,2,0,3,2,0,2
9485,786557,2,0,0,0,0,0,0,0,0,0,0,0,0,0,0,0,0
9486,786765,37,4,11,4,5,0,6,1,2,1,5,4,1,0,2,1,9
9486,792379,31,1,6,1,1,0,5,0,0,0,6,1,1,0,0,0,2
9486,792380,37,3,9,0,1,3,8,0,0,0,1,0,2,0,0,0,9
9486,781672,37,10,16,9,15,1,1,3,5,3,11,0,2,0,2,0,24
9486,781669,40,5,14,5,11,0,3,2,4,1,3,5,0,1,0,0,12
9486,797852,13,1,2,1,1,0,1,0,0,0,2,0,2,0,0,0,2
9486,797854,4,0,1,0,0,0,1,1,2,1,0,0,1,0,0,0,1
9486,797860,1,0,0,0,0,0,0,0,0,0,0,0,0,0,0,0,0
9486,797857,0,0,0,0,0,0,0,0,0,0,0,0,0,0,0,0,0
9486,792384,0,0,0,0,0,0,0,0,0,0,0,0,0,0,0,0,0
9487,791616,25,4,7,4,7,0,0,0,0,2,6,1,2,0,0,0,8
9487,780797,31,6,12,3,6,3,6,0,0,4,7,0,2,0,2,0,15
9487,785505,37,9,19,6,12,3,7,2,4,0,1,2,1,0,1,0,23
9487,780555,35,2,6,1,1,1,5,0,0,1,8,3,2,0,0,0,5
9487,775604,29,1,11,1,4,0,7,0,0,0,5,4,1,0,0,0,2
9487,796981,24,5,9,3,6,2,3,2,2,4,1,3,3,2,1,0,14
9487,791618,19,2,4,0,1,2,3,0,0,0,4,0,2,0,0,0,6
9488,791135,37,7,11,7,11,0,0,1,3,2,7,0,1,0,3,1,15
9488,796791,14,0,1,0,0,0,1,0,0,0,2,0,0,0,1,0,0
9488,791132,33,3,8,2,2,1,6,2,2,4,6,0,2,3,1,2,9
9488,786090,40,5,14,4,7,1,7,5,5,2,8,3,4,1,5,0,16
9488,786088,43,5,12,5,11,0,1,0,0,1,9,6,2,3,3,0,10
9488,791133,3,0,0,0,0,0,0,0,0,0,0,0,0,0,1,1,0
9488,791131,7,0,2,0,1,0,1,0,0,0,2,0,1,0,2,1,0
9488,791521,8,0,1,0,1,0,0,0,0,1,0,0,1,0,0,1,0
9488,796790,22,2,10,1,6,1,4,2,2,1,1,0,5,2,3,0,7
9488,774921,18,1,3,1,3,0,0,2,2,0,1,2,3,0,3,0,4
9489,796554,40,3,7,3,5,0,2,3,5,1,4,0,3,0,0,1,9
9489,790961,44,1,7,1,7,0,0,2,2,6,8,6,1,8,2,0,4
9489,785278,43,7,16,5,10,2,6,3,6,2,3,0,2,2,4,1,19
9489,780146,41,3,18,1,9,2,9,5,6,0,4,4,4,3,2,1,13
9489,775860,41,6,15,0,3,6,12,1,2,0,6,3,0,1,3,1,19
9489,796555,6,0,3,0,1,0,2,0,0,0,0,0,2,0,0,0,0
9489,796553,7,0,1,0,1,0,0,0,0,0,0,0,1,1,1,0,0
9489,786240,3,0,0,0,0,0,0,0,0,0,0,0,0,1,0,0,0
9490,781044,34,5,13,3,9,2,4,4,4,2,4,2,2,3,1,2,16
9490,791795,27,1,3,1,2,0,1,0,2,3,5,1,0,0,2,1,2
9490,786489,31,5,10,3,6,2,4,3,4,0,2,2,0,0,1,0,15
9490,786488,33,2,14,2,13,0,1,5,8,2,3,1,4,0,3,1,9
9490,781038,34,5,9,4,5,1,4,4,4,3,6,4,4,0,1,0,15
9490,797620,20,2,2,1,1,1,1,1,2,1,4,0,2,0,1,0,6
9490,786490,5,1,1,1,1,0,0,0,0,1,0,0,1,0,0,0,2
9490,797621,4,0,0,0,0,0,0,0,0,0,1,0,0,0,0,0,0
9490,797619,12,1,1,1,1,0,0,2,2,1,0,0,2,1,2,0,4
9491,792340,36,9,15,9,14,0,1,5,7,5,5,3,2,0,0,0,23
9491,792342,34,2,7,1,4,1,3,2,2,0,0,2,3,1,1,0,7
9491,792346,35,2,5,2,5,0,0,2,2,1,3,4,4,1,0,0,6
9491,781553,33,5,10,5,8,0,2,1,2,2,5,1,4,2,0,0,11
9491,781552,34,6,16,5,10,1,6,0,2,1,4,3,2,0,3,0,13
9491,798085,8,1,3,0,1,1,2,2,2,0,3,0,1,0,0,0,5
9491,798080,5,0,1,0,0,0,1,0,0,0,0,0,2,0,0,0,0
9491,792344,7,0,1,0,0,0,1,0,0,0,0,1,0,0,1,0,0
9491,792341,8,0,0,0,0,0,0,0,0,0,0,2,1,0,1,0,0
9492,785459,21,11,12,11,12,0,0,0,0,0,3,0,0,2,0,0,22
9492,789101,26,3,4,2,2,1,2,0,0,0,2,3,1,0,2,0,7
9492,789102,27,3,9,3,8,0,1,2,2,0,10,6,2,1,4,0,8
9492,781371,20,5,6,2,2,3,4,0,0,0,3,1,3,1,2,0,13
9492,781367,19,2,5,1,2,1,3,2,2,0,4,1,1,1,4,0,7
9492,797731,15,3,3,3,3,0,0,0,0,0,3,0,1,1,0,0,6
9492,792066,14,1,1,1,1,0,0,0,0,1,1,0,2,0,0,0,2
9492,781362,2,1,1,0,0,1,1,0,0,0,0,0,0,0,0,0,3
9492,792064,14,0,3,0,0,0,3,0,0,0,1,0,2,0,1,0,0
9492,792063,19,1,2,1,2,0,0,5,6,1,1,1,1,0,1,0,7
9492,792061,8,0,1,0,0,0,1,0,0,0,0,0,0,0,0,0,0
9492,788037,12,2,3,1,1,1,2,0,0,0,2,2,1,0,1,1,5
9492,789982,2,0,1,0,1,0,0,0,0,0,0,1,0,0,0,0,0
9492,797729,1,0,0,0,0,0,0,0,0,0,0,0,0,0,0,0,0
9493,791062,34,3,9,3,6,0,3,0,0,0,2,1,1,1,0,3,6
9493,791063,24,3,6,2,4,1,2,2,2,1,4,1,2,1,2,1,9
9493,785542,35,3,5,3,4,0,1,4,6,0,4,1,5,0,3,1,10
9493,780743,39,8,17,7,12,1,5,1,2,0,2,0,2,3,2,0,18
9493,780055,24,0,2,0,0,0,2,0,0,2,2,3,0,1,1,0,0
9493,791060,15,2,3,2,3,0,0,1,4,0,1,0,2,1,3,0,5
9493,785548,7,0,2,0,0,0,2,0,2,0,1,0,0,0,0,0,0
9493,791064,22,2,7,1,3,1,4,0,0,0,0,0,4,0,2,0,5
9494,775954,34,6,10,6,9,0,1,2,4,1,6,4,3,1,0,0,14
9494,781006,23,2,8,2,4,0,4,1,2,6,2,0,2,2,0,1,5
9494,796194,32,2,6,2,2,0,4,2,2,1,3,2,0,0,2,0,6
9494,796464,34,7,11,7,11,0,0,0,1,1,2,2,3,2,4,0,14
9494,796459,20,2,7,2,6,0,1,0,0,1,1,3,1,1,2,0,4
9494,790918,2,0,0,0,0,0,0,0,0,0,0,0,1,1,0,0,0
9494,790917,25,3,8,2,5,1,3,1,2,5,5,1,2,1,1,1,8
9494,781157,25,5,11,3,4,2,7,2,2,0,0,1,2,0,2,0,14
9494,790916,2,0,1,0,0,0,1,0,0,0,0,0,0,0,0,0,0
9494,785238,1,0,0,0,0,0,0,0,0,0,0,0,0,0,0,0,0
9494,780648,2,0,0,0,0,0,0,0,0,0,0,0,0,0,0,0,0
9495,785368,28,3,6,3,6,0,0,5,5,2,4,0,4,0,3,2,11
9495,780281,28,2,5,2,5,0,0,1,1,0,2,0,1,0,2,0,5
9495,790792,35,3,10,3,6,0,4,0,3,2,1,1,2,3,2,0,6
9495,785246,25,3,7,2,4,1,3,1,1,0,3,0,0,1,1,0,8
9495,780886,35,7,14,6,10,1,4,4,6,0,2,3,0,0,2,0,19
9495,790794,15,0,0,0,0,0,0,0,0,0,2,0,2,1,0,1,0
9495,790789,12,1,2,1,1,0,1,0,0,1,2,2,1,3,5,0,2
9495,796350,14,1,3,0,2,1,1,0,0,2,0,0,3,0,1,0,3
9495,796351,8,0,1,0,1,0,0,0,2,1,2,0,1,0,0,0,0
9495,790791,0,0,0,0,0,0,0,0,0,0,0,0,0,1,0,0,0
9496,785589,38,7,14,7,14,0,0,9,11,2,2,3,1,1,4,0,23
9496,791209,15,0,0,0,0,0,0,5,6,1,3,1,1,0,0,1,5
9496,791215,31,0,5,0,2,0,3,0,0,0,1,7,5,2,1,1,0
9496,791213,27,3,11,1,4,2,7,0,0,0,3,1,2,0,0,1,8
9496,791214,35,4,10,3,6,1,4,4,6,2,4,3,4,2,1,0,13
9496,791216,31,4,12,3,8,1,4,4,5,1,7,2,2,1,2,2,13
9496,791212,14,1,2,1,2,0,0,0,0,1,1,0,0,0,0,0,2
9496,796917,7,0,1,0,0,0,1,0,0,0,1,1,0,0,1,0,0
9496,791217,1,0,0,0,0,0,0,2,2,0,0,0,0,0,0,0,2
9496,791211,1,0,0,0,0,0,0,3,3,0,0,0,0,0,0,0,3
9497,796778,29,3,7,3,5,0,2,1,2,3,4,2,2,3,4,1,7
9497,781107,17,3,4,3,4,0,0,1,2,1,1,1,4,0,0,0,7
9497,791972,36,7,15,4,6,3,9,2,2,1,5,2,2,0,1,0,19
9497,791974,38,4,9,2,4,2,5,2,2,1,3,5,2,2,1,0,12
9497,780863,31,5,11,3,7,2,4,4,6,2,5,5,3,1,1,0,16
9497,791973,7,0,0,0,0,0,0,0,0,0,0,1,2,0,0,0,0
9497,780867,10,1,4,1,3,0,1,0,1,0,3,0,2,0,0,0,2
9497,796780,31,6,11,1,2,5,9,2,2,0,6,3,3,1,2,1,19
9497,780873,0,0,0,0,0,0,0,0,0,0,0,0,1,0,0,0,0
9497,792708,1,0,0,0,0,0,0,0,0,0,0,0,0,0,0,1,0
9498,791482,35,6,8,3,4,3,4,0,0,1,5,5,1,1,3,0,15
9498,786319,22,2,7,2,7,0,0,6,6,4,4,2,0,1,1,0,10
9498,786318,36,7,14,3,6,4,8,3,3,0,8,2,1,1,0,1,21
9498,784268,28,3,11,3,8,0,3,2,2,1,3,4,2,0,0,0,8
9498,780223,32,3,7,2,3,1,4,2,3,1,2,1,2,0,1,0,9
9498,791481,13,1,2,1,2,0,0,0,0,0,1,0,2,0,1,0,2
9498,780225,19,4,8,2,3,2,5,0,0,0,2,0,2,0,1,0,10
9498,797199,15,2,3,2,2,0,1,0,0,1,0,2,3,0,1,0,4
9498,797201,0,0,0,0,0,0,0,0,0,0,0,0,1,0,0,0,0
9499,791787,33,7,16,5,10,2,6,0,0,2,6,0,3,1,2,0,16
9499,789048,29,1,2,1,2,0,0,0,0,0,4,1,3,0,2,0,2
9499,789046,27,5,10,4,5,1,5,3,3,0,6,1,5,4,2,1,14
9499,791786,28,5,8,2,4,3,4,2,3,1,1,2,2,0,2,0,15
9499,789041,27,3,9,1,1,2,8,3,4,0,1,2,0,0,1,1,11
9499,791785,15,2,3,1,2,1,1,1,2,0,0,0,0,0,0,0,6
9499,785540,11,1,3,1,3,0,0,0,0,0,0,2,1,0,0,2,2
9499,797631,2,0,0,0,0,0,0,0,0,0,1,1,0,0,0,0,0
9499,797630,25,3,5,0,0,3,5,0,0,1,2,4,0,0,0,0,9
9499,789044,3,0,0,0,0,0,0,0,0,0,0,0,0,0,0,1,0
9500,797241,27,8,8,8,8,0,0,5,6,0,2,0,1,3,0,2,21
9500,791366,31,1,6,1,2,0,4,2,2,4,3,3,1,1,1,0,4
9500,797244,25,2,4,1,3,1,1,0,0,0,4,3,5,0,3,1,5
9500,797243,21,1,6,1,5,0,1,0,0,1,4,1,4,0,1,1,2
9500,785742,37,7,20,4,10,3,10,4,6,0,2,2,1,1,1,0,21
9500,791361,9,1,4,0,1,1,3,0,0,0,2,0,3,0,0,0,3
9500,780170,14,2,4,2,3,0,1,2,3,1,3,0,2,0,3,1,6
9500,791363,15,2,5,2,3,0,2,0,0,0,2,1,0,1,0,0,4
9500,786340,21,2,5,1,2,1,3,0,0,0,3,0,1,1,1,0,5
9501,785522,11,0,3,0,3,0,0,0,0,1,2,0,5,0,0,1,0
9501,781247,35,6,10,2,3,4,7,2,2,1,1,1,2,1,1,0,18
9501,796947,27,2,10,0,3,2,7,2,2,1,4,4,3,0,1,0,8
9501,791249,38,6,17,3,8,3,9,9,11,3,6,1,1,0,5,0,24
9501,775358,36,4,8,2,4,2,4,4,4,0,6,6,4,1,2,0,14
9501,796949,6,0,1,0,1,0,0,0,0,0,1,0,0,1,0,1,0
9501,785523,3,0,1,0,1,0,0,0,0,0,0,0,2,0,0,0,0
9501,791250,26,3,5,1,2,2,3,0,0,1,7,0,1,0,3,0,8
9501,785521,18,0,2,0,0,0,2,0,0,0,1,0,0,1,1,0,0
9502,790827,24,1,4,0,3,1,1,0,0,1,3,2,1,1,1,0,3
9502,790828,12,0,1,0,1,0,0,1,2,0,3,0,2,0,2,1,1
9502,785372,37,6,13,5,11,1,2,5,6,1,4,3,1,1,0,0,18
9502,796385,9,0,2,0,2,0,0,0,0,0,1,1,0,0,1,0,0
9502,774905,21,3,5,2,3,1,2,0,0,0,2,0,4,0,2,0,7
9502,785375,24,1,2,1,2,0,0,3,5,3,5,1,3,3,0,1,5
9502,786384,17,5,7,4,5,1,2,0,0,1,4,0,4,0,0,0,11
9502,790825,33,8,16,8,14,0,2,5,6,0,4,4,2,0,2,0,21
9502,785373,14,0,4,0,2,0,2,4,4,1,2,0,1,0,0,0,4
9502,796387,2,0,0,0,0,0,0,0,0,1,0,0,0,0,0,0,0
9502,780007,7,0,0,0,0,0,0,0,0,0,0,1,0,0,0,0,0
9503,780012,37,3,9,2,5,1,4,2,2,2,2,1,0,0,1,0,9
9503,796309,25,4,10,4,10,0,0,4,6,2,5,1,4,0,2,0,12
9503,790824,35,4,12,2,7,2,5,0,0,1,5,5,3,2,3,2,10
9503,780011,5,2,2,1,1,1,1,0,0,0,0,0,0,0,0,0,5
9503,775667,36,5,12,4,7,1,5,0,1,1,2,7,1,0,1,0,11
9503,774895,15,2,3,2,3,0,0,0,1,0,4,2,5,0,0,0,4
9503,781524,31,5,10,3,4,2,6,1,1,2,2,0,0,0,0,0,13
9503,785370,8,0,2,0,1,0,1,0,0,1,0,0,1,0,1,0,0
9503,796382,8,0,0,0,0,0,0,0,0,0,1,1,1,0,0,0,0
9504,797591,31,5,11,2,4,3,7,0,0,0,5,2,3,0,3,1,13
9504,785424,32,4,8,4,8,0,0,1,2,8,10,1,1,0,1,2,9
9504,797589,36,4,12,2,7,2,5,3,4,1,4,1,3,0,4,1,13
9504,791889,36,1,4,0,1,1,3,0,0,0,4,2,1,0,3,1,3
9504,791890,39,6,16,4,11,2,5,5,5,1,4,4,2,5,1,0,19
9504,791887,4,1,1,1,1,0,0,0,0,1,0,0,0,0,0,0,2
9504,780098,8,0,0,0,0,0,0,0,0,0,1,0,2,0,0,1,0
9504,791888,14,2,4,2,2,0,2,0,0,0,0,1,0,0,1,0,4
9505,792110,15,0,1,0,0,0,1,0,2,0,1,0,4,1,0,0,0
9505,786031,23,4,11,2,6,2,5,1,3,2,0,0,2,2,0,0,11
9505,797734,33,1,9,0,4,1,5,2,2,0,2,1,3,0,3,0,5
9505,797735,38,2,8,2,7,0,1,0,0,1,4,1,1,0,5,0,4
9505,781386,39,7,16,6,10,1,6,3,4,1,6,6,2,1,1,0,18
9505,786033,25,1,3,1,2,0,1,0,0,2,4,0,3,1,1,3,2
9505,797733,26,2,6,1,4,1,2,2,2,1,2,0,0,1,1,0,7
9505,792105,1,0,0,0,0,0,0,0,0,0,0,0,0,0,0,0,0
9505,792107,0,0,0,0,0,0,0,0,0,0,0,0,0,0,0,0,0
9506,786547,14,0,2,0,0,0,2,0,0,0,0,2,4,1,0,1,0
9506,786544,30,3,8,3,7,0,1,3,3,1,5,0,5,0,3,2,9
9506,797507,37,5,13,3,7,2,6,4,6,1,3,1,0,1,1,1,16
9506,792012,40,8,15,8,9,0,6,6,6,1,3,3,2,0,3,0,22
9506,786546,37,2,8,1,5,1,3,6,6,0,7,2,3,2,0,2,11
9506,797512,3,0,0,0,0,0,0,0,0,0,0,0,0,2,0,0,0
9506,786860,29,8,11,6,9,2,2,0,0,0,4,1,2,0,0,1,18
9506,797510,4,0,0,0,0,0,0,0,0,0,0,0,0,1,0,0,0
9506,792013,5,0,1,0,1,0,0,0,0,0,3,0,1,0,0,0,0
9506,797508,1,0,0,0,0,0,0,0,0,0,0,0,1,0,0,0,0
9507,786481,29,4,12,4,11,0,1,0,1,0,9,1,0,0,2,0,8
9507,797626,30,2,6,1,4,1,2,3,8,3,3,3,4,1,3,0,8
9507,797624,26,5,5,4,4,1,1,0,1,0,1,1,3,1,1,0,11
9507,786480,32,1,6,1,5,0,1,9,10,1,4,2,3,1,2,1,11
9507,781032,25,1,6,1,3,0,3,3,4,0,1,2,2,0,3,0,5
9507,797628,29,5,9,5,8,0,1,1,1,3,4,0,3,0,1,0,11
9507,791791,8,0,2,0,0,0,2,0,0,1,1,0,0,0,0,0,0
9507,785965,21,5,11,4,6,1,5,0,0,0,3,1,1,0,0,0,11
9508,780874,21,2,5,0,0,2,5,0,0,0,2,2,1,1,0,1,6
9508,781326,19,3,5,3,5,0,0,0,0,2,2,1,2,0,5,0,6
9508,797870,32,4,9,2,4,2,5,2,4,0,6,4,4,2,4,0,12
9508,792210,27,3,6,2,3,1,3,0,1,0,2,3,3,0,2,0,7
9508,781323,36,3,8,1,4,2,4,5,7,1,1,4,0,0,5,0,13
9508,797868,7,1,1,1,1,0,0,0,0,1,2,1,0,0,0,0,2
9508,785430,20,2,5,2,5,0,0,1,2,1,2,0,2,1,2,0,5
9508,785638,19,5,10,4,7,1,3,0,0,1,1,0,1,0,1,2,11
9508,792215,16,1,2,1,1,0,1,0,0,0,1,2,1,0,2,0,2
9508,786688,1,0,0,0,0,0,0,0,0,0,0,1,0,0,0,0,0
9508,786687,1,0,0,0,0,0,0,0,0,0,0,0,0,0,0,0,0
9508,792218,1,0,0,0,0,0,0,0,0,0,0,0,0,0,0,0,0
9509,796469,24,2,6,2,4,0,2,0,0,0,4,4,2,1,5,1,4
9509,779981,26,6,7,6,7,0,0,1,2,0,3,1,2,0,2,1,13
9509,785463,33,5,9,2,4,3,5,0,0,1,4,6,1,3,3,0,13
9509,779978,30,5,11,3,6,2,5,2,2,1,1,3,0,4,2,0,14
9509,776003,29,5,7,1,3,4,4,2,2,0,5,3,3,0,2,0,16
9509,790923,23,5,9,5,8,0,1,0,0,2,0,0,3,1,1,2,10
9509,779980,7,0,0,0,0,0,0,0,0,0,0,0,3,0,0,0,0
9509,779979,21,2,6,0,0,2,6,0,0,0,4,2,0,0,0,0,6
9509,785466,3,0,0,0,0,0,0,0,0,0,0,1,1,0,0,0,0
9509,790924,2,0,1,0,1,0,0,0,0,0,2,0,0,0,0,0,0
9509,785467,1,0,0,0,0,0,0,0,0,0,0,0,0,0,0,0,0
9509,800039,1,0,0,0,0,0,0,0,0,0,0,0,0,0,0,0,0
9510,796404,37,6,10,6,10,0,0,2,4,4,3,2,4,3,1,1,14
9510,790853,24,5,6,5,6,0,0,0,0,2,4,2,1,0,1,1,10
9510,790850,33,5,9,3,3,2,6,0,0,0,1,2,2,0,1,0,12
9510,781164,30,3,6,2,2,1,4,2,2,0,4,4,1,0,1,0,9
9510,781163,32,7,15,6,10,1,5,1,2,0,2,2,3,1,3,0,16
9510,790849,27,2,6,2,4,0,2,2,2,0,1,3,3,1,1,0,6
9510,796406,8,0,1,0,1,0,0,0,0,0,1,0,2,0,1,0,0
9510,790854,4,0,1,0,1,0,0,0,0,1,1,0,1,0,0,0,0
9510,785434,3,0,0,0,0,0,0,0,0,0,0,0,1,0,0,0,0
9510,796405,2,0,0,0,0,0,0,0,0,0,0,0,1,0,1,0,0
9511,780094,35,5,9,1,3,4,6,0,0,0,6,5,1,1,1,0,14
9511,775142,21,5,7,2,3,3,4,5,6,1,2,1,4,0,0,0,18
9511,790843,36,3,8,1,5,2,3,2,2,2,1,6,3,1,3,0,10
9511,786212,35,4,7,4,4,0,3,2,4,1,4,1,1,2,1,0,10
9511,785392,40,7,12,1,5,6,7,2,3,1,2,3,1,0,4,0,22
9511,790844,19,2,2,2,2,0,0,0,0,0,2,1,1,0,1,0,4
9511,781563,14,1,2,1,2,0,0,0,1,0,0,1,0,0,0,0,2
9512,775820,13,1,3,1,3,0,0,0,0,2,3,0,1,0,0,0,2
9512,775538,20,3,5,3,5,0,0,0,0,1,0,0,1,0,1,0,6
9512,791110,25,0,5,0,4,0,1,4,4,0,0,2,1,0,0,0,4
9512,785603,35,10,21,5,11,5,10,2,2,1,2,3,2,0,0,0,27
9512,776425,34,9,18,6,9,3,9,1,1,1,1,4,0,0,0,0,22
9512,796763,13,2,4,0,1,2,3,0,0,3,5,1,0,0,0,0,6
9512,791107,7,1,2,1,1,0,1,0,0,0,2,0,0,0,1,0,2
9512,791106,27,1,1,1,1,0,0,0,0,0,4,0,3,1,0,1,2
9512,796762,3,0,0,0,0,0,0,0,0,0,1,0,1,0,0,0,0
9512,786494,23,2,3,2,3,0,0,0,0,0,2,1,1,1,0,0,4
9513,791201,29,5,10,5,10,0,0,4,4,2,6,2,2,0,3,0,14
9513,775767,33,5,7,4,6,1,1,1,4,2,6,2,1,0,0,1,12
9513,796902,16,1,2,1,1,0,1,0,0,0,0,0,1,0,0,0,2
9513,785628,38,7,14,5,10,2,4,0,1,0,4,4,0,0,2,0,16
9513,785627,30,6,10,1,4,5,6,0,0,1,2,2,1,1,0,0,17
9513,791202,17,1,2,0,0,1,2,0,0,0,1,1,0,0,0,0,3
9513,781135,7,1,2,1,2,0,0,0,0,2,2,0,1,0,0,0,2
9513,796901,11,3,6,2,3,1,3,0,0,0,1,2,1,0,0,0,7
9513,785629,19,2,3,1,2,1,1,2,2,0,2,1,0,0,0,0,7
9513,796903,0,0,0,0,0,0,0,0,0,0,0,0,0,0,0,0,0
9514,791344,33,1,5,1,3,0,2,2,4,2,4,2,1,1,1,2,4
9514,781425,34,4,7,4,7,0,0,2,3,0,6,2,2,0,2,0,10
9514,791343,37,6,10,3,4,3,6,1,4,0,2,3,1,2,5,0,16
9514,781602,40,7,20,2,4,5,16,1,2,0,4,3,4,1,3,1,20
9514,775746,33,1,6,0,1,1,5,3,4,0,2,0,0,1,0,3,6
9514,781601,6,0,0,0,0,0,0,2,2,2,0,0,0,1,0,1,2
9514,797000,2,0,1,0,0,0,1,0,0,0,0,0,0,0,0,0,0
9514,786611,15,0,1,0,1,0,0,0,0,0,0,1,1,0,1,0,0
9515,785522,29,3,6,2,5,1,1,0,0,5,4,0,2,1,0,0,7
9515,781247,22,4,11,2,4,2,7,0,0,4,2,0,5,1,1,0,10
9515,796947,34,8,16,7,14,1,2,2,2,2,2,6,1,1,0,0,19
9515,791249,38,4,11,2,3,2,8,0,0,0,3,4,1,0,1,0,10
9515,775358,31,5,12,1,5,4,7,0,0,1,9,3,4,1,3,0,14
9515,796949,7,1,2,1,2,0,0,0,1,1,2,0,1,1,0,1,2
9515,791250,23,5,9,3,4,2,5,2,2,1,6,1,1,1,3,0,14
9515,785521,13,0,3,0,1,0,2,0,0,0,1,0,0,0,2,0,0
9515,785523,3,0,0,0,0,0,0,0,0,0,0,0,0,0,0,0,0
9516,792035,38,8,21,8,21,0,0,4,5,7,2,3,1,0,3,1,20
9516,780833,26,6,10,6,10,0,0,0,2,5,2,3,0,1,2,1,12
9516,792034,40,8,18,4,11,4,7,8,9,1,8,7,2,0,3,0,28
9516,791688,37,3,6,3,3,0,3,0,2,1,4,4,3,3,2,1,6
9516,780830,24,4,6,2,3,2,3,0,0,0,2,2,3,0,3,0,10
9516,797645,10,5,6,5,6,0,0,0,1,0,1,0,3,0,2,0,10
9516,785980,25,0,1,0,0,0,1,2,2,0,2,1,1,1,0,0,2
9517,786547,25,4,6,1,1,3,5,0,0,0,1,1,5,3,1,1,11
9517,786544,21,6,11,4,7,2,4,0,0,1,1,0,4,0,2,1,14
9517,797507,38,8,11,4,5,4,6,2,2,0,4,2,1,2,1,0,22
9517,792012,40,6,14,4,9,2,5,4,4,1,2,10,1,3,6,0,18
9517,786546,40,3,4,2,3,1,1,6,6,0,3,4,5,1,4,0,13
9517,797512,0,0,0,0,0,0,0,0,0,0,0,0,2,0,0,0,0
9517,786860,29,4,5,2,3,2,2,2,2,0,5,0,2,0,0,2,12
9517,797510,7,0,4,0,1,0,3,0,0,0,1,1,0,0,0,0,0
9517,792013,0,0,0,0,0,0,0,0,0,0,0,0,0,0,0,0,0
9518,791067,30,4,6,4,5,0,1,1,2,1,1,2,3,2,1,0,9
9518,780751,10,1,2,1,1,0,1,2,2,1,0,2,4,1,1,0,4
9518,796743,34,3,11,1,4,2,7,0,0,0,2,3,3,1,2,0,8
9518,791068,33,5,12,5,9,0,3,5,7,5,3,1,2,0,0,0,15
9518,785551,36,5,11,1,2,4,9,2,2,2,4,1,3,0,1,1,16
9518,785642,2,1,1,1,1,0,0,0,0,0,0,1,2,0,0,0,2
9518,780512,24,6,12,6,10,0,2,1,4,1,5,0,2,0,0,2,13
9518,780756,6,0,2,0,1,0,1,0,0,0,0,0,0,0,0,0,0
9518,791066,22,3,9,0,2,3,7,0,0,0,4,2,4,1,1,0,9
9518,796744,3,0,0,0,0,0,0,0,0,0,0,0,0,0,0,0,0
9519,786623,20,2,4,2,4,0,0,5,6,3,4,4,3,0,0,0,9
9519,797405,37,4,13,4,12,0,1,2,2,0,11,1,4,1,3,0,10
9519,791834,39,6,9,3,5,3,4,4,5,0,1,1,3,2,4,0,19
9519,791833,17,1,1,1,1,0,0,3,5,0,2,1,2,0,3,0,5
9519,785920,34,7,10,5,6,2,4,6,6,1,1,5,2,0,0,0,22
9519,786624,20,1,4,1,4,0,0,6,6,1,5,0,3,0,1,1,8
9519,785698,21,1,2,0,0,1,2,0,0,0,4,0,0,0,0,2,3
9519,784077,12,1,4,1,3,0,1,0,2,0,1,0,2,0,2,0,2
9520,790798,28,8,11,8,10,0,1,2,5,2,6,4,1,1,3,0,18
9520,780140,31,5,12,5,7,0,5,4,4,1,5,2,0,0,3,0,14
9520,796355,32,7,9,6,6,1,3,0,0,1,6,3,4,2,3,0,15
9520,785245,29,4,9,2,6,2,3,0,0,0,2,2,1,1,0,0,10
9520,780137,27,7,9,5,6,2,3,0,0,2,6,1,3,0,1,0,16
9520,790799,18,1,5,1,5,0,0,0,0,0,3,0,0,2,1,0,2
9520,775553,20,0,3,0,3,0,0,0,0,1,1,1,4,0,1,0,0
9520,796354,7,1,2,1,2,0,0,0,0,0,2,0,2,0,1,0,2
9520,796359,4,0,2,0,2,0,0,0,0,0,1,0,1,0,0,0,0
9520,790795,1,0,0,0,0,0,0,0,0,0,1,0,0,0,0,0,0
9520,790796,3,0,0,0,0,0,0,1,2,1,0,0,0,0,0,0,1
9521,792121,30,2,7,1,1,1,6,0,0,3,3,0,0,1,1,1,5
9521,786257,28,4,5,4,5,0,0,0,0,0,4,0,2,2,0,2,8
9521,786263,24,2,4,1,2,1,2,0,0,0,3,1,0,1,1,0,5
9521,785661,32,4,17,4,13,0,4,7,9,1,3,1,3,0,3,1,15
9521,775825,34,6,14,6,13,0,1,1,2,0,3,3,1,1,4,0,13
9521,797721,7,1,2,1,1,0,1,0,0,0,0,0,1,0,0,0,2
9521,792122,13,0,4,0,1,0,3,0,0,1,3,0,0,1,1,0,0
9521,797725,10,2,2,2,2,0,0,1,1,2,2,0,2,0,1,0,5
9521,786249,9,0,3,0,1,0,2,0,0,0,1,0,1,0,1,0,0
9521,797724,11,0,2,0,1,0,1,0,0,0,0,0,0,0,0,0,0
9521,792356,2,1,1,1,1,0,0,0,0,0,1,0,1,0,0,0,2
9522,797591,37,2,6,2,4,0,2,2,2,0,5,0,4,2,1,1,6
9522,785424,24,1,3,1,3,0,0,1,2,4,1,1,4,2,0,2,3
9522,797589,39,11,21,7,15,4,6,4,4,1,1,0,1,1,0,0,30
9522,791889,21,0,0,0,0,0,0,0,0,0,0,0,1,0,0,1,0
9522,791890,38,10,25,9,17,1,8,2,4,2,2,5,2,3,3,0,23
9522,797590,10,1,3,1,3,0,0,0,0,2,1,0,3,0,0,1,2
9522,791887,2,0,0,0,0,0,0,0,0,0,0,0,0,0,0,0,0
9522,781071,1,0,1,0,0,0,1,0,0,0,0,0,1,0,1,0,0
9522,780098,6,0,1,0,1,0,0,0,0,0,2,0,0,0,0,0,0
9522,791888,22,1,3,0,1,1,2,0,0,2,1,1,2,2,1,0,3
9523,791201,27,2,3,2,3,0,0,2,2,4,7,0,3,2,2,0,6
9523,775767,32,4,8,2,6,2,2,2,4,3,9,3,2,0,6,1,12
9523,785628,36,6,11,4,7,2,4,0,0,0,6,4,3,0,3,0,14
9523,785627,32,5,10,4,7,1,3,4,4,0,2,3,1,0,2,0,15
9523,796902,25,5,8,4,6,1,2,0,0,0,0,2,2,0,0,0,11
9523,791202,14,2,6,0,1,2,5,2,2,0,1,1,0,0,1,0,8
9523,781135,8,1,1,1,1,0,0,0,0,0,0,0,1,0,1,0,2
9523,796901,6,0,0,0,0,0,0,0,0,0,0,0,2,0,1,0,0
9523,785629,20,1,3,1,3,0,0,4,4,0,1,1,2,0,0,0,6
9523,796904,0,0,0,0,0,0,0,0,0,0,0,0,0,0,0,0,0
9524,796673,19,1,5,1,4,0,1,0,0,2,6,1,1,3,4,0,2
9524,796674,36,4,9,3,5,1,4,0,0,3,6,1,4,2,2,0,9
9524,779857,31,5,8,5,8,0,0,8,8,1,6,2,2,0,4,3,18
9524,779976,40,6,13,3,8,3,5,8,8,1,8,2,2,0,1,0,23
9524,774990,30,5,11,4,7,1,4,5,6,0,2,5,5,0,2,0,16
9524,781586,13,1,3,1,3,0,0,1,3,1,3,1,3,0,1,0,3
9524,785961,33,2,6,1,3,1,3,1,2,0,2,0,3,1,4,0,6
9524,791014,17,2,4,1,2,1,2,0,0,0,1,0,2,0,1,0,5
9524,785339,6,0,2,0,0,0,2,0,0,0,0,0,2,1,1,0,0
9525,791997,13,1,8,0,0,1,8,2,2,0,2,0,3,0,1,0,5
9525,786566,40,7,16,5,12,2,4,4,5,1,8,5,2,1,1,1,20
9525,791993,34,4,6,4,6,0,0,0,1,0,2,1,3,0,2,0,8
9525,781189,36,5,9,4,7,1,2,4,4,3,5,0,5,3,3,0,15
9525,781188,43,7,24,6,15,1,9,1,2,1,5,2,4,0,7,0,16
9525,786568,24,3,3,3,3,0,0,2,4,3,2,0,4,0,0,1,8
9525,781204,18,1,2,1,1,0,1,1,2,0,1,0,2,0,0,0,3
9525,786562,17,1,4,1,1,0,3,0,0,0,1,3,2,2,0,0,2
9526,785681,20,1,2,1,2,0,0,2,2,3,1,0,1,0,2,2,4
9526,796789,28,4,8,3,6,1,2,0,0,0,6,2,1,2,1,2,9
9526,791126,26,5,9,5,9,0,0,6,10,3,0,2,3,0,1,0,16
9526,791124,33,4,9,2,4,2,5,0,0,0,3,4,1,0,1,2,10
9526,780050,31,4,11,2,7,2,4,4,4,2,11,5,3,0,4,0,14
9526,784479,7,0,1,0,1,0,0,0,0,0,1,0,0,0,0,0,0
9526,796786,9,3,4,0,0,3,4,2,3,0,1,0,0,0,0,0,11
9526,775813,16,2,5,2,5,0,0,0,0,0,2,2,2,0,2,0,4
9526,796784,11,1,2,1,1,0,1,1,1,0,0,2,2,0,1,0,3
9526,796782,17,0,1,0,0,0,1,0,0,0,1,1,1,0,0,0,0
9526,792711,2,0,1,0,1,0,0,0,0,0,0,0,0,0,0,0,0
9526,796788,0,0,0,0,0,0,0,0,0,0,0,0,0,0,0,0,0
9527,786039,27,3,11,3,11,0,0,2,2,11,4,0,4,0,1,0,8
9527,792043,30,2,6,2,5,0,1,2,3,1,2,0,4,1,0,0,6
9527,786266,38,4,12,3,7,1,5,1,2,0,2,3,1,0,0,0,10
9527,792040,39,12,19,12,18,0,1,1,2,0,6,1,1,3,2,1,25
9527,775028,36,4,14,3,7,1,7,0,2,0,4,7,4,1,1,1,9
9527,797726,16,1,6,1,4,0,2,2,2,3,5,1,3,0,1,0,4
9527,797718,11,1,1,0,0,1,1,0,0,0,0,1,2,1,1,0,3
9527,797728,3,0,0,0,0,0,0,0,0,0,0,0,0,0,0,0,0
9528,785800,24,2,7,2,5,0,2,1,3,2,3,0,2,0,0,0,5
9528,785799,18,4,6,4,6,0,0,0,0,3,1,0,3,0,1,0,8
9528,791676,28,4,9,1,2,3,7,4,6,0,0,0,2,3,1,0,15
9528,780554,29,1,6,0,2,1,4,0,0,2,2,0,2,0,1,0,3
9528,780553,36,10,20,10,19,0,1,5,13,4,8,6,1,0,3,1,25
9528,797426,5,0,0,0,0,0,0,0,0,0,0,0,0,1,1,1,0
9528,791678,5,0,1,0,1,0,0,0,0,0,0,1,1,1,0,0,0
9528,785807,11,1,3,0,0,1,3,0,0,1,4,0,0,0,0,0,3
9528,780760,22,2,5,1,2,1,3,0,0,1,3,0,1,1,0,3,5
9528,797427,12,1,4,1,1,0,3,2,2,0,0,0,2,0,0,0,4
9528,791677,10,0,1,0,1,0,0,1,2,0,1,1,0,1,0,0,1
9529,791616,29,7,8,7,8,0,0,2,2,2,7,0,1,0,1,2,16
9529,780797,37,4,12,1,3,3,9,2,2,4,6,2,1,0,3,0,13
9529,785505,39,3,11,3,7,0,4,2,2,0,5,3,3,1,3,0,8
9529,780555,23,0,3,0,1,0,2,0,0,0,6,1,4,1,1,0,0
9529,775604,37,2,8,2,5,0,3,1,1,0,2,4,4,1,2,0,5
9529,796981,26,5,11,3,8,2,3,4,4,1,2,1,1,1,5,0,16
9529,791618,9,1,1,1,1,0,0,1,2,0,0,0,5,0,1,0,3
9530,791316,26,1,5,0,4,1,1,0,0,1,3,1,2,0,0,0,3
9530,780870,27,2,4,2,4,0,0,3,4,4,6,2,1,1,0,1,7
9530,781079,32,5,14,5,10,0,4,1,1,0,3,3,3,3,2,0,11
9530,781443,31,4,14,1,7,3,7,7,8,3,5,2,1,1,6,0,18
9530,775822,31,3,12,2,9,1,3,2,2,0,2,2,5,0,2,1,9
9530,796621,27,5,7,3,4,2,3,2,2,0,1,2,5,1,0,0,14
9530,791314,3,0,0,0,0,0,0,0,0,0,1,0,1,0,0,0,0
9530,785380,23,4,6,2,3,2,3,1,1,0,1,0,2,0,2,1,11
9531,796554,39,1,4,0,1,1,3,0,0,2,4,2,3,3,0,0,3
9531,790961,34,0,3,0,3,0,0,4,4,6,4,2,4,3,1,2,4
9531,785278,37,8,19,6,12,2,7,4,6,1,5,1,2,0,3,0,22
9531,780146,26,4,11,3,5,1,6,6,8,0,3,2,2,2,2,0,15
9531,775860,40,10,18,4,8,6,10,6,9,1,6,2,3,2,4,0,32
9531,796553,18,2,3,2,3,0,0,0,0,1,3,1,2,1,2,1,4
9531,780832,3,0,0,0,0,0,0,0,0,0,0,0,0,0,0,0,0
9531,796555,3,0,0,0,0,0,0,0,0,0,0,0,0,0,0,0,0
9532,797529,33,4,8,4,8,0,0,1,7,5,6,1,2,0,0,1,9
9532,797527,33,3,8,2,6,1,2,0,0,1,3,4,3,1,1,1,7
9532,791936,38,9,15,9,15,0,0,1,6,6,3,2,0,1,1,0,19
9532,797532,40,4,9,2,5,2,4,4,8,0,6,7,2,0,2,1,14
9532,785688,38,5,13,2,4,3,9,4,5,0,1,0,1,0,0,0,17
9532,791932,12,1,2,0,1,1,1,0,0,0,0,1,3,1,0,1,3
9532,791933,2,0,0,0,0,0,0,0,0,0,1,1,0,0,0,0,0
9532,785988,4,0,3,0,0,0,3,0,0,0,1,0,0,0,0,0,0
9533,786519,32,3,4,3,4,0,0,0,0,5,9,1,3,0,2,1,6
9533,791911,18,0,5,0,1,0,4,0,0,1,2,0,2,0,0,0,0
9533,797556,37,3,15,2,6,1,9,1,2,0,2,4,1,1,3,0,8
9533,791913,38,6,16,4,11,2,5,0,0,2,1,6,3,0,1,0,14
9533,786520,37,9,22,5,13,4,9,4,5,6,3,1,4,1,1,1,26
9533,797558,15,2,6,2,4,0,2,0,0,4,2,2,1,0,2,0,4
9533,797560,8,0,0,0,0,0,0,0,0,1,3,0,4,0,0,1,0
9533,797559,2,0,0,0,0,0,0,0,0,0,0,0,0,0,0,0,0
9533,797555,5,0,0,0,0,0,0,0,0,0,0,0,2,0,0,0,0
9533,781105,8,0,1,0,0,0,1,0,0,0,0,0,0,0,0,0,0
9534,792029,24,6,8,5,6,1,2,1,2,0,5,1,5,0,3,0,14
9534,797637,37,2,5,2,2,0,3,0,0,0,3,1,3,3,1,2,4
9534,761149,36,9,15,8,11,1,4,0,0,1,1,0,4,0,0,0,19
9534,792031,39,4,5,0,0,4,5,2,2,1,2,3,2,0,2,0,14
9534,780828,33,5,15,3,11,2,4,11,16,2,7,5,3,0,5,0,23
9534,785822,6,0,0,0,0,0,0,0,0,0,0,0,0,0,1,1,0
9534,797640,17,0,0,0,0,0,0,1,2,2,0,2,5,0,1,0,1
9534,797636,4,0,0,0,0,0,0,0,0,0,0,2,1,0,1,0,0
9534,792030,4,0,0,0,0,0,0,0,0,0,0,0,1,0,0,0,0
9535,781044,33,5,7,5,6,0,1,10,11,4,5,1,4,1,1,0,20
9535,791795,12,3,4,3,4,0,0,1,2,2,1,0,3,0,3,0,7
9535,786489,32,2,9,1,5,1,4,0,0,0,3,0,2,1,1,0,5
9535,786488,37,5,15,5,13,0,2,6,8,1,2,3,2,0,3,0,16
9535,781038,37,5,13,4,9,1,4,3,6,0,6,3,2,1,1,0,14
9535,797620,27,3,4,2,3,1,1,1,1,3,2,0,4,0,2,2,8
9535,786490,7,1,2,1,2,0,0,0,0,2,0,0,0,1,0,0,2
9535,797621,2,0,0,0,0,0,0,0,0,0,0,0,0,0,0,0,0
9535,797619,13,2,5,2,3,0,2,3,3,0,0,0,2,1,0,0,7
9536,791876,30,5,20,4,12,1,8,0,2,5,5,1,2,0,2,3,11
9536,791877,23,0,1,0,1,0,0,0,2,0,0,0,3,0,1,1,0
9536,797491,9,0,0,0,0,0,0,0,0,0,0,0,2,0,0,0,0
9536,797486,37,11,16,9,13,2,3,4,8,1,5,3,4,1,4,1,28
9536,780436,39,9,15,4,7,5,8,1,2,0,6,2,3,0,4,0,24
9536,781205,11,0,1,0,1,0,0,0,0,0,3,0,4,1,1,3,0
9536,785667,32,4,8,2,3,2,5,0,0,1,3,3,1,1,1,0,10
9536,797487,17,0,0,0,0,0,0,0,0,1,2,0,0,0,0,0,0
9536,790396,2,0,0,0,0,0,0,0,0,0,0,0,0,0,1,0,0
9537,790821,39,6,14,6,13,0,1,2,2,4,5,4,3,1,1,1,14
9537,775585,33,4,5,4,5,0,0,4,5,3,3,2,1,3,2,1,12
9537,790822,37,5,13,4,9,1,4,9,10,0,2,4,2,1,1,0,20
9537,780982,37,5,11,3,5,2,6,2,2,0,6,3,1,0,1,0,14
9537,774980,35,4,12,3,5,1,7,5,7,1,3,4,2,2,1,0,14
9537,780445,8,1,2,1,2,0,0,0,2,2,3,0,1,0,0,0,2
9537,785365,11,1,3,0,1,1,2,0,0,0,0,0,0,0,0,0,3
9538,780377,29,2,9,0,1,2,8,0,0,1,5,0,0,1,0,0,6
9538,786600,29,2,5,2,5,0,0,1,4,2,1,8,2,1,3,0,5
9538,797460,29,1,7,0,3,1,4,1,4,1,1,2,1,0,0,1,4
9538,786601,21,1,8,0,2,1,6,0,0,0,4,0,2,1,4,0,3
9538,791852,11,1,2,1,2,0,0,1,2,1,0,0,5,0,1,1,3
9538,797461,21,3,9,2,5,1,4,0,0,1,3,0,1,1,2,0,7
9538,786602,6,2,3,0,0,2,3,0,0,0,1,0,0,0,0,0,6
9538,786599,6,0,0,0,0,0,0,5,6,0,1,0,0,0,0,0,5
9538,791851,23,2,5,2,5,0,0,0,1,1,1,1,2,1,2,0,4
9538,791853,16,2,7,2,6,0,1,0,1,0,1,0,3,0,0,0,4
9538,797459,8,0,1,0,1,0,0,1,2,0,0,1,1,0,0,0,1
9538,786604,1,0,1,0,1,0,0,0,0,0,0,0,0,0,0,0,0
9539,776396,34,5,12,4,11,1,1,4,4,1,2,0,2,1,4,0,15
9539,776199,27,3,10,3,9,0,1,6,6,0,2,2,2,1,1,0,12
9539,797164,18,5,8,5,8,0,0,0,2,2,0,2,2,0,1,0,10
9539,797163,17,4,6,4,6,0,0,1,3,3,6,0,3,0,1,0,9
9539,786450,32,3,7,3,6,0,1,1,2,2,9,2,1,3,3,1,7
9539,797167,22,4,5,4,5,0,0,1,2,4,6,1,3,0,0,0,9
9539,797165,20,2,5,1,3,1,2,0,0,0,2,1,3,0,2,0,5
9539,797161,6,1,4,0,2,1,2,0,0,0,0,0,1,0,0,0,3
9539,791382,4,1,2,1,2,0,0,0,0,0,0,1,0,0,0,0,2
9539,791385,17,0,1,0,1,0,0,0,0,0,10,2,3,2,2,0,0
9539,791386,1,0,0,0,0,0,0,0,0,0,0,0,0,0,0,0,0
9539,797162,1,0,0,0,0,0,0,0,0,0,0,0,0,0,0,0,0
9539,793778,1,0,0,0,0,0,0,0,0,0,0,0,0,0,0,0,0
9540,780269,27,9,23,7,16,2,7,3,3,1,1,0,4,1,7,0,23
9540,785700,38,2,8,2,4,0,4,2,3,2,2,5,2,3,3,0,6
9540,796838,25,2,3,2,3,0,0,1,1,4,0,0,3,0,1,2,5
9540,796837,28,1,12,1,8,0,4,2,2,2,8,0,2,0,1,0,4
9540,796834,27,0,3,0,1,0,2,2,2,1,2,0,1,0,0,0,2
9540,796833,18,5,10,2,2,3,8,3,3,0,0,0,1,0,0,0,16
9540,791171,20,1,5,1,4,0,1,5,6,2,3,0,3,1,0,0,7
9540,785706,13,0,3,0,1,0,2,0,0,1,1,1,1,0,1,0,0
9540,796832,4,0,2,0,0,0,2,0,0,0,0,1,0,0,0,0,0
9541,797180,34,7,12,4,6,3,6,2,2,3,8,2,1,2,1,1,19
9541,791497,19,5,9,2,3,3,6,0,0,1,3,0,2,0,1,0,13
9541,774812,19,4,8,4,8,0,0,2,3,0,0,1,3,1,3,0,10
9541,780240,24,2,2,2,2,0,0,4,6,0,5,1,3,1,4,0,8
9541,780461,18,3,6,3,5,0,1,0,1,2,7,4,3,1,5,0,6
9541,776379,23,4,10,2,3,2,7,0,0,0,3,2,1,0,0,0,10
9541,791500,19,2,5,2,5,0,0,4,4,1,1,1,1,1,0,0,8
9541,791503,20,2,5,1,3,1,2,0,0,4,3,2,2,0,2,0,5
9541,791502,15,2,3,2,3,0,0,0,0,0,2,2,4,0,1,0,4
9541,791498,6,1,2,1,2,0,0,0,0,1,3,0,0,0,1,0,2
9541,790517,3,0,0,0,0,0,0,0,0,0,0,0,1,0,1,0,0
9542,780050,38,9,16,8,12,1,4,4,6,0,10,4,3,1,0,1,23
9542,791126,38,8,16,8,16,0,0,0,0,5,8,3,2,3,3,0,16
9542,796789,32,7,14,6,9,1,5,0,0,2,6,3,1,1,1,3,15
9542,791124,32,5,9,4,7,1,2,0,1,0,1,5,3,2,1,1,11
9542,785681,28,1,2,1,2,0,0,1,2,0,4,2,2,0,1,0,3
9542,775813,12,3,5,3,5,0,0,0,0,0,1,2,0,0,0,1,6
9542,796784,11,2,2,2,2,0,0,0,0,0,0,1,3,0,1,0,4
9542,796786,2,1,3,1,1,0,2,0,0,0,0,0,1,0,0,0,2
9542,796782,6,0,2,0,0,0,2,0,0,0,0,0,1,0,0,1,0
9542,784479,1,0,1,0,1,0,0,0,0,0,0,0,0,1,0,0,0
9543,797532,40,5,11,3,5,2,6,10,11,2,2,7,1,1,5,0,22
9543,785688,34,5,19,0,2,5,17,0,0,0,3,0,2,0,2,0,15
9543,797527,39,3,6,2,3,1,3,3,3,2,7,4,2,2,2,2,10
9543,791936,32,2,7,2,7,0,0,0,0,2,4,2,3,1,3,0,4
9543,797529,26,2,4,2,4,0,0,0,0,0,3,1,3,2,2,0,4
9543,785988,18,4,10,1,2,3,8,3,3,2,4,0,1,0,0,0,14
9543,791932,7,0,3,0,0,0,3,0,0,1,1,0,1,1,0,0,0
9543,791933,4,0,1,0,0,0,1,0,0,0,1,0,0,0,0,0,0
9543,791931,0,0,0,0,0,0,0,0,0,0,0,0,0,0,0,0,0
9543,797530,0,0,0,0,0,0,0,0,0,0,1,0,0,0,0,0,0
9544,791027,40,12,22,4,10,8,12,1,2,2,5,1,4,2,2,0,33
9544,777572,34,5,10,5,9,0,1,2,2,1,11,2,5,1,0,1,12
9544,791023,35,3,6,3,6,0,0,3,3,2,5,1,3,1,0,4,9
9544,791024,31,2,12,2,5,0,7,3,3,0,0,1,2,1,0,0,7
9544,781507,21,2,7,2,6,0,1,1,1,0,4,1,1,0,1,0,5
9544,796685,22,1,7,1,4,0,3,0,0,0,0,1,2,0,2,0,2
9544,796684,9,0,0,0,0,0,0,0,0,0,0,0,1,0,0,0,0
9544,791028,8,0,1,0,0,0,1,0,0,0,2,0,2,0,1,0,0
9545,785738,40,7,17,4,9,3,8,4,4,0,8,5,4,0,4,1,21
9545,780530,39,7,13,7,13,0,0,4,6,2,5,0,1,0,1,5,18
9545,785809,36,5,14,5,12,0,2,6,8,2,6,0,1,1,1,1,16
9545,785740,31,2,5,2,5,0,0,6,10,4,11,1,2,0,1,1,10
9545,797402,14,1,5,0,1,1,4,0,0,0,1,1,0,0,0,0,3
9545,786144,31,1,3,0,0,1,3,2,3,0,2,1,3,0,0,0,5
9545,797396,9,0,0,0,0,0,0,0,0,0,1,0,0,0,0,2,0
9546,791839,38,8,10,8,10,0,0,1,3,3,8,2,3,4,4,0,17
9546,797444,27,1,3,1,2,0,1,2,3,0,4,3,3,1,3,1,4
9546,792381,34,4,12,0,3,4,9,0,0,0,4,1,1,1,4,0,12
9546,791842,38,4,13,3,8,1,5,0,0,0,10,4,1,0,0,0,9
9546,786616,28,5,8,4,7,1,1,1,2,0,0,1,1,4,2,0,12
9546,797443,2,0,0,0,0,0,0,0,0,0,0,0,0,0,1,0,0
9546,785322,13,0,1,0,0,0,1,0,0,0,0,2,2,0,0,0,0
9546,786613,3,0,0,0,0,0,0,0,0,0,1,1,1,1,1,0,0
9546,786736,17,2,4,1,1,1,3,2,2,1,2,1,1,0,2,1,7
9547,797662,32,6,10,6,7,0,3,2,3,2,3,3,0,2,0,2,14
9547,786067,36,6,9,6,9,0,0,0,0,1,2,2,0,0,3,1,12
9547,797660,33,2,10,1,8,1,2,0,0,0,1,3,0,0,1,1,5
9547,785591,34,4,14,3,10,1,4,2,3,2,4,4,2,3,5,0,11
9547,780258,21,1,7,1,3,0,4,0,0,0,3,1,3,2,3,0,2
9547,792082,6,0,1,0,1,0,0,0,0,0,1,0,0,0,1,0,0
9547,792078,11,2,4,2,4,0,0,0,0,1,2,1,2,0,0,0,4
9547,791952,2,0,0,0,0,0,0,0,0,0,0,0,1,0,0,0,0
9547,797661,17,1,3,1,2,0,1,2,2,0,3,3,3,1,2,0,4
9547,797659,8,0,0,0,0,0,0,0,0,0,1,0,3,0,0,0,0
9548,796355,33,7,15,3,8,4,7,5,8,0,5,5,2,1,1,1,23
9548,790798,32,6,8,6,8,0,0,2,6,1,6,3,1,2,2,0,14
9548,785245,40,5,9,4,6,1,3,2,2,0,2,2,3,1,0,0,13
9548,780137,38,5,9,2,4,3,5,5,6,3,6,1,1,0,2,1,18
9548,780140,37,5,13,1,3,4,10,3,3,0,5,2,2,0,1,0,17
9548,790799,11,1,2,1,1,0,1,1,2,0,1,0,1,0,0,0,3
9548,775553,9,0,1,0,1,0,0,0,0,0,2,1,1,0,0,0,0
9549,779857,25,6,12,5,10,1,2,0,0,0,4,0,3,0,1,1,13
9549,774990,30,5,11,4,8,1,3,0,0,0,1,4,1,1,1,0,11
9549,796673,24,4,9,3,5,1,4,2,2,4,1,1,2,0,0,0,11
9549,779976,34,6,15,4,9,2,6,1,1,0,6,4,4,1,2,0,15
9549,796674,29,0,2,0,1,0,1,0,0,1,9,1,2,1,1,0,0
9549,781586,14,2,3,2,3,0,0,1,1,0,0,1,2,0,0,1,5
9549,785961,17,1,2,0,0,1,2,0,0,0,2,2,3,1,1,0,3
9549,791014,27,7,13,2,3,5,10,1,3,1,3,1,4,0,0,0,20
9549,785126,0,0,0,0,0,0,0,0,0,0,0,0,0,0,0,0,0
9550,797111,8,0,2,0,1,0,1,2,2,1,0,0,0,0,0,0,2
9550,791404,35,2,7,2,3,0,4,0,0,0,1,5,4,0,1,0,4
9550,791407,38,7,19,6,10,1,9,4,7,1,7,0,2,1,2,0,19
9550,785928,29,6,8,4,4,2,4,1,2,1,0,0,3,1,4,0,15
9550,785923,30,3,8,3,7,0,1,3,5,3,4,1,4,1,2,0,9
9550,797110,5,1,2,1,1,0,1,0,0,1,0,0,3,0,0,0,2
9550,797109,6,2,2,2,2,0,0,0,0,1,1,0,2,0,1,0,4
9550,791403,27,2,8,2,8,0,0,0,0,2,7,1,3,0,1,1,4
9550,797114,22,2,3,0,1,2,2,3,4,1,0,2,4,1,1,0,9
9550,791406,0,0,0,0,0,0,0,0,0,0,0,0,0,0,0,0,0
9551,791440,24,5,9,5,9,0,0,0,0,1,2,0,5,0,3,1,10
9551,797019,25,1,2,0,1,1,1,4,4,0,1,9,3,2,3,0,7
9551,797016,21,2,3,0,0,2,3,0,0,0,1,1,0,0,2,0,6
9551,781378,35,6,14,5,11,1,3,8,9,2,7,3,2,3,1,1,21
9551,775267,30,6,10,4,6,2,4,4,4,1,6,2,4,1,2,0,18
9551,781629,9,1,2,1,2,0,0,2,6,1,2,0,1,0,0,0,4
9551,797015,14,3,5,3,4,0,1,0,1,1,2,0,0,0,0,0,6
9551,797013,20,1,5,0,2,1,3,1,2,0,1,0,0,1,0,0,4
9551,791441,22,2,4,2,3,0,1,0,0,1,3,1,2,2,1,0,4
9551,775739,0,0,0,0,0,0,0,0,0,0,0,0,0,0,0,0,0
9552,790761,22,2,6,0,2,2,4,2,2,0,3,3,3,4,5,0,8
9552,790764,27,2,6,0,1,2,5,2,2,2,5,3,4,0,0,0,8
9552,796322,24,6,7,6,7,0,0,1,2,0,1,1,1,2,1,1,13
9552,796319,24,7,14,4,6,3,8,0,0,2,1,4,2,0,1,1,17
9552,796320,22,3,4,1,1,2,3,0,0,0,4,5,2,0,1,0,8
9552,785219,22,3,8,1,3,2,5,0,0,1,0,2,1,1,1,0,8
9552,779993,21,4,6,0,0,4,6,0,0,0,1,2,0,1,0,0,12
9552,796323,15,2,4,2,3,0,1,0,0,2,3,1,0,1,0,2,4
9552,775668,8,2,2,2,2,0,0,0,0,1,0,0,2,2,1,0,4
9552,796321,5,0,1,0,1,0,0,0,0,0,2,0,0,0,1,0,0
9552,790765,3,0,0,0,0,0,0,1,2,1,0,1,1,0,0,0,1
9552,779990,3,0,1,0,1,0,0,0,0,0,0,0,0,0,1,0,0
9552,790766,4,1,2,1,2,0,0,1,2,2,0,0,0,0,0,0,3
9553,780218,21,4,7,4,6,0,1,0,0,3,2,0,3,0,2,0,8
9553,790771,23,2,8,2,3,0,5,0,1,2,3,0,2,1,4,0,4
9553,790772,35,2,9,2,9,0,0,0,0,2,3,1,0,1,1,0,4
9553,796328,31,3,5,3,5,0,0,2,2,2,2,1,0,1,3,0,8
9553,780022,29,2,5,2,3,0,2,5,6,1,2,4,3,2,3,0,9
9553,767736,22,2,5,1,2,1,3,0,0,1,1,0,0,2,2,0,5
9553,790774,16,2,4,2,2,0,2,0,2,1,0,0,0,0,0,0,4
9553,796329,9,1,2,1,1,0,1,3,4,0,1,0,2,0,3,0,5
9553,782637,3,0,0,0,0,0,0,2,2,0,0,0,1,0,0,0,2
9553,792438,3,0,0,0,0,0,0,0,0,0,1,0,0,1,0,0,0
9553,794458,2,0,0,0,0,0,0,0,2,0,0,0,0,0,0,0,0
9553,782638,3,0,1,0,0,0,1,2,2,0,0,0,1,0,0,0,2
9553,800120,1,0,0,0,0,0,0,0,0,0,0,0,1,0,1,0,0
9553,796327,2,0,0,0,0,0,0,0,0,0,0,0,0,0,0,0,0
9554,786338,35,10,21,8,12,2,9,4,4,2,2,1,3,5,0,0,26
9554,792050,31,5,10,4,7,1,3,3,3,1,2,3,3,2,2,1,14
9554,775601,34,3,11,2,5,1,6,3,4,1,0,2,4,2,2,0,10
9554,785347,22,4,10,3,6,1,4,0,1,0,1,2,2,0,2,1,9
9554,792047,38,1,5,1,4,0,1,2,2,6,7,3,3,3,3,1,4
9554,797647,27,3,7,1,2,2,5,0,1,0,3,1,0,2,0,0,8
9554,791512,5,0,1,0,1,0,0,0,0,1,1,0,1,0,0,0,0
9554,792052,4,0,2,0,0,0,2,0,0,0,1,0,1,0,0,1,0
9554,780862,2,0,0,0,0,0,0,0,0,0,0,0,0,0,0,0,0
9554,797648,2,0,1,0,0,0,1,0,0,0,0,0,0,0,0,0,0
9555,796996,31,6,9,6,9,0,0,6,8,4,4,1,1,0,3,2,18
9555,776011,37,5,11,5,6,0,5,2,4,1,4,7,2,2,7,0,12
9555,792071,24,3,7,0,0,3,7,0,0,0,5,0,3,0,2,1,9
9555,780471,29,2,5,2,5,0,0,3,4,1,3,3,1,0,1,0,7
9555,791613,23,1,5,0,1,1,4,0,0,0,4,1,2,1,2,1,3
9555,791610,18,4,5,4,5,0,0,2,2,0,2,1,3,1,0,0,10
9555,785680,17,2,3,0,0,2,3,0,0,2,1,2,2,0,1,0,6
9555,791608,17,1,6,0,1,1,5,0,0,0,3,0,0,1,1,0,3
9555,786413,2,0,2,0,2,0,0,0,0,0,2,0,1,0,1,0,0
9555,796994,2,0,0,0,0,0,0,0,0,0,0,0,0,0,1,0,0
9556,786210,24,5,6,1,1,4,5,2,2,0,4,2,4,0,4,0,16
9556,785422,38,5,15,3,8,2,7,2,2,1,2,4,1,0,0,0,14
9556,774957,33,3,5,0,0,3,5,0,0,0,2,1,1,1,1,2,9
9556,775676,32,6,9,6,9,0,0,4,4,1,9,1,0,1,1,3,16
9556,785423,21,1,6,1,3,0,3,0,0,1,3,3,4,0,1,1,2
9556,786298,29,6,10,4,6,2,4,0,1,2,5,1,2,1,0,1,14
9556,785425,23,4,7,3,5,1,2,0,0,0,0,3,0,0,0,0,9
9557,785579,38,8,11,3,6,5,5,0,0,0,0,1,3,0,0,0,21
9557,781628,27,3,7,1,3,2,4,0,0,0,5,2,4,0,2,0,8
9557,799907,33,5,12,3,7,2,5,0,0,0,2,7,1,2,1,0,12
9557,785442,29,6,19,5,14,1,5,7,8,6,6,3,1,1,0,0,20
9557,790899,20,1,4,1,4,0,0,3,4,2,3,0,2,0,1,1,5
9557,790897,31,3,11,1,4,2,7,1,2,1,4,1,1,0,2,0,9
9557,775737,7,0,2,0,1,0,1,0,0,1,1,0,0,0,0,0,0
9557,796446,9,1,2,1,2,0,0,0,0,1,0,0,1,0,0,0,2
9557,775959,6,0,0,0,0,0,0,0,0,0,1,0,0,0,0,0,0
9558,796902,19,4,6,2,4,2,2,1,2,0,3,1,1,0,2,0,11
9558,785628,37,3,12,1,9,2,3,0,0,0,3,4,0,1,4,0,8
9558,785627,25,3,7,1,2,2,5,0,0,0,6,0,0,0,0,1,8
9558,775767,29,3,5,3,5,0,0,1,2,2,7,3,1,0,1,1,7
9558,791201,23,1,5,1,4,0,1,1,2,0,4,1,1,0,2,0,3
9558,791202,29,4,6,0,1,4,5,2,2,0,0,1,1,1,1,0,14
9558,785629,28,1,3,1,2,0,1,4,4,0,3,1,3,0,1,0,6
9558,781135,10,2,4,2,4,0,0,2,2,6,3,0,0,0,2,0,6
9559,791249,33,7,17,4,11,3,6,2,2,0,2,1,3,1,0,0,19
9559,775358,37,8,20,8,17,0,3,0,1,0,1,4,1,1,0,0,16
9559,785522,22,2,4,1,1,1,3,0,0,0,1,1,1,0,0,0,5
9559,796947,32,1,7,1,5,0,2,0,0,2,3,0,3,4,2,0,2
9559,781247,30,0,2,0,0,0,2,0,0,2,2,1,3,1,0,0,0
9559,791250,26,3,6,3,3,0,3,0,0,0,5,0,1,2,2,0,6
9559,796949,6,3,4,3,4,0,0,0,0,1,2,0,0,0,1,1,6
9559,785523,2,1,1,1,1,0,0,0,0,0,0,0,0,0,0,0,2
9559,785521,12,0,0,0,0,0,0,0,0,0,1,0,0,1,0,0,0
9560,786620,45,4,9,1,4,3,5,4,8,1,4,0,3,1,2,0,15
9560,781257,45,2,9,2,6,0,3,5,5,1,7,2,2,3,2,1,9
9560,781606,27,2,6,2,5,0,1,1,2,0,0,2,4,1,3,0,5
9560,796956,19,2,4,2,4,0,0,0,0,0,5,0,0,1,0,0,4
9560,791838,19,0,5,0,3,0,2,0,0,2,2,1,1,0,3,0,0
9560,781263,32,4,11,2,7,2,4,6,7,3,4,0,4,1,4,2,16
9560,796955,26,2,4,2,4,0,0,4,6,1,5,0,2,0,0,0,8
9560,791255,9,1,2,1,1,0,1,0,0,1,1,1,1,0,0,1,2
9560,780900,3,0,0,0,0,0,0,0,0,0,1,1,1,0,0,0,0
9561,786253,39,6,16,6,13,0,3,4,8,4,7,2,3,2,3,1,16
9561,786404,39,5,14,5,13,0,1,3,4,6,5,0,2,1,2,0,13
9561,780378,25,5,6,5,6,0,0,1,3,1,3,0,5,1,1,0,11
9561,786374,37,2,11,2,10,0,1,3,4,1,5,3,5,1,3,3,7
9561,786378,40,2,12,1,2,1,10,0,0,2,1,5,4,1,0,0,5
9561,780121,3,1,3,0,2,1,1,0,0,0,0,0,0,0,0,0,3
9561,780382,20,1,2,1,2,0,0,0,0,3,0,1,2,2,1,1,2
9561,797061,3,0,1,0,1,0,0,1,2,0,0,0,1,0,0,0,1
9561,797065,11,0,2,0,1,0,1,0,0,1,2,0,3,0,0,0,0
9561,791562,8,0,2,0,1,0,1,0,0,0,0,0,1,1,0,0,0
9562,781044,33,11,20,8,13,3,7,9,10,2,7,0,2,1,1,1,34
9562,791795,14,0,1,0,1,0,0,0,0,0,1,1,1,0,3,0,0
9562,786489,27,2,8,1,6,1,2,0,1,0,0,2,3,0,1,0,5
9562,786488,40,1,12,0,11,1,1,3,4,4,7,7,2,1,3,0,6
9562,781038,34,6,9,6,8,0,1,3,3,2,4,3,4,1,3,0,15
9562,797620,23,2,7,2,6,0,1,0,1,2,5,0,2,0,0,0,4
9562,786490,4,1,2,1,2,0,0,0,0,1,1,0,1,0,0,0,2
9562,797619,15,1,3,0,1,1,2,0,0,0,1,3,3,1,0,0,3
9562,786487,9,1,2,0,0,1,2,0,0,0,1,0,0,1,0,0,3
9562,797621,1,0,0,0,0,0,0,0,0,0,0,0,0,0,0,0,0
9563,786547,25,1,5,0,1,1,4,0,0,0,4,1,4,2,2,1,3
9563,786544,28,8,13,5,9,3,4,2,3,1,8,1,5,0,0,1,21
9563,797507,37,5,11,4,6,1,5,1,1,0,3,2,2,1,1,1,12
9563,792012,40,7,17,6,11,1,6,8,10,2,2,7,2,0,2,0,23
9563,786546,36,3,9,2,6,1,3,1,1,2,7,2,2,0,1,1,8
9563,786860,26,2,6,0,0,2,6,0,0,0,3,0,1,1,1,2,6
9563,797510,7,0,1,0,0,0,1,0,0,0,0,1,0,0,0,0,0
9563,792013,1,0,0,0,0,0,0,2,2,0,1,0,0,0,0,0,2
9564,785829,25,5,8,5,8,0,0,3,6,3,3,1,0,0,0,0,13
9564,775838,28,3,5,3,5,0,0,2,2,2,8,2,4,1,4,0,8
9564,796729,23,5,10,3,5,2,5,3,3,0,2,0,3,2,2,0,15
9564,791048,27,6,11,2,5,4,6,0,0,3,1,2,4,1,1,0,16
9564,786531,38,2,14,0,4,2,10,2,2,0,4,5,2,2,2,1,8
9564,791044,18,1,3,1,3,0,0,0,4,2,2,1,0,1,0,0,2
9564,780723,11,1,3,0,0,1,3,0,0,0,0,1,0,0,0,0,3
9564,796727,30,4,11,0,0,4,11,5,5,1,0,0,3,1,1,0,17
9565,796723,30,3,8,2,6,1,2,2,2,0,6,5,1,2,2,1,9
9565,791042,16,7,9,5,7,2,2,2,3,1,3,1,4,1,0,0,18
9565,791043,34,7,13,4,8,3,5,4,4,1,5,3,2,0,4,0,21
9565,776374,28,3,7,1,4,2,3,2,2,0,4,6,5,1,2,0,10
9565,775412,35,2,3,0,0,2,3,1,2,0,2,1,2,0,1,0,7
9565,785512,13,4,6,4,6,0,0,2,2,1,2,0,0,0,0,2,10
9565,774834,16,1,1,1,1,0,0,0,1,0,1,0,3,1,2,1,2
9565,796718,25,3,5,1,3,2,2,2,2,0,0,3,3,1,1,0,10
9565,796720,3,0,1,0,0,0,1,0,0,0,1,0,0,0,0,0,0
9566,797579,32,3,3,1,1,2,2,0,0,0,3,0,1,0,1,0,8
9566,786509,30,7,9,7,9,0,0,0,0,4,7,3,4,0,2,2,14
9566,786508,34,10,19,3,9,7,10,3,3,2,6,0,2,2,2,3,30
9566,785796,34,5,11,3,7,2,4,2,3,1,7,3,3,0,3,0,14
9566,797576,38,5,11,4,8,1,3,4,4,0,1,8,2,0,1,0,15
9566,797577,10,1,1,1,1,0,0,0,0,1,1,0,1,0,0,0,2
9566,786507,6,1,2,1,2,0,0,0,0,0,1,0,0,0,1,0,2
9566,786505,16,2,4,1,3,1,1,0,0,0,0,0,0,0,1,0,5
9567,786635,32,8,18,8,18,0,0,2,3,1,3,4,2,0,1,0,18
9567,791822,33,2,3,1,1,1,2,0,0,0,1,1,0,0,0,0,5
9567,781543,14,1,2,0,1,1,1,0,0,0,0,0,3,0,1,0,3
9567,780642,34,9,18,9,18,0,0,5,7,1,3,1,3,2,2,0,23
9567,776449,30,6,11,4,7,2,4,1,2,2,0,1,0,1,0,0,15
9567,798157,13,1,1,1,1,0,0,0,0,0,4,1,0,0,0,1,2
9567,797383,12,0,0,0,0,0,0,0,0,0,1,0,2,0,0,1,0
9567,791823,3,0,0,0,0,0,0,0,0,1,0,0,1,0,0,0,0
9567,786182,26,7,8,4,5,3,3,0,1,0,0,0,3,2,0,0,17
9567,786632,3,0,0,0,0,0,0,0,0,0,0,1,0,0,0,0,0
9568,790784,34,7,13,3,4,4,9,1,1,3,4,1,3,2,2,0,19
9568,786235,15,2,3,2,3,0,0,0,0,2,2,0,3,1,4,0,4
9568,797475,28,1,9,1,3,0,6,2,2,1,1,1,4,0,1,0,4
9568,786229,25,0,4,0,0,0,4,5,7,2,3,2,1,1,1,0,5
9568,775229,27,5,12,4,8,1,4,5,7,0,5,0,5,3,3,0,16
9568,786583,1,0,0,0,0,0,0,0,0,0,1,0,0,0,0,0,0
9568,776219,13,0,1,0,1,0,0,0,0,0,0,0,0,0,3,0,0
9568,797477,1,0,0,0,0,0,0,0,0,0,0,0,0,0,0,0,0
9568,797476,1,0,0,0,0,0,0,0,0,0,0,0,0,0,0,0,0
9568,791871,14,0,1,0,0,0,1,5,5,0,2,1,2,1,1,0,5
9568,786581,16,1,3,0,1,1,2,0,0,0,0,1,1,0,1,0,3
9568,786770,17,3,9,3,6,0,3,0,0,1,1,1,3,2,1,0,6
9568,781518,8,0,1,0,0,0,1,4,4,0,1,0,1,0,0,0,4
9569,797587,23,2,4,2,4,0,0,1,5,0,4,3,5,1,1,0,5
9569,786501,31,5,8,2,4,3,4,0,0,0,4,0,3,0,3,0,13
9569,781078,7,3,3,1,1,2,2,0,0,1,1,1,2,0,0,1,8
9569,786502,28,1,7,1,7,0,0,6,12,0,4,6,3,2,7,0,8
9569,781080,38,9,15,2,5,7,10,1,2,2,1,2,2,1,2,0,26
9569,791891,27,4,4,4,4,0,0,3,5,0,5,0,3,0,2,1,11
9569,791894,1,0,0,0,0,0,0,0,0,0,0,0,0,0,0,0,0
9569,797584,12,1,1,1,1,0,0,0,0,0,1,2,2,0,0,0,2
9569,791895,30,2,3,2,3,0,0,0,0,0,6,3,4,0,4,1,4
9569,791892,1,0,0,0,0,0,0,0,0,0,0,0,0,0,0,0,0
9569,797583,1,0,1,0,1,0,0,0,0,0,0,0,1,0,0,0,0
9569,781561,1,0,0,0,0,0,0,0,0,0,0,0,0,0,0,0,0
9570,785224,28,5,8,1,4,4,4,2,2,1,6,1,3,0,0,1,16
9570,780879,34,7,13,4,8,3,5,0,0,2,6,4,2,1,4,2,17
9570,790767,24,2,4,1,1,1,3,0,0,0,1,2,0,0,1,0,5
9570,785743,23,2,8,1,4,1,4,0,0,0,1,2,4,2,0,0,5
9570,780875,30,4,5,2,3,2,2,0,0,0,1,3,2,0,4,0,10
9570,790768,23,2,4,2,2,0,2,2,2,1,2,2,1,2,4,0,6
9570,785226,6,0,0,0,0,0,0,0,0,0,0,1,1,0,1,0,0
9570,796326,6,0,2,0,2,0,0,0,0,0,1,0,0,0,0,0,0
9570,775785,10,1,3,0,1,1,2,0,0,0,1,0,0,0,0,0,3
9570,790769,13,0,2,0,1,0,1,2,2,0,0,0,0,0,0,0,2
9570,796324,3,0,0,0,0,0,0,0,0,0,0,0,1,0,0,0,0
9571,790821,34,6,12,4,8,2,4,1,2,2,4,2,3,3,5,1,15
9571,775585,30,3,6,3,6,0,0,0,0,2,3,1,1,1,2,0,6
9571,790822,39,8,14,7,10,1,4,3,3,0,6,2,1,1,2,0,20
9571,780982,29,2,3,1,1,1,2,0,0,1,2,0,3,0,1,1,5
9571,774980,38,7,15,7,13,0,2,0,0,1,0,4,2,0,2,0,14
9571,780445,16,2,3,2,3,0,0,0,0,0,4,0,1,1,0,1,4
9571,785365,14,1,1,0,0,1,1,0,0,0,0,0,0,1,0,0,3
9572,786857,28,1,11,0,4,1,7,2,5,2,6,1,4,0,2,2,5
9572,781403,33,2,9,2,7,0,2,4,4,1,7,1,3,1,4,0,8
9572,792654,25,6,8,6,8,0,0,7,7,2,5,0,2,0,1,0,19
9572,797301,32,2,10,2,8,0,2,0,0,2,4,2,0,5,2,0,4
9572,780524,38,3,7,2,4,1,3,1,2,3,3,3,0,3,1,0,8
9572,781400,29,8,14,6,9,2,5,2,2,0,3,2,1,1,2,0,20
9572,792653,15,2,2,2,2,0,0,0,2,3,1,0,0,0,0,0,4
9573,797050,21,4,8,3,5,1,3,0,0,0,6,0,4,0,1,0,9
9573,780394,30,3,10,3,6,0,4,0,0,1,5,0,5,0,2,1,6
9573,780391,16,1,3,1,3,0,0,0,0,0,0,0,0,1,0,0,2
9573,790871,39,7,12,6,7,1,5,2,2,0,6,6,0,3,8,3,17
9573,780392,32,2,9,0,4,2,5,0,0,1,0,0,1,0,0,0,6
9573,797048,23,2,9,1,6,1,3,0,2,3,4,1,2,1,1,0,5
9573,776473,21,0,4,0,1,0,3,0,0,0,1,0,5,0,2,0,0
9573,791573,18,2,3,2,2,0,1,0,0,0,1,0,1,0,1,0,4
9574,796479,25,1,1,1,1,0,0,0,0,0,2,4,2,0,3,0,2
9574,781560,25,7,10,7,10,0,0,2,2,4,4,0,2,2,1,1,16
9574,791375,31,3,5,2,2,1,3,1,2,0,6,3,0,1,2,0,8
9574,785482,31,8,13,6,11,2,2,0,0,1,6,4,0,0,1,0,18
9574,780837,24,6,13,0,4,6,9,3,4,0,0,2,3,0,2,0,21
9574,796473,15,3,4,3,4,0,0,0,0,2,2,0,2,0,4,0,6
9574,786164,21,2,3,2,2,0,1,1,1,0,7,3,1,1,1,2,5
9574,796477,18,0,1,0,1,0,0,0,0,0,2,4,2,0,3,0,0
9574,796476,3,0,1,0,1,0,0,0,0,0,1,0,0,0,0,0,0
9574,796478,3,0,0,0,0,0,0,2,2,0,0,0,0,0,0,0,2
9574,796472,3,1,3,1,1,0,2,0,0,0,0,0,1,1,0,0,2
9574,790928,1,0,0,0,0,0,0,0,0,0,0,0,0,1,0,0,0
9575,792473,34,5,10,5,6,0,4,4,5,0,4,2,2,0,3,5,14
9575,780036,24,3,6,3,5,0,1,0,0,0,3,2,2,2,3,0,6
9575,792474,27,1,5,1,3,0,2,0,0,0,0,1,2,1,0,0,2
9575,785249,35,7,15,5,9,2,6,0,0,0,1,5,0,0,2,1,16
9575,780035,20,1,4,1,3,0,1,0,2,0,1,0,0,1,1,0,2
9575,792478,13,1,3,1,2,0,1,0,0,0,1,2,2,1,0,0,2
9575,780043,20,1,2,1,1,0,1,1,1,0,1,0,1,2,0,1,3
9575,799281,19,2,4,2,3,0,1,1,2,0,2,1,3,1,3,0,5
9575,785251,6,1,2,1,1,0,1,0,0,0,0,1,1,1,0,0,2
9575,792477,2,0,0,0,0,0,0,0,0,0,0,0,0,0,1,0,0
9576,797313,23,3,4,2,2,1,2,0,0,0,4,0,4,1,0,0,7
9576,786569,28,6,8,5,7,1,1,1,2,1,2,2,3,1,2,3,14
9576,791726,32,2,6,1,3,1,3,2,2,0,3,0,4,0,2,0,7
9576,786273,38,5,12,4,7,1,5,2,4,2,6,5,4,1,6,1,13
9576,780773,40,2,8,2,5,0,3,2,8,0,5,0,3,3,5,0,6
9576,791728,12,0,0,0,0,0,0,0,0,0,4,0,4,0,0,0,0
9576,797317,24,2,4,1,3,1,1,0,0,0,0,1,2,0,1,0,5
9576,786272,3,0,0,0,0,0,0,0,0,0,0,0,0,0,0,0,0
9577,797163,31,1,6,1,6,0,0,0,2,3,5,3,3,2,2,0,2
9577,797164,8,0,1,0,1,0,0,0,0,0,1,0,2,0,1,0,0
9577,786450,40,4,7,2,4,2,3,3,4,2,0,1,3,5,0,0,13
9577,776396,33,5,14,2,5,3,9,1,2,1,6,0,2,0,2,0,14
9577,776199,38,2,15,0,7,2,8,10,10,0,2,3,1,1,2,0,16
9577,797167,9,1,3,1,3,0,0,2,2,1,0,0,1,0,1,1,4
9577,791385,31,1,6,1,1,0,5,4,4,3,5,2,3,0,1,1,6
9577,797165,8,0,3,0,3,0,0,0,0,0,0,0,1,1,1,0,0
9577,791382,2,0,0,0,0,0,0,0,0,0,0,0,1,0,0,0,0
9578,791949,32,6,10,5,7,1,3,1,2,2,5,4,1,0,5,0,14
9578,776014,35,3,11,1,8,2,3,1,2,2,3,2,1,1,0,1,9
9578,797690,39,4,8,2,4,2,4,0,0,2,7,4,1,0,1,0,10
9578,785304,19,2,6,1,2,1,4,0,0,0,1,1,1,0,0,0,5
9578,780747,39,3,8,1,4,2,4,2,2,2,2,3,3,1,1,1,10
9578,797691,32,7,9,7,8,0,1,0,0,0,4,0,4,0,0,1,14
9578,797689,20,3,8,2,5,1,3,0,0,1,0,0,1,0,2,0,7
9578,784336,9,0,0,0,0,0,0,0,0,0,1,0,1,0,0,0,0
9579,785498,38,9,11,9,10,0,1,2,2,3,6,0,0,0,0,0,20
9579,776469,41,7,10,3,6,4,4,1,1,2,2,2,5,1,2,2,19
9579,796705,39,7,17,4,12,3,5,4,4,2,2,2,2,1,4,0,21
9579,796708,26,0,7,0,3,0,4,0,0,0,2,3,1,1,0,0,0
9579,776322,39,1,8,0,4,1,4,1,2,0,3,2,1,0,0,0,4
9579,781169,28,2,6,1,3,1,3,1,2,1,2,2,1,1,0,1,6
9579,780704,5,0,0,0,0,0,0,0,0,0,0,0,0,0,1,0,0
9579,796706,9,0,1,0,0,0,1,0,0,0,1,1,1,0,0,0,0
9580,791531,23,2,7,1,3,1,4,1,2,2,2,0,1,1,0,0,6
9580,791534,25,2,6,2,6,0,0,2,2,2,1,0,4,1,0,0,6
9580,791533,27,2,11,2,7,0,4,0,0,3,5,2,3,0,1,0,4
9580,791528,39,5,12,3,8,2,4,2,3,2,9,1,1,1,3,0,14
9580,775045,39,5,14,4,10,1,4,2,4,0,5,3,2,0,1,1,13
9580,797127,11,0,5,0,3,0,2,0,0,1,0,0,3,0,2,0,0
9580,791529,17,1,5,0,0,1,5,2,2,0,2,0,1,0,0,0,5
9580,797124,17,1,1,0,0,1,1,2,2,0,0,0,2,1,1,0,5
9580,774880,1,1,1,0,0,1,1,0,0,0,0,0,0,0,0,0,3
9580,797129,1,0,0,0,0,0,0,0,0,0,0,1,0,0,0,0,0
9581,790761,36,3,6,2,4,1,2,2,2,1,6,5,2,0,4,0,9
9581,790764,36,7,12,5,10,2,2,4,5,0,5,0,3,1,0,1,20
9581,796322,33,9,14,9,14,0,0,5,9,7,12,1,3,1,1,1,23
9581,796319,36,4,13,3,9,1,4,0,0,2,4,1,0,2,1,0,9
9581,796320,21,3,6,1,2,2,4,1,2,0,0,1,4,0,0,1,9
9581,796321,3,0,1,0,1,0,0,0,0,1,0,0,1,0,0,0,0
9581,785219,5,0,0,0,0,0,0,0,0,0,2,0,0,0,1,0,0
9581,779993,23,0,5,0,2,0,3,0,0,1,0,3,1,2,1,0,0
9581,796323,7,0,1,0,1,0,0,0,2,0,0,0,0,0,0,0,0
9582,791917,20,2,4,1,2,1,2,0,0,0,1,0,2,0,0,1,5
9582,786526,29,3,11,1,8,2,3,0,0,2,9,2,2,1,1,0,8
9582,786525,32,4,18,3,12,1,6,0,0,3,2,0,1,0,2,0,9
9582,791914,32,3,9,2,5,1,4,0,2,0,3,3,3,1,1,0,7
9582,786030,22,2,5,2,4,0,1,2,5,0,7,0,5,3,5,1,6
9582,786856,24,2,5,2,5,0,0,1,2,2,2,1,1,0,1,0,5
9582,797550,13,0,2,0,1,0,1,0,0,0,2,2,3,1,1,0,0
9582,786524,8,1,3,1,2,0,1,0,0,0,0,0,1,0,0,0,2
9582,781109,20,1,1,1,1,0,0,2,3,0,3,1,3,3,3,0,4
9582,791920,0,0,0,0,0,0,0,0,0,0,0,0,0,0,0,0,0
9583,776462,33,1,7,1,5,0,2,3,6,1,9,1,4,2,0,2,5
9583,775642,34,2,6,2,4,0,2,0,1,2,10,0,3,2,3,0,4
9583,791629,33,5,8,1,1,4,7,0,1,1,4,1,0,1,3,0,14
9583,796974,28,4,12,4,10,0,2,3,6,0,0,1,4,1,3,1,11
9583,781199,37,3,10,3,6,0,4,4,8,2,3,6,1,1,6,0,10
9583,786720,20,2,4,1,2,1,2,0,0,0,0,0,1,0,2,0,5
9583,791628,9,0,1,0,0,0,1,0,0,1,1,1,0,0,0,1,0
9583,791626,6,1,1,1,1,0,0,0,2,0,1,0,0,0,0,1,2
9584,791281,29,2,2,2,2,0,0,10,11,1,11,1,4,1,7,0,14
9584,792276,32,6,11,3,5,3,6,2,3,0,4,5,3,2,7,0,17
9584,791278,39,5,10,4,6,1,4,4,4,3,7,6,3,2,0,1,15
9584,786026,31,8,12,8,10,0,2,3,5,1,4,0,4,3,3,2,19
9584,785507,32,3,5,0,0,3,5,3,5,0,2,0,5,0,1,2,12
9584,796534,7,0,1,0,0,0,1,0,0,0,0,1,0,0,3,0,0
9584,785764,8,1,1,1,1,0,0,0,2,0,0,1,2,0,0,0,2
9584,796536,2,1,1,1,1,0,0,0,0,0,1,0,1,0,0,0,2
9584,796535,10,0,1,0,1,0,0,0,0,0,2,0,2,0,2,0,0
9584,785398,10,1,2,1,2,0,0,2,4,0,0,1,0,1,0,0,4
9585,797549,29,3,6,3,6,0,0,1,6,0,0,1,2,0,2,0,7
9585,797545,31,4,11,0,1,4,10,1,2,1,1,4,5,2,3,1,13
9585,797540,30,3,10,2,7,1,3,3,3,3,3,0,0,0,0,0,10
9585,790857,35,6,8,2,4,4,4,3,4,1,2,5,2,2,3,0,19
9585,780586,26,2,10,1,6,1,4,11,12,1,3,1,5,2,3,1,16
9585,791799,14,3,5,1,1,2,4,0,1,0,1,1,4,0,2,0,8
9585,797547,1,0,1,0,0,0,1,0,0,0,0,0,0,1,0,0,0
9585,791715,21,1,4,1,2,0,2,0,1,0,1,2,5,0,3,0,2
9585,791714,8,1,1,1,1,0,0,0,0,0,0,0,0,1,0,0,2
9585,789065,5,0,0,0,0,0,0,0,0,0,0,1,2,0,0,0,0
9586,792351,18,4,6,2,3,2,3,2,2,0,3,2,3,0,0,0,12
9586,786723,39,8,13,8,12,0,1,8,9,0,11,4,2,2,3,0,24
9586,792349,23,5,5,4,4,1,1,2,4,1,4,1,3,0,1,1,13
9586,798060,35,4,8,2,3,2,5,2,4,0,2,4,3,1,6,1,12
9586,792355,33,6,11,0,0,6,11,3,3,0,2,1,1,1,6,0,21
9586,786724,27,4,8,1,4,3,4,0,0,1,1,2,1,0,0,0,11
9586,798061,20,1,2,1,1,0,1,3,5,0,0,1,1,1,0,1,5
9586,792348,5,0,0,0,0,0,0,0,0,0,1,0,0,0,0,0,0
9587,786772,22,5,8,5,8,0,0,0,2,5,1,0,3,1,0,0,10
9587,781484,24,3,6,0,0,3,6,0,0,1,5,1,5,1,1,0,9
9587,786769,37,7,13,3,5,4,8,0,0,0,5,2,1,1,2,1,18
9587,786024,36,6,12,5,6,1,6,1,2,0,4,5,4,2,3,1,14
9587,780002,37,10,18,8,13,2,5,9,9,0,3,7,4,2,4,0,31
9587,791967,12,3,7,3,6,0,1,0,0,0,1,0,3,0,3,0,6
9587,790823,25,2,5,1,3,1,2,0,0,3,1,0,0,3,1,0,5
9587,786773,7,1,1,1,1,0,0,0,0,0,1,0,1,0,0,0,2
9588,780494,31,3,7,1,4,2,3,4,6,1,2,2,3,3,2,0,12
9588,797276,23,1,5,1,5,0,0,6,8,0,2,2,4,3,0,2,8
9588,780497,23,2,7,2,6,0,1,2,2,1,4,0,3,1,0,1,6
9588,780496,35,4,16,3,7,1,9,0,0,0,3,1,0,3,1,0,9
9588,780495,33,3,12,1,9,2,3,1,2,1,2,3,2,0,1,0,9
9588,797274,5,3,3,3,3,0,0,1,2,2,0,0,0,1,1,0,7
9588,791645,3,0,0,0,0,0,0,0,0,0,0,0,2,0,1,0,0
9588,785693,13,0,1,0,1,0,0,2,2,1,3,0,3,0,1,0,2
9588,799889,1,0,0,0,0,0,0,0,0,0,0,0,0,0,0,0,0
9588,797275,4,0,1,0,0,0,1,0,0,0,1,0,0,0,0,0,0
9588,791643,1,0,0,0,0,0,0,0,0,0,0,0,0,0,0,0,0
9588,789054,2,0,0,0,0,0,0,0,0,0,0,0,0,0,0,0,0
9588,785692,19,2,4,2,3,0,1,0,0,0,1,2,3,1,0,0,4
9588,785644,7,1,4,0,3,1,1,0,0,0,0,0,1,1,0,0,3
9589,796956,12,0,1,0,1,0,0,0,0,0,1,0,2,1,0,0,0
9589,791838,25,2,2,1,1,1,1,0,1,0,5,2,1,0,0,0,5
9589,786620,35,4,9,3,6,1,3,3,4,1,3,1,2,0,2,0,12
9589,781606,36,5,12,4,7,1,5,1,2,1,0,4,4,0,2,0,12
9589,781257,37,7,13,4,8,3,5,7,8,2,10,1,1,1,5,2,24
9589,796957,1,0,0,0,0,0,0,0,0,0,0,0,0,0,0,0,0
9589,796955,21,3,5,3,5,0,0,5,8,4,10,1,1,0,0,1,11
9589,791255,12,3,3,2,2,1,1,1,1,0,4,0,0,0,2,0,8
9589,796029,1,0,0,0,0,0,0,0,0,0,0,0,0,0,0,0,0
9589,791254,1,0,0,0,0,0,0,0,0,0,0,0,0,0,0,0,0
9589,781263,19,3,8,2,7,1,1,0,0,0,0,3,5,1,2,0,7
9590,790837,11,0,2,0,2,0,0,1,2,0,0,1,3,0,0,0,1
9590,781046,35,5,13,1,4,4,9,3,6,3,4,0,4,1,4,0,17
9590,780025,37,7,12,7,12,0,0,4,9,4,5,1,3,0,3,1,18
9590,785385,20,2,4,0,0,2,4,0,0,0,3,0,1,0,2,0,6
9590,785383,34,2,9,2,5,0,4,3,4,1,3,4,3,2,2,0,7
9590,786228,29,2,9,2,6,0,3,1,2,1,5,3,1,2,3,0,5
9590,796391,4,0,1,0,0,0,1,0,0,0,0,0,1,0,1,0,0
9590,786297,2,0,1,0,1,0,0,0,0,0,0,0,1,0,0,0,0
9590,792180,25,2,5,1,1,1,4,3,6,3,2,1,2,1,1,0,8
9590,780024,3,0,1,0,0,0,1,0,0,0,0,0,0,0,0,0,0
9591,800119,7,1,1,1,1,0,0,0,0,1,1,0,4,0,1,0,2
9591,780384,20,0,3,0,3,0,0,1,2,1,7,0,2,0,0,1,1
9591,786738,35,9,17,9,15,0,2,3,7,4,3,1,3,0,3,0,21
9591,775694,19,0,3,0,3,0,0,0,0,0,1,1,3,1,3,0,0
9591,774827,36,8,13,5,6,3,7,2,3,1,6,3,3,2,3,0,21
9591,791194,25,1,3,1,2,0,1,3,4,2,3,0,3,3,2,1,5
9591,791193,19,2,3,2,3,0,0,3,4,1,4,1,4,0,0,1,7
9591,796863,13,2,3,2,3,0,0,0,0,0,2,1,2,2,3,0,4
9591,780159,8,0,1,0,1,0,0,1,2,1,0,0,0,0,0,0,1
9591,796865,18,2,7,1,1,1,6,3,4,0,2,0,0,0,0,0,8
9592,796410,19,7,10,7,10,0,0,0,3,7,3,6,3,0,3,0,14
9592,790856,24,7,10,7,10,0,0,6,7,8,5,1,1,1,1,2,20
9592,796413,22,1,5,0,0,1,5,0,0,1,2,3,3,0,0,0,3
9592,796408,24,6,14,3,8,3,6,0,0,0,4,6,2,2,1,0,15
9592,796407,28,2,7,2,6,0,1,0,0,1,1,1,3,0,3,0,4
9592,796411,21,7,11,7,11,0,0,2,2,5,7,0,1,2,1,8,16
9592,790858,13,3,4,1,2,2,2,0,0,0,1,0,1,1,1,0,8
9592,796409,19,5,9,3,4,2,5,2,2,0,2,0,0,3,0,0,14
9592,780450,12,1,4,0,1,1,3,4,4,1,3,1,1,0,0,1,7
9592,781286,4,0,2,0,1,0,1,0,0,0,0,1,0,0,0,0,0
9592,780453,3,0,0,0,0,0,0,0,0,0,0,0,0,0,0,1,0
9592,780454,4,0,0,0,0,0,0,0,0,0,0,0,0,0,0,0,0
9592,796414,3,0,0,0,0,0,0,0,0,1,0,0,0,0,1,0,0
9592,775941,4,0,1,0,0,0,1,0,0,0,0,0,0,0,0,0,0
9593,785423,33,4,7,4,5,0,2,5,8,2,2,1,2,1,1,0,13
9593,775676,19,4,9,4,9,0,0,2,2,4,2,0,2,1,1,3,10
9593,786210,26,1,9,0,5,1,4,0,0,0,2,1,4,0,2,0,3
9593,785422,27,3,8,0,1,3,7,4,4,0,0,3,1,1,4,0,13
9593,774957,16,0,1,0,1,0,0,1,2,1,2,0,4,0,0,0,1
9593,796431,11,0,4,0,3,0,1,0,0,2,1,0,1,0,0,0,0
9593,786298,22,2,9,2,5,0,4,2,2,1,2,1,1,2,3,0,6
9593,785425,31,2,8,1,3,1,5,0,0,0,4,1,1,0,2,0,5
9593,796429,11,2,4,0,1,2,3,0,0,3,1,0,0,0,1,1,6
9593,793801,4,1,2,1,2,0,0,0,0,0,0,1,0,0,0,0,2
9594,779985,19,2,6,1,2,1,4,4,6,0,7,0,1,0,0,1,9
9594,790876,37,8,12,7,10,1,2,1,2,1,3,3,1,1,3,0,18
9594,785699,35,4,8,4,7,0,1,4,4,2,7,6,1,5,4,0,12
9594,781062,32,1,6,0,0,1,6,0,0,0,4,2,2,0,1,0,3
9594,774987,33,6,11,4,8,2,3,7,8,1,4,3,2,1,4,1,21
9594,790877,14,2,4,1,3,1,1,0,0,2,0,0,0,0,0,0,5
9594,785432,21,3,5,3,5,0,0,0,0,1,0,0,2,1,0,3,6
9594,790882,9,2,3,2,3,0,0,1,1,0,3,0,0,0,2,0,5
9595,781480,27,4,15,4,11,0,4,2,2,2,2,2,1,1,1,0,10
9595,774846,26,4,8,4,8,0,0,0,0,7,5,2,2,2,1,1,8
9595,791376,32,3,7,1,1,2,6,0,0,0,2,1,3,1,2,0,8
9595,797272,21,2,6,1,2,1,4,0,0,0,1,0,4,1,1,0,5
9595,766611,38,5,14,1,3,4,11,0,0,0,5,2,5,1,1,0,14
9595,786185,14,2,5,2,5,0,0,0,0,2,2,0,0,1,0,1,4
9595,797273,19,3,4,3,4,0,0,0,0,1,2,3,2,1,2,0,6
9595,786558,23,7,13,6,10,1,3,3,3,1,2,4,3,1,3,0,18
9596,781081,23,3,5,3,4,0,1,1,5,3,6,3,0,1,2,2,7
9596,791864,36,13,19,6,7,7,12,3,8,0,6,3,1,2,3,1,36
9596,791863,17,4,6,4,6,0,0,0,2,0,3,1,1,1,0,0,8
9596,797472,13,1,6,0,1,1,5,0,0,0,2,0,0,0,0,0,3
9596,780965,30,4,7,1,4,3,3,2,2,0,5,5,3,1,3,0,13
9596,797473,10,1,3,1,3,0,0,0,0,1,1,1,2,0,0,1,2
9596,786791,9,2,3,2,3,0,0,0,1,2,3,0,4,0,0,0,4
9596,797470,25,0,3,0,2,0,1,0,0,2,1,2,2,1,2,0,0
9596,791865,0,1,2,1,2,0,0,0,0,1,0,0,0,0,0,0,2
9596,786592,25,4,11,4,10,0,1,1,2,2,2,4,1,0,0,1,9
9596,776447,12,3,5,2,4,1,1,0,0,0,1,0,1,0,0,0,7
9597,800005,27,2,6,2,6,0,0,5,6,4,7,0,3,0,2,1,9
9597,800091,38,5,12,4,11,1,1,2,2,1,1,1,2,2,3,1,13
9597,799129,28,6,11,4,4,2,7,0,0,1,8,1,2,1,1,1,14
9597,799132,26,3,9,1,2,2,7,0,0,0,2,0,4,1,3,0,8
9597,792634,37,5,15,3,7,2,8,5,10,1,1,4,2,1,3,1,17
9597,799135,1,0,0,0,0,0,0,0,0,0,0,0,0,0,0,0,0
9597,799128,10,0,0,0,0,0,0,0,0,0,0,0,0,0,2,0,0
9597,799130,13,0,5,0,1,0,4,0,0,0,0,0,0,0,0,0,0
9597,799133,20,1,5,1,4,0,1,1,2,1,2,2,2,1,0,0,3
9598,791883,36,7,9,3,5,4,4,1,1,1,2,1,1,1,1,1,19
9598,781066,24,4,6,4,6,0,0,0,0,3,3,1,4,1,0,1,8
9598,797594,30,1,5,0,3,1,2,0,0,1,6,1,1,0,0,0,3
9598,791884,38,9,16,8,13,1,3,2,5,0,7,11,2,1,5,0,21
9598,780695,35,6,14,3,9,3,5,0,0,0,1,2,2,3,1,1,15
9598,797600,2,0,0,0,0,0,0,0,0,0,0,0,1,0,1,0,0
9598,797598,5,1,1,1,1,0,0,0,0,0,2,0,2,0,0,0,2
9598,797597,5,0,1,0,0,0,1,0,0,1,1,0,0,0,1,0,0
9598,791885,3,1,1,1,1,0,0,0,1,0,0,0,1,0,0,0,2
9598,786496,22,1,2,0,1,1,1,3,4,0,1,1,3,2,0,0,6
9599,776200,26,3,9,3,9,0,0,4,6,0,3,2,0,1,1,0,10
9599,786437,16,1,2,0,1,1,1,0,0,1,2,2,3,1,0,0,3
9599,780925,36,2,7,0,1,2,6,6,6,1,0,1,2,1,3,0,12
9599,781034,37,3,9,1,5,2,4,4,4,0,5,3,2,0,3,0,12
9599,791625,9,2,5,2,2,0,3,0,1,1,0,0,1,0,1,0,4
9599,791622,14,1,2,1,2,0,0,1,2,0,1,0,1,0,0,1,3
9599,791624,25,2,4,1,3,1,1,1,2,1,3,1,2,0,0,0,6
9599,780446,6,0,0,0,0,0,0,0,0,0,2,0,1,1,2,0,0
9599,796979,31,2,9,0,3,2,6,0,0,1,3,1,0,1,1,1,6
9600,792181,19,5,7,3,4,2,3,0,0,2,2,1,5,1,2,1,12
9600,780986,30,3,4,3,4,0,0,1,2,0,6,4,3,1,2,2,7
9600,785902,32,5,9,3,4,2,5,0,0,1,7,5,2,1,0,2,12
9600,792179,33,4,12,2,6,2,6,4,5,0,1,3,1,0,2,0,14
9600,786662,37,10,16,4,4,6,12,1,1,1,1,5,1,0,2,0,27
9600,792177,18,2,4,2,4,0,0,0,0,5,3,0,3,0,0,1,4
9600,786661,21,4,5,2,2,2,3,1,1,2,1,0,3,2,0,0,11
9600,797796,10,1,3,1,3,0,0,0,0,0,0,1,1,1,0,0,2
9601,785409,33,5,12,5,12,0,0,2,2,5,2,1,1,1,1,0,12
9601,785408,33,3,11,2,7,1,4,0,0,1,0,3,2,2,4,0,7
9601,785407,26,2,5,2,5,0,0,10,12,2,4,0,1,1,0,0,14
9601,796416,29,3,11,1,7,2,4,1,1,0,1,0,2,1,1,0,9
9601,790861,32,4,10,4,9,0,1,3,5,5,3,1,2,1,3,0,11
9601,796415,16,2,5,0,1,2,4,0,0,0,2,2,1,0,2,0,6
9601,780539,31,2,4,0,0,2,4,3,3,0,2,4,3,1,1,0,9
9602,797695,26,12,14,12,14,0,0,8,10,1,7,1,3,0,1,2,32
9602,797699,33,6,10,6,9,0,1,3,5,0,6,10,1,7,1,0,15
9602,797692,21,6,8,1,1,5,7,2,2,0,3,2,3,0,0,0,19
9602,791954,26,2,5,1,3,1,2,2,2,0,2,0,3,0,0,1,7
9602,780846,32,7,12,7,10,0,2,3,3,3,6,6,2,1,1,1,17
9602,797698,6,0,0,0,0,0,0,0,0,0,3,0,2,0,0,0,0
9602,797696,2,0,0,0,0,0,0,0,0,0,0,0,1,0,1,0,0
9602,780844,12,3,7,1,2,2,5,0,0,0,1,0,1,0,0,0,8
9602,797694,21,3,7,1,1,2,6,0,0,0,2,2,0,0,0,0,8
9602,791956,21,1,4,0,0,1,4,2,2,1,2,1,4,0,0,0,5
9603,791743,16,4,6,4,6,0,0,2,2,1,2,0,3,0,1,0,10
9603,797341,22,3,7,1,5,2,2,0,0,0,2,0,1,0,2,0,8
9603,791747,40,5,18,4,12,1,6,7,7,2,2,6,3,1,2,0,18
9603,791746,29,5,15,2,10,3,5,2,3,2,1,6,1,1,1,0,15
9603,786193,32,1,1,1,1,0,0,0,0,0,1,1,2,0,2,0,2
9603,797345,7,0,1,0,1,0,0,0,0,1,1,0,3,0,1,0,0
9603,797344,7,1,1,1,1,0,0,3,5,0,2,0,4,0,0,0,5
9603,797343,14,3,7,2,4,1,3,1,1,0,4,0,0,0,0,0,8
9603,797342,9,3,5,3,4,0,1,0,0,0,0,1,1,0,0,0,6
9603,797340,22,3,5,1,2,2,3,0,0,0,4,1,2,0,1,0,8
9603,791744,2,0,0,0,0,0,0,0,0,0,0,0,0,0,0,0,0
9604,789177,34,6,8,6,8,0,0,1,3,3,8,0,3,0,1,0,13
9604,780227,31,1,5,1,5,0,0,2,2,4,7,3,3,0,5,0,4
9604,791340,37,7,13,6,10,1,3,2,4,0,1,1,2,1,2,0,17
9604,780181,28,6,13,4,7,2,6,6,8,1,0,1,4,1,3,1,20
9604,776089,39,5,9,0,3,5,6,1,1,0,4,4,1,3,1,0,16
9604,797260,2,0,0,0,0,0,0,0,0,0,1,0,0,0,0,0,0
9604,775758,9,0,0,0,0,0,0,0,0,0,1,0,1,1,0,0,0
9604,791336,7,0,1,0,1,0,0,0,0,0,1,1,0,1,0,0,0
9604,789178,13,1,3,0,2,1,1,1,2,0,1,0,2,1,1,1,4
9605,792418,28,1,6,1,5,0,1,4,4,0,5,3,2,1,3,1,6
9605,782654,35,5,12,5,11,0,1,6,7,3,6,2,3,0,2,1,16
9605,796693,20,0,3,0,2,0,1,0,0,0,0,2,0,1,1,0,0
9605,796691,24,1,7,1,1,0,6,0,0,1,0,2,1,1,1,0,2
9605,789484,34,1,8,1,5,0,3,6,8,2,4,3,3,0,2,0,8
9605,792424,6,0,0,0,0,0,0,0,0,1,0,0,1,0,0,0,0
9605,800100,5,1,1,0,0,1,1,0,0,0,0,1,2,1,1,0,3
9605,792421,17,2,4,1,1,1,3,0,0,0,3,0,0,0,1,0,5
9605,792422,27,8,11,6,9,2,2,1,2,1,0,0,2,2,0,1,19
9605,792423,4,1,1,0,0,1,1,0,0,0,0,0,1,0,0,0,3
9606,790781,35,3,9,3,9,0,0,3,5,1,5,0,2,2,2,1,9
9606,780040,34,6,10,6,10,0,0,1,2,1,4,2,3,2,2,1,13
9606,790785,30,10,15,10,13,0,2,6,7,1,5,2,4,2,5,0,26
9606,781232,29,1,4,1,3,0,1,0,0,0,3,3,1,1,0,0,2
9606,780037,35,2,10,0,6,2,4,0,2,0,2,2,1,3,2,0,6
9606,796339,25,3,9,3,4,0,5,2,2,2,4,5,2,3,2,0,8
9606,796343,8,0,0,0,0,0,0,0,0,0,0,0,1,0,0,0,0
9606,790783,4,0,1,0,1,0,0,0,0,0,0,0,1,0,0,0,0
9607,792283,37,4,10,2,6,2,4,0,0,2,4,0,2,0,1,0,10
9607,797829,19,4,4,4,4,0,0,2,2,2,5,0,4,1,3,0,10
9607,797823,15,4,6,4,5,0,1,1,2,2,2,0,3,1,2,1,9
9607,792280,36,4,11,3,6,1,5,2,3,0,4,4,2,1,7,0,11
9607,780505,39,8,18,5,11,3,7,0,0,0,4,4,2,2,3,1,19
9607,785950,31,0,8,0,3,0,5,0,0,2,7,0,5,1,2,0,0
9607,792286,11,0,0,0,0,0,0,0,0,2,3,0,0,0,1,1,0
9607,797831,4,0,1,0,1,0,0,0,0,0,0,0,0,1,0,0,0
9607,792284,8,0,0,0,0,0,0,0,0,0,1,0,1,0,1,0,0
9608,797281,34,3,8,3,7,0,1,2,2,2,4,1,3,0,4,0,8
9608,791648,31,2,8,0,2,2,6,2,4,1,4,1,2,3,2,0,8
9608,785694,12,1,2,1,2,0,0,0,2,1,4,0,5,0,0,0,2
9608,797280,30,4,10,4,9,0,1,5,6,2,2,4,0,0,2,0,13
9608,797279,30,4,9,4,6,0,3,4,5,0,4,0,1,0,0,0,12
9608,791647,2,0,0,0,0,0,0,0,0,0,0,0,1,0,0,0,0
9608,791649,31,5,10,0,1,5,9,6,6,0,2,0,0,4,1,0,21
9608,786640,21,2,5,2,5,0,0,1,2,2,1,1,0,1,1,0,5
9608,785697,9,0,2,0,0,0,2,0,0,0,0,1,0,0,0,0,0
9609,781650,28,7,12,7,12,0,0,3,4,1,7,1,4,0,1,0,17
9609,797070,31,5,9,5,6,0,3,0,1,1,4,1,2,0,1,0,10
9609,776079,31,4,4,0,0,4,4,0,0,0,4,3,3,0,4,0,12
9609,777865,32,3,8,1,2,2,6,0,2,0,2,2,4,1,5,0,8
9609,791429,34,2,6,2,4,0,2,4,4,1,6,3,3,1,3,0,8
9609,797066,12,3,7,3,7,0,0,1,2,1,1,0,0,0,1,0,7
9609,780180,9,0,0,0,0,0,0,0,0,0,1,0,2,1,1,1,0
9609,797067,15,1,2,1,2,0,0,0,0,0,0,2,0,1,1,0,2
9609,797069,8,0,2,0,1,0,1,0,0,0,1,0,0,0,0,0,0
9610,796585,12,1,1,1,1,0,0,1,2,0,1,1,2,2,1,0,3
9610,780192,31,3,3,3,3,0,0,0,0,0,4,1,3,0,1,0,6
9610,798139,31,8,14,7,10,1,4,4,4,1,5,2,2,1,2,0,21
9610,786818,33,8,17,8,15,0,2,5,8,3,1,0,3,1,0,0,21
9610,780182,33,2,9,1,2,1,7,0,0,0,4,2,1,1,0,0,5
9610,796587,3,0,0,0,0,0,0,0,0,0,0,0,0,0,0,0,0
9610,780186,24,0,4,0,4,0,0,2,2,0,1,1,1,0,1,0,2
9610,798138,9,1,1,1,1,0,0,0,0,1,0,0,0,0,0,0,2
9610,786820,9,0,4,0,1,0,3,0,0,0,3,1,0,0,0,0,0
9610,780184,15,1,5,0,0,1,5,0,0,0,1,1,1,0,0,0,3
9611,791548,38,13,15,8,9,5,6,2,4,2,10,2,0,1,4,0,33
9611,791550,28,1,4,1,4,0,0,0,0,1,5,2,3,0,0,0,2
9611,791552,34,6,10,3,6,3,4,1,3,0,7,3,4,0,4,0,16
9611,786368,31,2,5,0,0,2,5,0,0,0,0,5,2,0,2,1,6
9611,786364,37,2,9,2,5,0,4,2,2,3,2,1,2,0,2,0,6
9611,797082,12,2,6,2,5,0,1,0,0,2,1,1,2,0,2,0,4
9611,780330,6,0,1,0,0,0,1,0,0,0,0,0,1,0,0,0,0
9611,780329,14,0,2,0,1,0,1,0,0,0,1,0,3,1,1,0,0
9612,797562,8,1,1,1,1,0,0,0,0,0,0,0,4,1,0,0,2
9612,791766,32,4,6,3,4,1,2,1,2,1,1,1,3,3,3,0,10
9612,786230,29,5,10,1,4,4,6,6,7,0,4,2,3,1,2,0,20
9612,780604,20,3,5,3,4,0,1,5,6,2,3,2,2,0,3,0,11
9612,780602,31,6,10,6,8,0,2,3,5,0,5,2,2,1,2,0,15
9612,786071,4,0,1,0,1,0,0,0,0,1,1,0,1,0,1,0,0
9612,797565,2,0,1,0,0,0,1,0,0,0,0,0,0,0,0,0,0
9612,791768,23,4,5,4,5,0,0,2,2,0,4,0,2,0,2,0,10
9612,786460,14,2,2,2,2,0,0,0,0,0,0,1,0,2,0,1,4
9612,797563,2,0,0,0,0,0,0,0,0,0,0,0,0,0,0,0,0
9612,797564,3,0,0,0,0,0,0,0,0,0,0,0,0,0,1,0,0
9612,791767,13,2,3,1,1,1,2,0,0,0,2,0,3,2,3,0,5
9612,780605,2,0,0,0,0,0,0,1,2,0,2,0,0,0,0,0,1
9612,780603,17,0,1,0,0,0,1,2,2,0,0,2,2,0,2,0,2
9613,792047,26,3,5,3,3,0,2,2,2,2,4,0,1,1,3,0,8
9613,786338,32,2,9,1,3,1,6,2,3,1,2,0,2,1,4,0,7
9613,797647,29,2,11,2,5,0,6,2,2,2,1,2,1,0,1,0,6
9613,792050,29,4,5,4,4,0,1,2,2,0,2,2,4,2,3,0,10
9613,775601,37,8,16,8,13,0,3,6,7,0,0,2,3,1,3,0,22
9613,792048,2,1,2,0,0,1,2,0,0,0,1,0,1,0,0,0,3
9613,791512,14,0,2,0,2,0,0,4,4,3,5,0,3,2,1,0,4
9613,792045,3,0,0,0,0,0,0,0,0,0,0,0,0,0,0,0,0
9613,797648,10,1,1,0,0,1,1,0,2,0,1,1,1,0,0,0,3
9613,792052,11,0,4,0,1,0,3,0,0,0,0,1,1,1,0,0,0
9613,792051,1,0,0,0,0,0,0,0,0,0,0,0,1,0,0,0,0
9613,780862,6,0,1,0,1,0,0,0,0,0,0,0,0,1,0,0,0
9614,780874,24,3,8,2,4,1,4,0,0,2,3,1,3,0,0,2,7
9614,781326,22,1,3,1,3,0,0,1,4,4,1,1,0,1,1,1,3
9614,797870,37,3,12,2,6,1,6,2,3,0,3,1,0,2,4,0,9
9614,792210,30,3,5,2,2,1,3,1,2,0,2,0,1,0,3,0,8
9614,781323,37,5,13,5,10,0,3,1,1,0,5,3,3,2,5,0,11
9614,797868,8,1,1,0,0,1,1,0,0,0,0,1,0,0,0,0,3
9614,785638,14,1,5,1,4,0,1,0,0,2,3,1,1,0,1,0,2
9614,785430,13,0,2,0,2,0,0,0,0,0,4,0,2,1,0,0,0
9614,792215,9,2,3,2,2,0,1,0,0,0,0,0,1,1,2,0,4
9614,797869,5,1,2,1,2,0,0,1,2,1,1,0,2,1,0,0,3
9614,792213,1,0,0,0,0,0,0,0,0,0,0,0,0,0,0,0,0
9615,796372,20,4,6,4,6,0,0,0,1,3,3,0,2,0,2,0,8
9615,796379,34,6,8,1,2,5,6,6,7,1,5,5,1,2,3,0,23
9615,796377,34,3,11,3,9,0,2,1,4,2,3,2,3,3,2,0,7
9615,790815,28,3,10,3,6,0,4,0,0,3,3,1,2,1,2,0,6
9615,780176,35,7,14,5,7,2,7,1,2,1,2,5,2,3,0,1,17
9615,786013,18,3,4,3,4,0,0,0,1,2,6,0,1,0,1,0,6
9615,796378,17,2,2,2,2,0,0,0,1,0,1,0,0,0,2,0,4
9615,796374,8,0,1,0,0,0,1,0,0,0,0,0,0,0,1,0,0
9615,796376,1,0,1,0,1,0,0,0,0,0,1,0,0,0,0,0,0
9615,796375,2,0,0,0,0,0,0,0,0,0,0,0,1,0,0,0,0
9615,790817,2,0,1,0,0,0,1,0,0,0,0,0,0,0,0,0,0
9615,796373,1,0,0,0,0,0,0,0,0,0,0,0,0,0,0,0,0
9616,781624,25,0,3,0,2,0,1,2,2,0,2,2,2,1,0,0,2
9616,792246,28,7,13,7,13,0,0,2,3,1,9,3,1,0,1,1,16
9616,797925,23,3,5,3,4,0,1,2,2,0,1,0,5,0,1,0,8
9616,781420,33,9,19,7,12,2,7,0,0,0,6,3,2,1,0,2,20
9616,781405,40,7,19,5,10,2,9,2,2,0,9,6,3,0,4,0,18
9616,781417,1,0,0,0,0,0,0,0,0,0,0,0,0,0,0,0,0
9616,780615,8,1,1,1,1,0,0,0,0,0,1,0,0,0,0,0,2
9616,791701,18,1,3,1,2,0,1,0,0,2,3,1,1,0,2,0,2
9616,792245,24,1,1,1,1,0,0,2,2,0,1,2,4,0,1,0,4
9617,791115,18,2,4,2,4,0,0,3,6,4,2,0,3,1,2,0,7
9617,791118,40,5,18,2,10,3,8,6,6,0,4,2,1,2,0,0,19
9617,785947,17,1,3,1,2,0,1,0,0,0,3,0,2,0,0,0,2
9617,785676,30,0,8,0,6,0,2,1,2,3,7,2,4,0,1,2,1
9617,774974,40,5,11,5,10,0,1,10,12,0,3,3,1,0,4,0,20
9617,796771,22,3,4,2,3,1,1,2,2,2,4,0,1,0,1,1,9
9617,796769,23,1,5,0,1,1,4,0,0,0,5,0,1,0,0,0,3
9617,791117,10,0,1,0,1,0,0,1,2,0,0,1,1,0,2,0,1
9618,776424,26,2,3,2,2,0,1,0,0,1,4,1,2,0,2,2,4
9618,792300,29,4,5,3,3,1,2,0,0,3,1,3,4,0,3,1,9
9618,792303,35,3,17,2,9,1,8,15,15,4,0,6,1,3,2,0,22
9618,781603,31,5,9,3,4,2,5,0,1,1,4,3,2,2,1,0,12
9618,780456,28,4,6,1,1,3,5,6,8,0,5,0,2,0,0,1,17
9618,797912,18,2,6,0,0,2,6,0,0,0,4,2,2,0,2,1,6
9618,786618,14,0,0,0,0,0,0,0,0,2,3,1,2,0,2,1,0
9618,797914,14,3,6,0,1,3,5,0,0,0,0,0,0,0,0,0,9
9618,790813,5,0,3,0,1,0,2,0,0,0,0,0,1,0,0,0,0
9619,792560,19,0,0,0,0,0,0,2,4,4,3,0,4,0,1,1,2
9619,792565,37,11,16,11,16,0,0,0,0,6,3,1,4,0,5,0,22
9619,792563,26,4,10,3,7,1,3,1,2,1,2,2,4,1,2,0,10
9619,792561,33,1,11,1,6,0,5,0,0,0,2,5,1,1,2,0,2
9619,780270,18,3,9,2,5,1,4,2,2,4,2,1,1,1,1,0,9
9619,785472,16,1,1,1,1,0,0,0,0,1,1,1,1,1,0,1,2
9619,776333,2,0,0,0,0,0,0,0,0,0,1,0,0,0,1,0,0
9619,798133,2,0,0,0,0,0,0,0,0,0,0,0,0,0,1,0,0
9619,798134,17,3,7,0,2,3,5,1,2,0,3,2,3,0,0,0,10
9619,780266,22,4,11,2,4,2,7,1,2,0,4,2,2,0,0,0,11
9619,798132,7,0,1,0,0,0,1,0,0,0,1,3,1,0,0,0,0
9619,798135,1,0,0,0,0,0,0,0,0,0,0,0,1,0,0,0,0
9620,786846,29,7,15,4,6,3,9,0,0,2,6,2,2,1,1,1,17
9620,775515,23,4,10,2,2,2,8,1,2,1,2,1,3,1,1,0,11
9620,791579,37,4,9,4,7,0,2,0,0,0,3,1,3,1,2,0,8
9620,786387,39,5,15,5,12,0,3,1,2,3,3,2,0,2,1,1,11
9620,780399,36,7,12,2,3,5,9,0,0,3,3,7,3,2,2,0,19
9620,797047,12,0,1,0,0,0,1,0,0,0,2,0,2,0,1,2,0
9620,780400,6,1,1,1,1,0,0,0,0,0,1,0,0,0,1,0,2
9620,791575,10,0,1,0,1,0,0,0,0,0,1,0,1,0,0,0,0
9620,797046,8,0,3,0,1,0,2,0,0,0,1,0,0,1,1,0,0
9621,791839,36,7,10,7,10,0,0,1,2,1,8,2,1,1,4,0,15
9621,797444,36,2,6,0,0,2,6,4,4,2,4,1,0,1,0,2,10
9621,792381,33,3,8,2,2,1,6,2,2,0,2,3,3,1,1,1,9
9621,791842,36,8,19,3,6,5,13,2,2,1,8,1,1,0,1,0,23
9621,786616,28,2,5,1,3,1,2,2,2,0,2,2,4,1,3,0,7
9621,785322,8,2,3,1,2,1,1,0,0,0,0,0,2,0,1,0,5
9621,786613,2,0,0,0,0,0,0,1,2,0,0,0,0,0,0,0,1
9621,786736,21,1,2,1,2,0,0,0,0,1,0,5,0,0,4,0,2
9622,791140,22,8,18,8,18,0,0,5,6,7,1,1,1,1,1,1,21
9622,791138,25,3,5,3,5,0,0,2,2,1,2,2,1,1,1,0,8
9622,786084,27,5,9,4,5,1,4,0,0,1,8,5,1,3,1,0,11
9622,780910,25,7,14,3,9,4,5,0,0,0,3,7,0,0,0,0,18
9622,780288,22,5,8,3,5,2,3,2,2,2,3,1,1,1,2,0,14
9622,796794,10,1,1,1,1,0,0,0,0,0,0,1,1,0,0,0,2
9622,792142,1,0,1,0,1,0,0,0,0,0,1,0,1,0,0,0,0
9622,791137,2,0,1,0,0,0,1,0,0,0,0,1,1,0,0,0,0
9622,796795,18,2,4,2,4,0,0,1,2,4,4,3,2,0,1,4,5
9622,796793,3,3,3,2,2,1,1,0,1,0,0,0,0,0,1,0,7
9622,786082,3,0,0,0,0,0,0,0,0,0,1,0,0,0,0,0,0
9622,780912,7,1,2,1,2,0,0,0,0,0,0,0,0,0,0,0,2
9622,780911,21,4,10,2,6,2,4,2,2,2,3,1,0,0,1,0,12
9622,781635,14,2,2,1,1,1,1,0,0,0,5,3,2,1,1,0,5
9623,780346,35,10,20,8,14,2,6,1,2,3,2,3,0,2,3,0,23
9623,780338,14,3,5,3,5,0,0,0,0,1,1,0,4,0,1,1,6
9623,791030,24,1,6,1,2,0,4,0,0,0,4,1,3,0,2,0,2
9623,785477,32,4,8,2,3,2,5,3,4,0,1,1,1,1,3,0,13
9623,785475,33,3,9,1,3,2,6,0,0,0,5,6,0,1,0,2,8
9623,791032,7,0,1,0,0,0,1,3,6,0,0,0,0,0,0,0,3
9623,791029,3,1,1,0,0,1,1,0,0,0,1,0,0,0,0,0,3
9623,796689,21,4,6,4,6,0,0,0,0,2,4,0,3,1,1,2,8
9623,791031,2,1,1,1,1,0,0,0,0,1,0,0,0,0,0,0,2
9623,796688,3,0,1,0,0,0,1,0,0,0,0,0,1,0,0,0,0
9623,796687,3,0,1,0,0,0,1,0,0,0,0,1,0,0,0,0,0
9623,786655,21,2,5,1,3,1,2,2,2,0,0,0,2,1,0,1,7
9623,780344,2,0,1,0,0,0,1,0,0,0,0,0,0,0,0,0,0
9624,780201,31,3,5,3,5,0,0,0,1,0,7,1,4,0,0,0,6
9624,791469,38,3,6,3,6,0,0,0,0,1,5,1,3,1,4,4,6
9624,797210,36,5,14,5,12,0,2,4,7,2,6,3,4,2,2,0,14
9624,786311,36,6,11,4,5,2,6,4,4,0,2,1,0,1,4,0,18
9624,775516,34,3,6,3,6,0,0,0,0,1,5,2,3,1,3,0,6
9624,798344,12,3,5,3,3,0,2,0,0,0,1,0,1,0,0,0,6
9624,791467,13,2,6,2,2,0,4,2,2,0,2,0,2,1,0,1,6
9625,791440,30,7,12,7,12,0,0,1,4,8,4,0,0,0,3,1,15
9625,797019,24,2,8,2,8,0,0,5,5,0,0,2,5,1,2,0,9
9625,797016,20,0,3,0,3,0,0,0,0,0,1,0,2,1,0,0,0
9625,781378,36,10,19,6,12,4,7,0,0,1,7,0,2,5,2,1,24
9625,775267,36,0,8,0,0,0,8,0,0,1,5,3,2,3,3,0,0
9625,791443,8,0,0,0,0,0,0,0,0,0,0,0,0,0,0,0,0
9625,781629,4,0,1,0,1,0,0,0,0,0,1,0,1,0,0,0,0
9625,775739,3,0,1,0,1,0,0,0,0,0,0,0,0,0,1,0,0
9625,797015,7,1,1,1,1,0,0,0,0,0,0,1,0,0,0,1,2
9625,797013,15,0,5,0,4,0,1,0,0,0,1,0,1,0,2,0,0
9625,791441,17,1,5,1,5,0,0,0,0,1,2,1,2,1,2,0,2
9626,781175,24,2,5,2,5,0,0,1,2,4,10,4,4,0,2,0,5
9626,786555,33,1,7,0,0,1,7,0,0,0,0,1,2,0,1,0,3
9626,786553,30,4,11,1,5,3,6,3,4,0,2,3,4,2,0,0,14
9626,780895,26,3,7,3,7,0,0,8,8,2,5,0,2,2,2,0,14
9626,781172,35,6,13,3,5,3,8,4,6,2,4,3,1,1,1,0,19
9626,792005,22,2,8,2,5,0,3,2,3,3,4,1,2,1,3,0,6
9626,781177,15,0,1,0,0,0,1,0,0,1,3,2,2,0,2,2,0
9626,785312,15,3,7,3,5,0,2,5,6,1,1,1,1,4,3,0,11
9627,781007,30,3,6,3,6,0,0,2,3,5,2,6,4,1,2,1,8
9627,781322,30,3,10,2,4,1,6,0,0,1,2,1,3,1,2,1,7
9627,786571,23,4,8,3,4,1,4,4,5,0,4,4,4,3,1,0,13
9627,781419,34,4,14,2,5,2,9,2,2,0,2,0,3,2,2,0,12
9627,780563,35,4,9,0,1,4,8,0,0,0,3,1,4,0,5,1,12
9627,784248,13,2,4,1,1,1,3,0,0,0,2,0,0,0,0,0,5
9627,797299,8,1,1,1,1,0,0,0,0,0,0,0,1,0,0,0,2
9627,785989,27,3,8,3,5,0,3,1,1,0,4,2,4,1,2,1,7
9628,775651,32,7,12,6,9,1,3,7,9,4,2,0,5,0,2,1,22
9628,791070,24,1,5,0,3,1,2,4,6,1,7,2,4,0,1,0,7
9628,791627,33,4,8,2,5,2,3,3,4,1,3,4,4,2,5,0,13
9628,785665,32,4,8,3,4,1,4,2,3,0,6,2,0,2,3,0,11
9628,776178,22,2,6,2,5,0,1,2,2,1,1,2,3,0,3,0,6
9628,791071,7,1,2,1,2,0,0,0,0,0,0,0,2,0,1,0,2
9628,785660,1,0,0,0,0,0,0,0,0,0,0,0,0,0,0,0,0
9628,776253,30,3,5,1,3,2,2,0,0,1,7,2,0,0,2,1,8
9628,796502,4,0,0,0,0,0,0,0,0,0,1,0,0,0,0,0,0
9628,796501,15,2,5,1,4,1,1,2,2,0,2,2,1,0,0,0,7
9629,780095,17,2,3,2,3,0,0,0,0,1,2,0,3,0,1,0,4
9629,776321,38,5,10,5,9,0,1,4,6,1,6,0,4,0,2,1,14
9629,786081,36,5,11,4,6,1,5,3,4,3,4,2,3,2,2,0,14
9629,785431,38,2,9,1,5,1,4,4,4,0,1,4,4,1,0,1,9
9629,780232,40,8,21,7,16,1,5,6,8,1,3,0,4,2,2,0,23
9629,786020,8,1,3,1,3,0,0,0,0,2,0,0,1,0,1,0,2
9629,785356,5,0,0,0,0,0,0,0,0,0,1,0,1,0,0,1,0
9629,789040,18,1,4,1,1,0,3,2,3,0,3,0,1,0,0,0,4
9630,792143,28,2,7,0,1,2,6,0,0,2,3,1,3,1,3,0,6
9630,786302,26,2,4,2,4,0,0,2,2,1,6,0,1,0,0,1,6
9630,786293,28,3,9,2,6,1,3,7,10,0,3,2,3,0,4,0,14
9630,780953,30,4,12,3,10,1,2,3,3,1,4,1,2,2,0,1,12
9630,786287,32,3,7,2,4,1,3,1,2,0,1,0,1,3,2,0,8
9630,780955,14,0,2,0,2,0,0,0,0,0,0,1,0,1,0,0,0
9630,797750,29,6,10,6,10,0,0,0,0,1,0,3,3,1,2,0,12
9630,797742,4,0,2,0,1,0,1,0,0,0,0,0,0,0,0,0,0
9630,797751,6,0,0,0,0,0,0,0,0,0,0,1,0,0,0,0,0
9630,792147,3,0,0,0,0,0,0,0,0,0,0,0,1,0,0,0,0
9631,791058,13,1,1,1,1,0,0,0,0,0,1,1,2,1,0,0,2
9631,780063,22,4,8,3,5,1,3,0,0,0,4,0,4,0,1,0,9
9631,796734,12,0,0,0,0,0,0,0,0,0,1,0,2,0,0,0,0
9631,791280,30,3,7,2,5,1,2,0,0,0,1,2,2,2,5,0,7
9631,791055,23,2,5,2,4,0,1,2,3,0,1,3,2,2,1,0,6
9631,775926,17,4,5,1,1,3,4,2,2,0,4,0,1,0,2,0,13
9631,785530,38,7,11,4,7,3,4,2,2,2,4,6,1,0,2,1,19
9631,785532,27,4,7,4,7,0,0,4,6,1,8,1,2,0,0,2,12
9631,791057,15,3,6,2,4,1,2,1,1,2,1,0,0,0,0,0,8
9631,775573,2,0,1,0,0,0,1,0,0,0,0,0,1,0,0,0,0
9631,791059,1,0,1,0,1,0,0,0,0,0,0,0,0,0,0,0,0
9632,781453,41,8,21,6,11,2,10,11,12,1,5,4,3,3,1,1,29
9632,797972,37,6,8,4,5,2,3,2,4,2,2,0,4,0,2,3,16
9632,797970,35,6,13,5,11,1,2,1,2,2,5,3,5,1,3,0,14
9632,797967,39,3,9,3,7,0,2,7,13,4,8,2,3,2,3,0,13
9632,774869,43,4,12,0,1,4,11,0,0,3,2,1,3,1,0,0,12
9632,792254,15,2,2,1,1,1,1,0,0,1,0,0,1,1,0,0,5
9632,786098,15,1,4,1,2,0,2,0,1,0,0,2,0,0,1,0,2
9632,797962,0,0,0,0,0,0,0,0,0,0,0,0,0,0,0,0,0
9633,785296,32,12,21,8,12,4,9,5,6,2,5,0,4,2,1,1,33
9633,767245,35,9,15,9,15,0,0,5,5,5,4,0,5,2,3,0,23
9633,780212,41,5,18,2,8,3,10,0,0,1,3,4,3,0,2,0,13
9633,775087,27,1,6,1,6,0,0,2,2,1,4,0,4,0,2,1,4
9633,780406,25,0,2,0,1,0,1,1,2,2,4,1,1,0,3,0,1
9633,790984,37,4,10,1,2,3,8,2,3,2,2,1,2,1,2,0,13
9633,780215,8,1,1,1,1,0,0,0,0,0,0,0,2,0,0,0,2
9633,785297,20,0,2,0,2,0,0,0,0,0,4,3,4,0,1,0,0
9633,780214,0,0,0,0,0,0,0,0,0,0,0,0,0,0,0,0,0
9634,791585,31,3,7,2,5,1,2,0,1,1,2,1,2,0,1,0,7
9634,791581,31,2,6,1,2,1,4,0,0,1,4,1,1,2,0,0,5
9634,786395,34,5,15,4,8,1,7,10,11,2,7,4,2,2,4,0,21
9634,786394,36,6,11,6,8,0,3,7,9,3,3,2,3,3,3,2,19
9634,780404,30,2,6,1,4,1,2,2,2,1,6,2,2,0,2,0,7
9634,785228,14,3,4,1,2,2,2,1,1,0,2,0,5,1,1,0,9
9634,780062,9,0,5,0,5,0,0,0,2,2,0,0,4,0,0,0,0
9634,780403,12,0,0,0,0,0,0,0,2,0,0,0,0,0,0,0,0
9634,797041,1,0,1,0,1,0,0,0,0,0,1,0,0,0,0,0,0
9634,799920,1,0,0,0,0,0,0,0,0,0,0,0,0,0,0,0,0
9634,797037,1,0,0,0,0,0,0,0,0,0,0,0,0,0,0,0,0
9635,790827,23,8,12,6,10,2,2,1,2,1,4,0,2,1,1,0,19
9635,790828,7,0,2,0,2,0,0,0,0,0,3,0,2,0,2,0,0
9635,785372,34,5,12,4,8,1,4,1,4,0,9,3,4,3,6,1,12
9635,790825,31,1,5,0,2,1,3,0,0,1,3,4,2,1,4,0,3
9635,774905,31,1,8,1,4,0,4,2,2,3,0,0,3,1,1,0,4
9635,785375,14,3,4,3,4,0,0,1,2,1,4,0,1,1,1,1,7
9635,785373,14,1,2,1,1,0,1,0,0,0,0,0,0,0,0,0,2
9635,786384,13,2,6,2,4,0,2,0,1,1,0,1,4,0,1,1,4
9635,796385,13,1,2,1,2,0,0,0,1,0,0,1,1,0,1,0,2
9635,796387,3,0,0,0,0,0,0,0,0,0,2,0,1,0,0,0,0
9635,780007,6,0,0,0,0,0,0,1,2,0,0,0,1,0,1,0,1
9635,785374,11,0,0,0,0,0,0,3,4,1,3,1,2,0,0,0,3
9636,791846,7,0,1,0,1,0,0,0,0,1,1,1,1,0,1,0,0
9636,797222,19,3,6,3,6,0,0,1,2,0,3,0,5,1,1,2,7
9636,781526,23,5,12,4,8,1,4,3,3,3,2,1,4,0,0,0,14
9636,797218,23,0,4,0,3,0,1,0,0,0,3,3,0,0,0,0,0
9636,775697,33,6,10,2,3,4,7,0,1,0,2,8,1,1,0,0,16
9636,797223,17,0,3,0,3,0,0,1,4,2,2,1,3,0,0,0,1
9636,791454,18,3,7,3,5,0,2,4,4,2,3,2,3,0,2,0,10
9636,797219,10,1,4,1,3,0,1,0,0,0,0,3,0,0,1,0,2
9636,791453,29,8,15,2,2,6,13,1,3,0,2,0,0,2,0,0,23
9636,797217,21,0,1,0,1,0,0,0,0,0,1,0,0,1,0,0,0
9636,797221,0,0,0,0,0,0,0,0,0,0,0,0,0,0,0,0,0
9637,796401,26,2,4,1,2,1,2,0,0,2,2,0,3,0,3,0,5
9637,785999,31,5,13,5,13,0,0,3,4,3,8,1,1,0,1,0,13
9637,775654,33,6,8,6,8,0,0,0,0,4,5,0,3,1,0,1,12
9637,791639,30,8,10,6,6,2,4,3,3,0,1,2,2,0,1,0,21
9637,785389,37,4,15,3,10,1,5,0,0,0,7,10,1,1,4,0,9
9637,785255,7,2,2,2,2,0,0,0,0,2,0,0,3,0,2,0,4
9637,791640,9,1,5,0,1,1,4,2,2,0,3,0,3,0,1,1,5
9637,796399,24,1,3,1,1,0,2,1,2,0,2,3,1,0,1,1,3
9637,796398,3,1,1,1,1,0,0,0,0,1,1,0,0,0,0,0,2
9638,775510,36,8,15,5,5,3,10,2,2,0,5,3,3,0,1,1,21
9638,774976,36,4,5,4,5,0,0,5,6,6,6,2,3,0,2,4,13
9638,797865,31,1,6,0,2,1,4,0,0,1,2,4,3,2,2,0,3
9638,786614,32,4,12,1,1,3,11,4,4,0,2,0,4,2,0,2,15
9638,786759,34,4,9,2,4,2,5,0,0,1,1,6,0,1,2,0,10
9638,792294,12,1,1,1,1,0,0,0,0,1,5,1,1,0,3,0,2
9638,792291,15,3,7,1,2,2,5,0,0,1,0,1,0,0,0,0,8
9638,792293,4,0,0,0,0,0,0,0,0,0,0,0,0,0,0,0,0
9639,792181,39,6,14,6,11,0,3,2,6,2,8,1,3,2,1,0,14
9639,780986,40,2,4,2,4,0,0,2,2,2,2,4,2,1,0,1,6
9639,785902,12,0,4,0,2,0,2,3,3,0,2,1,0,0,1,2,3
9639,792179,24,1,8,0,3,1,5,0,0,2,4,4,0,3,1,0,3
9639,786662,39,10,17,5,9,5,8,6,6,2,0,3,2,0,2,0,31
9639,786661,27,4,6,2,2,2,4,0,0,1,0,0,4,0,0,0,10
9639,797796,17,1,2,1,2,0,0,0,0,1,0,3,1,0,0,0,2
9639,792177,2,0,2,0,2,0,0,0,0,0,1,0,0,0,0,0,0
9640,791452,28,1,9,0,1,1,8,0,0,0,0,5,5,1,3,0,3
9640,781558,31,6,10,3,4,3,6,1,4,2,1,0,4,0,4,0,16
9640,797225,37,6,13,4,11,2,2,2,2,0,3,3,2,2,4,0,16
9640,780993,26,0,3,0,3,0,0,3,4,3,3,1,3,1,2,0,3
9640,791446,23,2,7,2,2,0,5,4,4,1,3,0,4,2,0,0,8
9640,797229,1,0,0,0,0,0,0,0,0,0,0,0,0,0,0,0,0
9640,797226,7,2,2,2,2,0,0,0,0,0,1,0,0,0,0,0,4
9640,797230,9,0,0,0,0,0,0,2,2,0,4,0,2,0,2,0,2
9640,791449,30,3,7,2,5,1,2,2,2,0,2,2,0,1,1,0,9
9640,797231,8,0,1,0,1,0,0,2,2,0,1,0,0,0,0,0,2
9641,786534,26,8,8,6,6,2,2,1,3,0,4,4,2,1,2,0,19
9641,791940,26,6,9,4,6,2,3,4,6,1,1,1,3,1,1,0,18
9641,792197,18,3,5,1,3,2,2,1,2,1,4,1,2,1,1,0,9
9641,797517,21,3,7,3,7,0,0,4,4,2,7,0,4,0,4,0,10
9641,781132,37,4,10,2,3,2,7,0,0,0,2,3,3,1,3,0,10
9641,797516,1,0,0,0,0,0,0,0,0,0,0,0,0,0,0,0,0
9641,797518,22,1,1,1,1,0,0,2,2,0,2,4,0,3,1,0,4
9641,797519,4,1,3,1,2,0,1,0,0,0,1,1,1,0,0,0,2
9641,789070,1,0,1,0,1,0,0,0,0,1,0,0,0,0,0,0,0
9641,791938,22,3,5,2,2,1,3,4,6,0,2,0,2,1,0,0,11
9641,797520,4,1,2,1,2,0,0,0,0,0,0,0,0,0,0,0,2
9641,786539,2,0,0,0,0,0,0,0,0,1,0,1,1,0,0,0,0
9641,797522,16,0,0,0,0,0,0,0,1,1,1,0,1,0,2,0,0
9642,790873,35,5,14,4,11,1,3,3,4,1,4,4,1,0,2,0,14
9642,785429,18,1,2,1,1,0,1,0,0,0,3,0,0,2,0,0,2
9642,780054,29,4,9,3,7,1,2,7,11,1,6,2,1,1,1,0,16
9642,781140,29,4,7,4,7,0,0,3,3,2,4,2,3,1,3,1,11
9642,786851,36,6,9,4,4,2,5,2,3,0,3,4,4,0,4,0,16
9642,796432,2,0,0,0,0,0,0,0,0,0,0,0,0,0,1,0,0
9642,776357,30,3,6,3,5,0,1,4,5,0,6,6,4,0,3,1,10
9642,796433,7,1,4,1,4,0,0,0,2,2,1,0,2,0,1,0,2
9642,781139,12,4,4,4,4,0,0,0,0,0,1,1,2,2,0,2,8
9642,776245,2,0,1,0,1,0,0,0,0,0,0,0,0,0,0,0,0
9643,776462,23,1,2,1,1,0,1,5,8,4,4,0,4,2,2,2,7
9643,775642,16,0,2,0,1,0,1,0,0,1,1,2,3,2,2,2,0
9643,791629,29,5,13,4,9,1,4,0,0,1,7,0,3,0,3,1,11
9643,796974,32,8,22,6,15,2,7,0,0,1,1,3,2,1,0,0,18
9643,781199,38,7,24,3,12,4,12,6,8,0,4,4,4,2,2,0,24
9643,791626,15,1,2,1,2,0,0,0,0,2,4,0,1,0,2,0,2
9643,786720,22,4,6,3,3,1,3,0,1,0,3,2,2,0,0,0,9
9643,791628,25,2,6,2,2,0,4,0,0,3,2,4,4,0,0,2,4
9644,785298,20,1,2,1,2,0,0,0,0,0,2,0,3,0,2,1,2
9644,778046,30,6,12,4,7,2,5,4,4,0,4,4,4,2,7,1,18
9644,782121,38,7,13,3,5,4,8,5,6,0,2,2,2,3,6,0,23
9644,775793,36,10,15,8,8,2,7,2,2,1,2,1,1,1,0,0,24
9644,775224,28,0,3,0,3,0,0,2,2,7,3,6,3,2,3,0,2
9644,785485,12,1,1,1,1,0,0,0,0,0,3,0,4,0,2,1,2
9644,785302,15,1,3,0,1,1,2,0,0,0,3,0,0,0,1,1,3
9644,786594,21,0,0,0,0,0,0,0,0,0,1,1,0,0,0,0,0
9645,796372,30,6,9,6,9,0,0,6,8,2,1,0,0,1,0,0,18
9645,796379,33,6,11,0,2,6,9,0,0,0,2,2,4,0,4,0,18
9645,796377,27,2,6,2,5,0,1,3,4,4,0,4,3,1,2,0,7
9645,780176,30,0,7,0,1,0,6,3,4,0,3,7,4,2,5,0,3
9645,786013,10,0,2,0,2,0,0,0,0,0,2,0,0,1,0,0,0
9645,796378,22,2,5,1,4,1,1,0,0,2,4,0,2,2,1,0,5
9645,796374,13,1,3,1,2,0,1,0,0,0,0,1,1,0,1,0,2
9645,790815,35,5,11,4,9,1,2,4,4,3,2,1,1,4,2,0,15
9646,785355,34,3,5,3,4,0,1,0,0,2,3,0,3,1,0,3,6
9646,781462,25,3,9,2,8,1,1,0,0,1,5,1,5,0,3,0,7
9646,780876,31,7,14,7,11,0,3,1,2,0,2,2,1,2,2,0,15
9646,785353,36,4,8,1,4,3,4,2,4,1,2,7,2,2,4,0,13
9646,781457,35,5,10,4,7,1,3,2,4,0,3,4,2,3,2,0,13
9646,790895,8,2,4,1,3,1,1,0,0,0,0,0,2,0,0,0,5
9646,781673,13,3,6,2,4,1,2,2,2,0,1,1,1,0,0,0,9
9646,791305,18,1,2,1,2,0,0,0,0,1,2,0,2,1,0,0,2
9647,790821,22,1,6,1,4,0,2,0,0,0,4,2,2,1,2,1,2
9647,775585,36,6,11,6,11,0,0,7,10,2,4,1,0,1,1,2,19
9647,790822,40,3,10,2,6,1,4,5,8,0,2,4,3,1,4,0,12
9647,780982,32,0,2,0,0,0,2,2,2,1,5,1,2,0,4,1,2
9647,774980,37,10,16,7,9,3,7,2,3,1,6,1,3,2,5,0,25
9647,780445,20,1,1,1,1,0,0,1,1,0,5,0,1,0,1,1,3
9647,785365,13,1,1,0,0,1,1,0,0,0,0,1,1,0,1,0,3
9648,786180,10,1,1,1,1,0,0,2,2,2,0,0,3,1,1,0,4
9648,792104,39,7,21,5,13,2,8,0,0,2,7,2,2,1,0,0,16
9648,797709,16,1,6,1,4,0,2,0,0,0,1,0,0,0,0,0,2
9648,786198,37,3,10,2,7,1,3,5,6,1,2,2,3,1,1,0,12
9648,775779,31,6,13,6,10,0,3,3,5,1,2,3,3,1,2,0,15
9648,786204,28,3,8,0,3,3,5,3,4,1,6,0,4,0,1,1,12
9648,797707,25,1,6,1,4,0,2,0,0,1,4,1,4,1,1,0,2
9648,797708,33,2,8,2,6,0,2,2,3,2,0,2,4,3,2,0,6
9648,776327,5,0,0,0,0,0,0,0,0,0,1,0,0,0,0,0,0
9648,792106,1,0,0,0,0,0,0,0,0,0,0,0,0,0,0,0,0
9649,780765,44,7,20,6,16,1,4,5,8,2,9,4,0,2,4,1,20
9649,781301,29,2,2,2,2,0,0,3,4,3,2,0,5,0,1,7,7
9649,786255,40,5,13,4,8,1,5,8,11,4,12,2,4,0,1,2,19
9649,780762,39,7,13,5,9,2,4,0,1,1,7,1,2,0,2,0,16
9649,780768,30,2,4,1,3,1,1,1,2,1,1,3,3,1,5,0,6
9649,791729,8,0,0,0,0,0,0,0,0,0,1,0,2,1,1,0,0
9649,797320,15,1,4,1,2,0,2,1,1,0,1,1,0,0,0,0,3
9649,780755,20,1,4,1,4,0,0,4,4,0,1,0,4,0,1,0,6
9650,785913,14,1,3,1,3,0,0,2,2,0,4,0,5,0,2,0,4
9650,781464,17,1,4,0,1,1,3,1,2,1,4,1,3,0,1,0,4
9650,785282,32,4,7,1,3,3,4,1,2,0,1,2,1,0,1,0,12
9650,781502,37,5,14,2,5,3,9,3,3,1,4,12,1,1,2,1,16
9650,780259,37,8,23,6,15,2,8,3,4,5,9,0,2,2,2,2,21
9650,781501,33,2,5,1,3,1,2,0,0,4,2,2,4,0,2,0,5
9650,792274,5,0,0,0,0,0,0,0,0,1,1,0,1,0,0,0,0
9650,792277,6,1,3,1,3,0,0,0,1,1,1,0,1,0,0,0,2
9650,786516,19,2,7,0,1,2,6,0,0,0,2,1,0,1,0,0,6
9651,791686,23,2,5,2,4,0,1,2,3,0,3,0,3,1,1,1,6
9651,798028,14,1,4,1,4,0,0,1,2,1,4,0,0,1,1,0,3
9651,798022,8,0,2,0,0,0,2,2,2,0,1,0,0,0,0,0,2
9651,790940,37,6,15,4,8,2,7,8,9,1,6,3,2,1,1,1,22
9651,780770,37,10,17,10,13,0,4,4,5,0,2,7,3,3,2,0,24
9651,792270,31,5,7,2,2,3,5,2,2,1,6,0,2,1,0,0,15
9651,792269,17,0,1,0,1,0,0,0,0,1,1,0,3,1,0,0,0
9651,786060,27,1,5,0,1,1,4,0,0,0,2,3,1,1,0,2,3
9651,792271,6,1,1,1,1,0,0,0,0,0,1,0,0,1,1,0,2
9652,785509,16,1,4,1,2,0,2,0,0,2,0,0,5,1,0,1,2
9652,791424,30,5,10,5,9,0,1,2,2,1,3,0,4,0,2,1,12
9652,797085,22,2,6,0,3,2,3,2,4,3,2,0,5,1,2,0,8
9652,791421,37,5,18,4,10,1,8,7,11,1,0,0,3,0,2,0,18
9652,785899,37,2,8,2,5,0,3,7,8,3,4,1,4,1,1,0,11
9652,797079,7,0,2,0,2,0,0,4,4,1,0,0,1,0,1,0,4
9652,791425,24,2,7,2,7,0,0,2,2,2,3,2,2,0,1,0,6
9652,797086,4,0,0,0,0,0,0,0,0,0,0,0,2,0,0,0,0
9652,797090,2,1,1,1,1,0,0,0,0,0,0,0,1,0,0,0,2
9652,797083,2,0,0,0,0,0,0,0,0,0,0,0,1,0,2,0,0
9652,797088,19,0,2,0,0,0,2,0,0,0,2,0,1,0,1,0,0
9653,775705,11,0,0,0,0,0,0,0,2,1,1,1,1,0,0,0,0
9653,791652,25,5,6,5,6,0,0,9,13,2,3,0,4,0,0,1,19
9653,786495,25,2,4,2,4,0,0,5,6,2,7,0,3,1,3,1,9
9653,791650,39,2,9,2,9,0,0,6,7,1,6,0,5,2,7,0,10
9653,776384,32,5,15,4,10,1,5,11,11,0,0,3,2,0,2,0,22
9653,791653,19,2,4,2,3,0,1,0,0,2,4,0,2,0,2,0,4
9653,791654,6,0,0,0,0,0,0,0,0,1,1,0,0,0,0,1,0
9653,797289,18,3,5,3,3,0,2,1,1,1,2,0,4,2,0,0,7
9653,797285,12,0,2,0,1,0,1,0,0,1,0,0,1,0,0,0,0
9653,797283,13,0,1,0,1,0,0,0,0,0,0,0,3,0,0,0,0
9654,792299,25,2,5,2,4,0,1,1,2,0,2,2,2,0,0,0,5
9654,786181,26,5,6,5,6,0,0,2,2,0,2,0,1,0,0,0,12
9654,792304,37,5,10,4,8,1,2,1,2,1,2,1,1,2,2,0,12
9654,792301,32,5,11,5,10,0,1,6,6,2,2,2,1,2,3,0,16
9654,786275,32,4,6,3,4,1,2,0,0,0,3,4,0,1,3,0,9
9654,798089,3,0,0,0,0,0,0,0,0,0,0,0,0,1,0,0,0
9654,792302,3,0,0,0,0,0,0,0,0,0,1,0,0,0,0,0,0
9654,792295,13,0,0,0,0,0,0,0,0,0,1,0,3,0,1,2,0
9654,786280,6,1,2,1,2,0,0,0,0,2,0,0,1,1,2,0,2
9654,786278,23,1,6,1,2,0,4,0,0,0,2,1,2,0,5,0,2
9655,791051,28,3,4,3,4,0,0,3,4,3,3,0,2,0,0,1,9
9655,780739,32,3,9,3,9,0,0,0,1,3,1,0,1,1,3,0,6
9655,785524,29,2,7,1,2,1,5,0,0,0,2,1,2,1,3,0,5
9655,781115,30,5,10,5,9,0,1,0,0,0,2,3,0,2,3,0,10
9655,775456,27,6,13,6,12,0,1,0,0,0,2,3,2,1,3,0,12
9655,796731,10,1,1,1,1,0,0,0,0,0,2,0,2,0,0,0,2
9655,791052,9,2,3,2,3,0,0,0,0,1,0,0,1,0,2,0,4
9655,790819,10,0,1,0,0,0,1,0,0,0,0,2,2,0,1,0,0
9655,786310,9,0,0,0,0,0,0,0,0,0,1,1,3,1,1,0,0
9655,775094,16,3,4,1,1,2,3,0,0,0,2,1,1,0,1,0,8
9656,780283,27,2,7,2,7,0,0,3,4,1,5,1,5,0,6,3,7
9656,790925,34,2,5,2,3,0,2,7,8,4,3,0,5,1,2,0,11
9656,791456,24,5,10,4,4,1,6,1,2,0,2,1,3,1,3,0,12
9656,785476,43,2,10,2,8,0,2,4,4,0,1,5,0,0,1,0,8
9656,785474,38,7,13,5,10,2,3,3,4,4,6,1,2,0,2,0,19
9656,800121,15,2,3,2,3,0,0,0,0,1,3,0,2,0,0,0,4
9656,785480,23,3,8,2,3,1,5,2,4,0,2,0,3,2,0,0,9
9656,790926,8,2,4,1,2,1,2,0,1,0,3,0,0,1,0,0,5
9656,796470,12,2,3,2,3,0,0,0,0,4,1,0,2,0,0,0,4
9656,785478,1,0,0,0,0,0,0,0,0,0,0,0,1,0,0,0,0
9657,796404,41,11,14,11,14,0,0,0,2,3,7,0,3,0,1,0,22
9657,790853,14,1,1,1,1,0,0,0,0,0,0,0,5,1,1,0,2
9657,790850,37,5,14,0,4,5,10,2,2,0,1,2,0,2,1,0,17
9657,781164,32,4,8,1,2,3,6,0,0,1,0,2,4,1,1,1,11
9657,781163,35,3,11,2,7,1,4,11,11,0,3,4,5,2,4,0,18
9657,790849,29,1,8,0,4,1,4,0,0,1,1,5,5,1,1,0,3
9657,796406,18,0,0,0,0,0,0,8,12,2,8,0,3,0,1,1,8
9657,785434,8,0,3,0,2,0,1,2,2,1,1,0,0,2,0,0,2
9657,781223,6,0,0,0,0,0,0,0,0,0,1,0,0,0,0,0,0
9657,790854,2,0,0,0,0,0,0,0,0,0,0,0,0,0,1,0,0
9657,790848,3,0,0,0,0,0,0,0,0,0,0,0,0,0,0,0,0
9658,785714,23,5,8,5,8,0,0,0,0,0,3,3,2,1,1,0,10
9658,775894,22,6,9,4,6,2,3,0,0,1,1,2,1,1,3,2,14
9658,785711,28,7,10,3,5,4,5,0,0,0,4,5,2,3,1,0,18
9658,780985,29,1,6,0,1,1,5,0,0,0,2,1,0,0,3,0,3
9658,775266,26,2,5,0,2,2,3,2,2,0,4,2,3,0,0,0,8
9658,796829,14,3,3,3,3,0,0,0,2,0,1,0,2,0,1,3,6
9658,791167,17,3,3,1,1,2,2,0,0,0,1,1,2,2,1,0,8
9658,785378,12,3,3,1,1,2,2,0,0,0,4,4,1,0,0,0,8
9658,779994,10,2,4,2,2,0,2,2,2,0,2,3,1,1,0,0,6
9658,791169,3,0,0,0,0,0,0,0,0,1,2,0,0,0,1,0,0
9658,796828,1,1,1,1,1,0,0,0,0,0,0,0,0,0,0,0,2
9658,796827,3,1,2,1,1,0,1,0,0,1,0,0,1,0,0,0,2
9658,796826,2,1,1,1,1,0,0,0,0,0,0,0,0,0,0,0,2
9658,785710,6,0,1,0,0,0,1,0,0,0,0,1,0,0,0,0,0
9658,780988,4,0,0,0,0,0,0,0,0,0,0,0,0,0,0,0,0
9659,785498,23,3,6,2,4,1,2,2,2,2,3,0,2,0,1,0,9
9659,776469,35,7,13,4,6,3,7,4,7,3,3,3,2,0,1,1,21
9659,796705,36,3,9,2,7,1,2,1,2,0,3,0,3,2,2,0,8
9659,796708,16,2,6,2,2,0,4,0,0,0,0,3,0,1,2,0,4
9659,776322,33,1,7,1,3,0,4,2,2,0,3,3,1,4,1,1,4
9659,781169,24,1,9,1,6,0,3,0,0,1,3,2,0,1,4,0,2
9659,796706,12,0,1,0,1,0,0,0,0,1,0,0,1,0,0,0,0
9659,780704,10,1,2,0,0,1,2,0,0,0,1,1,0,1,0,0,3
9659,791036,5,1,1,1,1,0,0,0,0,2,0,0,3,0,1,0,2
9659,791037,3,0,1,0,0,0,1,0,0,0,0,0,0,0,0,0,0
9659,780700,3,1,2,0,1,1,1,0,0,0,0,0,0,0,0,0,3
9660,776100,30,5,9,4,6,1,3,4,4,4,5,2,0,1,0,0,15
9660,785991,25,8,13,6,8,2,5,3,3,2,7,1,1,0,1,5,21
9660,797762,29,2,5,2,4,0,1,5,5,1,5,4,3,0,3,0,9
9660,781406,29,3,8,3,8,0,0,6,7,0,3,3,1,1,1,0,12
9660,781401,30,2,4,2,2,0,2,2,2,0,1,2,3,2,3,2,6
9660,797760,9,0,1,0,0,0,1,2,2,0,1,0,0,0,0,0,2
9660,792129,3,0,0,0,0,0,0,0,0,0,1,0,0,0,0,0,0
9660,792133,19,2,7,0,5,2,2,2,2,0,4,2,1,0,1,0,8
9660,781029,15,3,6,2,2,1,4,0,0,0,2,0,2,1,2,0,7
9660,775317,11,0,1,0,0,0,1,0,0,0,1,1,0,0,0,0,0
9660,797763,0,0,0,0,0,0,0,0,0,0,0,0,0,0,0,0,0
9660,792130,0,0,0,0,0,0,0,0,0,0,0,0,0,0,0,0,0
9660,785997,0,0,0,0,0,0,0,0,0,0,0,0,0,0,0,0,0
9661,781624,27,3,7,2,4,1,3,0,0,1,2,2,2,0,1,0,7
9661,792246,24,4,9,4,9,0,0,0,0,2,3,0,2,1,1,0,8
9661,797925,23,3,10,1,5,2,5,0,0,3,2,3,1,0,1,0,8
9661,781420,37,12,24,8,13,4,11,2,2,1,5,3,2,1,4,0,30
9661,781405,37,2,12,1,5,1,7,0,0,1,4,6,4,0,1,1,5
9661,781417,5,1,3,1,3,0,0,0,0,0,0,0,2,2,0,0,2
9661,780615,9,0,0,0,0,0,0,0,0,1,1,0,2,0,0,0,0
9661,791701,15,0,2,0,1,0,1,1,2,3,1,0,3,1,0,0,1
9661,792245,23,2,3,1,2,1,1,1,3,0,2,1,2,0,1,0,6
9661,797924,0,0,0,0,0,0,0,0,0,0,0,0,0,0,0,0,0
9662,790810,33,2,10,1,5,1,5,4,4,1,8,3,0,2,1,0,9
9662,796370,19,1,4,1,4,0,0,0,0,0,2,0,1,0,1,0,2
9662,790808,28,0,4,0,1,0,3,0,0,0,3,0,1,1,0,1,0
9662,785361,32,9,14,5,6,4,8,4,4,0,1,0,3,0,2,0,26
9662,779997,39,7,12,5,8,2,4,1,2,1,4,4,0,3,2,0,17
9662,790809,29,2,2,2,2,0,0,0,0,1,1,5,2,4,3,0,4
9662,774854,20,5,10,4,8,1,2,0,1,2,2,1,3,0,3,0,11
9663,779985,32,7,12,4,6,3,6,2,2,0,6,2,4,1,3,3,19
9663,790876,37,2,6,1,4,1,2,1,2,0,6,1,0,1,4,0,6
9663,785699,38,6,7,4,5,2,2,0,0,3,4,3,5,2,4,2,14
9663,781062,28,0,2,0,1,0,1,0,0,0,2,3,0,2,0,0,0
9663,774987,38,6,15,3,9,3,6,4,6,1,6,3,2,1,5,0,19
9663,790882,14,2,5,2,4,0,1,0,0,2,0,1,1,0,1,0,4
9663,785432,5,0,1,0,1,0,0,0,0,0,0,0,0,0,0,0,0
9663,790877,5,0,0,0,0,0,0,0,0,0,0,1,0,0,1,0,0
9663,790879,3,0,1,0,1,0,0,0,0,0,0,0,1,0,0,0,0
9664,796754,31,2,7,1,2,1,5,3,4,0,3,3,1,0,2,2,8
9664,796755,16,3,7,3,7,0,0,4,5,3,3,1,2,2,1,0,10
9664,791099,29,5,13,3,6,2,7,0,0,2,1,2,0,1,1,0,12
9664,785586,28,2,5,2,4,0,1,0,0,1,6,4,2,0,2,1,4
9664,780298,35,4,8,3,5,1,3,6,6,0,5,3,1,2,3,0,15
9664,780814,21,6,7,6,7,0,0,0,1,2,1,1,2,0,1,1,12
9664,785470,25,3,6,1,3,2,3,2,2,0,2,1,0,1,1,1,10
9664,790846,12,0,0,0,0,0,0,1,4,0,4,1,4,0,0,1,1
9664,780315,3,0,0,0,0,0,0,0,0,0,0,0,0,0,1,0,0
9665,785589,39,7,13,7,13,0,0,3,6,2,7,3,1,2,1,0,17
9665,791209,23,2,4,2,4,0,0,0,0,1,5,1,3,0,0,0,4
9665,791215,29,3,10,3,7,0,3,2,2,1,1,3,4,1,0,0,8
9665,791213,23,2,6,1,4,1,2,0,0,0,2,1,1,4,1,0,5
9665,791214,34,6,14,5,8,1,6,0,0,4,1,6,4,0,3,0,13
9665,791216,30,5,11,4,7,1,4,3,5,1,0,2,0,1,1,0,14
9665,791212,6,0,1,0,1,0,0,0,0,0,0,1,4,0,0,0,0
9665,776313,12,0,2,0,1,0,1,0,0,0,2,0,2,0,0,1,0
9665,796917,4,0,0,0,0,0,0,1,2,0,2,0,0,0,0,0,1
9666,792288,27,2,6,2,5,0,1,0,0,5,4,0,2,0,0,0,4
9666,785227,23,2,4,2,4,0,0,2,2,1,3,1,3,2,2,0,6
9666,786237,26,7,12,7,12,0,0,0,0,2,6,2,3,1,2,1,14
9666,780287,32,8,17,4,9,4,8,2,3,0,0,0,0,2,0,0,22
9666,776309,31,3,9,2,7,1,2,2,4,1,4,2,0,0,0,2,9
9666,798072,13,1,1,1,1,0,0,0,0,1,0,0,1,0,0,0,2
9666,798067,5,1,2,1,2,0,0,0,0,2,0,0,0,0,0,0,2
9666,798084,5,0,1,0,1,0,0,0,0,0,1,0,1,0,0,0,0
9666,792278,12,1,3,1,3,0,0,0,0,0,0,1,0,0,1,0,2
9666,786232,26,5,13,5,10,0,3,2,2,3,4,1,0,3,0,0,12
9667,791839,37,7,14,7,14,0,0,4,6,1,7,3,2,0,5,0,18
9667,797444,24,0,1,0,0,0,1,0,0,0,0,2,3,0,0,1,0
9667,792381,23,2,6,1,3,1,3,0,0,0,1,1,2,1,2,0,5
9667,791842,33,5,13,2,7,3,6,3,3,0,5,1,3,0,1,0,16
9667,786616,38,4,6,2,3,2,3,0,0,0,4,4,2,0,4,0,10
9667,785322,19,2,4,0,0,2,4,0,0,0,1,1,0,0,0,0,6
9667,786736,26,1,2,0,1,1,1,2,2,0,2,1,0,0,1,1,5
9668,791564,17,1,4,1,3,0,1,0,0,0,3,0,2,0,0,2,2
9668,775549,23,4,7,4,7,0,0,6,11,8,2,1,4,1,2,0,14
9668,797056,30,1,11,1,7,0,4,1,2,0,5,2,3,0,4,1,3
9668,791568,8,1,2,1,2,0,0,0,0,1,0,0,4,1,2,1,2
9668,797055,30,3,9,1,2,2,7,3,3,0,4,1,1,0,1,0,11
9668,797058,12,1,3,0,1,1,2,2,2,0,0,1,2,0,1,0,5
9668,791566,17,1,4,1,3,0,1,0,0,1,2,0,2,1,2,1,2
9668,797054,31,4,10,2,7,2,3,2,3,1,3,2,1,0,0,0,12
9668,786381,32,4,10,1,4,3,6,0,0,2,5,0,2,0,0,1,11
9669,790232,37,5,15,5,12,0,3,5,10,2,3,2,3,2,1,3,15
9669,780614,19,2,3,2,2,0,1,3,3,2,3,1,4,1,3,2,7
9669,780093,21,4,6,4,6,0,0,2,2,2,3,0,3,0,0,0,10
9669,789066,37,2,10,2,5,0,5,1,2,0,9,2,2,0,1,0,5
9669,776278,27,2,5,1,3,1,2,2,3,0,2,2,4,0,0,0,7
9669,780255,12,2,3,2,3,0,0,2,2,2,1,0,4,0,1,0,6
9669,792411,6,0,2,0,1,0,1,0,0,0,1,0,0,2,0,0,0
9669,786463,30,5,10,3,7,2,3,5,6,1,4,4,2,2,2,0,17
9669,785806,10,0,2,0,2,0,0,0,0,0,0,0,0,0,1,0,0
9669,786465,1,0,0,0,0,0,0,0,0,0,0,0,0,0,0,0,0
9670,776285,9,2,4,2,4,0,0,1,1,0,0,0,3,0,1,0,5
9670,791777,34,4,10,3,7,1,3,1,3,1,9,9,1,0,1,1,10
9670,781025,34,1,4,0,1,1,3,0,0,0,3,2,3,2,1,0,3
9670,786474,32,10,16,3,6,7,10,3,4,0,3,3,1,2,2,1,30
9670,775503,26,2,6,0,1,2,5,7,8,1,4,2,1,1,0,0,13
9670,791781,2,0,0,0,0,0,0,1,2,1,0,0,0,0,0,0,1
9670,791778,6,2,2,2,2,0,0,2,2,2,1,0,2,1,1,0,6
9670,786476,21,1,2,1,2,0,0,2,2,4,4,0,3,0,2,2,4
9670,797612,1,0,1,0,1,0,0,0,0,0,0,0,1,0,0,0,0
9670,791783,1,0,1,0,0,0,1,0,0,0,0,0,0,0,0,0,0
9670,791776,3,0,1,0,0,0,1,3,3,0,1,0,0,0,0,1,3
9670,791829,17,3,8,1,4,2,4,1,2,0,2,0,3,0,2,0,9
9670,780488,12,1,3,0,1,1,2,0,0,0,0,1,4,0,0,0,3
9670,791780,2,0,0,0,0,0,0,0,0,0,0,0,0,0,0,0,0
9671,781149,14,0,0,0,0,0,0,0,0,0,2,0,4,0,1,1,0
9671,792670,34,5,16,3,8,2,8,2,6,3,4,1,4,1,0,1,14
9671,789025,19,0,2,0,1,0,1,0,0,3,0,0,2,0,1,0,0
9671,782157,19,0,2,0,2,0,0,0,0,0,5,2,1,1,3,0,0
9671,774985,37,7,19,6,13,1,6,4,6,3,1,3,3,0,3,0,19
9671,786163,8,1,6,1,5,0,1,0,0,1,0,0,3,0,0,1,2
9671,792666,2,1,2,1,2,0,0,0,0,0,0,0,1,0,0,0,2
9671,780852,16,1,4,1,4,0,0,3,5,0,0,1,2,0,0,1,5
9671,786214,18,2,6,1,3,1,3,2,2,0,2,0,2,0,1,1,7
9671,798152,1,0,0,0,0,0,0,1,2,0,2,0,0,0,0,0,1
9671,792669,29,2,2,1,1,1,1,3,4,1,1,2,0,1,3,0,8
9671,775276,3,0,1,0,0,0,1,0,0,0,0,0,1,0,0,0,0
9672,781342,35,4,13,4,10,0,3,1,1,2,6,4,3,2,1,1,9
9672,781593,36,10,16,7,11,3,5,1,5,2,6,1,4,1,2,1,24
9672,790901,27,4,8,0,2,4,6,0,1,0,4,2,4,0,1,0,12
9672,785452,36,8,13,8,13,0,0,4,4,1,5,1,1,1,1,0,20
9672,781620,31,0,5,0,4,0,1,0,0,0,3,7,3,2,1,0,0
9672,796450,5,1,1,1,1,0,0,0,0,0,0,0,0,1,1,0,2
9672,774835,5,0,1,0,1,0,0,0,0,0,1,1,1,0,1,0,0
9672,790902,20,1,2,0,0,1,2,3,5,0,0,1,3,0,2,0,6
9672,796449,5,0,1,0,0,0,1,0,0,0,0,0,0,0,0,0,0
9673,790856,25,7,9,7,9,0,0,3,7,6,7,1,4,1,0,4,17
9673,780452,22,2,6,2,6,0,0,1,2,1,2,1,1,1,0,1,5
9673,796413,25,2,4,1,2,1,2,3,6,1,3,1,2,0,1,0,8
9673,796408,26,2,12,1,5,1,7,2,2,0,2,0,0,0,2,0,7
9673,796407,30,3,7,1,3,2,4,0,0,0,3,3,1,1,1,0,8
9673,796411,11,1,5,1,5,0,0,2,3,3,4,0,2,0,0,0,4
9673,790858,11,1,3,1,2,0,1,1,2,0,0,3,3,2,1,0,3
9673,796409,25,6,10,2,3,4,7,3,3,0,4,1,1,1,2,0,19
9673,780450,4,0,0,0,0,0,0,0,0,0,0,0,0,0,1,0,0
9673,796410,21,4,7,4,7,0,0,2,2,3,2,2,3,1,2,2,10
9674,790930,21,3,7,3,7,0,0,2,2,1,4,0,4,2,1,1,8
9674,780358,22,3,7,1,5,2,2,0,0,0,3,3,3,1,2,2,8
9674,775011,30,6,7,1,1,5,6,0,0,1,1,0,1,0,0,0,17
9674,780357,34,3,7,0,0,3,7,6,6,0,2,5,2,0,2,0,15
9674,775018,31,2,8,1,3,1,5,2,4,0,3,9,1,0,2,1,7
9674,776004,18,3,9,3,7,0,2,0,0,1,3,1,1,0,0,0,6
9674,796480,29,4,8,3,7,1,1,1,1,0,2,0,3,1,0,0,10
9674,776270,15,1,1,1,1,0,0,2,2,1,1,0,1,0,1,0,4
9675,781175,25,3,6,3,6,0,0,0,0,3,7,2,3,0,1,0,6
9675,786555,30,2,7,1,2,1,5,0,0,0,2,2,1,1,1,2,5
9675,786553,24,4,11,3,8,1,3,2,2,1,0,4,3,0,1,0,11
9675,780895,27,2,6,2,6,0,0,5,6,1,7,3,0,1,0,0,9
9675,781172,39,4,7,2,2,2,5,0,0,0,2,2,2,1,1,0,10
9675,792005,24,4,5,3,3,1,2,0,0,2,4,0,3,1,1,0,9
9675,781177,12,2,5,0,1,2,4,0,0,0,0,1,2,0,1,0,6
9675,785312,16,7,11,7,10,0,1,4,5,0,0,3,2,1,2,0,18
9675,797503,3,0,0,0,0,0,0,0,0,1,1,0,2,0,0,1,0
9676,781584,32,3,10,1,2,2,8,0,0,0,1,0,0,0,0,0,8
9676,786731,34,4,9,4,9,0,0,10,12,2,11,1,1,1,2,3,18
9676,798023,31,6,9,5,8,1,1,1,2,0,6,8,3,2,1,0,14
9676,781579,24,5,7,5,6,0,1,0,0,2,3,1,3,1,3,0,10
9676,780347,36,6,12,4,9,2,3,1,1,6,7,5,1,2,3,1,15
9676,798008,13,0,4,0,1,0,3,0,0,0,2,3,0,0,0,0,0
9676,775696,18,2,7,1,5,1,2,0,0,0,1,0,1,0,0,0,5
9676,798017,7,0,0,0,0,0,0,0,0,0,1,0,2,0,1,0,0
9676,776481,4,0,2,0,2,0,0,0,0,0,2,0,1,0,0,1,0
9676,792358,1,2,2,2,2,0,0,0,0,0,0,0,0,0,0,0,4
9677,791375,35,2,7,0,1,2,6,0,0,0,2,0,1,4,1,0,6
9677,780837,36,1,13,1,6,0,7,3,4,0,3,3,1,0,3,0,5
9677,785482,32,7,19,5,13,2,6,0,0,0,5,3,2,2,4,0,16
9677,796479,18,3,3,3,3,0,0,0,0,2,2,1,2,0,0,0,6
9677,781560,18,2,6,2,6,0,0,0,0,1,1,0,4,1,0,0,4
9677,786164,26,2,3,0,1,2,2,0,2,2,1,0,1,0,0,2,6
9677,796473,19,2,5,2,5,0,0,6,7,1,4,0,2,0,2,1,10
9677,796477,16,0,3,0,2,0,1,0,0,1,2,2,2,0,2,1,0
9678,786447,21,2,9,2,9,0,0,4,5,3,6,1,2,1,0,1,8
9678,775074,31,8,12,8,11,0,1,1,1,1,6,1,4,0,1,3,17
9678,786448,30,1,5,0,2,1,3,1,2,2,5,3,2,2,1,1,4
9678,780731,34,5,12,3,6,2,6,6,6,0,3,2,1,0,3,0,18
9678,780462,35,7,13,6,10,1,3,0,1,0,3,5,1,2,3,0,15
9678,791632,5,1,1,1,1,0,0,0,0,1,1,1,1,0,1,0,2
9678,786132,24,1,1,1,1,0,0,2,2,3,5,1,3,0,0,0,4
9678,796971,19,3,5,2,3,1,2,1,2,0,0,0,1,0,1,2,8
9678,791631,1,0,0,0,0,0,0,0,0,0,0,0,0,0,0,0,0
9679,790915,21,4,9,4,9,0,0,7,10,1,0,0,3,1,0,3,15
9679,790914,24,7,10,7,10,0,0,0,0,2,4,0,3,0,1,0,14
9679,780798,30,0,5,0,3,0,2,1,2,1,4,2,1,0,3,0,1
9679,785454,34,2,9,1,6,1,3,2,2,1,3,6,4,1,2,0,7
9679,785453,36,3,12,2,7,1,5,5,6,0,4,0,2,2,1,0,12
9679,800055,14,2,4,2,4,0,0,0,0,2,2,0,2,0,0,0,4
9679,790913,28,3,8,3,8,0,0,0,2,1,2,2,3,0,2,0,6
9679,790911,11,0,1,0,0,0,1,0,0,0,1,0,0,0,0,0,0
9679,785456,2,0,1,0,1,0,0,0,0,0,0,0,0,0,0,0,0
9680,791524,33,7,11,7,9,0,2,7,9,0,9,2,1,0,1,3,21
9680,797139,25,2,5,2,5,0,0,1,1,0,4,3,5,0,6,0,5
9680,775394,29,5,6,4,4,1,2,2,2,0,9,1,2,1,2,0,13
9680,780272,33,4,11,0,5,4,6,1,3,1,1,5,2,1,6,0,13
9680,775592,34,5,8,2,4,3,4,1,2,1,2,0,0,1,1,0,14
9680,786354,10,1,2,1,2,0,0,0,0,1,1,1,2,0,0,0,2
9680,791523,12,1,4,0,2,1,2,0,0,1,1,2,2,0,0,0,3
9680,780273,24,1,4,1,1,0,3,2,2,0,3,2,1,0,1,1,4
9681,775651,17,4,8,3,5,1,3,3,4,2,3,0,5,0,2,1,12
9681,791070,29,2,4,1,2,1,2,4,6,4,2,3,3,1,5,0,9
9681,791627,35,4,12,4,9,0,3,0,0,0,2,4,2,2,3,0,8
9681,785665,32,7,11,1,1,6,10,2,3,0,2,1,0,1,0,0,22
9681,776178,14,0,2,0,2,0,0,0,0,0,3,1,3,0,1,0,0
9681,796505,5,0,1,0,1,0,0,0,0,1,2,0,0,0,1,0,0
9681,791071,5,0,1,0,1,0,0,0,0,1,0,0,2,0,0,0,0
9681,785660,12,1,2,1,2,0,0,0,0,2,1,1,1,0,1,1,2
9681,776253,30,5,13,2,5,3,8,2,2,1,2,2,1,3,0,0,15
9681,796504,3,0,2,0,2,0,0,0,0,0,0,0,0,0,0,0,0
9681,796502,6,0,1,0,1,0,0,1,2,0,1,0,0,0,0,0,1
9681,796501,12,0,4,0,3,0,1,0,0,0,1,3,1,1,0,0,0
9682,786542,16,1,2,1,2,0,0,0,0,2,0,1,1,1,1,1,2
9682,786540,24,4,8,4,8,0,0,0,0,3,2,0,2,0,2,1,8
9682,792019,30,2,8,0,4,2,4,3,3,0,3,0,1,1,0,0,9
9682,792015,35,8,12,8,9,0,3,1,1,0,3,2,2,2,3,1,17
9682,775995,33,2,5,2,4,0,1,0,0,0,4,0,2,0,1,1,4
9682,792016,29,1,7,1,3,0,4,0,0,0,4,1,2,1,0,0,2
9682,791845,17,2,5,2,5,0,0,2,2,1,4,0,1,0,0,0,6
9682,785364,16,3,5,3,5,0,0,1,3,0,2,0,1,0,3,1,7
9683,791883,23,2,3,0,1,2,2,0,0,3,0,0,4,0,1,2,6
9683,781066,25,6,8,6,8,0,0,1,1,3,4,0,2,0,5,1,13
9683,797594,38,4,7,0,1,4,6,2,4,0,2,1,1,0,0,0,14
9683,791884,40,4,17,4,15,0,2,7,8,2,7,7,0,0,1,0,15
9683,780695,35,3,11,0,2,3,9,0,0,0,6,1,1,3,1,0,9
9683,797598,13,2,7,2,7,0,0,0,0,3,1,0,1,0,0,1,4
9683,797597,2,0,0,0,0,0,0,0,0,0,0,0,0,1,0,0,0
9683,786496,24,0,2,0,1,0,1,0,0,0,1,2,2,2,0,0,0
9684,781577,18,4,8,4,8,0,0,4,5,3,2,2,1,0,2,0,12
9684,780600,21,3,5,2,3,1,2,2,2,0,9,2,3,0,4,1,9
9684,775910,15,3,3,2,2,1,1,2,3,1,5,2,2,1,0,0,9
9684,781387,20,3,4,1,1,2,3,0,0,0,0,1,2,1,1,0,8
9684,786451,19,1,3,0,0,1,3,2,3,0,0,1,0,1,1,0,5
9684,791763,21,5,7,2,2,3,5,2,2,0,2,0,2,0,1,1,15
9684,780020,21,2,6,1,2,1,4,0,0,0,1,2,2,2,2,0,5
9684,797561,17,2,4,1,2,1,2,0,0,0,1,4,1,0,0,0,5
9684,790888,9,2,3,1,1,1,2,0,0,1,0,1,1,0,1,0,5
9684,786457,3,1,1,0,0,1,1,0,0,0,0,0,0,0,0,0,3
9684,800084,14,0,4,0,3,0,1,1,2,0,2,0,3,0,0,0,1
9684,786456,12,0,1,0,1,0,0,0,0,2,2,0,1,0,1,0,0
9684,780268,7,0,1,0,1,0,0,0,0,0,3,0,3,0,2,0,0
9684,793065,3,0,0,0,0,0,0,0,0,0,0,0,2,0,0,0,0
9685,786656,20,6,6,6,6,0,0,3,8,0,1,0,3,0,1,2,15
9685,781329,36,3,11,3,9,0,2,6,8,3,1,6,1,2,1,0,12
9685,786691,35,1,6,1,2,0,4,2,2,1,3,2,2,0,3,0,4
9685,781408,23,2,6,2,4,0,2,0,1,0,3,2,0,0,1,0,4
9685,786693,9,0,2,0,2,0,0,1,2,0,0,0,4,0,2,0,1
9685,792046,23,3,10,1,4,2,6,1,2,3,0,1,1,0,2,0,9
9685,781455,13,2,2,2,2,0,0,3,3,0,0,1,1,1,0,0,7
9685,792219,9,3,4,3,4,0,0,1,2,0,2,0,1,0,1,1,7
9685,792221,14,1,2,1,1,0,1,0,0,0,1,0,1,0,1,0,2
9685,792222,8,0,2,0,1,0,1,0,0,0,1,0,0,0,0,0,0
9685,797876,7,0,1,0,1,0,0,0,0,0,1,0,1,0,0,0,0
9685,776059,2,0,0,0,0,0,0,0,0,0,0,0,1,0,0,0,0
9685,792447,1,0,0,0,0,0,0,0,0,0,0,0,0,0,0,0,0
9686,791144,26,3,5,3,4,0,1,0,0,1,3,1,3,2,1,1,6
9686,785782,35,2,3,1,1,1,2,5,7,0,7,1,2,1,1,1,10
9686,791145,34,4,9,4,8,0,1,7,9,1,6,1,1,0,3,0,15
9686,791146,37,7,14,5,10,2,4,0,0,1,4,0,2,0,2,1,16
9686,785777,26,6,9,4,4,2,5,1,2,0,3,1,2,0,3,0,15
9686,791147,8,1,1,1,1,0,0,0,0,0,1,0,2,0,0,0,2
9686,796804,3,0,0,0,0,0,0,0,0,0,1,0,1,0,0,0,0
9686,791148,14,0,3,0,0,0,3,0,0,0,2,2,0,0,0,0,0
9686,786748,17,3,6,1,2,2,4,0,1,0,2,2,4,1,0,0,8
9687,791281,34,6,17,5,13,1,4,3,5,4,6,2,1,0,5,0,16
9687,792276,31,3,10,1,5,2,5,0,1,0,1,3,2,2,3,2,8
9687,791278,39,2,5,0,2,2,3,0,0,1,6,0,2,1,1,0,6
9687,786026,17,7,10,6,9,1,1,0,0,1,2,0,5,0,1,0,15
9687,785507,36,4,10,0,1,4,9,0,0,0,3,1,4,0,0,0,12
9687,785764,6,0,0,0,0,0,0,0,0,0,0,0,3,0,0,0,0
9687,796536,6,1,1,1,1,0,0,0,0,0,0,0,0,0,0,0,2
9687,796537,3,0,0,0,0,0,0,0,0,0,0,0,0,0,1,0,0
9687,796535,9,0,2,0,1,0,1,0,1,1,1,0,1,1,1,1,0
9687,785398,19,1,2,1,1,0,1,1,3,2,3,3,1,1,1,0,3
9688,791980,18,1,4,1,2,0,2,0,0,1,0,0,2,1,0,0,2
9688,785972,28,3,8,3,7,0,1,2,2,3,4,1,1,2,4,1,8
9688,785967,30,5,8,5,8,0,0,1,3,3,6,2,1,2,4,0,11
9688,791977,37,4,11,2,6,2,5,0,0,0,5,0,3,0,1,0,10
9688,791978,37,8,19,8,14,0,5,3,4,1,1,6,1,3,1,2,19
9688,780160,8,0,0,0,0,0,0,0,0,0,1,0,5,1,1,0,0
9688,791976,30,7,16,2,6,5,10,0,0,0,2,3,1,4,3,0,19
9688,797801,1,0,0,0,0,0,0,0,0,0,0,0,1,0,0,0,0
9688,785973,2,0,0,0,0,0,0,0,0,0,0,0,0,0,1,0,0
9688,797803,5,0,0,0,0,0,0,0,0,0,1,0,0,0,0,0,0
9688,797800,4,0,0,0,0,0,0,0,0,0,0,0,0,0,0,0,0
9689,796439,6,1,4,1,4,0,0,0,0,1,2,0,3,0,1,0,2
9689,790884,27,2,6,2,6,0,0,1,2,4,6,1,1,1,3,6,5
9689,791635,29,4,8,2,3,2,5,2,2,0,1,3,0,1,1,0,12
9689,790883,37,6,13,4,10,2,3,3,5,1,3,3,3,2,4,0,17
9689,796436,39,6,15,4,7,2,8,3,4,0,8,4,1,2,6,0,17
9689,785436,26,4,6,4,6,0,0,0,3,2,5,3,1,0,2,1,8
9689,796442,10,0,1,0,1,0,0,2,2,3,1,0,1,0,0,0,2
9689,796438,9,1,1,1,1,0,0,0,0,1,0,1,0,0,0,0,2
9689,790885,13,3,6,3,4,0,2,1,2,2,1,1,3,0,2,0,7
9689,781262,4,0,1,0,0,0,1,0,0,0,1,0,0,0,1,0,0
9690,785996,30,3,12,3,12,0,0,5,6,6,5,1,3,0,1,2,11
9690,785998,19,1,4,0,0,1,4,2,2,1,2,0,1,1,0,0,5
9690,785990,29,2,7,2,5,0,2,2,2,0,5,3,2,0,0,1,6
9690,780849,21,1,5,1,2,0,3,4,4,1,6,1,2,0,0,0,6
9690,780853,32,9,19,7,15,2,4,3,10,0,3,3,4,2,2,1,23
9690,786010,2,0,1,0,1,0,0,0,0,1,0,0,1,0,0,0,0
9690,792235,10,1,2,1,2,0,0,0,2,2,0,0,1,0,1,1,2
9690,797646,20,1,5,1,5,0,0,0,0,0,2,4,1,2,2,1,2
9690,792039,20,5,8,3,3,2,5,0,1,1,4,1,2,0,1,0,12
9690,780776,17,3,4,3,4,0,0,0,0,0,4,0,0,0,0,0,6
9691,796466,20,2,5,1,4,1,1,2,2,2,1,0,2,0,1,1,7
9691,785930,24,3,5,3,5,0,0,1,2,2,9,0,2,0,2,1,7
9691,780996,15,0,4,0,4,0,0,0,0,0,1,3,1,1,0,2,0
9691,796468,25,4,8,3,6,1,2,0,3,0,3,2,5,0,2,0,9
9691,791035,37,4,14,2,8,2,6,8,8,0,10,5,3,1,2,2,18
9691,790920,22,4,11,4,9,0,2,3,4,1,2,1,3,0,3,1,11
9691,780995,25,4,9,4,6,0,3,0,0,0,4,1,4,0,0,1,8
9691,786225,8,0,2,0,2,0,0,0,0,1,2,1,0,0,0,0,0
9691,775709,24,3,3,0,0,3,3,2,2,0,0,3,2,1,0,0,11
9692,791981,36,9,13,8,10,1,3,7,13,1,5,2,3,0,2,0,26
9692,786755,31,0,5,0,2,0,3,0,0,3,3,1,1,3,0,0,0
9692,780342,31,7,17,3,6,4,11,2,2,2,5,4,3,0,1,0,20
9692,791985,34,0,2,0,0,0,2,3,4,2,3,4,2,1,0,0,3
9692,781493,11,1,2,0,0,1,2,0,0,0,0,0,2,0,1,0,3
9692,791982,27,4,7,2,2,2,5,0,0,0,1,2,5,0,1,0,10
9692,791984,12,2,4,2,4,0,0,2,3,1,1,0,4,0,0,0,6
9692,786756,9,1,3,0,0,1,3,0,0,0,0,0,1,0,0,0,3
9692,791986,9,0,2,0,1,0,1,0,0,0,1,0,0,0,0,0,0
9693,786857,20,0,4,0,1,0,3,2,2,1,2,1,5,2,5,0,2
9693,781403,36,2,9,0,6,2,3,6,6,1,7,2,2,1,4,0,12
9693,792654,28,5,8,5,8,0,0,7,7,1,5,0,5,0,0,0,17
9693,797301,38,6,11,5,8,1,3,5,5,0,3,5,0,0,0,0,18
9693,780524,32,3,5,1,1,2,4,1,1,1,1,0,1,1,1,0,9
9693,781400,32,4,13,0,4,4,9,2,2,0,2,2,1,0,2,0,14
9693,792653,7,0,0,0,0,0,0,0,0,1,3,0,3,0,0,0,0
9693,797304,7,0,1,0,1,0,0,0,0,1,0,1,1,0,0,0,0
9694,786728,40,13,21,13,21,0,0,8,8,1,2,3,0,1,2,0,34
9694,780892,34,3,5,2,4,1,1,8,8,1,1,3,3,0,0,0,15
9694,785904,37,3,10,1,3,2,7,5,6,1,7,0,5,1,2,0,13
9694,786091,27,4,11,4,10,0,1,2,2,3,3,0,4,1,3,0,10
9694,775738,12,1,2,1,2,0,0,0,0,1,2,0,3,2,0,0,2
9694,797666,1,0,0,0,0,0,0,0,2,0,0,0,0,0,0,0,0
9694,781030,8,1,2,0,1,1,1,0,0,0,0,1,0,1,0,0,3
9694,786096,19,1,7,1,6,0,1,2,2,2,1,0,3,1,0,0,4
9694,786788,22,2,4,1,1,1,3,5,7,1,5,0,0,0,2,0,10
9695,785796,39,7,18,6,11,1,7,7,11,2,1,4,2,1,2,1,22
9695,797576,38,4,8,3,5,1,3,1,1,0,3,1,5,0,3,0,10
9695,786508,38,9,16,3,4,6,12,6,10,1,7,2,4,0,1,1,30
9695,786509,29,4,6,4,6,0,0,5,6,6,6,1,5,2,7,1,13
9695,797579,16,0,1,0,0,0,1,0,0,0,2,1,2,0,2,0,0
9695,786505,24,2,10,0,1,2,9,0,0,0,3,2,4,0,1,0,6
9695,786507,5,1,2,1,2,0,0,0,0,0,1,0,0,0,1,0,2
9695,797577,11,0,0,0,0,0,0,0,0,2,0,2,2,0,0,2,0
9696,786704,29,7,12,7,11,0,1,6,6,3,6,1,2,0,3,1,20
9696,785395,20,2,6,2,5,0,1,2,2,2,2,1,2,1,1,0,6
9696,775840,35,3,6,1,2,2,4,0,0,0,4,3,1,2,4,0,8
9696,775955,30,6,12,4,7,2,5,8,11,2,3,3,2,2,1,0,22
9696,775811,13,1,2,1,2,0,0,0,0,1,1,0,1,0,1,0,2
9696,786706,8,1,1,1,1,0,0,0,1,2,1,0,0,0,0,0,2
9696,775287,21,0,1,0,0,0,1,0,0,0,1,1,2,0,1,0,0
9696,786702,2,0,1,0,0,0,1,0,0,0,0,0,0,0,0,0,0
9696,790921,22,9,10,6,6,3,4,3,5,1,2,2,3,1,2,0,24
9696,786551,20,2,11,2,7,0,4,7,7,0,3,4,1,2,0,0,11
9697,774812,2,1,2,1,2,0,0,0,0,0,0,0,0,0,0,0,2
9697,797180,35,6,7,1,2,5,5,1,1,2,2,0,4,2,0,0,18
9697,791497,37,7,16,6,12,1,4,1,1,1,4,0,4,0,2,0,16
9697,780240,28,5,9,5,8,0,1,3,4,1,3,2,3,2,3,0,13
9697,780461,33,5,14,5,11,0,3,3,4,0,9,10,1,1,3,0,13
9697,791500,11,0,2,0,2,0,0,0,0,1,0,0,3,0,1,0,0
9697,791498,8,1,3,1,3,0,0,0,0,0,2,0,2,0,0,1,2
9697,790517,2,0,0,0,0,0,0,0,0,0,0,0,1,0,0,0,0
9697,791503,13,1,1,1,1,0,0,1,3,0,0,0,2,0,1,0,3
9697,776379,31,8,17,4,10,4,7,0,0,1,0,0,1,2,0,0,20
9698,780094,30,2,7,2,4,0,3,0,0,1,3,3,1,0,0,1,4
9698,775142,30,6,12,3,8,3,4,0,1,1,5,2,3,2,2,0,15
9698,790843,28,2,3,1,2,1,1,1,2,0,3,1,2,2,1,0,6
9698,786212,32,9,16,6,11,3,5,0,0,2,2,3,2,1,0,1,21
9698,785392,35,6,9,4,5,2,4,3,3,0,7,9,2,2,4,0,17
9698,790844,15,5,6,5,6,0,0,0,4,1,2,0,1,1,0,1,10
9698,781563,18,5,7,4,6,1,1,0,0,0,4,1,2,0,3,0,11
9698,792125,1,0,0,0,0,0,0,0,0,0,1,0,0,0,0,0,0
9698,799986,5,1,1,1,1,0,0,1,2,0,1,0,0,0,0,1,3
9698,796914,5,0,0,0,0,0,0,4,5,0,0,0,0,0,0,0,4
9698,790847,1,0,0,0,0,0,0,0,0,0,0,0,0,0,0,0,0
9699,780040,24,2,2,2,2,0,0,1,2,1,5,1,2,1,0,0,5
9699,790785,33,12,25,10,14,2,11,2,2,0,8,4,3,1,2,1,28
9699,781232,33,3,6,1,2,2,4,1,2,1,2,2,2,1,0,0,9
9699,780037,37,5,12,2,4,3,8,3,3,0,4,5,0,0,3,0,16
9699,796339,28,2,9,0,5,2,4,0,0,0,3,2,4,3,3,0,6
9699,796343,16,0,1,0,1,0,0,0,0,1,0,0,0,1,1,0,0
9699,790783,4,0,0,0,0,0,0,0,0,0,1,0,1,0,0,0,0
9699,780045,1,1,1,0,0,1,1,0,0,0,0,0,0,0,0,0,3
9699,792440,1,0,1,0,1,0,0,0,0,0,0,0,0,0,0,0,0
9699,790781,23,2,5,2,5,0,0,2,2,1,2,0,5,0,3,0,6
9700,796350,15,1,5,1,1,0,4,0,0,0,2,1,0,0,2,0,2
9700,785368,29,3,5,3,5,0,0,0,2,2,6,1,0,2,3,2,6
9700,780281,27,4,7,4,7,0,0,0,1,2,4,0,2,1,1,0,8
9700,790793,32,7,12,6,9,1,3,7,8,1,6,6,2,1,2,0,22
9700,785246,25,5,12,2,4,3,8,0,0,0,1,1,1,0,2,0,13
9700,796353,9,0,1,0,1,0,0,0,0,0,0,0,0,0,0,0,0
9700,796351,13,0,0,0,0,0,0,0,0,0,2,1,2,0,0,0,0
9700,790794,10,2,2,2,2,0,0,1,1,1,1,0,3,0,0,0,5
9700,780886,23,3,8,1,4,2,4,4,4,0,1,4,2,0,1,0,12
9700,790790,1,0,0,0,0,0,0,0,0,0,0,0,1,0,0,0,0
9700,790792,16,0,1,0,1,0,0,1,2,2,2,1,1,0,1,0,1
9701,776424,25,3,4,2,2,1,2,0,0,1,6,0,2,1,1,3,7
9701,792300,22,0,4,0,3,0,1,0,0,1,3,2,4,2,0,0,0
9701,792303,37,6,19,5,12,1,7,10,10,2,1,4,2,0,4,0,23
9701,781603,30,2,7,2,3,0,4,0,0,0,4,2,0,3,0,0,4
9701,780456,33,5,9,3,4,2,5,0,0,0,5,1,1,1,0,0,12
9701,786618,10,0,1,0,1,0,0,0,0,2,1,1,1,0,0,0,0
9701,797912,12,0,2,0,0,0,2,2,2,0,2,0,2,0,0,0,2
9701,797914,20,4,8,0,1,4,7,0,0,0,1,0,4,0,2,0,12
9701,790813,6,1,3,0,0,1,3,0,0,0,0,0,0,0,1,0,3
9701,797907,5,0,0,0,0,0,0,0,0,0,0,0,0,0,1,0,0
9702,786157,26,0,2,0,2,0,0,1,2,0,5,2,4,0,0,1,1
9702,780676,31,1,4,1,2,0,2,6,6,0,4,3,3,1,2,0,8
9702,791756,23,7,13,6,8,1,5,0,0,1,0,4,1,2,1,0,15
9702,780992,34,8,12,7,9,1,3,3,3,0,1,2,1,2,2,0,20
9702,780677,34,5,9,2,4,3,5,2,2,2,4,0,4,0,0,0,15
9702,797348,10,3,6,1,3,2,3,0,0,0,0,1,0,0,1,0,8
9702,791754,10,1,3,1,1,0,2,0,0,0,4,0,1,0,0,0,2
9702,780673,18,0,0,0,0,0,0,0,0,0,0,1,2,0,0,0,0
9702,775533,14,0,2,0,2,0,0,0,0,0,1,0,0,1,0,0,0
9703,797695,32,3,5,3,5,0,0,4,4,1,8,1,4,0,1,0,10
9703,797699,30,4,9,2,4,2,5,2,2,0,0,5,2,1,4,0,12
9703,797692,40,7,11,1,1,6,10,1,2,0,6,0,1,0,0,0,21
9703,791956,29,3,8,0,3,3,5,0,1,1,2,2,1,0,2,1,9
9703,780846,34,3,7,2,5,1,2,5,6,1,4,4,5,3,1,0,12
9703,791954,10,0,3,0,2,0,1,0,0,0,0,0,1,0,2,0,0
9703,797694,11,0,1,0,0,0,1,2,2,0,0,0,0,0,0,0,2
9703,780844,14,0,1,0,0,0,1,0,0,0,1,0,1,0,0,0,0
9704,799000,32,11,16,11,16,0,0,2,3,3,10,0,2,1,2,4,24
9704,785471,35,7,9,7,7,0,2,0,0,1,7,3,2,2,4,1,14
9704,780263,9,0,3,0,1,0,2,0,0,0,0,1,0,0,0,0,0
9704,786697,33,0,5,0,1,0,4,2,4,0,2,3,1,3,2,0,2
9704,775628,36,5,12,5,6,0,6,3,3,2,6,5,3,0,4,2,13
9704,792399,7,2,2,2,2,0,0,2,3,2,0,0,1,0,0,0,6
9704,775198,33,2,7,1,3,1,4,5,6,3,6,2,2,1,3,0,10
9704,775547,3,0,1,0,1,0,0,0,0,0,2,0,1,0,1,0,0
9704,780571,12,3,6,0,0,3,6,0,0,0,0,2,3,0,0,0,9
9705,796543,20,0,1,0,0,0,1,0,0,1,2,0,2,1,0,0,0
9705,790951,19,4,4,4,4,0,0,0,0,0,4,0,1,1,0,0,8
9705,796545,31,6,16,4,9,2,7,3,5,2,1,5,3,0,5,0,17
9705,786309,28,1,9,1,5,0,4,2,4,0,1,1,1,1,1,0,4
9705,776076,29,0,7,0,7,0,0,0,0,0,6,4,0,0,3,0,0
9705,796540,30,8,20,5,13,3,7,4,9,2,5,0,4,2,2,0,23
9705,796544,4,0,1,0,0,0,1,0,0,0,0,1,0,1,1,0,0
9705,798697,4,0,0,0,0,0,0,0,0,0,0,0,3,0,0,0,0
9705,796541,2,0,0,0,0,0,0,0,0,0,0,0,1,0,1,0,0
9705,790954,8,0,2,0,0,0,2,0,0,1,0,1,0,0,0,0,0
9705,786089,25,1,4,0,0,1,4,0,0,0,1,2,3,1,3,0,3
9706,785495,35,7,15,2,9,5,6,1,2,1,6,1,1,1,3,0,20
9706,785958,35,8,14,7,13,1,1,6,11,6,13,2,2,2,3,1,23
9706,785659,30,0,1,0,0,0,1,0,0,2,0,4,4,0,1,0,0
9706,785494,32,5,11,0,5,5,6,1,2,0,0,6,2,1,2,0,16
9706,780698,36,2,8,1,4,1,4,8,9,0,4,2,2,0,3,1,13
9706,785490,8,0,1,0,0,0,1,0,0,0,1,0,0,0,1,0,0
9706,775377,12,0,0,0,0,0,0,0,0,2,1,0,0,0,1,0,0
9706,780427,12,1,2,1,1,0,1,0,0,0,2,1,1,0,0,1,2
9707,780440,31,7,16,4,7,3,9,0,0,0,5,1,1,0,0,0,17
9707,775620,20,4,4,4,4,0,0,1,1,2,4,0,2,1,1,0,9
9707,791621,34,5,18,3,12,2,6,0,0,0,2,2,3,2,2,0,12
9707,786432,33,2,4,1,3,1,1,2,2,0,0,3,3,0,0,0,7
9707,786431,26,1,6,1,5,0,1,2,2,1,2,0,1,0,2,0,4
9707,786434,4,0,1,0,1,0,0,0,0,0,0,0,0,0,0,0,0
9707,781125,14,2,6,2,6,0,0,0,0,1,5,0,4,2,0,0,4
9707,796976,4,0,0,0,0,0,0,0,0,0,1,0,1,0,1,1,0
9707,781088,24,4,7,4,5,0,2,0,0,1,2,3,2,0,1,0,8
9707,775622,10,0,1,0,1,0,0,2,2,0,0,1,1,0,0,1,2
9708,792128,18,4,6,4,6,0,0,0,0,0,5,0,3,0,3,0,8
9708,786838,31,7,10,7,10,0,0,4,5,1,6,4,3,1,4,1,18
9708,792132,34,2,5,2,3,0,2,4,4,0,1,4,0,3,4,0,8
9708,792127,34,7,8,3,3,4,5,2,2,0,3,3,4,0,1,0,20
9708,792126,38,1,5,0,2,1,3,2,2,0,1,1,2,2,0,0,5
9708,799273,0,0,0,0,0,0,0,0,0,0,0,0,0,0,0,0,0
9708,792131,31,5,7,5,6,0,1,0,0,2,3,3,3,1,0,0,10
9708,799908,0,0,0,0,0,0,0,0,0,0,0,0,0,0,0,0,0
9708,797736,3,0,1,0,0,0,1,0,0,0,0,0,0,0,0,0,0
9708,797739,5,1,1,0,0,1,1,0,0,0,0,0,2,0,2,0,3
9708,791668,6,1,1,0,0,1,1,0,0,0,0,2,0,0,0,0,3
9709,786623,26,1,3,1,3,0,0,2,2,1,3,1,4,0,2,1,4
9709,797405,29,3,8,3,8,0,0,1,2,0,1,0,2,2,1,0,7
9709,791834,34,1,2,0,0,1,2,0,0,0,0,0,1,0,0,0,3
9709,791833,21,0,3,0,3,0,0,1,2,0,1,3,0,2,5,0,1
9709,785920,40,6,11,5,7,1,4,2,5,0,5,5,1,0,3,0,15
9709,786624,14,3,4,3,4,0,0,1,1,2,0,2,1,0,1,0,7
9709,797404,2,1,1,1,1,0,0,0,0,0,0,0,0,0,0,0,2
9709,785698,19,5,6,2,2,3,4,2,3,0,0,0,2,3,0,0,15
9709,784077,15,2,7,2,6,0,1,2,2,2,0,0,2,0,0,0,6
9710,781174,18,1,2,1,2,0,0,4,4,0,3,0,4,0,1,1,6
9710,785231,37,6,11,5,7,1,4,4,4,1,9,3,3,0,3,0,17
9710,781215,22,1,4,1,2,0,2,5,6,2,2,0,3,0,2,0,7
9710,779972,36,4,9,2,5,2,4,5,9,0,1,3,2,1,3,1,15
9710,775255,37,6,13,4,9,2,4,2,2,2,4,4,1,1,1,0,16
9710,796644,21,4,5,4,5,0,0,1,2,0,4,0,3,2,0,1,9
9710,791001,21,4,7,2,3,2,4,0,1,0,1,2,3,2,1,0,10
9710,785320,8,0,0,0,0,0,0,2,2,0,0,0,2,1,1,0,2
9711,797523,33,2,6,1,2,1,4,0,0,2,5,5,4,1,1,0,5
9711,785402,27,8,13,8,13,0,0,2,4,2,9,3,2,1,0,0,18
9711,797524,29,0,3,0,2,0,1,1,2,1,1,2,3,0,1,0,1
9711,792118,35,8,14,5,11,3,3,7,9,1,1,3,2,3,5,0,26
9711,782593,37,11,19,7,11,4,8,5,6,0,5,1,2,2,2,2,31
9711,785828,9,1,2,1,2,0,0,3,4,2,1,0,5,0,2,0,5
9711,791702,8,0,0,0,0,0,0,0,0,2,1,0,0,0,0,0,0
9711,791700,22,1,4,0,2,1,2,0,0,0,1,2,3,1,0,0,3
9712,781658,35,4,6,4,6,0,0,3,4,6,6,3,3,2,0,0,11
9712,781656,27,5,13,5,12,0,1,0,0,3,3,1,3,2,5,1,10
9712,796962,36,7,13,6,8,1,5,3,5,0,2,3,4,2,4,0,18
9712,786798,37,6,14,6,13,0,1,5,7,0,5,8,4,0,5,0,17
9712,780129,30,2,9,2,4,0,5,3,4,0,1,2,5,2,2,0,7
9712,798206,17,3,5,2,2,1,3,0,0,0,3,1,1,0,0,0,7
9712,791263,3,1,1,1,1,0,0,0,0,0,2,0,4,0,1,0,2
9712,796967,9,1,2,0,0,1,2,0,0,0,0,0,1,0,0,0,3
9712,796966,2,0,0,0,0,0,0,0,0,0,0,0,0,0,0,0,0
9712,791264,4,0,0,0,0,0,0,0,0,0,0,1,2,0,0,0,0
9713,788113,24,2,5,2,4,0,1,1,2,4,5,0,4,0,1,0,5
9713,776497,21,1,8,0,3,1,5,4,4,0,1,0,4,0,3,3,7
9713,785731,28,2,3,2,2,0,1,4,4,1,6,4,3,2,1,2,8
9713,785729,30,3,7,3,7,0,0,3,4,2,0,2,1,4,4,0,9
9713,780864,19,1,5,1,2,0,3,3,4,0,2,1,3,1,1,0,5
9713,799881,11,1,2,1,2,0,0,0,1,2,2,0,4,0,3,0,2
9713,792402,10,0,1,0,1,0,0,2,3,0,0,0,0,0,1,1,2
9713,796211,22,1,3,1,3,0,0,2,2,2,3,1,4,0,2,0,4
9713,797298,4,0,0,0,0,0,0,0,0,0,0,1,0,0,0,0,0
9713,786231,31,10,17,3,6,7,11,8,11,0,6,0,0,1,4,0,35
9714,791923,32,4,10,4,10,0,0,3,6,4,3,0,3,2,2,1,11
9714,781122,22,5,10,5,10,0,0,3,6,0,7,1,4,2,2,0,13
9714,791925,32,6,9,3,5,3,4,5,7,1,4,3,2,1,2,0,20
9714,786527,22,2,4,0,1,2,3,2,2,0,2,1,2,2,1,0,8
9714,781112,15,2,2,2,2,0,0,1,1,0,0,7,3,1,2,0,5
9714,786529,9,0,1,0,1,0,0,0,0,1,1,0,1,0,0,0,0
9714,797541,17,3,7,3,7,0,0,0,1,4,2,1,0,1,2,1,6
9714,797542,18,2,7,0,1,2,6,0,0,0,1,3,1,1,2,0,6
9714,791927,13,0,3,0,2,0,1,3,4,1,1,2,1,1,0,0,3
9714,786858,20,3,8,2,6,1,2,3,4,1,1,0,4,1,3,0,10
9715,797562,10,0,1,0,1,0,0,2,4,0,3,1,2,0,1,1,2
9715,791766,28,4,8,2,4,2,4,3,4,0,2,3,2,1,1,0,13
9715,786230,31,4,7,3,6,1,1,3,4,1,1,3,2,1,3,0,12
9715,780604,39,1,4,1,3,0,1,8,8,1,6,2,3,0,3,0,10
9715,780602,37,10,18,10,17,0,1,7,8,1,3,4,4,4,4,0,27
9715,791768,21,2,4,1,3,1,1,0,0,0,2,2,3,1,2,1,5
9715,786460,16,0,0,0,0,0,0,0,0,0,3,1,2,1,0,1,0
9715,791767,14,2,5,1,3,1,2,5,8,1,3,0,3,3,2,1,10
9715,780603,4,0,1,0,0,0,1,0,0,1,1,0,0,0,0,0,0
9716,790935,28,4,4,4,4,0,0,1,1,3,3,1,4,0,2,0,9
9716,792442,25,1,1,1,1,0,0,0,0,3,6,2,4,0,1,1,2
9716,790938,31,1,5,1,5,0,0,2,5,0,3,0,1,0,0,0,4
9716,780933,34,3,7,0,2,3,5,3,5,1,3,0,1,0,0,0,12
9716,775340,38,10,26,8,17,2,9,9,10,1,2,4,1,0,2,0,31
9716,796491,12,3,6,1,2,2,4,0,0,0,5,0,1,0,0,0,8
9716,796190,11,0,1,0,0,0,1,0,0,0,1,0,0,0,0,0,0
9716,790937,15,3,5,3,5,0,0,2,3,1,4,0,3,0,0,2,8
9716,796492,6,0,3,0,1,0,2,0,0,0,1,0,0,1,1,0,0
9717,780291,35,11,18,10,16,1,2,3,5,2,1,0,4,0,0,2,26
9717,785607,10,2,3,2,3,0,0,1,1,2,1,0,2,0,0,0,5
9717,796665,25,2,10,2,4,0,6,0,1,2,3,1,2,1,0,0,4
9717,785333,15,0,4,0,3,0,1,0,0,0,0,0,3,0,1,0,0
9717,775305,30,2,6,2,3,0,3,0,0,1,4,2,2,0,0,0,4
9717,796663,3,0,1,0,1,0,0,0,0,1,1,0,2,0,0,0,0
9717,791004,25,3,10,2,4,1,6,2,2,0,4,1,0,1,0,0,9
9717,791006,26,4,7,3,4,1,3,3,3,2,6,0,1,1,0,0,12
9717,796666,11,1,1,1,1,0,0,1,2,1,2,1,1,0,0,0,3
9717,796664,19,2,8,2,6,0,2,0,0,1,0,1,3,0,1,0,4
9717,791005,1,0,0,0,0,0,0,0,0,0,1,0,0,0,0,0,0
9718,780634,30,4,8,4,8,0,0,2,2,7,6,1,3,1,1,3,10
9718,791826,31,4,12,2,6,2,6,0,0,1,4,2,0,0,0,0,10
9718,786785,33,4,11,2,5,2,6,3,5,1,10,0,1,0,1,0,13
9718,780633,35,3,9,2,3,1,6,0,0,0,2,7,4,2,1,0,7
9718,776009,37,5,13,4,9,1,4,2,2,0,0,5,1,0,4,0,13
9718,797389,10,1,2,1,2,0,0,0,0,0,3,0,4,1,0,1,2
9718,786783,19,3,4,3,4,0,0,0,0,1,3,1,1,0,2,0,6
9718,786784,5,0,1,0,0,0,1,0,0,0,0,0,4,0,1,0,0
9719,791401,36,8,14,8,14,0,0,3,7,4,5,1,3,0,0,2,19
9719,786837,24,3,6,2,3,1,3,0,2,2,1,3,2,0,2,1,7
9719,780125,21,2,8,2,8,0,0,0,0,2,3,1,2,2,2,1,4
9719,785931,34,2,6,2,4,0,2,1,4,0,4,7,2,2,1,0,5
9719,780118,29,3,8,2,4,1,4,2,2,0,4,1,3,0,2,0,9
9719,791400,30,3,10,3,5,0,5,0,0,1,1,1,1,0,1,0,6
9719,797126,10,0,2,0,2,0,0,0,0,0,1,0,1,2,1,0,0
9719,797125,16,0,2,0,0,0,2,0,0,0,1,0,0,0,0,0,0
9720,790863,31,6,8,4,5,2,3,2,4,3,4,4,1,0,0,0,16
9720,780021,28,3,8,3,8,0,0,4,4,4,2,2,2,0,3,3,10
9720,785412,29,4,12,1,5,3,7,6,7,1,4,2,1,3,3,0,17
9720,780099,21,2,4,2,3,0,1,0,2,1,2,0,3,1,0,0,4
9720,776214,38,6,14,4,9,2,5,2,2,1,7,2,2,3,2,0,16
9720,775686,20,0,3,0,1,0,2,0,0,1,5,1,2,0,0,0,0
9720,785411,5,0,1,0,0,0,1,0,0,0,0,0,0,0,1,0,0
9720,776221,11,1,3,1,2,0,1,0,0,0,2,2,2,1,2,1,2
9720,785413,17,4,7,4,7,0,0,0,0,1,1,0,3,0,1,0,8
9721,791302,32,6,12,5,10,1,2,0,1,4,6,0,3,2,1,2,13
9721,781622,30,3,6,1,1,2,5,0,0,0,1,0,3,0,0,0,8
9721,791309,36,6,13,6,12,0,1,2,2,0,3,13,2,3,5,0,14
9721,785835,19,3,5,2,3,1,2,0,0,1,3,0,0,0,0,1,7
9721,776334,36,2,9,0,7,2,2,3,4,0,1,1,3,0,3,0,9
9721,775862,12,1,2,1,2,0,0,0,0,2,2,0,2,0,0,0,2
9721,796601,23,3,8,2,5,1,3,5,8,0,3,0,3,0,2,0,12
9721,791304,7,0,3,0,3,0,0,0,0,1,2,1,1,0,0,0,0
9721,791301,5,2,2,1,1,1,1,0,0,0,0,0,1,1,1,0,5
9724,774806,29,6,11,6,10,0,1,5,6,2,9,1,3,1,4,4,17
9724,775823,19,2,5,1,4,1,1,2,6,0,3,1,5,2,0,0,7
9724,791041,35,4,10,1,2,3,8,0,0,2,3,0,2,0,1,0,11
9724,791038,37,6,12,6,10,0,2,3,3,0,7,3,3,0,2,0,15
9724,789023,37,2,10,1,5,1,5,2,2,0,0,2,2,1,4,0,7
9724,796716,5,0,0,0,0,0,0,0,0,0,1,1,0,0,0,0,0
9724,796714,9,0,1,0,1,0,0,0,0,0,1,0,0,0,1,0,0
9724,796712,3,1,1,0,0,1,1,0,0,0,0,0,0,0,0,0,3
9724,775205,22,0,1,0,0,0,1,6,6,0,2,2,3,0,3,0,6
9724,796711,2,0,0,0,0,0,0,0,0,0,0,0,0,0,0,0,0
9724,791346,2,0,0,0,0,0,0,0,0,0,0,0,0,0,0,0,0
9725,797325,34,5,9,5,9,0,0,0,0,4,10,2,3,1,1,0,10
9725,797329,22,2,4,1,1,1,3,0,0,2,2,0,5,0,0,0,5
9725,797327,40,10,17,6,12,4,5,3,4,0,3,1,1,1,0,0,27
9725,797323,38,8,19,5,10,3,9,7,8,0,3,4,2,1,5,0,26
9725,786236,39,4,11,1,5,3,6,1,1,0,3,0,4,0,1,0,12
9725,786244,2,0,0,0,0,0,0,0,0,0,1,0,0,0,0,0,0
9725,781002,6,0,1,0,1,0,0,0,0,0,1,0,0,2,0,1,0
9725,776478,2,0,0,0,0,0,0,0,0,0,0,0,1,0,0,0,0
9725,786233,13,1,1,1,1,0,0,1,2,0,2,0,5,3,1,0,3
9725,786246,1,0,0,0,0,0,0,0,0,0,0,0,0,0,0,0,0
9725,797324,3,0,0,0,0,0,0,0,0,0,0,0,0,0,0,0,0
9728,775260,44,5,13,4,8,1,5,2,2,0,3,3,1,3,1,0,13
9728,786732,26,6,10,5,6,1,4,1,2,1,4,1,5,0,3,0,14
9728,786615,43,3,7,2,5,1,2,6,8,1,5,3,3,0,1,0,13
9728,790893,47,2,4,0,2,2,2,5,6,1,6,0,4,0,1,1,11
9728,796444,37,7,14,6,13,1,1,11,14,3,6,2,2,0,1,5,26
9728,775536,16,1,1,1,1,0,0,0,0,0,4,0,4,0,2,0,2
9728,790889,7,1,1,1,1,0,0,0,0,0,2,0,2,0,1,0,2
9728,790890,30,3,8,3,5,0,3,4,7,0,3,1,3,0,1,0,10
9729,798060,27,1,4,1,1,0,3,6,8,0,4,2,3,1,2,1,8
9729,786723,48,6,17,5,15,1,2,7,7,4,9,3,5,1,0,0,20
9729,792351,36,1,4,1,3,0,1,8,10,0,4,1,5,0,5,0,10
9729,786724,25,3,4,2,2,1,2,0,0,0,3,0,5,0,0,0,7
9729,792349,32,3,9,3,7,0,2,0,0,1,2,0,4,0,1,0,6
9729,792355,45,6,15,4,9,2,6,2,3,0,5,2,2,0,2,0,16
9729,798061,29,7,10,5,7,2,3,2,2,0,2,1,5,0,2,1,18
9729,792348,7,0,1,0,0,0,1,0,0,0,0,0,1,0,0,0,0
9729,792347,1,0,0,0,0,0,0,0,0,0,0,0,1,0,0,0,0
9730,797367,32,3,7,3,7,0,0,0,0,4,6,2,5,1,4,2,6
9730,797369,30,2,7,1,4,1,3,0,0,2,1,6,3,1,3,0,5
9730,797366,28,3,4,3,4,0,0,0,0,5,3,2,2,0,1,0,6
9730,791807,36,2,7,0,2,2,5,2,2,1,4,1,1,1,1,1,8
9730,786130,37,12,21,7,11,5,10,1,3,1,7,3,1,1,4,0,30
9730,797371,8,1,2,1,2,0,0,0,0,0,2,0,0,0,0,1,2
9730,797365,6,2,3,1,1,1,2,0,0,0,0,0,0,0,1,0,5
9730,797363,19,3,10,2,8,1,2,0,0,0,1,1,0,1,1,0,7
9730,797364,4,0,0,0,0,0,0,0,0,0,0,0,0,0,0,0,0
9731,780201,32,3,8,3,8,0,0,2,3,1,1,1,2,1,4,1,8
9731,791469,26,3,5,3,5,0,0,0,2,1,5,1,1,0,0,2,6
9731,797210,37,6,11,5,10,1,1,2,3,0,3,3,2,2,2,0,15
9731,786311,37,5,11,2,5,3,6,4,4,0,4,1,1,1,0,0,17
9731,775516,23,0,2,0,2,0,0,0,0,0,0,4,3,1,2,0,0
9731,798344,19,5,6,4,5,1,1,0,0,1,2,1,0,0,1,1,11
9731,791467,26,5,10,2,4,3,6,0,0,1,3,1,3,2,2,0,13
9732,796812,16,6,9,6,9,0,0,2,4,2,1,0,3,1,1,1,14
9732,780952,24,2,8,2,5,0,3,1,2,4,4,3,0,1,1,4,5
9732,791155,20,4,11,4,7,0,4,2,2,1,4,5,1,1,0,0,10
9732,786609,28,4,11,3,7,1,4,5,7,4,6,0,0,0,0,1,14
9732,796810,23,5,10,2,5,3,5,1,1,1,0,8,1,1,1,0,14
9732,780945,11,2,4,2,4,0,0,0,0,0,1,0,3,2,1,0,4
9732,796814,15,3,4,3,4,0,0,0,0,1,2,3,4,1,2,0,6
9732,780950,19,3,7,1,2,2,5,1,1,3,2,0,3,0,0,2,9
9732,791156,23,2,5,1,2,1,3,2,2,1,1,0,1,1,1,0,7
9732,785752,10,1,4,1,2,0,2,4,4,0,2,1,0,0,0,0,6
9732,791158,8,1,2,1,1,0,1,0,0,1,1,0,1,0,0,0,2
9732,796811,3,1,1,0,0,1,1,0,0,0,0,0,0,0,0,0,3
9733,791194,25,1,6,1,5,0,1,2,3,3,2,2,4,0,2,0,4
9733,780384,25,2,5,2,5,0,0,0,1,1,3,1,4,1,2,2,4
9733,786738,28,6,12,5,11,1,1,6,7,1,3,1,4,1,4,0,19
9733,775694,24,4,8,2,5,2,3,0,0,0,2,1,2,1,3,0,10
9733,774827,29,3,9,3,7,0,2,2,3,0,6,2,3,0,2,0,8
9733,800119,12,0,4,0,4,0,0,0,0,2,2,0,2,0,1,0,0
9733,791193,10,1,2,1,2,0,0,2,2,1,0,0,2,0,0,0,4
9733,780159,6,0,1,0,1,0,0,0,0,0,0,0,0,0,0,0,0
9733,796865,6,1,3,1,1,0,2,0,0,0,0,0,0,0,0,0,2
9733,796863,19,3,6,2,4,1,2,0,0,0,0,1,2,0,0,0,7
9733,799890,14,0,1,0,1,0,0,2,2,1,0,0,0,0,1,0,2
9733,791189,1,0,0,0,0,0,0,0,0,0,0,0,0,0,0,0,0
9733,796866,1,0,0,0,0,0,0,0,0,0,0,0,0,0,0,0,0
9734,792632,33,6,7,6,7,0,0,0,0,6,5,3,4,5,4,2,12
9734,792629,41,3,6,2,3,1,3,7,8,0,4,1,2,3,2,0,14
9734,792631,21,1,6,1,3,0,3,0,0,1,0,0,2,1,3,0,2
9734,781491,35,5,10,3,6,2,4,0,0,2,3,2,5,1,1,0,12
9734,780250,41,8,15,4,6,4,9,6,14,1,7,2,4,0,5,3,26
9734,796637,6,0,0,0,0,0,0,0,0,0,1,0,1,0,0,0,0
9734,796634,10,1,1,1,1,0,0,0,0,1,1,0,1,0,1,0,2
9734,796642,2,0,0,0,0,0,0,0,0,0,0,0,0,0,1,0,0
9734,792626,30,2,7,2,6,0,1,0,0,1,1,4,1,0,3,0,4
9734,792627,6,0,2,0,2,0,0,0,0,0,0,0,1,0,0,0,0
9735,792067,44,4,8,3,6,1,2,5,8,4,7,2,2,3,3,0,14
9735,792062,15,1,2,1,2,0,0,2,4,2,0,0,1,0,0,0,4
9735,797649,41,2,10,1,5,1,5,6,6,1,6,1,3,5,2,0,11
9735,792058,24,1,5,1,5,0,0,1,5,3,0,1,2,1,1,0,3
9735,789053,42,3,8,2,4,1,4,0,0,0,0,5,3,0,4,0,7
9735,786836,4,0,1,0,1,0,0,0,0,0,1,0,0,0,1,0,0
9735,775523,28,8,12,8,9,0,3,4,5,3,4,0,2,1,2,0,20
9735,789029,25,2,9,0,3,2,6,2,2,0,3,1,3,2,4,0,8
9735,790779,2,0,0,0,0,0,0,0,0,0,0,0,0,0,0,0,0
9736,796469,13,1,1,1,1,0,0,0,0,2,4,0,1,1,5,0,2
9736,779981,29,5,6,5,6,0,0,0,0,2,9,0,4,2,3,4,10
9736,785463,18,0,5,0,2,0,3,0,0,1,0,1,2,0,2,0,0
9736,779978,39,7,16,5,10,2,6,3,4,1,2,6,1,2,5,0,19
9736,790923,27,4,6,3,5,1,1,1,2,5,2,0,2,0,0,2,10
9736,779979,24,5,9,0,0,5,9,0,0,1,0,1,1,0,0,1,15
9736,776003,33,3,11,0,5,3,6,2,2,0,2,4,4,1,3,0,11
9736,785466,12,0,1,0,0,0,1,0,0,1,1,1,1,1,2,0,0
9736,779980,5,0,0,0,0,0,0,0,0,0,1,0,2,0,0,0,0
9737,780323,27,4,9,4,9,0,0,2,2,7,2,4,3,1,2,0,10
9737,792233,34,5,13,1,6,4,7,4,6,2,2,2,1,2,1,1,18
9737,792229,35,5,13,5,12,0,1,1,2,1,3,1,2,6,4,1,11
9737,785954,38,2,11,1,4,1,7,2,3,1,3,1,3,2,1,0,7
9737,785811,25,3,8,3,7,0,1,1,3,1,2,0,2,0,4,0,7
9737,797894,21,2,3,2,3,0,0,2,2,3,0,4,0,2,1,0,6
9737,792230,7,1,1,0,0,1,1,0,2,0,2,1,0,0,0,0,3
9737,792234,12,2,2,2,2,0,0,0,0,1,2,0,1,0,0,0,4
9737,797891,1,0,0,0,0,0,0,0,0,0,0,0,0,0,0,0,0
9738,783072,28,5,9,3,5,2,4,6,8,1,3,0,1,0,1,1,18
9738,781463,26,3,7,3,6,0,1,0,0,0,4,1,0,0,3,0,6
9738,791540,38,8,16,6,10,2,6,0,0,1,3,2,3,4,1,0,18
9738,787782,33,3,8,2,3,1,5,0,0,1,0,1,2,2,1,0,7
9738,776068,31,2,9,1,3,1,6,5,7,0,4,2,4,1,3,0,10
9738,797817,22,3,7,3,7,0,0,7,7,1,5,3,1,3,3,0,13
9738,774879,3,0,1,0,1,0,0,0,0,1,0,0,0,0,0,0,0
9738,792153,19,1,1,0,0,1,1,0,0,0,0,0,2,0,0,0,3
9739,797281,25,4,8,3,7,1,1,1,1,0,7,2,5,2,3,0,10
9739,791648,22,3,4,3,4,0,0,1,2,0,3,1,1,0,0,1,7
9739,785694,23,8,10,8,10,0,0,0,0,3,4,0,4,0,2,3,16
9739,797280,28,3,5,2,3,1,2,0,1,0,2,2,4,0,1,0,7
9739,797279,37,8,12,4,5,4,7,3,4,1,0,2,2,3,4,0,23
9739,791647,2,1,1,1,1,0,0,0,0,0,0,0,0,0,0,0,2
9739,791649,20,1,5,1,2,0,3,3,3,0,2,0,0,2,3,0,5
9739,786640,26,4,5,4,5,0,0,2,3,0,3,5,0,0,3,0,10
9739,785697,17,0,2,0,1,0,1,0,0,0,1,2,2,1,3,2,0
9740,776344,26,2,9,2,7,0,2,0,1,1,4,1,4,2,2,1,4
9740,775821,29,6,13,5,9,1,4,0,0,3,4,2,1,1,1,0,13
9740,792453,34,5,15,5,13,0,2,0,0,1,4,5,2,0,2,0,10
9740,785131,22,3,4,1,1,2,3,0,0,0,4,2,3,0,1,0,8
9740,781538,32,4,9,2,3,2,6,4,4,0,4,1,1,6,0,0,14
9740,798113,4,0,1,0,1,0,0,0,0,0,0,0,1,0,0,0,0
9740,785152,9,0,0,0,0,0,0,1,2,0,1,0,3,0,0,0,1
9740,798115,19,2,5,0,1,2,4,0,0,0,1,0,0,0,1,1,6
9740,792324,11,0,0,0,0,0,0,0,0,1,2,0,1,0,1,0,0
9740,776233,14,2,5,0,2,2,3,0,0,0,1,0,0,1,0,0,6
9741,791760,20,2,7,1,4,1,3,0,0,1,2,1,1,0,3,0,5
9741,780256,33,3,8,1,4,2,4,0,0,2,6,0,3,0,3,0,8
9741,796879,26,3,6,2,4,1,2,2,2,1,2,3,2,0,0,0,9
9741,796880,35,5,11,4,6,1,5,1,2,1,4,3,3,3,2,0,12
9741,791334,28,0,6,0,3,0,3,4,4,0,4,0,1,0,1,0,4
9741,785874,20,5,6,5,5,0,1,0,0,0,2,0,2,0,1,1,10
9741,796883,15,0,3,0,3,0,0,1,2,1,1,3,0,1,1,0,1
9741,791757,16,1,3,1,1,0,2,0,0,1,1,0,0,0,2,0,2
9741,781590,7,0,2,0,2,0,0,1,2,0,2,0,0,0,0,1,1
9742,780914,27,2,7,1,4,1,3,4,5,0,1,1,3,0,0,0,9
9742,785803,31,1,3,1,2,0,1,2,2,1,2,1,1,0,0,0,4
9742,780920,34,4,14,4,12,0,2,2,2,0,4,3,1,1,2,0,10
9742,780919,26,5,7,5,6,0,1,5,7,2,3,1,1,1,2,1,15
9742,775640,15,3,4,2,3,1,1,2,2,0,3,0,4,2,1,1,9
9742,791142,17,0,2,0,0,0,2,0,0,2,2,1,1,0,0,0,0
9742,796797,17,3,5,2,4,1,1,1,3,3,3,1,2,1,1,0,8
9742,775816,21,2,7,2,5,0,2,2,2,0,2,0,3,1,0,0,6
9742,791141,6,0,3,0,2,0,1,0,0,0,1,0,0,1,1,0,0
9742,796799,6,0,0,0,0,0,0,0,0,0,1,0,1,1,1,0,0
9743,791055,31,2,3,2,2,0,1,3,6,0,1,4,5,0,1,0,7
9743,785530,29,3,11,2,5,1,6,3,3,0,5,0,5,0,3,0,10
9743,780063,35,4,10,1,4,3,6,0,0,0,6,2,1,0,2,0,11
9743,785532,10,2,2,2,2,0,0,0,0,1,1,0,3,0,1,0,4
9743,791058,17,0,0,0,0,0,0,2,2,1,4,0,2,0,1,0,2
9743,796734,25,2,6,0,1,2,5,3,3,1,1,0,2,0,2,0,9
9743,775926,24,2,5,1,2,1,3,0,0,0,2,1,0,0,2,0,5
9743,796733,2,0,0,0,0,0,0,0,0,1,0,0,0,1,0,0,0
9743,775573,9,0,7,0,3,0,4,0,0,0,0,0,1,0,0,0,0
9743,791057,8,0,0,0,0,0,0,1,3,0,0,0,1,0,1,1,1
9743,791059,10,3,3,3,3,0,0,3,3,1,0,0,3,0,0,1,9
9744,780012,15,0,5,0,1,0,4,0,0,1,3,2,1,0,0,0,0
9744,796309,23,3,5,3,5,0,0,0,0,1,4,1,3,1,4,1,6
9744,790824,39,7,12,5,7,2,5,0,0,0,4,2,2,1,1,0,16
9744,780011,36,6,13,2,5,4,8,0,0,1,3,1,0,2,0,0,16
9744,775667,37,6,14,4,12,2,2,4,4,2,3,15,0,2,0,0,18
9744,774895,12,2,2,2,2,0,0,2,2,4,4,0,1,0,0,0,6
9744,781524,28,4,6,2,3,2,3,0,0,0,1,0,1,0,1,0,10
9744,785370,10,3,3,3,3,0,0,1,1,0,0,0,0,0,0,0,7
9745,791585,30,3,7,2,3,1,4,0,0,0,1,4,0,0,1,1,7
9745,791581,27,0,3,0,2,0,1,0,0,1,1,2,1,0,0,0,0
9745,786395,38,7,15,4,7,3,8,2,4,1,4,1,0,0,2,0,19
9745,786394,39,5,15,4,7,1,8,0,0,1,6,5,1,0,1,0,11
9745,780404,27,7,9,7,8,0,1,2,2,1,5,3,4,1,5,0,16
9745,780062,13,1,1,1,1,0,0,2,2,0,0,0,1,0,0,1,4
9745,785228,21,3,4,0,0,3,4,0,0,0,1,1,3,0,0,0,9
9745,780403,5,0,0,0,0,0,0,0,0,0,0,0,0,0,0,0,0
9746,776110,13,0,1,0,0,0,1,0,0,0,0,1,1,0,0,1,0
9746,780059,17,3,6,3,5,0,1,2,2,5,2,7,1,3,0,2,8
9746,796494,19,3,5,1,1,2,4,0,0,1,3,0,1,0,1,1,8
9746,790944,18,5,12,2,6,3,6,0,0,0,1,1,2,1,1,0,13
9746,780061,19,3,7,0,0,3,7,0,0,0,4,2,0,3,0,0,9
9746,780058,10,0,5,0,2,0,3,0,0,2,0,2,1,0,0,0,0
9746,796496,20,2,6,1,2,1,4,1,1,1,6,0,1,0,0,0,6
9746,786754,22,6,8,4,4,2,4,0,0,0,0,3,1,1,2,0,14
9746,790941,14,4,4,4,4,0,0,3,3,1,1,0,4,0,1,1,11
9746,790943,14,3,4,2,2,1,2,0,0,0,1,2,1,1,2,0,7
9746,796495,16,1,4,0,1,1,3,2,2,1,2,2,0,1,2,2,5
9746,796497,7,1,2,1,2,0,0,0,0,0,0,0,0,0,0,0,2
9746,796499,5,0,1,0,0,0,1,0,0,0,0,0,1,0,0,0,0
9746,785097,3,1,1,1,1,0,0,0,0,0,0,0,1,1,0,0,2
9746,788853,3,0,0,0,0,0,0,0,0,0,1,0,1,0,0,0,0
9747,796401,22,1,3,1,2,0,1,0,0,1,1,1,1,0,1,0,2
9747,785999,31,4,6,4,6,0,0,5,7,4,2,1,3,0,3,0,13
9747,775654,26,2,4,2,4,0,0,2,2,5,6,0,1,0,1,5,6
9747,791639,33,7,18,6,13,1,5,3,5,1,1,0,1,1,1,0,18
9747,785389,33,2,14,2,7,0,7,0,0,1,5,2,1,2,7,0,4
9747,791640,12,0,2,0,2,0,0,0,0,1,0,2,3,0,1,0,0
9747,785255,9,0,3,0,2,0,1,0,0,0,1,0,1,0,0,0,0
9747,796399,22,0,6,0,3,0,3,0,0,1,4,1,0,0,1,0,0
9747,796398,9,0,1,0,0,0,1,0,0,0,1,1,1,0,1,0,0
9747,796400,3,2,5,2,4,0,1,1,2,3,0,0,0,0,0,0,5
9748,790839,23,0,2,0,0,0,2,5,6,3,2,0,0,0,0,0,5
9748,785388,30,12,23,12,23,0,0,2,5,8,6,5,3,1,1,2,26
9748,796395,43,6,13,2,5,4,8,3,5,1,1,3,2,1,3,1,19
9748,785386,32,1,5,0,1,1,4,1,2,0,1,3,0,0,2,2,4
9748,780373,33,0,4,0,0,0,4,0,0,0,2,3,3,1,0,1,0
9748,780370,22,1,2,0,0,1,2,1,3,0,2,0,3,1,0,0,4
9748,796393,16,4,7,4,7,0,0,3,6,1,2,1,1,0,0,1,11
9748,790840,14,2,4,0,0,2,4,0,0,0,2,0,1,0,2,0,6
9748,790841,12,1,2,0,0,1,2,0,0,0,0,1,2,0,1,0,3
9749,790873,33,5,13,4,8,1,5,6,7,2,3,5,5,0,1,1,17
9749,785429,11,0,5,0,1,0,4,0,0,0,1,0,0,0,0,0,0
9749,780054,30,2,4,2,4,0,0,2,2,2,8,1,5,0,1,0,6
9749,781140,19,7,10,3,5,4,5,0,0,1,3,1,2,1,0,0,18
9749,786851,40,7,17,3,6,4,11,2,2,0,5,3,1,0,1,0,20
9749,776357,35,5,8,5,7,0,1,0,0,0,5,7,1,4,4,0,10
9749,781139,18,1,1,1,1,0,0,0,0,2,0,0,4,0,1,1,2
9749,796433,13,0,0,0,0,0,0,2,2,1,0,1,2,1,1,0,2
9749,776245,21,3,7,1,2,2,5,4,5,1,2,1,1,0,0,0,12
9749,799973,5,0,1,0,1,0,0,0,0,1,0,0,1,0,0,0,0
9750,786041,14,0,2,0,2,0,0,0,0,0,2,1,1,1,3,0,0
9750,780881,29,3,9,2,5,1,4,0,2,7,5,1,0,0,6,0,7
9750,792075,30,2,9,1,3,1,6,1,1,2,4,1,2,1,4,1,6
9750,786686,38,9,17,5,10,4,7,13,17,0,2,4,3,3,1,0,35
9750,780052,27,1,6,1,4,0,2,0,0,0,1,2,1,1,2,0,2
9750,780882,12,1,5,0,3,1,2,0,0,1,0,1,5,0,2,0,3
9750,780275,17,1,1,1,1,0,0,1,3,2,2,0,3,0,0,3,3
9750,775222,13,3,7,2,3,1,4,0,1,2,4,0,4,0,0,0,7
9750,792074,18,3,8,1,3,2,5,0,0,2,0,1,2,1,0,0,8
9750,780884,2,0,0,0,0,0,0,0,0,0,0,0,0,0,0,0,0
9751,781107,18,3,3,3,3,0,0,0,0,1,3,0,2,0,0,1,6
9751,791972,33,6,10,1,3,5,7,2,3,2,5,2,2,4,4,1,19
9751,796777,32,5,6,5,6,0,0,2,3,0,6,1,3,2,4,0,12
9751,791974,31,2,7,0,3,2,4,4,4,0,5,4,4,2,1,2,10
9751,780863,35,3,11,2,7,1,4,7,11,3,0,6,3,2,3,1,14
9751,796780,21,1,5,1,2,0,3,1,2,1,3,4,3,0,1,0,3
9751,796778,22,3,9,3,9,0,0,3,6,3,4,1,2,1,4,0,9
9751,785366,8,0,1,0,1,0,0,1,2,0,1,1,1,0,0,0,1
9752,789177,41,5,7,5,7,0,0,6,9,4,13,1,2,2,0,6,16
9752,780227,24,2,4,1,3,1,1,0,0,0,2,0,4,1,1,0,5
9752,791340,39,4,16,3,11,1,5,3,6,0,3,3,2,1,5,0,12
9752,780181,39,12,26,10,19,2,7,9,9,1,3,2,3,1,3,0,35
9752,776089,40,1,4,1,2,0,2,3,4,2,1,3,3,2,1,0,5
9752,797262,1,0,0,0,0,0,0,0,0,0,0,0,1,0,0,0,0
9752,797260,1,0,0,0,0,0,0,0,0,1,0,0,0,0,0,0,0
9752,775758,20,0,0,0,0,0,0,2,4,0,1,1,2,2,1,0,2
9752,791336,13,1,4,1,4,0,0,2,2,1,1,1,0,0,0,0,4
9752,789178,7,0,0,0,0,0,0,2,2,0,0,0,4,0,0,0,2
9753,799000,21,6,8,6,8,0,0,2,2,4,3,0,5,0,1,0,14
9753,785471,29,4,6,4,4,0,2,0,2,2,6,1,4,0,1,1,8
9753,775198,42,3,9,2,5,1,4,5,8,3,2,1,3,1,2,0,12
9753,786697,37,1,8,1,5,0,3,2,4,2,5,3,3,0,1,0,4
9753,775628,35,10,17,8,14,2,3,8,8,0,2,5,4,1,6,1,30
9753,792399,6,0,0,0,0,0,0,0,0,1,0,0,1,0,3,0,0
9753,780263,29,2,6,1,4,1,2,3,4,1,8,0,3,1,2,1,8
9753,775547,7,0,1,0,0,0,1,0,0,0,0,0,0,0,2,0,0
9753,780571,19,2,5,0,2,2,3,2,3,0,1,0,4,2,1,0,8
9754,780765,39,3,16,2,11,1,5,1,3,5,5,5,1,0,2,0,8
9754,781301,29,2,3,2,3,0,0,2,2,3,4,1,5,0,1,1,6
9754,786255,35,9,18,7,12,2,6,2,4,0,5,1,3,0,2,0,22
9754,780762,23,1,6,0,3,1,3,0,0,0,2,1,1,0,2,0,3
9754,780768,34,4,8,4,6,0,2,0,2,2,2,2,3,4,5,0,8
9754,797320,6,0,2,0,2,0,0,0,0,0,2,0,1,0,0,0,0
9754,780755,24,2,5,1,4,1,1,0,0,3,3,0,3,1,1,0,5
9754,791729,10,3,4,3,3,0,1,0,0,1,0,0,2,0,0,1,6
9755,786857,28,3,7,2,5,1,2,2,3,2,4,0,4,1,2,2,9
9755,781403,39,5,11,3,9,2,2,7,8,0,6,0,1,1,2,2,19
9755,792654,31,3,9,3,9,0,0,4,9,2,6,0,2,1,1,2,10
9755,797301,37,5,6,3,4,2,2,3,3,0,2,1,2,1,2,0,15
9755,780524,21,0,1,0,0,0,1,2,2,1,1,1,3,0,3,0,2
9755,792653,8,1,4,1,4,0,0,0,0,1,2,0,1,0,1,0,2
9755,781400,31,4,10,3,5,1,5,0,0,0,3,3,0,1,3,0,9
9755,797302,5,0,0,0,0,0,0,0,0,0,0,0,0,0,0,0,0
9756,786690,24,7,10,5,6,2,4,1,2,2,9,1,5,0,6,1,17
9756,796816,33,6,11,4,6,2,5,1,1,1,6,1,1,2,2,0,15
9756,780629,32,0,2,0,0,0,2,6,10,2,4,1,3,0,4,0,6
9756,774845,35,1,10,1,6,0,4,7,12,0,3,8,4,1,4,0,9
9756,775888,32,4,9,3,5,1,4,1,2,0,4,1,2,1,2,2,10
9756,796817,3,0,0,0,0,0,0,0,0,0,1,0,0,0,0,0,0
9756,791161,10,0,2,0,0,0,2,0,0,0,3,1,4,0,0,0,0
9756,796815,9,2,5,2,3,0,2,0,0,0,0,1,0,0,0,0,4
9756,796819,3,0,0,0,0,0,0,0,2,0,0,0,0,0,0,0,0
9756,791159,3,0,1,0,0,0,1,0,0,0,0,0,0,0,0,0,0
9756,785346,16,0,1,0,0,0,1,0,0,0,1,0,3,2,1,0,0
9757,788113,27,2,9,2,5,0,4,3,5,2,3,2,4,3,3,0,7
9757,776497,25,1,8,0,3,1,5,4,4,0,2,1,1,0,2,1,7
9757,785731,27,5,10,4,8,1,2,2,4,2,7,2,4,2,3,0,13
9757,785729,32,4,9,3,7,1,2,0,0,1,0,2,3,1,3,0,9
9757,780864,25,3,8,2,6,1,2,0,0,0,3,1,3,1,0,0,7
9757,799881,6,2,4,2,4,0,0,0,0,1,1,0,1,0,1,0,4
9757,792402,7,0,0,0,0,0,0,0,0,0,1,2,0,0,0,0,0
9757,796211,13,1,4,1,3,0,1,4,5,4,5,1,1,1,0,0,6
9757,797298,9,0,1,0,0,0,1,0,0,0,1,1,2,0,0,0,0
9757,786231,29,9,20,4,11,5,9,6,7,8,7,4,2,2,1,0,29
9758,791416,27,6,10,6,10,0,0,6,11,7,5,0,2,2,2,1,18
9758,781614,22,3,5,3,4,0,1,2,2,2,1,1,4,0,2,0,8
9758,797096,26,5,10,3,5,2,5,0,0,2,3,2,1,2,1,0,12
9758,785906,32,8,11,8,9,0,2,7,9,2,3,6,1,3,5,0,23
9758,780096,30,4,7,4,5,0,2,0,0,0,1,4,4,1,1,0,8
9758,797093,15,2,8,2,7,0,1,3,5,0,2,1,2,0,2,0,7
9758,780100,23,2,4,0,0,2,4,3,4,1,4,1,3,0,0,0,9
9758,785907,10,1,3,1,3,0,0,0,0,1,2,0,3,0,0,0,2
9758,797094,3,0,1,0,0,0,1,0,0,0,1,1,1,0,0,0,0
9758,791415,3,0,1,0,1,0,0,0,0,1,1,0,0,0,1,0,0
9758,785903,4,0,0,0,0,0,0,0,0,0,1,0,0,0,0,0,0
9758,767484,3,1,1,0,0,1,1,0,0,0,1,0,0,0,0,0,3
9758,797098,2,0,0,0,0,0,0,0,0,0,0,0,0,0,0,0,0
9759,780634,17,3,3,3,3,0,0,0,0,0,5,0,5,2,0,1,6
9759,791826,14,1,2,1,1,0,1,3,4,0,1,0,5,0,2,1,5
9759,786785,34,7,13,7,12,0,1,7,9,1,1,1,1,3,0,0,21
9759,780633,30,4,8,3,3,1,5,1,1,0,3,1,3,0,2,1,10
9759,776009,31,6,13,6,13,0,0,1,1,0,0,1,3,3,5,0,13
9759,786784,22,2,5,2,4,0,1,3,4,1,0,0,2,1,0,0,7
9759,797389,18,2,4,1,2,1,2,1,2,0,3,1,2,0,0,1,6
9759,786783,11,0,3,0,2,0,1,0,0,0,1,1,3,0,2,1,0
9759,780635,6,0,1,0,1,0,0,0,1,0,1,0,0,0,0,0,0
9759,800144,5,0,1,0,1,0,0,0,0,0,0,2,0,0,0,0,0
9759,797388,6,0,1,0,1,0,0,0,0,0,1,0,0,0,0,0,0
9759,797387,3,0,0,0,0,0,0,0,0,0,0,0,0,0,0,0,0
9759,797390,3,0,0,0,0,0,0,0,0,0,0,0,0,0,0,0,0
9760,775738,12,1,5,1,4,0,1,0,0,2,0,0,0,0,0,1,2
9760,786091,43,8,13,4,8,4,5,2,2,1,5,0,3,1,1,1,22
9760,786728,41,4,11,4,11,0,0,3,5,2,1,9,5,1,2,2,11
9760,785904,37,6,16,4,9,2,7,1,1,0,10,2,2,1,3,0,15
9760,780892,40,3,8,0,1,3,7,0,0,0,5,0,0,2,2,0,9
9760,786788,6,0,2,0,0,0,2,0,0,0,1,0,1,0,0,0,0
9760,786096,29,6,13,4,10,2,3,2,2,1,6,2,4,0,2,1,16
9760,781030,17,1,2,1,2,0,0,0,0,0,1,1,0,0,0,2,2
9760,785734,0,0,0,0,0,0,0,0,0,0,0,0,0,0,0,0,0
9761,775705,13,0,0,0,0,0,0,0,0,0,0,0,1,0,0,0,0
9761,791652,39,7,13,7,13,0,0,8,10,2,6,1,2,0,2,8,22
9761,786495,33,5,10,4,9,1,1,0,0,4,10,4,3,2,0,0,11
9761,791650,41,11,19,9,14,2,5,5,7,1,8,2,3,1,6,0,29
9761,776384,43,3,16,1,9,2,7,0,0,0,4,4,1,0,2,0,8
9761,791653,15,1,4,1,3,0,1,0,0,0,2,0,0,0,0,0,2
9761,797289,16,1,3,1,3,0,0,0,0,0,1,0,1,0,0,0,2
9761,797283,21,2,5,0,0,2,5,0,0,0,2,0,0,0,1,0,6
9761,791654,1,0,0,0,0,0,0,0,0,0,0,0,0,0,0,0,0
9761,797285,3,0,0,0,0,0,0,0,0,0,0,0,0,0,0,0,0
9762,785536,8,0,0,0,0,0,0,0,0,0,1,0,1,0,1,0,0
9762,780119,31,6,12,6,11,0,1,4,7,3,5,3,5,2,5,1,16
9762,796558,28,4,12,4,12,0,0,3,6,0,6,4,4,1,2,0,11
9762,796559,39,2,6,2,3,0,3,1,1,4,4,0,2,0,4,1,5
9762,776097,22,1,3,1,3,0,0,2,2,0,2,0,3,0,2,0,4
9762,775679,4,0,0,0,0,0,0,0,0,0,0,0,1,0,0,0,0
9762,780149,32,9,16,5,9,4,7,5,6,0,4,4,0,1,5,1,27
9762,785280,27,1,4,0,0,1,4,0,0,0,2,2,1,1,1,0,3
9762,785285,9,2,2,2,2,0,0,0,0,0,0,0,3,0,0,2,4
9763,790863,32,2,5,2,3,0,2,2,2,0,11,1,3,3,2,2,6
9763,780021,26,3,6,3,6,0,0,3,7,0,0,0,5,1,3,0,9
9763,785412,25,5,10,4,7,1,3,3,3,0,2,2,2,1,4,0,14
9763,780099,26,3,13,3,9,0,4,1,2,3,6,0,2,1,2,1,7
9763,776214,38,4,10,2,4,2,6,1,2,0,1,5,3,3,5,0,11
9763,775686,10,0,0,0,0,0,0,2,2,0,1,1,5,0,2,0,2
9763,785413,21,3,4,2,3,1,1,0,0,2,0,2,4,0,2,0,7
9763,776221,12,1,2,0,1,1,1,0,1,0,0,0,0,0,1,0,3
9763,785411,4,0,0,0,0,0,0,0,0,0,1,0,0,0,0,0,0
9763,785417,6,1,2,0,1,1,1,2,2,0,1,0,1,0,0,0,5
9764,776279,17,3,6,0,1,3,5,0,0,0,0,0,3,0,1,1,9
9764,781505,23,1,3,0,2,1,1,3,5,1,5,0,1,0,2,0,6
9764,780353,21,2,3,2,3,0,0,5,5,2,0,1,2,0,2,4,9
9764,791317,23,6,11,6,8,0,3,3,4,2,4,5,1,4,1,0,15
9764,777573,24,2,5,1,2,1,3,0,0,1,6,3,2,0,0,0,5
9764,791318,4,0,0,0,0,0,0,0,0,0,1,0,0,0,2,0,0
9764,791319,1,0,0,0,0,0,0,0,0,0,0,0,0,0,0,0,0
9764,788965,1,0,0,0,0,0,0,0,0,0,0,0,0,0,0,0,0
9764,786222,21,5,7,3,5,2,2,2,2,4,10,0,0,1,0,1,14
9764,785966,9,2,3,2,3,0,0,0,0,0,3,0,1,0,1,0,4
9764,796646,5,0,1,0,0,0,1,0,0,1,0,1,2,0,1,0,0
9764,796647,4,1,1,0,0,1,1,0,0,0,0,0,0,1,1,0,3
9764,796649,22,6,10,6,7,0,3,2,2,0,1,1,1,0,0,0,14
9764,790851,20,0,4,0,2,0,2,2,4,1,2,1,2,1,3,1,2
9764,796648,5,0,2,0,2,0,0,0,0,0,2,0,0,0,0,0,0
9765,797325,23,3,5,3,5,0,0,0,0,2,2,1,4,1,0,0,6
9765,797329,21,0,3,0,1,0,2,0,0,2,2,1,2,0,0,1,0
9765,797327,29,2,12,1,6,1,6,2,3,0,2,0,1,1,2,1,7
9765,797323,33,5,15,4,9,1,6,1,2,2,0,3,0,1,3,0,12
9765,786236,36,5,15,4,9,1,6,4,6,2,2,0,4,1,2,0,15
9765,786246,9,1,3,0,0,1,3,0,0,0,2,0,2,0,0,0,3
9765,786244,3,0,0,0,0,0,0,0,0,0,1,0,0,0,0,0,0
9765,781002,6,0,0,0,0,0,0,0,2,0,1,0,2,0,1,0,0
9765,797330,4,0,1,0,1,0,0,0,0,1,0,0,0,1,1,0,0
9765,797328,3,0,1,0,1,0,0,0,0,0,0,0,0,0,0,0,0
9765,797324,10,1,2,1,2,0,0,1,2,1,0,1,0,1,0,0,3
9765,791732,3,0,0,0,0,0,0,0,0,0,0,0,0,0,0,0,0
9765,786233,20,0,3,0,0,0,3,1,2,0,2,0,1,0,1,0,1
9766,781300,27,2,8,2,6,0,2,4,4,0,5,2,3,0,0,0,8
9766,790803,28,7,11,7,11,0,0,3,5,4,7,2,3,0,2,4,17
9766,790801,13,0,1,0,1,0,0,1,2,0,0,1,2,1,2,0,1
9766,781304,28,3,8,3,7,0,1,3,5,0,1,2,2,0,6,0,9
9766,781302,24,2,7,1,4,1,3,0,1,3,4,0,0,2,4,0,5
9766,796364,5,0,0,0,0,0,0,2,2,0,1,0,2,0,1,1,2
9766,796360,25,4,7,4,6,0,1,3,3,1,4,4,1,2,3,0,11
9766,780598,20,3,4,0,0,3,4,0,0,0,2,0,2,1,0,0,9
9766,796363,20,3,6,2,4,1,2,0,0,1,0,0,3,2,0,2,7
9766,781305,5,0,1,0,1,0,0,0,0,0,2,0,0,0,0,0,0
9766,796362,1,0,0,0,0,0,0,0,0,0,0,0,1,0,0,0,0
9766,790802,4,0,0,0,0,0,0,0,0,0,0,0,0,0,0,0,0
9767,790856,26,5,10,5,10,0,0,2,3,4,2,1,2,2,0,2,12
9767,780452,27,1,2,1,2,0,0,3,4,5,3,1,4,0,1,0,5
9767,796413,28,4,10,1,3,3,7,0,0,0,5,1,0,2,2,0,11
9767,796408,26,4,14,1,9,3,5,2,2,1,1,1,5,2,4,0,13
9767,796407,24,3,9,3,7,0,2,1,2,3,1,1,2,1,1,1,7
9767,796410,17,2,6,2,6,0,0,1,5,2,4,0,0,0,1,1,5
9767,790858,14,2,6,2,5,0,1,0,2,1,2,2,1,0,0,0,4
9767,796409,24,2,10,2,7,0,3,3,3,0,1,2,2,1,2,0,7
9767,796411,10,0,1,0,1,0,0,2,4,1,2,0,2,0,0,0,2
9767,780450,4,0,0,0,0,0,0,0,0,0,0,0,0,0,0,0,0
9768,785714,27,5,7,5,7,0,0,1,4,2,5,0,4,1,2,1,11
9768,775894,35,4,13,3,9,1,4,5,8,7,5,1,0,0,3,1,14
9768,785711,38,6,14,5,10,1,4,0,0,0,4,3,2,0,3,0,13
9768,780985,35,3,11,2,5,1,6,2,2,0,1,3,3,0,1,0,9
9768,775266,31,1,9,0,6,1,3,0,0,0,8,0,4,1,0,0,3
9768,779994,9,1,1,1,1,0,0,0,0,3,5,0,1,1,0,0,2
9768,791167,7,1,2,0,1,1,1,0,0,0,1,0,2,0,1,0,3
9768,796829,13,2,5,2,5,0,0,0,0,3,0,0,1,0,1,0,4
9768,785378,5,0,0,0,0,0,0,0,0,0,0,0,0,0,0,1,0
9769,796812,21,6,9,6,9,0,0,1,2,0,5,0,4,0,2,1,13
9769,780952,33,4,8,3,7,1,1,4,6,4,3,1,1,1,0,0,13
9769,791155,33,4,14,4,11,0,3,6,7,1,7,2,1,1,4,0,14
9769,786609,28,1,7,1,5,0,2,0,0,2,4,1,1,0,0,0,2
9769,796810,30,2,6,1,5,1,1,0,0,0,2,3,1,0,1,0,5
9769,780945,4,1,3,1,3,0,0,0,0,1,0,0,1,0,0,0,2
9769,796814,12,0,2,0,1,0,1,0,0,0,3,2,2,1,1,0,0
9769,791156,20,0,4,0,3,0,1,2,2,0,0,1,0,1,0,0,2
9769,780950,19,1,5,0,0,1,5,2,2,1,0,0,2,0,0,0,5
9770,791522,38,11,14,11,14,0,0,2,6,3,4,2,3,0,1,1,24
9770,786351,33,8,15,5,11,3,4,1,1,4,8,0,2,1,0,0,20
9770,786348,15,0,0,0,0,0,0,0,0,0,1,1,1,0,1,0,0
9770,797146,39,5,17,3,10,2,7,6,7,2,2,2,1,0,1,0,18
9770,797143,35,4,11,2,4,2,7,0,0,0,5,5,4,3,1,0,10
9770,797142,2,0,0,0,0,0,0,0,0,0,0,0,2,0,1,0,0
9770,797147,26,0,5,0,4,0,1,2,2,3,2,3,3,4,1,1,2
9770,785816,9,1,1,1,1,0,0,0,0,1,1,1,0,0,0,0,2
9770,797144,3,0,2,0,1,0,1,0,0,0,1,0,0,0,0,0,0
9771,786447,17,0,4,0,4,0,0,5,7,2,3,0,5,0,0,0,5
9771,775074,34,7,8,7,8,0,0,6,6,4,9,1,3,0,3,3,20
9771,786448,32,5,10,5,8,0,2,0,0,2,4,2,1,0,2,1,10
9771,780731,40,9,20,4,9,5,11,3,4,0,2,2,2,0,1,1,26
9771,780462,36,3,13,2,8,1,5,0,1,2,1,3,0,3,1,0,7
9771,791632,9,1,2,1,2,0,0,0,0,2,1,0,0,0,0,0,2
9771,786132,20,0,2,0,2,0,0,1,2,4,2,0,1,1,1,1,1
9771,796971,8,0,3,0,2,0,1,0,0,0,0,0,3,0,3,0,0
9771,791631,4,1,2,1,2,0,0,0,0,1,0,0,0,0,0,0,2
9772,786157,14,0,0,0,0,0,0,0,0,0,2,1,5,0,0,1,0
9772,780676,36,6,15,3,8,3,7,9,14,1,7,1,2,1,2,1,24
9772,791756,27,6,12,6,12,0,0,1,3,0,4,4,2,2,1,0,13
9772,780992,28,3,9,2,4,1,5,2,2,0,2,2,1,2,1,0,9
9772,780677,35,6,9,3,4,3,5,0,0,1,8,2,2,2,0,0,15
9772,775533,13,0,1,0,1,0,0,0,2,2,1,0,4,1,2,0,0
9772,780673,14,1,2,0,0,1,2,2,2,0,1,1,3,0,1,0,5
9772,786150,13,0,0,0,0,0,0,0,0,1,0,1,4,0,2,0,0
9772,797348,12,2,4,1,2,1,2,5,7,0,2,2,2,0,0,0,10
9772,791754,8,0,1,0,1,0,0,1,2,0,0,0,2,0,0,1,1
9773,797523,22,0,2,0,0,0,2,0,0,0,2,2,4,0,0,0,0
9773,785402,27,6,9,6,9,0,0,7,11,2,7,0,3,0,2,0,19
9773,797524,28,1,2,1,2,0,0,2,2,4,4,0,5,0,1,2,4
9773,792118,39,6,15,4,9,2,6,11,14,2,3,6,3,1,3,0,25
9773,782593,38,4,15,2,6,2,9,7,7,0,5,3,3,0,5,0,17
9773,785828,12,1,3,1,3,0,0,0,0,1,1,0,2,0,1,0,2
9773,791702,9,0,1,0,1,0,0,0,0,0,0,0,0,0,1,0,0
9773,791700,20,0,4,0,1,0,3,0,0,0,1,0,4,3,1,0,0
9773,797526,2,1,1,0,0,1,1,0,0,0,0,0,1,0,0,0,3
9773,797525,3,0,1,0,1,0,0,0,0,0,1,0,0,0,0,1,0
9773,792663,0,0,0,0,0,0,0,0,0,0,0,0,0,0,0,0,0
9774,781244,23,8,14,6,11,2,3,0,2,1,3,3,3,0,3,2,18
9774,791241,27,10,13,9,11,1,2,0,0,1,3,2,0,0,0,0,21
9774,785537,19,1,4,1,3,0,1,0,0,1,2,2,2,0,1,0,2
9774,781243,27,2,2,1,1,1,1,3,4,0,10,2,0,2,0,1,8
9774,781237,15,0,0,0,0,0,0,0,0,0,1,0,2,0,0,0,0
9774,796943,4,0,0,0,0,0,0,0,0,0,1,0,2,0,1,0,0
9774,785535,7,0,0,0,0,0,0,1,2,0,1,0,0,1,0,0,1
9774,796940,8,1,3,1,2,0,1,1,2,0,3,0,1,0,1,0,3
9774,791243,17,3,3,2,2,1,1,2,2,0,0,3,1,0,1,0,9
9774,791245,18,4,6,3,4,1,2,0,0,0,2,4,3,1,5,0,9
9774,791246,11,0,4,0,1,0,3,2,2,0,0,0,1,1,1,0,2
9774,785529,4,0,1,0,1,0,0,0,0,0,1,0,0,0,0,0,0
9774,776205,20,2,5,1,3,1,2,0,0,1,7,0,0,0,0,0,5
9775,797281,33,1,8,1,6,0,2,0,0,0,10,1,4,0,2,0,2
9775,791648,22,2,8,1,2,1,6,2,2,1,3,0,2,1,1,1,7
9775,785694,26,4,7,4,7,0,0,1,2,0,0,1,2,1,1,0,9
9775,797280,23,1,4,0,2,1,2,0,0,1,0,0,1,0,1,0,3
9775,797279,29,2,6,1,3,1,3,0,0,0,3,3,3,2,1,0,5
9775,791647,14,2,7,1,5,1,2,0,0,0,1,0,1,0,1,0,5
9775,791649,17,0,3,0,1,0,2,0,0,0,0,1,0,0,1,0,0
9775,786640,27,7,10,6,8,1,2,0,2,0,0,3,1,1,1,0,15
9775,785697,5,0,3,0,0,0,3,0,0,0,2,1,0,1,0,0,0
9775,785695,4,1,2,1,1,0,1,2,4,0,1,0,0,1,0,0,4
9776,781454,30,2,9,2,7,0,2,3,4,3,5,0,3,0,1,0,7
9776,786424,29,0,7,0,7,0,0,0,0,5,8,1,4,0,3,2,0
9776,792366,25,3,9,2,6,1,3,4,4,1,2,0,4,2,2,0,11
9776,791015,24,1,3,0,2,1,1,0,0,0,0,0,2,1,0,0,3
9776,785483,37,8,19,5,8,3,11,15,16,1,2,2,2,0,2,0,34
9776,785959,19,0,1,0,1,0,0,1,4,1,4,1,2,0,1,1,1
9776,797979,19,2,6,2,3,0,3,0,0,3,0,0,3,1,1,0,4
9776,792279,13,1,3,1,2,0,1,0,2,0,2,0,2,1,1,0,2
9776,775335,3,0,0,0,0,0,0,0,0,0,0,0,0,0,1,0,0
9776,797983,1,0,0,0,0,0,0,0,0,0,0,0,0,0,0,0,0
9777,781577,21,6,8,3,3,3,5,8,8,1,3,0,3,1,1,0,23
9777,775910,27,3,7,2,3,1,4,2,5,4,2,3,0,0,1,2,9
9777,786451,29,2,8,2,5,0,3,0,0,1,4,1,3,0,1,0,4
9777,780600,20,4,5,3,3,1,2,4,4,0,4,2,4,1,1,0,13
9777,781387,30,2,9,1,6,1,3,3,4,0,2,2,2,1,2,0,8
9777,800084,3,0,1,0,0,0,1,0,0,0,1,0,0,0,0,0,0
9777,791763,17,1,3,0,0,1,3,0,0,0,1,0,5,0,0,1,3
9777,786456,17,1,3,1,3,0,0,1,2,1,4,0,2,0,1,1,3
9777,797561,16,3,3,2,2,1,1,1,2,1,2,1,2,0,3,0,8
9777,780020,17,3,8,2,5,1,3,0,0,0,2,1,4,0,1,1,7
9777,790888,2,0,0,0,0,0,0,0,0,0,0,0,0,0,0,0,0
9777,786457,1,0,0,0,0,0,0,0,0,0,0,0,0,0,0,0,0
9778,781579,28,4,7,4,7,0,0,5,6,4,7,1,2,1,0,2,13
9778,786731,38,6,14,6,14,0,0,6,6,5,9,0,3,0,2,9,18
9778,798023,31,2,7,1,4,1,3,0,1,0,7,4,2,0,5,0,5
9778,781584,38,4,12,1,1,3,11,0,0,0,1,2,2,2,1,0,11
9778,780347,39,3,9,2,5,1,4,0,1,3,2,5,0,0,1,0,7
9778,775696,13,3,9,1,5,2,4,0,0,2,3,0,3,1,2,0,8
9778,798017,3,0,0,0,0,0,0,0,0,0,0,0,1,0,0,0,0
9778,798008,10,0,3,0,0,0,3,0,0,0,2,4,1,0,0,0,0
9779,791144,22,2,7,2,7,0,0,0,0,3,4,2,2,2,2,0,4
9779,785782,37,1,4,0,0,1,4,0,0,1,3,0,3,0,0,0,3
9779,791145,33,3,16,3,13,0,3,6,8,3,7,0,1,3,1,1,12
9779,791146,37,7,18,6,14,1,4,0,0,1,6,2,3,1,0,0,15
9779,785777,28,1,8,1,5,0,3,0,0,3,1,0,3,1,2,1,2
9779,791147,11,3,9,2,7,1,2,2,3,5,1,0,4,0,1,0,9
9779,791148,14,0,3,0,1,0,2,3,4,0,2,0,0,0,0,2,3
9779,786748,15,0,2,0,1,0,1,2,3,1,0,2,0,0,0,0,2
9779,796804,3,0,0,0,0,0,0,0,0,0,0,0,0,0,0,0,0
9780,786029,35,4,10,4,10,0,0,1,3,7,4,2,3,2,1,1,9
9780,781398,25,0,2,0,1,0,1,0,0,0,1,0,0,1,1,1,0
9780,792114,38,6,17,2,5,4,12,4,5,0,5,3,2,1,0,0,20
9780,786018,30,2,6,0,1,2,5,2,2,1,4,2,0,1,1,0,8
9780,775678,30,5,12,3,4,2,8,0,0,0,4,2,1,2,0,0,12
9780,797746,13,3,7,1,3,2,4,0,0,1,3,1,4,0,0,0,8
9780,792112,2,0,0,0,0,0,0,0,0,0,1,0,0,0,0,0,0
9780,797740,15,1,5,1,4,0,1,5,5,0,0,1,0,0,1,0,7
9780,797737,12,2,2,2,2,0,0,0,0,0,0,4,0,1,0,1,4
9781,785996,33,5,10,5,7,0,3,3,4,4,9,2,3,1,5,2,13
9781,785998,32,3,8,1,2,2,6,0,0,4,2,1,1,0,0,1,8
9781,785990,27,4,7,1,2,3,5,0,0,0,2,3,1,0,0,0,11
9781,780849,30,4,9,0,3,4,6,0,0,0,5,0,0,0,0,0,12
9781,780853,33,3,13,3,10,0,3,1,3,0,5,3,4,0,2,0,7
9781,797646,14,3,6,3,6,0,0,0,0,0,2,2,0,0,1,0,6
9781,792235,6,0,0,0,0,0,0,1,2,0,0,0,2,0,0,0,1
9781,792039,16,4,4,3,3,1,1,0,0,1,3,0,1,1,0,0,9
9781,780776,9,0,1,0,1,0,0,0,0,1,2,0,3,0,2,0,0
9782,776100,26,1,3,1,3,0,0,0,2,0,4,1,2,0,2,1,2
9782,785991,35,9,12,7,8,2,4,2,2,2,5,0,1,2,2,4,22
9782,797762,37,4,9,3,8,1,1,4,4,1,3,9,1,3,2,2,13
9782,781406,24,2,6,1,4,1,2,2,2,2,4,2,3,0,3,0,7
9782,781401,35,1,5,0,2,1,3,0,2,0,5,1,1,1,2,1,3
9782,797760,2,0,0,0,0,0,0,0,0,0,1,0,1,0,0,0,0
9782,792133,22,2,5,0,1,2,4,0,0,0,1,3,1,1,0,0,6
9782,781029,17,3,7,0,1,3,6,0,0,0,0,0,2,0,3,0,9
9782,775317,2,0,0,0,0,0,0,2,2,0,0,0,0,0,1,0,2
9783,792288,27,5,7,5,7,0,0,0,0,1,4,1,1,0,0,1,10
9783,785227,28,0,5,0,5,0,0,1,2,4,2,2,3,1,0,1,1
9783,786237,30,6,12,6,12,0,0,2,2,3,1,2,3,0,5,1,14
9783,780287,39,6,18,2,10,4,8,0,0,0,2,1,1,2,1,1,16
9783,776309,35,4,9,3,5,1,4,6,8,0,4,1,1,1,2,1,15
9783,798072,12,1,2,1,2,0,0,0,0,1,0,0,4,0,0,1,2
9783,792278,3,0,1,0,0,0,1,0,0,0,1,1,0,0,0,0,0
9783,786232,26,1,5,1,4,0,1,0,0,0,4,4,2,1,4,0,2
9784,775954,19,3,4,3,4,0,0,2,2,1,0,0,2,0,1,1,8
9784,781006,36,4,9,2,6,2,3,1,2,0,8,1,2,0,0,9,11
9784,796194,31,4,9,0,0,4,9,2,4,0,1,5,0,1,2,0,14
9784,796464,30,6,11,6,9,0,2,1,2,3,6,6,5,1,3,0,13
9784,796459,34,4,12,4,9,0,3,3,4,3,1,3,3,3,3,0,11
9784,781157,15,2,9,1,4,1,5,2,2,1,2,1,3,0,2,0,7
9784,790917,30,4,5,2,2,2,3,2,2,2,7,5,2,0,0,1,12
9784,785238,5,1,1,1,1,0,0,0,0,1,0,0,1,0,0,0,2
9784,790916,0,0,0,0,0,0,0,0,0,0,0,0,0,0,0,0,0
9785,790794,15,1,1,1,1,0,0,0,0,0,2,0,2,2,1,0,2
9785,785368,24,2,7,2,7,0,0,0,0,2,5,2,0,0,0,1,4
9785,790793,39,8,19,3,8,5,11,9,10,2,2,1,2,1,3,0,30
9785,785246,26,2,5,0,1,2,4,0,0,0,2,0,1,0,1,0,6
9785,780886,34,3,13,0,5,3,8,5,5,0,1,1,3,1,2,0,14
9785,796351,12,1,3,1,3,0,0,0,0,3,3,0,3,0,2,0,2
9785,780281,7,1,3,1,3,0,0,1,1,0,2,0,0,0,2,0,3
9785,790792,26,0,4,0,3,0,1,0,0,1,2,2,4,1,1,4,0
9785,790790,7,2,3,2,3,0,0,1,2,1,0,0,1,0,0,0,5
9785,796353,5,0,0,0,0,0,0,0,0,0,0,1,1,0,0,0,0
9785,796350,5,0,0,0,0,0,0,0,0,0,0,0,0,0,1,0,0
9786,791524,33,4,8,3,6,1,2,0,1,1,3,2,1,1,5,1,9
9786,797139,27,4,9,4,9,0,0,2,3,3,3,2,3,0,3,2,10
9786,775394,22,2,10,1,6,1,4,7,7,2,4,1,1,0,0,2,12
9786,780272,36,2,15,2,9,0,6,2,3,1,4,5,1,0,1,1,6
9786,775592,33,3,7,2,4,1,3,0,0,1,4,1,4,0,2,0,7
9786,785970,8,1,1,1,1,0,0,0,0,0,2,0,1,0,0,0,2
9786,791526,3,0,1,0,0,0,1,0,0,0,1,0,0,0,1,0,0
9786,791523,11,0,0,0,0,0,0,0,0,1,0,0,0,0,1,0,0
9786,780273,27,1,2,1,1,0,1,0,0,1,3,1,1,1,0,0,2
9787,791883,32,3,10,3,6,0,4,4,6,0,6,0,3,1,1,1,10
9787,781066,30,5,7,5,7,0,0,0,0,2,3,0,4,2,1,1,10
9787,797594,31,3,7,0,1,3,6,2,2,0,2,2,1,0,2,0,11
9787,791884,37,7,16,7,15,0,1,4,4,0,6,5,2,1,4,0,18
9787,780695,35,0,6,0,1,0,5,2,2,0,5,3,0,1,0,1,2
9787,797598,3,0,0,0,0,0,0,0,0,0,0,0,0,0,1,0,0
9787,797597,3,1,1,1,1,0,0,0,0,0,0,0,0,0,0,0,2
9787,791885,1,0,0,0,0,0,0,0,0,0,0,0,1,0,0,0,0
9787,786496,28,0,2,0,1,0,1,1,2,1,0,0,1,1,0,0,1
9788,797972,32,4,8,4,6,0,2,0,0,3,4,1,3,0,1,0,8
9788,797967,35,11,21,11,17,0,4,4,4,4,5,2,3,0,3,2,26
9788,797970,30,1,7,1,2,0,5,3,4,1,0,2,5,3,3,0,5
9788,781453,38,11,19,6,7,5,12,2,2,0,1,4,3,0,4,0,29
9788,774869,36,3,6,2,2,1,4,2,2,2,8,2,2,1,0,0,9
9788,792254,13,1,3,1,2,0,1,1,2,0,1,2,0,1,0,0,3
9788,786098,16,0,1,0,0,0,1,0,0,0,1,0,0,0,1,0,0
9789,792197,29,3,13,3,9,0,4,4,6,3,4,1,3,0,2,0,10
9789,781132,39,11,18,8,10,3,8,1,2,2,6,7,3,0,2,0,26
9789,797517,29,6,12,6,12,0,0,0,1,4,8,0,0,0,2,0,12
9789,791940,33,3,5,2,3,1,2,1,1,2,1,4,1,0,0,0,8
9789,786534,37,11,19,6,10,5,9,0,0,1,4,5,0,2,4,0,27
9789,797519,1,0,0,0,0,0,0,0,0,0,0,0,1,0,0,0,0
9789,797522,6,0,1,0,1,0,0,0,0,2,0,1,2,0,0,0,0
9789,797518,9,1,2,1,1,0,1,0,0,0,0,0,0,0,0,0,2
9789,791938,17,0,2,0,1,0,1,2,4,0,1,0,2,1,2,0,2
9790,790232,35,5,14,2,8,3,6,3,4,1,2,1,1,2,0,0,16
9790,780614,14,1,1,1,1,0,0,0,2,1,1,1,1,1,2,0,2
9790,780093,8,1,1,1,1,0,0,0,0,0,1,0,3,0,2,1,2
9790,789066,39,2,10,1,3,1,7,6,6,0,5,5,3,1,1,0,11
9790,776278,18,0,5,0,0,0,5,0,0,0,0,1,2,0,0,0,0
9790,797593,6,2,2,2,2,0,0,1,1,1,0,0,2,0,1,0,5
9790,780255,26,1,4,1,4,0,0,3,6,0,4,3,3,1,1,0,5
9790,792411,9,0,3,0,0,0,3,0,0,1,0,0,2,3,1,0,0
9790,786465,2,1,1,1,1,0,0,0,0,0,0,0,0,1,0,0,2
9790,786463,25,6,12,3,4,3,8,6,7,5,3,0,2,0,1,0,21
9790,785806,18,0,0,0,0,0,0,0,0,0,0,1,4,0,1,0,0
9791,797163,30,5,9,5,9,0,0,3,5,3,6,2,4,1,1,0,13
9791,797164,11,2,3,2,3,0,0,0,0,2,1,0,1,0,1,0,4
9791,786450,36,4,5,3,3,1,2,0,0,0,6,1,3,1,1,0,9
9791,776396,35,1,9,1,5,0,4,2,5,1,6,2,2,1,8,0,4
9791,776199,34,5,8,2,3,3,5,6,7,0,3,5,5,0,1,0,19
9791,797167,10,0,1,0,1,0,0,0,0,0,1,1,0,0,0,0,0
9791,791385,26,5,5,3,3,2,2,2,2,2,3,0,5,0,2,0,14
9791,797161,3,0,0,0,0,0,0,2,2,0,1,1,0,0,0,0,2
9791,797165,15,1,5,0,3,1,2,2,4,0,1,0,0,0,1,0,5
9792,775806,29,3,7,3,4,0,3,3,4,3,3,2,3,1,2,0,9
9792,781011,25,8,9,8,9,0,0,2,3,1,4,0,5,0,0,2,18
9792,797601,26,2,8,1,1,1,7,1,2,0,4,4,3,0,1,0,6
9792,781012,39,7,12,3,5,4,7,5,7,0,3,3,1,4,1,0,23
9792,775119,25,4,6,4,4,0,2,4,4,0,6,4,2,0,3,0,12
9792,775188,14,2,4,2,3,0,1,0,0,3,3,0,2,1,3,0,4
9792,775563,25,4,13,4,10,0,3,6,8,1,6,2,4,0,1,0,14
9792,797604,5,0,1,0,0,0,1,0,0,0,1,0,0,0,0,0,0
9792,786466,12,0,0,0,0,0,0,2,2,0,0,0,1,1,0,0,2
9793,791923,25,4,12,3,11,1,1,1,5,4,5,1,2,0,1,0,10
9793,781122,7,2,3,2,3,0,0,0,0,0,1,0,3,0,1,0,4
9793,791925,36,3,11,2,7,1,4,3,4,0,4,3,2,2,1,0,10
9793,786527,30,3,7,1,2,2,5,3,4,2,0,1,2,1,2,0,11
9793,781112,24,2,8,2,7,0,1,2,2,0,4,4,1,1,0,0,6
9793,786529,5,1,1,1,1,0,0,1,2,1,3,0,2,1,1,0,3
9793,797541,18,2,4,2,4,0,0,3,3,1,7,0,2,0,0,2,7
9793,797542,14,1,5,1,2,0,3,0,0,0,0,0,2,1,1,0,2
9793,791927,28,6,11,5,8,1,3,7,8,0,2,3,4,2,1,0,20
9793,786858,12,1,2,0,1,1,1,0,0,0,0,0,0,0,1,0,3
9793,797543,1,0,0,0,0,0,0,0,0,0,0,0,0,0,0,0,0
9794,785298,12,1,2,1,2,0,0,2,2,3,2,0,4,0,0,3,4
9794,775224,29,4,10,4,10,0,0,1,2,8,7,1,4,0,1,0,9
9794,778046,30,6,15,5,8,1,7,3,3,0,3,1,4,0,4,0,16
9794,782121,34,6,13,5,8,1,5,0,2,0,1,3,1,2,2,0,13
9794,775793,36,7,17,4,10,3,7,0,0,2,4,1,2,1,0,0,17
9794,785485,27,2,4,2,4,0,0,2,2,5,1,1,2,0,3,1,6
9794,786594,20,1,8,1,3,0,5,2,2,0,3,2,2,0,1,0,4
9794,785302,12,2,6,1,2,1,4,0,0,0,0,2,1,2,1,0,5
9795,796439,22,3,6,3,6,0,0,2,2,2,1,0,0,0,2,0,8
9795,790884,27,2,6,2,6,0,0,6,8,0,6,2,1,0,1,6,10
9795,791635,3,0,0,0,0,0,0,0,0,0,0,0,0,0,0,0,0
9795,790883,33,8,13,7,11,1,2,3,3,1,4,1,4,1,4,0,20
9795,796436,38,7,16,3,6,4,10,7,8,0,8,5,2,1,3,0,25
9795,785436,37,1,8,1,8,0,0,1,2,1,4,1,2,3,1,0,3
9795,796438,28,4,6,3,4,1,2,2,3,1,5,2,2,0,1,1,11
9795,796442,6,1,1,1,1,0,0,0,0,0,0,0,0,0,0,1,2
9795,790885,6,2,3,2,2,0,1,0,0,2,0,0,0,0,1,0,4
9796,785287,10,2,2,2,2,0,0,0,2,2,2,1,3,0,0,0,4
9796,776286,33,5,8,4,6,1,2,0,0,4,3,2,1,0,1,1,11
9796,791445,36,4,9,0,1,4,8,2,2,0,5,3,0,1,1,0,14
9796,785357,32,4,12,0,3,4,9,3,4,1,3,1,3,1,0,0,15
9796,775560,34,5,10,5,7,0,3,5,5,0,10,10,1,0,4,2,15
9796,781627,14,3,5,3,5,0,0,1,2,4,2,0,5,0,1,2,7
9796,775557,8,0,1,0,1,0,0,0,0,0,2,0,0,0,0,2,0
9796,797010,16,1,4,1,2,0,2,0,0,1,0,2,1,1,0,0,2
9796,785895,13,2,5,0,0,2,5,0,0,0,1,0,2,0,0,0,6
9796,797011,1,0,0,0,0,0,0,0,0,0,1,0,0,0,0,0,0
9796,797009,1,0,1,0,0,0,1,0,0,0,0,0,0,0,0,0,0
9796,797012,2,1,1,0,0,1,1,0,0,0,1,2,0,0,0,0,3
9797,791686,28,3,6,2,4,1,2,4,6,2,2,4,2,1,2,0,11
9797,798028,33,3,6,3,4,0,2,2,5,0,4,3,1,0,0,0,8
9797,792270,24,2,7,1,3,1,4,0,0,1,4,0,1,0,0,2,5
9797,790940,36,4,12,3,8,1,4,0,2,1,3,3,2,1,1,0,9
9797,780770,32,4,12,3,8,1,4,0,0,0,2,3,4,1,2,1,9
9797,786060,23,1,4,1,3,0,1,0,0,0,0,2,0,1,0,0,2
9797,792271,12,3,6,3,6,0,0,2,5,2,1,0,1,0,0,1,8
9797,792269,12,0,1,0,1,0,0,0,0,1,1,0,1,0,0,0,0
9797,792273,0,0,0,0,0,0,0,0,0,0,0,0,0,0,0,0,0
9798,785495,39,10,14,7,10,3,4,3,3,0,5,4,2,4,4,0,26
9798,785958,42,7,17,7,16,0,1,2,6,9,11,1,4,0,1,0,16
9798,785659,27,3,7,3,6,0,1,0,1,2,1,1,5,1,1,0,6
9798,785494,41,7,14,4,9,3,5,1,4,1,2,4,1,1,2,1,18
9798,780698,40,5,14,4,9,1,5,1,3,2,7,3,2,1,4,2,12
9798,785490,9,0,0,0,0,0,0,0,0,0,0,0,0,2,0,0,0
9798,775377,18,1,3,1,3,0,0,1,2,4,3,0,2,0,0,1,3
9798,780427,9,0,1,0,1,0,0,0,0,0,1,1,1,0,1,0,0
9799,790935,37,3,6,3,4,0,2,0,0,3,1,1,3,0,1,1,6
9799,792442,30,4,9,4,9,0,0,3,4,6,8,1,3,0,0,4,11
9799,790938,25,3,6,3,5,0,1,0,0,2,0,3,5,1,0,0,6
9799,780933,39,4,12,3,5,1,7,0,0,0,2,1,0,1,2,0,9
9799,775340,43,11,33,8,23,3,10,2,2,1,6,5,1,0,4,0,27
9799,796491,7,0,0,0,0,0,0,0,0,0,4,0,5,0,0,0,0
9799,796190,20,3,8,1,2,2,6,1,1,3,1,2,0,0,0,0,9
9799,790937,15,2,2,2,2,0,0,0,0,0,0,0,1,0,1,0,4
9799,796492,9,0,1,0,1,0,0,2,2,0,0,0,0,0,2,0,2
9799,790936,0,0,0,0,0,0,0,0,0,0,0,0,0,0,0,0,0
9800,780094,32,3,5,2,2,1,3,3,3,0,3,0,2,0,0,0,10
9800,775142,35,6,12,6,9,0,3,2,4,1,2,4,4,5,1,2,14
9800,790843,39,5,15,3,6,2,9,2,2,1,4,2,2,2,3,1,14
9800,786212,36,4,13,1,4,3,9,3,3,2,1,0,2,1,2,0,14
9800,785392,39,3,6,3,5,0,1,1,2,2,5,6,4,0,2,0,7
9800,790844,10,1,1,1,1,0,0,1,2,1,1,0,1,0,1,0,3
9800,799986,3,0,1,0,1,0,0,0,0,0,0,0,1,0,0,1,0
9800,781563,6,1,2,1,2,0,0,0,1,0,0,0,1,0,0,0,2
9801,796404,32,6,9,6,9,0,0,0,0,7,5,4,2,0,4,2,12
9801,790853,10,2,3,2,3,0,0,0,0,0,2,1,3,0,2,0,4
9801,790850,34,3,8,0,1,3,7,2,4,1,5,4,0,0,1,0,11
9801,781164,33,2,3,1,1,1,2,7,8,0,1,1,2,1,0,0,12
9801,781163,36,5,12,0,4,5,8,1,2,1,5,3,3,2,6,0,16
9801,796406,24,5,7,5,7,0,0,3,5,2,7,1,1,0,2,1,13
9801,785434,14,1,4,0,3,1,1,0,0,0,1,0,2,1,0,0,3
9801,790854,3,1,1,1,1,0,0,2,2,0,0,0,2,0,0,0,4
9801,790849,14,0,3,0,2,0,1,0,0,0,0,2,1,0,0,0,0
9802,786704,28,7,12,7,12,0,0,9,10,1,6,0,2,2,2,1,23
9802,785395,25,2,6,1,2,1,4,0,0,0,4,0,0,1,0,1,5
9802,775840,30,1,5,1,5,0,0,2,2,1,3,1,2,0,0,0,4
9802,775955,33,6,11,6,8,0,3,5,7,0,3,4,0,0,1,0,17
9802,775811,14,1,1,1,1,0,0,0,0,0,1,0,0,1,0,0,2
9802,786706,12,0,1,0,1,0,0,0,0,0,2,0,3,0,2,0,0
9802,775287,15,0,1,0,0,0,1,1,2,1,2,0,1,0,0,0,1
9802,786702,2,0,0,0,0,0,0,0,0,0,2,0,0,0,0,0,0
9802,790921,15,0,3,0,1,0,2,3,4,0,2,1,2,3,0,0,3
9802,786551,26,3,7,1,4,2,3,8,9,0,2,1,0,1,1,0,16
9803,792299,22,3,6,2,2,1,4,0,0,0,2,0,4,0,1,0,7
9803,786181,22,6,9,6,9,0,0,3,4,3,5,0,5,0,1,1,15
9803,792304,39,4,12,1,5,3,7,2,2,1,1,3,0,0,2,1,13
9803,792301,37,4,10,3,6,1,4,0,0,0,0,4,1,0,3,0,9
9803,786275,27,2,6,2,4,0,2,0,0,0,7,3,5,0,0,0,4
9803,798089,1,0,0,0,0,0,0,0,0,0,0,0,0,1,0,0,0
9803,792302,7,0,1,0,1,0,0,0,0,0,2,0,0,0,0,0,0
9803,792295,13,0,0,0,0,0,0,0,0,0,0,0,1,0,0,0,0
9803,786280,10,0,1,0,1,0,0,0,0,0,3,0,3,1,1,1,0
9803,786278,22,3,8,3,6,0,2,1,2,0,4,1,5,1,4,0,7
9803,798092,0,0,0,0,0,0,0,0,0,0,0,0,0,0,0,0,0
9804,786805,20,4,7,2,5,2,2,1,1,1,2,0,1,1,0,0,11
9804,774936,21,8,12,8,12,0,0,4,4,3,3,3,1,0,2,1,20
9804,790932,23,3,6,2,3,1,3,1,1,1,3,4,0,1,2,0,8
9804,781345,29,0,1,0,0,0,1,1,2,2,2,6,2,1,2,0,1
9804,786803,23,3,6,2,5,1,1,0,0,0,2,1,2,3,0,0,7
9804,796490,3,0,0,0,0,0,0,0,0,0,1,0,0,0,1,0,0
9804,796488,7,2,2,1,1,1,1,0,2,1,0,1,0,0,0,0,5
9804,790934,12,5,7,2,3,3,4,3,4,1,5,1,0,0,1,0,16
9804,786804,17,4,10,4,4,0,6,3,3,0,2,2,1,2,1,0,11
9804,796489,2,0,1,0,1,0,0,0,0,0,0,0,0,0,0,0,0
9804,796487,7,1,3,1,2,0,1,0,0,1,0,0,1,0,0,0,2
9804,790933,19,2,6,2,5,0,1,1,2,1,1,2,3,1,0,0,5
9804,780033,14,2,2,1,1,1,1,2,2,0,0,2,1,2,0,0,7
9804,780030,3,0,1,0,1,0,0,0,0,0,0,0,0,0,1,1,0
9805,780201,26,0,6,0,6,0,0,2,2,0,1,0,4,0,3,0,2
9805,791469,28,2,4,2,4,0,0,0,0,1,3,0,2,1,0,5,4
9805,797210,37,8,14,7,12,1,2,1,2,0,4,4,2,2,3,0,18
9805,786311,25,3,8,2,4,1,4,0,0,1,0,3,0,0,2,0,7
9805,775516,21,3,5,3,4,0,1,0,0,0,2,0,2,1,4,0,6
9805,798344,18,3,4,3,4,0,0,0,0,2,3,0,3,0,2,1,6
9805,791470,2,2,2,2,2,0,0,0,0,1,0,0,0,0,0,0,4
9805,791471,12,0,1,0,1,0,0,1,2,0,2,1,2,0,0,0,1
9805,791467,31,8,12,3,4,5,8,2,2,0,3,1,2,2,2,2,23
9806,780027,38,10,15,10,13,0,2,4,5,4,5,3,2,1,0,4,24
9806,786176,35,5,13,5,9,0,4,0,1,2,5,1,2,0,1,1,10
9806,786173,31,3,7,2,4,1,3,0,0,0,2,2,2,1,2,0,7
9806,780028,28,0,3,0,0,0,3,0,0,0,4,6,3,3,1,0,0
9806,774828,30,3,9,2,3,1,6,4,4,0,1,3,2,1,2,0,11
9806,797175,15,3,9,3,7,0,2,0,0,3,2,0,2,0,0,3,6
9806,791380,10,1,6,1,6,0,0,0,0,1,2,3,2,0,2,0,2
9806,791379,12,1,2,1,2,0,0,0,0,2,2,0,0,0,0,2,2
9806,797178,1,0,0,0,0,0,0,0,0,0,0,0,0,0,0,0,0
9807,790930,25,1,3,1,3,0,0,0,0,1,4,2,2,2,3,1,2
9807,780358,13,1,2,1,2,0,0,0,0,1,0,0,2,0,1,0,2
9807,775011,28,2,4,1,2,1,2,0,0,2,6,0,1,0,3,1,5
9807,780357,34,3,7,1,2,2,5,2,2,0,3,3,4,0,0,0,10
9807,775018,38,8,17,5,10,3,7,0,0,0,2,2,2,0,2,0,19
9807,776004,27,6,17,5,14,1,3,4,4,4,4,0,3,0,1,1,17
9807,796480,23,1,4,1,4,0,0,0,0,0,5,3,1,1,2,1,2
9807,776270,12,0,3,0,3,0,0,0,0,0,1,1,0,0,0,0,0
9808,781081,35,6,12,6,12,0,0,6,7,5,6,0,2,1,2,1,18
9808,791864,32,3,8,1,3,2,5,0,0,1,2,1,3,2,0,1,8
9808,791863,27,5,10,4,6,1,4,0,0,3,5,1,1,2,1,0,11
9808,786592,39,6,15,5,12,1,3,5,7,2,5,1,4,1,1,0,18
9808,780965,39,1,4,1,1,0,3,2,2,0,4,4,0,1,2,0,4
9808,797473,9,0,0,0,0,0,0,2,2,0,1,0,2,0,0,2,2
9808,786791,2,0,0,0,0,0,0,0,0,0,0,0,0,1,1,0,0
9808,797470,16,4,11,3,7,1,4,5,5,1,1,0,5,1,0,0,14
9808,776447,1,0,0,0,0,0,0,0,0,0,0,0,0,0,0,0,0
9809,792632,34,4,10,4,10,0,0,1,1,5,3,1,3,0,1,0,9
9809,792629,36,3,8,2,5,1,3,3,4,0,6,5,1,0,1,0,10
9809,792631,12,1,4,1,2,0,2,0,0,1,1,1,1,0,0,0,2
9809,781491,28,4,8,4,7,0,1,2,2,1,2,1,3,2,4,0,10
9809,780250,29,5,10,4,8,1,2,5,7,1,6,0,4,0,2,0,16
9809,796637,5,1,2,1,2,0,0,0,0,1,1,0,1,0,4,0,2
9809,796634,5,0,1,0,1,0,0,1,2,2,0,1,2,0,0,1,1
9809,796638,2,0,0,0,0,0,0,0,0,0,0,0,1,0,0,0,0
9809,792627,18,2,5,1,3,1,2,1,2,0,0,0,0,0,0,0,6
9809,792626,31,2,9,1,6,1,3,2,4,2,6,3,4,1,2,0,7
9809,796642,0,0,0,0,0,0,0,0,0,0,0,0,0,0,0,0,0
9810,785518,33,5,9,5,7,0,2,6,8,1,3,5,2,4,3,0,16
9810,796390,14,2,5,2,5,0,0,2,2,1,0,1,3,0,0,1,6
9810,790832,31,4,12,2,6,2,6,2,2,1,0,3,3,0,2,0,12
9810,790834,28,2,10,1,5,1,5,2,2,2,13,3,2,2,2,0,7
9810,785451,30,3,11,3,9,0,2,3,5,4,8,2,2,1,3,0,9
9810,790833,29,7,11,4,6,3,5,0,0,1,2,2,3,1,1,0,17
9810,790831,7,1,2,1,2,0,0,1,2,1,2,0,3,0,3,1,3
9810,790830,21,0,1,0,1,0,0,0,0,0,3,4,1,2,1,0,0
9810,785379,7,0,0,0,0,0,0,0,0,0,0,0,0,1,0,0,0
9811,796754,31,6,12,5,9,1,3,0,3,2,2,4,4,4,2,1,13
9811,796755,4,1,3,1,3,0,0,0,0,0,0,0,0,0,0,0,2
9811,791099,16,1,5,0,0,1,5,0,0,1,1,0,1,0,2,1,3
9811,785586,30,3,10,3,7,0,3,1,2,3,8,3,2,1,3,1,7
9811,780298,38,4,13,1,5,3,8,4,4,1,2,5,5,1,3,1,15
9811,785470,33,2,6,0,1,2,5,5,5,2,4,1,4,1,4,1,11
9811,780814,1,0,0,0,0,0,0,0,0,0,0,0,2,0,0,0,0
9811,790846,28,3,6,3,5,0,1,3,8,1,4,0,1,0,0,3,9
9811,780315,19,0,1,0,1,0,0,2,2,0,2,1,0,1,1,0,2
9811,785588,0,0,0,0,0,0,0,0,0,0,0,0,0,0,0,0,0
9812,790893,30,3,7,1,5,2,2,0,0,3,2,2,0,1,0,1,8
9812,796444,39,11,16,10,13,1,3,3,7,3,6,3,1,0,3,5,26
9812,786615,35,4,10,3,5,1,5,0,2,0,4,0,0,1,0,0,9
9812,786732,21,2,4,2,2,0,2,0,0,0,3,0,2,0,2,0,4
9812,775260,34,4,9,2,7,2,2,1,1,1,4,5,2,0,1,0,11
9812,790890,20,2,5,1,3,1,2,0,0,0,0,2,3,1,3,0,5
9812,775536,11,1,2,1,2,0,0,2,2,1,0,0,2,0,1,0,4
9812,790889,6,0,0,0,0,0,0,0,0,0,2,0,1,0,0,0,0
9812,780702,4,1,1,0,0,1,1,0,0,0,0,0,0,0,0,0,3
9813,775640,13,0,3,0,2,0,1,0,0,1,1,0,2,0,1,1,0
9813,780919,33,3,8,3,8,0,0,0,0,3,3,0,1,0,2,0,6
9813,785803,30,0,2,0,1,0,1,2,2,1,3,2,1,0,0,1,2
9813,780920,32,9,16,5,10,4,6,2,2,0,5,4,1,2,2,0,24
9813,780914,33,3,6,1,2,2,4,1,2,2,2,1,2,1,0,0,9
9813,796799,10,1,2,1,2,0,0,0,0,0,1,0,1,0,0,0,2
9813,796797,7,0,3,0,2,0,1,0,0,0,2,2,2,0,2,1,0
9813,775816,27,6,15,2,7,4,8,3,4,2,5,0,1,0,1,0,19
9813,791142,7,1,2,1,2,0,0,0,0,1,0,1,2,1,1,0,2
9813,791141,8,3,4,1,1,2,3,0,0,0,0,0,0,1,1,0,8
9814,781530,29,3,14,3,12,0,2,11,13,1,5,2,2,2,3,0,17
9814,776423,25,2,4,2,4,0,0,4,4,2,5,2,3,0,0,3,8
9814,798096,28,5,6,4,4,1,2,6,7,0,5,1,1,1,2,0,17
9814,792307,24,2,3,0,0,2,3,3,4,1,1,1,2,0,1,0,9
9814,792319,27,2,4,1,1,1,3,0,0,0,4,1,2,1,1,0,5
9814,792314,18,2,2,2,2,0,0,0,0,2,1,0,2,1,1,2,4
9814,786296,15,2,5,2,3,0,2,0,0,0,1,0,4,1,1,0,4
9814,792320,7,0,1,0,1,0,0,0,0,0,3,0,1,0,0,0,0
9814,798106,5,0,0,0,0,0,0,0,0,0,0,0,0,1,1,0,0
9814,798104,20,5,10,3,5,2,5,2,2,1,0,1,1,0,0,0,14
9814,792321,2,0,1,0,1,0,0,0,0,0,0,0,1,0,0,0,0
9815,776344,29,6,18,2,8,4,10,0,0,1,1,1,4,1,1,0,16
9815,775821,29,6,10,6,8,0,2,4,4,3,7,0,2,0,0,0,16
9815,792453,31,2,9,1,6,1,3,2,2,0,2,5,0,1,3,0,7
9815,785131,30,1,6,0,2,1,4,1,1,1,3,3,5,0,3,0,4
9815,781538,26,2,5,2,2,0,3,2,2,0,2,0,3,0,0,0,6
9815,798113,6,0,0,0,0,0,0,1,2,0,0,0,1,0,0,1,1
9815,785152,5,0,0,0,0,0,0,0,0,0,0,0,1,0,0,0,0
9815,798115,20,0,3,0,0,0,3,0,0,0,1,2,1,0,1,0,0
9815,792324,9,1,3,1,1,0,2,0,0,0,2,0,0,0,0,0,2
9815,776233,15,3,7,3,5,0,2,3,3,2,0,0,3,1,1,0,9
9816,786861,37,4,11,3,6,1,5,5,6,2,4,0,5,2,0,2,14
9816,792417,30,3,8,3,7,0,1,4,4,2,6,1,1,0,2,0,10
9816,786867,24,2,8,2,5,0,3,0,0,0,1,1,0,0,0,0,4
9816,780387,40,5,11,4,8,1,3,9,11,1,7,1,2,3,3,1,20
9816,767033,37,6,17,5,11,1,6,3,4,0,4,3,4,4,3,1,16
9816,796867,0,0,0,0,0,0,0,0,0,0,1,0,0,0,0,0,0
9816,792416,16,0,0,0,0,0,0,0,0,0,0,1,3,0,0,0,0
9816,796869,0,0,0,0,0,0,0,0,0,0,0,0,0,0,0,0,0
9816,796870,8,0,0,0,0,0,0,0,0,0,2,0,0,0,0,0,0
9816,786865,0,0,0,0,0,0,0,0,0,0,0,0,0,0,0,0,0
9816,796864,0,0,0,0,0,0,0,0,0,0,0,0,0,0,0,0,0
9816,786866,8,0,0,0,0,0,0,0,0,2,1,0,0,0,0,0,0
9816,796868,0,0,0,0,0,0,0,0,0,0,0,0,0,0,0,0,0
9817,786406,17,0,4,0,2,0,2,0,0,1,1,0,1,0,0,0,0
9817,780414,33,5,15,4,8,1,7,4,4,2,6,1,4,0,6,0,15
9817,786410,22,1,8,0,2,1,6,0,0,2,1,0,3,0,0,0,3
9817,775095,12,2,3,2,3,0,0,1,2,2,1,0,0,0,0,1,5
9817,791606,37,3,13,2,6,1,7,2,3,1,10,2,3,1,2,1,9
9817,791603,4,1,2,1,1,0,1,0,0,0,0,0,1,0,0,0,2
9817,797020,19,1,2,1,2,0,0,0,0,0,3,1,3,2,3,3,2
9817,792392,4,0,0,0,0,0,0,0,0,0,0,0,0,0,1,0,0
9817,797021,24,1,4,0,1,1,3,0,0,1,2,0,2,0,1,0,3
9817,791605,28,4,10,1,2,3,8,0,0,1,3,1,1,0,1,0,11
9818,785370,24,0,3,0,2,0,1,7,8,3,5,2,3,0,1,0,7
9818,796309,31,9,14,9,14,0,0,3,3,2,6,0,2,1,1,1,21
9818,790824,29,2,10,0,3,2,7,2,2,0,6,4,5,2,0,3,8
9818,780011,39,4,8,2,4,2,4,2,2,0,4,3,0,0,0,0,12
9818,775667,33,1,11,0,7,1,4,7,8,0,1,4,2,0,0,0,10
9818,774895,9,3,4,3,4,0,0,0,0,1,0,0,1,0,0,0,6
9818,796383,12,0,1,0,1,0,0,0,0,0,4,0,2,0,0,1,0
9818,781524,23,1,6,0,3,1,3,0,0,1,0,1,1,0,0,0,3
9819,790873,32,5,14,2,10,3,4,5,5,1,4,3,1,0,2,1,18
9819,785429,17,1,2,0,0,1,2,0,0,1,1,0,0,0,0,0,3
9819,780054,32,3,4,1,2,2,2,1,5,2,3,1,3,0,1,1,9
9819,786851,32,9,20,4,10,5,10,1,3,0,6,4,2,0,1,1,24
9819,781139,20,0,1,0,1,0,0,0,0,2,0,1,4,0,0,0,0
9819,796433,14,2,5,2,5,0,0,0,0,1,4,0,3,0,0,0,4
9819,776245,21,1,4,0,2,1,2,0,0,1,4,0,3,0,2,4,3
9819,776357,28,3,6,3,5,0,1,1,1,0,4,4,3,0,2,0,7
9819,796102,1,0,0,0,0,0,0,0,0,1,0,0,0,0,0,0,0
9819,799973,3,0,1,0,0,0,1,0,0,0,1,0,0,0,0,0,0
9819,796432,0,0,0,0,0,0,0,0,0,0,0,0,0,0,0,0,0
9820,786029,32,4,9,4,9,0,0,3,6,0,7,0,3,1,1,1,11
9820,781398,32,2,6,1,4,1,2,0,0,2,4,3,3,3,3,2,5
9820,792114,37,4,11,1,5,3,6,2,4,0,4,3,3,2,2,0,13
9820,786018,32,2,6,0,1,2,5,0,0,0,2,2,0,1,2,0,6
9820,775678,36,6,16,4,11,2,5,0,0,0,4,5,2,1,3,1,14
9820,797746,16,1,4,1,1,0,3,0,0,1,4,1,1,0,1,1,2
9820,797740,8,3,3,2,2,1,1,0,0,0,0,1,1,0,0,0,7
9820,797737,7,0,0,0,0,0,0,1,2,0,0,0,1,0,2,1,1
9821,781107,19,2,4,2,4,0,0,1,2,0,1,0,2,0,3,3,5
9821,791972,32,1,4,0,1,1,3,5,6,1,8,0,3,0,4,0,8
9821,796777,29,3,9,3,7,0,2,0,0,0,0,4,0,1,1,0,6
9821,791974,28,2,7,2,6,0,1,2,3,0,4,1,2,2,2,0,6
9821,780863,15,3,6,2,4,1,2,2,4,2,3,3,0,1,1,0,9
9821,796778,28,4,12,4,10,0,2,1,3,3,8,1,3,3,4,3,9
9821,796780,26,4,6,2,2,2,4,0,0,0,4,1,1,2,1,0,10
9821,785366,23,3,7,2,4,1,3,0,0,0,1,4,1,0,0,0,7
9822,785536,5,0,3,0,1,0,2,0,0,0,0,0,0,0,0,1,0
9822,780119,39,10,13,10,13,0,0,1,3,4,3,2,2,0,5,1,21
9822,796558,35,2,7,2,6,0,1,2,2,2,6,5,2,4,1,0,6
9822,796559,39,8,16,4,6,4,10,8,12,3,6,1,4,2,3,0,28
9822,776097,25,1,6,0,2,1,4,0,2,0,5,4,4,0,1,1,3
9822,785285,26,2,4,2,4,0,0,0,0,4,3,1,2,0,1,3,4
9822,780149,27,4,14,3,7,1,7,0,0,2,1,3,1,3,3,0,9
9822,785280,4,0,2,0,0,0,2,0,0,0,1,0,1,0,2,0,0
9823,791522,38,4,11,3,10,1,1,0,1,1,6,1,1,3,5,0,9
9823,786351,28,5,9,3,4,2,5,1,1,1,7,0,3,0,1,0,13
9823,797146,40,6,18,2,12,4,6,5,5,1,1,2,1,3,2,1,21
9823,786348,6,0,1,0,1,0,0,0,0,0,0,0,0,0,0,0,0
9823,797143,40,7,16,6,11,1,5,4,4,2,2,4,1,2,4,0,19
9823,785816,15,2,2,2,2,0,0,0,0,2,6,0,2,1,1,0,4
9823,797142,12,1,2,1,2,0,0,0,0,1,0,0,3,0,0,0,2
9823,797147,21,3,7,2,5,1,2,3,4,2,3,1,3,1,1,1,10
9824,785287,17,3,4,3,4,0,0,0,0,1,1,0,2,0,1,0,6
9824,776286,31,3,6,3,4,0,2,9,9,3,4,2,4,0,0,1,15
9824,791445,38,5,15,3,5,2,10,2,2,0,4,0,3,0,1,0,14
9824,785357,38,7,15,2,7,5,8,2,2,2,4,2,3,4,2,1,21
9824,775560,37,4,7,4,5,0,2,3,4,0,5,3,3,1,6,1,11
9824,781627,6,0,2,0,2,0,0,0,0,0,2,0,2,0,0,1,0
9824,797010,15,0,3,0,3,0,0,3,4,0,1,2,1,0,2,0,3
9824,775557,15,3,3,3,3,0,0,0,1,2,1,1,3,0,0,1,6
9824,797012,3,0,0,0,0,0,0,0,0,0,0,0,0,0,0,0,0
9825,785518,25,5,12,5,11,0,1,6,7,1,0,3,5,1,4,1,16
9825,796390,19,4,7,4,7,0,0,0,0,4,3,1,1,0,1,1,8
9825,790832,33,9,16,4,8,5,8,4,10,0,3,2,3,4,3,0,27
9825,790834,31,1,3,0,1,1,2,2,4,1,3,0,4,2,0,0,5
9825,785451,26,1,3,0,0,1,3,1,2,0,2,0,3,1,2,0,4
9825,790833,29,4,8,4,5,0,3,2,4,1,1,0,2,0,2,1,10
9825,790831,15,0,0,0,0,0,0,0,0,0,0,2,1,1,1,0,0
9825,790830,21,2,4,2,3,0,1,0,0,0,5,1,1,0,1,0,4
9825,785379,1,0,0,0,0,0,0,0,0,0,0,0,0,0,0,0,0
9826,781081,20,0,1,0,1,0,0,2,2,1,4,0,4,0,1,0,2
9826,791864,24,5,16,4,9,1,7,2,4,4,3,1,5,0,3,0,13
9826,791863,19,2,4,2,3,0,1,0,0,2,1,0,2,1,1,0,4
9826,786592,30,6,13,4,10,2,3,0,3,2,0,0,2,1,0,0,14
9826,780965,27,1,3,1,1,0,2,0,0,0,2,3,3,2,2,0,2
9826,797473,12,1,1,1,1,0,0,0,1,2,1,0,0,0,0,1,2
9826,786791,13,2,2,2,2,0,0,0,0,3,5,0,2,0,1,1,4
9826,797470,20,3,12,2,7,1,5,3,4,0,2,1,4,0,2,0,10
9826,797472,28,2,11,1,4,1,7,0,0,1,2,0,1,1,3,0,5
9826,776447,5,2,8,1,3,1,5,0,0,2,0,0,0,0,0,0,5
9826,791865,2,0,0,0,0,0,0,0,0,0,0,0,0,0,0,0,0
9827,799000,34,7,11,7,11,0,0,2,4,3,9,1,4,2,2,1,16
9827,785471,21,5,6,5,6,0,0,0,1,1,1,2,4,0,2,1,10
9827,775198,35,3,6,3,4,0,2,9,9,2,6,1,1,1,1,0,15
9827,786697,34,4,10,2,6,2,4,5,8,1,2,6,2,1,2,1,15
9827,775628,33,5,12,5,9,0,3,3,5,1,5,3,4,2,3,0,13
9827,792399,6,0,0,0,0,0,0,0,0,0,2,0,0,0,0,0,0
9827,780263,18,4,7,3,4,1,3,0,0,0,2,0,1,0,1,0,9
9827,775547,2,1,1,1,1,0,0,0,0,1,1,0,0,0,0,0,2
9827,798999,2,0,0,0,0,0,0,0,0,0,1,0,0,0,0,0,0
9827,792397,2,0,1,0,1,0,0,0,0,0,0,0,0,0,0,0,0
9827,780571,11,0,3,0,1,0,2,0,0,0,0,0,0,1,0,0,0
9827,786695,2,0,0,0,0,0,0,0,0,0,0,0,0,0,0,0,0
9828,785714,20,1,6,1,6,0,0,0,4,1,3,2,4,1,4,1,2
9828,775894,28,1,8,1,4,0,4,3,4,1,2,0,2,0,2,0,5
9828,785711,34,7,8,4,4,3,4,0,0,1,3,4,3,1,2,0,17
9828,780985,29,3,8,1,2,2,6,0,0,0,5,2,0,0,1,0,8
9828,775266,28,1,13,0,3,1,10,0,0,0,0,2,1,3,0,0,3
9828,779994,21,3,12,0,4,3,8,2,2,1,2,0,2,0,0,0,11
9828,785378,16,0,2,0,1,0,1,0,0,2,2,2,2,0,1,0,0
9828,796829,13,1,1,1,1,0,0,0,2,1,1,0,2,0,0,0,2
9828,791169,2,0,0,0,0,0,0,0,0,0,2,0,0,0,1,0,0
9828,780988,3,0,1,0,0,0,1,0,0,0,1,0,0,1,0,0,0
9828,785710,6,0,0,0,0,0,0,0,0,0,0,0,0,0,0,0,0
9829,786857,28,7,13,4,6,3,7,2,2,4,4,0,1,1,1,2,19
9829,781403,32,0,3,0,1,0,2,2,3,0,3,3,2,2,2,0,2
9829,792654,32,5,6,5,6,0,0,1,7,2,10,1,3,1,4,1,11
9829,797301,34,4,14,4,9,0,5,2,2,2,6,5,2,1,1,0,10
9829,780524,23,3,4,0,1,3,3,0,0,1,1,2,1,0,0,0,9
9829,792653,5,1,2,1,2,0,0,0,0,1,1,0,0,1,0,0,2
9829,781400,25,6,12,2,5,4,7,2,2,1,4,1,0,0,3,0,18
9829,797304,8,0,2,0,1,0,1,0,2,1,1,0,1,0,0,0,0
9829,797303,3,0,1,0,0,0,1,0,0,0,2,0,0,1,1,0,0
9829,797306,4,1,1,1,1,0,0,0,0,0,0,0,0,0,0,0,2
9829,797305,3,0,0,0,0,0,0,0,0,0,0,0,1,0,0,0,0
9829,797302,3,0,0,0,0,0,0,0,0,0,0,0,0,0,0,0,0
9830,791241,32,6,8,5,5,1,3,2,2,0,3,0,2,0,3,0,15
9830,781244,27,6,15,6,14,0,1,2,3,2,12,1,4,0,0,1,14
9830,785537,37,4,10,3,9,1,1,3,4,3,0,3,1,1,3,0,12
9830,781243,35,2,10,2,3,0,7,5,5,0,10,1,3,2,3,3,9
9830,781237,32,3,4,1,1,2,3,1,2,0,1,1,3,0,0,0,9
9830,791243,6,0,0,0,0,0,0,0,0,0,0,0,0,0,0,0,0
9830,791245,23,0,2,0,1,0,1,4,4,1,1,2,1,0,3,0,4
9830,776205,8,0,3,0,1,0,2,2,4,1,0,1,0,1,1,0,2
9831,775705,7,0,0,0,0,0,0,0,0,0,0,0,2,0,0,0,0
9831,791652,33,6,10,6,10,0,0,0,0,7,3,0,5,0,3,0,12
9831,786495,25,3,11,3,8,0,3,9,11,1,7,0,2,3,1,0,15
9831,791650,22,3,8,3,7,0,1,0,0,0,0,0,2,1,4,0,6
9831,776384,23,1,5,1,3,0,2,0,0,0,2,1,0,0,2,0,2
9831,797284,1,1,2,0,0,1,2,0,0,0,1,0,0,0,0,0,3
9831,791653,17,0,4,0,1,0,3,0,0,0,1,0,1,0,0,0,0
9831,791654,4,0,0,0,0,0,0,0,0,0,0,0,1,0,0,0,0
9831,797289,25,1,5,1,4,0,1,5,6,0,6,1,4,1,1,0,7
9831,797286,16,3,8,3,5,0,3,1,2,0,1,0,2,3,0,0,7
9831,797285,6,0,1,0,0,0,1,0,0,0,0,0,0,0,0,0,0
9831,797283,19,1,1,0,0,1,1,0,0,0,2,0,0,0,1,0,3
9831,791651,2,0,0,0,0,0,0,0,0,0,0,0,0,0,0,0,0
9832,776100,26,3,6,3,6,0,0,2,3,2,1,0,0,0,0,0,8
9832,785991,42,3,12,2,6,1,6,6,6,2,9,2,5,0,2,1,13
9832,797762,21,1,6,1,3,0,3,0,1,0,0,1,3,0,2,1,2
9832,781406,44,2,8,2,7,0,1,2,3,0,3,3,2,2,4,1,6
9832,781401,37,3,5,2,2,1,3,7,7,1,3,2,2,3,4,0,14
9832,792133,35,4,10,1,4,3,6,0,0,1,3,2,0,1,3,0,11
9832,781029,20,1,3,0,0,1,3,0,0,1,1,1,2,0,0,0,3
9833,791883,41,2,10,1,3,1,7,1,2,2,7,1,3,0,2,3,6
9833,781066,38,6,11,6,11,0,0,0,0,3,2,1,4,0,0,0,12
9833,797594,37,4,9,1,2,3,7,2,2,1,2,2,3,2,1,1,13
9833,791884,45,7,17,5,14,2,3,4,4,1,3,5,0,0,6,0,20
9833,780695,38,2,7,0,3,2,4,2,2,0,9,2,4,1,2,0,8
9833,797598,3,1,1,1,1,0,0,0,0,1,1,0,2,0,1,0,2
9833,786496,22,0,1,0,0,0,1,0,0,0,1,1,1,1,2,0,0
9833,797597,1,0,0,0,0,0,0,0,0,0,0,0,0,0,0,0,0
9833,791885,0,0,0,0,0,0,0,0,0,0,0,0,0,0,0,0,0
9834,776279,28,3,9,2,3,1,6,2,5,0,0,2,0,0,1,0,9
9834,781505,28,3,10,3,5,0,5,1,1,2,3,3,4,0,1,0,7
9834,780353,30,5,9,5,9,0,0,2,2,3,5,1,1,0,0,0,12
9834,791317,36,7,10,4,6,3,4,2,2,3,4,2,1,3,0,0,19
9834,777573,27,2,6,1,4,1,2,5,6,0,4,0,2,0,3,0,10
9834,791318,1,1,1,1,1,0,0,0,0,0,1,0,0,0,0,0,2
9834,786222,20,2,3,2,3,0,0,0,0,0,6,1,3,0,1,0,4
9834,785966,1,0,0,0,0,0,0,0,0,0,0,0,0,0,0,0,0
9834,796646,1,0,0,0,0,0,0,0,0,0,0,1,1,0,0,0,0
9834,796647,1,0,0,0,0,0,0,0,0,0,0,0,0,0,0,0,0
9834,796649,16,3,5,0,1,3,4,0,0,0,4,0,1,1,2,0,9
9834,790851,11,0,2,0,2,0,0,2,2,1,0,1,0,0,0,0,2
9835,781577,31,4,10,2,6,2,4,1,2,0,5,0,3,0,2,0,11
9835,775910,36,1,8,1,3,0,5,2,2,2,3,1,4,1,1,1,4
9835,786451,28,2,5,1,1,1,4,0,0,1,1,0,1,0,1,0,5
9835,780600,34,5,12,3,6,2,6,0,0,1,2,1,2,1,2,1,12
9835,781387,37,6,13,2,2,4,11,2,2,0,1,2,4,2,1,0,18
9835,800084,1,0,1,0,1,0,0,2,3,0,0,0,0,0,0,0,2
9835,791763,9,0,1,0,0,0,1,0,0,0,1,0,1,0,0,0,0
9835,786456,3,0,0,0,0,0,0,0,0,0,1,1,1,0,0,0,0
9835,797561,3,0,0,0,0,0,0,0,0,0,0,0,0,0,1,0,0
9835,780020,16,2,5,2,4,0,1,0,0,0,1,0,1,0,0,0,4
9835,793065,1,0,0,0,0,0,0,0,0,0,0,0,0,0,0,0,0
9835,786457,1,0,0,0,0,0,0,0,0,0,0,0,0,0,0,0,0
9836,786704,29,4,7,4,7,0,0,5,6,2,9,1,2,1,2,0,13
9836,785395,30,8,14,5,7,3,7,0,1,0,3,2,1,1,0,0,19
9836,775840,35,3,9,3,7,0,2,2,2,2,1,2,2,3,2,0,8
9836,775955,39,7,13,3,6,4,7,4,5,0,1,3,1,1,1,0,22
9836,775811,19,1,3,0,1,1,2,0,0,1,2,1,0,0,0,0,3
9836,786706,11,3,6,3,6,0,0,2,4,3,2,0,1,1,0,0,8
9836,775287,10,0,2,0,0,0,2,0,0,0,1,1,2,0,0,0,0
9836,790921,18,3,3,3,3,0,0,0,1,0,4,2,4,1,1,0,6
9836,786551,9,0,1,0,0,0,1,0,0,1,0,0,0,0,0,0,0
9837,781530,29,10,19,10,17,0,2,2,2,0,4,0,1,1,2,1,22
9837,776423,22,1,5,1,5,0,0,2,2,2,6,2,3,0,2,0,4
9837,798096,28,3,8,3,7,0,1,1,2,1,4,0,1,2,0,0,7
9837,792307,21,0,2,0,1,0,1,0,0,0,4,0,1,0,0,0,0
9837,792319,24,2,3,1,1,1,2,0,0,0,0,1,0,0,2,0,5
9837,792316,1,0,1,0,1,0,0,0,0,0,0,0,1,0,0,0,0
9837,792314,21,3,4,3,4,0,0,3,4,2,1,0,1,0,1,3,9
9837,786296,16,0,1,0,1,0,0,0,0,0,0,1,1,0,0,0,0
9837,792320,6,1,1,1,1,0,0,0,0,1,0,0,3,0,0,0,2
9837,798104,22,3,8,2,4,1,4,4,4,0,2,1,3,0,3,0,11
9837,792309,7,1,2,0,0,1,2,0,0,0,0,0,2,0,0,0,3
9837,798106,2,0,0,0,0,0,0,0,0,0,0,0,0,0,0,0,0
9837,792321,1,0,0,0,0,0,0,0,0,0,0,0,0,0,0,0,0
9838,775503,34,6,11,4,5,2,6,0,1,2,5,1,2,1,3,0,14
9838,786474,30,5,11,3,7,2,4,5,5,0,4,1,2,3,1,0,17
9838,791777,39,5,13,4,11,1,2,1,1,0,7,5,1,3,3,2,12
9838,776285,6,1,3,1,3,0,0,0,0,1,1,0,5,0,1,0,2
9838,781025,32,3,6,2,4,1,2,0,2,4,4,4,1,1,3,1,7
9838,791778,15,2,3,2,3,0,0,0,0,0,1,0,2,0,0,0,4
9838,780488,15,1,7,0,1,1,6,5,5,0,0,3,2,1,0,0,8
9838,791829,18,2,5,2,2,0,3,3,3,0,2,3,3,0,3,1,7
9838,786476,11,0,0,0,0,0,0,0,0,0,0,0,4,0,0,0,0
9839,788113,37,5,11,4,8,1,3,2,3,2,6,0,0,0,1,1,13
9839,776497,11,1,2,1,1,0,1,1,3,1,0,0,4,1,2,1,3
9839,785729,31,3,9,3,9,0,0,3,4,1,2,3,2,1,3,0,9
9839,785731,29,3,8,3,8,0,0,2,5,2,7,0,2,1,3,0,8
9839,780864,27,3,9,2,4,1,5,2,2,0,2,2,3,2,3,0,9
9839,792402,12,1,1,1,1,0,0,1,2,1,1,1,2,0,0,1,3
9839,796211,18,0,1,0,1,0,0,0,0,2,3,0,2,0,1,1,0
9839,786231,30,5,15,4,7,1,8,5,6,1,4,0,3,2,4,0,16
9839,797298,2,0,0,0,0,0,0,0,0,0,0,0,0,0,0,0,0
9839,799881,3,1,1,1,1,0,0,0,0,1,0,0,0,0,0,0,2
9840,776110,10,1,3,0,0,1,3,0,0,0,1,0,3,1,3,0,3
9840,780059,35,6,18,6,15,0,3,8,11,6,7,4,3,3,4,1,20
9840,796496,27,1,3,0,1,1,2,4,4,3,5,0,2,1,0,1,7
9840,790944,25,1,4,1,2,0,2,0,0,0,0,1,2,0,1,0,2
9840,780061,36,3,13,0,2,3,11,0,0,1,3,2,3,3,3,0,9
9840,780058,16,4,11,3,6,1,5,1,1,2,3,0,2,1,2,2,10
9840,790941,11,1,2,1,2,0,0,1,1,1,2,0,0,0,0,0,3
9840,790943,9,0,0,0,0,0,0,0,0,0,0,0,1,1,3,0,0
9840,786754,31,8,13,7,11,1,2,2,2,0,3,2,1,0,1,0,19
9841,781006,39,2,6,1,2,1,4,2,2,2,3,1,2,1,1,2,7
9841,796194,29,3,7,0,1,3,6,2,2,0,5,4,3,3,2,0,11
9841,796464,36,8,16,7,13,1,3,3,4,4,5,1,3,2,5,1,20
9841,796459,36,7,17,5,14,2,3,2,2,1,3,3,2,2,5,1,18
9841,790917,17,2,4,2,2,0,2,0,0,0,6,1,5,1,2,1,4
9841,781157,22,1,5,1,2,0,3,2,2,0,2,1,1,1,2,0,4
9841,785238,17,2,4,2,4,0,0,0,0,2,1,2,2,1,1,0,4
9841,790918,3,0,1,0,1,0,0,0,0,0,0,0,0,0,1,1,0
9841,790916,1,0,0,0,0,0,0,0,2,0,1,0,0,0,0,2,0
9842,791416,24,11,17,11,17,0,0,4,7,4,4,1,4,0,0,1,26
9842,797096,21,2,7,0,1,2,6,2,2,0,2,2,0,0,0,0,8
9842,785906,38,7,16,7,15,0,1,4,5,0,7,9,1,0,5,0,18
9842,781614,22,2,4,2,2,0,2,0,0,0,1,1,0,2,1,0,4
9842,780096,31,3,10,2,5,1,5,2,2,0,1,5,1,1,0,2,9
9842,785907,13,1,3,1,3,0,0,1,2,2,2,0,4,1,1,0,3
9842,797093,28,6,8,6,7,0,1,0,0,0,7,3,2,3,0,1,12
9842,780100,20,0,1,0,1,0,0,2,2,2,7,1,2,0,1,2,2
9842,791415,3,0,0,0,0,0,0,0,0,0,0,0,0,0,0,0,0
9843,780027,34,8,21,8,18,0,3,5,6,3,9,2,4,3,3,1,21
9843,786176,37,4,12,1,5,3,7,1,2,3,4,1,2,1,0,1,12
9843,786173,22,2,5,2,5,0,0,0,0,0,1,1,0,0,1,0,4
9843,780028,27,0,0,0,0,0,0,2,2,0,5,3,4,0,2,1,2
9843,774828,38,6,15,1,2,5,13,3,4,0,2,6,2,1,2,0,20
9843,797175,20,2,5,2,4,0,1,0,0,0,4,1,2,0,1,0,4
9843,791379,11,2,2,2,2,0,0,0,0,0,1,2,1,0,1,0,4
9843,791380,5,0,0,0,0,0,0,0,0,0,1,2,0,0,2,0,0
9843,797177,1,0,0,0,0,0,0,0,0,0,0,0,1,0,0,0,0
9843,797178,5,2,4,2,4,0,0,0,0,0,1,1,2,0,0,0,4
9844,796956,4,0,1,0,1,0,0,0,0,0,0,0,0,0,0,0,0
9844,791838,24,0,3,0,0,0,3,2,2,0,2,0,0,1,0,1,2
9844,786620,37,2,8,1,2,1,6,8,8,0,8,1,3,3,3,0,13
9844,781606,38,3,9,2,5,1,4,3,4,1,2,3,3,0,1,0,10
9844,781257,33,4,10,1,5,3,5,0,0,0,4,0,2,0,3,0,11
9844,796955,18,3,5,3,5,0,0,0,3,3,0,1,2,0,0,0,6
9844,791256,1,0,0,0,0,0,0,0,0,0,0,0,0,0,0,0,0
9844,791255,13,1,3,1,3,0,0,0,0,1,1,0,3,0,0,1,2
9844,781263,32,3,14,3,11,0,3,1,2,1,4,1,5,0,2,0,7
9845,797163,33,5,7,5,7,0,0,2,3,3,8,2,2,1,2,3,12
9845,797164,16,1,1,1,1,0,0,0,0,1,2,1,3,0,0,0,2
9845,786450,39,2,5,2,4,0,1,2,5,1,3,4,3,0,4,0,6
9845,776396,37,5,14,4,9,1,5,2,2,0,5,1,2,2,2,0,13
9845,776199,32,5,13,3,5,2,8,6,6,0,4,1,1,0,1,1,18
9845,797167,6,0,0,0,0,0,0,0,0,2,0,0,0,1,0,0,0
9845,791385,24,4,7,3,6,1,1,0,0,1,3,0,4,0,1,0,9
9845,797161,1,0,0,0,0,0,0,0,0,0,0,0,0,0,0,0,0
9845,797165,8,0,2,0,1,0,1,0,0,0,1,0,1,0,1,0,0
9845,791382,4,0,1,0,1,0,0,0,0,0,1,0,0,1,1,0,0
9846,790923,18,5,8,4,6,1,2,2,4,2,3,0,4,0,1,0,13
9846,779981,35,8,11,8,11,0,0,5,10,6,8,2,1,3,4,2,21
9846,785463,25,1,9,1,5,0,4,1,2,0,3,5,2,1,2,0,3
9846,779978,37,10,14,6,9,4,5,6,6,0,1,1,2,0,3,0,30
9846,776003,36,1,8,0,4,1,4,10,10,0,1,2,1,1,2,0,13
9846,796469,6,0,2,0,1,0,1,0,0,1,1,0,3,0,2,0,0
9846,779979,18,0,2,0,1,0,1,4,4,0,0,0,1,0,0,0,4
9846,785466,25,3,3,2,2,1,1,0,0,1,7,1,4,3,1,2,7
9847,796439,22,5,9,5,9,0,0,1,2,3,4,0,5,0,2,0,11
9847,790884,29,4,6,4,6,0,0,4,6,1,5,2,2,1,0,2,12
9847,791635,6,1,3,1,1,0,2,0,0,0,0,0,0,2,1,0,2
9847,790883,37,4,10,4,7,0,3,2,2,1,2,3,5,1,4,1,10
9847,796436,33,11,23,6,11,5,12,2,2,0,3,3,3,2,1,0,29
9847,796438,26,4,5,3,3,1,2,0,0,1,2,1,4,1,1,0,9
9847,785436,33,4,7,3,6,1,1,4,5,1,2,6,3,2,3,0,13
9847,796442,4,0,0,0,0,0,0,0,0,2,0,0,0,0,1,0,0
9847,790885,6,0,2,0,1,0,1,0,0,0,2,0,0,0,0,0,0
9847,781262,4,0,0,0,0,0,0,0,0,0,0,0,0,0,0,0,0
9848,786157,24,4,7,4,7,0,0,2,4,3,5,1,3,1,2,2,10
9848,780676,36,4,11,4,8,0,3,6,6,1,3,1,3,2,2,1,14
9848,791756,28,5,9,5,9,0,0,0,0,0,2,3,3,3,1,0,10
9848,780992,20,4,7,3,3,1,4,0,0,0,2,1,0,0,0,0,9
9848,780677,32,3,8,2,4,1,4,2,2,1,2,0,0,0,0,1,9
9848,791754,11,1,2,1,2,0,0,2,2,1,1,0,1,0,0,1,4
9848,775533,12,3,5,3,4,0,1,0,0,2,2,0,4,0,1,0,6
9848,797348,14,1,5,1,5,0,0,0,0,1,1,1,3,2,1,0,2
9848,780673,18,0,3,0,0,0,3,2,2,0,0,0,2,1,0,0,2
9848,786150,5,1,1,1,1,0,0,0,1,0,0,0,1,1,0,0,2
9849,781579,30,3,6,2,5,1,1,5,6,3,3,1,3,1,3,0,12
9849,786731,34,7,11,7,11,0,0,4,4,2,4,0,2,0,3,3,18
9849,798023,33,4,13,4,10,0,3,0,0,1,3,4,3,0,4,1,8
9849,781584,35,1,6,0,1,1,5,1,1,0,2,0,1,0,1,0,4
9849,780347,37,1,6,1,4,0,2,5,7,2,6,4,3,1,3,0,7
9849,775696,21,3,8,2,6,1,2,1,1,1,1,1,0,0,1,0,8
9849,798008,7,0,1,0,1,0,0,0,0,0,0,0,0,0,1,0,0
9849,798017,3,0,0,0,0,0,0,0,0,1,1,0,0,0,0,0,0
9850,785495,29,2,7,1,5,1,2,4,4,1,2,0,1,1,2,0,9
9850,785958,37,6,12,6,12,0,0,4,7,4,7,0,4,0,3,1,16
9850,785659,27,2,6,1,3,1,3,2,5,3,3,1,2,1,2,0,7
9850,785494,39,8,22,7,16,1,6,7,7,1,1,2,4,0,2,0,24
9850,780698,36,4,14,2,8,2,6,3,4,3,5,3,4,0,5,2,13
9850,785490,9,0,1,0,0,0,1,0,0,1,3,0,0,0,0,0,0
9850,775377,11,0,0,0,0,0,0,0,0,1,0,1,2,0,0,2,0
9850,791130,4,0,2,0,1,0,1,0,0,0,0,0,1,0,0,0,0
9850,780427,5,0,0,0,0,0,0,0,0,0,0,0,2,0,0,0,0
9850,791034,3,0,0,0,0,0,0,0,0,0,0,0,0,0,0,0,0
9851,792197,27,6,9,4,7,2,2,6,6,0,2,0,0,1,4,0,20
9851,781132,37,3,9,0,4,3,5,0,0,0,5,5,5,2,0,0,9
9851,797517,33,8,14,8,14,0,0,1,1,4,3,1,3,1,1,0,17
9851,791940,29,1,7,1,6,0,1,1,3,1,1,0,2,0,0,1,3
9851,786534,38,9,16,6,9,3,7,1,3,0,6,7,2,5,2,0,22
9851,797522,4,1,1,1,1,0,0,0,0,0,0,0,4,0,0,0,2
9851,791939,2,0,0,0,0,0,0,0,0,1,0,0,1,0,0,0,0
9851,797518,13,1,1,1,1,0,0,6,6,0,3,1,1,0,0,1,8
9851,791938,17,0,1,0,1,0,0,3,4,0,3,3,0,0,2,0,3
9852,781300,21,3,4,3,4,0,0,2,4,1,0,0,3,0,0,0,8
9852,790803,26,4,9,4,9,0,0,3,4,5,5,0,4,0,3,2,11
9852,790801,12,0,0,0,0,0,0,2,2,0,1,2,0,0,3,0,2
9852,781304,27,6,10,3,5,3,5,0,0,1,3,1,5,0,8,0,15
9852,781302,32,4,8,3,5,1,3,1,1,1,6,4,3,1,1,1,10
9852,796360,29,8,10,6,8,2,2,3,3,3,1,3,2,0,6,0,21
9852,796364,8,1,3,1,3,0,0,0,0,1,0,0,3,0,0,1,2
9852,780598,22,1,2,0,1,1,1,0,0,0,3,1,2,0,1,0,3
9852,796363,12,0,2,0,0,0,2,0,0,0,1,0,0,0,2,0,0
9852,781305,11,1,2,0,0,1,2,0,0,0,2,1,1,0,0,1,3
9853,785355,18,3,8,2,2,1,6,0,0,2,0,0,1,0,1,0,7
9853,781462,36,5,13,5,13,0,0,5,9,6,2,2,3,2,1,3,15
9853,780876,33,5,13,4,7,1,6,4,4,1,2,3,3,2,1,0,15
9853,785353,37,8,12,6,8,2,4,2,2,0,3,3,0,2,3,1,20
9853,781457,40,4,11,4,7,0,4,5,7,2,3,3,2,5,0,0,13
9853,791305,7,0,0,0,0,0,0,0,0,0,0,0,2,1,0,0,0
9853,790895,20,0,1,0,1,0,0,5,6,0,0,2,1,2,0,0,5
9853,781673,9,2,4,1,1,1,3,0,0,1,0,0,1,1,1,0,5
9854,775806,19,1,6,1,4,0,2,1,1,0,4,0,0,0,1,0,3
9854,781011,32,3,7,3,6,0,1,0,1,3,3,1,3,1,2,3,6
9854,797601,39,6,15,3,4,3,11,1,2,0,3,5,2,3,2,0,16
9854,781012,37,5,13,4,7,1,6,0,2,4,3,1,1,2,3,1,11
9854,775119,23,1,7,1,6,0,1,0,1,1,2,0,1,2,2,0,2
9854,797602,1,0,0,0,0,0,0,0,0,1,1,0,0,0,1,0,0
9854,775188,8,0,0,0,0,0,0,0,0,0,1,0,1,0,1,0,0
9854,775563,20,3,9,3,8,0,1,0,2,3,2,0,2,1,2,1,6
9854,797604,3,0,1,0,1,0,0,0,0,0,0,0,0,1,1,0,0
9854,797605,1,0,1,0,1,0,0,0,0,0,0,0,0,0,0,0,0
9854,786466,16,0,5,0,0,0,5,1,2,0,1,1,2,0,0,1,1
9854,791770,1,0,0,0,0,0,0,0,0,0,0,0,0,0,0,0,0
9855,786805,28,5,8,3,6,2,2,1,2,4,4,3,2,1,1,0,13
9855,774936,20,3,10,3,9,0,1,1,1,1,5,1,0,0,0,0,7
9855,790932,25,5,13,4,10,1,3,0,0,1,3,6,3,4,2,0,11
9855,781345,33,4,8,1,4,3,4,0,0,2,8,1,4,2,2,0,11
9855,786803,29,6,7,5,6,1,1,0,0,0,3,3,2,2,2,1,13
9855,796490,1,1,1,0,0,1,1,0,0,0,0,0,0,0,0,0,3
9855,796488,1,0,0,0,0,0,0,0,0,0,1,0,0,0,0,0,0
9855,790934,20,1,4,0,1,1,3,2,2,1,7,3,3,1,4,0,5
9855,786804,10,0,3,0,0,0,3,2,2,2,4,0,0,0,1,0,2
9855,796487,1,0,0,0,0,0,0,0,0,0,0,1,0,0,0,0,0
9855,790933,20,2,6,1,5,1,1,4,4,1,2,1,0,1,2,1,9
9855,780033,10,2,3,1,1,1,2,0,0,1,1,0,1,0,2,1,5
9855,780030,1,0,1,0,0,0,1,0,0,0,0,0,0,1,0,0,0
9855,796489,1,0,0,0,0,0,0,0,0,0,0,0,0,0,0,0,0
9856,780914,27,3,5,0,1,3,4,2,4,0,1,0,3,0,0,0,11
9856,785803,28,1,3,1,2,0,1,0,0,0,0,0,3,0,2,0,2
9856,780920,37,6,13,5,10,1,3,5,8,2,4,7,2,0,3,1,18
9856,780919,28,7,9,7,9,0,0,2,3,4,4,1,2,0,0,0,16
9856,775640,13,1,3,1,2,0,1,0,1,1,3,0,0,0,0,0,2
9856,775816,24,2,10,2,5,0,5,2,2,1,4,1,1,0,0,0,6
9856,796799,9,1,2,1,1,0,1,0,0,0,0,0,0,1,0,0,2
9856,796797,14,1,5,0,2,1,3,1,2,3,2,1,3,1,1,0,4
9856,791142,17,2,2,1,1,1,1,0,0,0,1,0,1,0,1,0,5
9856,791141,3,1,1,1,1,0,0,0,0,0,0,0,0,0,1,0,2
9857,790850,33,3,8,1,1,2,7,6,7,0,2,3,2,1,0,0,14
9857,781163,30,3,9,2,5,1,4,0,0,0,6,4,4,0,1,0,7
9857,781164,27,3,4,2,3,1,1,0,0,0,1,1,3,0,1,0,7
9857,796404,29,4,8,4,8,0,0,0,1,3,4,2,2,0,2,0,8
9857,790853,17,2,4,2,4,0,0,1,2,1,0,1,3,1,1,1,5
9857,796406,12,1,1,1,1,0,0,1,2,2,3,0,2,0,0,0,3
9857,785434,21,6,11,3,5,3,6,0,0,2,1,1,1,0,1,0,15
9857,790849,27,3,6,1,3,2,3,2,2,0,2,2,2,1,0,0,10
9857,781223,4,0,1,0,0,0,1,1,2,0,0,0,0,0,0,0,1
9858,791140,22,4,7,4,7,0,0,0,0,3,1,2,3,0,0,0,8
9858,791138,32,4,4,2,2,2,2,1,2,1,1,1,3,3,0,0,11
9858,786084,32,6,12,2,6,4,6,1,2,1,4,4,2,1,1,0,17
9858,780910,30,6,11,4,7,2,4,2,2,0,3,4,1,2,5,0,16
9858,780288,29,3,10,0,5,3,5,1,1,0,4,3,1,0,1,0,10
9858,796794,4,0,1,0,0,0,1,0,0,0,0,0,0,0,0,0,0
9858,796795,18,2,4,2,4,0,0,1,2,1,3,1,3,0,1,1,5
9858,780912,3,1,2,1,1,0,1,0,0,0,1,0,1,0,0,0,2
9858,780911,24,5,8,2,4,3,4,3,5,0,3,1,1,3,0,0,16
9858,781635,6,0,0,0,0,0,0,0,0,0,0,2,0,0,0,0,0
9859,791548,39,5,13,4,8,1,5,2,2,2,5,3,1,0,3,1,13
9859,791550,21,2,3,2,3,0,0,0,4,2,4,0,1,0,1,0,4
9859,791552,19,1,6,0,3,1,3,1,2,0,2,2,5,0,2,0,4
9859,786368,24,1,3,0,0,1,3,2,2,0,4,2,2,0,2,0,5
9859,786364,39,9,12,8,9,1,3,1,1,3,1,1,2,0,3,0,20
9859,797082,18,4,7,4,5,0,2,1,1,3,2,1,1,0,0,0,9
9859,780332,2,1,1,1,1,0,0,0,0,0,0,1,1,0,0,0,2
9859,781643,1,1,1,1,1,0,0,0,0,0,0,0,0,0,0,0,2
9859,780330,5,1,1,1,1,0,0,0,0,1,0,2,0,1,0,0,2
9859,780329,32,4,15,3,9,1,6,2,4,1,1,0,0,1,1,0,11
9859,797080,0,0,0,0,0,0,0,0,0,0,0,0,0,0,0,0,0
9860,786123,37,5,6,5,6,0,0,4,5,3,9,1,4,0,2,3,14
9860,797673,36,3,16,3,10,0,6,3,4,2,5,2,2,1,0,0,9
9860,786118,34,6,11,5,7,1,4,0,1,2,2,1,4,1,2,1,13
9860,786117,39,6,14,2,9,4,5,7,7,0,5,6,3,1,2,0,23
9860,780437,37,3,12,1,10,2,2,2,3,2,4,2,1,0,0,0,10
9860,797675,2,1,1,1,1,0,0,0,0,1,0,0,0,0,0,0,2
9860,792093,15,1,2,0,0,1,2,0,0,1,1,0,1,0,3,0,3
9861,792378,18,2,3,2,3,0,0,0,0,1,2,0,4,0,2,1,4
9861,786746,36,4,11,2,5,2,6,2,4,0,9,2,3,0,0,1,12
9861,780178,13,2,4,2,4,0,0,0,0,0,1,1,3,1,0,0,4
9861,792376,27,4,11,2,5,2,6,11,12,0,6,2,3,0,5,0,21
9861,797883,38,2,8,1,5,1,3,1,2,0,3,3,4,2,2,0,6
9861,797890,18,2,9,2,7,0,2,0,0,0,0,0,0,1,0,0,4
9861,775075,25,2,2,2,2,0,0,0,0,2,1,1,0,0,0,2,4
9861,785744,1,0,2,0,2,0,0,0,0,0,0,0,0,0,0,0,0
9861,797885,22,4,4,3,3,1,1,1,2,0,1,0,1,0,0,0,10
9861,797888,2,0,0,0,0,0,0,0,0,0,0,0,0,0,0,0,0
9862,791416,29,5,9,5,9,0,0,6,13,4,5,0,4,0,1,1,16
9862,797096,15,1,5,1,3,0,2,3,3,0,2,0,2,0,1,0,5
9862,785906,41,5,17,2,10,3,7,3,4,2,7,4,2,0,5,0,16
9862,781614,16,1,2,0,0,1,2,0,0,0,1,1,3,1,0,0,3
9862,780096,43,4,7,2,2,2,5,0,0,1,3,3,1,0,0,1,10
9862,780100,29,4,6,1,3,3,3,2,2,1,2,0,3,3,0,0,13
9862,785907,16,3,4,3,4,0,0,6,6,5,1,2,5,1,0,0,12
9862,797093,36,6,14,6,12,0,2,4,4,0,6,5,3,0,3,0,16
9863,790873,37,3,16,3,9,0,7,6,8,2,5,4,4,3,2,2,12
9863,785429,12,0,0,0,0,0,0,0,0,1,1,0,3,0,0,1,0
9863,780054,42,6,14,5,12,1,2,9,9,3,1,0,5,1,3,0,22
9863,786851,40,12,21,7,11,5,10,3,5,0,8,0,2,1,2,0,32
9863,781139,19,0,1,0,0,0,1,0,0,0,0,0,4,0,0,0,0
9863,776245,28,1,2,0,0,1,2,1,3,2,5,1,3,0,0,0,4
9863,776357,33,6,10,5,7,1,3,3,3,0,4,6,3,1,0,0,16
9863,796433,8,1,1,1,1,0,0,0,0,0,3,0,2,0,1,1,2
9863,799973,5,0,0,0,0,0,0,0,2,0,0,0,0,0,0,0,0
9863,796432,1,0,0,0,0,0,0,0,0,0,0,0,0,1,0,0,0
9864,780059,34,6,16,6,13,0,3,1,2,5,6,6,3,1,2,4,13
9864,776110,13,0,2,0,1,0,1,0,0,1,3,0,1,0,0,0,0
9864,796496,25,6,8,4,4,2,4,0,0,1,4,1,4,1,1,1,14
9864,790944,37,8,19,3,6,5,13,0,0,1,4,4,0,1,1,0,21
9864,780061,31,2,8,2,5,0,3,0,0,0,6,0,2,0,3,2,4
9864,780058,13,2,5,0,0,2,5,0,0,0,3,0,3,0,1,0,6
9864,790941,17,4,6,4,6,0,0,0,1,7,1,1,2,1,0,1,8
9864,790943,2,0,1,0,1,0,0,0,0,0,0,0,0,0,0,0,0
9864,786754,28,5,11,2,4,3,7,1,2,1,4,4,0,0,1,0,14
9865,791522,39,13,23,12,20,1,3,3,7,5,3,2,4,2,1,0,30
9865,786351,32,1,6,1,3,0,3,0,0,4,8,1,3,1,2,0,2
9865,797146,40,6,18,2,8,4,10,2,2,1,2,2,1,3,0,1,18
9865,786348,33,3,7,3,7,0,0,2,2,4,4,0,1,0,0,1,8
9865,797143,38,7,17,2,6,5,11,2,2,0,7,5,1,0,2,1,21
9865,797147,9,0,1,0,1,0,0,0,0,0,1,0,1,0,0,1,0
9865,785816,9,0,2,0,2,0,0,0,0,1,1,0,2,0,0,1,0
9866,785287,14,0,1,0,1,0,0,1,2,0,3,0,1,2,0,1,1
9866,776286,22,4,7,4,7,0,0,1,1,0,3,2,2,0,0,0,9
9866,791445,30,6,11,4,6,2,5,2,2,0,3,1,1,0,1,0,16
9866,785357,21,8,12,3,3,5,9,0,0,1,2,1,2,2,2,1,21
9866,775560,21,3,6,1,3,2,3,2,2,2,3,7,0,1,1,1,10
9866,797010,20,4,13,4,12,0,1,0,0,3,1,7,2,1,1,0,8
9866,781627,20,4,5,4,5,0,0,0,0,2,4,2,1,1,0,0,8
9866,775557,15,1,1,1,1,0,0,0,0,1,4,0,1,0,1,1,2
9866,797012,16,1,1,1,1,0,0,0,0,0,2,3,3,1,0,0,2
9866,785895,10,2,5,1,1,1,4,0,0,0,1,1,1,0,0,0,5
9866,797011,5,3,3,3,3,0,0,0,0,1,0,0,1,0,0,0,6
9866,797009,3,1,1,0,0,1,1,0,0,0,0,0,1,0,0,0,3
9866,781626,3,0,0,0,0,0,0,0,0,0,0,0,0,0,0,0,0
9867,781107,11,0,1,0,1,0,0,0,0,1,0,0,2,0,2,1,0
9867,791972,28,4,13,1,3,3,10,0,0,1,1,0,1,1,1,0,11
9867,796777,22,1,7,1,4,0,3,0,0,1,2,2,0,0,2,0,2
9867,791974,28,2,6,1,2,1,4,4,5,0,1,1,1,0,2,0,9
9867,780863,24,3,13,2,8,1,5,1,2,3,2,2,1,0,1,0,8
9867,796778,21,2,6,2,5,0,1,3,4,4,2,1,3,0,1,2,7
9867,796780,21,1,7,1,3,0,4,0,0,0,3,1,1,0,1,1,2
9867,785366,22,2,5,1,2,1,3,0,0,0,2,2,0,0,0,0,5
9867,780867,16,3,6,1,3,2,3,2,4,3,3,1,2,0,0,1,10
9867,791973,5,0,1,0,1,0,0,0,0,1,1,1,1,1,0,0,0
9867,792708,1,0,0,0,0,0,0,0,0,0,0,0,0,0,0,0,0
9867,780873,1,0,0,0,0,0,0,0,0,0,0,0,0,0,0,0,0
9868,791837,37,6,15,2,7,4,8,2,2,3,7,0,1,0,1,1,18
9868,786621,24,3,5,3,3,0,2,2,2,1,1,1,0,0,0,0,8
9868,780613,35,5,11,5,11,0,0,5,5,0,6,0,5,0,2,0,15
9868,797437,19,1,1,1,1,0,0,2,4,1,1,1,3,0,2,0,4
9868,780609,40,6,13,3,5,3,8,3,4,0,3,5,1,4,3,0,18
9868,786619,13,5,6,5,6,0,0,0,0,3,0,0,5,1,1,1,10
9868,797439,12,0,0,0,0,0,0,0,0,0,2,0,2,2,2,0,0
9868,786622,20,1,4,0,2,1,2,0,0,2,3,1,1,0,0,1,3
9869,797972,31,3,6,3,4,0,2,2,2,2,3,1,4,1,2,1,8
9869,797967,37,6,15,6,13,0,2,1,2,4,2,4,0,1,2,0,13
9869,797970,32,7,15,5,8,2,7,2,2,2,1,0,4,1,2,0,18
9869,781453,31,1,6,0,1,1,5,7,9,1,4,4,3,1,3,0,10
9869,774869,39,4,9,2,4,2,5,1,1,1,1,1,3,2,1,0,11
9869,792254,10,1,1,1,1,0,0,1,1,0,5,0,0,0,0,0,3
9869,797962,2,0,0,0,0,0,0,0,0,0,0,0,0,0,0,1,0
9869,786098,18,1,6,0,1,1,5,0,0,0,1,0,0,1,2,0,3
9870,797721,17,0,5,0,1,0,4,2,2,0,1,0,0,0,0,0,2
9870,786257,36,6,10,5,8,1,2,0,1,1,7,2,2,2,2,1,13
9870,786263,20,4,9,4,6,0,3,0,0,0,4,0,0,0,1,0,8
9870,785661,33,2,4,1,2,1,2,4,5,0,3,2,5,0,1,0,9
9870,775825,40,6,12,5,8,1,4,4,4,0,3,11,2,1,3,0,17
9870,792121,19,1,1,0,0,1,1,2,2,0,2,0,2,0,1,0,5
9870,797725,4,1,1,1,1,0,0,0,0,0,1,0,0,0,0,1,2
9870,792122,26,4,8,1,3,3,5,0,0,1,2,1,2,0,1,0,11
9870,797724,5,0,0,0,0,0,0,0,0,0,1,0,0,0,0,0,0
9871,785991,31,8,16,8,16,0,0,3,5,4,7,1,4,0,1,2,19
9871,792133,37,1,11,1,7,0,4,0,0,0,5,7,0,0,1,0,2
9871,797762,27,3,6,3,6,0,0,1,2,1,3,4,2,1,1,1,7
9871,781406,34,7,15,6,13,1,2,6,6,1,2,2,3,2,1,1,21
9871,781401,32,4,5,2,3,2,2,0,1,0,3,1,2,2,0,1,10
9871,797760,8,0,1,0,1,0,0,0,0,0,1,0,1,0,0,0,0
9871,792129,9,0,0,0,0,0,0,0,0,1,0,0,1,0,0,1,0
9871,781029,22,2,2,0,0,2,2,4,5,0,0,2,0,1,0,0,10
9872,785740,27,0,2,0,2,0,0,0,0,1,1,1,1,0,0,2,0
9872,785809,35,4,8,3,5,1,3,1,2,0,16,1,2,0,4,2,10
9872,780530,34,4,10,4,8,0,2,1,4,2,4,2,4,0,1,3,9
9872,797402,28,2,6,0,1,2,5,0,0,0,3,1,2,0,0,0,6
9872,785738,40,4,14,2,5,2,9,4,7,0,3,3,2,0,0,0,14
9872,797396,7,2,2,2,2,0,0,0,0,0,1,0,0,0,2,0,4
9872,786144,29,3,7,2,4,1,3,2,3,1,1,1,1,1,2,0,9
9873,799000,27,2,7,2,7,0,0,2,4,1,6,2,2,0,0,0,6
9873,785471,35,8,14,7,12,1,2,2,4,4,5,1,2,0,1,1,19
9873,775198,31,3,6,2,4,1,2,2,4,1,3,1,0,1,0,0,9
9873,786697,35,3,11,1,5,2,6,4,6,1,3,1,2,0,1,1,12
9873,775628,29,3,11,1,9,2,2,0,1,1,5,4,4,0,2,0,8
9873,792399,13,1,3,1,3,0,0,0,0,1,2,0,3,1,1,0,2
9873,780263,10,1,3,1,2,0,1,0,0,0,1,0,0,0,0,0,2
9873,775547,4,1,1,1,1,0,0,0,0,0,1,0,0,0,0,0,2
9873,780571,16,0,1,0,0,0,1,0,0,0,0,0,1,0,0,0,0
9874,796347,21,0,3,0,1,0,2,1,4,1,5,1,2,0,0,0,1
9874,790788,31,4,9,1,3,3,6,2,2,1,2,1,0,0,0,1,13
9874,785243,32,7,11,6,9,1,2,0,0,2,2,5,2,0,1,1,15
9874,781028,37,4,12,4,6,0,6,4,4,0,3,4,1,3,2,0,12
9874,781026,14,1,6,0,4,1,2,0,0,1,0,1,1,0,2,0,3
9874,796348,21,3,4,3,3,0,1,0,0,0,2,0,3,1,2,0,6
9874,796349,17,4,6,2,2,2,4,1,1,0,0,1,0,0,0,0,11
9874,781027,12,0,1,0,0,0,1,0,0,0,1,0,4,0,0,0,0
9874,785242,11,0,0,0,0,0,0,0,0,0,0,1,1,1,2,0,0
9874,790787,3,0,0,0,0,0,0,0,0,0,0,0,1,0,0,1,0
9874,796346,1,0,0,0,0,0,0,0,0,0,1,0,0,0,1,0,0
9875,785409,33,7,7,7,7,0,0,0,2,1,7,1,1,1,1,0,14
9875,785408,32,5,10,3,6,2,4,1,2,1,3,0,2,2,2,0,13
9875,785407,33,8,10,7,8,1,2,4,4,3,4,1,3,0,0,0,21
9875,796416,36,3,5,1,3,2,2,0,0,0,5,4,2,1,2,0,8
9875,780539,31,3,9,2,3,1,6,0,0,0,1,5,2,0,1,0,7
9875,796415,13,1,3,1,2,0,1,0,0,0,0,1,1,0,2,0,2
9875,790861,16,3,5,2,3,1,2,0,0,0,0,0,2,1,1,0,7
9875,796417,3,0,1,0,1,0,0,3,4,1,1,0,0,0,0,0,3
9875,790860,1,0,1,0,1,0,0,0,0,0,0,0,0,0,0,0,0
9875,796419,1,0,0,0,0,0,0,0,0,0,0,0,0,0,0,0,0
9875,796418,1,0,0,0,0,0,0,0,0,0,0,0,0,0,0,0,0
9876,781174,35,6,8,6,8,0,0,6,8,5,5,2,3,0,4,0,18
9876,785231,32,4,10,2,4,2,6,0,1,3,5,4,2,3,2,0,10
9876,781215,35,4,11,1,6,3,5,2,4,1,1,2,4,1,1,0,13
9876,779972,36,6,13,1,5,5,8,0,0,0,6,9,2,0,4,1,17
9876,775255,29,5,11,3,4,2,7,1,1,1,1,1,2,1,1,0,13
9876,796644,5,2,2,2,2,0,0,0,1,0,1,0,1,0,0,1,4
9876,791001,17,2,3,1,1,1,2,0,1,0,1,3,3,0,2,0,5
9876,796643,11,1,1,0,0,1,1,2,3,0,0,0,1,0,0,1,5
9877,780881,23,2,6,2,5,0,1,0,0,0,4,3,4,1,2,2,4
9877,780275,25,2,4,2,4,0,0,0,2,1,4,0,1,0,2,1,4
9877,792075,27,5,8,2,4,3,4,3,5,0,2,0,4,0,1,0,16
9877,786686,38,9,16,6,12,3,4,2,3,0,7,12,1,1,1,0,23
9877,775222,36,6,9,3,5,3,4,2,2,0,3,2,2,1,1,1,17
9877,792074,15,1,3,1,2,0,1,2,2,1,0,0,2,0,0,0,4
9877,780884,2,1,1,1,1,0,0,0,0,0,0,0,0,0,0,0,2
9877,785437,15,2,3,2,3,0,0,1,1,3,0,0,3,0,3,1,5
9877,780882,19,3,6,2,3,1,3,2,2,0,1,2,3,2,0,0,9
9878,786029,35,8,13,8,13,0,0,6,11,0,4,1,1,2,2,0,22
9878,781398,27,2,4,1,3,1,1,0,0,4,3,1,3,1,0,2,5
9878,792114,27,0,6,0,3,0,3,1,2,1,0,0,4,0,2,1,1
9878,786018,34,5,11,3,5,2,6,1,2,2,5,0,2,0,0,3,13
9878,775678,35,4,13,4,8,0,5,2,3,1,2,4,2,3,2,0,10
9878,797746,14,0,3,0,1,0,2,0,2,1,6,0,1,1,0,0,0
9878,797740,9,0,2,0,2,0,0,0,0,0,2,1,0,0,2,0,0
9878,797737,15,0,2,0,1,0,1,1,2,1,1,0,0,0,0,1,1
9878,786022,4,0,2,0,2,0,0,0,0,0,0,0,0,0,0,0,0
9879,785631,34,4,10,1,4,3,6,0,0,0,4,2,2,1,2,2,11
9879,786248,29,4,6,4,6,0,0,1,1,4,6,1,4,0,4,2,9
9879,791200,40,8,21,5,12,3,9,2,3,0,2,3,3,2,2,0,21
9879,785630,38,1,8,0,4,1,4,0,0,0,4,3,2,0,1,0,3
9879,785632,37,1,4,1,4,0,0,2,4,1,3,4,3,0,1,0,4
9879,785863,10,1,3,1,3,0,0,1,2,0,4,0,1,1,1,0,3
9879,791199,10,1,1,1,1,0,0,0,0,0,4,0,1,0,0,1,2
9879,791198,2,0,0,0,0,0,0,0,0,0,0,0,0,0,0,0,0
9880,776285,23,3,5,3,5,0,0,0,0,2,6,0,4,0,0,0,6
9880,791777,27,1,10,1,10,0,0,2,2,0,4,4,2,1,2,0,4
9880,781025,12,0,0,0,0,0,0,0,0,0,1,2,3,1,0,0,0
9880,786474,38,4,13,2,7,2,6,0,0,2,2,1,1,4,3,0,10
9880,775503,28,2,8,1,3,1,5,0,0,0,3,1,1,0,0,0,5
9880,786476,2,0,1,0,1,0,0,0,0,0,0,0,0,0,0,0,0
9880,791780,6,0,0,0,0,0,0,0,0,0,1,1,0,0,0,2,0
9880,791829,29,8,13,4,8,4,5,4,5,0,5,0,2,2,4,0,24
9880,780488,12,0,4,0,2,0,2,0,0,0,0,1,0,1,0,0,0
9880,791778,15,2,4,2,4,0,0,1,2,1,2,0,0,0,0,1,5
9880,791776,8,0,0,0,0,0,0,0,0,0,0,0,1,1,0,1,0
9881,796554,28,0,2,0,2,0,0,0,0,3,8,0,0,1,0,4,0
9881,790961,38,3,6,3,6,0,0,3,3,3,5,4,1,2,2,0,9
9881,785278,31,3,16,2,7,1,9,2,2,2,2,0,1,0,0,1,9
9881,780146,29,7,19,4,8,3,11,1,1,1,3,1,3,1,2,0,18
9881,775860,37,1,14,0,1,1,13,4,4,0,6,2,1,0,5,1,7
9881,780832,14,1,1,1,1,0,0,5,6,2,3,0,0,0,1,2,7
9881,796553,16,0,1,0,1,0,0,0,0,1,3,0,1,1,2,2,0
9881,796555,4,1,3,0,0,1,3,0,0,0,0,0,1,0,0,0,3
9881,786240,3,0,0,0,0,0,0,0,0,0,0,0,0,0,0,0,0
9882,790827,26,3,3,3,3,0,0,4,4,1,4,0,2,0,1,0,10
9882,790828,14,4,7,4,7,0,0,0,0,0,1,0,3,0,0,0,8
9882,785372,42,6,12,4,9,2,3,2,2,1,4,7,3,1,4,1,16
9882,790825,33,4,12,3,6,1,6,0,0,3,2,2,2,0,2,0,9
9882,774905,35,5,8,4,7,1,1,1,2,2,5,3,4,0,2,1,12
9882,785375,20,1,2,1,2,0,0,5,6,0,2,0,2,0,0,3,7
9882,785373,24,2,7,1,2,1,5,2,2,1,1,2,1,1,1,0,7
9882,786384,16,3,6,2,4,1,2,2,2,2,1,0,1,0,1,1,9
9882,796385,12,1,3,1,2,0,1,0,0,0,0,2,1,0,0,0,2
9882,796387,3,0,1,0,1,0,0,0,0,0,1,0,0,0,0,0,0
9882,796386,0,0,0,0,0,0,0,0,0,0,0,0,0,0,0,0,0
9883,780283,26,3,7,3,7,0,0,5,6,3,3,1,4,0,2,0,11
9883,790925,45,11,20,8,16,3,4,2,4,2,2,2,1,0,0,1,27
9883,791456,41,9,20,6,11,3,9,2,2,1,3,2,3,0,2,0,23
9883,785476,34,2,6,1,4,1,2,2,2,0,0,4,1,0,2,0,7
9883,785474,38,4,8,3,6,1,2,2,4,1,7,2,4,1,0,2,11
9883,785480,15,1,1,0,0,1,1,0,0,0,1,0,0,1,0,0,3
9883,790926,2,0,0,0,0,0,0,0,0,0,1,0,0,0,1,0,0
9883,785478,6,0,0,0,0,0,0,0,0,0,0,0,2,0,1,0,0
9883,800121,6,0,3,0,3,0,0,0,0,2,0,0,0,0,0,0,0
9883,796470,12,1,2,1,2,0,0,2,2,2,1,2,0,0,0,0,4
9884,785368,43,6,8,6,8,0,0,7,8,3,11,2,1,1,3,3,19
9884,780281,25,4,7,4,6,0,1,1,5,0,5,0,5,1,0,0,9
9884,790793,44,5,9,2,3,3,6,1,2,0,3,4,1,1,4,0,14
9884,785246,37,4,8,4,7,0,1,2,2,1,1,0,3,0,0,0,10
9884,780886,22,2,6,2,4,0,2,2,2,0,5,1,1,1,1,0,6
9884,790792,32,5,8,3,5,2,3,3,4,1,3,2,0,1,4,0,15
9884,796351,14,0,0,0,0,0,0,2,4,0,1,0,5,0,1,0,2
9884,790790,1,0,0,0,0,0,0,0,0,0,0,0,2,0,1,0,0
9884,796350,2,0,0,0,0,0,0,0,0,0,0,0,1,0,1,0,0
9884,796353,5,0,0,0,0,0,0,0,0,0,1,0,0,0,0,0,0
9885,781342,36,3,6,3,6,0,0,1,2,2,5,2,5,1,1,1,7
9885,781593,37,2,5,2,4,0,1,2,4,2,3,4,5,0,3,1,6
9885,790901,38,8,18,4,8,4,10,8,11,1,0,1,4,1,3,0,28
9885,785452,45,7,15,7,13,0,2,4,4,1,3,2,1,0,1,0,18
9885,781620,29,0,1,0,1,0,0,0,0,0,1,1,3,1,2,0,0
9885,790902,29,4,11,1,1,3,10,0,0,0,3,0,3,3,1,0,11
9885,796450,2,0,0,0,0,0,0,0,0,0,0,0,1,0,0,0,0
9885,774835,9,0,1,0,1,0,0,0,0,0,1,1,2,0,0,0,0
9886,791416,20,8,11,8,11,0,0,2,5,2,3,1,1,0,2,2,18
9886,797096,20,4,5,3,3,1,2,1,2,0,4,2,2,1,1,0,10
9886,785906,33,8,14,8,14,0,0,1,1,0,11,6,1,3,0,0,17
9886,781614,20,4,5,4,5,0,0,0,0,0,5,0,0,0,0,0,8
9886,780096,32,5,9,4,7,1,2,0,0,0,2,2,2,1,0,0,11
9886,785907,15,1,6,1,6,0,0,0,0,1,2,0,1,0,1,1,2
9886,797093,23,4,9,4,8,0,1,0,0,0,3,5,2,0,1,0,8
9886,780100,20,2,3,2,2,0,1,0,0,1,3,2,2,0,0,0,4
9886,797094,8,0,0,0,0,0,0,0,0,0,0,1,0,0,0,0,0
9886,797098,1,0,0,0,0,0,0,0,0,1,0,0,0,0,0,0,0
9886,797095,1,0,1,0,1,0,0,0,0,0,0,0,0,0,0,0,0
9886,767484,2,0,0,0,0,0,0,0,0,0,0,0,0,0,0,0,0
9886,785903,1,0,0,0,0,0,0,0,0,0,0,0,0,0,0,0,0
9886,791415,4,0,0,0,0,0,0,0,0,0,0,0,0,0,0,0,0
9887,791201,21,1,8,1,5,0,3,0,0,0,1,1,0,1,0,0,2
9887,775767,27,5,12,5,10,0,2,0,0,4,6,2,2,0,1,2,10
9887,796902,30,3,10,1,8,2,2,4,4,0,2,1,2,1,2,0,12
9887,785628,32,2,12,2,10,0,2,0,0,0,4,2,3,0,3,0,4
9887,785627,26,3,9,1,5,2,4,0,0,1,4,1,0,0,1,1,8
9887,781135,7,0,1,0,1,0,0,0,0,0,0,0,1,0,0,0,0
9887,785629,10,1,1,0,0,1,1,0,0,1,1,0,0,0,0,0,3
9887,791202,26,3,6,2,3,1,3,0,0,0,1,0,1,0,0,0,7
9887,796901,10,1,3,0,0,1,3,0,0,0,2,0,0,0,2,0,3
9887,796904,4,0,0,0,0,0,0,0,0,0,2,3,0,0,0,0,0
9887,788869,2,0,0,0,0,0,0,0,0,0,0,0,1,0,0,0,0
9887,781138,1,0,0,0,0,0,0,0,0,0,0,0,0,0,0,0,0
9887,796903,2,0,0,0,0,0,0,0,0,0,0,0,0,0,0,0,0
9887,789974,2,0,0,0,0,0,0,0,0,0,0,0,0,0,0,0,0
9888,790873,39,10,15,9,12,1,3,2,4,6,8,5,4,0,5,1,23
9888,785429,21,2,5,1,1,1,4,0,0,0,3,1,0,2,0,2,5
9888,780054,34,3,8,3,6,0,2,1,2,0,2,0,4,0,0,1,7
9888,786851,43,7,21,4,9,3,12,1,3,1,9,3,3,0,3,0,18
9888,781139,32,1,3,1,3,0,0,1,2,1,2,3,3,0,3,1,3
9888,796433,6,2,4,2,4,0,0,0,2,0,0,0,1,0,2,0,4
9888,776357,38,4,8,4,7,0,1,4,5,0,6,3,2,0,3,0,12
9888,776245,12,0,3,0,2,0,1,0,0,2,4,0,0,0,0,0,0
9888,796432,0,0,0,0,0,0,0,0,0,0,0,0,0,0,0,0,0
9889,786547,26,2,5,1,2,1,3,0,0,2,2,2,4,1,0,0,5
9889,786544,45,9,21,4,9,5,12,7,7,4,7,0,3,1,2,0,30
9889,797507,44,1,5,1,2,0,3,1,3,1,3,2,2,1,3,0,3
9889,792012,45,10,24,5,14,5,10,4,6,1,4,3,1,2,1,0,29
9889,786546,42,2,8,2,5,0,3,2,2,0,3,6,3,5,0,0,6
9889,786860,19,1,5,1,2,0,3,0,0,0,3,0,3,0,0,1,2
9889,797510,4,0,2,0,1,0,1,0,0,0,0,0,0,0,0,0,0
9890,775897,19,2,2,2,2,0,0,0,0,1,4,2,1,1,2,0,4
9890,780324,28,4,6,4,6,0,0,2,2,2,3,0,0,1,1,0,10
9890,791543,31,3,8,0,0,3,8,3,4,0,3,2,0,1,2,0,12
9890,786530,40,4,8,0,1,4,7,4,6,0,3,8,2,1,2,0,16
9890,780317,36,8,13,4,6,4,7,1,2,3,3,4,2,1,2,0,21
9890,791545,16,3,8,3,7,0,1,0,1,4,0,1,1,0,0,0,6
9890,784246,17,1,5,1,3,0,2,0,0,2,1,0,3,0,0,0,2
9890,797092,3,0,1,0,1,0,0,0,0,0,0,0,0,0,0,0,0
9890,786360,10,0,2,0,0,0,2,0,0,0,0,1,0,0,0,0,0
9891,785355,31,4,9,4,9,0,0,0,0,1,0,0,4,0,0,1,8
9891,785353,38,6,10,5,7,1,3,1,1,0,4,4,1,2,3,0,14
9891,781673,38,3,5,3,3,0,2,0,0,0,5,1,4,1,1,0,6
9891,780876,34,7,9,7,9,0,0,1,2,0,5,2,3,2,4,2,15
9891,781457,40,5,11,3,6,2,5,1,2,0,0,3,4,0,2,0,13
9891,791305,8,1,1,1,1,0,0,0,0,0,1,0,1,0,0,1,2
9891,790895,11,1,2,1,2,0,0,0,0,0,0,0,2,1,2,1,2
9892,796439,35,3,8,3,8,0,0,4,7,4,5,0,0,1,1,2,10
9892,790884,12,2,3,2,3,0,0,0,0,1,2,0,3,0,1,1,4
9892,790883,36,8,14,7,12,1,2,4,5,1,6,0,2,4,2,1,21
9892,796436,33,3,14,1,6,2,8,7,9,1,4,1,3,2,4,1,15
9892,785436,39,2,4,2,4,0,0,5,7,1,5,4,3,1,3,0,9
9892,796438,29,3,10,3,6,0,4,0,1,2,0,0,4,1,2,1,6
9892,796442,6,0,1,0,1,0,0,0,0,0,0,0,1,0,0,1,0
9892,790885,8,1,1,1,1,0,0,0,0,1,2,0,1,0,0,0,2
9892,781262,2,1,2,1,1,0,1,0,0,0,0,0,0,0,0,0,2
9893,791482,29,0,2,0,0,0,2,2,2,0,2,3,4,2,0,0,2
9893,786319,29,4,11,4,11,0,0,3,5,1,6,1,1,2,3,1,11
9893,786318,35,4,13,2,5,2,8,2,2,0,5,1,3,1,2,2,12
9893,784268,32,3,10,2,8,1,2,3,3,1,1,1,0,1,5,0,10
9893,780223,35,6,9,2,3,4,6,0,1,0,3,4,4,1,3,1,16
9893,780225,13,1,4,0,1,1,3,0,0,1,4,1,4,0,2,0,3
9893,791481,16,2,4,2,4,0,0,0,0,1,5,0,3,0,1,3,4
9893,797199,11,1,3,1,3,0,0,0,0,0,0,1,2,0,0,0,2
9893,786317,0,0,0,0,0,0,0,0,0,0,0,0,1,0,0,0,0
9893,797201,0,0,0,0,0,0,0,0,0,0,0,0,0,0,0,0,0
9894,790856,24,6,9,6,9,0,0,3,3,2,2,1,1,2,1,0,15
9894,780452,22,4,12,4,12,0,0,2,4,5,5,1,0,0,2,2,10
9894,796413,26,2,4,0,1,2,3,2,2,0,1,1,2,0,0,0,8
9894,796408,28,4,13,2,8,2,5,0,0,0,1,3,2,0,0,0,10
9894,796407,22,1,4,1,3,0,1,0,0,0,3,0,3,0,1,0,2
9894,796410,19,2,4,2,4,0,0,0,0,1,2,1,2,0,3,1,4
9894,796411,13,1,3,1,3,0,0,0,0,0,1,1,0,0,1,0,2
9894,796409,22,2,9,1,6,1,3,0,0,1,3,2,2,0,0,1,5
9894,780450,7,0,0,0,0,0,0,0,0,0,2,0,1,0,1,0,0
9894,790858,12,3,5,3,4,0,1,0,1,0,0,0,1,0,0,0,6
9894,775941,1,0,1,0,1,0,0,0,0,0,0,0,0,0,0,0,0
9894,780453,1,0,1,0,1,0,0,0,0,1,0,0,0,0,0,1,0
9894,780454,1,0,0,0,0,0,0,0,0,0,0,0,0,0,1,0,0
9894,781286,1,0,0,0,0,0,0,0,0,0,0,0,0,0,0,0,0
9894,798137,1,0,0,0,0,0,0,0,0,0,0,0,0,0,0,0,0
9895,790930,17,0,1,0,1,0,0,1,2,0,0,0,0,1,0,0,1
9895,780358,26,2,8,1,5,1,3,2,2,2,3,1,2,0,1,4,7
9895,775011,23,4,10,3,5,1,5,0,0,2,3,2,3,1,1,0,9
9895,780357,37,10,15,5,8,5,7,4,4,0,6,1,1,0,1,0,29
9895,775018,36,8,15,5,7,3,8,2,2,0,5,3,0,0,2,0,21
9895,776004,24,3,6,1,4,2,2,1,2,1,3,3,3,0,0,3,9
9895,796480,23,3,4,3,3,0,1,0,0,0,6,3,2,1,1,1,6
9895,776270,5,0,0,0,0,0,0,0,0,0,1,1,0,1,0,0,0
9895,796485,3,0,1,0,1,0,0,0,0,2,0,1,0,0,0,0,0
9895,796486,1,1,1,0,0,1,1,0,0,0,0,0,0,0,0,0,3
9895,785491,1,0,0,0,0,0,0,0,0,0,0,0,0,1,0,0,0
9895,785496,1,0,0,0,0,0,0,0,0,0,0,0,0,0,0,0,0
9895,796483,1,0,0,0,0,0,0,0,0,0,0,0,0,0,0,0,0
9895,796484,1,0,0,0,0,0,0,0,0,0,0,0,0,0,0,0,0
9895,796482,1,0,0,0,0,0,0,0,0,0,0,0,0,0,0,0,0
9896,790839,35,2,6,1,4,1,2,2,3,5,4,2,2,0,2,0,7
9896,785388,30,7,15,7,15,0,0,0,1,9,4,5,3,1,3,0,14
9896,796395,42,10,24,6,12,4,12,2,3,1,1,0,2,0,0,2,26
9896,785386,34,1,7,1,3,0,4,0,0,2,2,3,3,1,1,1,2
9896,780373,19,2,5,1,2,1,3,4,4,0,1,1,1,0,2,1,9
9896,796393,15,0,2,0,2,0,0,0,0,0,3,1,2,0,1,2,0
9896,780370,10,0,2,0,0,0,2,2,2,0,1,0,1,0,0,0,2
9896,790840,12,0,2,0,0,0,2,0,0,1,1,0,0,0,2,0,0
9896,790841,28,3,6,0,1,3,5,0,1,0,2,1,4,0,0,0,9
9897,791883,42,7,13,6,7,1,6,1,1,1,4,3,2,1,0,2,16
9897,781066,28,1,4,1,4,0,0,0,0,2,0,2,3,0,2,1,2
9897,797594,40,6,9,2,3,4,6,0,0,0,3,0,3,0,1,0,16
9897,791884,43,7,18,5,14,2,4,8,8,1,11,5,4,0,2,0,24
9897,780695,37,4,10,3,6,1,4,4,4,0,1,2,2,3,0,0,13
9897,797598,16,2,4,2,4,0,0,0,2,1,0,0,3,0,0,0,4
9897,797597,1,0,0,0,0,0,0,0,0,0,1,0,0,0,0,0,0
9897,786496,18,1,1,0,0,1,1,0,0,1,2,2,1,0,0,0,3
9898,785224,23,4,10,2,7,2,3,0,0,0,2,0,1,2,1,0,10
9898,780879,38,5,14,5,13,0,1,5,6,3,8,3,1,1,1,0,15
9898,790767,20,1,3,0,0,1,3,0,0,0,1,3,1,1,1,0,3
9898,790768,30,3,8,1,5,2,3,0,0,0,0,3,2,0,2,0,8
9898,780875,30,5,6,4,4,1,2,3,3,1,2,2,4,0,2,1,14
9898,775785,17,1,4,1,4,0,0,0,0,4,3,2,0,1,2,1,2
9898,785743,22,1,8,1,3,0,5,0,0,0,0,0,1,1,1,0,2
9898,796326,2,0,0,0,0,0,0,0,0,0,1,0,2,0,0,0,0
9898,785226,3,0,1,0,1,0,0,0,0,0,1,0,1,0,0,0,0
9898,790769,15,1,5,1,3,0,2,0,0,0,0,1,0,0,0,1,2
9899,780634,30,1,3,1,3,0,0,0,0,4,6,0,3,3,2,3,2
9899,791826,22,3,4,1,1,2,3,0,0,0,2,4,2,0,0,0,8
9899,786785,34,3,14,3,8,0,6,4,5,1,4,0,1,0,3,1,10
9899,780633,36,5,11,3,3,2,8,1,2,0,1,3,3,1,2,0,13
9899,776009,34,5,7,2,2,3,5,0,0,0,3,1,1,1,3,0,13
9899,797389,9,0,1,0,1,0,0,0,0,0,3,0,1,0,1,0,0
9899,786783,24,6,12,5,7,1,5,0,0,5,5,3,1,1,1,1,13
9899,786784,11,0,6,0,3,0,3,1,2,2,0,0,1,0,1,0,1
9900,791980,30,6,8,3,3,3,5,0,0,3,2,2,1,1,1,0,15
9900,785972,32,1,3,0,1,1,2,0,2,0,1,0,1,1,0,0,3
9900,785967,24,5,13,5,13,0,0,2,2,3,4,1,4,1,2,3,12
9900,791977,32,5,12,4,8,1,4,2,2,1,1,2,1,1,1,0,13
9900,791978,36,11,17,8,13,3,4,5,6,2,4,6,1,3,0,0,30
9900,780160,15,0,0,0,0,0,0,0,1,0,2,1,4,2,0,1,0
9900,791976,23,3,9,2,6,1,3,2,2,0,0,3,1,1,1,0,9
9900,797800,1,0,0,0,0,0,0,0,0,0,0,0,2,0,1,0,0
9900,785973,5,0,0,0,0,0,0,0,0,0,0,1,1,0,0,0,0
9900,797803,1,1,1,1,1,0,0,0,0,0,1,0,0,0,0,0,2
9900,797801,1,0,0,0,0,0,0,0,0,0,0,0,0,0,0,0,0
9901,797292,32,5,12,5,12,0,0,0,2,3,6,1,3,1,1,3,10
9901,780509,34,1,3,1,2,0,1,0,1,0,3,2,3,0,2,1,2
9901,797290,36,7,11,2,3,5,8,2,2,0,4,4,2,0,6,0,21
9901,797291,24,3,4,2,3,1,1,0,0,0,3,2,2,0,2,0,7
9901,786064,35,7,11,3,5,4,6,0,0,2,2,1,4,2,1,0,18
9901,791660,24,3,5,3,4,0,1,3,4,1,1,4,0,1,5,1,9
9901,791658,7,0,2,0,2,0,0,0,0,1,0,0,0,0,1,0,0
9901,785658,5,0,1,0,0,0,1,0,0,0,0,1,0,0,0,0,0
9901,791661,1,0,1,0,0,0,1,0,0,0,0,0,0,0,0,0,0
9901,791663,1,0,0,0,0,0,0,0,0,0,0,0,0,0,0,0,0
9901,797294,1,0,0,0,0,0,0,0,0,0,0,0,0,0,0,0,0
9902,785536,4,0,1,0,1,0,0,0,0,0,0,0,0,0,0,0,0
9902,780119,40,8,16,8,16,0,0,11,13,4,8,1,2,5,2,2,27
9902,796558,32,6,11,6,11,0,0,0,0,3,3,3,3,2,4,2,12
9902,796559,35,4,8,3,4,1,4,3,5,0,1,0,3,1,1,0,12
9902,776097,38,6,13,5,9,1,4,4,4,1,6,4,3,0,1,0,17
9902,796560,5,0,1,0,1,0,0,0,0,0,3,0,2,0,0,0,0
9902,780149,32,4,12,1,4,3,8,3,5,1,4,2,1,3,1,0,14
9902,785280,12,1,2,1,2,0,0,1,2,0,0,1,1,2,1,0,3
9902,785285,2,0,0,0,0,0,0,0,0,0,0,0,0,0,0,0,0
9903,791140,25,2,5,2,5,0,0,2,6,4,4,1,3,0,2,0,6
9903,791138,24,0,0,0,0,0,0,0,0,0,3,1,2,0,1,1,0
9903,786084,33,3,10,2,5,1,5,2,2,0,4,5,2,2,2,0,9
9903,780910,30,4,13,1,7,3,6,2,2,2,1,4,4,2,6,0,13
9903,780288,28,4,13,0,5,4,8,2,2,0,3,4,4,1,3,0,14
9903,796794,4,0,0,0,0,0,0,1,2,0,1,0,0,0,0,0,1
9903,796795,12,5,6,5,6,0,0,1,3,0,2,0,4,0,2,0,11
9903,780911,29,4,9,1,3,3,6,0,0,1,5,1,2,0,6,0,11
9903,780912,5,0,0,0,0,0,0,0,0,1,2,0,0,0,0,1,0
9903,781635,10,1,2,0,0,1,2,0,0,0,3,1,3,0,0,0,3
9904,780323,28,3,6,3,6,0,0,0,0,3,3,2,1,1,0,0,6
9904,792233,31,5,12,5,10,0,2,0,1,0,1,3,2,1,0,0,10
9904,792229,37,4,10,2,6,2,4,0,0,1,6,3,3,0,2,1,10
9904,785954,36,3,8,1,3,2,5,4,4,1,5,4,1,3,3,0,12
9904,785811,30,6,16,3,10,3,6,1,1,0,3,0,1,0,1,0,16
9904,792234,3,0,1,0,1,0,0,0,0,0,0,0,0,0,0,0,0
9904,797894,17,3,6,3,6,0,0,1,2,1,0,0,4,2,1,2,7
9904,792230,10,1,2,1,1,0,1,0,0,0,2,3,2,1,0,0,2
9904,786016,8,1,1,1,1,0,0,0,0,0,0,0,0,0,0,0,2
9905,781579,31,5,9,5,9,0,0,3,4,3,5,0,1,1,2,0,13
9905,786731,40,5,8,5,8,0,0,1,2,2,11,6,2,1,5,7,11
9905,798023,23,2,7,0,2,2,5,0,0,1,2,1,1,0,4,0,6
9905,781584,33,2,8,0,1,2,7,0,0,0,2,1,2,1,3,0,6
9905,780347,38,5,8,5,7,0,1,1,2,1,0,4,3,0,5,2,11
9905,775696,19,3,8,3,3,0,5,0,2,1,3,0,1,0,1,0,6
9905,798008,16,0,2,0,1,0,1,0,0,0,3,1,2,0,2,0,0
9905,798017,0,0,0,0,0,0,0,0,0,0,0,0,1,0,0,0,0
9906,778046,33,5,16,4,8,1,8,2,2,0,4,9,3,5,3,0,13
9906,782121,31,5,10,3,4,2,6,0,0,1,5,3,2,3,2,2,12
9906,775793,28,9,17,5,9,4,8,0,0,2,2,0,1,1,1,1,22
9906,775224,11,0,0,0,0,0,0,0,0,1,3,0,5,0,0,1,0
9906,785302,21,3,7,2,5,1,2,1,2,2,7,2,1,2,1,1,8
9906,785485,16,2,7,2,7,0,0,0,0,1,2,1,2,1,1,0,4
9906,786594,23,4,7,1,2,3,5,1,2,3,1,1,1,2,2,0,12
9906,785298,22,2,4,2,4,0,0,1,2,2,2,0,1,1,0,1,5
9906,790987,4,0,2,0,2,0,0,0,0,1,1,0,0,0,0,0,0
9906,796598,5,0,3,0,0,0,3,1,2,1,1,0,0,0,0,0,1
9906,785301,2,0,1,0,0,0,1,0,0,0,0,0,0,0,0,0,0
9906,778469,2,1,1,1,1,0,0,0,0,0,0,0,0,0,0,0,2
9906,796599,2,0,0,0,0,0,0,0,0,0,0,0,0,0,0,0,0
9907,792417,34,3,7,2,6,1,1,1,3,1,2,0,2,0,4,3,8
9907,786861,39,2,7,2,5,0,2,1,2,1,3,1,1,0,3,1,5
9907,786867,0,0,0,0,0,0,0,0,0,0,0,0,0,0,0,0,0
9907,780387,39,7,14,5,8,2,6,3,3,1,6,3,2,2,4,1,19
9907,767033,38,2,12,0,4,2,8,5,5,0,9,6,4,1,7,0,11
9907,792416,34,3,10,3,6,0,4,2,2,0,2,1,5,2,4,0,8
9907,796870,7,0,0,0,0,0,0,0,0,1,1,0,1,0,0,2,0
9907,786866,3,0,1,0,0,0,1,0,0,0,1,0,0,0,2,0,0
9907,796869,1,0,0,0,0,0,0,0,0,0,1,0,0,0,0,0,0
9907,796867,2,2,3,2,3,0,0,0,0,0,1,0,0,0,0,0,4
9907,785801,1,0,0,0,0,0,0,0,0,0,0,0,0,0,0,0,0
9907,796864,0,0,0,0,0,0,0,0,0,0,0,0,0,0,0,0,0
9907,796868,1,0,0,0,0,0,0,0,0,0,0,0,0,0,0,0,0
9907,786865,1,0,0,0,0,0,0,0,0,0,0,0,0,0,0,0,0
9908,785238,10,0,0,0,0,0,0,1,2,2,1,0,0,0,0,0,1
9908,796194,35,4,9,1,1,3,8,0,0,0,3,1,4,3,1,0,11
9908,796464,35,6,16,5,14,1,2,1,2,3,3,2,2,3,2,0,14
9908,796459,31,5,12,5,11,0,1,2,2,1,2,3,3,0,0,0,12
9908,781006,27,0,2,0,1,0,1,4,4,0,2,0,4,0,3,0,4
9908,790918,6,0,0,0,0,0,0,0,0,1,0,0,0,0,1,1,0
9908,790917,24,2,10,2,5,0,5,1,2,4,9,2,0,2,2,1,5
9908,781157,26,4,14,3,5,1,9,0,0,2,0,2,3,0,1,0,9
9908,780648,4,0,0,0,0,0,0,0,0,0,0,0,0,0,0,0,0
9908,790916,1,0,0,0,0,0,0,0,0,0,0,0,0,0,0,0,0
9908,790919,1,0,0,0,0,0,0,0,0,0,0,0,0,0,0,0,0
9909,796404,25,2,10,2,10,0,0,0,0,4,5,3,2,1,1,2,4
9909,790853,25,8,8,8,8,0,0,0,0,2,2,0,2,0,3,3,16
9909,790850,33,5,11,1,2,4,9,0,1,0,6,2,1,1,1,0,14
9909,781164,33,3,5,0,1,3,4,1,2,1,5,4,1,0,3,0,10
9909,781163,38,5,12,4,8,1,4,2,2,1,9,6,2,0,3,0,13
9909,796406,14,1,5,1,5,0,0,0,0,2,0,1,1,0,0,1,2
9909,785434,14,2,3,0,0,2,3,0,0,0,1,1,1,0,1,0,6
9909,790849,14,1,2,1,1,0,1,3,5,0,2,3,3,3,2,0,5
9909,790848,1,0,0,0,0,0,0,0,0,0,0,0,0,0,0,0,0
9909,796405,1,0,0,0,0,0,0,0,0,0,0,0,0,0,0,0,0
9909,781223,1,0,0,0,0,0,0,0,0,0,0,0,0,0,0,0,0
9909,790854,1,0,0,0,0,0,0,0,0,0,0,0,0,0,0,0,0
9910,791144,24,5,10,5,10,0,0,1,1,1,4,2,2,2,0,2,11
9910,785782,30,5,12,1,2,4,10,0,0,0,0,0,2,3,0,1,14
9910,791145,32,8,11,8,11,0,0,1,1,3,5,2,0,0,4,0,17
9910,791146,37,6,13,6,13,0,0,2,2,0,2,9,2,1,4,1,14
9910,785777,30,2,7,0,3,2,4,0,0,1,6,1,2,2,2,0,6
9910,791147,14,2,8,1,4,1,4,2,2,2,5,0,1,0,0,1,7
9910,796804,7,1,3,1,2,0,1,0,0,0,0,0,0,0,0,0,2
9910,791148,13,1,4,1,3,0,1,0,0,3,2,2,1,0,1,0,2
9910,786748,13,1,2,1,2,0,0,0,0,1,0,1,1,0,0,0,2
9911,785495,31,9,18,7,14,2,4,1,1,3,3,4,2,2,4,0,21
9911,785958,34,5,10,5,9,0,1,0,1,3,6,1,2,1,3,0,10
9911,785659,26,4,6,3,4,1,2,3,4,1,5,1,3,1,1,2,12
9911,785494,31,3,9,2,4,1,5,0,0,0,2,2,2,1,4,0,7
9911,780698,36,5,13,4,8,1,5,1,2,3,3,3,1,1,1,1,12
9911,785490,13,2,4,0,1,2,3,0,0,1,2,0,0,1,1,1,6
9911,775377,16,2,2,2,2,0,0,1,2,2,2,0,1,0,0,0,5
9911,780427,13,0,1,0,0,0,1,0,0,0,3,1,0,0,0,1,0
9912,785287,18,1,1,1,1,0,0,4,4,5,2,0,2,1,0,4,6
9912,776286,21,4,7,4,6,0,1,2,4,2,2,0,4,0,0,0,10
9912,791445,35,5,14,2,6,3,8,1,1,0,2,3,0,1,0,0,14
9912,785357,35,6,13,2,5,4,8,2,2,3,1,4,0,0,3,0,18
9912,775560,1,0,1,0,0,0,1,0,0,0,0,0,0,0,0,0,0
9912,797010,24,5,10,5,8,0,2,5,6,0,3,2,2,3,1,0,15
9912,797012,12,0,2,0,0,0,2,0,2,0,2,1,1,0,3,0,0
9912,775557,15,4,5,4,5,0,0,2,2,2,2,0,2,1,0,2,10
9912,785895,13,0,3,0,0,0,3,2,2,0,1,1,1,0,1,0,2
9912,781627,19,4,4,4,4,0,0,4,4,1,4,1,2,1,1,1,12
9912,791444,2,0,0,0,0,0,0,0,0,1,0,0,0,0,0,0,0
9912,797011,3,0,0,0,0,0,0,0,2,0,0,0,1,0,0,0,0
9912,781626,1,0,1,0,1,0,0,0,0,1,0,0,2,0,0,0,0
9912,797009,1,0,0,0,0,0,0,0,0,0,0,0,0,0,0,0,0
9913,785681,24,3,5,3,5,0,0,0,0,2,1,2,1,1,0,4,6
9913,796789,28,3,9,0,2,3,7,2,4,1,2,0,4,3,1,0,11
9913,791126,25,2,8,2,8,0,0,2,2,0,0,2,4,2,4,0,6
9913,791124,27,1,2,1,2,0,0,0,0,0,0,1,3,0,1,0,2
9913,780050,31,3,11,2,8,1,3,1,2,1,7,3,1,0,0,0,8
9913,775813,16,2,3,2,3,0,0,1,2,1,0,0,3,0,2,0,5
9913,796784,8,0,2,0,0,0,2,0,0,0,0,0,0,0,2,0,0
9913,784479,6,1,2,0,0,1,2,0,1,0,3,0,3,0,1,0,3
9913,796786,10,1,1,1,1,0,0,3,4,0,0,0,3,0,1,0,5
9913,796783,0,0,0,0,0,0,0,0,0,0,0,0,1,0,0,0,0
9913,792711,3,0,0,0,0,0,0,0,0,0,0,0,2,0,1,0,0
9913,796782,15,1,1,0,0,1,1,3,4,0,1,0,0,0,1,0,6
9913,796788,3,0,0,0,0,0,0,2,2,0,0,0,0,0,0,0,2
9913,796787,1,0,0,0,0,0,0,2,2,0,0,0,0,0,0,0,2
9913,791125,3,0,0,0,0,0,0,0,0,0,0,0,0,0,0,0,0
9914,786132,20,0,3,0,2,0,1,0,0,1,0,0,3,0,2,0,0
9914,775074,24,2,8,2,7,0,1,4,5,1,3,1,4,0,2,0,8
9914,796971,38,4,11,4,7,0,4,1,1,2,5,3,2,1,2,2,9
9914,786448,37,4,6,3,4,1,2,1,2,2,8,1,5,0,7,0,10
9914,780731,40,7,17,5,12,2,5,6,7,0,1,5,1,2,2,0,22
9914,791632,14,3,5,2,4,1,1,0,1,2,5,0,2,0,3,0,7
9914,791631,18,1,2,1,2,0,0,0,0,0,3,1,3,1,2,0,2
9914,791630,7,1,2,0,1,1,1,0,0,1,0,0,2,0,1,0,3
9914,786449,2,0,0,0,0,0,0,0,0,0,1,0,0,0,0,0,0
9915,791524,31,3,5,3,4,0,1,2,2,1,5,2,3,4,2,0,8
9915,797139,28,8,14,8,14,0,0,6,9,2,5,1,4,1,2,1,22
9915,780272,36,2,10,2,6,0,4,10,12,0,2,7,1,3,3,1,14
9915,775592,30,3,8,2,3,1,5,3,3,0,3,0,1,2,1,0,10
9915,775394,28,1,3,1,3,0,0,0,1,1,3,2,2,1,1,1,2
9915,785970,10,1,4,1,4,0,0,1,2,2,0,0,3,0,0,1,3
9915,780273,12,0,2,0,0,0,2,0,0,0,0,0,2,1,0,0,0
9915,791523,6,1,3,0,1,1,2,0,0,0,0,1,0,0,1,0,3
9915,791526,17,3,5,1,2,2,3,0,0,1,2,0,3,3,0,0,8
9915,786354,2,0,0,0,0,0,0,0,0,0,0,0,1,0,0,0,0
9916,786157,23,2,3,2,3,0,0,1,3,3,2,0,4,1,0,1,5
9916,780676,36,8,19,7,10,1,9,0,1,3,5,4,3,0,1,0,17
9916,791756,26,3,7,1,4,2,3,0,0,2,2,6,4,3,1,0,8
9916,780992,22,1,7,0,0,1,7,0,0,0,1,0,1,0,1,0,3
9916,780677,37,6,16,1,3,5,13,0,0,2,3,1,0,0,0,0,17
9916,791754,10,1,3,1,3,0,0,1,1,1,2,0,1,1,1,0,3
9916,775533,15,1,2,1,2,0,0,0,0,0,1,1,0,0,0,0,2
9916,797348,11,0,5,0,2,0,3,1,2,1,1,2,0,1,0,0,1
9916,780673,16,0,3,0,0,0,3,0,0,0,1,1,1,0,0,0,0
9916,791753,1,0,0,0,0,0,0,0,0,0,0,1,0,0,0,0,0
9916,797349,1,1,1,0,0,1,1,0,0,0,0,0,0,0,0,0,3
9916,797350,1,1,1,0,0,1,1,0,0,0,0,0,0,0,0,0,3
9916,791730,1,0,0,0,0,0,0,0,0,0,0,0,0,0,0,0,0
9917,792181,28,1,4,1,3,0,1,1,2,0,4,0,2,0,2,0,3
9917,780986,34,3,4,3,4,0,0,5,5,2,2,5,3,0,2,2,11
9917,785902,15,0,2,0,1,0,1,0,0,0,1,1,1,0,1,1,0
9917,792179,29,3,10,0,2,3,8,3,3,0,6,7,2,0,4,0,12
9917,786662,34,11,15,4,5,7,10,1,1,0,4,0,2,0,1,0,30
9917,797796,16,3,5,1,3,2,2,0,0,0,2,1,2,0,2,2,8
9917,786661,25,3,5,1,1,2,4,1,2,0,2,0,1,0,0,2,9
9917,792177,16,1,1,1,1,0,0,0,0,2,3,0,2,0,0,1,2
9917,797794,1,1,1,0,0,1,1,0,0,0,0,0,0,0,0,0,3
9917,792176,1,0,0,0,0,0,0,0,0,0,0,0,0,0,0,0,0
9917,797795,1,0,0,0,0,0,0,0,0,0,0,0,0,0,0,0,0
9918,791981,38,7,15,7,12,0,3,8,11,3,8,6,4,1,2,3,22
9918,780342,35,4,9,4,7,0,2,3,4,1,6,2,2,0,0,2,11
9918,791982,37,5,13,3,6,2,7,3,4,0,3,2,1,0,1,3,15
9918,791985,12,0,0,0,0,0,0,0,0,0,1,1,1,1,0,0,0
9918,781493,27,3,8,1,2,2,6,2,3,0,3,0,4,0,2,0,10
9918,786755,17,0,2,0,0,0,2,1,2,1,1,0,4,0,0,0,1
9918,786756,13,2,3,0,0,2,3,0,0,0,1,0,2,1,0,0,6
9918,791984,2,0,0,0,0,0,0,0,0,0,1,0,1,0,1,0,0
9918,791986,19,2,2,0,0,2,2,2,2,1,1,0,2,0,0,0,8
9919,785459,19,5,8,5,8,0,0,2,4,2,2,1,5,0,1,0,12
9919,789102,34,2,10,2,10,0,0,5,8,1,10,7,2,0,5,0,9
9919,789101,26,3,4,2,3,1,1,0,0,3,3,2,2,0,0,0,7
9919,781371,19,2,6,0,2,2,4,2,2,0,0,0,3,0,0,0,8
9919,781367,22,3,7,2,3,1,4,2,2,0,2,1,1,0,1,0,9
9919,797731,10,0,3,0,3,0,0,0,0,1,2,0,3,0,0,0,0
9919,792066,21,2,3,2,3,0,0,1,1,2,1,0,4,0,0,0,5
9919,792064,15,0,5,0,0,0,5,0,0,0,1,1,0,0,0,0,0
9919,788037,17,3,8,1,3,2,5,2,2,0,3,0,1,0,2,0,10
9919,792063,10,1,3,0,1,1,2,0,0,0,1,1,1,0,0,0,3
9919,792061,7,0,1,0,0,0,1,0,0,0,0,0,1,0,1,0,0
9920,785518,28,5,10,3,8,2,2,0,0,1,4,2,3,2,4,0,12
9920,796390,15,3,3,3,3,0,0,0,3,1,2,0,2,0,1,0,6
9920,790832,27,1,7,0,2,1,5,0,0,1,2,0,1,0,0,0,3
9920,790834,29,5,7,2,2,3,5,2,2,6,4,2,1,0,0,0,15
9920,785451,36,8,20,4,9,4,11,1,2,0,6,5,3,2,1,0,21
9920,790833,27,4,8,4,5,0,3,2,3,3,2,5,1,0,1,1,10
9920,790830,16,0,1,0,1,0,0,0,0,0,2,3,0,1,1,0,0
9920,790831,13,2,7,2,7,0,0,0,2,4,2,1,0,0,1,1,4
9920,785379,8,0,1,0,1,0,0,0,0,0,0,0,0,1,1,0,0
9920,796389,1,0,0,0,0,0,0,0,0,0,0,0,0,1,0,0,0
9921,799906,38,5,10,4,6,1,4,0,1,1,7,1,3,2,3,0,11
9921,775833,16,2,2,2,2,0,0,1,4,0,0,0,2,0,1,1,5
9921,796845,26,3,5,2,3,1,2,0,1,0,5,0,2,0,1,0,7
9921,781036,38,3,10,3,7,0,3,0,0,0,2,3,1,0,2,0,6
9921,774894,38,5,11,4,5,1,6,2,2,0,4,3,1,1,2,1,13
9921,785439,20,6,8,2,4,4,4,0,0,0,1,1,1,2,1,0,16
9921,796847,24,1,4,1,2,0,2,0,0,0,2,1,3,0,1,0,2
9922,781300,31,8,13,8,11,0,2,1,4,1,6,3,1,0,0,1,17
9922,790803,24,6,9,6,9,0,0,1,2,3,6,1,4,0,4,2,13
9922,790801,16,0,2,0,2,0,0,1,2,0,0,2,0,0,0,0,1
9922,781304,32,2,6,2,4,0,2,0,0,0,1,6,2,2,2,1,4
9922,781302,30,5,8,5,6,0,2,2,2,0,4,2,1,1,0,0,12
9922,796364,10,2,5,2,4,0,1,2,2,1,3,0,3,0,1,1,6
9922,796363,11,0,2,0,1,0,1,3,4,0,1,0,1,0,0,0,3
9922,796360,26,2,2,2,2,0,0,0,0,0,4,1,2,0,5,1,4
9922,780598,14,0,0,0,0,0,0,4,4,0,5,0,1,0,1,0,4
9922,781305,6,0,1,0,0,0,1,0,0,0,0,0,0,0,0,0,0
9923,785800,22,2,7,2,3,0,4,0,0,1,0,2,2,2,1,0,4
9923,785799,22,0,1,0,1,0,0,0,0,1,4,0,2,0,0,0,0
9923,791676,30,5,10,0,1,5,9,1,1,0,1,3,3,1,2,0,16
9923,780554,31,3,9,2,4,1,5,0,0,1,3,0,2,0,1,0,7
9923,780553,36,7,18,7,17,0,1,3,6,0,5,4,3,2,4,1,17
9923,797427,11,1,5,0,1,1,4,1,2,0,1,0,1,0,0,0,4
9923,780760,18,0,6,0,3,0,3,4,4,3,1,1,2,0,0,0,4
9923,791678,13,0,0,0,0,0,0,0,0,1,4,0,0,0,0,0,0
9923,797426,2,0,0,0,0,0,0,0,0,0,0,1,1,0,0,0,0
9923,791677,10,1,4,1,3,0,1,0,0,0,0,3,2,2,0,0,2
9923,785807,5,0,0,0,0,0,0,0,0,0,0,0,0,0,0,0,0
9924,791522,32,4,9,3,6,1,3,2,3,0,11,3,3,0,3,0,11
9924,786351,31,5,10,2,4,3,6,0,0,3,8,1,3,0,0,1,13
9924,797146,39,7,18,5,11,2,7,11,13,0,4,3,2,0,1,0,27
9924,786348,32,5,10,4,7,1,3,2,2,7,3,2,3,1,0,4,13
9924,797143,31,2,10,1,5,1,5,2,2,0,1,1,3,0,0,0,7
9924,797142,8,1,1,1,1,0,0,0,0,1,0,0,1,0,1,0,2
9924,785816,13,1,2,1,2,0,0,1,2,2,3,0,2,0,0,0,3
9924,797147,11,0,1,0,1,0,0,0,0,0,1,1,0,1,2,0,0
9924,797144,1,0,1,0,0,0,1,0,0,0,0,0,1,0,0,0,0
9924,786826,1,0,0,0,0,0,0,0,0,0,1,0,0,0,0,0,0
9924,797148,1,0,0,0,0,0,0,0,0,0,0,0,0,0,0,0,0
9925,786123,39,5,7,5,7,0,0,5,6,4,5,3,3,1,1,3,15
9925,797673,38,6,14,6,11,0,3,6,7,1,2,1,4,0,1,0,18
9925,786118,31,2,10,0,0,2,10,0,0,0,5,1,3,1,0,0,6
9925,786117,39,3,18,3,14,0,4,4,5,1,2,5,2,0,0,1,10
9925,780437,36,5,9,4,8,1,1,0,0,1,4,0,1,1,0,0,11
9925,792093,10,0,3,0,1,0,2,1,2,0,1,0,3,0,1,0,1
9925,797672,4,0,2,0,2,0,0,0,0,2,1,0,1,0,0,0,0
9925,797675,1,0,0,0,0,0,0,0,0,0,0,0,0,0,0,1,0
9925,786119,1,0,0,0,0,0,0,0,0,0,0,0,0,0,0,0,0
9925,797671,1,0,0,0,0,0,0,0,0,0,0,0,0,0,0,0,0
9926,780985,37,3,10,2,3,1,7,1,1,0,7,4,3,1,0,1,8
9926,785714,32,6,8,6,8,0,0,3,5,4,7,0,3,1,1,2,15
9926,775894,37,4,11,4,8,0,3,0,0,1,2,3,3,0,0,0,8
9926,775266,29,5,14,2,5,3,9,0,0,1,2,2,1,0,0,0,13
9926,785711,38,7,11,4,5,3,6,0,0,0,2,8,1,2,6,0,17
9926,796829,8,0,1,0,1,0,0,0,0,1,0,0,2,0,0,0,0
9926,791167,16,1,3,1,3,0,0,0,1,0,1,1,1,0,1,0,2
9926,779994,3,0,0,0,0,0,0,0,0,0,0,0,0,0,0,0,0
9927,775811,15,2,4,2,2,0,2,0,0,2,2,0,1,0,0,0,4
9927,775955,39,4,9,2,5,2,4,3,5,2,4,7,1,0,2,1,13
9927,785395,33,3,9,2,5,1,4,6,6,0,6,1,1,1,0,1,13
9927,775840,35,5,11,4,7,1,4,0,0,0,2,3,2,0,0,0,11
9927,786704,25,5,8,5,8,0,0,2,2,2,4,0,5,1,1,1,12
9927,786706,15,1,4,1,4,0,0,1,2,3,4,0,2,0,1,0,3
9927,790921,12,0,3,0,1,0,2,0,0,0,1,3,3,0,2,0,0
9927,786551,19,1,7,0,3,1,4,1,2,1,1,1,1,0,1,0,4
9927,775287,7,1,2,1,1,0,1,0,0,0,2,0,0,0,0,0,2
9928,790893,23,6,7,5,5,1,2,2,2,0,5,2,3,0,0,1,15
9928,796444,38,7,15,6,11,1,4,2,4,5,6,2,0,0,3,3,17
9928,786615,28,5,10,4,9,1,1,3,5,1,1,2,1,0,0,0,14
9928,786732,21,2,5,2,4,0,1,0,1,2,1,0,0,2,0,1,4
9928,775260,33,4,11,3,6,1,5,0,1,0,6,10,1,1,1,0,9
9928,775536,17,2,2,2,2,0,0,0,0,0,3,2,1,0,1,0,4
9928,790890,14,1,3,1,2,0,1,1,2,0,1,2,2,0,1,0,3
9928,790889,18,1,3,0,0,1,3,0,0,0,3,0,2,0,2,1,3
9928,780702,5,1,1,0,0,1,1,0,0,0,0,0,0,0,0,0,3
9928,796445,1,0,0,0,0,0,0,0,0,1,0,0,0,0,0,0,0
9928,791501,1,0,0,0,0,0,0,0,0,0,0,0,0,0,0,1,0
9928,799891,1,0,1,0,1,0,0,0,0,0,0,0,0,0,0,0,0
9929,785631,29,3,10,3,6,0,4,0,0,2,4,1,3,0,1,0,6
9929,786248,25,3,11,3,11,0,0,0,0,2,5,1,3,0,1,1,6
9929,791200,39,8,22,2,11,6,11,4,4,2,3,2,2,0,2,0,26
9929,785630,31,1,9,1,5,0,4,2,2,2,1,2,3,1,0,0,4
9929,785632,35,2,6,1,4,1,2,0,0,3,4,4,2,4,1,0,5
9929,791199,14,1,3,1,3,0,0,1,2,1,2,0,3,0,1,0,3
9929,785863,16,2,4,2,4,0,0,2,3,0,0,1,1,0,1,0,6
9929,791198,7,0,1,0,0,0,1,0,0,0,0,0,0,0,0,0,0
9929,791197,1,0,1,0,1,0,0,0,0,0,0,0,0,0,0,0,0
9929,791196,1,0,1,0,0,0,1,0,0,0,0,0,0,0,0,0,0
9929,781129,0,0,0,0,0,0,0,0,0,0,0,0,0,0,0,0,0
9929,796898,1,0,0,0,0,0,0,0,0,0,0,0,0,0,0,0,0
9929,791195,1,0,0,0,0,0,0,0,0,0,0,0,0,0,0,0,0
9930,780027,33,9,16,5,11,4,5,2,4,4,2,1,3,2,2,1,24
9930,786176,36,3,7,2,3,1,4,9,10,0,8,5,1,0,0,0,16
9930,786173,32,2,5,2,4,0,1,3,5,0,2,1,1,0,1,1,7
9930,780028,13,0,2,0,1,0,1,0,0,0,0,1,4,1,0,0,0
9930,774828,29,4,7,1,2,3,5,2,2,1,3,2,1,0,2,0,13
9930,797175,25,6,11,5,6,1,5,0,0,2,5,3,4,1,0,4,13
9930,791380,11,2,2,1,1,1,1,0,0,0,1,2,1,0,1,0,5
9930,791379,15,2,3,2,3,0,0,2,2,2,0,0,0,0,0,0,6
9930,797178,6,1,1,1,1,0,0,0,1,0,2,2,0,0,0,0,2
9931,776279,25,3,7,1,1,2,6,0,0,0,3,5,4,1,1,3,8
9931,781505,33,5,11,5,8,0,3,3,5,3,2,2,4,0,1,0,13
9931,780353,28,8,11,8,11,0,0,2,3,3,3,1,2,0,2,0,18
9931,791317,38,6,16,3,7,3,9,0,0,1,2,7,2,1,1,0,15
9931,777573,25,1,7,0,2,1,5,0,0,0,1,1,3,0,0,0,3
9931,786222,19,5,9,4,8,1,1,2,3,6,1,0,3,0,1,1,13
9931,796649,13,0,4,0,3,0,1,0,0,0,2,1,1,1,0,0,0
9931,790851,19,2,3,2,2,0,1,0,0,0,1,2,1,1,0,0,4
9931,791318,0,0,1,0,1,0,0,0,0,1,0,0,0,0,0,0,0
9931,796647,0,0,1,0,1,0,0,0,0,0,0,0,0,0,0,0,0
9931,785966,0,0,0,0,0,0,0,0,0,0,0,0,0,0,0,0,0
9931,796646,0,0,0,0,0,0,0,0,0,0,0,0,0,0,0,0,0
9931,796648,0,0,0,0,0,0,0,0,0,0,0,0,0,0,0,0,0
9932,775510,38,4,16,3,8,1,8,6,6,0,9,3,2,1,0,0,15
9932,774976,24,4,11,3,5,1,6,0,0,2,4,1,3,1,0,4,9
9932,797865,38,3,7,3,5,0,2,0,0,1,1,3,0,1,0,2,6
9932,786614,34,4,9,0,1,4,8,0,0,1,3,0,4,2,1,0,12
9932,786759,37,3,10,2,6,1,4,2,4,0,3,3,0,0,0,0,9
9932,786761,9,0,0,0,0,0,0,0,0,0,1,0,1,0,1,0,0
9932,792291,4,0,2,0,1,0,1,0,0,0,0,0,0,0,0,0,0
9932,792293,16,3,5,2,3,1,2,0,0,1,2,0,3,0,1,1,7
9933,792197,31,5,12,2,4,3,8,2,2,0,2,0,1,0,2,0,15
9933,781132,40,7,15,4,6,3,9,0,0,1,4,4,3,0,3,1,17
9933,797517,30,2,6,2,6,0,0,3,4,1,5,0,0,0,1,1,7
9933,791940,36,2,9,2,6,0,3,4,4,2,1,0,1,1,0,0,8
9933,797522,3,0,0,0,0,0,0,0,0,0,0,0,2,0,0,0,0
9933,797518,17,1,1,1,1,0,0,2,2,1,5,0,1,0,0,0,4
9933,786534,40,4,7,3,4,1,3,2,2,0,13,8,0,0,3,0,11
9933,791938,3,0,0,0,0,0,0,0,0,0,0,0,1,0,0,0,0
9934,790798,22,3,7,3,7,0,0,4,4,3,3,5,2,0,0,1,10
9934,780140,27,8,12,2,3,6,9,1,1,1,4,2,0,0,1,0,23
9934,796355,18,2,8,2,5,0,3,2,2,0,4,2,3,1,4,1,6
9934,785245,27,1,5,1,1,0,4,2,2,1,3,5,1,2,1,0,4
9934,780137,28,6,12,5,9,1,3,2,2,1,8,2,0,1,1,0,15
9934,790799,24,7,7,6,6,1,1,2,2,3,4,4,1,3,0,0,17
9934,775553,21,2,3,0,1,2,2,0,0,0,1,7,2,1,3,0,6
9934,796354,9,3,4,0,0,3,4,0,0,0,2,0,2,0,0,0,9
9934,799892,5,0,1,0,1,0,0,0,1,0,2,0,2,0,0,0,0
9934,790796,6,1,1,1,1,0,0,0,0,0,2,0,0,0,1,1,2
9934,796359,7,1,1,0,0,1,1,2,2,0,0,0,2,0,0,0,5
9934,790795,2,0,0,0,0,0,0,1,2,0,0,0,0,0,0,0,1
9934,790800,1,0,0,0,0,0,0,0,0,0,0,0,0,0,0,0,0
9934,794905,1,0,0,0,0,0,0,0,0,0,0,0,0,0,0,0,0
9934,788844,2,0,0,0,0,0,0,0,0,0,0,0,0,0,0,0,0
9935,776285,20,4,9,4,9,0,0,0,0,0,2,1,5,1,0,0,8
9935,791777,33,4,17,4,13,0,4,4,5,0,3,4,1,0,0,0,12
9935,781025,27,3,8,0,5,3,3,3,3,1,1,0,0,4,2,0,12
9935,786474,27,1,8,0,4,1,4,0,2,0,2,2,0,0,3,0,3
9935,775503,27,3,4,1,2,2,2,0,0,1,5,1,0,1,1,0,8
9935,791829,18,3,7,2,4,1,3,1,3,0,1,0,1,1,1,0,8
9935,786476,13,0,1,0,1,0,0,0,0,0,0,0,2,0,0,0,0
9935,791780,6,0,1,0,0,0,1,0,0,0,1,0,2,0,0,0,0
9935,780488,9,1,3,1,1,0,2,0,0,1,0,2,1,0,0,0,2
9935,791778,4,0,1,0,1,0,0,0,0,0,0,0,0,0,0,0,0
9935,791781,1,0,0,0,0,0,0,0,0,0,0,0,1,0,1,0,0
9935,791776,11,0,2,0,0,0,2,2,3,1,1,0,0,0,1,0,2
9935,797612,2,0,1,0,1,0,0,0,0,0,0,0,0,0,0,0,0
9935,791783,2,0,0,0,0,0,0,0,0,0,1,0,1,0,0,0,0
9936,790923,31,4,5,4,4,0,1,3,4,0,3,2,1,0,3,3,11
9936,779981,32,3,3,3,3,0,0,4,4,2,9,2,2,2,0,3,10
9936,785463,36,1,7,0,3,1,4,0,0,0,1,2,3,2,4,1,3
9936,779978,27,4,10,3,4,1,6,0,1,0,3,2,4,0,7,0,9
9936,776003,30,4,9,1,4,3,5,2,2,1,2,5,2,1,4,0,13
9936,796469,6,1,1,0,0,1,1,0,0,0,0,0,1,0,0,0,3
9936,779979,16,1,3,0,0,1,3,0,0,0,1,1,0,0,2,0,3
9936,779980,6,0,0,0,0,0,0,0,0,2,3,0,0,1,1,0,0
9936,790924,6,0,2,0,2,0,0,0,0,0,1,1,0,0,0,0,0
9936,785466,10,0,0,0,0,0,0,0,0,0,2,0,3,0,1,2,0
9937,786805,27,4,9,3,7,1,2,2,2,4,4,0,1,1,2,0,11
9937,774936,19,3,6,3,6,0,0,0,0,2,3,1,1,1,1,0,6
9937,790932,31,5,12,5,10,0,2,1,1,1,1,1,2,0,0,0,11
9937,781345,36,3,8,3,4,0,4,1,2,1,6,2,1,1,2,0,7
9937,786803,27,1,10,1,8,0,2,1,1,0,0,1,1,5,1,0,3
9937,786804,13,2,11,1,7,1,4,4,4,1,0,3,4,0,1,0,9
9937,790934,21,0,6,0,4,0,2,1,2,3,0,1,3,2,1,0,1
9937,790933,18,2,5,1,3,1,2,0,0,1,2,0,2,1,0,0,5
9937,780033,8,0,0,0,0,0,0,0,0,0,1,0,0,0,1,0,0
9937,796487,0,0,0,0,0,0,0,0,0,0,0,0,0,0,0,0,0
9938,780919,24,3,6,3,6,0,0,0,0,0,3,0,1,0,0,0,6
9938,775640,13,3,4,2,3,1,1,2,2,0,0,1,3,0,2,0,9
9938,785803,33,3,4,1,1,2,3,2,2,0,4,1,3,1,2,1,10
9938,780920,28,4,8,3,6,1,2,3,3,0,5,13,1,0,0,0,12
9938,780914,27,6,8,1,1,5,7,1,2,0,3,4,1,1,0,0,18
9938,796797,20,9,10,4,5,5,5,1,1,0,3,0,1,0,2,2,24
9938,775816,20,1,7,1,3,0,4,0,0,0,4,1,3,0,3,0,2
9938,791142,13,1,2,1,2,0,0,0,0,0,1,1,3,1,0,0,2
9938,796799,5,0,0,0,0,0,0,0,0,0,1,1,1,0,0,0,0
9938,791141,12,1,2,0,0,1,2,3,4,0,0,4,0,0,2,0,6
9938,796796,2,2,3,2,3,0,0,0,0,1,0,1,0,0,0,0,4
9938,796801,2,1,2,0,1,1,1,0,0,0,1,0,0,0,0,0,3
9938,775639,1,0,0,0,0,0,0,0,0,0,0,0,0,0,0,0,0
9939,786857,32,4,8,2,3,2,5,0,0,1,1,1,2,1,1,1,10
9939,781403,36,3,13,2,9,1,4,4,5,0,2,6,3,1,4,0,11
9939,792654,24,7,12,7,12,0,0,6,9,4,8,0,1,0,0,1,20
9939,797301,35,3,12,2,6,1,6,0,0,1,2,1,2,2,2,0,7
9939,780524,25,3,4,1,1,2,3,9,9,0,3,1,4,1,3,0,17
9939,781400,28,2,6,1,3,1,3,0,0,0,0,1,2,0,1,0,5
9939,792653,9,0,0,0,0,0,0,0,3,0,2,0,1,0,1,1,0
9939,797303,6,1,2,0,0,1,2,0,0,0,1,2,1,0,0,0,3
9939,797302,1,0,1,0,0,0,1,0,0,0,0,0,0,0,0,0,0
9939,797306,1,0,0,0,0,0,0,0,0,0,0,0,0,0,0,1,0
9939,797305,1,0,0,0,0,0,0,0,0,0,0,0,0,0,0,0,0
9939,797304,2,0,0,0,0,0,0,0,0,0,0,0,0,0,0,0,0
9940,774854,7,1,2,1,1,0,1,0,0,0,0,1,1,0,1,0,2
9940,796370,19,1,6,0,0,1,6,0,0,1,0,2,1,0,0,0,3
9940,790808,39,2,11,0,6,2,5,6,6,1,3,4,1,1,1,1,12
9940,785361,39,7,16,5,8,2,8,2,4,0,7,3,3,1,0,0,18
9940,779997,33,9,13,5,7,4,6,1,1,2,6,3,3,1,1,0,23
9940,790809,35,5,8,2,4,3,4,0,0,0,1,4,3,2,0,1,13
9940,785362,25,9,15,9,15,0,0,4,5,5,4,2,3,2,1,1,22
9940,796368,2,0,0,0,0,0,0,0,0,0,2,1,1,0,1,0,0
9940,796371,1,0,0,0,0,0,0,0,0,0,0,0,0,0,0,0,0
9941,781244,33,11,18,6,7,5,11,8,9,2,3,0,4,0,3,3,35
9941,791241,37,8,11,4,6,4,5,3,3,0,9,1,5,1,1,1,23
9941,785537,37,4,9,4,8,0,1,4,4,0,1,8,1,0,2,0,12
9941,781243,31,1,9,1,4,0,5,0,0,1,5,2,3,1,2,0,2
9941,781237,23,0,1,0,1,0,0,0,0,0,1,2,2,0,1,0,0
9941,791245,20,3,4,2,2,1,2,0,0,0,4,3,1,0,1,0,7
9941,791243,3,0,0,0,0,0,0,0,0,0,0,0,0,0,1,0,0
9941,776205,16,2,6,2,4,0,2,1,2,0,3,2,1,0,1,0,5
9941,796943,0,0,0,0,0,0,0,0,0,0,0,0,0,0,0,0,0
9941,785535,0,0,0,0,0,0,0,0,0,0,0,0,0,0,0,0,0
9941,791246,0,0,0,0,0,0,0,0,0,0,0,0,0,0,0,0,0
9942,785370,25,2,5,1,2,1,3,6,8,1,1,1,1,1,1,1,11
9942,796309,24,6,7,6,7,0,0,4,4,0,2,0,5,0,6,3,16
9942,790824,34,3,7,2,3,1,4,2,2,1,8,6,3,0,2,0,9
9942,780011,35,3,9,0,3,3,6,2,3,1,5,5,3,2,1,0,11
9942,775667,37,6,12,4,6,2,6,4,4,2,2,5,1,1,2,0,18
9942,774895,10,3,4,3,4,0,0,1,2,1,1,0,4,0,2,0,7
9942,796382,8,2,5,0,1,2,4,0,0,0,2,0,0,0,0,0,6
9942,781524,16,0,1,0,0,0,1,0,0,2,1,0,3,0,0,0,0
9942,796383,11,1,4,1,2,0,2,2,3,1,2,2,1,0,0,0,4
9943,799000,15,1,1,1,1,0,0,4,4,0,2,0,5,0,0,0,6
9943,785471,25,4,8,4,7,0,1,3,3,1,2,2,4,4,1,1,11
9943,775198,37,1,4,1,4,0,0,4,5,1,0,2,0,0,1,0,6
9943,786697,29,3,10,3,8,0,2,0,0,2,2,1,1,1,2,0,6
9943,775628,32,8,18,8,17,0,1,8,8,0,4,1,2,2,4,1,24
9943,792399,24,3,8,3,7,0,1,0,2,5,3,0,2,1,1,0,6
9943,775547,4,0,1,0,0,0,1,0,0,0,0,0,1,0,0,0,0
9943,780571,14,1,5,0,1,1,4,0,0,0,0,0,1,0,1,0,3
9943,792397,19,2,9,2,7,0,2,0,0,1,0,1,4,0,0,0,4
9943,786695,1,0,0,0,0,0,0,0,0,0,0,0,0,0,0,0,0
9944,780059,39,8,15,8,13,0,2,4,4,3,3,2,1,3,5,0,20
9944,776110,12,0,2,0,1,0,1,3,4,2,2,0,1,2,0,0,3
9944,796496,21,1,3,1,3,0,0,0,0,2,3,3,1,1,1,1,2
9944,790944,29,4,9,3,4,1,5,1,2,0,4,2,0,1,1,0,10
9944,780061,31,3,13,2,8,1,5,3,8,2,5,1,3,1,4,2,10
9944,786754,21,5,7,4,6,1,1,0,2,0,3,2,4,0,1,0,11
9944,780058,23,2,2,0,0,2,2,0,0,0,4,0,3,1,2,0,6
9944,790941,20,2,2,2,2,0,0,2,3,1,3,0,3,1,0,0,6
9944,790943,4,0,0,0,0,0,0,0,0,0,0,0,1,0,0,0,0
9945,797163,33,3,5,3,5,0,0,0,0,0,6,2,3,1,2,3,6
9945,797164,17,0,1,0,1,0,0,0,0,1,2,0,2,0,3,0,0
9945,786450,27,3,8,3,6,0,2,0,0,3,0,1,3,1,2,4,6
9945,776396,35,8,18,5,8,3,10,0,0,0,5,0,1,1,3,0,19
9945,776199,32,6,16,4,10,2,6,2,2,0,1,2,3,1,5,0,16
9945,791385,23,1,4,1,2,0,2,2,3,1,1,1,4,1,0,1,4
9945,797165,16,2,6,2,4,0,2,0,0,0,3,2,1,1,0,0,4
9945,791386,10,0,1,0,0,0,1,0,0,0,0,0,1,1,0,0,0
9945,797167,7,0,0,0,0,0,0,0,0,0,2,0,1,0,0,0,0
9946,791809,10,0,0,0,0,0,0,0,0,1,3,0,1,1,1,0,0
9946,780651,33,8,13,8,13,0,0,1,3,3,7,3,3,3,2,4,17
9946,791815,34,9,19,7,11,2,8,1,1,1,2,0,4,0,3,2,21
9946,791810,31,1,2,1,1,0,1,1,2,0,0,5,1,1,2,0,3
9946,780650,35,5,16,3,10,2,6,2,2,1,5,6,3,6,4,0,14
9946,781596,5,1,2,1,2,0,0,1,1,1,0,0,0,0,0,0,3
9946,791812,21,3,7,1,2,2,5,2,2,0,2,0,1,0,0,0,10
9946,791814,8,0,2,0,1,0,1,0,0,0,1,1,0,0,0,0,0
9946,786645,19,0,2,0,2,0,0,0,0,1,1,0,5,3,1,0,0
9946,786644,4,0,1,0,0,0,1,0,0,0,0,1,0,0,1,0,0
9947,796401,32,4,5,2,2,2,3,0,0,1,2,1,2,3,2,1,10
9947,785999,19,4,7,4,7,0,0,0,0,2,4,1,4,2,1,0,8
9947,775654,31,1,2,1,2,0,0,2,4,1,6,0,2,0,2,0,4
9947,791639,37,6,14,6,11,0,3,7,8,0,3,2,1,1,0,0,19
9947,785389,34,5,12,2,8,3,4,7,8,0,4,6,0,1,7,0,20
9947,791640,7,1,1,1,1,0,0,1,2,1,1,1,1,0,1,0,3
9947,796398,18,1,3,1,1,0,2,0,0,1,5,2,0,2,0,0,2
9947,796399,19,3,6,2,5,1,1,1,1,0,1,1,0,0,2,0,8
9947,785255,3,0,0,0,0,0,0,0,0,0,0,0,0,0,0,0,0
9948,796812,16,2,7,2,7,0,0,0,0,4,0,0,2,0,1,0,4
9948,780952,35,3,8,3,6,0,2,0,2,5,2,4,1,2,0,2,6
9948,791155,40,6,16,5,10,1,6,2,6,1,4,1,2,0,3,0,15
9948,786609,29,1,10,1,10,0,0,0,0,7,4,0,1,0,1,3,2
9948,796810,30,3,12,0,5,3,7,0,0,3,3,3,1,0,0,0,9
9948,780950,20,2,5,0,0,2,5,0,0,0,0,0,1,0,0,0,6
9948,780945,2,0,0,0,0,0,0,0,0,0,1,0,2,1,1,0,0
9948,796814,8,0,1,0,0,0,1,0,0,1,2,1,4,0,1,0,0
9948,791156,20,4,6,3,4,1,2,3,4,0,2,1,3,3,3,0,12
9949,791585,33,4,7,3,5,1,2,3,4,0,4,1,1,0,1,2,12
9949,791581,36,3,5,3,4,0,1,0,0,1,4,4,0,0,2,0,6
9949,786395,34,8,14,5,9,3,5,4,4,1,4,2,2,3,2,0,23
9949,786394,33,5,9,1,3,4,6,0,0,0,5,1,4,1,3,2,14
9949,780404,36,2,5,1,3,1,2,2,2,0,7,4,5,0,1,0,7
9949,780062,7,0,1,0,1,0,0,1,2,1,0,0,1,0,1,0,1
9949,785228,16,0,2,0,0,0,2,0,2,0,0,0,1,0,0,0,0
9949,780403,5,0,0,0,0,0,0,0,0,0,0,1,0,0,0,0,0
9950,790877,23,1,4,1,3,0,1,2,2,2,2,3,4,0,0,2,4
9950,779985,33,6,13,1,4,5,9,2,2,0,3,0,2,1,0,0,19
9950,785699,36,6,10,5,9,1,1,3,4,2,8,1,3,2,3,0,16
9950,781062,24,1,5,1,4,0,1,0,0,0,3,2,2,0,0,0,2
9950,774987,38,6,16,5,13,1,3,10,12,0,4,6,0,0,3,0,23
9950,790879,17,1,1,1,1,0,0,0,2,0,0,0,1,0,0,2,2
9950,785432,7,1,2,1,2,0,0,0,0,2,0,1,2,0,0,0,2
9950,790882,22,1,4,1,4,0,0,2,2,0,3,1,2,2,0,0,4
9951,790863,29,3,8,1,2,2,6,0,0,1,4,2,3,0,1,0,8
9951,780021,30,6,11,6,11,0,0,4,6,4,8,1,4,1,1,2,16
9951,785412,18,1,7,1,4,0,3,0,0,0,1,5,1,1,2,0,2
9951,780099,30,3,7,0,2,3,5,2,2,1,3,1,1,0,1,0,11
9951,776214,39,6,15,0,4,6,11,2,2,0,2,2,4,3,1,1,20
9951,775686,15,0,3,0,1,0,2,2,2,0,6,1,1,0,0,0,2
9951,785413,16,2,4,2,4,0,0,2,2,0,1,2,3,0,1,1,6
9951,776221,22,1,3,1,3,0,0,1,2,1,1,1,1,0,1,0,3
9951,785411,1,0,0,0,0,0,0,0,0,0,0,0,0,0,0,0,0
9952,796673,13,0,2,0,1,0,1,0,2,1,1,0,1,0,0,0,0
9952,796674,34,3,6,3,4,0,2,0,0,4,6,1,4,0,1,0,6
9952,779857,27,4,8,4,8,0,0,3,5,1,9,0,3,0,3,2,11
9952,779976,38,9,17,7,11,2,6,0,0,0,5,1,1,0,2,0,20
9952,774990,29,6,12,5,6,1,6,2,3,0,1,2,2,0,1,0,15
9952,781586,11,2,2,2,2,0,0,0,0,2,1,0,0,0,2,0,4
9952,785961,16,0,1,0,1,0,0,1,2,0,0,1,3,1,0,0,1
9952,791014,11,0,1,0,0,0,1,0,0,0,0,0,0,0,1,0,0
9952,785339,21,1,2,1,1,0,1,3,4,0,1,0,4,0,0,0,5
9953,780283,18,1,1,1,1,0,0,1,2,1,2,1,3,0,1,1,3
9953,790925,38,5,7,3,5,2,2,1,5,1,7,3,2,2,0,0,13
9953,791456,39,10,16,7,9,3,7,4,5,1,4,0,3,0,1,1,27
9953,785476,30,3,13,2,8,1,5,0,0,0,1,5,2,1,0,0,7
9953,785474,34,6,13,5,10,1,3,3,4,2,3,1,1,0,0,0,16
9953,800121,5,0,1,0,1,0,0,0,0,0,1,0,2,0,0,0,0
9953,785478,16,0,1,0,1,0,0,0,0,3,0,0,4,0,1,1,0
9953,790926,6,1,3,0,1,1,2,0,0,0,0,0,0,0,0,0,3
9953,785480,11,2,3,2,3,0,0,0,0,0,1,0,1,0,0,0,4
9953,796470,3,0,0,0,0,0,0,0,0,0,1,0,0,0,0,0,0
9953,796471,0,0,0,0,0,0,0,0,0,0,0,0,0,0,0,0,0
9953,790343,0,0,0,0,0,0,0,0,0,0,0,0,0,0,0,0,0
9956,791416,32,7,12,7,12,0,0,7,8,2,7,0,2,2,1,2,21
9956,797096,26,4,6,2,2,2,4,0,0,0,2,1,3,1,1,0,10
9956,785906,38,4,10,3,8,1,2,0,0,0,2,2,3,0,6,0,9
9956,781614,16,1,1,0,0,1,1,0,0,0,4,0,1,0,3,0,3
9956,780096,33,1,10,1,5,0,5,0,0,0,0,4,4,0,1,0,2
9956,797093,26,4,5,4,5,0,0,1,3,0,4,7,4,1,4,0,9
9956,780100,22,0,3,0,2,0,1,2,2,2,1,0,0,1,1,0,2
9956,785907,7,1,2,1,1,0,1,0,0,0,0,0,1,0,0,0,2
9957,775897,21,0,2,0,1,0,1,0,0,0,0,0,1,0,0,0,0
9957,780324,33,9,18,9,18,0,0,1,2,4,8,5,2,4,3,0,19
9957,791543,27,3,7,2,6,1,1,0,0,0,0,2,3,2,1,0,7
9957,786530,39,2,5,1,3,1,2,4,6,0,4,4,2,2,4,0,9
9957,780317,36,5,8,5,6,0,2,4,5,0,2,0,3,1,0,1,14
9957,784246,19,1,2,0,0,1,2,0,0,1,4,4,2,1,1,0,3
9957,791545,18,4,6,3,4,1,2,5,7,0,3,1,1,2,0,2,14
9957,797092,7,2,3,2,3,0,0,1,2,1,1,0,2,0,1,1,5
9958,791980,21,1,4,1,2,0,2,2,2,5,4,0,0,0,3,0,4
9958,785972,32,6,16,6,15,0,1,2,2,4,3,2,1,1,1,0,14
9958,785967,21,2,9,2,9,0,0,3,3,0,3,1,1,1,2,1,7
9958,791977,36,8,15,1,2,7,13,0,0,1,2,3,3,1,0,0,23
9958,791978,37,4,10,1,5,3,5,0,0,1,3,7,2,3,4,0,11
9958,791976,27,4,12,3,7,1,5,2,2,1,1,2,2,0,3,0,11
9958,780160,19,1,4,1,4,0,0,0,2,5,4,3,4,1,1,0,2
9958,785973,6,0,0,0,0,0,0,0,0,0,0,0,1,1,0,0,0
9958,797800,1,0,0,0,0,0,0,0,0,0,0,0,1,0,0,0,0
9959,792181,35,5,9,3,6,2,3,0,2,1,6,1,3,0,4,5,12
9959,785902,11,1,4,0,0,1,4,0,0,0,0,2,2,0,0,0,3
9959,780986,38,4,6,4,6,0,0,4,4,1,5,5,4,2,2,1,12
9959,792179,29,4,8,0,0,4,8,0,1,0,6,7,0,1,3,0,12
9959,786662,37,8,17,2,4,6,13,3,4,0,3,1,1,2,4,0,25
9959,786661,29,3,6,2,3,1,3,0,0,1,2,0,0,0,0,0,7
9959,797796,14,2,2,2,2,0,0,0,0,0,0,2,0,1,1,0,4
9959,792177,7,0,0,0,0,0,0,0,0,1,1,0,4,0,1,0,0
9960,785287,12,0,0,0,0,0,0,0,0,0,1,0,4,3,0,0,0
9960,776286,24,2,6,2,5,0,1,0,0,1,1,4,4,1,0,0,4
9960,791445,26,1,9,1,4,0,5,2,2,1,5,2,3,2,3,0,4
9960,785357,40,7,15,2,6,5,9,3,6,4,5,1,1,2,4,1,22
9960,775560,32,6,12,4,8,2,4,3,4,1,4,2,1,0,3,1,17
9960,781627,19,3,7,2,6,1,1,0,1,2,0,1,1,0,0,0,7
9960,797010,26,3,10,3,8,0,2,2,3,3,3,0,0,1,0,0,8
9960,775557,19,0,0,0,0,0,0,1,2,2,0,1,0,0,0,2,1
9960,797012,2,0,0,0,0,0,0,0,0,0,0,0,0,0,0,0,0
9961,780634,26,2,4,2,4,0,0,2,4,1,3,1,1,1,0,1,6
9961,791826,25,2,2,1,1,1,1,0,0,1,4,4,1,0,2,0,5
9961,786785,31,2,8,0,3,2,5,0,0,1,4,2,3,1,2,2,6
9961,780633,31,5,10,4,7,1,3,3,4,0,2,4,4,0,5,0,14
9961,776009,33,4,12,3,8,1,4,0,0,0,1,3,2,0,2,0,9
9961,797389,13,2,4,2,4,0,0,0,0,3,2,0,0,0,1,0,4
9961,786784,23,3,6,1,4,2,2,2,2,0,1,0,2,1,0,0,10
9961,786783,18,2,4,2,3,0,1,2,2,0,4,0,5,1,1,0,6
9962,791981,36,8,14,6,9,2,5,0,0,4,2,6,1,1,0,1,18
9962,780342,30,5,9,4,5,1,4,4,4,1,8,4,2,0,1,0,15
9962,791982,34,6,12,4,7,2,5,1,1,0,4,5,2,0,0,0,15
9962,791985,13,2,3,0,0,2,3,0,1,0,1,0,0,0,1,0,6
9962,781493,26,4,7,1,1,3,6,0,0,0,2,1,2,0,2,0,11
9962,786755,11,0,2,0,2,0,0,0,0,1,1,0,2,1,0,0,0
9962,791986,22,2,3,1,1,1,2,1,1,0,1,0,0,2,0,0,6
9962,786756,19,3,5,0,1,3,4,0,0,0,0,3,1,1,0,0,9
9962,791984,8,1,1,0,0,1,1,1,2,0,1,0,1,1,1,0,4
9962,800198,1,0,0,0,0,0,0,0,0,0,0,0,0,0,0,0,0
9963,791883,37,2,5,1,2,1,3,2,2,3,6,1,4,0,2,1,7
9963,797594,33,4,8,1,1,3,7,0,0,0,3,3,3,0,1,0,11
9963,791884,39,8,16,6,11,2,5,7,8,1,5,4,2,0,0,0,25
9963,781066,39,3,7,3,7,0,0,2,2,4,2,3,1,1,1,0,8
9963,780695,37,4,15,2,5,2,10,0,0,0,2,1,3,1,3,0,10
9963,786496,11,0,0,0,0,0,0,0,0,0,0,0,0,0,1,0,0
9963,797597,1,0,1,0,0,0,1,0,0,0,0,0,0,0,0,0,0
9963,791885,1,0,0,0,0,0,0,0,0,0,0,0,0,0,1,0,0
9963,797600,1,0,0,0,0,0,0,0,0,0,0,0,0,0,0,0,0
9963,797598,1,0,0,0,0,0,0,0,0,0,0,0,0,0,0,0,0
9964,785298,17,1,4,1,4,0,0,2,2,2,1,0,1,0,0,0,4
9964,778046,29,5,11,3,7,2,4,4,6,0,4,2,4,1,1,0,16
9964,782121,37,6,8,4,5,2,3,2,4,0,1,8,3,2,3,0,16
9964,775793,34,3,11,2,8,1,3,2,2,0,2,2,2,0,0,0,9
9964,775224,27,3,4,3,4,0,0,0,0,2,5,1,0,0,0,0,6
9964,785302,24,5,12,3,7,2,5,5,6,1,5,1,0,2,0,0,17
9964,785485,10,1,2,1,2,0,0,0,0,0,1,1,3,0,0,0,2
9964,786594,22,1,3,0,1,1,2,3,3,0,0,0,2,1,0,0,6
9964,785301,0,0,0,0,0,0,0,0,0,0,1,0,0,0,0,0,0
9964,796599,0,0,0,0,0,0,0,0,0,0,0,0,0,0,0,0,0
9964,790987,0,0,0,0,0,0,0,0,0,0,0,0,0,0,0,0,0
9964,796598,0,0,0,0,0,0,0,0,0,0,0,0,0,0,0,0,0
9964,778469,0,0,0,0,0,0,0,0,0,0,0,0,0,0,0,0,0
9965,790930,22,1,1,1,1,0,0,2,2,1,2,1,2,0,0,1,4
9965,780358,18,5,7,4,6,1,1,0,0,2,2,1,2,0,1,1,11
9965,775011,29,3,5,2,3,1,2,1,2,2,3,0,2,0,0,0,8
9965,780357,38,3,11,1,5,2,6,0,0,0,3,4,3,0,3,0,8
9965,775018,37,5,17,3,9,2,8,0,0,1,1,4,1,0,4,0,12
9965,776004,27,4,9,3,6,1,3,1,2,1,9,3,4,0,2,3,10
9965,796480,24,4,5,3,4,1,1,1,1,0,2,0,4,0,3,0,10
9965,796483,0,0,0,0,0,0,0,0,0,0,0,0,0,0,0,0,0
9965,796482,0,0,0,0,0,0,0,0,0,0,0,0,0,0,0,0,0
9965,796486,0,0,0,0,0,0,0,0,0,0,0,0,0,0,0,0,0
9965,785491,0,0,0,0,0,0,0,0,0,0,0,0,0,0,0,0,0
9965,776270,5,0,0,0,0,0,0,0,0,0,0,0,0,0,0,0,0
9966,796560,28,0,4,0,3,0,1,1,2,2,8,4,3,0,2,0,1
9966,780119,39,9,11,9,11,0,0,2,3,3,3,2,2,0,1,1,20
9966,796558,37,7,15,7,14,0,1,1,2,0,6,1,2,0,1,0,15
9966,796559,39,6,11,4,5,2,6,1,2,2,4,1,2,0,1,0,15
9966,776097,31,2,9,2,8,0,1,6,6,2,1,2,4,0,2,0,10
9966,780149,23,2,11,0,4,2,7,1,2,0,3,0,2,0,2,0,7
9966,785280,3,0,1,0,0,0,1,0,0,0,1,0,1,0,0,0,0
9967,780323,18,2,7,2,7,0,0,1,2,4,1,1,1,0,1,0,5
9967,792233,35,6,16,3,12,3,4,5,5,1,2,0,3,1,0,0,20
9967,792229,34,6,13,5,9,1,4,2,3,2,6,2,4,0,1,0,15
9967,785954,35,4,11,1,5,3,6,0,1,2,6,5,4,1,3,1,11
9967,785811,35,2,6,1,4,1,2,4,7,1,2,2,2,0,1,1,9
9967,797894,15,0,4,0,4,0,0,0,0,1,2,1,3,0,0,0,0
9967,792230,5,0,0,0,0,0,0,0,0,0,1,1,1,0,1,0,0
9967,786016,9,0,0,0,0,0,0,0,0,0,0,0,1,1,2,1,0
9967,797891,11,2,4,0,0,2,4,0,0,0,2,0,0,0,0,0,6
9967,792234,1,0,0,0,0,0,0,0,0,0,0,0,0,0,0,0,0
9967,781356,2,0,0,0,0,0,0,0,0,0,0,0,0,0,0,0,0
9968,785368,29,5,6,5,6,0,0,4,4,4,6,0,1,1,5,3,14
9968,780281,21,4,6,4,4,0,2,0,0,3,2,1,3,0,1,0,8
9968,790793,37,8,16,5,8,3,8,0,1,0,7,4,3,0,4,0,19
9968,785246,31,7,11,4,4,3,7,0,0,0,4,0,1,1,1,0,17
9968,780886,37,5,11,4,7,1,4,3,3,0,2,5,3,3,3,0,14
9968,796351,16,1,1,1,1,0,0,0,1,1,2,1,3,1,3,0,2
9968,790794,11,2,4,2,4,0,0,0,0,1,1,1,2,0,1,0,4
9968,790792,18,0,3,0,2,0,1,0,0,1,0,0,3,1,1,0,0
9969,786547,21,1,5,1,1,0,4,0,0,2,1,3,2,3,1,0,2
9969,786544,40,9,16,5,9,4,7,6,9,3,8,0,1,4,2,0,28
9969,797507,34,4,7,3,3,1,4,0,0,0,1,1,1,3,2,0,9
9969,792012,40,6,14,4,7,2,7,12,12,0,2,7,3,2,5,0,26
9969,786546,35,4,6,3,4,1,2,0,1,0,3,1,2,0,1,0,9
9969,786860,19,1,6,0,2,1,4,0,0,0,0,0,2,0,0,0,3
9969,797510,11,1,3,0,1,1,2,1,1,0,0,0,0,0,0,0,4
9969,792013,0,0,0,0,0,0,0,0,0,0,0,0,0,0,0,0,0
9970,796439,25,1,4,1,4,0,0,1,4,3,3,0,5,0,1,0,3
9970,790884,10,2,4,2,4,0,0,0,0,0,0,0,3,0,1,0,4
9970,790883,34,3,12,3,9,0,3,10,13,1,2,4,4,4,0,0,16
9970,796436,40,6,20,2,9,4,11,8,10,1,3,3,4,5,1,0,24
9970,785436,22,0,3,0,3,0,0,0,2,1,4,1,2,1,3,0,0
9970,796442,11,2,3,2,3,0,0,2,2,1,0,0,2,0,1,1,6
9970,796438,21,0,3,0,0,0,3,0,0,1,0,2,0,1,1,0,0
9970,791635,11,1,3,0,0,1,3,1,2,0,0,0,5,0,0,0,4
9970,790885,23,3,11,0,3,3,8,4,5,3,5,0,2,0,0,1,13
9970,781262,3,0,2,0,1,0,1,0,0,0,0,0,1,0,0,0,0
9970,790520,0,0,0,0,0,0,0,0,0,0,0,0,1,0,0,0,0
9971,796404,23,3,8,3,8,0,0,0,0,1,11,2,4,0,4,2,6
9971,790853,31,2,5,2,5,0,0,3,4,4,8,2,3,0,2,4,7
9971,790850,31,3,10,1,2,2,8,7,7,0,6,1,3,0,3,0,15
9971,781164,26,0,3,0,0,0,3,0,0,1,0,0,3,0,1,0,0
9971,781163,28,5,11,4,7,1,4,15,16,0,7,0,4,0,3,1,26
9971,785434,26,4,9,1,4,3,5,4,4,2,3,0,2,0,0,0,15
9971,790854,9,2,2,2,2,0,0,1,1,0,1,2,2,0,2,4,5
9971,790849,9,0,1,0,1,0,0,2,2,0,3,0,1,1,1,0,2
9971,790848,2,0,0,0,0,0,0,0,0,0,0,0,0,1,1,0,0
9971,781223,15,2,2,2,2,0,0,0,1,0,2,0,2,0,0,0,4
9972,796664,32,3,9,1,6,2,3,0,0,2,3,1,1,0,0,0,8
9972,785333,33,1,8,1,4,0,4,2,4,1,5,3,0,1,2,0,4
9972,796665,35,4,13,3,8,1,5,0,0,1,2,1,1,0,0,0,9
9972,780291,18,3,11,3,10,0,1,0,0,2,2,2,2,2,0,0,6
9972,785607,19,3,5,3,5,0,0,0,0,1,4,1,5,0,0,3,6
9972,796663,12,2,4,2,4,0,0,0,0,1,1,0,1,0,0,2,4
9972,796666,10,1,3,1,2,0,1,0,0,2,0,2,2,0,0,1,2
9972,791004,24,5,12,2,4,3,8,0,0,1,4,1,0,0,1,0,13
9972,791005,3,0,0,0,0,0,0,0,0,0,0,0,0,0,0,0,0
9972,791006,14,0,5,0,4,0,1,0,0,1,2,1,1,0,2,0,0
9973,792163,24,0,5,0,2,0,3,0,0,1,1,1,1,1,0,1,0
9973,792164,33,5,14,3,8,2,6,4,4,0,3,1,1,1,3,0,16
9973,797772,25,1,6,1,3,0,3,0,0,0,8,1,1,0,0,0,2
9973,792167,21,7,11,7,11,0,0,1,6,4,8,0,2,1,0,1,15
9973,797777,19,3,6,3,6,0,0,2,2,3,3,1,2,0,1,1,8
9973,780974,23,0,5,0,2,0,3,2,2,1,2,0,0,0,1,0,2
9973,791372,19,2,5,2,3,0,2,0,0,0,2,0,1,0,2,0,4
9973,797766,16,2,4,2,3,0,1,0,0,3,4,1,2,0,1,0,4
9973,797767,20,1,3,1,2,0,1,0,0,1,1,4,1,2,1,0,2
9974,791023,11,2,7,1,4,1,3,2,2,1,0,0,1,0,1,1,7
9974,796685,34,8,14,4,7,4,7,4,4,0,3,0,3,4,2,0,24
9974,791027,37,7,15,7,11,0,4,3,4,1,4,4,3,0,1,0,17
9974,791024,30,5,13,3,9,2,4,0,0,1,1,1,2,2,3,0,12
9974,777572,38,4,11,3,5,1,6,3,3,1,9,1,1,2,2,0,12
9974,796686,2,0,0,0,0,0,0,0,0,0,0,0,1,0,0,0,0
9974,791028,12,0,3,0,0,0,3,2,2,0,2,1,1,0,1,0,2
9974,796684,14,2,4,0,2,2,2,0,0,0,0,0,2,0,2,0,6
9974,781507,22,1,5,1,3,0,2,0,1,0,4,2,4,1,2,0,2
9975,791135,27,7,10,7,10,0,0,3,4,6,10,3,4,0,2,1,17
9975,796791,26,5,9,3,3,2,6,3,4,0,0,1,0,1,1,0,15
9975,791132,29,3,11,1,5,2,6,4,5,4,5,2,4,0,5,0,12
9975,786090,34,10,14,7,10,3,4,2,2,1,8,1,3,3,5,0,25
9975,786088,34,1,5,1,5,0,0,3,4,1,7,10,1,1,3,0,5
9975,791131,7,0,2,0,1,0,1,0,0,0,1,1,0,0,2,1,0
9975,791521,7,1,1,1,1,0,0,0,0,0,0,1,1,1,0,1,2
9975,796790,17,1,7,1,3,0,4,0,0,1,1,1,0,0,1,0,2
9975,774921,19,5,13,3,8,2,5,3,6,2,4,1,4,3,1,0,15
9976,780283,31,5,7,5,7,0,0,2,6,2,10,1,3,1,2,1,12
9976,785474,32,2,7,1,4,1,3,1,2,3,4,5,1,1,1,0,6
9976,785476,28,3,6,3,6,0,0,0,0,0,1,4,4,0,1,0,6
9976,790925,34,4,11,4,9,0,2,2,2,3,4,2,3,0,0,2,10
9976,791456,27,7,15,4,8,3,7,0,0,0,3,1,1,1,0,1,17
9976,796470,14,2,4,2,3,0,1,1,2,3,4,1,1,0,2,0,5
9976,790926,13,3,4,1,2,2,2,0,0,0,1,0,1,0,0,0,8
9976,785480,18,1,4,0,0,1,4,0,0,0,3,1,1,0,1,0,3
9976,785478,1,0,0,0,0,0,0,0,1,0,0,0,0,1,0,0,0
9976,796471,1,0,0,0,0,0,0,0,0,0,0,0,0,0,0,0,0
9976,790343,1,0,0,0,0,0,0,0,0,0,0,0,0,0,0,0,0
9977,786805,30,1,9,1,8,0,1,1,2,1,3,1,2,1,2,0,3
9977,774936,11,3,6,3,6,0,0,2,2,1,3,0,1,0,0,0,8
9977,786803,19,1,5,0,3,1,2,2,2,0,3,1,0,0,1,0,5
9977,790932,34,2,8,1,6,1,2,3,3,1,1,2,0,0,2,1,8
9977,781345,37,2,5,2,4,0,1,1,2,2,6,7,1,1,1,0,5
9977,790933,22,6,12,4,6,2,6,0,0,0,0,0,0,1,2,0,14
9977,786804,13,0,3,0,1,0,2,0,0,1,1,0,0,0,0,0,0
9977,790934,10,0,2,0,1,0,1,0,0,0,2,0,4,0,0,1,0
9977,780033,14,1,3,1,2,0,1,0,0,0,3,2,4,0,0,0,2
9977,796487,6,1,4,1,1,0,3,0,0,0,0,0,3,0,0,0,2
9977,796490,1,0,0,0,0,0,0,0,0,1,1,0,0,0,1,0,0
9977,796489,1,0,0,0,0,0,0,0,0,0,0,0,0,0,0,0,0
9977,780030,1,0,0,0,0,0,0,0,0,0,0,0,0,0,0,0,0
9977,796488,1,0,0,0,0,0,0,0,0,0,0,0,0,0,0,0,0
9978,785714,32,6,7,6,7,0,0,0,0,4,11,0,3,1,2,0,12
9978,775894,34,6,13,5,10,1,3,2,2,0,5,3,2,1,2,0,15
9978,785711,38,7,16,3,9,4,7,2,2,0,3,2,2,1,1,1,20
9978,780985,37,3,5,1,2,2,3,2,3,1,4,5,2,2,2,0,10
9978,775266,34,4,12,3,7,1,5,2,2,1,2,2,3,0,1,0,11
9978,791167,10,1,4,0,2,1,2,1,2,0,1,0,3,0,0,0,4
9978,796829,8,0,1,0,1,0,0,0,2,0,1,0,1,0,1,1,0
9978,785378,2,0,1,0,1,0,0,0,0,0,0,0,0,0,1,0,0
9978,779994,3,0,1,0,0,0,1,0,0,1,1,0,0,0,1,0,0
9978,785710,1,0,0,0,0,0,0,0,0,0,0,0,0,0,0,0,0
9978,780988,1,0,0,0,0,0,0,0,0,0,0,0,0,0,0,0,0
9978,791169,0,0,0,0,0,0,0,0,0,0,0,0,0,0,0,0,0
9978,796828,0,0,0,0,0,0,0,0,0,0,0,0,0,0,0,0,0
9978,796826,0,0,0,0,0,0,0,0,0,0,0,0,0,0,0,0,0
9979,792197,33,4,12,2,4,2,8,0,0,1,5,0,2,1,1,0,10
9979,781132,38,3,12,2,6,1,6,2,4,1,9,3,2,1,6,0,9
9979,797517,23,5,8,5,8,0,0,2,2,3,6,0,3,1,3,1,12
9979,791940,32,4,14,1,5,3,9,0,0,0,1,2,4,0,0,0,11
9979,786534,40,1,10,1,7,0,3,2,4,3,6,7,0,1,4,0,4
9979,797522,9,2,2,2,2,0,0,0,2,2,0,0,2,0,0,0,4
9979,797518,20,2,8,1,4,1,4,3,4,0,1,0,4,1,0,0,8
9979,791938,5,0,0,0,0,0,0,0,0,0,0,0,0,0,0,0,0
9980,781300,28,2,8,2,8,0,0,5,7,2,4,2,0,0,4,0,9
9980,790803,11,2,2,2,2,0,0,1,1,0,0,1,5,0,2,1,5
9980,790801,18,0,2,0,1,0,1,2,2,0,1,0,1,0,1,1,2
9980,781304,31,2,3,2,3,0,0,3,4,1,1,3,1,1,0,0,7
9980,781302,28,8,12,4,5,4,7,2,2,1,4,4,1,4,1,0,22
9980,780598,20,4,8,3,4,1,4,2,3,1,4,0,1,1,0,0,11
9980,796360,22,2,2,2,2,0,0,2,2,0,1,5,1,3,3,0,6
9980,796363,11,2,4,2,3,0,1,0,0,0,0,0,0,0,1,0,4
9980,796364,7,0,0,0,0,0,0,0,0,0,2,0,2,0,1,1,0
9980,790802,9,0,3,0,0,0,3,0,0,0,0,1,1,1,0,0,0
9980,781305,11,2,2,1,1,1,1,0,0,0,1,0,1,0,0,0,5
9980,781306,1,0,0,0,0,0,0,0,0,0,1,0,0,0,0,0,0
9980,776372,1,0,0,0,0,0,0,0,0,0,0,0,1,0,0,0,0
9980,796362,1,0,0,0,0,0,0,0,0,0,0,0,0,0,0,0,0
9980,776366,1,0,0,0,0,0,0,0,0,0,0,0,0,0,0,0,0
9981,780919,20,3,4,3,3,0,1,5,7,3,0,1,4,0,4,0,11
9981,775640,8,0,0,0,0,0,0,0,0,1,0,0,3,0,0,0,0
9981,785803,24,1,3,1,2,0,1,0,0,1,1,2,2,0,0,1,2
9981,780920,29,4,12,4,8,0,4,2,2,2,2,1,3,2,5,1,10
9981,780914,28,5,9,2,4,3,5,0,0,3,3,2,2,0,4,0,13
9981,775816,23,1,9,0,3,1,6,0,0,2,6,0,4,0,2,0,3
9981,796799,10,1,2,1,2,0,0,0,0,0,0,0,2,1,1,0,2
9981,796797,24,0,5,0,3,0,2,0,0,3,1,1,1,0,1,0,0
9981,791142,18,2,4,1,3,1,1,0,0,0,0,4,1,2,1,0,5
9981,791141,14,3,8,2,3,1,5,0,0,0,1,1,0,0,0,0,7
9981,796801,1,0,0,0,0,0,0,0,0,0,0,0,0,0,0,0,0
9981,796796,1,0,0,0,0,0,0,0,2,0,0,0,0,0,0,0,0
9982,790941,25,2,4,2,4,0,0,2,2,3,4,1,0,0,0,1,6
9982,780059,17,2,4,2,3,0,1,2,2,4,2,1,4,0,3,0,6
9982,796496,17,2,3,2,3,0,0,0,0,0,3,0,1,1,1,3,4
9982,790944,32,6,11,1,3,5,8,4,4,0,3,3,0,1,1,0,21
9982,780061,32,7,15,3,6,4,9,2,2,2,4,2,0,2,1,0,20
9982,786754,29,6,15,4,9,2,6,0,0,2,3,11,2,0,3,0,14
9982,796494,23,4,6,2,2,2,4,0,0,1,3,0,0,0,0,0,10
9982,780058,16,5,7,2,2,3,5,0,0,3,2,1,1,1,0,0,13
9982,790943,2,0,0,0,0,0,0,0,0,0,0,0,1,0,0,0,0
9982,796497,1,1,1,1,1,0,0,0,0,0,0,0,0,0,0,0,2
9982,785097,1,0,0,0,0,0,0,0,0,0,0,0,0,0,0,0,0
9982,776110,2,0,0,0,0,0,0,0,0,0,0,0,0,0,0,0,0
9982,788853,1,0,0,0,0,0,0,0,0,0,0,0,0,0,0,0,0
9982,796495,1,0,0,0,0,0,0,0,0,0,0,0,0,0,0,0,0
9982,796499,1,0,0,0,0,0,0,0,0,0,0,0,0,0,0,0,0
9983,791585,29,5,10,3,6,2,4,0,1,0,0,5,4,1,1,0,12
9983,791581,30,3,4,3,3,0,1,0,0,0,2,4,1,2,2,0,6
9983,786395,34,5,14,3,5,2,9,1,2,2,4,1,1,1,1,0,13
9983,786394,38,11,17,6,9,5,8,0,2,2,4,3,2,2,3,0,27
9983,780404,31,4,8,4,5,0,3,2,2,0,2,3,1,0,0,1,10
9983,780403,5,0,0,0,0,0,0,0,0,0,0,0,1,0,1,0,0
9983,780062,4,1,1,1,1,0,0,0,0,0,0,0,0,0,0,0,2
9983,785228,25,2,5,1,3,1,2,0,0,0,3,1,0,0,0,0,5
9983,791582,1,1,1,1,1,0,0,0,0,0,0,0,0,0,0,0,2
9983,797037,1,0,0,0,0,0,0,0,0,0,0,0,0,0,0,0,0
9983,799920,1,0,0,0,0,0,0,0,0,0,0,0,0,0,0,0,0
9983,797041,1,0,0,0,0,0,0,0,0,0,0,0,0,0,0,0,0
9984,780027,36,14,20,11,16,3,4,5,7,4,5,1,3,1,1,0,36
9984,786176,34,7,17,4,9,3,8,0,0,1,5,5,0,0,3,1,17
9984,786173,13,0,3,0,1,0,2,0,0,0,0,0,1,1,0,0,0
9984,780028,12,0,1,0,1,0,0,0,0,0,1,1,1,0,2,0,0
9984,774828,19,0,4,0,2,0,2,0,0,0,1,3,1,0,1,0,0
9984,797176,3,0,0,0,0,0,0,0,0,0,1,0,0,0,0,0,0
9984,791379,20,4,6,4,4,0,2,2,2,0,2,1,0,1,0,1,10
9984,797178,13,2,4,1,3,1,1,0,0,0,1,2,4,1,0,0,5
9984,791380,13,2,3,2,3,0,0,1,1,1,1,4,2,2,3,0,5
9984,797179,12,0,0,0,0,0,0,1,2,1,1,4,0,0,0,1,1
9984,797175,24,2,9,1,4,1,5,1,2,2,2,1,1,1,1,1,6
9984,780026,1,0,1,0,0,0,1,0,0,0,0,0,0,0,0,0,0
9984,786170,0,0,0,0,0,0,0,0,0,0,0,0,0,0,0,0,0
9984,797177,0,0,0,0,0,0,0,0,0,0,0,0,0,0,0,0,0
9985,780094,32,3,9,2,6,1,3,2,2,1,1,1,3,0,1,1,9
9985,775142,34,8,15,7,10,1,5,0,2,2,4,5,2,2,2,2,17
9985,790843,32,9,12,8,9,1,3,4,5,0,3,7,2,1,2,0,23
9985,786212,30,8,14,3,5,5,9,0,0,3,4,1,2,3,2,0,21
9985,785392,40,7,10,4,6,3,4,2,2,0,6,7,3,1,3,0,19
9985,790844,12,1,2,1,2,0,0,0,0,0,2,0,1,0,0,1,2
9985,781563,10,0,2,0,1,0,1,0,0,0,1,2,0,0,0,0,0
9985,796914,4,0,1,0,1,0,0,0,0,1,0,1,0,0,0,0,0
9985,799986,6,2,3,2,3,0,0,0,0,0,1,1,0,0,0,2,4
9985,781161,0,0,0,0,0,0,0,0,0,0,1,0,0,0,0,0,0
9985,790847,0,0,0,0,0,0,0,0,0,0,0,0,0,0,0,0,0
9985,792125,0,0,0,0,0,0,0,0,0,0,0,0,0,0,0,0,0
9985,785396,0,0,0,0,0,0,0,0,0,0,0,0,0,0,0,0,0
9986,790798,35,9,12,9,12,0,0,12,14,6,7,4,1,0,1,1,30
9986,780140,30,5,11,1,3,4,8,2,2,0,3,0,3,1,2,0,16
9986,796355,35,5,13,4,7,1,6,5,6,1,2,3,3,3,4,0,16
9986,785245,38,3,5,2,3,1,2,0,0,0,0,2,1,1,1,0,7
9986,780137,37,3,8,1,3,2,5,4,4,2,6,0,2,0,1,0,12
9986,775553,7,1,2,1,1,0,1,0,0,0,1,1,0,0,1,0,2
9986,790799,18,2,6,2,6,0,0,0,0,0,3,2,2,2,0,1,4
9987,790877,24,5,8,5,8,0,0,1,2,2,1,0,2,1,0,1,11
9987,779985,25,1,8,0,5,1,3,0,0,0,5,0,2,0,0,1,3
9987,785699,37,3,6,2,4,1,2,0,0,3,6,2,5,1,3,0,7
9987,781062,21,2,5,0,0,2,5,0,0,0,1,1,2,0,1,0,6
9987,774987,34,11,17,10,13,1,4,4,4,1,1,2,4,2,5,0,27
9987,785432,28,0,3,0,3,0,0,2,4,0,1,4,4,0,0,5,2
9987,790879,4,0,0,0,0,0,0,0,0,0,1,0,1,0,1,0,0
9987,790882,26,7,11,7,9,0,2,1,2,0,2,1,1,0,2,1,15
9987,796434,1,0,0,0,0,0,0,0,0,0,0,0,0,0,0,0,0
9988,786566,26,8,13,6,10,2,3,4,4,0,5,1,4,0,4,0,22
9988,786568,30,6,9,6,9,0,0,1,2,5,6,0,4,2,2,2,13
9988,791995,24,3,7,0,0,3,7,2,2,1,4,0,3,0,0,0,11
9988,781189,38,6,12,6,10,0,2,2,2,1,5,3,1,2,2,0,14
9988,781188,38,4,10,4,9,0,1,6,6,1,4,13,2,0,2,1,14
9988,797493,22,3,4,3,4,0,0,0,0,3,2,1,1,1,1,0,6
9988,786565,2,0,2,0,1,0,1,0,0,0,0,0,0,0,0,0,0
9988,786562,20,0,4,0,2,0,2,0,0,0,2,1,2,1,0,0,0
9989,797174,23,3,4,3,4,0,0,0,0,0,6,3,2,0,2,0,6
9989,791510,17,1,5,1,2,0,3,2,2,0,2,1,2,0,1,0,4
9989,786699,16,1,1,1,1,0,0,0,0,0,1,1,2,0,0,1,2
9989,785593,26,1,7,1,3,0,4,2,3,1,1,1,3,1,1,0,4
9989,775357,35,6,10,1,2,5,8,4,5,0,4,4,0,1,1,0,21
9989,791507,24,3,6,3,6,0,0,0,0,2,2,0,2,1,2,1,6
9989,797168,26,3,7,1,4,2,3,5,6,2,2,3,1,0,5,0,13
9989,791504,21,5,7,5,7,0,0,0,1,0,0,1,2,0,2,0,10
9989,791505,12,0,5,0,2,0,3,0,0,0,1,0,0,1,0,0,0
9990,785370,27,2,6,2,4,0,2,3,4,1,4,0,2,1,0,2,7
9990,796309,31,4,7,4,7,0,0,4,5,1,10,3,4,0,3,1,12
9990,790824,33,5,9,4,5,1,4,4,6,1,6,2,3,0,2,1,15
9990,780011,32,7,11,2,2,5,9,2,2,0,4,7,1,0,1,0,21
9990,775667,32,2,8,1,4,1,4,0,0,1,1,6,1,0,4,0,5
9990,781524,27,6,9,3,3,3,6,6,6,0,3,1,4,0,0,0,21
9990,774895,9,0,0,0,0,0,0,1,2,0,1,0,1,0,0,0,1
9990,796383,9,2,2,2,2,0,0,0,0,1,0,3,1,0,1,0,4
9991,791522,35,4,11,4,10,0,1,3,8,0,4,0,5,0,0,3,11
9991,786351,27,2,6,1,3,1,3,1,1,1,2,0,4,0,0,1,6
9991,797146,40,10,23,7,18,3,5,7,7,1,2,0,2,1,2,1,30
9991,786348,24,1,3,1,2,0,1,0,0,2,1,2,2,3,0,0,2
9991,797143,40,10,23,8,13,2,10,5,5,1,8,6,1,1,1,0,27
9991,785816,18,0,1,0,1,0,0,2,2,2,1,0,4,0,0,0,2
9991,797147,9,0,2,0,1,0,1,0,0,0,0,0,2,0,0,0,0
9991,797144,1,0,0,0,0,0,0,0,0,0,0,0,0,0,0,0,0
9991,797142,6,0,0,0,0,0,0,0,0,0,0,0,0,0,0,0,0
9992,796585,13,2,3,2,3,0,0,0,0,0,0,0,0,0,0,0,4
9992,780192,32,5,12,2,6,3,6,1,1,4,6,2,2,0,3,0,14
9992,798139,19,1,7,1,4,0,3,0,0,0,1,2,1,1,0,0,2
9992,786818,29,4,8,4,7,0,1,4,5,0,3,2,2,2,3,0,12
9992,780182,24,3,13,2,4,1,9,0,0,0,3,0,2,1,1,0,7
9992,796587,9,1,2,1,2,0,0,0,0,1,0,0,4,0,1,2,2
9992,780186,18,0,3,0,3,0,0,3,6,2,3,2,4,0,1,0,3
9992,798138,13,2,2,2,2,0,0,0,0,2,0,0,0,0,0,0,4
9992,796584,7,1,1,0,0,1,1,1,2,0,1,0,1,0,1,0,4
9992,786820,20,3,6,3,4,0,2,0,0,0,0,4,1,0,1,0,6
9992,780184,16,2,4,1,1,1,3,4,5,0,1,1,0,1,1,0,9
9993,775131,26,2,3,2,2,0,1,0,0,1,3,1,4,0,0,1,4
9993,796616,39,6,9,1,2,5,7,0,0,0,4,3,3,0,1,0,17
9993,796612,37,6,10,6,10,0,0,1,1,2,2,2,1,3,5,1,13
9993,796607,17,1,2,1,1,0,1,0,0,1,2,1,5,1,1,0,2
9993,785562,28,8,19,7,16,1,3,14,16,3,8,1,3,1,2,3,31
9993,792429,3,0,0,0,0,0,0,0,0,0,0,0,0,0,1,0,0
9993,796614,17,2,7,2,3,0,4,2,2,1,4,0,2,1,0,1,6
9993,796610,5,1,2,1,1,0,1,0,0,1,0,0,0,0,0,0,2
9993,796606,28,1,5,1,5,0,0,0,1,0,2,2,2,2,1,0,2
9994,785362,22,2,4,2,4,0,0,1,2,2,2,1,1,0,1,1,5
9994,796370,15,0,5,0,2,0,3,0,0,0,0,1,1,0,0,0,0
9994,790808,33,2,9,1,3,1,6,0,2,0,4,0,1,2,0,0,5
9994,785361,34,3,13,1,5,2,8,0,0,1,4,1,3,2,1,1,8
9994,779997,31,6,15,5,13,1,2,2,2,2,4,4,4,2,0,0,15
9994,774854,11,1,2,1,2,0,0,2,2,1,1,0,0,0,1,0,4
9994,790809,28,1,1,0,0,1,1,0,0,0,1,4,3,0,0,0,3
9994,790810,9,0,3,0,3,0,0,2,2,0,0,1,2,1,1,0,2
9994,796368,9,3,7,2,4,1,3,0,0,1,1,0,1,0,2,0,7
9994,796371,2,0,0,0,0,0,0,0,0,0,1,0,0,0,0,0,0
9994,796369,2,0,1,0,0,0,1,2,2,0,0,0,0,0,0,0,2
9994,790812,2,0,1,0,0,0,1,0,0,0,0,0,1,1,0,0,0
9994,779999,2,0,1,0,1,0,0,0,0,1,0,0,0,0,1,0,0
9995,790893,31,6,14,2,9,4,5,1,1,2,6,4,1,0,1,1,17
9995,796444,27,4,6,4,6,0,0,2,4,4,9,5,1,1,1,3,10
9995,786615,34,1,4,0,2,1,2,2,2,0,8,3,3,1,2,0,5
9995,786732,21,5,7,2,3,3,4,0,3,0,0,1,2,0,1,0,13
9995,775260,27,5,12,3,7,2,5,0,0,0,4,3,1,0,1,0,12
9995,790890,18,4,5,4,5,0,0,1,3,0,1,1,1,0,3,0,9
9995,790889,11,2,2,1,1,1,1,0,0,0,0,1,1,0,1,0,5
9995,775536,15,4,4,4,4,0,0,2,2,0,2,0,3,0,1,0,10
9995,796445,4,1,1,1,1,0,0,0,0,0,1,0,0,0,1,0,2
9995,791501,2,0,0,0,0,0,0,0,0,0,1,0,0,0,1,0,0
9995,799891,4,0,0,0,0,0,0,0,0,0,0,0,1,0,0,0,0
9995,780702,4,0,1,0,0,0,1,0,0,0,0,0,0,0,0,0,0
9995,796132,1,0,0,0,0,0,0,2,2,0,0,0,0,1,0,0,2
9995,792678,1,0,0,0,0,0,0,0,0,0,0,0,0,0,0,0,0
9996,791135,37,9,13,9,13,0,0,4,10,5,7,1,5,2,1,1,22
9996,796791,35,3,5,2,2,1,3,0,0,0,4,2,0,2,0,0,7
9996,791132,32,3,7,2,3,1,4,0,1,2,3,1,2,0,3,0,7
9996,786090,28,4,9,3,5,1,4,0,2,2,3,1,5,0,3,0,9
9996,786088,41,4,11,4,11,0,0,3,5,1,4,8,2,1,2,0,11
9996,791133,2,0,0,0,0,0,0,0,0,0,1,0,0,0,0,0,0
9996,791521,8,1,2,1,2,0,0,0,0,2,0,1,1,1,1,0,2
9996,796790,16,0,6,0,5,0,1,2,2,1,1,0,1,0,0,0,2
9996,774921,26,4,10,3,6,1,4,8,12,0,3,3,4,0,1,0,17
9997,797777,12,0,1,0,1,0,0,2,2,0,0,0,5,0,0,2,2
9997,792167,20,0,3,0,3,0,0,1,4,0,4,1,2,0,5,1,1
9997,792163,8,0,0,0,0,0,0,0,0,0,1,0,1,0,0,0,0
9997,797772,21,3,7,0,1,3,6,2,2,0,3,1,4,0,1,0,11
9997,792164,43,6,15,4,8,2,7,2,2,1,2,3,2,1,1,0,16
9997,797766,17,1,2,1,2,0,0,1,2,3,5,0,1,1,0,0,3
9997,797767,28,2,5,2,3,0,2,0,0,1,3,4,5,2,4,0,4
9997,797765,0,0,0,0,0,0,0,0,0,0,0,0,1,0,0,0,0
9997,791372,38,2,11,1,3,1,8,2,2,1,2,1,4,1,1,0,7
9997,780974,38,10,14,8,11,2,3,6,9,4,6,0,3,0,3,0,28
9998,775131,35,4,7,1,1,3,6,5,6,0,4,4,4,4,1,1,16
9998,796616,26,4,10,1,1,3,9,2,2,0,0,2,3,0,1,0,13
9998,796612,37,6,16,6,16,0,0,0,0,1,7,4,1,1,5,0,12
9998,796607,19,2,6,2,5,0,1,0,0,0,3,2,1,0,0,0,4
9998,785562,34,5,13,3,10,2,3,1,1,1,1,1,1,3,3,0,13
9998,792429,5,1,2,1,1,0,1,0,0,0,0,0,0,0,0,0,2
9998,796614,12,3,5,3,5,0,0,2,2,0,1,2,1,0,0,1,8
9998,796610,7,0,2,0,1,0,1,0,0,0,0,0,1,0,0,0,0
9998,796606,25,1,1,0,0,1,1,0,0,1,2,1,3,1,1,0,3
9999,786566,39,10,15,9,12,1,3,7,8,0,7,2,0,3,2,5,28
9999,786568,7,2,2,2,2,0,0,0,0,0,0,0,1,0,0,0,4
9999,791995,12,0,1,0,0,0,1,0,0,0,2,0,2,3,0,0,0
9999,781189,26,4,11,3,9,1,2,2,2,0,2,3,3,1,4,0,11
9999,781188,40,3,10,2,7,1,3,1,2,0,9,8,3,0,3,0,8
9999,797493,30,6,8,6,8,0,0,1,2,2,4,1,2,2,2,0,13
9999,781204,19,3,4,0,0,3,4,0,0,3,2,4,2,0,3,1,9
9999,791993,27,4,6,4,6,0,0,1,2,1,2,3,1,0,0,0,9
10000,786566,31,3,5,2,2,1,3,2,2,1,5,2,4,0,1,4,9
10000,786568,27,7,9,7,9,0,0,2,2,2,4,0,5,1,0,2,16
10000,791995,9,2,5,2,2,0,3,0,0,0,1,0,3,0,1,0,4
10000,781189,30,4,10,3,6,1,4,2,2,1,3,4,1,3,2,0,11
10000,781188,39,5,12,2,7,3,5,2,3,1,3,7,2,1,3,0,15
10000,797493,18,2,5,2,5,0,0,2,4,1,3,1,1,0,0,0,6
10000,781204,10,1,4,1,2,0,2,0,0,0,3,2,2,0,2,0,2
10000,791993,8,1,2,1,2,0,0,0,0,1,1,0,0,0,1,0,2
10000,786562,27,7,12,4,6,3,6,2,2,0,0,3,2,5,0,1,19
10000,786565,1,0,0,0,0,0,0,0,0,0,0,0,0,0,0,0,0
10001,791135,31,4,12,4,12,0,0,7,8,2,3,1,1,0,0,0,15
10001,796791,26,1,4,0,1,1,3,2,2,0,0,0,0,0,3,0,5
10001,791132,16,0,1,0,0,0,1,0,0,0,1,0,4,0,2,0,0
10001,786090,28,3,7,2,3,1,4,1,2,0,5,1,4,2,3,0,8
10001,786088,34,2,6,2,5,0,1,5,5,0,5,4,1,1,3,0,9
10001,791133,19,3,4,3,4,0,0,0,2,2,4,0,3,0,1,0,6
10001,791131,4,0,2,0,1,0,1,0,0,0,2,0,0,0,1,1,0
10001,791521,9,1,2,1,2,0,0,0,1,2,0,1,1,0,1,2,2
10001,796790,26,5,12,1,5,4,7,2,4,0,3,3,2,0,2,0,16
10001,786092,4,0,0,0,0,0,0,0,0,0,0,0,1,0,3,0,0
10001,774921,3,0,0,0,0,0,0,0,0,0,1,0,1,0,0,0,0
10002,791837,25,1,7,1,4,0,3,2,2,0,3,0,5,1,3,0,4
10002,786621,26,6,7,3,3,3,4,1,2,0,2,2,3,2,0,0,16
10002,780613,31,1,10,1,10,0,0,5,7,3,2,1,3,2,1,0,7
10002,797437,15,0,2,0,1,0,1,0,0,1,1,2,3,0,0,0,0
10002,780609,40,7,12,2,2,5,10,3,3,1,1,6,0,4,1,0,22
10002,786622,30,4,9,3,5,1,4,0,1,2,1,1,0,1,0,1,9
10002,797439,19,2,3,2,2,0,1,1,2,0,2,1,2,0,1,0,5
10002,786619,14,1,3,1,3,0,0,2,6,0,2,1,2,1,0,1,4
10003,796401,30,1,6,0,3,1,3,0,0,2,2,0,1,1,3,0,3
10003,785255,24,2,4,1,2,1,2,0,0,1,6,0,3,0,2,0,5
10003,775654,26,4,5,4,5,0,0,0,2,3,8,3,5,0,1,2,8
10003,791639,36,7,10,5,6,2,4,2,2,0,7,2,3,0,3,0,18
10003,785389,36,5,13,3,8,2,5,10,10,0,0,5,1,2,2,0,22
10003,791640,9,2,4,2,2,0,2,2,2,0,1,0,3,0,1,0,6
10003,796399,26,1,2,1,1,0,1,2,2,1,3,4,1,0,2,1,4
10003,796398,13,1,2,1,2,0,0,0,0,1,1,0,1,0,2,0,2
10004,785518,23,3,8,2,5,1,3,2,2,2,3,2,4,3,3,0,9
10004,796390,14,0,0,0,0,0,0,0,5,1,1,1,3,0,2,0,0
10004,790832,28,5,11,4,7,1,4,0,0,0,4,1,3,1,2,0,11
10004,790834,24,3,3,1,1,2,2,2,2,2,5,0,3,0,1,0,10
10004,785451,32,3,12,2,7,1,5,1,2,0,5,0,1,1,3,0,8
10004,790830,25,3,7,3,6,0,1,0,0,0,6,0,2,1,1,1,6
10004,790831,13,1,2,1,2,0,0,0,0,0,1,0,0,1,2,0,2
10004,790833,32,5,10,5,7,0,3,1,2,0,4,3,3,1,0,2,11
10004,785379,9,1,3,1,1,0,2,0,2,1,0,0,0,0,0,0,2
10005,781174,34,5,6,5,6,0,0,2,2,0,7,1,4,2,2,0,12
10005,785231,38,4,13,3,7,1,6,2,3,1,1,1,3,0,0,0,11
10005,781215,31,3,9,0,3,3,6,1,2,1,4,1,2,0,1,0,10
10005,779972,30,4,10,2,5,2,5,0,0,0,4,5,3,0,5,0,10
10005,775255,38,3,9,2,4,1,5,4,6,1,5,0,1,2,2,1,11
10005,796644,6,0,1,0,1,0,0,0,0,0,1,0,2,0,1,0,0
10005,791001,16,1,5,1,3,0,2,0,0,0,0,1,1,2,3,0,2
10005,796643,7,0,0,0,0,0,0,0,2,0,3,0,1,0,1,0,0
10006,791144,21,3,6,3,5,0,1,0,0,1,3,1,2,0,1,1,6
10006,785782,31,0,8,0,1,0,7,0,0,0,2,1,3,2,0,0,0
10006,791145,32,7,13,7,11,0,2,2,2,2,9,3,1,1,3,0,16
10006,791146,35,6,13,4,8,2,5,4,4,0,1,4,2,2,2,0,18
10006,785777,32,6,9,5,5,1,4,3,3,0,3,0,3,2,1,1,16
10006,791147,17,2,6,2,3,0,3,1,2,1,2,0,1,1,0,2,5
10006,786748,13,1,2,1,1,0,1,0,0,0,4,2,0,1,1,0,2
10006,791148,13,1,2,1,2,0,0,0,0,0,0,0,1,2,2,0,2
10006,796804,6,0,0,0,0,0,0,0,0,1,0,2,1,0,0,0,0
10007,785409,38,6,7,6,7,0,0,1,2,3,3,0,0,0,2,2,13
10007,785408,39,6,16,4,8,2,8,1,1,1,3,5,3,1,1,0,15
10007,785407,33,6,7,5,6,1,1,0,0,4,5,1,4,1,2,0,13
10007,796416,29,2,13,2,7,0,6,3,5,0,4,4,5,0,3,0,7
10007,790861,29,1,2,1,2,0,0,0,0,1,7,1,0,0,4,0,2
10007,796415,24,3,10,2,5,1,5,1,1,0,1,2,4,1,5,0,8
10007,796417,2,0,0,0,0,0,0,0,0,0,0,0,1,0,0,0,0
10007,790859,6,1,2,0,0,1,2,0,0,0,1,0,0,0,0,0,3
10008,785991,34,6,14,5,9,1,5,2,4,8,8,1,1,0,1,3,15
10008,792133,36,7,12,3,5,4,7,2,3,1,4,8,1,0,2,0,20
10008,797762,18,1,4,1,3,0,1,0,0,0,1,1,4,1,1,0,2
10008,781406,36,4,12,3,7,1,5,4,4,0,5,4,0,0,1,1,13
10008,781401,33,3,13,1,8,2,5,0,0,1,2,4,4,1,1,0,8
10008,797760,7,0,3,0,1,0,2,0,0,1,2,1,0,0,1,1,0
10008,792129,6,0,0,0,0,0,0,0,0,1,0,0,0,0,0,1,0
10008,781029,30,2,8,1,3,1,5,2,2,1,2,0,4,1,1,1,7
10009,791524,33,3,7,2,6,1,1,2,5,0,2,6,3,2,4,1,9
10009,797139,25,5,10,5,10,0,0,1,1,2,5,3,2,3,3,2,11
10009,780272,31,4,9,3,6,1,3,2,2,1,5,4,0,0,3,0,11
10009,775592,37,7,11,1,4,6,7,0,1,0,6,0,3,0,1,0,20
10009,775394,23,2,7,2,6,0,1,2,2,3,1,0,1,0,0,0,6
10009,785970,14,2,4,2,4,0,0,0,0,1,2,0,3,0,0,1,4
10009,791526,20,2,4,0,1,2,3,0,0,0,5,1,2,0,1,0,6
10009,780273,17,1,3,0,0,1,3,2,2,0,2,2,0,0,0,2,5
10010,791144,13,0,2,0,2,0,0,1,2,0,0,0,1,0,2,1,1
10010,785782,25,1,5,0,0,1,5,2,2,1,0,1,2,0,4,0,5
10010,791145,35,5,14,4,10,1,4,7,8,1,6,3,1,0,1,1,18
10010,791146,39,7,12,4,7,3,5,0,0,0,0,4,1,1,3,0,17
10010,785777,32,2,7,1,2,1,5,2,2,1,6,0,1,1,2,0,7
10010,791147,13,2,2,0,0,2,2,0,0,0,1,2,3,0,0,0,6
10010,791148,26,1,5,0,2,1,3,5,7,1,1,3,1,2,0,0,8
10010,786748,13,1,3,1,1,0,2,1,2,1,1,1,0,1,1,0,3
10010,796804,3,1,2,1,1,0,1,0,0,0,1,0,0,0,0,0,2
10010,796803,1,0,0,0,0,0,0,0,0,0,0,0,0,0,0,0,0
10011,785518,28,9,12,7,10,2,2,1,2,5,4,6,3,4,2,1,21
10011,796390,15,1,1,1,1,0,0,1,1,1,5,0,2,0,2,1,3
10011,790832,30,1,4,1,2,0,2,2,2,0,2,2,2,1,2,0,4
10011,790834,32,7,13,3,6,4,7,0,0,0,5,2,2,2,1,1,18
10011,785451,34,9,16,2,5,7,11,2,2,1,4,2,2,0,0,0,27
10011,790831,2,0,1,0,1,0,0,0,0,1,0,0,2,0,0,0,0
10011,790833,24,3,6,2,3,1,3,2,2,1,6,6,4,0,2,0,9
10011,790830,25,3,5,3,4,0,1,0,0,0,0,6,0,1,2,1,6
10011,785379,9,1,3,1,2,0,1,0,0,1,0,0,0,1,0,0,2
10011,796389,1,0,0,0,0,0,0,0,0,0,0,0,0,0,0,0,0
10012,797139,30,7,14,7,14,0,0,6,10,3,7,3,2,4,2,3,20
10012,775394,24,4,8,4,4,0,4,2,4,0,2,0,3,0,1,0,10
10012,791524,31,3,10,1,5,2,5,0,0,1,1,3,3,2,1,1,8
10012,780272,29,2,11,1,5,1,6,0,0,1,1,9,4,0,1,0,5
10012,775592,27,4,8,2,3,2,5,1,1,0,1,1,1,0,1,0,11
10012,791526,24,2,4,0,0,2,4,0,0,0,1,2,2,1,0,0,6
10012,785970,6,1,3,1,3,0,0,0,0,0,0,0,2,0,1,0,2
10012,780273,22,0,2,0,1,0,1,0,0,0,1,0,1,0,1,0,0
10012,786354,3,0,0,0,0,0,0,0,0,0,0,0,1,0,1,0,0
10012,791523,2,0,0,0,0,0,0,0,0,0,0,1,1,0,0,0,0
10012,797141,1,0,1,0,0,0,1,0,0,0,0,0,0,0,0,0,0
10012,791525,1,0,0,0,0,0,0,0,0,0,0,0,0,0,0,0,0
10013,796401,36,6,7,5,5,1,2,2,3,2,4,3,3,1,1,0,15
10013,796398,34,1,2,1,1,0,1,0,1,2,5,3,3,1,2,0,2
10013,775654,24,3,5,3,5,0,0,2,3,3,4,1,2,0,2,3,8
10013,791639,34,7,13,2,6,5,7,6,7,1,3,1,2,0,3,0,25
10013,785389,31,8,16,4,10,4,6,3,4,0,4,4,3,2,4,0,23
10013,785255,11,3,4,3,3,0,1,1,2,1,3,0,3,1,1,0,7
10013,796399,22,1,4,1,2,0,2,2,4,1,4,2,1,1,1,1,4
10013,791640,5,0,1,0,0,0,1,0,0,0,0,0,0,0,0,1,0
10013,785391,1,0,0,0,0,0,0,0,0,0,0,0,0,0,0,0,0
10013,796402,1,0,0,0,0,0,0,0,0,0,0,0,0,0,0,0,0
10013,796400,1,0,0,0,0,0,0,0,0,0,0,0,0,0,0,0,0
10014,796560,9,1,3,1,3,0,0,0,0,0,3,0,1,0,0,0,2
10014,780119,39,6,14,6,14,0,0,0,0,11,3,1,3,1,2,0,12
10014,796558,34,7,13,7,13,0,0,2,2,2,6,2,3,0,2,0,16
10014,796559,38,4,20,4,17,0,3,6,7,1,5,0,4,1,2,3,14
10014,776097,38,9,17,8,14,1,3,3,4,2,2,6,4,1,1,0,22
10014,780149,13,1,6,1,4,0,2,2,2,0,3,0,1,2,2,0,4
10014,785280,28,1,4,1,3,0,1,0,0,0,6,4,1,2,1,0,2
10014,785285,1,0,0,0,0,0,0,0,0,0,0,0,0,0,0,0,0
10015,786547,29,4,6,2,2,2,4,1,2,2,4,3,4,1,1,3,11
10015,786544,40,4,7,3,3,1,4,3,3,0,11,1,2,0,4,0,12
10015,797507,37,4,8,3,3,1,5,0,0,0,6,5,0,2,1,1,9
10015,792012,40,8,19,5,11,3,8,6,8,1,1,4,3,0,5,0,25
10015,786546,35,6,13,5,9,1,4,0,0,2,4,2,4,0,2,0,13
10015,786860,11,0,4,0,1,0,3,0,0,0,1,1,1,0,0,0,0
10015,797510,5,0,2,0,0,0,2,0,0,0,0,0,0,0,0,0,0
10015,792013,3,0,2,0,1,0,1,0,0,0,0,0,0,0,0,0,0
10016,775897,22,1,3,1,2,0,1,6,6,0,1,0,5,1,2,0,8
10016,780324,35,6,12,6,12,0,0,2,2,4,6,4,0,0,0,1,14
10016,791543,24,2,7,1,1,1,6,3,4,0,1,0,3,1,0,0,8
10016,786530,40,3,7,1,2,2,5,2,3,1,1,6,2,1,1,0,10
10016,780317,28,3,11,1,3,2,8,2,3,3,4,3,4,0,4,1,10
10016,791545,20,1,4,1,4,0,0,2,3,2,3,1,4,0,1,2,4
10016,784246,21,1,5,1,3,0,2,0,3,1,2,0,1,1,0,0,2
10016,797092,4,0,2,0,2,0,0,0,0,0,1,0,0,0,0,0,0
10016,786360,6,0,2,0,1,0,1,0,0,0,1,0,0,0,0,0,0
10016,791546,0,1,1,1,1,0,0,0,0,0,0,0,1,0,0,0,2
10016,791547,0,0,0,0,0,0,0,0,0,0,0,0,0,0,0,0,0
10016,775437,0,0,0,0,0,0,0,0,0,0,0,0,0,0,0,0,0
10017,796404,26,4,8,4,8,0,0,2,2,3,8,2,2,1,1,0,10
10017,790853,28,2,6,2,6,0,0,0,0,1,3,0,4,0,2,0,4
10017,790850,26,3,9,1,3,2,6,0,0,0,1,0,2,1,0,0,8
10017,781164,23,0,2,0,0,0,2,6,8,1,1,1,0,1,1,0,6
10017,781163,40,6,13,4,10,2,3,8,8,0,4,4,2,0,0,0,22
10017,796406,12,2,4,2,4,0,0,0,0,1,4,0,4,0,0,2,4
10017,790849,20,1,3,1,2,0,1,0,0,2,1,4,0,0,2,0,2
10017,785434,14,2,5,2,5,0,0,2,2,0,0,1,2,0,1,0,6
10017,781223,11,1,1,0,0,1,1,0,0,0,0,1,0,1,0,0,3
10018,785298,19,2,5,2,5,0,0,0,0,2,0,0,3,1,0,1,4
10018,775224,23,3,5,3,5,0,0,0,0,2,7,0,4,0,1,0,6
10018,778046,36,4,14,3,5,1,9,0,3,1,1,3,1,2,2,1,9
10018,782121,36,7,13,7,10,0,3,0,0,0,1,2,1,2,1,1,14
10018,775793,35,2,6,2,5,0,1,1,1,3,1,2,0,1,1,2,5
10018,785485,15,1,4,1,4,0,0,0,0,2,1,1,1,0,0,0,2
10018,785302,12,3,6,3,3,0,3,0,0,1,2,0,1,1,0,0,6
10018,786594,24,4,6,2,3,2,3,6,6,0,3,1,1,1,0,0,16
10019,791981,38,4,7,4,7,0,0,0,1,5,7,2,1,1,2,1,8
10019,780342,30,4,6,4,4,0,2,8,8,2,2,2,1,0,3,0,16
10019,791982,35,7,14,6,8,1,6,0,0,1,4,3,3,0,3,0,15
10019,791985,10,1,2,0,0,1,2,0,0,0,1,0,0,0,1,0,3
10019,781493,31,1,11,0,5,1,6,0,0,1,3,0,1,0,4,0,3
10019,791986,11,0,0,0,0,0,0,0,0,0,1,1,3,0,0,0,0
10019,786756,10,0,1,0,0,0,1,0,0,0,0,0,2,0,0,0,0
10019,791984,13,1,2,1,2,0,0,0,2,0,2,0,1,0,0,3,2
10019,786755,22,2,3,2,3,0,0,0,0,0,1,0,2,0,2,2,4
10020,785287,12,1,3,1,3,0,0,0,0,0,0,1,3,0,0,0,2
10020,776286,28,4,6,4,6,0,0,5,6,4,6,2,2,0,1,0,13
10020,791445,39,5,15,3,6,2,9,0,0,1,3,2,1,4,1,0,12
10020,785357,32,5,15,1,3,4,12,0,0,2,2,1,3,3,1,0,14
10020,775560,34,3,8,3,5,0,3,3,6,2,6,8,3,1,1,1,9
10020,797010,15,2,6,1,4,1,2,1,2,0,0,1,1,0,2,0,6
10020,781627,19,2,5,2,5,0,0,0,0,1,3,0,3,0,1,1,4
10020,775557,21,1,2,1,2,0,0,0,0,1,2,0,0,0,0,2,2
10021,792181,35,3,9,2,5,1,4,1,2,1,4,0,4,1,1,1,8
10021,785902,13,0,3,0,1,0,2,2,2,0,0,0,0,0,1,0,2
10021,780986,35,1,6,1,6,0,0,0,0,0,2,2,4,0,1,0,2
10021,792179,24,4,10,2,5,2,5,2,2,0,1,1,2,0,2,0,12
10021,786662,36,3,13,2,4,1,9,5,7,0,6,1,2,2,2,0,12
10021,797796,23,2,4,1,3,1,1,0,0,0,1,1,3,0,3,0,5
10021,792177,19,1,2,1,2,0,0,3,4,3,3,0,2,0,1,2,5
10021,786661,15,0,3,0,1,0,2,0,0,0,2,0,0,0,0,1,0
10022,785518,26,5,11,5,10,0,1,2,3,2,2,1,3,1,2,1,12
10022,796390,16,2,5,2,5,0,0,2,3,2,4,0,1,1,0,2,6
10022,790832,32,6,12,2,5,4,7,7,9,1,3,5,2,1,1,0,23
10022,790834,35,2,9,0,4,2,5,2,3,5,11,1,2,1,2,1,8
10022,785451,29,4,8,2,4,2,4,0,0,1,3,3,3,1,0,1,10
10022,790831,7,0,1,0,1,0,0,0,0,0,0,2,2,0,1,0,0
10022,790833,30,6,13,4,9,2,4,1,2,1,4,2,3,1,4,5,15
10022,790830,19,1,2,1,1,0,1,1,2,1,4,0,0,1,0,0,3
10022,785379,4,0,0,0,0,0,0,0,0,0,0,0,0,0,1,0,0
10022,796389,1,0,0,0,0,0,0,0,0,0,0,0,1,0,0,0,0
10022,785377,1,0,0,0,0,0,0,0,0,0,0,0,0,0,0,0,0
10023,796401,29,2,6,2,4,0,2,2,2,1,4,0,3,0,1,1,6
10023,775654,32,3,6,3,6,0,0,2,2,3,8,0,3,1,3,2,8
10023,791639,32,2,7,1,3,1,4,1,3,0,0,1,3,1,0,0,6
10023,796398,28,6,13,3,8,3,5,4,6,2,4,3,5,1,4,0,19
10023,785389,37,1,10,1,5,0,5,2,4,0,4,3,1,1,4,1,4
10023,796399,35,7,16,5,11,2,5,1,2,0,3,3,1,0,0,1,17
10023,785255,3,0,0,0,0,0,0,0,0,0,2,0,2,0,0,0,0
10023,796400,4,2,2,2,2,0,0,0,0,1,1,1,0,1,0,0,4
10023,791640,0,0,0,0,0,0,0,0,0,0,0,0,0,0,0,0,0
10024,791144,10,1,4,1,4,0,0,4,4,0,2,1,2,0,1,1,6
10024,785782,33,2,8,0,2,2,6,0,0,0,1,3,2,1,1,0,6
10024,791145,28,4,6,4,5,0,1,1,2,0,9,2,2,2,2,2,9
10024,791146,36,6,12,2,3,4,9,2,3,0,4,7,2,2,3,0,18
10024,785777,32,2,7,1,3,1,4,5,5,2,1,0,2,0,2,0,10
10024,791147,21,5,6,2,2,3,4,2,4,2,4,1,2,2,1,0,15
10024,796804,4,1,1,1,1,0,0,0,1,0,0,0,0,0,1,0,2
10024,791148,24,1,5,0,2,1,3,3,4,0,3,1,1,0,2,0,6
10024,786748,12,1,2,1,2,0,0,0,0,0,1,1,3,1,2,0,2
10025,791524,37,6,14,5,8,1,6,0,0,2,5,5,2,1,1,0,13
10025,797139,34,10,13,10,13,0,0,7,12,5,8,3,2,2,5,1,27
10025,780272,35,6,12,4,9,2,3,0,0,1,5,2,2,0,1,0,14
10025,775592,27,5,13,1,3,4,10,0,1,0,5,1,1,1,2,0,14
10025,775394,24,0,0,0,0,0,0,0,0,0,2,4,4,2,2,0,0
10025,785970,3,1,1,1,1,0,0,0,0,1,0,0,1,0,1,0,2
10025,791526,29,2,4,0,0,2,4,0,3,0,3,3,3,3,3,1,6
10025,791523,4,0,2,0,1,0,1,0,0,0,0,0,1,0,0,0,0
10025,780273,6,0,1,0,0,0,1,0,0,0,0,1,3,0,1,0,0
10025,786354,1,0,0,0,0,0,0,0,0,0,0,0,0,0,0,0,0
10026,776110,12,1,1,0,0,1,1,0,0,0,0,2,0,0,1,1,3
10026,780059,30,3,6,3,3,0,3,2,7,4,5,3,3,1,4,3,8
10026,790944,29,2,7,2,5,0,2,0,0,0,4,0,2,0,5,0,4
10026,780061,42,5,15,3,8,2,7,4,4,1,4,1,4,1,1,0,16
10026,790941,24,4,5,4,5,0,0,0,2,4,1,0,5,1,1,0,8
10026,780058,13,1,2,0,0,1,2,0,2,0,4,0,0,0,0,0,3
10026,796494,17,2,6,2,2,0,4,2,3,0,2,0,2,0,0,1,6
10026,796496,23,4,5,3,3,1,2,1,3,1,8,0,5,3,1,0,10
10026,786754,35,8,22,6,15,2,7,2,4,1,2,3,2,0,1,0,20
10027,780283,26,5,10,5,10,0,0,0,0,1,4,0,3,0,1,4,10
10027,790925,45,6,13,4,7,2,6,3,4,2,6,3,2,3,1,1,17
10027,791456,30,5,18,4,12,1,6,2,2,3,1,1,5,2,0,0,13
10027,785476,31,5,8,5,7,0,1,3,5,0,2,5,3,2,1,1,13
10027,785474,42,4,15,0,5,4,10,5,5,2,4,2,3,0,3,0,17
10027,796470,19,0,2,0,1,0,1,3,4,4,5,0,2,0,1,1,3
10027,790926,11,0,3,0,2,0,1,0,0,0,1,1,2,1,0,0,0
10027,785480,20,4,5,1,1,3,4,4,5,0,3,0,1,0,0,0,15
10027,785478,1,0,0,0,0,0,0,0,0,0,0,0,0,0,0,0,0
10028,790798,27,10,14,10,13,0,1,2,3,2,4,4,3,0,4,0,22
10028,780140,34,5,8,3,5,2,3,0,0,3,4,1,2,2,1,1,12
10028,796355,34,3,7,3,5,0,2,3,3,0,5,6,0,2,6,0,9
10028,785245,36,7,9,4,4,3,5,0,0,0,4,8,2,0,1,0,17
10028,780137,34,5,13,2,3,3,10,0,0,0,8,1,2,0,2,0,13
10028,790799,16,3,3,3,3,0,0,1,4,1,1,2,2,1,1,0,7
10028,775553,11,1,3,0,0,1,3,0,0,0,2,1,0,0,1,0,3
10028,799892,1,0,0,0,0,0,0,0,0,0,0,0,0,0,0,1,0
10028,790796,2,0,0,0,0,0,0,0,0,0,0,0,1,0,0,0,0
10028,796354,3,0,0,0,0,0,0,0,0,0,0,0,0,0,0,0,0
10028,796359,2,0,0,0,0,0,0,0,0,0,0,0,0,0,0,0,0
10029,785714,21,6,9,6,9,0,0,0,2,1,4,3,3,1,3,0,12
10029,775894,32,3,10,3,7,0,3,0,0,1,4,2,3,3,5,0,6
10029,785711,34,7,16,4,9,3,7,2,2,0,3,2,1,1,2,0,19
10029,780985,32,2,9,1,2,1,7,0,0,1,0,3,0,0,0,0,5
10029,775266,31,6,13,5,8,1,5,0,2,1,4,1,1,0,0,0,13
10029,796829,16,1,4,1,4,0,0,0,0,2,0,0,1,2,0,0,2
10029,791167,17,2,4,2,4,0,0,0,0,0,1,0,1,0,0,0,4
10029,779994,5,1,2,1,2,0,0,0,0,0,1,0,1,0,0,0,2
10029,785710,3,0,1,0,1,0,0,0,0,1,0,0,1,0,0,0,0
10029,780988,2,0,0,0,0,0,0,0,0,0,0,0,0,1,0,0,0
10029,791169,2,0,0,0,0,0,0,0,0,0,0,0,0,1,0,0,0
10029,796827,1,0,1,0,0,0,1,0,0,0,0,0,0,0,0,0,0
10029,785378,3,0,0,0,0,0,0,2,2,1,0,0,0,0,0,0,2
10029,796828,1,0,0,0,0,0,0,0,0,0,0,0,0,0,0,0,0
10030,785370,26,5,10,5,10,0,0,4,6,3,3,2,0,2,2,0,14
10030,796309,30,5,10,5,10,0,0,4,7,4,4,2,2,0,1,2,14
10030,790824,35,4,9,4,5,0,4,5,6,0,10,5,2,0,0,1,13
10030,780011,32,3,9,3,7,0,2,0,1,0,0,4,0,1,0,0,6
10030,775667,35,3,9,2,6,1,3,1,2,0,3,4,1,0,2,0,8
10030,796383,5,0,0,0,0,0,0,0,0,0,0,0,1,1,1,0,0
10030,774895,9,3,3,3,3,0,0,0,0,1,2,1,1,0,0,0,6
10030,781524,21,5,6,3,4,2,2,0,0,1,2,0,1,0,0,0,12
10030,796384,2,1,1,1,1,0,0,1,1,0,0,0,0,0,1,0,3
10030,780941,1,0,0,0,0,0,0,0,0,0,0,1,1,0,0,0,0
10030,796382,2,0,1,0,1,0,0,0,0,0,1,0,1,0,0,0,0
10030,785367,2,0,1,0,1,0,0,0,0,0,0,0,0,0,0,0,0
10031,781300,20,3,5,3,5,0,0,2,2,0,3,1,4,0,3,0,8
10031,790803,22,3,6,3,6,0,0,1,2,1,2,1,1,0,0,1,7
10031,790801,17,1,3,1,3,0,0,0,0,1,1,1,1,0,4,1,2
10031,781304,25,5,14,5,11,0,3,0,0,1,1,2,4,0,1,0,10
10031,781302,25,3,5,2,2,1,3,2,2,2,2,1,2,3,0,0,9
10031,780598,31,4,9,0,2,4,7,0,0,0,6,1,3,0,1,0,12
10031,796364,5,0,1,0,1,0,0,0,0,0,1,0,1,0,1,1,0
10031,796363,9,0,2,0,1,0,1,0,0,0,1,0,0,1,1,0,0
10031,796360,25,4,11,4,8,0,3,0,0,1,0,3,4,1,3,1,8
10031,790802,5,0,1,0,0,0,1,0,0,0,2,0,0,0,0,0,0
10031,781305,9,0,0,0,0,0,0,0,0,0,1,0,1,0,0,0,0
10031,781306,2,1,1,1,1,0,0,0,0,1,0,0,0,0,0,0,2
10031,796362,2,0,0,0,0,0,0,0,0,0,1,0,1,0,0,1,0
10031,781303,2,0,1,0,0,0,1,0,0,0,0,0,0,1,0,0,0
10031,776366,1,0,1,0,0,0,1,0,0,0,0,0,0,0,0,0,0
10032,796444,36,4,6,4,5,0,1,2,3,2,6,6,2,0,1,2,10
10032,790893,35,6,9,6,8,0,1,1,1,3,3,2,3,1,1,1,13
10032,786615,26,2,4,0,2,2,2,0,0,1,2,2,3,1,4,0,6
10032,786732,32,8,10,4,5,4,5,2,3,1,4,1,2,3,0,0,22
10032,775260,34,7,11,4,5,3,6,3,3,0,2,3,0,0,3,0,20
10032,790890,16,1,3,1,3,0,0,0,0,0,1,1,0,0,4,0,2
10032,790889,10,3,5,2,3,1,2,2,2,0,2,0,0,0,0,0,9
10032,775536,8,0,6,0,6,0,0,0,0,1,0,0,1,0,0,1,0
10032,780702,1,0,0,0,0,0,0,0,0,0,0,0,0,0,0,0,0
10032,799891,1,0,0,0,0,0,0,0,0,0,0,0,0,0,0,0,0
10032,796445,1,0,0,0,0,0,0,0,0,0,0,0,0,0,0,0,0
10033,780094,29,1,7,1,5,0,2,0,0,4,2,1,2,0,2,0,2
10033,775142,35,9,19,7,14,2,5,8,8,7,3,2,2,2,1,1,28
10033,790843,39,8,16,6,10,2,6,3,3,3,2,6,1,3,1,1,21
10033,786212,35,2,12,2,8,0,4,0,0,0,4,1,3,0,4,0,4
10033,785392,39,2,8,1,4,1,4,0,0,0,1,5,3,2,2,1,5
10033,790844,8,0,2,0,2,0,0,0,0,1,1,0,1,0,1,0,0
10033,799986,11,4,5,4,5,0,0,0,1,1,0,0,2,0,0,0,8
10033,796914,1,0,0,0,0,0,0,0,0,0,0,0,0,0,0,0,0
10033,781563,3,0,0,0,0,0,0,0,0,0,0,0,0,0,0,0,0
10034,785287,18,2,2,2,2,0,0,1,3,3,2,1,0,0,1,1,5
10034,776286,35,1,6,1,5,0,1,4,8,5,5,0,2,1,1,0,6
10034,791445,34,5,19,0,6,5,13,5,6,2,2,2,1,2,0,0,20
10034,785357,36,5,15,1,5,4,10,4,4,1,1,4,3,2,0,0,18
10034,775560,38,4,13,2,7,2,6,0,0,1,7,8,3,1,3,2,10
10034,775557,7,0,1,0,1,0,0,0,0,0,0,0,2,0,1,0,0
10034,781627,20,3,4,3,4,0,0,2,3,5,2,1,1,0,0,0,8
10034,797010,12,0,2,0,0,0,2,0,0,1,1,1,0,0,0,0,0
10035,796404,33,4,9,4,9,0,0,0,2,1,4,2,5,1,0,1,8
10035,790853,22,2,2,2,2,0,0,0,0,2,1,0,3,1,1,0,4
10035,790850,31,3,7,1,2,2,5,0,0,0,1,0,3,1,1,0,8
10035,781164,16,0,1,0,0,0,1,3,3,0,1,0,0,0,1,0,3
10035,781163,36,3,12,3,10,0,2,5,8,2,5,6,3,0,3,0,11
10035,796406,14,2,3,2,3,0,0,0,2,1,2,2,3,0,1,0,4
10035,785434,13,4,7,2,3,2,4,3,5,0,5,0,1,0,1,0,13
10035,781223,9,1,1,0,0,1,1,0,0,0,1,0,0,1,0,0,3
10035,790849,24,3,5,2,2,1,3,0,0,1,0,4,1,0,1,0,7
10035,790854,2,0,0,0,0,0,0,0,0,0,0,0,1,0,0,0,0
10036,785298,13,2,3,2,3,0,0,0,0,2,2,1,1,0,0,0,4
10036,778046,33,4,11,2,8,2,3,4,4,1,2,5,2,0,3,0,14
10036,782121,29,6,11,6,11,0,0,0,3,0,1,6,3,1,1,0,12
10036,775793,37,8,18,5,11,3,7,3,3,0,5,0,2,0,0,2,22
10036,775224,18,2,4,2,4,0,0,0,0,3,1,1,5,1,0,1,4
10036,786594,26,2,6,0,4,2,2,4,4,0,0,3,3,4,1,1,10
10036,785302,20,3,6,2,3,1,3,0,0,1,2,1,3,3,2,0,7
10036,785485,24,3,3,3,3,0,0,2,3,3,3,0,2,0,1,1,8
10037,796560,15,4,5,4,5,0,0,0,0,3,1,0,1,0,1,1,8
10037,780119,37,5,9,5,9,0,0,0,0,1,5,3,4,2,0,1,10
10037,796558,32,6,13,6,11,0,2,2,2,2,4,2,2,1,2,0,14
10037,796559,33,2,10,2,6,0,4,7,8,2,3,1,2,0,3,1,11
10037,776097,35,3,7,2,6,1,1,6,8,2,2,2,3,1,6,1,13
10037,780149,15,5,6,3,4,2,2,2,3,0,0,1,5,0,3,1,14
10037,785280,31,1,4,1,2,0,2,0,2,0,6,4,1,1,0,0,2
10037,785285,2,0,0,0,0,0,0,0,0,0,0,0,0,0,0,0,0
10038,790798,31,10,19,10,18,0,1,3,4,2,3,4,4,3,0,0,23
10038,780140,37,6,19,3,9,3,10,3,5,3,5,2,1,0,1,0,18
10038,796355,35,7,11,5,7,2,4,2,2,1,9,8,3,0,3,0,18
10038,785245,36,3,7,3,4,0,3,1,2,0,1,4,2,1,1,0,7
10038,780137,29,4,5,4,5,0,0,1,2,3,3,3,3,0,2,1,9
10038,790799,17,0,1,0,1,0,0,0,0,1,3,0,3,2,1,1,0
10038,775553,10,2,2,0,0,2,2,2,2,0,2,0,0,0,1,1,8
10038,799892,1,0,0,0,0,0,0,0,0,0,1,0,0,0,0,0,0
10038,796359,1,1,1,1,1,0,0,0,0,1,0,0,0,0,0,0,2
10038,796354,1,0,1,0,0,0,1,0,0,0,0,0,0,0,0,0,0
10038,790796,1,0,0,0,0,0,0,0,0,0,0,0,0,0,0,0,0
10038,790795,1,0,0,0,0,0,0,0,0,0,0,0,0,0,0,0,0
10039,790893,35,7,11,6,8,1,3,4,5,0,7,3,1,1,0,0,19
10039,796444,35,5,11,5,11,0,0,7,8,2,3,3,2,0,0,0,17
10039,786615,34,5,13,4,9,1,4,2,2,2,4,0,2,2,1,0,13
10039,786732,14,1,4,1,4,0,0,0,2,3,0,0,1,0,2,0,2
10039,775260,35,4,13,2,7,2,6,1,2,0,2,2,3,0,1,0,11
10039,790889,19,2,5,2,3,0,2,0,0,0,1,1,1,3,2,0,4
10039,790890,16,0,2,0,2,0,0,0,0,0,0,0,1,1,2,0,0
10039,775536,10,0,3,0,3,0,0,0,0,0,2,0,2,0,1,0,0
10039,780702,2,0,0,0,0,0,0,0,0,0,1,0,0,0,0,0,0
10040,785370,30,4,5,4,5,0,0,0,0,0,0,0,0,1,2,1,8
10040,796309,29,5,10,5,10,0,0,1,4,1,1,0,3,0,4,1,11
10040,790824,34,1,10,1,6,0,4,2,2,2,6,2,3,2,2,1,4
10040,780011,37,3,8,3,7,0,1,2,2,1,4,4,2,0,2,0,8
10040,775667,31,1,7,0,4,1,3,0,2,1,4,4,2,1,1,0,3
10040,781524,28,3,5,1,2,2,3,0,0,1,8,2,1,1,1,0,8
10040,774895,11,3,6,3,6,0,0,1,1,2,1,0,0,0,2,0,7
10041,780283,18,2,6,2,6,0,0,0,0,0,0,3,5,0,2,1,4
10041,790925,38,1,6,1,5,0,1,2,2,2,4,4,2,3,2,1,4
10041,791456,38,11,19,9,14,2,5,4,5,0,2,0,0,0,0,0,28
10041,785476,33,5,10,4,6,1,4,0,0,0,1,2,1,2,2,0,11
10041,785474,39,2,10,2,8,0,2,0,0,3,6,2,1,0,1,0,4
10041,785478,20,0,0,0,0,0,0,0,0,1,4,0,3,0,1,0,0
10041,785480,5,0,1,0,1,0,0,0,0,0,1,1,0,0,0,0,0
10041,790926,5,0,2,0,1,0,1,0,0,0,2,0,1,0,0,0,0
10041,796470,2,0,0,0,0,0,0,0,0,0,1,0,0,0,0,0,0
10041,800121,2,0,0,0,0,0,0,0,0,0,0,0,1,0,0,0,0
10042,785298,16,2,2,2,2,0,0,0,0,1,3,0,2,1,2,0,4
10042,778046,33,6,9,2,4,4,5,1,1,1,4,4,2,2,3,0,17
10042,782121,36,4,11,1,5,3,6,1,2,0,2,11,2,1,0,0,12
10042,775793,29,4,9,3,4,1,5,2,4,0,2,6,2,1,0,0,11
10042,775224,15,1,1,1,1,0,0,0,0,0,1,0,4,1,1,0,2
10042,785302,19,5,10,3,5,2,5,0,0,2,2,0,3,0,2,0,12
10042,785485,21,3,5,3,5,0,0,5,6,4,2,1,1,0,0,0,11
10042,786594,23,3,6,2,4,1,2,0,0,2,1,1,1,0,0,0,7
10042,796598,2,0,1,0,0,0,1,0,0,0,0,0,0,0,0,0,0
10042,778469,1,1,1,1,1,0,0,0,0,1,0,0,0,0,0,0,2
10042,785301,1,0,0,0,0,0,0,0,0,0,0,0,1,0,0,0,0
10042,796599,2,0,0,0,0,0,0,0,0,0,0,0,0,0,0,0,0
10042,790987,2,0,0,0,0,0,0,0,0,0,0,0,0,0,0,0,0
10043,785287,17,2,3,2,3,0,0,2,2,2,0,0,0,0,0,1,6
10043,776286,26,1,2,1,2,0,0,1,2,3,3,3,1,2,2,2,3
10043,791445,39,7,14,2,5,5,9,1,3,1,3,2,1,0,0,0,20
10043,785357,37,4,12,3,4,1,8,4,4,0,2,2,1,2,2,1,13
10043,775560,32,3,10,3,8,0,2,0,1,1,1,1,2,0,5,0,6
10043,781627,18,1,6,1,6,0,0,2,2,5,0,2,3,0,1,1,4
10043,775557,4,0,0,0,0,0,0,0,0,0,1,0,1,0,0,0,0
10043,797010,20,2,6,2,6,0,0,0,0,0,1,0,1,0,0,0,4
10043,797012,2,1,2,1,2,0,0,1,2,1,1,0,0,0,0,0,3
10043,791444,2,0,0,0,0,0,0,0,0,0,0,0,0,0,0,0,0
10043,797011,1,0,0,0,0,0,0,0,0,0,0,0,0,0,0,0,0
10043,797009,1,0,0,0,0,0,0,0,0,0,0,0,0,0,0,0,0
10043,785895,1,0,0,0,0,0,0,0,0,0,0,0,0,0,0,0,0
10044,790798,38,11,15,11,14,0,1,3,5,1,3,2,4,0,0,0,25
10044,780140,44,6,13,4,5,2,8,1,2,1,4,5,2,2,1,1,15
10044,796355,40,6,12,4,7,2,5,2,2,0,5,6,3,2,2,1,16
10044,785245,42,4,9,3,6,1,3,2,4,0,1,8,1,1,2,0,11
10044,780137,42,9,12,7,9,2,3,2,3,2,4,2,3,2,2,0,22
10044,790799,10,0,0,0,0,0,0,2,4,0,1,0,3,1,2,1,2
10044,775553,9,1,2,1,1,0,1,0,0,0,1,3,0,0,1,0,2
10045,780283,42,7,14,7,14,0,0,0,1,2,8,5,3,0,0,1,14
10045,790925,40,6,12,4,7,2,5,5,7,2,3,4,2,1,3,0,19
10045,791456,45,12,18,9,12,3,6,2,4,1,5,2,2,2,4,0,29
10045,785476,36,6,11,5,8,1,3,4,5,0,1,7,2,1,1,0,17
10045,785474,18,2,3,1,1,1,2,0,0,0,4,2,4,0,0,0,5
10045,796470,8,0,0,0,0,0,0,3,4,1,1,0,2,0,1,0,3
10045,785480,31,1,1,0,0,1,1,0,0,1,2,1,1,0,0,0,3
10045,785478,0,0,0,0,0,0,0,0,0,0,0,0,0,0,0,0,0
10045,790926,5,0,0,0,0,0,0,0,0,0,0,0,0,0,0,0,0
10046,790798,33,5,7,5,7,0,0,2,2,0,5,3,4,0,5,2,12
10046,780140,38,5,12,3,5,2,7,0,0,0,3,2,3,1,1,1,12
10046,796355,33,8,15,6,10,2,5,4,6,0,1,3,3,2,3,0,22
10046,785245,39,2,5,2,2,0,3,5,8,0,4,4,4,0,2,0,9
10046,780137,31,3,5,3,4,0,1,2,3,1,1,1,0,0,0,0,8
10046,775553,10,0,0,0,0,0,0,0,0,0,2,2,0,0,3,0,0
10046,790799,13,1,3,1,3,0,0,2,2,0,0,1,3,1,0,0,4
10046,796359,1,0,1,0,1,0,0,0,0,0,0,0,0,0,0,0,0
10046,796354,1,1,1,0,0,1,1,0,0,0,0,0,0,0,0,0,3
10046,799892,1,0,0,0,0,0,0,0,0,0,0,0,0,0,0,0,0
10047,785298,16,0,3,0,3,0,0,3,4,3,3,0,5,0,1,1,3
10047,778046,31,6,14,2,5,4,9,6,6,0,3,7,3,0,0,0,22
10047,782121,36,6,15,5,11,1,4,2,2,1,5,5,1,1,3,1,15
10047,775793,31,8,15,6,12,2,3,1,2,0,2,0,0,0,1,1,19
10047,775224,27,3,7,3,6,0,1,0,0,8,3,2,3,2,0,1,6
10047,786594,22,3,6,0,2,3,4,4,4,1,1,2,2,1,1,0,13
10047,785485,16,3,4,3,4,0,0,0,0,1,1,1,4,2,0,0,6
10047,785302,16,1,2,1,1,0,1,0,0,0,2,1,1,1,1,0,2
10047,796599,1,0,0,0,0,0,0,0,0,0,0,0,0,0,0,1,0
10047,796598,1,0,1,0,0,0,1,0,0,0,0,0,0,0,0,0,0
10047,778469,1,0,0,0,0,0,0,0,0,0,0,0,0,1,0,0,0
10047,790987,1,0,0,0,0,0,0,0,0,0,0,0,0,0,0,0,0
10047,785301,1,0,0,0,0,0,0,0,0,0,0,0,0,0,0,0,0
